Territory;Year;Age;Total;Men;Women
Akmenė d. mun.;2001;-1;30266;14244;16022
Akmenė d. mun.;2001;0;306;170;136
Akmenė d. mun.;2001;1;320;158;162
Akmenė d. mun.;2001;2;346;185;161
Akmenė d. mun.;2001;3;365;187;178
Akmenė d. mun.;2001;4;375;210;165
Akmenė d. mun.;2001;5;392;211;181
Akmenė d. mun.;2001;6;394;212;182
Akmenė d. mun.;2001;7;507;231;276
Akmenė d. mun.;2001;8;552;286;266
Akmenė d. mun.;2001;9;537;297;240
Akmenė d. mun.;2001;10;503;263;240
Akmenė d. mun.;2001;11;521;253;268
Akmenė d. mun.;2001;12;461;251;210
Akmenė d. mun.;2001;13;550;259;291
Akmenė d. mun.;2001;14;566;303;263
Akmenė d. mun.;2001;15;539;251;288
Akmenė d. mun.;2001;16;544;270;274
Akmenė d. mun.;2001;17;481;251;230
Akmenė d. mun.;2001;18;369;201;168
Akmenė d. mun.;2001;19;320;179;141
Akmenė d. mun.;2001;20;328;189;139
Akmenė d. mun.;2001;21;316;170;146
Akmenė d. mun.;2001;22;338;170;168
Akmenė d. mun.;2001;23;338;160;178
Akmenė d. mun.;2001;24;317;165;152
Akmenė d. mun.;2001;25;313;154;159
Akmenė d. mun.;2001;26;359;178;181
Akmenė d. mun.;2001;27;371;178;193
Akmenė d. mun.;2001;28;389;210;179
Akmenė d. mun.;2001;29;412;197;215
Akmenė d. mun.;2001;30;415;197;218
Akmenė d. mun.;2001;31;409;208;201
Akmenė d. mun.;2001;32;436;214;222
Akmenė d. mun.;2001;33;414;212;202
Akmenė d. mun.;2001;34;404;199;205
Akmenė d. mun.;2001;35;389;196;193
Akmenė d. mun.;2001;36;408;210;198
Akmenė d. mun.;2001;37;464;229;235
Akmenė d. mun.;2001;38;452;232;220
Akmenė d. mun.;2001;39;451;220;231
Akmenė d. mun.;2001;40;483;241;242
Akmenė d. mun.;2001;41;487;220;267
Akmenė d. mun.;2001;42;456;218;238
Akmenė d. mun.;2001;43;422;210;212
Akmenė d. mun.;2001;44;426;209;217
Akmenė d. mun.;2001;45;408;215;193
Akmenė d. mun.;2001;46;404;175;229
Akmenė d. mun.;2001;47;332;171;161
Akmenė d. mun.;2001;48;364;187;177
Akmenė d. mun.;2001;49;396;169;227
Akmenė d. mun.;2001;50;371;163;208
Akmenė d. mun.;2001;51;356;173;183
Akmenė d. mun.;2001;52;377;175;202
Akmenė d. mun.;2001;53;296;145;151
Akmenė d. mun.;2001;54;286;125;161
Akmenė d. mun.;2001;55;326;130;196
Akmenė d. mun.;2001;56;282;122;160
Akmenė d. mun.;2001;57;353;160;193
Akmenė d. mun.;2001;58;397;165;232
Akmenė d. mun.;2001;59;351;150;201
Akmenė d. mun.;2001;60;363;143;220
Akmenė d. mun.;2001;61;309;126;183
Akmenė d. mun.;2001;62;289;129;160
Akmenė d. mun.;2001;63;313;123;190
Akmenė d. mun.;2001;64;351;155;196
Akmenė d. mun.;2001;65;342;143;199
Akmenė d. mun.;2001;66;332;124;208
Akmenė d. mun.;2001;67;314;116;198
Akmenė d. mun.;2001;68;293;103;190
Akmenė d. mun.;2001;69;290;124;166
Akmenė d. mun.;2001;70;265;102;163
Akmenė d. mun.;2001;71;238;76;162
Akmenė d. mun.;2001;72;289;114;175
Akmenė d. mun.;2001;73;239;81;158
Akmenė d. mun.;2001;74;199;68;131
Akmenė d. mun.;2001;75;234;81;153
Akmenė d. mun.;2001;76;175;50;125
Akmenė d. mun.;2001;77;186;53;133
Akmenė d. mun.;2001;78;152;59;93
Akmenė d. mun.;2001;79;153;36;117
Akmenė d. mun.;2001;80;110;34;76
Akmenė d. mun.;2001;81;97;22;75
Akmenė d. mun.;2001;82;68;19;49
Akmenė d. mun.;2001;83;67;28;39
Akmenė d. mun.;2001;84;44;13;31
Akmenė d. mun.;2001;85;310;83;227
Akmenė d. mun.;2002;-1;29933;14034;15899
Akmenė d. mun.;2002;0;260;137;123
Akmenė d. mun.;2002;1;305;172;133
Akmenė d. mun.;2002;2;319;157;162
Akmenė d. mun.;2002;3;342;181;161
Akmenė d. mun.;2002;4;365;187;178
Akmenė d. mun.;2002;5;373;210;163
Akmenė d. mun.;2002;6;389;208;181
Akmenė d. mun.;2002;7;391;208;183
Akmenė d. mun.;2002;8;502;233;269
Akmenė d. mun.;2002;9;541;279;262
Akmenė d. mun.;2002;10;531;296;235
Akmenė d. mun.;2002;11;500;258;242
Akmenė d. mun.;2002;12;515;249;266
Akmenė d. mun.;2002;13;457;245;212
Akmenė d. mun.;2002;14;545;257;288
Akmenė d. mun.;2002;15;557;298;259
Akmenė d. mun.;2002;16;535;249;286
Akmenė d. mun.;2002;17;536;263;273
Akmenė d. mun.;2002;18;467;246;221
Akmenė d. mun.;2002;19;376;199;177
Akmenė d. mun.;2002;20;330;183;147
Akmenė d. mun.;2002;21;340;196;144
Akmenė d. mun.;2002;22;318;171;147
Akmenė d. mun.;2002;23;333;168;165
Akmenė d. mun.;2002;24;336;156;180
Akmenė d. mun.;2002;25;310;159;151
Akmenė d. mun.;2002;26;303;149;154
Akmenė d. mun.;2002;27;347;170;177
Akmenė d. mun.;2002;28;362;170;192
Akmenė d. mun.;2002;29;381;204;177
Akmenė d. mun.;2002;30;402;189;213
Akmenė d. mun.;2002;31;398;189;209
Akmenė d. mun.;2002;32;394;199;195
Akmenė d. mun.;2002;33;429;209;220
Akmenė d. mun.;2002;34;404;206;198
Akmenė d. mun.;2002;35;392;188;204
Akmenė d. mun.;2002;36;384;192;192
Akmenė d. mun.;2002;37;395;199;196
Akmenė d. mun.;2002;38;452;224;228
Akmenė d. mun.;2002;39;439;224;215
Akmenė d. mun.;2002;40;446;218;228
Akmenė d. mun.;2002;41;481;242;239
Akmenė d. mun.;2002;42;479;216;263
Akmenė d. mun.;2002;43;444;211;233
Akmenė d. mun.;2002;44;412;203;209
Akmenė d. mun.;2002;45;422;209;213
Akmenė d. mun.;2002;46;396;205;191
Akmenė d. mun.;2002;47;404;172;232
Akmenė d. mun.;2002;48;322;166;156
Akmenė d. mun.;2002;49;357;181;176
Akmenė d. mun.;2002;50;393;166;227
Akmenė d. mun.;2002;51;362;155;207
Akmenė d. mun.;2002;52;349;166;183
Akmenė d. mun.;2002;53;367;170;197
Akmenė d. mun.;2002;54;295;144;151
Akmenė d. mun.;2002;55;285;124;161
Akmenė d. mun.;2002;56;318;126;192
Akmenė d. mun.;2002;57;274;118;156
Akmenė d. mun.;2002;58;340;154;186
Akmenė d. mun.;2002;59;391;162;229
Akmenė d. mun.;2002;60;336;139;197
Akmenė d. mun.;2002;61;357;140;217
Akmenė d. mun.;2002;62;305;124;181
Akmenė d. mun.;2002;63;286;127;159
Akmenė d. mun.;2002;64;305;119;186
Akmenė d. mun.;2002;65;344;151;193
Akmenė d. mun.;2002;66;338;139;199
Akmenė d. mun.;2002;67;325;123;202
Akmenė d. mun.;2002;68;308;113;195
Akmenė d. mun.;2002;69;287;100;187
Akmenė d. mun.;2002;70;287;124;163
Akmenė d. mun.;2002;71;258;95;163
Akmenė d. mun.;2002;72;232;73;159
Akmenė d. mun.;2002;73;282;111;171
Akmenė d. mun.;2002;74;226;74;152
Akmenė d. mun.;2002;75;192;62;130
Akmenė d. mun.;2002;76;224;76;148
Akmenė d. mun.;2002;77;170;45;125
Akmenė d. mun.;2002;78;174;49;125
Akmenė d. mun.;2002;79;145;57;88
Akmenė d. mun.;2002;80;138;33;105
Akmenė d. mun.;2002;81;106;32;74
Akmenė d. mun.;2002;82;91;21;70
Akmenė d. mun.;2002;83;55;18;37
Akmenė d. mun.;2002;84;62;25;37
Akmenė d. mun.;2002;85;308;79;229
Akmenė d. mun.;2003;-1;29500;13811;15689
Akmenė d. mun.;2003;0;257;143;114
Akmenė d. mun.;2003;1;261;135;126
Akmenė d. mun.;2003;2;304;169;135
Akmenė d. mun.;2003;3;323;159;164
Akmenė d. mun.;2003;4;344;186;158
Akmenė d. mun.;2003;5;363;187;176
Akmenė d. mun.;2003;6;371;212;159
Akmenė d. mun.;2003;7;392;211;181
Akmenė d. mun.;2003;8;389;206;183
Akmenė d. mun.;2003;9;501;232;269
Akmenė d. mun.;2003;10;534;277;257
Akmenė d. mun.;2003;11;530;294;236
Akmenė d. mun.;2003;12;494;254;240
Akmenė d. mun.;2003;13;511;248;263
Akmenė d. mun.;2003;14;454;242;212
Akmenė d. mun.;2003;15;535;252;283
Akmenė d. mun.;2003;16;542;287;255
Akmenė d. mun.;2003;17;522;245;277
Akmenė d. mun.;2003;18;525;259;266
Akmenė d. mun.;2003;19;460;243;217
Akmenė d. mun.;2003;20;368;194;174
Akmenė d. mun.;2003;21;329;180;149
Akmenė d. mun.;2003;22;330;193;137
Akmenė d. mun.;2003;23;324;172;152
Akmenė d. mun.;2003;24;332;169;163
Akmenė d. mun.;2003;25;317;150;167
Akmenė d. mun.;2003;26;288;148;140
Akmenė d. mun.;2003;27;298;146;152
Akmenė d. mun.;2003;28;338;169;169
Akmenė d. mun.;2003;29;353;165;188
Akmenė d. mun.;2003;30;376;204;172
Akmenė d. mun.;2003;31;392;185;207
Akmenė d. mun.;2003;32;395;187;208
Akmenė d. mun.;2003;33;389;195;194
Akmenė d. mun.;2003;34;423;205;218
Akmenė d. mun.;2003;35;400;204;196
Akmenė d. mun.;2003;36;376;178;198
Akmenė d. mun.;2003;37;376;186;190
Akmenė d. mun.;2003;38;387;195;192
Akmenė d. mun.;2003;39;439;218;221
Akmenė d. mun.;2003;40;434;221;213
Akmenė d. mun.;2003;41;433;207;226
Akmenė d. mun.;2003;42;471;235;236
Akmenė d. mun.;2003;43;466;211;255
Akmenė d. mun.;2003;44;439;208;231
Akmenė d. mun.;2003;45;409;201;208
Akmenė d. mun.;2003;46;418;210;208
Akmenė d. mun.;2003;47;389;200;189
Akmenė d. mun.;2003;48;399;171;228
Akmenė d. mun.;2003;49;314;159;155
Akmenė d. mun.;2003;50;350;177;173
Akmenė d. mun.;2003;51;381;162;219
Akmenė d. mun.;2003;52;352;149;203
Akmenė d. mun.;2003;53;340;157;183
Akmenė d. mun.;2003;54;361;167;194
Akmenė d. mun.;2003;55;294;142;152
Akmenė d. mun.;2003;56;283;124;159
Akmenė d. mun.;2003;57;310;122;188
Akmenė d. mun.;2003;58;264;113;151
Akmenė d. mun.;2003;59;331;145;186
Akmenė d. mun.;2003;60;383;159;224
Akmenė d. mun.;2003;61;327;138;189
Akmenė d. mun.;2003;62;350;132;218
Akmenė d. mun.;2003;63;293;119;174
Akmenė d. mun.;2003;64;277;123;154
Akmenė d. mun.;2003;65;298;115;183
Akmenė d. mun.;2003;66;341;146;195
Akmenė d. mun.;2003;67;331;134;197
Akmenė d. mun.;2003;68;317;115;202
Akmenė d. mun.;2003;69;299;105;194
Akmenė d. mun.;2003;70;288;97;191
Akmenė d. mun.;2003;71;271;111;160
Akmenė d. mun.;2003;72;247;89;158
Akmenė d. mun.;2003;73;228;69;159
Akmenė d. mun.;2003;74;271;104;167
Akmenė d. mun.;2003;75;218;71;147
Akmenė d. mun.;2003;76;182;52;130
Akmenė d. mun.;2003;77;210;69;141
Akmenė d. mun.;2003;78;156;41;115
Akmenė d. mun.;2003;79;160;42;118
Akmenė d. mun.;2003;80;131;51;80
Akmenė d. mun.;2003;81;127;28;99
Akmenė d. mun.;2003;82;95;29;66
Akmenė d. mun.;2003;83;81;18;63
Akmenė d. mun.;2003;84;46;14;32
Akmenė d. mun.;2003;85;293;75;218
Akmenė d. mun.;2004;-1;28951;13529;15422
Akmenė d. mun.;2004;0;252;135;117
Akmenė d. mun.;2004;1;254;142;112
Akmenė d. mun.;2004;2;259;134;125
Akmenė d. mun.;2004;3;308;169;139
Akmenė d. mun.;2004;4;325;162;163
Akmenė d. mun.;2004;5;346;188;158
Akmenė d. mun.;2004;6;363;186;177
Akmenė d. mun.;2004;7;370;212;158
Akmenė d. mun.;2004;8;391;212;179
Akmenė d. mun.;2004;9;387;207;180
Akmenė d. mun.;2004;10;495;228;267
Akmenė d. mun.;2004;11;533;274;259
Akmenė d. mun.;2004;12;522;288;234
Akmenė d. mun.;2004;13;487;253;234
Akmenė d. mun.;2004;14;500;244;256
Akmenė d. mun.;2004;15;442;238;204
Akmenė d. mun.;2004;16;525;249;276
Akmenė d. mun.;2004;17;531;282;249
Akmenė d. mun.;2004;18;504;239;265
Akmenė d. mun.;2004;19;504;251;253
Akmenė d. mun.;2004;20;433;226;207
Akmenė d. mun.;2004;21;354;192;162
Akmenė d. mun.;2004;22;315;175;140
Akmenė d. mun.;2004;23;318;185;133
Akmenė d. mun.;2004;24;301;154;147
Akmenė d. mun.;2004;25;316;162;154
Akmenė d. mun.;2004;26;309;146;163
Akmenė d. mun.;2004;27;260;133;127
Akmenė d. mun.;2004;28;279;135;144
Akmenė d. mun.;2004;29;324;164;160
Akmenė d. mun.;2004;30;333;153;180
Akmenė d. mun.;2004;31;364;199;165
Akmenė d. mun.;2004;32;386;179;207
Akmenė d. mun.;2004;33;391;183;208
Akmenė d. mun.;2004;34;380;191;189
Akmenė d. mun.;2004;35;411;198;213
Akmenė d. mun.;2004;36;394;204;190
Akmenė d. mun.;2004;37;370;176;194
Akmenė d. mun.;2004;38;365;178;187
Akmenė d. mun.;2004;39;379;189;190
Akmenė d. mun.;2004;40;435;215;220
Akmenė d. mun.;2004;41;422;215;207
Akmenė d. mun.;2004;42;421;200;221
Akmenė d. mun.;2004;43;464;231;233
Akmenė d. mun.;2004;44;456;205;251
Akmenė d. mun.;2004;45;430;204;226
Akmenė d. mun.;2004;46;400;198;202
Akmenė d. mun.;2004;47;409;205;204
Akmenė d. mun.;2004;48;387;196;191
Akmenė d. mun.;2004;49;388;164;224
Akmenė d. mun.;2004;50;306;154;152
Akmenė d. mun.;2004;51;344;174;170
Akmenė d. mun.;2004;52;371;156;215
Akmenė d. mun.;2004;53;350;149;201
Akmenė d. mun.;2004;54;336;153;183
Akmenė d. mun.;2004;55;357;164;193
Akmenė d. mun.;2004;56;289;138;151
Akmenė d. mun.;2004;57;276;118;158
Akmenė d. mun.;2004;58;303;118;185
Akmenė d. mun.;2004;59;257;108;149
Akmenė d. mun.;2004;60;327;141;186
Akmenė d. mun.;2004;61;371;155;216
Akmenė d. mun.;2004;62;324;134;190
Akmenė d. mun.;2004;63;350;129;221
Akmenė d. mun.;2004;64;294;116;178
Akmenė d. mun.;2004;65;274;119;155
Akmenė d. mun.;2004;66;290;108;182
Akmenė d. mun.;2004;67;332;138;194
Akmenė d. mun.;2004;68;320;124;196
Akmenė d. mun.;2004;69;302;106;196
Akmenė d. mun.;2004;70;297;104;193
Akmenė d. mun.;2004;71;271;88;183
Akmenė d. mun.;2004;72;263;105;158
Akmenė d. mun.;2004;73;235;86;149
Akmenė d. mun.;2004;74;211;63;148
Akmenė d. mun.;2004;75;263;101;162
Akmenė d. mun.;2004;76;214;67;147
Akmenė d. mun.;2004;77;169;46;123
Akmenė d. mun.;2004;78;192;61;131
Akmenė d. mun.;2004;79;147;36;111
Akmenė d. mun.;2004;80;153;42;111
Akmenė d. mun.;2004;81;124;48;76
Akmenė d. mun.;2004;82;120;26;94
Akmenė d. mun.;2004;83;90;25;65
Akmenė d. mun.;2004;84;72;15;57
Akmenė d. mun.;2004;85;265;66;199
Akmenė d. mun.;2005;-1;28239;13159;15080
Akmenė d. mun.;2005;0;248;114;134
Akmenė d. mun.;2005;1;247;134;113
Akmenė d. mun.;2005;2;252;141;111
Akmenė d. mun.;2005;3;258;134;124
Akmenė d. mun.;2005;4;303;168;135
Akmenė d. mun.;2005;5;317;158;159
Akmenė d. mun.;2005;6;341;186;155
Akmenė d. mun.;2005;7;356;184;172
Akmenė d. mun.;2005;8;367;209;158
Akmenė d. mun.;2005;9;389;210;179
Akmenė d. mun.;2005;10;383;205;178
Akmenė d. mun.;2005;11;489;224;265
Akmenė d. mun.;2005;12;525;269;256
Akmenė d. mun.;2005;13;515;285;230
Akmenė d. mun.;2005;14;479;247;232
Akmenė d. mun.;2005;15;488;238;250
Akmenė d. mun.;2005;16;435;233;202
Akmenė d. mun.;2005;17;513;241;272
Akmenė d. mun.;2005;18;511;270;241
Akmenė d. mun.;2005;19;490;233;257
Akmenė d. mun.;2005;20;485;242;243
Akmenė d. mun.;2005;21;412;219;193
Akmenė d. mun.;2005;22;337;186;151
Akmenė d. mun.;2005;23;298;171;127
Akmenė d. mun.;2005;24;304;177;127
Akmenė d. mun.;2005;25;272;140;132
Akmenė d. mun.;2005;26;295;155;140
Akmenė d. mun.;2005;27;282;132;150
Akmenė d. mun.;2005;28;245;124;121
Akmenė d. mun.;2005;29;267;124;143
Akmenė d. mun.;2005;30;304;151;153
Akmenė d. mun.;2005;31;322;145;177
Akmenė d. mun.;2005;32;342;184;158
Akmenė d. mun.;2005;33;358;163;195
Akmenė d. mun.;2005;34;378;180;198
Akmenė d. mun.;2005;35;369;187;182
Akmenė d. mun.;2005;36;400;196;204
Akmenė d. mun.;2005;37;383;195;188
Akmenė d. mun.;2005;38;359;168;191
Akmenė d. mun.;2005;39;359;174;185
Akmenė d. mun.;2005;40;366;185;181
Akmenė d. mun.;2005;41;431;214;217
Akmenė d. mun.;2005;42;410;209;201
Akmenė d. mun.;2005;43;413;195;218
Akmenė d. mun.;2005;44;453;227;226
Akmenė d. mun.;2005;45;448;203;245
Akmenė d. mun.;2005;46;419;192;227
Akmenė d. mun.;2005;47;386;190;196
Akmenė d. mun.;2005;48;395;194;201
Akmenė d. mun.;2005;49;380;191;189
Akmenė d. mun.;2005;50;375;156;219
Akmenė d. mun.;2005;51;305;156;149
Akmenė d. mun.;2005;52;330;168;162
Akmenė d. mun.;2005;53;361;153;208
Akmenė d. mun.;2005;54;335;142;193
Akmenė d. mun.;2005;55;332;149;183
Akmenė d. mun.;2005;56;347;158;189
Akmenė d. mun.;2005;57;279;129;150
Akmenė d. mun.;2005;58;264;110;154
Akmenė d. mun.;2005;59;290;109;181
Akmenė d. mun.;2005;60;246;101;145
Akmenė d. mun.;2005;61;320;134;186
Akmenė d. mun.;2005;62;360;149;211
Akmenė d. mun.;2005;63;318;130;188
Akmenė d. mun.;2005;64;343;128;215
Akmenė d. mun.;2005;65;282;110;172
Akmenė d. mun.;2005;66;267;116;151
Akmenė d. mun.;2005;67;288;104;184
Akmenė d. mun.;2005;68;332;139;193
Akmenė d. mun.;2005;69;317;123;194
Akmenė d. mun.;2005;70;291;97;194
Akmenė d. mun.;2005;71;284;99;185
Akmenė d. mun.;2005;72;264;83;181
Akmenė d. mun.;2005;73;251;99;152
Akmenė d. mun.;2005;74;224;80;144
Akmenė d. mun.;2005;75;205;63;142
Akmenė d. mun.;2005;76;236;88;148
Akmenė d. mun.;2005;77;204;65;139
Akmenė d. mun.;2005;78;163;46;117
Akmenė d. mun.;2005;79;187;60;127
Akmenė d. mun.;2005;80;141;33;108
Akmenė d. mun.;2005;81;143;38;105
Akmenė d. mun.;2005;82;106;42;64
Akmenė d. mun.;2005;83;109;21;88
Akmenė d. mun.;2005;84;80;20;60
Akmenė d. mun.;2005;85;282;65;217
Akmenė d. mun.;2006;-1;27328;12687;14641
Akmenė d. mun.;2006;0;226;108;118
Akmenė d. mun.;2006;1;243;110;133
Akmenė d. mun.;2006;2;248;132;116
Akmenė d. mun.;2006;3;251;141;110
Akmenė d. mun.;2006;4;252;131;121
Akmenė d. mun.;2006;5;302;169;133
Akmenė d. mun.;2006;6;305;150;155
Akmenė d. mun.;2006;7;330;177;153
Akmenė d. mun.;2006;8;349;182;167
Akmenė d. mun.;2006;9;366;212;154
Akmenė d. mun.;2006;10;386;210;176
Akmenė d. mun.;2006;11;381;203;178
Akmenė d. mun.;2006;12;484;227;257
Akmenė d. mun.;2006;13;505;256;249
Akmenė d. mun.;2006;14;507;281;226
Akmenė d. mun.;2006;15;460;238;222
Akmenė d. mun.;2006;16;469;229;240
Akmenė d. mun.;2006;17;425;223;202
Akmenė d. mun.;2006;18;489;232;257
Akmenė d. mun.;2006;19;484;252;232
Akmenė d. mun.;2006;20;454;215;239
Akmenė d. mun.;2006;21;456;233;223
Akmenė d. mun.;2006;22;393;211;182
Akmenė d. mun.;2006;23;304;168;136
Akmenė d. mun.;2006;24;276;167;109
Akmenė d. mun.;2006;25;273;162;111
Akmenė d. mun.;2006;26;262;139;123
Akmenė d. mun.;2006;27;273;147;126
Akmenė d. mun.;2006;28;260;118;142
Akmenė d. mun.;2006;29;234;117;117
Akmenė d. mun.;2006;30;254;120;134
Akmenė d. mun.;2006;31;289;145;144
Akmenė d. mun.;2006;32;313;139;174
Akmenė d. mun.;2006;33;328;173;155
Akmenė d. mun.;2006;34;348;161;187
Akmenė d. mun.;2006;35;358;170;188
Akmenė d. mun.;2006;36;350;176;174
Akmenė d. mun.;2006;37;387;188;199
Akmenė d. mun.;2006;38;366;182;184
Akmenė d. mun.;2006;39;352;165;187
Akmenė d. mun.;2006;40;350;167;183
Akmenė d. mun.;2006;41;349;171;178
Akmenė d. mun.;2006;42;418;207;211
Akmenė d. mun.;2006;43;392;197;195
Akmenė d. mun.;2006;44;397;183;214
Akmenė d. mun.;2006;45;437;213;224
Akmenė d. mun.;2006;46;423;186;237
Akmenė d. mun.;2006;47;414;186;228
Akmenė d. mun.;2006;48;373;180;193
Akmenė d. mun.;2006;49;388;190;198
Akmenė d. mun.;2006;50;369;184;185
Akmenė d. mun.;2006;51;365;151;214
Akmenė d. mun.;2006;52;293;147;146
Akmenė d. mun.;2006;53;319;164;155
Akmenė d. mun.;2006;54;347;145;202
Akmenė d. mun.;2006;55;324;139;185
Akmenė d. mun.;2006;56;324;143;181
Akmenė d. mun.;2006;57;341;154;187
Akmenė d. mun.;2006;58;273;124;149
Akmenė d. mun.;2006;59;258;107;151
Akmenė d. mun.;2006;60;286;107;179
Akmenė d. mun.;2006;61;241;98;143
Akmenė d. mun.;2006;62;305;125;180
Akmenė d. mun.;2006;63;355;144;211
Akmenė d. mun.;2006;64;311;123;188
Akmenė d. mun.;2006;65;334;122;212
Akmenė d. mun.;2006;66;273;103;170
Akmenė d. mun.;2006;67;255;110;145
Akmenė d. mun.;2006;68;273;97;176
Akmenė d. mun.;2006;69;323;134;189
Akmenė d. mun.;2006;70;308;118;190
Akmenė d. mun.;2006;71;281;94;187
Akmenė d. mun.;2006;72;263;94;169
Akmenė d. mun.;2006;73;255;80;175
Akmenė d. mun.;2006;74;239;90;149
Akmenė d. mun.;2006;75;208;73;135
Akmenė d. mun.;2006;76;186;52;134
Akmenė d. mun.;2006;77;223;82;141
Akmenė d. mun.;2006;78;194;61;133
Akmenė d. mun.;2006;79;154;42;112
Akmenė d. mun.;2006;80;174;57;117
Akmenė d. mun.;2006;81;124;31;93
Akmenė d. mun.;2006;82;132;34;98
Akmenė d. mun.;2006;83;93;34;59
Akmenė d. mun.;2006;84;95;17;78
Akmenė d. mun.;2006;85;297;68;229
Akmenė d. mun.;2007;-1;26665;12313;14352
Akmenė d. mun.;2007;0;221;105;116
Akmenė d. mun.;2007;1;219;104;115
Akmenė d. mun.;2007;2;248;114;134
Akmenė d. mun.;2007;3;240;125;115
Akmenė d. mun.;2007;4;249;139;110
Akmenė d. mun.;2007;5;249;129;120
Akmenė d. mun.;2007;6;303;167;136
Akmenė d. mun.;2007;7;300;147;153
Akmenė d. mun.;2007;8;327;174;153
Akmenė d. mun.;2007;9;340;176;164
Akmenė d. mun.;2007;10;364;210;154
Akmenė d. mun.;2007;11;374;204;170
Akmenė d. mun.;2007;12;375;201;174
Akmenė d. mun.;2007;13;482;223;259
Akmenė d. mun.;2007;14;500;254;246
Akmenė d. mun.;2007;15;503;280;223
Akmenė d. mun.;2007;16;456;236;220
Akmenė d. mun.;2007;17;465;227;238
Akmenė d. mun.;2007;18;413;219;194
Akmenė d. mun.;2007;19;474;226;248
Akmenė d. mun.;2007;20;462;238;224
Akmenė d. mun.;2007;21;432;205;227
Akmenė d. mun.;2007;22;429;225;204
Akmenė d. mun.;2007;23;370;200;170
Akmenė d. mun.;2007;24;284;155;129
Akmenė d. mun.;2007;25;251;150;101
Akmenė d. mun.;2007;26;253;146;107
Akmenė d. mun.;2007;27;248;131;117
Akmenė d. mun.;2007;28;266;143;123
Akmenė d. mun.;2007;29;255;120;135
Akmenė d. mun.;2007;30;217;111;106
Akmenė d. mun.;2007;31;249;119;130
Akmenė d. mun.;2007;32;290;144;146
Akmenė d. mun.;2007;33;293;129;164
Akmenė d. mun.;2007;34;320;168;152
Akmenė d. mun.;2007;35;331;155;176
Akmenė d. mun.;2007;36;352;170;182
Akmenė d. mun.;2007;37;339;170;169
Akmenė d. mun.;2007;38;382;185;197
Akmenė d. mun.;2007;39;356;176;180
Akmenė d. mun.;2007;40;346;160;186
Akmenė d. mun.;2007;41;342;163;179
Akmenė d. mun.;2007;42;343;164;179
Akmenė d. mun.;2007;43;414;201;213
Akmenė d. mun.;2007;44;379;189;190
Akmenė d. mun.;2007;45;384;178;206
Akmenė d. mun.;2007;46;427;208;219
Akmenė d. mun.;2007;47;408;177;231
Akmenė d. mun.;2007;48;400;180;220
Akmenė d. mun.;2007;49;371;178;193
Akmenė d. mun.;2007;50;376;187;189
Akmenė d. mun.;2007;51;358;174;184
Akmenė d. mun.;2007;52;359;148;211
Akmenė d. mun.;2007;53;288;143;145
Akmenė d. mun.;2007;54;311;155;156
Akmenė d. mun.;2007;55;336;139;197
Akmenė d. mun.;2007;56;314;130;184
Akmenė d. mun.;2007;57;323;142;181
Akmenė d. mun.;2007;58;341;152;189
Akmenė d. mun.;2007;59;260;113;147
Akmenė d. mun.;2007;60;252;98;154
Akmenė d. mun.;2007;61;276;101;175
Akmenė d. mun.;2007;62;237;95;142
Akmenė d. mun.;2007;63;295;117;178
Akmenė d. mun.;2007;64;349;140;209
Akmenė d. mun.;2007;65;305;120;185
Akmenė d. mun.;2007;66;330;117;213
Akmenė d. mun.;2007;67;268;102;166
Akmenė d. mun.;2007;68;242;101;141
Akmenė d. mun.;2007;69;265;94;171
Akmenė d. mun.;2007;70;304;123;181
Akmenė d. mun.;2007;71;301;112;189
Akmenė d. mun.;2007;72;267;86;181
Akmenė d. mun.;2007;73;252;87;165
Akmenė d. mun.;2007;74;245;75;170
Akmenė d. mun.;2007;75;229;84;145
Akmenė d. mun.;2007;76;194;63;131
Akmenė d. mun.;2007;77;173;46;127
Akmenė d. mun.;2007;78;210;78;132
Akmenė d. mun.;2007;79;178;57;121
Akmenė d. mun.;2007;80;141;38;103
Akmenė d. mun.;2007;81;153;46;107
Akmenė d. mun.;2007;82;115;30;85
Akmenė d. mun.;2007;83;115;26;89
Akmenė d. mun.;2007;84;82;30;52
Akmenė d. mun.;2007;85;326;66;260
Akmenė d. mun.;2008;-1;25967;11911;14056
Akmenė d. mun.;2008;0;219;98;121
Akmenė d. mun.;2008;1;210;98;112
Akmenė d. mun.;2008;2;219;106;113
Akmenė d. mun.;2008;3;238;109;129
Akmenė d. mun.;2008;4;237;125;112
Akmenė d. mun.;2008;5;241;131;110
Akmenė d. mun.;2008;6;243;127;116
Akmenė d. mun.;2008;7;301;165;136
Akmenė d. mun.;2008;8;297;146;151
Akmenė d. mun.;2008;9;318;167;151
Akmenė d. mun.;2008;10;339;175;164
Akmenė d. mun.;2008;11;360;204;156
Akmenė d. mun.;2008;12;371;201;170
Akmenė d. mun.;2008;13;370;202;168
Akmenė d. mun.;2008;14;477;220;257
Akmenė d. mun.;2008;15;492;252;240
Akmenė d. mun.;2008;16;499;275;224
Akmenė d. mun.;2008;17;449;232;217
Akmenė d. mun.;2008;18;458;222;236
Akmenė d. mun.;2008;19;407;212;195
Akmenė d. mun.;2008;20;455;216;239
Akmenė d. mun.;2008;21;447;230;217
Akmenė d. mun.;2008;22;410;198;212
Akmenė d. mun.;2008;23;412;212;200
Akmenė d. mun.;2008;24;347;193;154
Akmenė d. mun.;2008;25;261;143;118
Akmenė d. mun.;2008;26;225;139;86
Akmenė d. mun.;2008;27;232;134;98
Akmenė d. mun.;2008;28;241;127;114
Akmenė d. mun.;2008;29;248;128;120
Akmenė d. mun.;2008;30;246;113;133
Akmenė d. mun.;2008;31;204;107;97
Akmenė d. mun.;2008;32;239;116;123
Akmenė d. mun.;2008;33;288;146;142
Akmenė d. mun.;2008;34;291;125;166
Akmenė d. mun.;2008;35;313;163;150
Akmenė d. mun.;2008;36;326;150;176
Akmenė d. mun.;2008;37;337;160;177
Akmenė d. mun.;2008;38;328;164;164
Akmenė d. mun.;2008;39;374;180;194
Akmenė d. mun.;2008;40;348;169;179
Akmenė d. mun.;2008;41;335;155;180
Akmenė d. mun.;2008;42;329;156;173
Akmenė d. mun.;2008;43;337;160;177
Akmenė d. mun.;2008;44;400;193;207
Akmenė d. mun.;2008;45;369;182;187
Akmenė d. mun.;2008;46;379;176;203
Akmenė d. mun.;2008;47;414;199;215
Akmenė d. mun.;2008;48;404;176;228
Akmenė d. mun.;2008;49;400;178;222
Akmenė d. mun.;2008;50;365;174;191
Akmenė d. mun.;2008;51;369;182;187
Akmenė d. mun.;2008;52;341;166;175
Akmenė d. mun.;2008;53;350;142;208
Akmenė d. mun.;2008;54;283;135;148
Akmenė d. mun.;2008;55;301;148;153
Akmenė d. mun.;2008;56;324;133;191
Akmenė d. mun.;2008;57;303;124;179
Akmenė d. mun.;2008;58;316;136;180
Akmenė d. mun.;2008;59;322;138;184
Akmenė d. mun.;2008;60;250;105;145
Akmenė d. mun.;2008;61;252;95;157
Akmenė d. mun.;2008;62;267;95;172
Akmenė d. mun.;2008;63;224;84;140
Akmenė d. mun.;2008;64;288;114;174
Akmenė d. mun.;2008;65;341;136;205
Akmenė d. mun.;2008;66;300;116;184
Akmenė d. mun.;2008;67;320;112;208
Akmenė d. mun.;2008;68;262;98;164
Akmenė d. mun.;2008;69;238;100;138
Akmenė d. mun.;2008;70;258;92;166
Akmenė d. mun.;2008;71;289;113;176
Akmenė d. mun.;2008;72;291;104;187
Akmenė d. mun.;2008;73;257;85;172
Akmenė d. mun.;2008;74;241;80;161
Akmenė d. mun.;2008;75;236;70;166
Akmenė d. mun.;2008;76;215;77;138
Akmenė d. mun.;2008;77;181;54;127
Akmenė d. mun.;2008;78;157;42;115
Akmenė d. mun.;2008;79;194;66;128
Akmenė d. mun.;2008;80;162;49;113
Akmenė d. mun.;2008;81;117;28;89
Akmenė d. mun.;2008;82;131;39;92
Akmenė d. mun.;2008;83;97;24;73
Akmenė d. mun.;2008;84;98;23;75
Akmenė d. mun.;2008;85;343;77;266
Akmenė d. mun.;2009;-1;25310;11630;13680
Akmenė d. mun.;2009;0;225;121;104
Akmenė d. mun.;2009;1;214;95;119
Akmenė d. mun.;2009;2;207;98;109
Akmenė d. mun.;2009;3;213;102;111
Akmenė d. mun.;2009;4;234;108;126
Akmenė d. mun.;2009;5;231;123;108
Akmenė d. mun.;2009;6;239;131;108
Akmenė d. mun.;2009;7;238;126;112
Akmenė d. mun.;2009;8;302;165;137
Akmenė d. mun.;2009;9;294;141;153
Akmenė d. mun.;2009;10;314;167;147
Akmenė d. mun.;2009;11;327;168;159
Akmenė d. mun.;2009;12;351;201;150
Akmenė d. mun.;2009;13;363;198;165
Akmenė d. mun.;2009;14;371;204;167
Akmenė d. mun.;2009;15;477;219;258
Akmenė d. mun.;2009;16;487;248;239
Akmenė d. mun.;2009;17;495;271;224
Akmenė d. mun.;2009;18;433;224;209
Akmenė d. mun.;2009;19;451;218;233
Akmenė d. mun.;2009;20;393;208;185
Akmenė d. mun.;2009;21;437;207;230
Akmenė d. mun.;2009;22;426;220;206
Akmenė d. mun.;2009;23;393;195;198
Akmenė d. mun.;2009;24;387;202;185
Akmenė d. mun.;2009;25;333;186;147
Akmenė d. mun.;2009;26;236;132;104
Akmenė d. mun.;2009;27;197;120;77
Akmenė d. mun.;2009;28;213;125;88
Akmenė d. mun.;2009;29;224;120;104
Akmenė d. mun.;2009;30;235;120;115
Akmenė d. mun.;2009;31;235;107;128
Akmenė d. mun.;2009;32;190;100;90
Akmenė d. mun.;2009;33;225;109;116
Akmenė d. mun.;2009;34;269;135;134
Akmenė d. mun.;2009;35;282;121;161
Akmenė d. mun.;2009;36;304;157;147
Akmenė d. mun.;2009;37;317;145;172
Akmenė d. mun.;2009;38;325;158;167
Akmenė d. mun.;2009;39;321;160;161
Akmenė d. mun.;2009;40;366;177;189
Akmenė d. mun.;2009;41;343;168;175
Akmenė d. mun.;2009;42;331;151;180
Akmenė d. mun.;2009;43;323;157;166
Akmenė d. mun.;2009;44;327;159;168
Akmenė d. mun.;2009;45;386;186;200
Akmenė d. mun.;2009;46;361;176;185
Akmenė d. mun.;2009;47;371;171;200
Akmenė d. mun.;2009;48;405;193;212
Akmenė d. mun.;2009;49;391;169;222
Akmenė d. mun.;2009;50;393;177;216
Akmenė d. mun.;2009;51;360;174;186
Akmenė d. mun.;2009;52;362;176;186
Akmenė d. mun.;2009;53;333;162;171
Akmenė d. mun.;2009;54;346;138;208
Akmenė d. mun.;2009;55;270;129;141
Akmenė d. mun.;2009;56;292;143;149
Akmenė d. mun.;2009;57;322;132;190
Akmenė d. mun.;2009;58;298;121;177
Akmenė d. mun.;2009;59;312;135;177
Akmenė d. mun.;2009;60;316;138;178
Akmenė d. mun.;2009;61;246;101;145
Akmenė d. mun.;2009;62;245;91;154
Akmenė d. mun.;2009;63;260;92;168
Akmenė d. mun.;2009;64;216;81;135
Akmenė d. mun.;2009;65;286;113;173
Akmenė d. mun.;2009;66;332;130;202
Akmenė d. mun.;2009;67;294;110;184
Akmenė d. mun.;2009;68;310;108;202
Akmenė d. mun.;2009;69;257;95;162
Akmenė d. mun.;2009;70;230;93;137
Akmenė d. mun.;2009;71;247;87;160
Akmenė d. mun.;2009;72;282;110;172
Akmenė d. mun.;2009;73;282;100;182
Akmenė d. mun.;2009;74;249;78;171
Akmenė d. mun.;2009;75;230;71;159
Akmenė d. mun.;2009;76;224;66;158
Akmenė d. mun.;2009;77;207;73;134
Akmenė d. mun.;2009;78;171;53;118
Akmenė d. mun.;2009;79;145;36;109
Akmenė d. mun.;2009;80;176;58;118
Akmenė d. mun.;2009;81;146;42;104
Akmenė d. mun.;2009;82;110;26;84
Akmenė d. mun.;2009;83;116;34;82
Akmenė d. mun.;2009;84;90;21;69
Akmenė d. mun.;2009;85;343;74;269
Akmenė d. mun.;2010;-1;24501;11262;13239
Akmenė d. mun.;2010;0;217;115;102
Akmenė d. mun.;2010;1;222;120;102
Akmenė d. mun.;2010;2;204;89;115
Akmenė d. mun.;2010;3;197;91;106
Akmenė d. mun.;2010;4;205;97;108
Akmenė d. mun.;2010;5;229;109;120
Akmenė d. mun.;2010;6;232;125;107
Akmenė d. mun.;2010;7;237;130;107
Akmenė d. mun.;2010;8;234;124;110
Akmenė d. mun.;2010;9;290;163;127
Akmenė d. mun.;2010;10;287;139;148
Akmenė d. mun.;2010;11;312;166;146
Akmenė d. mun.;2010;12;322;162;160
Akmenė d. mun.;2010;13;344;197;147
Akmenė d. mun.;2010;14;353;190;163
Akmenė d. mun.;2010;15;363;199;164
Akmenė d. mun.;2010;16;464;215;249
Akmenė d. mun.;2010;17;483;247;236
Akmenė d. mun.;2010;18;485;268;217
Akmenė d. mun.;2010;19;411;213;198
Akmenė d. mun.;2010;20;426;201;225
Akmenė d. mun.;2010;21;367;202;165
Akmenė d. mun.;2010;22;413;197;216
Akmenė d. mun.;2010;23;400;210;190
Akmenė d. mun.;2010;24;368;184;184
Akmenė d. mun.;2010;25;362;192;170
Akmenė d. mun.;2010;26;295;167;128
Akmenė d. mun.;2010;27;214;127;87
Akmenė d. mun.;2010;28;183;114;69
Akmenė d. mun.;2010;29;185;109;76
Akmenė d. mun.;2010;30;216;116;100
Akmenė d. mun.;2010;31;218;108;110
Akmenė d. mun.;2010;32;219;100;119
Akmenė d. mun.;2010;33;181;90;91
Akmenė d. mun.;2010;34;218;106;112
Akmenė d. mun.;2010;35;251;122;129
Akmenė d. mun.;2010;36;268;113;155
Akmenė d. mun.;2010;37;298;155;143
Akmenė d. mun.;2010;38;299;134;165
Akmenė d. mun.;2010;39;319;154;165
Akmenė d. mun.;2010;40;313;153;160
Akmenė d. mun.;2010;41;347;165;182
Akmenė d. mun.;2010;42;333;162;171
Akmenė d. mun.;2010;43;327;150;177
Akmenė d. mun.;2010;44;318;151;167
Akmenė d. mun.;2010;45;318;152;166
Akmenė d. mun.;2010;46;377;185;192
Akmenė d. mun.;2010;47;354;174;180
Akmenė d. mun.;2010;48;361;167;194
Akmenė d. mun.;2010;49;395;188;207
Akmenė d. mun.;2010;50;375;162;213
Akmenė d. mun.;2010;51;384;173;211
Akmenė d. mun.;2010;52;352;172;180
Akmenė d. mun.;2010;53;351;168;183
Akmenė d. mun.;2010;54;322;155;167
Akmenė d. mun.;2010;55;333;132;201
Akmenė d. mun.;2010;56;267;125;142
Akmenė d. mun.;2010;57;280;136;144
Akmenė d. mun.;2010;58;313;128;185
Akmenė d. mun.;2010;59;288;115;173
Akmenė d. mun.;2010;60;300;127;173
Akmenė d. mun.;2010;61;311;136;175
Akmenė d. mun.;2010;62;241;98;143
Akmenė d. mun.;2010;63;237;86;151
Akmenė d. mun.;2010;64;253;91;162
Akmenė d. mun.;2010;65;209;75;134
Akmenė d. mun.;2010;66;281;114;167
Akmenė d. mun.;2010;67;325;124;201
Akmenė d. mun.;2010;68;285;106;179
Akmenė d. mun.;2010;69;297;104;193
Akmenė d. mun.;2010;70;244;90;154
Akmenė d. mun.;2010;71;219;87;132
Akmenė d. mun.;2010;72;235;83;152
Akmenė d. mun.;2010;73;267;104;163
Akmenė d. mun.;2010;74;269;93;176
Akmenė d. mun.;2010;75;236;73;163
Akmenė d. mun.;2010;76;216;61;155
Akmenė d. mun.;2010;77;215;62;153
Akmenė d. mun.;2010;78;190;67;123
Akmenė d. mun.;2010;79;169;50;119
Akmenė d. mun.;2010;80;140;36;104
Akmenė d. mun.;2010;81;163;51;112
Akmenė d. mun.;2010;82;129;33;96
Akmenė d. mun.;2010;83;104;26;78
Akmenė d. mun.;2010;84;100;29;71
Akmenė d. mun.;2010;85;367;83;284
Akmenė d. mun.;2011;-1;23460;10773;12687
Akmenė d. mun.;2011;0;186;96;90
Akmenė d. mun.;2011;1;195;109;86
Akmenė d. mun.;2011;2;183;102;81
Akmenė d. mun.;2011;3;181;84;97
Akmenė d. mun.;2011;4;172;76;96
Akmenė d. mun.;2011;5;182;92;90
Akmenė d. mun.;2011;6;206;96;110
Akmenė d. mun.;2011;7;211;111;100
Akmenė d. mun.;2011;8;220;120;100
Akmenė d. mun.;2011;9;217;118;99
Akmenė d. mun.;2011;10;265;149;116
Akmenė d. mun.;2011;11;282;147;135
Akmenė d. mun.;2011;12;309;165;144
Akmenė d. mun.;2011;13;320;160;160
Akmenė d. mun.;2011;14;333;181;152
Akmenė d. mun.;2011;15;337;184;153
Akmenė d. mun.;2011;16;361;191;170
Akmenė d. mun.;2011;17;445;212;233
Akmenė d. mun.;2011;18;461;243;218
Akmenė d. mun.;2011;19;396;235;161
Akmenė d. mun.;2011;20;313;157;156
Akmenė d. mun.;2011;21;301;139;162
Akmenė d. mun.;2011;22;295;179;116
Akmenė d. mun.;2011;23;300;146;154
Akmenė d. mun.;2011;24;264;158;106
Akmenė d. mun.;2011;25;235;119;116
Akmenė d. mun.;2011;26;239;124;115
Akmenė d. mun.;2011;27;203;113;90
Akmenė d. mun.;2011;28;178;96;82
Akmenė d. mun.;2011;29;180;94;86
Akmenė d. mun.;2011;30;161;82;79
Akmenė d. mun.;2011;31;206;104;102
Akmenė d. mun.;2011;32;197;90;107
Akmenė d. mun.;2011;33;237;113;124
Akmenė d. mun.;2011;34;209;98;111
Akmenė d. mun.;2011;35;233;114;119
Akmenė d. mun.;2011;36;259;121;138
Akmenė d. mun.;2011;37;290;123;167
Akmenė d. mun.;2011;38;304;148;156
Akmenė d. mun.;2011;39;323;141;182
Akmenė d. mun.;2011;40;324;152;172
Akmenė d. mun.;2011;41;313;157;156
Akmenė d. mun.;2011;42;367;180;187
Akmenė d. mun.;2011;43;346;169;177
Akmenė d. mun.;2011;44;342;157;185
Akmenė d. mun.;2011;45;331;165;166
Akmenė d. mun.;2011;46;350;179;171
Akmenė d. mun.;2011;47;376;180;196
Akmenė d. mun.;2011;48;371;178;193
Akmenė d. mun.;2011;49;387;181;206
Akmenė d. mun.;2011;50;400;193;207
Akmenė d. mun.;2011;51;380;169;211
Akmenė d. mun.;2011;52;378;173;205
Akmenė d. mun.;2011;53;369;177;192
Akmenė d. mun.;2011;54;353;170;183
Akmenė d. mun.;2011;55;317;151;166
Akmenė d. mun.;2011;56;342;144;198
Akmenė d. mun.;2011;57;286;139;147
Akmenė d. mun.;2011;58;298;150;148
Akmenė d. mun.;2011;59;313;138;175
Akmenė d. mun.;2011;60;300;123;177
Akmenė d. mun.;2011;61;289;124;165
Akmenė d. mun.;2011;62;310;132;178
Akmenė d. mun.;2011;63;238;97;141
Akmenė d. mun.;2011;64;247;91;156
Akmenė d. mun.;2011;65;260;87;173
Akmenė d. mun.;2011;66;210;82;128
Akmenė d. mun.;2011;67;281;110;171
Akmenė d. mun.;2011;68;325;126;199
Akmenė d. mun.;2011;69;277;105;172
Akmenė d. mun.;2011;70;291;101;190
Akmenė d. mun.;2011;71;235;85;150
Akmenė d. mun.;2011;72;221;86;135
Akmenė d. mun.;2011;73;245;87;158
Akmenė d. mun.;2011;74;256;96;160
Akmenė d. mun.;2011;75;257;84;173
Akmenė d. mun.;2011;76;228;70;158
Akmenė d. mun.;2011;77;214;64;150
Akmenė d. mun.;2011;78;200;54;146
Akmenė d. mun.;2011;79;191;64;127
Akmenė d. mun.;2011;80;154;45;109
Akmenė d. mun.;2011;81;138;35;103
Akmenė d. mun.;2011;82;156;48;108
Akmenė d. mun.;2011;83;115;33;82
Akmenė d. mun.;2011;84;91;21;70
Akmenė d. mun.;2011;85;399;91;308
Akmenė d. mun.;2012;-1;22796;10471;12325
Akmenė d. mun.;2012;0;230;121;109
Akmenė d. mun.;2012;1;179;90;89
Akmenė d. mun.;2012;2;184;105;79
Akmenė d. mun.;2012;3;174;93;81
Akmenė d. mun.;2012;4;186;90;96
Akmenė d. mun.;2012;5;173;73;100
Akmenė d. mun.;2012;6;180;90;90
Akmenė d. mun.;2012;7;206;93;113
Akmenė d. mun.;2012;8;211;111;100
Akmenė d. mun.;2012;9;218;120;98
Akmenė d. mun.;2012;10;212;116;96
Akmenė d. mun.;2012;11;262;148;114
Akmenė d. mun.;2012;12;278;147;131
Akmenė d. mun.;2012;13;308;167;141
Akmenė d. mun.;2012;14;319;159;160
Akmenė d. mun.;2012;15;326;178;148
Akmenė d. mun.;2012;16;332;183;149
Akmenė d. mun.;2012;17;357;188;169
Akmenė d. mun.;2012;18;434;206;228
Akmenė d. mun.;2012;19;432;224;208
Akmenė d. mun.;2012;20;380;231;149
Akmenė d. mun.;2012;21;278;146;132
Akmenė d. mun.;2012;22;268;124;144
Akmenė d. mun.;2012;23;259;163;96
Akmenė d. mun.;2012;24;272;135;137
Akmenė d. mun.;2012;25;250;149;101
Akmenė d. mun.;2012;26;198;107;91
Akmenė d. mun.;2012;27;219;117;102
Akmenė d. mun.;2012;28;185;101;84
Akmenė d. mun.;2012;29;152;87;65
Akmenė d. mun.;2012;30;172;90;82
Akmenė d. mun.;2012;31;152;78;74
Akmenė d. mun.;2012;32;194;99;95
Akmenė d. mun.;2012;33;191;82;109
Akmenė d. mun.;2012;34;224;105;119
Akmenė d. mun.;2012;35;194;96;98
Akmenė d. mun.;2012;36;224;106;118
Akmenė d. mun.;2012;37;251;117;134
Akmenė d. mun.;2012;38;284;119;165
Akmenė d. mun.;2012;39;296;144;152
Akmenė d. mun.;2012;40;311;134;177
Akmenė d. mun.;2012;41;319;151;168
Akmenė d. mun.;2012;42;300;149;151
Akmenė d. mun.;2012;43;360;179;181
Akmenė d. mun.;2012;44;339;165;174
Akmenė d. mun.;2012;45;333;153;180
Akmenė d. mun.;2012;46;323;160;163
Akmenė d. mun.;2012;47;345;178;167
Akmenė d. mun.;2012;48;366;173;193
Akmenė d. mun.;2012;49;367;173;194
Akmenė d. mun.;2012;50;381;178;203
Akmenė d. mun.;2012;51;387;186;201
Akmenė d. mun.;2012;52;372;165;207
Akmenė d. mun.;2012;53;369;168;201
Akmenė d. mun.;2012;54;365;173;192
Akmenė d. mun.;2012;55;348;166;182
Akmenė d. mun.;2012;56;311;150;161
Akmenė d. mun.;2012;57;340;144;196
Akmenė d. mun.;2012;58;275;132;143
Akmenė d. mun.;2012;59;289;144;145
Akmenė d. mun.;2012;60;311;135;176
Akmenė d. mun.;2012;61;293;120;173
Akmenė d. mun.;2012;62;283;120;163
Akmenė d. mun.;2012;63;296;119;177
Akmenė d. mun.;2012;64;229;90;139
Akmenė d. mun.;2012;65;244;89;155
Akmenė d. mun.;2012;66;249;83;166
Akmenė d. mun.;2012;67;203;77;126
Akmenė d. mun.;2012;68;276;109;167
Akmenė d. mun.;2012;69;313;119;194
Akmenė d. mun.;2012;70;273;102;171
Akmenė d. mun.;2012;71;284;101;183
Akmenė d. mun.;2012;72;227;80;147
Akmenė d. mun.;2012;73;209;82;127
Akmenė d. mun.;2012;74;238;84;154
Akmenė d. mun.;2012;75;253;94;159
Akmenė d. mun.;2012;76;246;80;166
Akmenė d. mun.;2012;77;213;63;150
Akmenė d. mun.;2012;78;200;59;141
Akmenė d. mun.;2012;79;193;52;141
Akmenė d. mun.;2012;80;177;56;121
Akmenė d. mun.;2012;81;146;43;103
Akmenė d. mun.;2012;82;131;30;101
Akmenė d. mun.;2012;83;142;41;101
Akmenė d. mun.;2012;84;96;28;68
Akmenė d. mun.;2012;85;427;96;331
Akmenė d. mun.;2013;-1;22210;10220;11990
Akmenė d. mun.;2013;0;195;114;81
Akmenė d. mun.;2013;1;231;124;107
Akmenė d. mun.;2013;2;175;88;87
Akmenė d. mun.;2013;3;171;99;72
Akmenė d. mun.;2013;4;173;93;80
Akmenė d. mun.;2013;5;177;92;85
Akmenė d. mun.;2013;6;167;71;96
Akmenė d. mun.;2013;7;177;91;86
Akmenė d. mun.;2013;8;203;91;112
Akmenė d. mun.;2013;9;201;104;97
Akmenė d. mun.;2013;10;219;119;100
Akmenė d. mun.;2013;11;210;117;93
Akmenė d. mun.;2013;12;253;143;110
Akmenė d. mun.;2013;13;277;148;129
Akmenė d. mun.;2013;14;311;170;141
Akmenė d. mun.;2013;15;314;154;160
Akmenė d. mun.;2013;16;323;175;148
Akmenė d. mun.;2013;17;327;180;147
Akmenė d. mun.;2013;18;353;186;167
Akmenė d. mun.;2013;19;403;192;211
Akmenė d. mun.;2013;20;416;222;194
Akmenė d. mun.;2013;21;366;226;140
Akmenė d. mun.;2013;22;260;142;118
Akmenė d. mun.;2013;23;247;120;127
Akmenė d. mun.;2013;24;245;158;87
Akmenė d. mun.;2013;25;255;128;127
Akmenė d. mun.;2013;26;216;138;78
Akmenė d. mun.;2013;27;177;92;85
Akmenė d. mun.;2013;28;195;103;92
Akmenė d. mun.;2013;29;176;100;76
Akmenė d. mun.;2013;30;144;82;62
Akmenė d. mun.;2013;31;153;78;75
Akmenė d. mun.;2013;32;143;75;68
Akmenė d. mun.;2013;33;181;88;93
Akmenė d. mun.;2013;34;186;80;106
Akmenė d. mun.;2013;35;218;108;110
Akmenė d. mun.;2013;36;188;96;92
Akmenė d. mun.;2013;37;215;96;119
Akmenė d. mun.;2013;38;248;115;133
Akmenė d. mun.;2013;39;276;108;168
Akmenė d. mun.;2013;40;291;143;148
Akmenė d. mun.;2013;41;308;132;176
Akmenė d. mun.;2013;42;309;148;161
Akmenė d. mun.;2013;43;296;147;149
Akmenė d. mun.;2013;44;355;175;180
Akmenė d. mun.;2013;45;332;160;172
Akmenė d. mun.;2013;46;328;150;178
Akmenė d. mun.;2013;47;323;159;164
Akmenė d. mun.;2013;48;341;176;165
Akmenė d. mun.;2013;49;364;173;191
Akmenė d. mun.;2013;50;366;173;193
Akmenė d. mun.;2013;51;382;178;204
Akmenė d. mun.;2013;52;384;181;203
Akmenė d. mun.;2013;53;367;160;207
Akmenė d. mun.;2013;54;362;163;199
Akmenė d. mun.;2013;55;359;168;191
Akmenė d. mun.;2013;56;342;164;178
Akmenė d. mun.;2013;57;309;150;159
Akmenė d. mun.;2013;58;337;140;197
Akmenė d. mun.;2013;59;269;125;144
Akmenė d. mun.;2013;60;288;143;145
Akmenė d. mun.;2013;61;306;133;173
Akmenė d. mun.;2013;62;288;117;171
Akmenė d. mun.;2013;63;283;117;166
Akmenė d. mun.;2013;64;287;114;173
Akmenė d. mun.;2013;65;222;83;139
Akmenė d. mun.;2013;66;236;84;152
Akmenė d. mun.;2013;67;245;81;164
Akmenė d. mun.;2013;68;193;69;124
Akmenė d. mun.;2013;69;269;102;167
Akmenė d. mun.;2013;70;305;114;191
Akmenė d. mun.;2013;71;269;100;169
Akmenė d. mun.;2013;72;279;97;182
Akmenė d. mun.;2013;73;214;73;141
Akmenė d. mun.;2013;74;200;77;123
Akmenė d. mun.;2013;75;229;79;150
Akmenė d. mun.;2013;76;240;89;151
Akmenė d. mun.;2013;77;231;68;163
Akmenė d. mun.;2013;78;197;58;139
Akmenė d. mun.;2013;79;188;54;134
Akmenė d. mun.;2013;80;173;46;127
Akmenė d. mun.;2013;81;164;51;113
Akmenė d. mun.;2013;82;132;35;97
Akmenė d. mun.;2013;83;115;25;90
Akmenė d. mun.;2013;84;127;35;92
Akmenė d. mun.;2013;85;441;105;336
Akmenė d. mun.;2014;-1;21677;9986;11691
Akmenė d. mun.;2014;0;188;93;95
Akmenė d. mun.;2014;1;196;117;79
Akmenė d. mun.;2014;2;233;127;106
Akmenė d. mun.;2014;3;169;83;86
Akmenė d. mun.;2014;4;171;99;72
Akmenė d. mun.;2014;5;172;93;79
Akmenė d. mun.;2014;6;179;94;85
Akmenė d. mun.;2014;7;163;70;93
Akmenė d. mun.;2014;8;172;86;86
Akmenė d. mun.;2014;9;203;92;111
Akmenė d. mun.;2014;10;194;98;96
Akmenė d. mun.;2014;11;210;115;95
Akmenė d. mun.;2014;12;213;117;96
Akmenė d. mun.;2014;13;249;141;108
Akmenė d. mun.;2014;14;279;147;132
Akmenė d. mun.;2014;15;308;171;137
Akmenė d. mun.;2014;16;317;154;163
Akmenė d. mun.;2014;17;318;175;143
Akmenė d. mun.;2014;18;316;175;141
Akmenė d. mun.;2014;19;336;181;155
Akmenė d. mun.;2014;20;389;188;201
Akmenė d. mun.;2014;21;407;221;186
Akmenė d. mun.;2014;22;343;212;131
Akmenė d. mun.;2014;23;241;133;108
Akmenė d. mun.;2014;24;217;106;111
Akmenė d. mun.;2014;25;229;149;80
Akmenė d. mun.;2014;26;236;121;115
Akmenė d. mun.;2014;27;185;116;69
Akmenė d. mun.;2014;28;173;87;86
Akmenė d. mun.;2014;29;186;104;82
Akmenė d. mun.;2014;30;161;94;67
Akmenė d. mun.;2014;31;126;71;55
Akmenė d. mun.;2014;32;143;72;71
Akmenė d. mun.;2014;33;131;65;66
Akmenė d. mun.;2014;34;176;87;89
Akmenė d. mun.;2014;35;179;74;105
Akmenė d. mun.;2014;36;205;103;102
Akmenė d. mun.;2014;37;191;96;95
Akmenė d. mun.;2014;38;205;87;118
Akmenė d. mun.;2014;39;246;112;134
Akmenė d. mun.;2014;40;275;106;169
Akmenė d. mun.;2014;41;283;143;140
Akmenė d. mun.;2014;42;308;131;177
Akmenė d. mun.;2014;43;303;145;158
Akmenė d. mun.;2014;44;290;142;148
Akmenė d. mun.;2014;45;355;174;181
Akmenė d. mun.;2014;46;334;160;174
Akmenė d. mun.;2014;47;324;150;174
Akmenė d. mun.;2014;48;322;158;164
Akmenė d. mun.;2014;49;338;175;163
Akmenė d. mun.;2014;50;360;173;187
Akmenė d. mun.;2014;51;360;170;190
Akmenė d. mun.;2014;52;382;175;207
Akmenė d. mun.;2014;53;378;175;203
Akmenė d. mun.;2014;54;361;156;205
Akmenė d. mun.;2014;55;350;157;193
Akmenė d. mun.;2014;56;361;169;192
Akmenė d. mun.;2014;57;336;159;177
Akmenė d. mun.;2014;58;304;146;158
Akmenė d. mun.;2014;59;336;139;197
Akmenė d. mun.;2014;60;266;124;142
Akmenė d. mun.;2014;61;288;143;145
Akmenė d. mun.;2014;62;302;132;170
Akmenė d. mun.;2014;63;281;110;171
Akmenė d. mun.;2014;64;278;116;162
Akmenė d. mun.;2014;65;280;109;171
Akmenė d. mun.;2014;66;215;82;133
Akmenė d. mun.;2014;67;227;81;146
Akmenė d. mun.;2014;68;236;76;160
Akmenė d. mun.;2014;69;189;65;124
Akmenė d. mun.;2014;70;256;95;161
Akmenė d. mun.;2014;71;298;109;189
Akmenė d. mun.;2014;72;259;95;164
Akmenė d. mun.;2014;73;266;92;174
Akmenė d. mun.;2014;74;205;68;137
Akmenė d. mun.;2014;75;194;70;124
Akmenė d. mun.;2014;76;217;74;143
Akmenė d. mun.;2014;77;225;83;142
Akmenė d. mun.;2014;78;223;65;158
Akmenė d. mun.;2014;79;187;55;132
Akmenė d. mun.;2014;80;178;49;129
Akmenė d. mun.;2014;81;161;44;117
Akmenė d. mun.;2014;82;146;45;101
Akmenė d. mun.;2014;83;122;32;90
Akmenė d. mun.;2014;84;94;22;72
Akmenė d. mun.;2014;85;469;121;348
Akmenė d. mun.;2015;-1;21332;9797;11535
Akmenė d. mun.;2015;0;185;86;99
Akmenė d. mun.;2015;1;189;94;95
Akmenė d. mun.;2015;2;200;122;78
Akmenė d. mun.;2015;3;229;125;104
Akmenė d. mun.;2015;4;177;89;88
Akmenė d. mun.;2015;5;168;93;75
Akmenė d. mun.;2015;6;175;94;81
Akmenė d. mun.;2015;7;177;93;84
Akmenė d. mun.;2015;8;165;72;93
Akmenė d. mun.;2015;9;171;87;84
Akmenė d. mun.;2015;10;196;90;106
Akmenė d. mun.;2015;11;195;97;98
Akmenė d. mun.;2015;12;209;113;96
Akmenė d. mun.;2015;13;213;116;97
Akmenė d. mun.;2015;14;248;140;108
Akmenė d. mun.;2015;15;278;145;133
Akmenė d. mun.;2015;16;305;167;138
Akmenė d. mun.;2015;17;316;154;162
Akmenė d. mun.;2015;18;312;170;142
Akmenė d. mun.;2015;19;286;160;126
Akmenė d. mun.;2015;20;323;168;155
Akmenė d. mun.;2015;21;376;180;196
Akmenė d. mun.;2015;22;383;203;180
Akmenė d. mun.;2015;23;316;199;117
Akmenė d. mun.;2015;24;221;119;102
Akmenė d. mun.;2015;25;212;108;104
Akmenė d. mun.;2015;26;217;142;75
Akmenė d. mun.;2015;27;223;116;107
Akmenė d. mun.;2015;28;176;108;68
Akmenė d. mun.;2015;29;161;79;82
Akmenė d. mun.;2015;30;173;102;71
Akmenė d. mun.;2015;31;159;93;66
Akmenė d. mun.;2015;32;124;67;57
Akmenė d. mun.;2015;33;144;68;76
Akmenė d. mun.;2015;34;123;54;69
Akmenė d. mun.;2015;35;169;80;89
Akmenė d. mun.;2015;36;181;77;104
Akmenė d. mun.;2015;37;204;106;98
Akmenė d. mun.;2015;38;198;103;95
Akmenė d. mun.;2015;39;203;88;115
Akmenė d. mun.;2015;40;235;106;129
Akmenė d. mun.;2015;41;275;110;165
Akmenė d. mun.;2015;42;275;136;139
Akmenė d. mun.;2015;43;314;136;178
Akmenė d. mun.;2015;44;305;146;159
Akmenė d. mun.;2015;45;291;147;144
Akmenė d. mun.;2015;46;361;178;183
Akmenė d. mun.;2015;47;330;156;174
Akmenė d. mun.;2015;48;322;150;172
Akmenė d. mun.;2015;49;320;157;163
Akmenė d. mun.;2015;50;336;176;160
Akmenė d. mun.;2015;51;360;173;187
Akmenė d. mun.;2015;52;355;169;186
Akmenė d. mun.;2015;53;377;170;207
Akmenė d. mun.;2015;54;378;174;204
Akmenė d. mun.;2015;55;358;154;204
Akmenė d. mun.;2015;56;345;157;188
Akmenė d. mun.;2015;57;363;169;194
Akmenė d. mun.;2015;58;329;154;175
Akmenė d. mun.;2015;59;297;141;156
Akmenė d. mun.;2015;60;330;136;194
Akmenė d. mun.;2015;61;267;123;144
Akmenė d. mun.;2015;62;284;139;145
Akmenė d. mun.;2015;63;296;127;169
Akmenė d. mun.;2015;64;276;107;169
Akmenė d. mun.;2015;65;275;114;161
Akmenė d. mun.;2015;66;271;106;165
Akmenė d. mun.;2015;67;209;79;130
Akmenė d. mun.;2015;68;217;74;143
Akmenė d. mun.;2015;69;228;71;157
Akmenė d. mun.;2015;70;186;63;123
Akmenė d. mun.;2015;71;249;91;158
Akmenė d. mun.;2015;72;296;108;188
Akmenė d. mun.;2015;73;256;93;163
Akmenė d. mun.;2015;74;257;86;171
Akmenė d. mun.;2015;75;198;65;133
Akmenė d. mun.;2015;76;186;67;119
Akmenė d. mun.;2015;77;211;70;141
Akmenė d. mun.;2015;78;217;81;136
Akmenė d. mun.;2015;79;205;58;147
Akmenė d. mun.;2015;80;174;47;127
Akmenė d. mun.;2015;81;164;42;122
Akmenė d. mun.;2015;82;148;39;109
Akmenė d. mun.;2015;83;131;36;95
Akmenė d. mun.;2015;84;108;28;80
Akmenė d. mun.;2015;85;487;121;366
Akmenė d. mun.;2016;-1;20824;9534;11290
Akmenė d. mun.;2016;0;185;98;87
Akmenė d. mun.;2016;1;192;88;104
Akmenė d. mun.;2016;2;178;83;95
Akmenė d. mun.;2016;3;204;122;82
Akmenė d. mun.;2016;4;230;125;105
Akmenė d. mun.;2016;5;172;83;89
Akmenė d. mun.;2016;6;162;89;73
Akmenė d. mun.;2016;7;171;93;78
Akmenė d. mun.;2016;8;170;89;81
Akmenė d. mun.;2016;9;167;73;94
Akmenė d. mun.;2016;10;173;87;86
Akmenė d. mun.;2016;11;195;91;104
Akmenė d. mun.;2016;12;194;96;98
Akmenė d. mun.;2016;13;210;113;97
Akmenė d. mun.;2016;14;207;115;92
Akmenė d. mun.;2016;15;242;135;107
Akmenė d. mun.;2016;16;280;146;134
Akmenė d. mun.;2016;17;296;160;136
Akmenė d. mun.;2016;18;303;150;153
Akmenė d. mun.;2016;19;284;153;131
Akmenė d. mun.;2016;20;286;155;131
Akmenė d. mun.;2016;21;316;161;155
Akmenė d. mun.;2016;22;364;177;187
Akmenė d. mun.;2016;23;365;194;171
Akmenė d. mun.;2016;24;295;184;111
Akmenė d. mun.;2016;25;202;108;94
Akmenė d. mun.;2016;26;191;91;100
Akmenė d. mun.;2016;27;194;130;64
Akmenė d. mun.;2016;28;220;110;110
Akmenė d. mun.;2016;29;157;93;64
Akmenė d. mun.;2016;30;146;73;73
Akmenė d. mun.;2016;31;158;94;64
Akmenė d. mun.;2016;32;151;92;59
Akmenė d. mun.;2016;33;123;67;56
Akmenė d. mun.;2016;34;142;70;72
Akmenė d. mun.;2016;35;115;48;67
Akmenė d. mun.;2016;36;164;81;83
Akmenė d. mun.;2016;37;174;72;102
Akmenė d. mun.;2016;38;209;114;95
Akmenė d. mun.;2016;39;189;95;94
Akmenė d. mun.;2016;40;198;85;113
Akmenė d. mun.;2016;41;226;98;128
Akmenė d. mun.;2016;42;271;106;165
Akmenė d. mun.;2016;43;275;138;137
Akmenė d. mun.;2016;44;309;133;176
Akmenė d. mun.;2016;45;297;143;154
Akmenė d. mun.;2016;46;277;135;142
Akmenė d. mun.;2016;47;359;179;180
Akmenė d. mun.;2016;48;325;153;172
Akmenė d. mun.;2016;49;319;148;171
Akmenė d. mun.;2016;50;316;153;163
Akmenė d. mun.;2016;51;334;176;158
Akmenė d. mun.;2016;52;358;174;184
Akmenė d. mun.;2016;53;347;164;183
Akmenė d. mun.;2016;54;372;165;207
Akmenė d. mun.;2016;55;370;172;198
Akmenė d. mun.;2016;56;352;154;198
Akmenė d. mun.;2016;57;330;151;179
Akmenė d. mun.;2016;58;361;171;190
Akmenė d. mun.;2016;59;327;151;176
Akmenė d. mun.;2016;60;288;136;152
Akmenė d. mun.;2016;61;328;137;191
Akmenė d. mun.;2016;62;269;124;145
Akmenė d. mun.;2016;63;277;134;143
Akmenė d. mun.;2016;64;289;122;167
Akmenė d. mun.;2016;65;275;106;169
Akmenė d. mun.;2016;66;270;113;157
Akmenė d. mun.;2016;67;266;102;164
Akmenė d. mun.;2016;68;205;74;131
Akmenė d. mun.;2016;69;215;73;142
Akmenė d. mun.;2016;70;219;64;155
Akmenė d. mun.;2016;71;184;63;121
Akmenė d. mun.;2016;72;242;88;154
Akmenė d. mun.;2016;73;287;103;184
Akmenė d. mun.;2016;74;245;84;161
Akmenė d. mun.;2016;75;247;81;166
Akmenė d. mun.;2016;76;188;60;128
Akmenė d. mun.;2016;77;177;64;113
Akmenė d. mun.;2016;78;202;66;136
Akmenė d. mun.;2016;79;205;73;132
Akmenė d. mun.;2016;80;191;53;138
Akmenė d. mun.;2016;81;165;44;121
Akmenė d. mun.;2016;82;155;39;116
Akmenė d. mun.;2016;83;136;31;105
Akmenė d. mun.;2016;84;123;35;88
Akmenė d. mun.;2016;85;477;118;359
Akmenė d. mun.;2017;-1;20210;9252;10958
Akmenė d. mun.;2017;0;207;111;96
Akmenė d. mun.;2017;1;173;91;82
Akmenė d. mun.;2017;2;189;83;106
Akmenė d. mun.;2017;3;170;78;92
Akmenė d. mun.;2017;4;198;120;78
Akmenė d. mun.;2017;5;227;125;102
Akmenė d. mun.;2017;6;169;87;82
Akmenė d. mun.;2017;7;158;87;71
Akmenė d. mun.;2017;8;159;87;72
Akmenė d. mun.;2017;9;172;88;84
Akmenė d. mun.;2017;10;162;73;89
Akmenė d. mun.;2017;11;165;83;82
Akmenė d. mun.;2017;12;192;89;103
Akmenė d. mun.;2017;13;195;97;98
Akmenė d. mun.;2017;14;204;111;93
Akmenė d. mun.;2017;15;206;114;92
Akmenė d. mun.;2017;16;239;133;106
Akmenė d. mun.;2017;17;280;144;136
Akmenė d. mun.;2017;18;287;154;133
Akmenė d. mun.;2017;19;290;142;148
Akmenė d. mun.;2017;20;277;148;129
Akmenė d. mun.;2017;21;270;147;123
Akmenė d. mun.;2017;22;297;158;139
Akmenė d. mun.;2017;23;352;171;181
Akmenė d. mun.;2017;24;343;185;158
Akmenė d. mun.;2017;25;280;182;98
Akmenė d. mun.;2017;26;174;92;82
Akmenė d. mun.;2017;27;179;88;91
Akmenė d. mun.;2017;28;176;119;57
Akmenė d. mun.;2017;29;208;107;101
Akmenė d. mun.;2017;30;133;80;53
Akmenė d. mun.;2017;31;137;73;64
Akmenė d. mun.;2017;32;160;94;66
Akmenė d. mun.;2017;33;146;90;56
Akmenė d. mun.;2017;34;106;62;44
Akmenė d. mun.;2017;35;124;58;66
Akmenė d. mun.;2017;36;101;40;61
Akmenė d. mun.;2017;37;153;77;76
Akmenė d. mun.;2017;38;165;66;99
Akmenė d. mun.;2017;39;198;105;93
Akmenė d. mun.;2017;40;181;91;90
Akmenė d. mun.;2017;41;193;84;109
Akmenė d. mun.;2017;42;218;91;127
Akmenė d. mun.;2017;43;264;102;162
Akmenė d. mun.;2017;44;283;142;141
Akmenė d. mun.;2017;45;296;128;168
Akmenė d. mun.;2017;46;282;136;146
Akmenė d. mun.;2017;47;271;132;139
Akmenė d. mun.;2017;48;354;177;177
Akmenė d. mun.;2017;49;315;147;168
Akmenė d. mun.;2017;50;306;141;165
Akmenė d. mun.;2017;51;312;149;163
Akmenė d. mun.;2017;52;325;172;153
Akmenė d. mun.;2017;53;349;170;179
Akmenė d. mun.;2017;54;346;165;181
Akmenė d. mun.;2017;55;367;160;207
Akmenė d. mun.;2017;56;372;173;199
Akmenė d. mun.;2017;57;348;152;196
Akmenė d. mun.;2017;58;329;150;179
Akmenė d. mun.;2017;59;349;164;185
Akmenė d. mun.;2017;60;316;143;173
Akmenė d. mun.;2017;61;278;131;147
Akmenė d. mun.;2017;62;323;135;188
Akmenė d. mun.;2017;63;264;121;143
Akmenė d. mun.;2017;64;271;131;140
Akmenė d. mun.;2017;65;285;119;166
Akmenė d. mun.;2017;66;265;97;168
Akmenė d. mun.;2017;67;262;107;155
Akmenė d. mun.;2017;68;253;96;157
Akmenė d. mun.;2017;69;202;72;130
Akmenė d. mun.;2017;70;212;72;140
Akmenė d. mun.;2017;71;216;62;154
Akmenė d. mun.;2017;72;172;58;114
Akmenė d. mun.;2017;73;233;82;151
Akmenė d. mun.;2017;74;268;94;174
Akmenė d. mun.;2017;75;235;77;158
Akmenė d. mun.;2017;76;237;74;163
Akmenė d. mun.;2017;77;182;58;124
Akmenė d. mun.;2017;78;169;59;110
Akmenė d. mun.;2017;79;187;56;131
Akmenė d. mun.;2017;80;192;65;127
Akmenė d. mun.;2017;81;178;47;131
Akmenė d. mun.;2017;82;156;39;117
Akmenė d. mun.;2017;83;136;31;105
Akmenė d. mun.;2017;84;127;27;100
Akmenė d. mun.;2017;85;510;134;376
Akmenė d. mun.;2018;-1;19606;8942;10664
Akmenė d. mun.;2018;0;176;88;88
Akmenė d. mun.;2018;1;209;115;94
Akmenė d. mun.;2018;2;171;89;82
Akmenė d. mun.;2018;3;193;85;108
Akmenė d. mun.;2018;4;165;78;87
Akmenė d. mun.;2018;5;199;120;79
Akmenė d. mun.;2018;6;224;124;100
Akmenė d. mun.;2018;7;175;86;89
Akmenė d. mun.;2018;8;160;88;72
Akmenė d. mun.;2018;9;160;86;74
Akmenė d. mun.;2018;10;171;89;82
Akmenė d. mun.;2018;11;158;70;88
Akmenė d. mun.;2018;12;163;80;83
Akmenė d. mun.;2018;13;190;88;102
Akmenė d. mun.;2018;14;193;96;97
Akmenė d. mun.;2018;15;202;111;91
Akmenė d. mun.;2018;16;203;113;90
Akmenė d. mun.;2018;17;236;134;102
Akmenė d. mun.;2018;18;271;139;132
Akmenė d. mun.;2018;19;260;140;120
Akmenė d. mun.;2018;20;274;135;139
Akmenė d. mun.;2018;21;257;135;122
Akmenė d. mun.;2018;22;247;135;112
Akmenė d. mun.;2018;23;275;147;128
Akmenė d. mun.;2018;24;315;156;159
Akmenė d. mun.;2018;25;316;166;150
Akmenė d. mun.;2018;26;242;165;77
Akmenė d. mun.;2018;27;146;77;69
Akmenė d. mun.;2018;28;159;82;77
Akmenė d. mun.;2018;29;154;106;48
Akmenė d. mun.;2018;30;189;99;90
Akmenė d. mun.;2018;31;120;69;51
Akmenė d. mun.;2018;32;127;65;62
Akmenė d. mun.;2018;33;142;83;59
Akmenė d. mun.;2018;34;133;80;53
Akmenė d. mun.;2018;35;103;60;43
Akmenė d. mun.;2018;36;122;56;66
Akmenė d. mun.;2018;37;96;37;59
Akmenė d. mun.;2018;38;147;74;73
Akmenė d. mun.;2018;39;155;59;96
Akmenė d. mun.;2018;40;197;103;94
Akmenė d. mun.;2018;41;181;92;89
Akmenė d. mun.;2018;42;195;87;108
Akmenė d. mun.;2018;43;216;92;124
Akmenė d. mun.;2018;44;255;98;157
Akmenė d. mun.;2018;45;273;137;136
Akmenė d. mun.;2018;46;288;124;164
Akmenė d. mun.;2018;47;277;133;144
Akmenė d. mun.;2018;48;269;131;138
Akmenė d. mun.;2018;49;346;172;174
Akmenė d. mun.;2018;50;312;147;165
Akmenė d. mun.;2018;51;305;143;162
Akmenė d. mun.;2018;52;301;141;160
Akmenė d. mun.;2018;53;324;170;154
Akmenė d. mun.;2018;54;346;168;178
Akmenė d. mun.;2018;55;345;165;180
Akmenė d. mun.;2018;56;360;156;204
Akmenė d. mun.;2018;57;365;170;195
Akmenė d. mun.;2018;58;346;147;199
Akmenė d. mun.;2018;59;324;149;175
Akmenė d. mun.;2018;60;347;162;185
Akmenė d. mun.;2018;61;308;138;170
Akmenė d. mun.;2018;62;279;130;149
Akmenė d. mun.;2018;63;316;132;184
Akmenė d. mun.;2018;64;259;120;139
Akmenė d. mun.;2018;65;274;130;144
Akmenė d. mun.;2018;66;279;117;162
Akmenė d. mun.;2018;67;256;94;162
Akmenė d. mun.;2018;68;254;102;152
Akmenė d. mun.;2018;69;249;94;155
Akmenė d. mun.;2018;70;196;69;127
Akmenė d. mun.;2018;71;206;69;137
Akmenė d. mun.;2018;72;203;55;148
Akmenė d. mun.;2018;73;165;53;112
Akmenė d. mun.;2018;74;226;74;152
Akmenė d. mun.;2018;75;255;88;167
Akmenė d. mun.;2018;76;220;69;151
Akmenė d. mun.;2018;77;229;69;160
Akmenė d. mun.;2018;78;169;49;120
Akmenė d. mun.;2018;79;162;56;106
Akmenė d. mun.;2018;80;174;50;124
Akmenė d. mun.;2018;81;180;58;122
Akmenė d. mun.;2018;82;161;41;120
Akmenė d. mun.;2018;83;142;34;108
Akmenė d. mun.;2018;84;130;28;102
Akmenė d. mun.;2018;85;544;131;413
Alytus county;2001;-1;187990;90320;97670
Alytus county;2001;0;1828;918;910
Alytus county;2001;1;1940;983;957
Alytus county;2001;2;1971;1011;960
Alytus county;2001;3;1985;1064;921
Alytus county;2001;4;2070;1045;1025
Alytus county;2001;5;2250;1121;1129
Alytus county;2001;6;2372;1222;1150
Alytus county;2001;7;2582;1340;1242
Alytus county;2001;8;2929;1458;1471
Alytus county;2001;9;3021;1557;1464
Alytus county;2001;10;3021;1550;1471
Alytus county;2001;11;2971;1517;1454
Alytus county;2001;12;2909;1569;1340
Alytus county;2001;13;2997;1548;1449
Alytus county;2001;14;3124;1607;1517
Alytus county;2001;15;3070;1543;1527
Alytus county;2001;16;2985;1536;1449
Alytus county;2001;17;3026;1549;1477
Alytus county;2001;18;2399;1263;1136
Alytus county;2001;19;2109;1200;909
Alytus county;2001;20;1998;1117;881
Alytus county;2001;21;2040;1172;868
Alytus county;2001;22;2152;1212;940
Alytus county;2001;23;2146;1132;1014
Alytus county;2001;24;2353;1221;1132
Alytus county;2001;25;2410;1329;1081
Alytus county;2001;26;2346;1231;1115
Alytus county;2001;27;2453;1291;1162
Alytus county;2001;28;2614;1342;1272
Alytus county;2001;29;2668;1349;1319
Alytus county;2001;30;2575;1326;1249
Alytus county;2001;31;2663;1339;1324
Alytus county;2001;32;2722;1359;1363
Alytus county;2001;33;2798;1461;1337
Alytus county;2001;34;2688;1405;1283
Alytus county;2001;35;2716;1367;1349
Alytus county;2001;36;2862;1496;1366
Alytus county;2001;37;2861;1480;1381
Alytus county;2001;38;3011;1535;1476
Alytus county;2001;39;3003;1485;1518
Alytus county;2001;40;3079;1572;1507
Alytus county;2001;41;3036;1531;1505
Alytus county;2001;42;2943;1479;1464
Alytus county;2001;43;2634;1360;1274
Alytus county;2001;44;2369;1146;1223
Alytus county;2001;45;2360;1127;1233
Alytus county;2001;46;2222;1119;1103
Alytus county;2001;47;2261;1131;1130
Alytus county;2001;48;2362;1142;1220
Alytus county;2001;49;2310;1103;1207
Alytus county;2001;50;2209;1062;1147
Alytus county;2001;51;2336;1088;1248
Alytus county;2001;52;2070;992;1078
Alytus county;2001;53;1895;893;1002
Alytus county;2001;54;1829;855;974
Alytus county;2001;55;2066;999;1067
Alytus county;2001;56;1766;832;934
Alytus county;2001;57;2122;990;1132
Alytus county;2001;58;2154;973;1181
Alytus county;2001;59;2080;939;1141
Alytus county;2001;60;2010;889;1121
Alytus county;2001;61;1973;870;1103
Alytus county;2001;62;2145;946;1199
Alytus county;2001;63;1980;859;1121
Alytus county;2001;64;2102;839;1263
Alytus county;2001;65;2085;887;1198
Alytus county;2001;66;1848;773;1075
Alytus county;2001;67;1918;815;1103
Alytus county;2001;68;1944;776;1168
Alytus county;2001;69;1905;725;1180
Alytus county;2001;70;1978;747;1231
Alytus county;2001;71;1775;651;1124
Alytus county;2001;72;1709;589;1120
Alytus county;2001;73;1577;556;1021
Alytus county;2001;74;1442;481;961
Alytus county;2001;75;1405;421;984
Alytus county;2001;76;1321;443;878
Alytus county;2001;77;1184;384;800
Alytus county;2001;78;1121;329;792
Alytus county;2001;79;805;257;548
Alytus county;2001;80;721;234;487
Alytus county;2001;81;624;195;429
Alytus county;2001;82;424;129;295
Alytus county;2001;83;368;109;259
Alytus county;2001;84;424;106;318
Alytus county;2001;85;2461;727;1734
Alytus county;2002;-1;186484;89293;97191
Alytus county;2002;0;1703;851;852
Alytus county;2002;1;1819;918;901
Alytus county;2002;2;1932;976;956
Alytus county;2002;3;1969;1008;961
Alytus county;2002;4;1978;1056;922
Alytus county;2002;5;2058;1037;1021
Alytus county;2002;6;2237;1118;1119
Alytus county;2002;7;2377;1225;1152
Alytus county;2002;8;2571;1334;1237
Alytus county;2002;9;2910;1444;1466
Alytus county;2002;10;3019;1554;1465
Alytus county;2002;11;3002;1535;1467
Alytus county;2002;12;2936;1493;1443
Alytus county;2002;13;2864;1542;1322
Alytus county;2002;14;2966;1525;1441
Alytus county;2002;15;3087;1580;1507
Alytus county;2002;16;3037;1525;1512
Alytus county;2002;17;2942;1508;1434
Alytus county;2002;18;2961;1516;1445
Alytus county;2002;19;2323;1227;1096
Alytus county;2002;20;2069;1176;893
Alytus county;2002;21;1954;1085;869
Alytus county;2002;22;2013;1141;872
Alytus county;2002;23;2146;1205;941
Alytus county;2002;24;2102;1105;997
Alytus county;2002;25;2341;1219;1122
Alytus county;2002;26;2361;1294;1067
Alytus county;2002;27;2304;1204;1100
Alytus county;2002;28;2416;1257;1159
Alytus county;2002;29;2556;1303;1253
Alytus county;2002;30;2610;1317;1293
Alytus county;2002;31;2528;1295;1233
Alytus county;2002;32;2615;1308;1307
Alytus county;2002;33;2680;1329;1351
Alytus county;2002;34;2750;1431;1319
Alytus county;2002;35;2646;1374;1272
Alytus county;2002;36;2681;1344;1337
Alytus county;2002;37;2826;1466;1360
Alytus county;2002;38;2816;1449;1367
Alytus county;2002;39;2943;1486;1457
Alytus county;2002;40;2955;1451;1504
Alytus county;2002;41;3058;1561;1497
Alytus county;2002;42;3007;1512;1495
Alytus county;2002;43;2929;1469;1460
Alytus county;2002;44;2607;1346;1261
Alytus county;2002;45;2325;1128;1197
Alytus county;2002;46;2328;1107;1221
Alytus county;2002;47;2210;1112;1098
Alytus county;2002;48;2213;1099;1114
Alytus county;2002;49;2324;1116;1208
Alytus county;2002;50;2290;1084;1206
Alytus county;2002;51;2174;1042;1132
Alytus county;2002;52;2328;1079;1249
Alytus county;2002;53;2043;975;1068
Alytus county;2002;54;1859;880;979
Alytus county;2002;55;1796;840;956
Alytus county;2002;56;2018;971;1047
Alytus county;2002;57;1733;817;916
Alytus county;2002;58;2075;966;1109
Alytus county;2002;59;2106;942;1164
Alytus county;2002;60;2054;925;1129
Alytus county;2002;61;2004;884;1120
Alytus county;2002;62;1957;848;1109
Alytus county;2002;63;2111;925;1186
Alytus county;2002;64;1965;841;1124
Alytus county;2002;65;2085;824;1261
Alytus county;2002;66;2056;869;1187
Alytus county;2002;67;1838;765;1073
Alytus county;2002;68;1886;786;1100
Alytus county;2002;69;1905;751;1154
Alytus county;2002;70;1879;706;1173
Alytus county;2002;71;1950;733;1217
Alytus county;2002;72;1738;625;1113
Alytus county;2002;73;1663;564;1099
Alytus county;2002;74;1564;548;1016
Alytus county;2002;75;1392;452;940
Alytus county;2002;76;1371;414;957
Alytus county;2002;77;1287;423;864
Alytus county;2002;78;1130;350;780
Alytus county;2002;79;1067;301;766
Alytus county;2002;80;757;233;524
Alytus county;2002;81;674;210;464
Alytus county;2002;82;576;175;401
Alytus county;2002;83;393;115;278
Alytus county;2002;84;324;86;238
Alytus county;2002;85;2432;683;1749
Alytus county;2003;-1;184992;88331;96661
Alytus county;2003;0;1537;770;767
Alytus county;2003;1;1682;838;844
Alytus county;2003;2;1801;906;895
Alytus county;2003;3;1906;959;947
Alytus county;2003;4;1957;1000;957
Alytus county;2003;5;1967;1053;914
Alytus county;2003;6;2052;1033;1019
Alytus county;2003;7;2221;1109;1112
Alytus county;2003;8;2363;1220;1143
Alytus county;2003;9;2570;1330;1240
Alytus county;2003;10;2895;1442;1453
Alytus county;2003;11;3001;1544;1457
Alytus county;2003;12;2962;1515;1447
Alytus county;2003;13;2896;1473;1423
Alytus county;2003;14;2825;1513;1312
Alytus county;2003;15;2922;1497;1425
Alytus county;2003;16;3047;1556;1491
Alytus county;2003;17;2983;1490;1493
Alytus county;2003;18;2907;1484;1423
Alytus county;2003;19;2928;1499;1429
Alytus county;2003;20;2277;1208;1069
Alytus county;2003;21;2048;1163;885
Alytus county;2003;22;1953;1079;874
Alytus county;2003;23;2011;1131;880
Alytus county;2003;24;2127;1185;942
Alytus county;2003;25;2067;1087;980
Alytus county;2003;26;2284;1192;1092
Alytus county;2003;27;2316;1265;1051
Alytus county;2003;28;2275;1187;1088
Alytus county;2003;29;2375;1233;1142
Alytus county;2003;30;2523;1284;1239
Alytus county;2003;31;2584;1301;1283
Alytus county;2003;32;2506;1290;1216
Alytus county;2003;33;2594;1296;1298
Alytus county;2003;34;2657;1317;1340
Alytus county;2003;35;2711;1402;1309
Alytus county;2003;36;2619;1362;1257
Alytus county;2003;37;2646;1321;1325
Alytus county;2003;38;2814;1461;1353
Alytus county;2003;39;2797;1439;1358
Alytus county;2003;40;2923;1478;1445
Alytus county;2003;41;2931;1440;1491
Alytus county;2003;42;3043;1551;1492
Alytus county;2003;43;2981;1498;1483
Alytus county;2003;44;2914;1461;1453
Alytus county;2003;45;2583;1327;1256
Alytus county;2003;46;2298;1107;1191
Alytus county;2003;47;2314;1102;1212
Alytus county;2003;48;2189;1095;1094
Alytus county;2003;49;2187;1083;1104
Alytus county;2003;50;2291;1095;1196
Alytus county;2003;51;2259;1067;1192
Alytus county;2003;52;2147;1023;1124
Alytus county;2003;53;2324;1077;1247
Alytus county;2003;54;2018;957;1061
Alytus county;2003;55;1831;857;974
Alytus county;2003;56;1767;821;946
Alytus county;2003;57;1991;951;1040
Alytus county;2003;58;1712;799;913
Alytus county;2003;59;2048;948;1100
Alytus county;2003;60;2075;921;1154
Alytus county;2003;61;2023;904;1119
Alytus county;2003;62;1979;862;1117
Alytus county;2003;63;1942;839;1103
Alytus county;2003;64;2085;905;1180
Alytus county;2003;65;1959;829;1130
Alytus county;2003;66;2064;811;1253
Alytus county;2003;67;2022;850;1172
Alytus county;2003;68;1800;739;1061
Alytus county;2003;69;1858;763;1095
Alytus county;2003;70;1860;716;1144
Alytus county;2003;71;1839;673;1166
Alytus county;2003;72;1908;699;1209
Alytus county;2003;73;1670;582;1088
Alytus county;2003;74;1613;529;1084
Alytus county;2003;75;1508;510;998
Alytus county;2003;76;1339;419;920
Alytus county;2003;77;1331;390;941
Alytus county;2003;78;1215;383;832
Alytus county;2003;79;1063;310;753
Alytus county;2003;80;994;274;720
Alytus county;2003;81;708;208;500
Alytus county;2003;82;620;179;441
Alytus county;2003;83;537;170;367
Alytus county;2003;84;360;102;258
Alytus county;2003;85;2263;593;1670
Alytus county;2004;-1;182751;86956;95795
Alytus county;2004;0;1586;794;792
Alytus county;2004;1;1529;767;762
Alytus county;2004;2;1683;840;843
Alytus county;2004;3;1786;898;888
Alytus county;2004;4;1890;948;942
Alytus county;2004;5;1947;996;951
Alytus county;2004;6;1956;1045;911
Alytus county;2004;7;2043;1025;1018
Alytus county;2004;8;2205;1102;1103
Alytus county;2004;9;2358;1214;1144
Alytus county;2004;10;2559;1328;1231
Alytus county;2004;11;2880;1431;1449
Alytus county;2004;12;2974;1532;1442
Alytus county;2004;13;2919;1497;1422
Alytus county;2004;14;2844;1442;1402
Alytus county;2004;15;2781;1493;1288
Alytus county;2004;16;2870;1471;1399
Alytus county;2004;17;2999;1536;1463
Alytus county;2004;18;2914;1458;1456
Alytus county;2004;19;2846;1459;1387
Alytus county;2004;20;2859;1461;1398
Alytus county;2004;21;2211;1177;1034
Alytus county;2004;22;2003;1142;861
Alytus county;2004;23;1904;1051;853
Alytus county;2004;24;1968;1104;864
Alytus county;2004;25;2056;1140;916
Alytus county;2004;26;1994;1043;951
Alytus county;2004;27;2205;1154;1051
Alytus county;2004;28;2223;1200;1023
Alytus county;2004;29;2209;1146;1063
Alytus county;2004;30;2320;1200;1120
Alytus county;2004;31;2446;1237;1209
Alytus county;2004;32;2527;1276;1251
Alytus county;2004;33;2444;1260;1184
Alytus county;2004;34;2547;1268;1279
Alytus county;2004;35;2612;1286;1326
Alytus county;2004;36;2673;1379;1294
Alytus county;2004;37;2601;1351;1250
Alytus county;2004;38;2611;1306;1305
Alytus county;2004;39;2765;1430;1335
Alytus county;2004;40;2762;1423;1339
Alytus county;2004;41;2881;1460;1421
Alytus county;2004;42;2890;1419;1471
Alytus county;2004;43;3015;1535;1480
Alytus county;2004;44;2942;1470;1472
Alytus county;2004;45;2878;1445;1433
Alytus county;2004;46;2552;1303;1249
Alytus county;2004;47;2282;1099;1183
Alytus county;2004;48;2290;1085;1205
Alytus county;2004;49;2165;1079;1086
Alytus county;2004;50;2153;1059;1094
Alytus county;2004;51;2259;1072;1187
Alytus county;2004;52;2219;1044;1175
Alytus county;2004;53;2117;999;1118
Alytus county;2004;54;2295;1062;1233
Alytus county;2004;55;2002;944;1058
Alytus county;2004;56;1813;846;967
Alytus county;2004;57;1750;808;942
Alytus county;2004;58;1958;925;1033
Alytus county;2004;59;1685;779;906
Alytus county;2004;60;1995;917;1078
Alytus county;2004;61;2028;888;1140
Alytus county;2004;62;1979;873;1106
Alytus county;2004;63;1936;828;1108
Alytus county;2004;64;1914;816;1098
Alytus county;2004;65;2067;886;1181
Alytus county;2004;66;1925;794;1131
Alytus county;2004;67;2034;781;1253
Alytus county;2004;68;1981;814;1167
Alytus county;2004;69;1763;704;1059
Alytus county;2004;70;1811;731;1080
Alytus county;2004;71;1821;690;1131
Alytus county;2004;72;1800;650;1150
Alytus county;2004;73;1858;670;1188
Alytus county;2004;74;1608;543;1065
Alytus county;2004;75;1562;494;1068
Alytus county;2004;76;1450;478;972
Alytus county;2004;77;1281;391;890
Alytus county;2004;78;1267;359;908
Alytus county;2004;79;1159;349;810
Alytus county;2004;80;998;277;721
Alytus county;2004;81;943;247;696
Alytus county;2004;82;657;174;483
Alytus county;2004;83;577;159;418
Alytus county;2004;84;496;154;342
Alytus county;2004;85;2186;546;1640
Alytus county;2005;-1;179626;85293;94333
Alytus county;2005;0;1477;736;741
Alytus county;2005;1;1567;783;784
Alytus county;2005;2;1513;761;752
Alytus county;2005;3;1666;838;828
Alytus county;2005;4;1771;895;876
Alytus county;2005;5;1868;941;927
Alytus county;2005;6;1929;990;939
Alytus county;2005;7;1941;1036;905
Alytus county;2005;8;2027;1013;1014
Alytus county;2005;9;2186;1094;1092
Alytus county;2005;10;2337;1197;1140
Alytus county;2005;11;2544;1321;1223
Alytus county;2005;12;2850;1415;1435
Alytus county;2005;13;2938;1509;1429
Alytus county;2005;14;2864;1462;1402
Alytus county;2005;15;2815;1426;1389
Alytus county;2005;16;2724;1459;1265
Alytus county;2005;17;2822;1439;1383
Alytus county;2005;18;2938;1503;1435
Alytus county;2005;19;2838;1425;1413
Alytus county;2005;20;2764;1415;1349
Alytus county;2005;21;2765;1417;1348
Alytus county;2005;22;2142;1148;994
Alytus county;2005;23;1943;1114;829
Alytus county;2005;24;1832;1015;817
Alytus county;2005;25;1891;1067;824
Alytus county;2005;26;1970;1094;876
Alytus county;2005;27;1915;1003;912
Alytus county;2005;28;2096;1100;996
Alytus county;2005;29;2142;1158;984
Alytus county;2005;30;2134;1098;1036
Alytus county;2005;31;2257;1163;1094
Alytus county;2005;32;2384;1197;1187
Alytus county;2005;33;2446;1233;1213
Alytus county;2005;34;2372;1225;1147
Alytus county;2005;35;2483;1232;1251
Alytus county;2005;36;2562;1264;1298
Alytus county;2005;37;2612;1342;1270
Alytus county;2005;38;2572;1328;1244
Alytus county;2005;39;2554;1273;1281
Alytus county;2005;40;2716;1399;1317
Alytus county;2005;41;2723;1401;1322
Alytus county;2005;42;2833;1428;1405
Alytus county;2005;43;2847;1393;1454
Alytus county;2005;44;2991;1520;1471
Alytus county;2005;45;2888;1447;1441
Alytus county;2005;46;2846;1422;1424
Alytus county;2005;47;2525;1288;1237
Alytus county;2005;48;2249;1078;1171
Alytus county;2005;49;2269;1078;1191
Alytus county;2005;50;2141;1061;1080
Alytus county;2005;51;2125;1039;1086
Alytus county;2005;52;2229;1056;1173
Alytus county;2005;53;2177;1017;1160
Alytus county;2005;54;2081;985;1096
Alytus county;2005;55;2257;1036;1221
Alytus county;2005;56;1978;926;1052
Alytus county;2005;57;1790;828;962
Alytus county;2005;58;1712;779;933
Alytus county;2005;59;1918;901;1017
Alytus county;2005;60;1648;751;897
Alytus county;2005;61;1956;895;1061
Alytus county;2005;62;1990;858;1132
Alytus county;2005;63;1930;835;1095
Alytus county;2005;64;1895;797;1098
Alytus county;2005;65;1874;789;1085
Alytus county;2005;66;2005;846;1159
Alytus county;2005;67;1888;774;1114
Alytus county;2005;68;1991;756;1235
Alytus county;2005;69;1920;776;1144
Alytus county;2005;70;1713;676;1037
Alytus county;2005;71;1743;689;1054
Alytus county;2005;72;1756;648;1108
Alytus county;2005;73;1724;600;1124
Alytus county;2005;74;1791;631;1160
Alytus county;2005;75;1549;511;1038
Alytus county;2005;76;1499;472;1027
Alytus county;2005;77;1387;443;944
Alytus county;2005;78;1205;354;851
Alytus county;2005;79;1193;334;859
Alytus county;2005;80;1077;322;755
Alytus county;2005;81;932;244;688
Alytus county;2005;82;882;220;662
Alytus county;2005;83;599;151;448
Alytus county;2005;84;507;133;374
Alytus county;2005;85;2226;577;1649
Alytus county;2006;-1;175813;83135;92678
Alytus county;2006;0;1467;723;744
Alytus county;2006;1;1464;727;737
Alytus county;2006;2;1539;767;772
Alytus county;2006;3;1503;756;747
Alytus county;2006;4;1638;819;819
Alytus county;2006;5;1750;883;867
Alytus county;2006;6;1845;929;916
Alytus county;2006;7;1911;982;929
Alytus county;2006;8;1919;1024;895
Alytus county;2006;9;2018;1016;1002
Alytus county;2006;10;2177;1089;1088
Alytus county;2006;11;2327;1190;1137
Alytus county;2006;12;2525;1312;1213
Alytus county;2006;13;2803;1390;1413
Alytus county;2006;14;2899;1485;1414
Alytus county;2006;15;2799;1429;1370
Alytus county;2006;16;2720;1368;1352
Alytus county;2006;17;2653;1406;1247
Alytus county;2006;18;2741;1397;1344
Alytus county;2006;19;2807;1431;1376
Alytus county;2006;20;2706;1352;1354
Alytus county;2006;21;2614;1336;1278
Alytus county;2006;22;2632;1352;1280
Alytus county;2006;23;2038;1088;950
Alytus county;2006;24;1841;1064;777
Alytus county;2006;25;1694;944;750
Alytus county;2006;26;1773;1014;759
Alytus county;2006;27;1875;1043;832
Alytus county;2006;28;1815;955;860
Alytus county;2006;29;2018;1050;968
Alytus county;2006;30;2076;1115;961
Alytus county;2006;31;2074;1069;1005
Alytus county;2006;32;2175;1115;1060
Alytus county;2006;33;2304;1149;1155
Alytus county;2006;34;2374;1186;1188
Alytus county;2006;35;2302;1177;1125
Alytus county;2006;36;2423;1191;1232
Alytus county;2006;37;2512;1232;1280
Alytus county;2006;38;2550;1304;1246
Alytus county;2006;39;2516;1293;1223
Alytus county;2006;40;2504;1237;1267
Alytus county;2006;41;2659;1363;1296
Alytus county;2006;42;2671;1366;1305
Alytus county;2006;43;2781;1392;1389
Alytus county;2006;44;2816;1374;1442
Alytus county;2006;45;2956;1501;1455
Alytus county;2006;46;2842;1419;1423
Alytus county;2006;47;2818;1397;1421
Alytus county;2006;48;2493;1273;1220
Alytus county;2006;49;2213;1053;1160
Alytus county;2006;50;2234;1060;1174
Alytus county;2006;51;2112;1039;1073
Alytus county;2006;52;2086;1013;1073
Alytus county;2006;53;2183;1022;1161
Alytus county;2006;54;2130;989;1141
Alytus county;2006;55;2046;965;1081
Alytus county;2006;56;2212;1002;1210
Alytus county;2006;57;1944;905;1039
Alytus county;2006;58;1752;795;957
Alytus county;2006;59;1681;758;923
Alytus county;2006;60;1873;878;995
Alytus county;2006;61;1615;726;889
Alytus county;2006;62;1917;869;1048
Alytus county;2006;63;1939;824;1115
Alytus county;2006;64;1894;807;1087
Alytus county;2006;65;1849;759;1090
Alytus county;2006;66;1819;750;1069
Alytus county;2006;67;1954;806;1148
Alytus county;2006;68;1846;747;1099
Alytus county;2006;69;1950;730;1220
Alytus county;2006;70;1877;742;1135
Alytus county;2006;71;1686;656;1030
Alytus county;2006;72;1688;666;1022
Alytus county;2006;73;1714;621;1093
Alytus county;2006;74;1661;561;1100
Alytus county;2006;75;1707;582;1125
Alytus county;2006;76;1478;478;1000
Alytus county;2006;77;1424;438;986
Alytus county;2006;78;1318;407;911
Alytus county;2006;79;1126;318;808
Alytus county;2006;80;1110;305;805
Alytus county;2006;81;1002;294;708
Alytus county;2006;82;845;213;632
Alytus county;2006;83;789;179;610
Alytus county;2006;84;537;127;410
Alytus county;2006;85;2245;577;1668
Alytus county;2007;-1;173028;81530;91498
Alytus county;2007;0;1468;759;709
Alytus county;2007;1;1448;714;734
Alytus county;2007;2;1438;715;723
Alytus county;2007;3;1519;748;771
Alytus county;2007;4;1481;744;737
Alytus county;2007;5;1622;805;817
Alytus county;2007;6;1736;871;865
Alytus county;2007;7;1834;920;914
Alytus county;2007;8;1896;969;927
Alytus county;2007;9;1911;1018;893
Alytus county;2007;10;2008;1011;997
Alytus county;2007;11;2171;1087;1084
Alytus county;2007;12;2320;1184;1136
Alytus county;2007;13;2509;1301;1208
Alytus county;2007;14;2784;1375;1409
Alytus county;2007;15;2880;1474;1406
Alytus county;2007;16;2771;1415;1356
Alytus county;2007;17;2692;1355;1337
Alytus county;2007;18;2609;1383;1226
Alytus county;2007;19;2680;1367;1313
Alytus county;2007;20;2741;1395;1346
Alytus county;2007;21;2628;1315;1313
Alytus county;2007;22;2547;1297;1250
Alytus county;2007;23;2548;1300;1248
Alytus county;2007;24;1983;1044;939
Alytus county;2007;25;1767;1021;746
Alytus county;2007;26;1611;892;719
Alytus county;2007;27;1704;976;728
Alytus county;2007;28;1835;1015;820
Alytus county;2007;29;1770;934;836
Alytus county;2007;30;1957;1020;937
Alytus county;2007;31;2056;1104;952
Alytus county;2007;32;2017;1039;978
Alytus county;2007;33;2140;1089;1051
Alytus county;2007;34;2254;1110;1144
Alytus county;2007;35;2341;1164;1177
Alytus county;2007;36;2260;1148;1112
Alytus county;2007;37;2387;1169;1218
Alytus county;2007;38;2479;1214;1265
Alytus county;2007;39;2510;1277;1233
Alytus county;2007;40;2475;1266;1209
Alytus county;2007;41;2477;1223;1254
Alytus county;2007;42;2618;1333;1285
Alytus county;2007;43;2639;1344;1295
Alytus county;2007;44;2728;1360;1368
Alytus county;2007;45;2761;1344;1417
Alytus county;2007;46;2937;1485;1452
Alytus county;2007;47;2806;1398;1408
Alytus county;2007;48;2777;1367;1410
Alytus county;2007;49;2470;1255;1215
Alytus county;2007;50;2171;1030;1141
Alytus county;2007;51;2208;1038;1170
Alytus county;2007;52;2084;1012;1072
Alytus county;2007;53;2029;979;1050
Alytus county;2007;54;2146;993;1153
Alytus county;2007;55;2070;949;1121
Alytus county;2007;56;2010;936;1074
Alytus county;2007;57;2172;972;1200
Alytus county;2007;58;1916;885;1031
Alytus county;2007;59;1716;771;945
Alytus county;2007;60;1646;736;910
Alytus county;2007;61;1836;847;989
Alytus county;2007;62;1588;703;885
Alytus county;2007;63;1879;844;1035
Alytus county;2007;64;1880;778;1102
Alytus county;2007;65;1858;780;1078
Alytus county;2007;66;1807;724;1083
Alytus county;2007;67;1770;717;1053
Alytus county;2007;68;1905;779;1126
Alytus county;2007;69;1792;718;1074
Alytus county;2007;70;1901;709;1192
Alytus county;2007;71;1820;704;1116
Alytus county;2007;72;1634;620;1014
Alytus county;2007;73;1622;621;1001
Alytus county;2007;74;1638;582;1056
Alytus county;2007;75;1580;521;1059
Alytus county;2007;76;1624;540;1084
Alytus county;2007;77;1402;447;955
Alytus county;2007;78;1347;405;942
Alytus county;2007;79;1242;372;870
Alytus county;2007;80;1057;294;763
Alytus county;2007;81;1027;265;762
Alytus county;2007;82;930;265;665
Alytus county;2007;83;754;190;564
Alytus county;2007;84;704;151;553
Alytus county;2007;85;2263;540;1723
Alytus county;2008;-1;170249;79964;90285
Alytus county;2008;0;1360;695;665
Alytus county;2008;1;1455;745;710
Alytus county;2008;2;1431;705;726
Alytus county;2008;3;1415;707;708
Alytus county;2008;4;1498;733;765
Alytus county;2008;5;1461;730;731
Alytus county;2008;6;1598;790;808
Alytus county;2008;7;1709;857;852
Alytus county;2008;8;1826;918;908
Alytus county;2008;9;1881;963;918
Alytus county;2008;10;1892;1001;891
Alytus county;2008;11;1979;1000;979
Alytus county;2008;12;2153;1074;1079
Alytus county;2008;13;2312;1174;1138
Alytus county;2008;14;2497;1295;1202
Alytus county;2008;15;2766;1364;1402
Alytus county;2008;16;2856;1457;1399
Alytus county;2008;17;2738;1399;1339
Alytus county;2008;18;2657;1336;1321
Alytus county;2008;19;2563;1358;1205
Alytus county;2008;20;2631;1343;1288
Alytus county;2008;21;2673;1362;1311
Alytus county;2008;22;2549;1276;1273
Alytus county;2008;23;2478;1269;1209
Alytus county;2008;24;2469;1254;1215
Alytus county;2008;25;1898;1002;896
Alytus county;2008;26;1701;979;722
Alytus county;2008;27;1541;859;682
Alytus county;2008;28;1644;946;698
Alytus county;2008;29;1783;987;796
Alytus county;2008;30;1724;906;818
Alytus county;2008;31;1919;992;927
Alytus county;2008;32;2025;1088;937
Alytus county;2008;33;1964;1006;958
Alytus county;2008;34;2101;1067;1034
Alytus county;2008;35;2223;1088;1135
Alytus county;2008;36;2296;1144;1152
Alytus county;2008;37;2221;1123;1098
Alytus county;2008;38;2355;1153;1202
Alytus county;2008;39;2439;1190;1249
Alytus county;2008;40;2480;1256;1224
Alytus county;2008;41;2451;1254;1197
Alytus county;2008;42;2445;1205;1240
Alytus county;2008;43;2579;1310;1269
Alytus county;2008;44;2608;1324;1284
Alytus county;2008;45;2688;1330;1358
Alytus county;2008;46;2719;1317;1402
Alytus county;2008;47;2889;1447;1442
Alytus county;2008;48;2762;1354;1408
Alytus county;2008;49;2746;1346;1400
Alytus county;2008;50;2441;1228;1213
Alytus county;2008;51;2129;1001;1128
Alytus county;2008;52;2178;1014;1164
Alytus county;2008;53;2056;990;1066
Alytus county;2008;54;1992;944;1048
Alytus county;2008;55;2101;960;1141
Alytus county;2008;56;2037;925;1112
Alytus county;2008;57;1983;921;1062
Alytus county;2008;58;2123;931;1192
Alytus county;2008;59;1884;866;1018
Alytus county;2008;60;1681;745;936
Alytus county;2008;61;1608;711;897
Alytus county;2008;62;1800;819;981
Alytus county;2008;63;1557;681;876
Alytus county;2008;64;1839;817;1022
Alytus county;2008;65;1834;749;1085
Alytus county;2008;66;1810;750;1060
Alytus county;2008;67;1771;701;1070
Alytus county;2008;68;1727;683;1044
Alytus county;2008;69;1858;750;1108
Alytus county;2008;70;1747;684;1063
Alytus county;2008;71;1845;674;1171
Alytus county;2008;72;1757;665;1092
Alytus county;2008;73;1580;587;993
Alytus county;2008;74;1557;587;970
Alytus county;2008;75;1583;548;1035
Alytus county;2008;76;1509;479;1030
Alytus county;2008;77;1550;496;1054
Alytus county;2008;78;1327;412;915
Alytus county;2008;79;1288;379;909
Alytus county;2008;80;1166;340;826
Alytus county;2008;81;980;264;716
Alytus county;2008;82;942;238;704
Alytus county;2008;83;841;232;609
Alytus county;2008;84;671;168;503
Alytus county;2008;85;2449;547;1902
Alytus county;2009;-1;167603;78542;89061
Alytus county;2009;0;1379;701;678
Alytus county;2009;1;1349;688;661
Alytus county;2009;2;1440;740;700
Alytus county;2009;3;1416;699;717
Alytus county;2009;4;1400;700;700
Alytus county;2009;5;1470;722;748
Alytus county;2009;6;1438;719;719
Alytus county;2009;7;1578;781;797
Alytus county;2009;8;1702;851;851
Alytus county;2009;9;1822;920;902
Alytus county;2009;10;1865;953;912
Alytus county;2009;11;1879;994;885
Alytus county;2009;12;1966;990;976
Alytus county;2009;13;2131;1055;1076
Alytus county;2009;14;2290;1159;1131
Alytus county;2009;15;2480;1285;1195
Alytus county;2009;16;2760;1364;1396
Alytus county;2009;17;2851;1454;1397
Alytus county;2009;18;2724;1392;1332
Alytus county;2009;19;2627;1324;1303
Alytus county;2009;20;2523;1333;1190
Alytus county;2009;21;2575;1311;1264
Alytus county;2009;22;2623;1340;1283
Alytus county;2009;23;2492;1246;1246
Alytus county;2009;24;2397;1223;1174
Alytus county;2009;25;2380;1217;1163
Alytus county;2009;26;1805;955;850
Alytus county;2009;27;1622;942;680
Alytus county;2009;28;1478;823;655
Alytus county;2009;29;1592;918;674
Alytus county;2009;30;1733;961;772
Alytus county;2009;31;1692;891;801
Alytus county;2009;32;1860;964;896
Alytus county;2009;33;1965;1047;918
Alytus county;2009;34;1924;986;938
Alytus county;2009;35;2055;1041;1014
Alytus county;2009;36;2187;1075;1112
Alytus county;2009;37;2256;1119;1137
Alytus county;2009;38;2185;1096;1089
Alytus county;2009;39;2334;1137;1197
Alytus county;2009;40;2405;1164;1241
Alytus county;2009;41;2454;1231;1223
Alytus county;2009;42;2425;1235;1190
Alytus county;2009;43;2412;1185;1227
Alytus county;2009;44;2544;1288;1256
Alytus county;2009;45;2567;1297;1270
Alytus county;2009;46;2654;1301;1353
Alytus county;2009;47;2688;1299;1389
Alytus county;2009;48;2854;1420;1434
Alytus county;2009;49;2724;1333;1391
Alytus county;2009;50;2699;1308;1391
Alytus county;2009;51;2410;1212;1198
Alytus county;2009;52;2094;977;1117
Alytus county;2009;53;2141;990;1151
Alytus county;2009;54;2022;970;1052
Alytus county;2009;55;1946;910;1036
Alytus county;2009;56;2055;929;1126
Alytus county;2009;57;1999;900;1099
Alytus county;2009;58;1960;904;1056
Alytus county;2009;59;2082;900;1182
Alytus county;2009;60;1847;835;1012
Alytus county;2009;61;1650;726;924
Alytus county;2009;62;1584;698;886
Alytus county;2009;63;1766;798;968
Alytus county;2009;64;1515;653;862
Alytus county;2009;65;1802;780;1022
Alytus county;2009;66;1786;719;1067
Alytus county;2009;67;1763;718;1045
Alytus county;2009;68;1724;669;1055
Alytus county;2009;69;1682;651;1031
Alytus county;2009;70;1799;715;1084
Alytus county;2009;71;1711;664;1047
Alytus county;2009;72;1791;647;1144
Alytus county;2009;73;1693;629;1064
Alytus county;2009;74;1525;551;974
Alytus county;2009;75;1502;561;941
Alytus county;2009;76;1514;507;1007
Alytus county;2009;77;1439;454;985
Alytus county;2009;78;1466;454;1012
Alytus county;2009;79;1260;386;874
Alytus county;2009;80;1197;343;854
Alytus county;2009;81;1083;305;778
Alytus county;2009;82;893;237;656
Alytus county;2009;83;851;209;642
Alytus county;2009;84;773;203;570
Alytus county;2009;85;2607;561;2046
Alytus county;2010;-1;164833;77090;87743
Alytus county;2010;0;1455;721;734
Alytus county;2010;1;1360;690;670
Alytus county;2010;2;1325;677;648
Alytus county;2010;3;1424;732;692
Alytus county;2010;4;1401;684;717
Alytus county;2010;5;1373;686;687
Alytus county;2010;6;1455;713;742
Alytus county;2010;7;1434;715;719
Alytus county;2010;8;1566;774;792
Alytus county;2010;9;1681;842;839
Alytus county;2010;10;1802;906;896
Alytus county;2010;11;1853;950;903
Alytus county;2010;12;1866;984;882
Alytus county;2010;13;1957;983;974
Alytus county;2010;14;2122;1057;1065
Alytus county;2010;15;2275;1149;1126
Alytus county;2010;16;2456;1271;1185
Alytus county;2010;17;2740;1352;1388
Alytus county;2010;18;2825;1448;1377
Alytus county;2010;19;2688;1377;1311
Alytus county;2010;20;2570;1296;1274
Alytus county;2010;21;2458;1299;1159
Alytus county;2010;22;2488;1269;1219
Alytus county;2010;23;2531;1294;1237
Alytus county;2010;24;2388;1197;1191
Alytus county;2010;25;2309;1186;1123
Alytus county;2010;26;2251;1153;1098
Alytus county;2010;27;1705;905;800
Alytus county;2010;28;1545;900;645
Alytus county;2010;29;1421;798;623
Alytus county;2010;30;1530;883;647
Alytus county;2010;31;1672;928;744
Alytus county;2010;32;1656;868;788
Alytus county;2010;33;1809;940;869
Alytus county;2010;34;1917;1019;898
Alytus county;2010;35;1883;969;914
Alytus county;2010;36;2009;1032;977
Alytus county;2010;37;2151;1051;1100
Alytus county;2010;38;2222;1104;1118
Alytus county;2010;39;2146;1076;1070
Alytus county;2010;40;2297;1110;1187
Alytus county;2010;41;2372;1147;1225
Alytus county;2010;42;2419;1208;1211
Alytus county;2010;43;2398;1214;1184
Alytus county;2010;44;2375;1163;1212
Alytus county;2010;45;2498;1259;1239
Alytus county;2010;46;2527;1272;1255
Alytus county;2010;47;2616;1280;1336
Alytus county;2010;48;2658;1284;1374
Alytus county;2010;49;2815;1398;1417
Alytus county;2010;50;2682;1300;1382
Alytus county;2010;51;2668;1289;1379
Alytus county;2010;52;2393;1203;1190
Alytus county;2010;53;2068;963;1105
Alytus county;2010;54;2102;966;1136
Alytus county;2010;55;1992;951;1041
Alytus county;2010;56;1912;890;1022
Alytus county;2010;57;2023;905;1118
Alytus county;2010;58;1963;875;1088
Alytus county;2010;59;1920;879;1041
Alytus county;2010;60;2052;878;1174
Alytus county;2010;61;1810;805;1005
Alytus county;2010;62;1623;704;919
Alytus county;2010;63;1553;675;878
Alytus county;2010;64;1714;759;955
Alytus county;2010;65;1477;624;853
Alytus county;2010;66;1761;747;1014
Alytus county;2010;67;1729;677;1052
Alytus county;2010;68;1717;690;1027
Alytus county;2010;69;1673;640;1033
Alytus county;2010;70;1635;621;1014
Alytus county;2010;71;1753;685;1068
Alytus county;2010;72;1661;628;1033
Alytus county;2010;73;1735;621;1114
Alytus county;2010;74;1638;596;1042
Alytus county;2010;75;1472;525;947
Alytus county;2010;76;1439;526;913
Alytus county;2010;77;1451;461;990
Alytus county;2010;78;1358;424;934
Alytus county;2010;79;1380;418;962
Alytus county;2010;80;1167;346;821
Alytus county;2010;81;1113;305;808
Alytus county;2010;82;996;275;721
Alytus county;2010;83;809;203;606
Alytus county;2010;84;764;183;581
Alytus county;2010;85;2936;640;2296
Alytus county;2011;-1;158403;74004;84399
Alytus county;2011;0;1198;637;561
Alytus county;2011;1;1293;668;625
Alytus county;2011;2;1230;621;609
Alytus county;2011;3;1149;592;557
Alytus county;2011;4;1270;653;617
Alytus county;2011;5;1270;632;638
Alytus county;2011;6;1285;640;645
Alytus county;2011;7;1374;685;689
Alytus county;2011;8;1356;687;669
Alytus county;2011;9;1504;750;754
Alytus county;2011;10;1661;828;833
Alytus county;2011;11;1757;868;889
Alytus county;2011;12;1809;932;877
Alytus county;2011;13;1829;971;858
Alytus county;2011;14;1913;963;950
Alytus county;2011;15;2071;1028;1043
Alytus county;2011;16;2216;1125;1091
Alytus county;2011;17;2395;1236;1159
Alytus county;2011;18;2669;1316;1353
Alytus county;2011;19;2360;1262;1098
Alytus county;2011;20;2187;1191;996
Alytus county;2011;21;2118;1124;994
Alytus county;2011;22;2024;1131;893
Alytus county;2011;23;1986;1064;922
Alytus county;2011;24;1995;1089;906
Alytus county;2011;25;1811;970;841
Alytus county;2011;26;1713;921;792
Alytus county;2011;27;1721;926;795
Alytus county;2011;28;1579;834;745
Alytus county;2011;29;1628;874;754
Alytus county;2011;30;1561;801;760
Alytus county;2011;31;1563;836;727
Alytus county;2011;32;1659;880;779
Alytus county;2011;33;1704;868;836
Alytus county;2011;34;1858;931;927
Alytus county;2011;35;1934;993;941
Alytus county;2011;36;1941;963;978
Alytus county;2011;37;2017;994;1023
Alytus county;2011;38;2192;1056;1136
Alytus county;2011;39;2286;1116;1170
Alytus county;2011;40;2225;1138;1087
Alytus county;2011;41;2350;1127;1223
Alytus county;2011;42;2409;1165;1244
Alytus county;2011;43;2449;1210;1239
Alytus county;2011;44;2401;1216;1185
Alytus county;2011;45;2389;1160;1229
Alytus county;2011;46;2500;1258;1242
Alytus county;2011;47;2558;1292;1266
Alytus county;2011;48;2657;1314;1343
Alytus county;2011;49;2673;1309;1364
Alytus county;2011;50;2738;1351;1387
Alytus county;2011;51;2672;1304;1368
Alytus county;2011;52;2565;1235;1330
Alytus county;2011;53;2294;1148;1146
Alytus county;2011;54;2081;971;1110
Alytus county;2011;55;2109;958;1151
Alytus county;2011;56;1922;911;1011
Alytus county;2011;57;1928;906;1022
Alytus county;2011;58;2049;906;1143
Alytus county;2011;59;1991;875;1116
Alytus county;2011;60;1950;872;1078
Alytus county;2011;61;1990;848;1142
Alytus county;2011;62;1804;794;1010
Alytus county;2011;63;1610;687;923
Alytus county;2011;64;1491;628;863
Alytus county;2011;65;1720;734;986
Alytus county;2011;66;1509;640;869
Alytus county;2011;67;1732;720;1012
Alytus county;2011;68;1726;676;1050
Alytus county;2011;69;1684;668;1016
Alytus county;2011;70;1634;602;1032
Alytus county;2011;71;1590;594;996
Alytus county;2011;72;1670;630;1040
Alytus county;2011;73;1553;572;981
Alytus county;2011;74;1649;570;1079
Alytus county;2011;75;1541;546;995
Alytus county;2011;76;1395;483;912
Alytus county;2011;77;1394;491;903
Alytus county;2011;78;1358;418;940
Alytus county;2011;79;1265;375;890
Alytus county;2011;80;1283;387;896
Alytus county;2011;81;1074;308;766
Alytus county;2011;82;1025;277;748
Alytus county;2011;83;896;245;651
Alytus county;2011;84;702;161;541
Alytus county;2011;85;3112;668;2444
Alytus county;2012;-1;154980;72327;82653
Alytus county;2012;0;1293;684;609
Alytus county;2012;1;1211;644;567
Alytus county;2012;2;1282;667;615
Alytus county;2012;3;1205;601;604
Alytus county;2012;4;1144;591;553
Alytus county;2012;5;1251;641;610
Alytus county;2012;6;1255;628;627
Alytus county;2012;7;1266;631;635
Alytus county;2012;8;1362;682;680
Alytus county;2012;9;1342;683;659
Alytus county;2012;10;1494;744;750
Alytus county;2012;11;1633;817;816
Alytus county;2012;12;1729;853;876
Alytus county;2012;13;1786;920;866
Alytus county;2012;14;1816;963;853
Alytus county;2012;15;1894;953;941
Alytus county;2012;16;2048;1022;1026
Alytus county;2012;17;2198;1118;1080
Alytus county;2012;18;2357;1214;1143
Alytus county;2012;19;2565;1276;1289
Alytus county;2012;20;2295;1233;1062
Alytus county;2012;21;2108;1147;961
Alytus county;2012;22;1998;1063;935
Alytus county;2012;23;1894;1061;833
Alytus county;2012;24;1859;1009;850
Alytus county;2012;25;1840;1006;834
Alytus county;2012;26;1678;893;785
Alytus county;2012;27;1587;860;727
Alytus county;2012;28;1591;858;733
Alytus county;2012;29;1465;765;700
Alytus county;2012;30;1539;817;722
Alytus county;2012;31;1466;753;713
Alytus county;2012;32;1483;788;695
Alytus county;2012;33;1583;826;757
Alytus county;2012;34;1670;843;827
Alytus county;2012;35;1790;898;892
Alytus county;2012;36;1863;959;904
Alytus county;2012;37;1886;936;950
Alytus county;2012;38;1970;973;997
Alytus county;2012;39;2152;1030;1122
Alytus county;2012;40;2245;1096;1149
Alytus county;2012;41;2186;1117;1069
Alytus county;2012;42;2307;1107;1200
Alytus county;2012;43;2365;1142;1223
Alytus county;2012;44;2402;1178;1224
Alytus county;2012;45;2367;1191;1176
Alytus county;2012;46;2359;1145;1214
Alytus county;2012;47;2458;1238;1220
Alytus county;2012;48;2522;1270;1252
Alytus county;2012;49;2620;1305;1315
Alytus county;2012;50;2637;1291;1346
Alytus county;2012;51;2726;1342;1384
Alytus county;2012;52;2641;1282;1359
Alytus county;2012;53;2527;1216;1311
Alytus county;2012;54;2267;1133;1134
Alytus county;2012;55;2061;956;1105
Alytus county;2012;56;2098;950;1148
Alytus county;2012;57;1903;903;1000
Alytus county;2012;58;1899;886;1013
Alytus county;2012;59;2013;886;1127
Alytus county;2012;60;1969;855;1114
Alytus county;2012;61;1926;855;1071
Alytus county;2012;62;1960;824;1136
Alytus county;2012;63;1775;769;1006
Alytus county;2012;64;1578;660;918
Alytus county;2012;65;1458;603;855
Alytus county;2012;66;1689;715;974
Alytus county;2012;67;1469;610;859
Alytus county;2012;68;1679;680;999
Alytus county;2012;69;1678;642;1036
Alytus county;2012;70;1639;641;998
Alytus county;2012;71;1592;576;1016
Alytus county;2012;72;1550;566;984
Alytus county;2012;73;1615;595;1020
Alytus county;2012;74;1499;541;958
Alytus county;2012;75;1590;541;1049
Alytus county;2012;76;1493;527;966
Alytus county;2012;77;1330;445;885
Alytus county;2012;78;1324;458;866
Alytus county;2012;79;1300;388;912
Alytus county;2012;80;1203;339;864
Alytus county;2012;81;1206;361;845
Alytus county;2012;82;992;282;710
Alytus county;2012;83;937;250;687
Alytus county;2012;84;821;224;597
Alytus county;2012;85;3257;696;2561
Alytus county;2013;-1;152139;70898;81241
Alytus county;2013;0;1369;681;688
Alytus county;2013;1;1281;684;597
Alytus county;2013;2;1174;617;557
Alytus county;2013;3;1246;647;599
Alytus county;2013;4;1163;586;577
Alytus county;2013;5;1117;575;542
Alytus county;2013;6;1227;627;600
Alytus county;2013;7;1233;620;613
Alytus county;2013;8;1248;620;628
Alytus county;2013;9;1349;678;671
Alytus county;2013;10;1325;675;650
Alytus county;2013;11;1486;736;750
Alytus county;2013;12;1617;801;816
Alytus county;2013;13;1717;845;872
Alytus county;2013;14;1772;913;859
Alytus county;2013;15;1804;960;844
Alytus county;2013;16;1880;947;933
Alytus county;2013;17;2050;1026;1024
Alytus county;2013;18;2164;1102;1062
Alytus county;2013;19;2311;1195;1116
Alytus county;2013;20;2499;1237;1262
Alytus county;2013;21;2211;1188;1023
Alytus county;2013;22;2034;1116;918
Alytus county;2013;23;1877;1011;866
Alytus county;2013;24;1846;1045;801
Alytus county;2013;25;1770;958;812
Alytus county;2013;26;1699;938;761
Alytus county;2013;27;1538;824;714
Alytus county;2013;28;1496;815;681
Alytus county;2013;29;1500;824;676
Alytus county;2013;30;1405;740;665
Alytus county;2013;31;1470;774;696
Alytus county;2013;32;1412;724;688
Alytus county;2013;33;1406;745;661
Alytus county;2013;34;1564;815;749
Alytus county;2013;35;1636;824;812
Alytus county;2013;36;1761;884;877
Alytus county;2013;37;1830;937;893
Alytus county;2013;38;1875;930;945
Alytus county;2013;39;1929;942;987
Alytus county;2013;40;2130;1020;1110
Alytus county;2013;41;2207;1077;1130
Alytus county;2013;42;2164;1102;1062
Alytus county;2013;43;2291;1105;1186
Alytus county;2013;44;2340;1117;1223
Alytus county;2013;45;2370;1161;1209
Alytus county;2013;46;2343;1173;1170
Alytus county;2013;47;2350;1136;1214
Alytus county;2013;48;2431;1219;1212
Alytus county;2013;49;2502;1256;1246
Alytus county;2013;50;2599;1288;1311
Alytus county;2013;51;2628;1284;1344
Alytus county;2013;52;2695;1329;1366
Alytus county;2013;53;2606;1257;1349
Alytus county;2013;54;2486;1190;1296
Alytus county;2013;55;2238;1111;1127
Alytus county;2013;56;2043;940;1103
Alytus county;2013;57;2075;935;1140
Alytus county;2013;58;1871;877;994
Alytus county;2013;59;1870;866;1004
Alytus county;2013;60;1982;862;1120
Alytus county;2013;61;1937;833;1104
Alytus county;2013;62;1891;826;1065
Alytus county;2013;63;1921;798;1123
Alytus county;2013;64;1747;750;997
Alytus county;2013;65;1545;634;911
Alytus county;2013;66;1427;580;847
Alytus county;2013;67;1646;682;964
Alytus county;2013;68;1436;587;849
Alytus county;2013;69;1636;656;980
Alytus county;2013;70;1637;617;1020
Alytus county;2013;71;1583;601;982
Alytus county;2013;72;1544;552;992
Alytus county;2013;73;1499;534;965
Alytus county;2013;74;1556;559;997
Alytus county;2013;75;1445;511;934
Alytus county;2013;76;1518;503;1015
Alytus county;2013;77;1433;497;936
Alytus county;2013;78;1277;426;851
Alytus county;2013;79;1242;410;832
Alytus county;2013;80;1226;358;868
Alytus county;2013;81;1112;300;812
Alytus county;2013;82;1131;332;799
Alytus county;2013;83;907;251;656
Alytus county;2013;84;846;223;623
Alytus county;2013;85;3485;767;2718
Alytus county;2014;-1;149851;69911;79940
Alytus county;2014;0;1322;677;645
Alytus county;2014;1;1352;678;674
Alytus county;2014;2;1251;675;576
Alytus county;2014;3;1147;607;540
Alytus county;2014;4;1232;635;597
Alytus county;2014;5;1140;573;567
Alytus county;2014;6;1082;559;523
Alytus county;2014;7;1208;621;587
Alytus county;2014;8;1217;612;605
Alytus county;2014;9;1239;618;621
Alytus county;2014;10;1331;670;661
Alytus county;2014;11;1304;666;638
Alytus county;2014;12;1476;733;743
Alytus county;2014;13;1609;798;811
Alytus county;2014;14;1707;842;865
Alytus county;2014;15;1752;909;843
Alytus county;2014;16;1788;949;839
Alytus county;2014;17;1866;941;925
Alytus county;2014;18;2033;1017;1016
Alytus county;2014;19;2118;1083;1035
Alytus county;2014;20;2243;1153;1090
Alytus county;2014;21;2476;1213;1263
Alytus county;2014;22;2144;1155;989
Alytus county;2014;23;1930;1081;849
Alytus county;2014;24;1802;991;811
Alytus county;2014;25;1780;1007;773
Alytus county;2014;26;1691;917;774
Alytus county;2014;27;1629;911;718
Alytus county;2014;28;1464;799;665
Alytus county;2014;29;1460;814;646
Alytus county;2014;30;1463;814;649
Alytus county;2014;31;1362;728;634
Alytus county;2014;32;1429;754;675
Alytus county;2014;33;1381;704;677
Alytus county;2014;34;1373;724;649
Alytus county;2014;35;1524;792;732
Alytus county;2014;36;1617;812;805
Alytus county;2014;37;1745;875;870
Alytus county;2014;38;1811;931;880
Alytus county;2014;39;1848;922;926
Alytus county;2014;40;1900;929;971
Alytus county;2014;41;2114;1004;1110
Alytus county;2014;42;2173;1059;1114
Alytus county;2014;43;2139;1087;1052
Alytus county;2014;44;2269;1083;1186
Alytus county;2014;45;2313;1101;1212
Alytus county;2014;46;2353;1152;1201
Alytus county;2014;47;2323;1158;1165
Alytus county;2014;48;2336;1128;1208
Alytus county;2014;49;2410;1208;1202
Alytus county;2014;50;2490;1246;1244
Alytus county;2014;51;2583;1276;1307
Alytus county;2014;52;2594;1260;1334
Alytus county;2014;53;2664;1304;1360
Alytus county;2014;54;2583;1243;1340
Alytus county;2014;55;2457;1170;1287
Alytus county;2014;56;2230;1103;1127
Alytus county;2014;57;2025;929;1096
Alytus county;2014;58;2059;920;1139
Alytus county;2014;59;1859;868;991
Alytus county;2014;60;1854;853;1001
Alytus county;2014;61;1953;841;1112
Alytus county;2014;62;1912;816;1096
Alytus county;2014;63;1854;804;1050
Alytus county;2014;64;1882;776;1106
Alytus county;2014;65;1714;728;986
Alytus county;2014;66;1523;616;907
Alytus county;2014;67;1400;568;832
Alytus county;2014;68;1601;656;945
Alytus county;2014;69;1394;567;827
Alytus county;2014;70;1585;620;965
Alytus county;2014;71;1594;589;1005
Alytus county;2014;72;1544;570;974
Alytus county;2014;73;1496;523;973
Alytus county;2014;74;1453;512;941
Alytus county;2014;75;1514;531;983
Alytus county;2014;76;1404;497;907
Alytus county;2014;77;1462;478;984
Alytus county;2014;78;1381;464;917
Alytus county;2014;79;1213;398;815
Alytus county;2014;80;1181;388;793
Alytus county;2014;81;1158;332;826
Alytus county;2014;82;1032;269;763
Alytus county;2014;83;1040;297;743
Alytus county;2014;84;835;217;618
Alytus county;2014;85;3652;813;2839
Alytus county;2015;-1;147809;68887;78922
Alytus county;2015;0;1295;642;653
Alytus county;2015;1;1318;671;647
Alytus county;2015;2;1329;665;664
Alytus county;2015;3;1223;654;569
Alytus county;2015;4;1132;600;532
Alytus county;2015;5;1207;626;581
Alytus county;2015;6;1131;567;564
Alytus county;2015;7;1068;555;513
Alytus county;2015;8;1195;612;583
Alytus county;2015;9;1200;601;599
Alytus county;2015;10;1218;604;614
Alytus county;2015;11;1313;666;647
Alytus county;2015;12;1295;663;632
Alytus county;2015;13;1464;729;735
Alytus county;2015;14;1604;796;808
Alytus county;2015;15;1689;835;854
Alytus county;2015;16;1740;901;839
Alytus county;2015;17;1784;945;839
Alytus county;2015;18;1852;939;913
Alytus county;2015;19;1986;994;992
Alytus county;2015;20;2078;1068;1010
Alytus county;2015;21;2206;1134;1072
Alytus county;2015;22;2418;1200;1218
Alytus county;2015;23;2091;1123;968
Alytus county;2015;24;1890;1060;830
Alytus county;2015;25;1766;974;792
Alytus county;2015;26;1723;985;738
Alytus county;2015;27;1643;890;753
Alytus county;2015;28;1594;892;702
Alytus county;2015;29;1421;782;639
Alytus county;2015;30;1399;792;607
Alytus county;2015;31;1455;797;658
Alytus county;2015;32;1300;695;605
Alytus county;2015;33;1398;740;658
Alytus county;2015;34;1341;670;671
Alytus county;2015;35;1333;702;631
Alytus county;2015;36;1498;783;715
Alytus county;2015;37;1587;805;782
Alytus county;2015;38;1725;860;865
Alytus county;2015;39;1791;913;878
Alytus county;2015;40;1829;906;923
Alytus county;2015;41;1892;924;968
Alytus county;2015;42;2092;989;1103
Alytus county;2015;43;2159;1051;1108
Alytus county;2015;44;2118;1071;1047
Alytus county;2015;45;2247;1072;1175
Alytus county;2015;46;2297;1092;1205
Alytus county;2015;47;2330;1143;1187
Alytus county;2015;48;2300;1142;1158
Alytus county;2015;49;2307;1101;1206
Alytus county;2015;50;2396;1202;1194
Alytus county;2015;51;2467;1231;1236
Alytus county;2015;52;2565;1270;1295
Alytus county;2015;53;2598;1260;1338
Alytus county;2015;54;2637;1290;1347
Alytus county;2015;55;2560;1228;1332
Alytus county;2015;56;2421;1143;1278
Alytus county;2015;57;2211;1080;1131
Alytus county;2015;58;2009;916;1093
Alytus county;2015;59;2036;900;1136
Alytus county;2015;60;1835;844;991
Alytus county;2015;61;1833;840;993
Alytus county;2015;62;1922;824;1098
Alytus county;2015;63;1888;793;1095
Alytus county;2015;64;1809;775;1034
Alytus county;2015;65;1850;751;1099
Alytus county;2015;66;1675;701;974
Alytus county;2015;67;1495;597;898
Alytus county;2015;68;1361;540;821
Alytus county;2015;69;1578;640;938
Alytus county;2015;70;1359;547;812
Alytus county;2015;71;1544;590;954
Alytus county;2015;72;1548;558;990
Alytus county;2015;73;1501;544;957
Alytus county;2015;74;1450;493;957
Alytus county;2015;75;1411;489;922
Alytus county;2015;76;1450;498;952
Alytus county;2015;77;1342;465;877
Alytus county;2015;78;1393;448;945
Alytus county;2015;79;1321;431;890
Alytus county;2015;80;1134;362;772
Alytus county;2015;81;1102;350;752
Alytus county;2015;82;1084;299;785
Alytus county;2015;83;944;242;702
Alytus county;2015;84;953;263;690
Alytus county;2015;85;3856;862;2994
Alytus county;2016;-1;145109;67486;77623
Alytus county;2016;0;1348;642;706
Alytus county;2016;1;1288;643;645
Alytus county;2016;2;1286;656;630
Alytus county;2016;3;1325;661;664
Alytus county;2016;4;1209;645;564
Alytus county;2016;5;1126;596;530
Alytus county;2016;6;1176;613;563
Alytus county;2016;7;1126;558;568
Alytus county;2016;8;1061;556;505
Alytus county;2016;9;1185;609;576
Alytus county;2016;10;1191;599;592
Alytus county;2016;11;1203;596;607
Alytus county;2016;12;1302;663;639
Alytus county;2016;13;1285;659;626
Alytus county;2016;14;1455;726;729
Alytus county;2016;15;1577;781;796
Alytus county;2016;16;1675;827;848
Alytus county;2016;17;1720;885;835
Alytus county;2016;18;1755;924;831
Alytus county;2016;19;1801;906;895
Alytus county;2016;20;1949;979;970
Alytus county;2016;21;2029;1037;992
Alytus county;2016;22;2152;1096;1056
Alytus county;2016;23;2336;1150;1186
Alytus county;2016;24;1986;1062;924
Alytus county;2016;25;1796;1009;787
Alytus county;2016;26;1680;943;737
Alytus county;2016;27;1647;949;698
Alytus county;2016;28;1540;853;687
Alytus county;2016;29;1506;849;657
Alytus county;2016;30;1369;751;618
Alytus county;2016;31;1332;754;578
Alytus county;2016;32;1369;747;622
Alytus county;2016;33;1248;657;591
Alytus county;2016;34;1353;718;635
Alytus county;2016;35;1318;655;663
Alytus county;2016;36;1300;688;612
Alytus county;2016;37;1459;760;699
Alytus county;2016;38;1558;784;774
Alytus county;2016;39;1695;846;849
Alytus county;2016;40;1754;886;868
Alytus county;2016;41;1816;902;914
Alytus county;2016;42;1863;911;952
Alytus county;2016;43;2068;979;1089
Alytus county;2016;44;2131;1037;1094
Alytus county;2016;45;2074;1046;1028
Alytus county;2016;46;2207;1044;1163
Alytus county;2016;47;2255;1062;1193
Alytus county;2016;48;2295;1125;1170
Alytus county;2016;49;2268;1122;1146
Alytus county;2016;50;2291;1087;1204
Alytus county;2016;51;2366;1178;1188
Alytus county;2016;52;2441;1208;1233
Alytus county;2016;53;2544;1266;1278
Alytus county;2016;54;2563;1245;1318
Alytus county;2016;55;2608;1272;1336
Alytus county;2016;56;2515;1206;1309
Alytus county;2016;57;2394;1124;1270
Alytus county;2016;58;2179;1056;1123
Alytus county;2016;59;1985;893;1092
Alytus county;2016;60;1998;870;1128
Alytus county;2016;61;1806;822;984
Alytus county;2016;62;1812;825;987
Alytus county;2016;63;1896;808;1088
Alytus county;2016;64;1856;771;1085
Alytus county;2016;65;1777;756;1021
Alytus county;2016;66;1809;719;1090
Alytus county;2016;67;1640;678;962
Alytus county;2016;68;1463;579;884
Alytus county;2016;69;1339;528;811
Alytus county;2016;70;1533;612;921
Alytus county;2016;71;1320;526;794
Alytus county;2016;72;1496;559;937
Alytus county;2016;73;1495;527;968
Alytus county;2016;74;1453;517;936
Alytus county;2016;75;1399;462;937
Alytus county;2016;76;1357;460;897
Alytus county;2016;77;1386;470;916
Alytus county;2016;78;1281;428;853
Alytus county;2016;79;1325;416;909
Alytus county;2016;80;1252;399;853
Alytus county;2016;81;1073;334;739
Alytus county;2016;82;1031;315;716
Alytus county;2016;83;998;267;731
Alytus county;2016;84;857;212;645
Alytus county;2016;85;4124;945;3179
Alytus county;2017;-1;141616;65876;75740
Alytus county;2017;0;1230;642;588
Alytus county;2017;1;1323;623;700
Alytus county;2017;2;1259;626;633
Alytus county;2017;3;1254;640;614
Alytus county;2017;4;1295;647;648
Alytus county;2017;5;1188;638;550
Alytus county;2017;6;1099;582;517
Alytus county;2017;7;1150;601;549
Alytus county;2017;8;1103;550;553
Alytus county;2017;9;1056;550;506
Alytus county;2017;10;1174;605;569
Alytus county;2017;11;1167;593;574
Alytus county;2017;12;1196;589;607
Alytus county;2017;13;1286;659;627
Alytus county;2017;14;1265;648;617
Alytus county;2017;15;1436;718;718
Alytus county;2017;16;1551;768;783
Alytus county;2017;17;1659;818;841
Alytus county;2017;18;1688;880;808
Alytus county;2017;19;1690;896;794
Alytus county;2017;20;1740;873;867
Alytus county;2017;21;1883;950;933
Alytus county;2017;22;1957;997;960
Alytus county;2017;23;2060;1065;995
Alytus county;2017;24;2215;1116;1099
Alytus county;2017;25;1866;1016;850
Alytus county;2017;26;1651;952;699
Alytus county;2017;27;1569;905;664
Alytus county;2017;28;1519;887;632
Alytus county;2017;29;1419;787;632
Alytus county;2017;30;1398;795;603
Alytus county;2017;31;1249;689;560
Alytus county;2017;32;1239;714;525
Alytus county;2017;33;1310;706;604
Alytus county;2017;34;1198;632;566
Alytus county;2017;35;1279;668;611
Alytus county;2017;36;1266;627;639
Alytus county;2017;37;1261;663;598
Alytus county;2017;38;1419;732;687
Alytus county;2017;39;1524;764;760
Alytus county;2017;40;1651;827;824
Alytus county;2017;41;1705;852;853
Alytus county;2017;42;1785;889;896
Alytus county;2017;43;1816;881;935
Alytus county;2017;44;2036;963;1073
Alytus county;2017;45;2096;1024;1072
Alytus county;2017;46;2047;1031;1016
Alytus county;2017;47;2174;1029;1145
Alytus county;2017;48;2217;1031;1186
Alytus county;2017;49;2274;1107;1167
Alytus county;2017;50;2229;1091;1138
Alytus county;2017;51;2263;1070;1193
Alytus county;2017;52;2354;1170;1184
Alytus county;2017;53;2410;1191;1219
Alytus county;2017;54;2501;1233;1268
Alytus county;2017;55;2513;1215;1298
Alytus county;2017;56;2580;1258;1322
Alytus county;2017;57;2484;1191;1293
Alytus county;2017;58;2354;1098;1256
Alytus county;2017;59;2142;1028;1114
Alytus county;2017;60;1956;869;1087
Alytus county;2017;61;1955;836;1119
Alytus county;2017;62;1774;793;981
Alytus county;2017;63;1790;811;979
Alytus county;2017;64;1858;782;1076
Alytus county;2017;65;1824;745;1079
Alytus county;2017;66;1743;732;1011
Alytus county;2017;67;1771;698;1073
Alytus county;2017;68;1614;660;954
Alytus county;2017;69;1443;567;876
Alytus county;2017;70;1312;509;803
Alytus county;2017;71;1491;578;913
Alytus county;2017;72;1292;502;790
Alytus county;2017;73;1448;529;919
Alytus county;2017;74;1444;496;948
Alytus county;2017;75;1391;483;908
Alytus county;2017;76;1347;438;909
Alytus county;2017;77;1302;432;870
Alytus county;2017;78;1329;436;893
Alytus county;2017;79;1219;403;816
Alytus county;2017;80;1254;382;872
Alytus county;2017;81;1171;374;797
Alytus county;2017;82;1006;309;697
Alytus county;2017;83;961;286;675
Alytus county;2017;84;934;247;687
Alytus county;2017;85;4265;989;3276
Alytus county;2018;-1;138095;64263;73832
Alytus county;2018;0;1234;641;593
Alytus county;2018;1;1209;629;580
Alytus county;2018;2;1281;607;674
Alytus county;2018;3;1242;611;631
Alytus county;2018;4;1221;620;601
Alytus county;2018;5;1276;641;635
Alytus county;2018;6;1169;629;540
Alytus county;2018;7;1083;574;509
Alytus county;2018;8;1136;595;541
Alytus county;2018;9;1087;542;545
Alytus county;2018;10;1043;547;496
Alytus county;2018;11;1158;596;562
Alytus county;2018;12;1151;585;566
Alytus county;2018;13;1184;581;603
Alytus county;2018;14;1278;655;623
Alytus county;2018;15;1253;638;615
Alytus county;2018;16;1419;706;713
Alytus county;2018;17;1541;762;779
Alytus county;2018;18;1628;804;824
Alytus county;2018;19;1603;845;758
Alytus county;2018;20;1615;851;764
Alytus county;2018;21;1660;823;837
Alytus county;2018;22;1766;900;866
Alytus county;2018;23;1840;941;899
Alytus county;2018;24;1932;1007;925
Alytus county;2018;25;2029;1035;994
Alytus county;2018;26;1718;951;767
Alytus county;2018;27;1490;872;618
Alytus county;2018;28;1439;835;604
Alytus county;2018;29;1396;833;563
Alytus county;2018;30;1307;741;566
Alytus county;2018;31;1284;722;562
Alytus county;2018;32;1202;673;529
Alytus county;2018;33;1169;670;499
Alytus county;2018;34;1254;672;582
Alytus county;2018;35;1157;602;555
Alytus county;2018;36;1235;648;587
Alytus county;2018;37;1234;615;619
Alytus county;2018;38;1233;645;588
Alytus county;2018;39;1363;691;672
Alytus county;2018;40;1497;750;747
Alytus county;2018;41;1631;826;805
Alytus county;2018;42;1662;829;833
Alytus county;2018;43;1755;877;878
Alytus county;2018;44;1796;875;921
Alytus county;2018;45;2010;950;1060
Alytus county;2018;46;2073;1012;1061
Alytus county;2018;47;2025;1025;1000
Alytus county;2018;48;2158;1021;1137
Alytus county;2018;49;2196;1025;1171
Alytus county;2018;50;2255;1095;1160
Alytus county;2018;51;2195;1070;1125
Alytus county;2018;52;2237;1058;1179
Alytus county;2018;53;2340;1162;1178
Alytus county;2018;54;2377;1167;1210
Alytus county;2018;55;2479;1220;1259
Alytus county;2018;56;2496;1203;1293
Alytus county;2018;57;2543;1233;1310
Alytus county;2018;58;2466;1179;1287
Alytus county;2018;59;2338;1085;1253
Alytus county;2018;60;2107;1003;1104
Alytus county;2018;61;1933;851;1082
Alytus county;2018;62;1931;812;1119
Alytus county;2018;63;1759;781;978
Alytus county;2018;64;1761;794;967
Alytus county;2018;65;1837;768;1069
Alytus county;2018;66;1787;718;1069
Alytus county;2018;67;1714;715;999
Alytus county;2018;68;1728;677;1051
Alytus county;2018;69;1584;639;945
Alytus county;2018;70;1397;542;855
Alytus county;2018;71;1274;484;790
Alytus county;2018;72;1451;554;897
Alytus county;2018;73;1261;488;773
Alytus county;2018;74;1412;510;902
Alytus county;2018;75;1389;467;922
Alytus county;2018;76;1339;454;885
Alytus county;2018;77;1293;410;883
Alytus county;2018;78;1242;405;837
Alytus county;2018;79;1257;395;862
Alytus county;2018;80;1131;362;769
Alytus county;2018;81;1178;347;831
Alytus county;2018;82;1085;332;753
Alytus county;2018;83;911;269;642
Alytus county;2018;84;880;258;622
Alytus county;2018;85;4406;1031;3375
Alytus d. mun.;2001;-1;32644;16030;16614
Alytus d. mun.;2001;0;306;144;162
Alytus d. mun.;2001;1;316;165;151
Alytus d. mun.;2001;2;321;167;154
Alytus d. mun.;2001;3;315;165;150
Alytus d. mun.;2001;4;333;170;163
Alytus d. mun.;2001;5;373;191;182
Alytus d. mun.;2001;6;364;190;174
Alytus d. mun.;2001;7;412;230;182
Alytus d. mun.;2001;8;467;234;233
Alytus d. mun.;2001;9;533;263;270
Alytus d. mun.;2001;10;480;228;252
Alytus d. mun.;2001;11;477;247;230
Alytus d. mun.;2001;12;504;272;232
Alytus d. mun.;2001;13;518;291;227
Alytus d. mun.;2001;14;505;288;217
Alytus d. mun.;2001;15;516;278;238
Alytus d. mun.;2001;16;485;258;227
Alytus d. mun.;2001;17;523;277;246
Alytus d. mun.;2001;18;412;238;174
Alytus d. mun.;2001;19;325;206;119
Alytus d. mun.;2001;20;325;177;148
Alytus d. mun.;2001;21;318;174;144
Alytus d. mun.;2001;22;309;191;118
Alytus d. mun.;2001;23;275;150;125
Alytus d. mun.;2001;24;284;148;136
Alytus d. mun.;2001;25;314;184;130
Alytus d. mun.;2001;26;296;167;129
Alytus d. mun.;2001;27;320;181;139
Alytus d. mun.;2001;28;328;182;146
Alytus d. mun.;2001;29;374;200;174
Alytus d. mun.;2001;30;369;216;153
Alytus d. mun.;2001;31;398;198;200
Alytus d. mun.;2001;32;356;173;183
Alytus d. mun.;2001;33;452;240;212
Alytus d. mun.;2001;34;411;230;181
Alytus d. mun.;2001;35;449;253;196
Alytus d. mun.;2001;36;451;249;202
Alytus d. mun.;2001;37;443;241;202
Alytus d. mun.;2001;38;432;241;191
Alytus d. mun.;2001;39;480;282;198
Alytus d. mun.;2001;40;510;272;238
Alytus d. mun.;2001;41;481;264;217
Alytus d. mun.;2001;42;420;244;176
Alytus d. mun.;2001;43;438;242;196
Alytus d. mun.;2001;44;343;179;164
Alytus d. mun.;2001;45;356;199;157
Alytus d. mun.;2001;46;359;202;157
Alytus d. mun.;2001;47;343;197;146
Alytus d. mun.;2001;48;335;179;156
Alytus d. mun.;2001;49;317;169;148
Alytus d. mun.;2001;50;335;165;170
Alytus d. mun.;2001;51;359;175;184
Alytus d. mun.;2001;52;335;182;153
Alytus d. mun.;2001;53;293;166;127
Alytus d. mun.;2001;54;300;153;147
Alytus d. mun.;2001;55;381;179;202
Alytus d. mun.;2001;56;293;139;154
Alytus d. mun.;2001;57;383;191;192
Alytus d. mun.;2001;58;410;196;214
Alytus d. mun.;2001;59;422;200;222
Alytus d. mun.;2001;60;383;164;219
Alytus d. mun.;2001;61;364;175;189
Alytus d. mun.;2001;62;461;208;253
Alytus d. mun.;2001;63;403;168;235
Alytus d. mun.;2001;64;438;167;271
Alytus d. mun.;2001;65;470;215;255
Alytus d. mun.;2001;66;412;171;241
Alytus d. mun.;2001;67;529;225;304
Alytus d. mun.;2001;68;492;199;293
Alytus d. mun.;2001;69;486;182;304
Alytus d. mun.;2001;70;506;207;299
Alytus d. mun.;2001;71;452;174;278
Alytus d. mun.;2001;72;421;147;274
Alytus d. mun.;2001;73;362;139;223
Alytus d. mun.;2001;74;375;122;253
Alytus d. mun.;2001;75;373;117;256
Alytus d. mun.;2001;76;318;112;206
Alytus d. mun.;2001;77;311;101;210
Alytus d. mun.;2001;78;288;81;207
Alytus d. mun.;2001;79;224;67;157
Alytus d. mun.;2001;80;197;80;117
Alytus d. mun.;2001;81;153;50;103
Alytus d. mun.;2001;82;109;33;76
Alytus d. mun.;2001;83;102;34;68
Alytus d. mun.;2001;84;116;31;85
Alytus d. mun.;2001;85;617;189;428
Alytus d. mun.;2002;-1;32255;15824;16431
Alytus d. mun.;2002;0;327;167;160
Alytus d. mun.;2002;1;290;134;156
Alytus d. mun.;2002;2;301;158;143
Alytus d. mun.;2002;3;319;168;151
Alytus d. mun.;2002;4;312;163;149
Alytus d. mun.;2002;5;328;168;160
Alytus d. mun.;2002;6;368;194;174
Alytus d. mun.;2002;7;363;194;169
Alytus d. mun.;2002;8;411;228;183
Alytus d. mun.;2002;9;458;228;230
Alytus d. mun.;2002;10;535;263;272
Alytus d. mun.;2002;11;472;221;251
Alytus d. mun.;2002;12;462;242;220
Alytus d. mun.;2002;13;495;268;227
Alytus d. mun.;2002;14;514;291;223
Alytus d. mun.;2002;15;498;283;215
Alytus d. mun.;2002;16;507;273;234
Alytus d. mun.;2002;17;483;258;225
Alytus d. mun.;2002;18;519;274;245
Alytus d. mun.;2002;19;396;231;165
Alytus d. mun.;2002;20;317;200;117
Alytus d. mun.;2002;21;320;177;143
Alytus d. mun.;2002;22;316;171;145
Alytus d. mun.;2002;23;307;191;116
Alytus d. mun.;2002;24;270;143;127
Alytus d. mun.;2002;25;283;146;137
Alytus d. mun.;2002;26;308;180;128
Alytus d. mun.;2002;27;288;162;126
Alytus d. mun.;2002;28;310;179;131
Alytus d. mun.;2002;29;324;178;146
Alytus d. mun.;2002;30;362;194;168
Alytus d. mun.;2002;31;362;211;151
Alytus d. mun.;2002;32;398;198;200
Alytus d. mun.;2002;33;345;170;175
Alytus d. mun.;2002;34;443;239;204
Alytus d. mun.;2002;35;402;224;178
Alytus d. mun.;2002;36;445;250;195
Alytus d. mun.;2002;37;446;248;198
Alytus d. mun.;2002;38;429;233;196
Alytus d. mun.;2002;39;419;229;190
Alytus d. mun.;2002;40;473;274;199
Alytus d. mun.;2002;41;502;268;234
Alytus d. mun.;2002;42;474;261;213
Alytus d. mun.;2002;43;420;244;176
Alytus d. mun.;2002;44;436;241;195
Alytus d. mun.;2002;45;337;177;160
Alytus d. mun.;2002;46;349;194;155
Alytus d. mun.;2002;47;358;199;159
Alytus d. mun.;2002;48;333;189;144
Alytus d. mun.;2002;49;333;175;158
Alytus d. mun.;2002;50;319;168;151
Alytus d. mun.;2002;51;333;162;171
Alytus d. mun.;2002;52;358;174;184
Alytus d. mun.;2002;53;331;182;149
Alytus d. mun.;2002;54;286;161;125
Alytus d. mun.;2002;55;298;150;148
Alytus d. mun.;2002;56;374;174;200
Alytus d. mun.;2002;57;290;138;152
Alytus d. mun.;2002;58;371;186;185
Alytus d. mun.;2002;59;394;188;206
Alytus d. mun.;2002;60;413;194;219
Alytus d. mun.;2002;61;387;166;221
Alytus d. mun.;2002;62;359;169;190
Alytus d. mun.;2002;63;459;209;250
Alytus d. mun.;2002;64;399;162;237
Alytus d. mun.;2002;65;438;168;270
Alytus d. mun.;2002;66;458;211;247
Alytus d. mun.;2002;67;411;171;240
Alytus d. mun.;2002;68;512;212;300
Alytus d. mun.;2002;69;477;190;287
Alytus d. mun.;2002;70;477;177;300
Alytus d. mun.;2002;71;496;202;294
Alytus d. mun.;2002;72;446;171;275
Alytus d. mun.;2002;73;406;142;264
Alytus d. mun.;2002;74;361;138;223
Alytus d. mun.;2002;75;359;114;245
Alytus d. mun.;2002;76;365;117;248
Alytus d. mun.;2002;77;309;106;203
Alytus d. mun.;2002;78;293;91;202
Alytus d. mun.;2002;79;271;72;199
Alytus d. mun.;2002;80;212;60;152
Alytus d. mun.;2002;81;180;69;111
Alytus d. mun.;2002;82;140;44;96
Alytus d. mun.;2002;83;102;29;73
Alytus d. mun.;2002;84;91;30;61
Alytus d. mun.;2002;85;613;176;437
Alytus d. mun.;2003;-1;31828;15563;16265
Alytus d. mun.;2003;0;258;127;131
Alytus d. mun.;2003;1;315;158;157
Alytus d. mun.;2003;2;274;126;148
Alytus d. mun.;2003;3;293;152;141
Alytus d. mun.;2003;4;310;163;147
Alytus d. mun.;2003;5;309;164;145
Alytus d. mun.;2003;6;327;168;159
Alytus d. mun.;2003;7;364;193;171
Alytus d. mun.;2003;8;361;192;169
Alytus d. mun.;2003;9;408;226;182
Alytus d. mun.;2003;10;455;227;228
Alytus d. mun.;2003;11;531;262;269
Alytus d. mun.;2003;12;464;217;247
Alytus d. mun.;2003;13;454;237;217
Alytus d. mun.;2003;14;488;262;226
Alytus d. mun.;2003;15;505;284;221
Alytus d. mun.;2003;16;491;278;213
Alytus d. mun.;2003;17;494;266;228
Alytus d. mun.;2003;18;479;254;225
Alytus d. mun.;2003;19;517;269;248
Alytus d. mun.;2003;20;389;228;161
Alytus d. mun.;2003;21;320;202;118
Alytus d. mun.;2003;22;314;174;140
Alytus d. mun.;2003;23;318;171;147
Alytus d. mun.;2003;24;305;190;115
Alytus d. mun.;2003;25;273;147;126
Alytus d. mun.;2003;26;277;141;136
Alytus d. mun.;2003;27;300;173;127
Alytus d. mun.;2003;28;277;157;120
Alytus d. mun.;2003;29;295;172;123
Alytus d. mun.;2003;30;322;176;146
Alytus d. mun.;2003;31;345;185;160
Alytus d. mun.;2003;32;369;217;152
Alytus d. mun.;2003;33;384;187;197
Alytus d. mun.;2003;34;342;169;173
Alytus d. mun.;2003;35;440;236;204
Alytus d. mun.;2003;36;397;224;173
Alytus d. mun.;2003;37;440;247;193
Alytus d. mun.;2003;38;437;243;194
Alytus d. mun.;2003;39;431;232;199
Alytus d. mun.;2003;40;410;224;186
Alytus d. mun.;2003;41;464;269;195
Alytus d. mun.;2003;42;499;266;233
Alytus d. mun.;2003;43;472;259;213
Alytus d. mun.;2003;44;420;244;176
Alytus d. mun.;2003;45;440;243;197
Alytus d. mun.;2003;46;334;174;160
Alytus d. mun.;2003;47;348;193;155
Alytus d. mun.;2003;48;361;198;163
Alytus d. mun.;2003;49;334;190;144
Alytus d. mun.;2003;50;328;170;158
Alytus d. mun.;2003;51;316;166;150
Alytus d. mun.;2003;52;328;160;168
Alytus d. mun.;2003;53;359;173;186
Alytus d. mun.;2003;54;335;181;154
Alytus d. mun.;2003;55;285;155;130
Alytus d. mun.;2003;56;288;146;142
Alytus d. mun.;2003;57;365;169;196
Alytus d. mun.;2003;58;292;137;155
Alytus d. mun.;2003;59;364;181;183
Alytus d. mun.;2003;60;388;182;206
Alytus d. mun.;2003;61;403;186;217
Alytus d. mun.;2003;62;380;163;217
Alytus d. mun.;2003;63;352;164;188
Alytus d. mun.;2003;64;451;203;248
Alytus d. mun.;2003;65;397;159;238
Alytus d. mun.;2003;66;428;165;263
Alytus d. mun.;2003;67;454;207;247
Alytus d. mun.;2003;68;404;164;240
Alytus d. mun.;2003;69;510;210;300
Alytus d. mun.;2003;70;470;185;285
Alytus d. mun.;2003;71;462;164;298
Alytus d. mun.;2003;72;480;191;289
Alytus d. mun.;2003;73;425;160;265
Alytus d. mun.;2003;74;393;137;256
Alytus d. mun.;2003;75;349;131;218
Alytus d. mun.;2003;76;336;100;236
Alytus d. mun.;2003;77;355;112;243
Alytus d. mun.;2003;78;286;94;192
Alytus d. mun.;2003;79;278;80;198
Alytus d. mun.;2003;80;256;66;190
Alytus d. mun.;2003;81;200;54;146
Alytus d. mun.;2003;82;168;62;106
Alytus d. mun.;2003;83;131;42;89
Alytus d. mun.;2003;84;92;27;65
Alytus d. mun.;2003;85;566;161;405
Alytus d. mun.;2004;-1;31741;15486;16255
Alytus d. mun.;2004;0;285;148;137
Alytus d. mun.;2004;1;256;127;129
Alytus d. mun.;2004;2;317;162;155
Alytus d. mun.;2004;3;276;130;146
Alytus d. mun.;2004;4;292;153;139
Alytus d. mun.;2004;5;316;164;152
Alytus d. mun.;2004;6;310;164;146
Alytus d. mun.;2004;7;332;171;161
Alytus d. mun.;2004;8;366;193;173
Alytus d. mun.;2004;9;363;192;171
Alytus d. mun.;2004;10;412;231;181
Alytus d. mun.;2004;11;456;226;230
Alytus d. mun.;2004;12;529;260;269
Alytus d. mun.;2004;13;459;215;244
Alytus d. mun.;2004;14;448;234;214
Alytus d. mun.;2004;15;482;261;221
Alytus d. mun.;2004;16;494;281;213
Alytus d. mun.;2004;17;483;275;208
Alytus d. mun.;2004;18;491;268;223
Alytus d. mun.;2004;19;474;250;224
Alytus d. mun.;2004;20;510;266;244
Alytus d. mun.;2004;21;391;227;164
Alytus d. mun.;2004;22;318;199;119
Alytus d. mun.;2004;23;309;175;134
Alytus d. mun.;2004;24;314;169;145
Alytus d. mun.;2004;25;299;189;110
Alytus d. mun.;2004;26;263;144;119
Alytus d. mun.;2004;27;273;137;136
Alytus d. mun.;2004;28;282;162;120
Alytus d. mun.;2004;29;275;154;121
Alytus d. mun.;2004;30;290;167;123
Alytus d. mun.;2004;31;309;163;146
Alytus d. mun.;2004;32;341;185;156
Alytus d. mun.;2004;33;357;211;146
Alytus d. mun.;2004;34;386;190;196
Alytus d. mun.;2004;35;349;170;179
Alytus d. mun.;2004;36;439;233;206
Alytus d. mun.;2004;37;397;221;176
Alytus d. mun.;2004;38;445;249;196
Alytus d. mun.;2004;39;441;239;202
Alytus d. mun.;2004;40;431;230;201
Alytus d. mun.;2004;41;409;223;186
Alytus d. mun.;2004;42;467;273;194
Alytus d. mun.;2004;43;498;264;234
Alytus d. mun.;2004;44;479;266;213
Alytus d. mun.;2004;45;433;248;185
Alytus d. mun.;2004;46;438;239;199
Alytus d. mun.;2004;47;339;178;161
Alytus d. mun.;2004;48;358;199;159
Alytus d. mun.;2004;49;365;201;164
Alytus d. mun.;2004;50;336;188;148
Alytus d. mun.;2004;51;335;170;165
Alytus d. mun.;2004;52;311;162;149
Alytus d. mun.;2004;53;323;154;169
Alytus d. mun.;2004;54;364;174;190
Alytus d. mun.;2004;55;331;174;157
Alytus d. mun.;2004;56;291;158;133
Alytus d. mun.;2004;57;294;149;145
Alytus d. mun.;2004;58;368;171;197
Alytus d. mun.;2004;59;295;139;156
Alytus d. mun.;2004;60;363;180;183
Alytus d. mun.;2004;61;386;178;208
Alytus d. mun.;2004;62;398;183;215
Alytus d. mun.;2004;63;377;163;214
Alytus d. mun.;2004;64;348;161;187
Alytus d. mun.;2004;65;451;203;248
Alytus d. mun.;2004;66;393;155;238
Alytus d. mun.;2004;67;427;162;265
Alytus d. mun.;2004;68;449;200;249
Alytus d. mun.;2004;69;404;161;243
Alytus d. mun.;2004;70;494;201;293
Alytus d. mun.;2004;71;460;175;285
Alytus d. mun.;2004;72;452;162;290
Alytus d. mun.;2004;73;472;186;286
Alytus d. mun.;2004;74;400;146;254
Alytus d. mun.;2004;75;379;125;254
Alytus d. mun.;2004;76;339;125;214
Alytus d. mun.;2004;77;324;94;230
Alytus d. mun.;2004;78;344;104;240
Alytus d. mun.;2004;79;273;86;187
Alytus d. mun.;2004;80;266;75;191
Alytus d. mun.;2004;81;242;57;185
Alytus d. mun.;2004;82;183;46;137
Alytus d. mun.;2004;83;150;54;96
Alytus d. mun.;2004;84;125;41;84
Alytus d. mun.;2004;85;548;148;400
Alytus d. mun.;2005;-1;31415;15339;16076
Alytus d. mun.;2005;0;241;131;110
Alytus d. mun.;2005;1;287;151;136
Alytus d. mun.;2005;2;248;123;125
Alytus d. mun.;2005;3;318;166;152
Alytus d. mun.;2005;4;282;133;149
Alytus d. mun.;2005;5;297;159;138
Alytus d. mun.;2005;6;314;161;153
Alytus d. mun.;2005;7;309;162;147
Alytus d. mun.;2005;8;330;171;159
Alytus d. mun.;2005;9;367;194;173
Alytus d. mun.;2005;10;358;191;167
Alytus d. mun.;2005;11;411;232;179
Alytus d. mun.;2005;12;455;224;231
Alytus d. mun.;2005;13;528;258;270
Alytus d. mun.;2005;14;456;215;241
Alytus d. mun.;2005;15;452;235;217
Alytus d. mun.;2005;16;479;260;219
Alytus d. mun.;2005;17;492;280;212
Alytus d. mun.;2005;18;476;269;207
Alytus d. mun.;2005;19;482;267;215
Alytus d. mun.;2005;20;475;249;226
Alytus d. mun.;2005;21;502;263;239
Alytus d. mun.;2005;22;393;228;165
Alytus d. mun.;2005;23;304;189;115
Alytus d. mun.;2005;24;306;174;132
Alytus d. mun.;2005;25;311;166;145
Alytus d. mun.;2005;26;294;185;109
Alytus d. mun.;2005;27;248;134;114
Alytus d. mun.;2005;28;261;131;130
Alytus d. mun.;2005;29;284;159;125
Alytus d. mun.;2005;30;272;151;121
Alytus d. mun.;2005;31;287;166;121
Alytus d. mun.;2005;32;302;160;142
Alytus d. mun.;2005;33;338;185;153
Alytus d. mun.;2005;34;352;208;144
Alytus d. mun.;2005;35;389;192;197
Alytus d. mun.;2005;36;354;172;182
Alytus d. mun.;2005;37;435;229;206
Alytus d. mun.;2005;38;401;220;181
Alytus d. mun.;2005;39;439;243;196
Alytus d. mun.;2005;40;433;236;197
Alytus d. mun.;2005;41;435;237;198
Alytus d. mun.;2005;42;404;215;189
Alytus d. mun.;2005;43;464;271;193
Alytus d. mun.;2005;44;503;268;235
Alytus d. mun.;2005;45;478;266;212
Alytus d. mun.;2005;46;432;246;186
Alytus d. mun.;2005;47;437;238;199
Alytus d. mun.;2005;48;344;181;163
Alytus d. mun.;2005;49;366;202;164
Alytus d. mun.;2005;50;366;197;169
Alytus d. mun.;2005;51;342;188;154
Alytus d. mun.;2005;52;337;169;168
Alytus d. mun.;2005;53;309;165;144
Alytus d. mun.;2005;54;328;157;171
Alytus d. mun.;2005;55;368;174;194
Alytus d. mun.;2005;56;333;175;158
Alytus d. mun.;2005;57;289;158;131
Alytus d. mun.;2005;58;295;149;146
Alytus d. mun.;2005;59;367;171;196
Alytus d. mun.;2005;60;285;134;151
Alytus d. mun.;2005;61;359;177;182
Alytus d. mun.;2005;62;379;174;205
Alytus d. mun.;2005;63;386;171;215
Alytus d. mun.;2005;64;370;155;215
Alytus d. mun.;2005;65;343;159;184
Alytus d. mun.;2005;66;437;191;246
Alytus d. mun.;2005;67;387;156;231
Alytus d. mun.;2005;68;415;159;256
Alytus d. mun.;2005;69;433;191;242
Alytus d. mun.;2005;70;387;153;234
Alytus d. mun.;2005;71;468;185;283
Alytus d. mun.;2005;72;443;163;280
Alytus d. mun.;2005;73;430;146;284
Alytus d. mun.;2005;74;464;179;285
Alytus d. mun.;2005;75;382;137;245
Alytus d. mun.;2005;76;371;123;248
Alytus d. mun.;2005;77;318;115;203
Alytus d. mun.;2005;78;302;82;220
Alytus d. mun.;2005;79;324;97;227
Alytus d. mun.;2005;80;254;79;175
Alytus d. mun.;2005;81;251;69;182
Alytus d. mun.;2005;82;228;52;176
Alytus d. mun.;2005;83;169;39;130
Alytus d. mun.;2005;84;135;45;90
Alytus d. mun.;2005;85;536;159;377
Alytus d. mun.;2006;-1;30786;15003;15783
Alytus d. mun.;2006;0;265;126;139
Alytus d. mun.;2006;1;244;130;114
Alytus d. mun.;2006;2;278;145;133
Alytus d. mun.;2006;3;256;127;129
Alytus d. mun.;2006;4;317;164;153
Alytus d. mun.;2006;5;275;130;145
Alytus d. mun.;2006;6;295;160;135
Alytus d. mun.;2006;7;315;164;151
Alytus d. mun.;2006;8;308;162;146
Alytus d. mun.;2006;9;327;173;154
Alytus d. mun.;2006;10;369;198;171
Alytus d. mun.;2006;11;360;189;171
Alytus d. mun.;2006;12;412;233;179
Alytus d. mun.;2006;13;444;218;226
Alytus d. mun.;2006;14;519;253;266
Alytus d. mun.;2006;15;449;212;237
Alytus d. mun.;2006;16;433;221;212
Alytus d. mun.;2006;17;468;254;214
Alytus d. mun.;2006;18;481;274;207
Alytus d. mun.;2006;19;464;264;200
Alytus d. mun.;2006;20;465;256;209
Alytus d. mun.;2006;21;444;232;212
Alytus d. mun.;2006;22;486;255;231
Alytus d. mun.;2006;23;385;221;164
Alytus d. mun.;2006;24;298;185;113
Alytus d. mun.;2006;25;295;169;126
Alytus d. mun.;2006;26;275;145;130
Alytus d. mun.;2006;27;276;174;102
Alytus d. mun.;2006;28;241;131;110
Alytus d. mun.;2006;29;257;128;129
Alytus d. mun.;2006;30;273;152;121
Alytus d. mun.;2006;31;269;153;116
Alytus d. mun.;2006;32;281;159;122
Alytus d. mun.;2006;33;290;154;136
Alytus d. mun.;2006;34;338;186;152
Alytus d. mun.;2006;35;344;204;140
Alytus d. mun.;2006;36;384;189;195
Alytus d. mun.;2006;37;352;173;179
Alytus d. mun.;2006;38;420;221;199
Alytus d. mun.;2006;39;397;217;180
Alytus d. mun.;2006;40;426;233;193
Alytus d. mun.;2006;41;425;231;194
Alytus d. mun.;2006;42;426;232;194
Alytus d. mun.;2006;43;402;214;188
Alytus d. mun.;2006;44;462;269;193
Alytus d. mun.;2006;45;511;273;238
Alytus d. mun.;2006;46;474;261;213
Alytus d. mun.;2006;47;430;243;187
Alytus d. mun.;2006;48;437;239;198
Alytus d. mun.;2006;49;341;177;164
Alytus d. mun.;2006;50;362;200;162
Alytus d. mun.;2006;51;363;195;168
Alytus d. mun.;2006;52;340;187;153
Alytus d. mun.;2006;53;335;166;169
Alytus d. mun.;2006;54;304;160;144
Alytus d. mun.;2006;55;324;151;173
Alytus d. mun.;2006;56;368;173;195
Alytus d. mun.;2006;57;330;170;160
Alytus d. mun.;2006;58;286;153;133
Alytus d. mun.;2006;59;288;146;142
Alytus d. mun.;2006;60;363;169;194
Alytus d. mun.;2006;61;281;131;150
Alytus d. mun.;2006;62;356;176;180
Alytus d. mun.;2006;63;363;162;201
Alytus d. mun.;2006;64;380;164;216
Alytus d. mun.;2006;65;355;145;210
Alytus d. mun.;2006;66;338;154;184
Alytus d. mun.;2006;67;427;182;245
Alytus d. mun.;2006;68;374;150;224
Alytus d. mun.;2006;69;409;156;253
Alytus d. mun.;2006;70;422;184;238
Alytus d. mun.;2006;71;377;148;229
Alytus d. mun.;2006;72;455;180;275
Alytus d. mun.;2006;73;427;155;272
Alytus d. mun.;2006;74;412;140;272
Alytus d. mun.;2006;75;445;164;281
Alytus d. mun.;2006;76;361;127;234
Alytus d. mun.;2006;77;342;111;231
Alytus d. mun.;2006;78;299;106;193
Alytus d. mun.;2006;79;285;75;210
Alytus d. mun.;2006;80;301;86;215
Alytus d. mun.;2006;81;237;74;163
Alytus d. mun.;2006;82;220;55;165
Alytus d. mun.;2006;83;200;37;163
Alytus d. mun.;2006;84;148;32;116
Alytus d. mun.;2006;85;526;166;360
Alytus d. mun.;2007;-1;30281;14763;15518
Alytus d. mun.;2007;0;241;128;113
Alytus d. mun.;2007;1;263;124;139
Alytus d. mun.;2007;2;226;124;102
Alytus d. mun.;2007;3;274;141;133
Alytus d. mun.;2007;4;250;124;126
Alytus d. mun.;2007;5;312;164;148
Alytus d. mun.;2007;6;269;125;144
Alytus d. mun.;2007;7;298;161;137
Alytus d. mun.;2007;8;313;159;154
Alytus d. mun.;2007;9;304;160;144
Alytus d. mun.;2007;10;329;173;156
Alytus d. mun.;2007;11;372;201;171
Alytus d. mun.;2007;12;362;192;170
Alytus d. mun.;2007;13;414;233;181
Alytus d. mun.;2007;14;443;221;222
Alytus d. mun.;2007;15;516;251;265
Alytus d. mun.;2007;16;440;207;233
Alytus d. mun.;2007;17;431;219;212
Alytus d. mun.;2007;18;462;253;209
Alytus d. mun.;2007;19;470;267;203
Alytus d. mun.;2007;20;446;256;190
Alytus d. mun.;2007;21;459;251;208
Alytus d. mun.;2007;22;431;225;206
Alytus d. mun.;2007;23;466;247;219
Alytus d. mun.;2007;24;377;215;162
Alytus d. mun.;2007;25;289;179;110
Alytus d. mun.;2007;26;277;159;118
Alytus d. mun.;2007;27;259;140;119
Alytus d. mun.;2007;28;268;169;99
Alytus d. mun.;2007;29;226;127;99
Alytus d. mun.;2007;30;246;127;119
Alytus d. mun.;2007;31;278;150;128
Alytus d. mun.;2007;32;265;152;113
Alytus d. mun.;2007;33;284;162;122
Alytus d. mun.;2007;34;287;151;136
Alytus d. mun.;2007;35;334;181;153
Alytus d. mun.;2007;36;346;206;140
Alytus d. mun.;2007;37;383;189;194
Alytus d. mun.;2007;38;348;172;176
Alytus d. mun.;2007;39;424;223;201
Alytus d. mun.;2007;40;392;210;182
Alytus d. mun.;2007;41;427;236;191
Alytus d. mun.;2007;42;425;225;200
Alytus d. mun.;2007;43;420;226;194
Alytus d. mun.;2007;44;402;213;189
Alytus d. mun.;2007;45;463;269;194
Alytus d. mun.;2007;46;510;270;240
Alytus d. mun.;2007;47;469;256;213
Alytus d. mun.;2007;48;432;248;184
Alytus d. mun.;2007;49;434;237;197
Alytus d. mun.;2007;50;341;178;163
Alytus d. mun.;2007;51;358;196;162
Alytus d. mun.;2007;52;349;184;165
Alytus d. mun.;2007;53;338;184;154
Alytus d. mun.;2007;54;328;162;166
Alytus d. mun.;2007;55;300;157;143
Alytus d. mun.;2007;56;326;152;174
Alytus d. mun.;2007;57;366;172;194
Alytus d. mun.;2007;58;330;170;160
Alytus d. mun.;2007;59;281;151;130
Alytus d. mun.;2007;60;293;147;146
Alytus d. mun.;2007;61;368;171;197
Alytus d. mun.;2007;62;283;131;152
Alytus d. mun.;2007;63;356;174;182
Alytus d. mun.;2007;64;349;154;195
Alytus d. mun.;2007;65;375;158;217
Alytus d. mun.;2007;66;347;137;210
Alytus d. mun.;2007;67;333;152;181
Alytus d. mun.;2007;68;414;173;241
Alytus d. mun.;2007;69;366;146;220
Alytus d. mun.;2007;70;397;150;247
Alytus d. mun.;2007;71;412;178;234
Alytus d. mun.;2007;72;364;139;225
Alytus d. mun.;2007;73;436;169;267
Alytus d. mun.;2007;74;414;148;266
Alytus d. mun.;2007;75;392;130;262
Alytus d. mun.;2007;76;423;153;270
Alytus d. mun.;2007;77;341;120;221
Alytus d. mun.;2007;78;322;104;218
Alytus d. mun.;2007;79;278;94;184
Alytus d. mun.;2007;80;262;66;196
Alytus d. mun.;2007;81;273;75;198
Alytus d. mun.;2007;82;220;63;157
Alytus d. mun.;2007;83;195;50;145
Alytus d. mun.;2007;84;176;29;147
Alytus d. mun.;2007;85;519;148;371
Alytus d. mun.;2008;-1;29773;14466;15307
Alytus d. mun.;2008;0;240;115;125
Alytus d. mun.;2008;1;233;124;109
Alytus d. mun.;2008;2;257;124;133
Alytus d. mun.;2008;3;219;119;100
Alytus d. mun.;2008;4;269;139;130
Alytus d. mun.;2008;5;248;122;126
Alytus d. mun.;2008;6;304;160;144
Alytus d. mun.;2008;7;267;125;142
Alytus d. mun.;2008;8;290;158;132
Alytus d. mun.;2008;9;313;162;151
Alytus d. mun.;2008;10;304;161;143
Alytus d. mun.;2008;11;325;173;152
Alytus d. mun.;2008;12;378;201;177
Alytus d. mun.;2008;13;364;195;169
Alytus d. mun.;2008;14;412;231;181
Alytus d. mun.;2008;15;444;220;224
Alytus d. mun.;2008;16;520;254;266
Alytus d. mun.;2008;17;438;206;232
Alytus d. mun.;2008;18;430;217;213
Alytus d. mun.;2008;19;454;249;205
Alytus d. mun.;2008;20;464;265;199
Alytus d. mun.;2008;21;435;250;185
Alytus d. mun.;2008;22;438;242;196
Alytus d. mun.;2008;23;415;216;199
Alytus d. mun.;2008;24;448;235;213
Alytus d. mun.;2008;25;367;209;158
Alytus d. mun.;2008;26;279;172;107
Alytus d. mun.;2008;27;265;153;112
Alytus d. mun.;2008;28;251;133;118
Alytus d. mun.;2008;29;261;170;91
Alytus d. mun.;2008;30;211;119;92
Alytus d. mun.;2008;31;246;127;119
Alytus d. mun.;2008;32;276;148;128
Alytus d. mun.;2008;33;259;147;112
Alytus d. mun.;2008;34;277;158;119
Alytus d. mun.;2008;35;283;147;136
Alytus d. mun.;2008;36;330;179;151
Alytus d. mun.;2008;37;338;200;138
Alytus d. mun.;2008;38;384;184;200
Alytus d. mun.;2008;39;349;171;178
Alytus d. mun.;2008;40;429;228;201
Alytus d. mun.;2008;41;389;204;185
Alytus d. mun.;2008;42;424;235;189
Alytus d. mun.;2008;43;426;226;200
Alytus d. mun.;2008;44;415;221;194
Alytus d. mun.;2008;45;399;209;190
Alytus d. mun.;2008;46;452;263;189
Alytus d. mun.;2008;47;509;264;245
Alytus d. mun.;2008;48;465;250;215
Alytus d. mun.;2008;49;431;247;184
Alytus d. mun.;2008;50;431;234;197
Alytus d. mun.;2008;51;334;174;160
Alytus d. mun.;2008;52;351;188;163
Alytus d. mun.;2008;53;342;177;165
Alytus d. mun.;2008;54;330;178;152
Alytus d. mun.;2008;55;324;158;166
Alytus d. mun.;2008;56;292;153;139
Alytus d. mun.;2008;57;331;153;178
Alytus d. mun.;2008;58;362;167;195
Alytus d. mun.;2008;59;328;171;157
Alytus d. mun.;2008;60;273;144;129
Alytus d. mun.;2008;61;291;146;145
Alytus d. mun.;2008;62;358;163;195
Alytus d. mun.;2008;63;278;127;151
Alytus d. mun.;2008;64;346;168;178
Alytus d. mun.;2008;65;340;152;188
Alytus d. mun.;2008;66;368;152;216
Alytus d. mun.;2008;67;339;131;208
Alytus d. mun.;2008;68;325;147;178
Alytus d. mun.;2008;69;402;168;234
Alytus d. mun.;2008;70;351;138;213
Alytus d. mun.;2008;71;390;147;243
Alytus d. mun.;2008;72;396;171;225
Alytus d. mun.;2008;73;354;130;224
Alytus d. mun.;2008;74;415;157;258
Alytus d. mun.;2008;75;399;139;260
Alytus d. mun.;2008;76;372;119;253
Alytus d. mun.;2008;77;406;138;268
Alytus d. mun.;2008;78;326;112;214
Alytus d. mun.;2008;79;304;97;207
Alytus d. mun.;2008;80;256;88;168
Alytus d. mun.;2008;81;241;56;185
Alytus d. mun.;2008;82;247;64;183
Alytus d. mun.;2008;83;205;53;152
Alytus d. mun.;2008;84;177;43;134
Alytus d. mun.;2008;85;565;136;429
Alytus d. mun.;2009;-1;29441;14269;15172
Alytus d. mun.;2009;0;222;126;96
Alytus d. mun.;2009;1;242;114;128
Alytus d. mun.;2009;2;233;125;108
Alytus d. mun.;2009;3;254;123;131
Alytus d. mun.;2009;4;221;122;99
Alytus d. mun.;2009;5;262;136;126
Alytus d. mun.;2009;6;236;116;120
Alytus d. mun.;2009;7;303;160;143
Alytus d. mun.;2009;8;268;124;144
Alytus d. mun.;2009;9;288;156;132
Alytus d. mun.;2009;10;315;163;152
Alytus d. mun.;2009;11;304;160;144
Alytus d. mun.;2009;12;329;171;158
Alytus d. mun.;2009;13;383;199;184
Alytus d. mun.;2009;14;373;194;179
Alytus d. mun.;2009;15;413;228;185
Alytus d. mun.;2009;16;442;222;220
Alytus d. mun.;2009;17;525;251;274
Alytus d. mun.;2009;18;440;206;234
Alytus d. mun.;2009;19;430;219;211
Alytus d. mun.;2009;20;453;246;207
Alytus d. mun.;2009;21;458;261;197
Alytus d. mun.;2009;22;436;252;184
Alytus d. mun.;2009;23;435;238;197
Alytus d. mun.;2009;24;411;217;194
Alytus d. mun.;2009;25;442;230;212
Alytus d. mun.;2009;26;353;202;151
Alytus d. mun.;2009;27;276;171;105
Alytus d. mun.;2009;28;256;149;107
Alytus d. mun.;2009;29;242;132;110
Alytus d. mun.;2009;30;258;167;91
Alytus d. mun.;2009;31;213;120;93
Alytus d. mun.;2009;32;243;123;120
Alytus d. mun.;2009;33;281;149;132
Alytus d. mun.;2009;34;261;148;113
Alytus d. mun.;2009;35;272;155;117
Alytus d. mun.;2009;36;281;147;134
Alytus d. mun.;2009;37;331;177;154
Alytus d. mun.;2009;38;338;202;136
Alytus d. mun.;2009;39;388;189;199
Alytus d. mun.;2009;40;350;170;180
Alytus d. mun.;2009;41;430;228;202
Alytus d. mun.;2009;42;383;200;183
Alytus d. mun.;2009;43;415;229;186
Alytus d. mun.;2009;44;419;220;199
Alytus d. mun.;2009;45;412;216;196
Alytus d. mun.;2009;46;398;206;192
Alytus d. mun.;2009;47;455;265;190
Alytus d. mun.;2009;48;509;264;245
Alytus d. mun.;2009;49;459;245;214
Alytus d. mun.;2009;50;431;245;186
Alytus d. mun.;2009;51;430;232;198
Alytus d. mun.;2009;52;328;168;160
Alytus d. mun.;2009;53;348;184;164
Alytus d. mun.;2009;54;338;175;163
Alytus d. mun.;2009;55;327;176;151
Alytus d. mun.;2009;56;320;151;169
Alytus d. mun.;2009;57;299;156;143
Alytus d. mun.;2009;58;330;151;179
Alytus d. mun.;2009;59;359;166;193
Alytus d. mun.;2009;60;319;162;157
Alytus d. mun.;2009;61;273;142;131
Alytus d. mun.;2009;62;291;148;143
Alytus d. mun.;2009;63;353;159;194
Alytus d. mun.;2009;64;265;120;145
Alytus d. mun.;2009;65;337;159;178
Alytus d. mun.;2009;66;332;146;186
Alytus d. mun.;2009;67;358;143;215
Alytus d. mun.;2009;68;329;122;207
Alytus d. mun.;2009;69;316;139;177
Alytus d. mun.;2009;70;390;163;227
Alytus d. mun.;2009;71;340;131;209
Alytus d. mun.;2009;72;388;147;241
Alytus d. mun.;2009;73;385;162;223
Alytus d. mun.;2009;74;341;118;223
Alytus d. mun.;2009;75;401;152;249
Alytus d. mun.;2009;76;378;126;252
Alytus d. mun.;2009;77;359;116;243
Alytus d. mun.;2009;78;388;126;262
Alytus d. mun.;2009;79;304;107;197
Alytus d. mun.;2009;80;279;84;195
Alytus d. mun.;2009;81;234;73;161
Alytus d. mun.;2009;82;222;48;174
Alytus d. mun.;2009;83;226;59;167
Alytus d. mun.;2009;84;185;43;142
Alytus d. mun.;2009;85;597;137;460
Alytus d. mun.;2010;-1;29052;14082;14970
Alytus d. mun.;2010;0;253;117;136
Alytus d. mun.;2010;1;229;131;98
Alytus d. mun.;2010;2;237;112;125
Alytus d. mun.;2010;3;229;122;107
Alytus d. mun.;2010;4;246;114;132
Alytus d. mun.;2010;5;222;122;100
Alytus d. mun.;2010;6;261;131;130
Alytus d. mun.;2010;7;243;117;126
Alytus d. mun.;2010;8;305;163;142
Alytus d. mun.;2010;9;271;129;142
Alytus d. mun.;2010;10;277;150;127
Alytus d. mun.;2010;11;311;162;149
Alytus d. mun.;2010;12;303;157;146
Alytus d. mun.;2010;13;324;169;155
Alytus d. mun.;2010;14;379;193;186
Alytus d. mun.;2010;15;362;188;174
Alytus d. mun.;2010;16;407;224;183
Alytus d. mun.;2010;17;444;222;222
Alytus d. mun.;2010;18;519;251;268
Alytus d. mun.;2010;19;439;205;234
Alytus d. mun.;2010;20;425;215;210
Alytus d. mun.;2010;21;445;243;202
Alytus d. mun.;2010;22;442;257;185
Alytus d. mun.;2010;23;429;246;183
Alytus d. mun.;2010;24;424;233;191
Alytus d. mun.;2010;25;402;214;188
Alytus d. mun.;2010;26;440;230;210
Alytus d. mun.;2010;27;335;194;141
Alytus d. mun.;2010;28;263;162;101
Alytus d. mun.;2010;29;253;152;101
Alytus d. mun.;2010;30;241;133;108
Alytus d. mun.;2010;31;253;164;89
Alytus d. mun.;2010;32;208;116;92
Alytus d. mun.;2010;33;234;112;122
Alytus d. mun.;2010;34;275;148;127
Alytus d. mun.;2010;35;266;148;118
Alytus d. mun.;2010;36;267;158;109
Alytus d. mun.;2010;37;282;147;135
Alytus d. mun.;2010;38;332;178;154
Alytus d. mun.;2010;39;328;197;131
Alytus d. mun.;2010;40;391;193;198
Alytus d. mun.;2010;41;347;169;178
Alytus d. mun.;2010;42;426;229;197
Alytus d. mun.;2010;43;381;199;182
Alytus d. mun.;2010;44;414;228;186
Alytus d. mun.;2010;45;414;221;193
Alytus d. mun.;2010;46;407;214;193
Alytus d. mun.;2010;47;393;201;192
Alytus d. mun.;2010;48;455;265;190
Alytus d. mun.;2010;49;507;261;246
Alytus d. mun.;2010;50;460;247;213
Alytus d. mun.;2010;51;432;247;185
Alytus d. mun.;2010;52;427;231;196
Alytus d. mun.;2010;53;331;167;164
Alytus d. mun.;2010;54;343;179;164
Alytus d. mun.;2010;55;339;175;164
Alytus d. mun.;2010;56;319;171;148
Alytus d. mun.;2010;57;318;145;173
Alytus d. mun.;2010;58;295;153;142
Alytus d. mun.;2010;59;321;146;175
Alytus d. mun.;2010;60;352;163;189
Alytus d. mun.;2010;61;317;160;157
Alytus d. mun.;2010;62;275;144;131
Alytus d. mun.;2010;63;288;144;144
Alytus d. mun.;2010;64;341;150;191
Alytus d. mun.;2010;65;254;112;142
Alytus d. mun.;2010;66;327;152;175
Alytus d. mun.;2010;67;317;135;182
Alytus d. mun.;2010;68;354;143;211
Alytus d. mun.;2010;69;321;117;204
Alytus d. mun.;2010;70;309;134;175
Alytus d. mun.;2010;71;379;152;227
Alytus d. mun.;2010;72;324;117;207
Alytus d. mun.;2010;73;368;138;230
Alytus d. mun.;2010;74;373;156;217
Alytus d. mun.;2010;75;331;113;218
Alytus d. mun.;2010;76;386;145;241
Alytus d. mun.;2010;77;360;111;249
Alytus d. mun.;2010;78;340;114;226
Alytus d. mun.;2010;79;361;116;245
Alytus d. mun.;2010;80;288;97;191
Alytus d. mun.;2010;81;266;76;190
Alytus d. mun.;2010;82;219;70;149
Alytus d. mun.;2010;83;204;44;160
Alytus d. mun.;2010;84;201;55;146
Alytus d. mun.;2010;85;672;157;515
Alytus d. mun.;2011;-1;28210;13682;14528
Alytus d. mun.;2011;0;214;126;88
Alytus d. mun.;2011;1;216;101;115
Alytus d. mun.;2011;2;203;121;82
Alytus d. mun.;2011;3;205;100;105
Alytus d. mun.;2011;4;226;118;108
Alytus d. mun.;2011;5;223;114;109
Alytus d. mun.;2011;6;209;114;95
Alytus d. mun.;2011;7;265;137;128
Alytus d. mun.;2011;8;242;129;113
Alytus d. mun.;2011;9;293;141;152
Alytus d. mun.;2011;10;285;142;143
Alytus d. mun.;2011;11;306;156;150
Alytus d. mun.;2011;12;333;172;161
Alytus d. mun.;2011;13;318;166;152
Alytus d. mun.;2011;14;331;170;161
Alytus d. mun.;2011;15;374;189;185
Alytus d. mun.;2011;16;362;196;166
Alytus d. mun.;2011;17;421;230;191
Alytus d. mun.;2011;18;434;231;203
Alytus d. mun.;2011;19;422;225;197
Alytus d. mun.;2011;20;353;178;175
Alytus d. mun.;2011;21;354;194;160
Alytus d. mun.;2011;22;335;200;135
Alytus d. mun.;2011;23;305;182;123
Alytus d. mun.;2011;24;303;180;123
Alytus d. mun.;2011;25;288;170;118
Alytus d. mun.;2011;26;247;129;118
Alytus d. mun.;2011;27;325;167;158
Alytus d. mun.;2011;28;271;144;127
Alytus d. mun.;2011;29;275;156;119
Alytus d. mun.;2011;30;237;115;122
Alytus d. mun.;2011;31;264;142;122
Alytus d. mun.;2011;32;264;142;122
Alytus d. mun.;2011;33;248;120;128
Alytus d. mun.;2011;34;290;135;155
Alytus d. mun.;2011;35;283;149;134
Alytus d. mun.;2011;36;311;169;142
Alytus d. mun.;2011;37;302;164;138
Alytus d. mun.;2011;38;339;179;160
Alytus d. mun.;2011;39;378;206;172
Alytus d. mun.;2011;40;372;220;152
Alytus d. mun.;2011;41;426;203;223
Alytus d. mun.;2011;42;379;178;201
Alytus d. mun.;2011;43;419;222;197
Alytus d. mun.;2011;44;406;217;189
Alytus d. mun.;2011;45;436;239;197
Alytus d. mun.;2011;46;458;250;208
Alytus d. mun.;2011;47;441;233;208
Alytus d. mun.;2011;48;437;234;203
Alytus d. mun.;2011;49;475;274;201
Alytus d. mun.;2011;50;503;258;245
Alytus d. mun.;2011;51;476;262;214
Alytus d. mun.;2011;52;437;248;189
Alytus d. mun.;2011;53;405;220;185
Alytus d. mun.;2011;54;363;183;180
Alytus d. mun.;2011;55;376;201;175
Alytus d. mun.;2011;56;338;174;164
Alytus d. mun.;2011;57;339;182;157
Alytus d. mun.;2011;58;333;157;176
Alytus d. mun.;2011;59;327;171;156
Alytus d. mun.;2011;60;338;162;176
Alytus d. mun.;2011;61;335;155;180
Alytus d. mun.;2011;62;319;152;167
Alytus d. mun.;2011;63;284;149;135
Alytus d. mun.;2011;64;267;125;142
Alytus d. mun.;2011;65;331;137;194
Alytus d. mun.;2011;66;279;119;160
Alytus d. mun.;2011;67;326;149;177
Alytus d. mun.;2011;68;314;136;178
Alytus d. mun.;2011;69;329;129;200
Alytus d. mun.;2011;70;311;113;198
Alytus d. mun.;2011;71;279;113;166
Alytus d. mun.;2011;72;346;131;215
Alytus d. mun.;2011;73;298;114;184
Alytus d. mun.;2011;74;339;123;216
Alytus d. mun.;2011;75;328;132;196
Alytus d. mun.;2011;76;296;106;190
Alytus d. mun.;2011;77;348;125;223
Alytus d. mun.;2011;78;309;90;219
Alytus d. mun.;2011;79;300;92;208
Alytus d. mun.;2011;80;325;101;224
Alytus d. mun.;2011;81;254;83;171
Alytus d. mun.;2011;82;232;60;172
Alytus d. mun.;2011;83;202;63;139
Alytus d. mun.;2011;84;165;31;134
Alytus d. mun.;2011;85;756;167;589
Alytus d. mun.;2012;-1;27960;13621;14339
Alytus d. mun.;2012;0;241;137;104
Alytus d. mun.;2012;1;233;137;96
Alytus d. mun.;2012;2;218;100;118
Alytus d. mun.;2012;3;207;122;85
Alytus d. mun.;2012;4;208;96;112
Alytus d. mun.;2012;5;233;119;114
Alytus d. mun.;2012;6;223;115;108
Alytus d. mun.;2012;7;215;117;98
Alytus d. mun.;2012;8;265;137;128
Alytus d. mun.;2012;9;246;129;117
Alytus d. mun.;2012;10;294;144;150
Alytus d. mun.;2012;11;279;142;137
Alytus d. mun.;2012;12;309;159;150
Alytus d. mun.;2012;13;334;172;162
Alytus d. mun.;2012;14;325;174;151
Alytus d. mun.;2012;15;332;170;162
Alytus d. mun.;2012;16;371;187;184
Alytus d. mun.;2012;17;373;198;175
Alytus d. mun.;2012;18;424;231;193
Alytus d. mun.;2012;19;418;225;193
Alytus d. mun.;2012;20;419;225;194
Alytus d. mun.;2012;21;353;183;170
Alytus d. mun.;2012;22;341;191;150
Alytus d. mun.;2012;23;329;196;133
Alytus d. mun.;2012;24;282;166;116
Alytus d. mun.;2012;25;282;174;108
Alytus d. mun.;2012;26;272;157;115
Alytus d. mun.;2012;27;225;122;103
Alytus d. mun.;2012;28;309;160;149
Alytus d. mun.;2012;29;268;140;128
Alytus d. mun.;2012;30;274;156;118
Alytus d. mun.;2012;31;225;112;113
Alytus d. mun.;2012;32;267;142;125
Alytus d. mun.;2012;33;267;141;126
Alytus d. mun.;2012;34;244;124;120
Alytus d. mun.;2012;35;288;133;155
Alytus d. mun.;2012;36;275;144;131
Alytus d. mun.;2012;37;306;163;143
Alytus d. mun.;2012;38;304;167;137
Alytus d. mun.;2012;39;344;183;161
Alytus d. mun.;2012;40;378;210;168
Alytus d. mun.;2012;41;374;221;153
Alytus d. mun.;2012;42;426;205;221
Alytus d. mun.;2012;43;378;177;201
Alytus d. mun.;2012;44;416;218;198
Alytus d. mun.;2012;45;408;217;191
Alytus d. mun.;2012;46;430;235;195
Alytus d. mun.;2012;47;455;249;206
Alytus d. mun.;2012;48;445;235;210
Alytus d. mun.;2012;49;437;234;203
Alytus d. mun.;2012;50;473;275;198
Alytus d. mun.;2012;51;506;258;248
Alytus d. mun.;2012;52;470;259;211
Alytus d. mun.;2012;53;440;248;192
Alytus d. mun.;2012;54;405;222;183
Alytus d. mun.;2012;55;363;184;179
Alytus d. mun.;2012;56;379;204;175
Alytus d. mun.;2012;57;334;173;161
Alytus d. mun.;2012;58;334;179;155
Alytus d. mun.;2012;59;332;156;176
Alytus d. mun.;2012;60;329;170;159
Alytus d. mun.;2012;61;339;164;175
Alytus d. mun.;2012;62;334;152;182
Alytus d. mun.;2012;63;316;150;166
Alytus d. mun.;2012;64;286;150;136
Alytus d. mun.;2012;65;265;121;144
Alytus d. mun.;2012;66;330;136;194
Alytus d. mun.;2012;67;274;114;160
Alytus d. mun.;2012;68;324;144;180
Alytus d. mun.;2012;69;308;131;177
Alytus d. mun.;2012;70;325;125;200
Alytus d. mun.;2012;71;305;112;193
Alytus d. mun.;2012;72;270;105;165
Alytus d. mun.;2012;73;334;123;211
Alytus d. mun.;2012;74;284;108;176
Alytus d. mun.;2012;75;323;116;207
Alytus d. mun.;2012;76;321;129;192
Alytus d. mun.;2012;77;273;96;177
Alytus d. mun.;2012;78;331;117;214
Alytus d. mun.;2012;79;298;84;214
Alytus d. mun.;2012;80;284;82;202
Alytus d. mun.;2012;81;304;92;212
Alytus d. mun.;2012;82;233;74;159
Alytus d. mun.;2012;83;209;52;157
Alytus d. mun.;2012;84;184;59;125
Alytus d. mun.;2012;85;772;166;606
Alytus d. mun.;2013;-1;27618;13484;14134
Alytus d. mun.;2013;0;232;117;115
Alytus d. mun.;2013;1;242;139;103
Alytus d. mun.;2013;2;227;133;94
Alytus d. mun.;2013;3;223;104;119
Alytus d. mun.;2013;4;207;123;84
Alytus d. mun.;2013;5;209;99;110
Alytus d. mun.;2013;6;227;111;116
Alytus d. mun.;2013;7;221;115;106
Alytus d. mun.;2013;8;211;112;99
Alytus d. mun.;2013;9;268;138;130
Alytus d. mun.;2013;10;246;128;118
Alytus d. mun.;2013;11;295;142;153
Alytus d. mun.;2013;12;282;140;142
Alytus d. mun.;2013;13;309;159;150
Alytus d. mun.;2013;14;334;172;162
Alytus d. mun.;2013;15;326;174;152
Alytus d. mun.;2013;16;337;175;162
Alytus d. mun.;2013;17;373;189;184
Alytus d. mun.;2013;18;369;194;175
Alytus d. mun.;2013;19;416;229;187
Alytus d. mun.;2013;20;412;221;191
Alytus d. mun.;2013;21;410;220;190
Alytus d. mun.;2013;22;350;182;168
Alytus d. mun.;2013;23;331;189;142
Alytus d. mun.;2013;24;322;197;125
Alytus d. mun.;2013;25;277;163;114
Alytus d. mun.;2013;26;264;166;98
Alytus d. mun.;2013;27;247;148;99
Alytus d. mun.;2013;28;219;127;92
Alytus d. mun.;2013;29;295;152;143
Alytus d. mun.;2013;30;262;138;124
Alytus d. mun.;2013;31;268;155;113
Alytus d. mun.;2013;32;221;110;111
Alytus d. mun.;2013;33;258;139;119
Alytus d. mun.;2013;34;267;144;123
Alytus d. mun.;2013;35;246;123;123
Alytus d. mun.;2013;36;287;131;156
Alytus d. mun.;2013;37;276;147;129
Alytus d. mun.;2013;38;299;156;143
Alytus d. mun.;2013;39;303;170;133
Alytus d. mun.;2013;40;349;188;161
Alytus d. mun.;2013;41;376;208;168
Alytus d. mun.;2013;42;376;223;153
Alytus d. mun.;2013;43;426;206;220
Alytus d. mun.;2013;44;378;175;203
Alytus d. mun.;2013;45;420;222;198
Alytus d. mun.;2013;46;405;213;192
Alytus d. mun.;2013;47;433;239;194
Alytus d. mun.;2013;48;452;247;205
Alytus d. mun.;2013;49;440;230;210
Alytus d. mun.;2013;50;433;228;205
Alytus d. mun.;2013;51;475;275;200
Alytus d. mun.;2013;52;500;254;246
Alytus d. mun.;2013;53;470;259;211
Alytus d. mun.;2013;54;429;244;185
Alytus d. mun.;2013;55;400;216;184
Alytus d. mun.;2013;56;366;182;184
Alytus d. mun.;2013;57;379;202;177
Alytus d. mun.;2013;58;331;171;160
Alytus d. mun.;2013;59;334;177;157
Alytus d. mun.;2013;60;330;153;177
Alytus d. mun.;2013;61;324;167;157
Alytus d. mun.;2013;62;335;160;175
Alytus d. mun.;2013;63;335;156;179
Alytus d. mun.;2013;64;313;149;164
Alytus d. mun.;2013;65;286;151;135
Alytus d. mun.;2013;66;259;117;142
Alytus d. mun.;2013;67;322;130;192
Alytus d. mun.;2013;68;268;107;161
Alytus d. mun.;2013;69;318;142;176
Alytus d. mun.;2013;70;299;126;173
Alytus d. mun.;2013;71;315;118;197
Alytus d. mun.;2013;72;297;107;190
Alytus d. mun.;2013;73;262;103;159
Alytus d. mun.;2013;74;324;115;209
Alytus d. mun.;2013;75;274;102;172
Alytus d. mun.;2013;76;311;111;200
Alytus d. mun.;2013;77;308;122;186
Alytus d. mun.;2013;78;260;91;169
Alytus d. mun.;2013;79;318;106;212
Alytus d. mun.;2013;80;278;77;201
Alytus d. mun.;2013;81;252;68;184
Alytus d. mun.;2013;82;280;81;199
Alytus d. mun.;2013;83;212;66;146
Alytus d. mun.;2013;84;187;48;139
Alytus d. mun.;2013;85;811;181;630
Alytus d. mun.;2014;-1;27347;13372;13975
Alytus d. mun.;2014;0;255;129;126
Alytus d. mun.;2014;1;229;115;114
Alytus d. mun.;2014;2;228;128;100
Alytus d. mun.;2014;3;224;134;90
Alytus d. mun.;2014;4;222;101;121
Alytus d. mun.;2014;5;217;130;87
Alytus d. mun.;2014;6;213;102;111
Alytus d. mun.;2014;7;228;112;116
Alytus d. mun.;2014;8;219;114;105
Alytus d. mun.;2014;9;208;110;98
Alytus d. mun.;2014;10;274;143;131
Alytus d. mun.;2014;11;249;130;119
Alytus d. mun.;2014;12;300;141;159
Alytus d. mun.;2014;13;286;143;143
Alytus d. mun.;2014;14;313;160;153
Alytus d. mun.;2014;15;335;175;160
Alytus d. mun.;2014;16;323;170;153
Alytus d. mun.;2014;17;340;175;165
Alytus d. mun.;2014;18;376;191;185
Alytus d. mun.;2014;19;363;192;171
Alytus d. mun.;2014;20;411;226;185
Alytus d. mun.;2014;21;418;227;191
Alytus d. mun.;2014;22;404;220;184
Alytus d. mun.;2014;23;335;172;163
Alytus d. mun.;2014;24;325;194;131
Alytus d. mun.;2014;25;310;192;118
Alytus d. mun.;2014;26;265;155;110
Alytus d. mun.;2014;27;251;159;92
Alytus d. mun.;2014;28;232;138;94
Alytus d. mun.;2014;29;220;131;89
Alytus d. mun.;2014;30;301;157;144
Alytus d. mun.;2014;31;256;133;123
Alytus d. mun.;2014;32;265;149;116
Alytus d. mun.;2014;33;207;104;103
Alytus d. mun.;2014;34;257;141;116
Alytus d. mun.;2014;35;269;145;124
Alytus d. mun.;2014;36;246;124;122
Alytus d. mun.;2014;37;291;136;155
Alytus d. mun.;2014;38;282;150;132
Alytus d. mun.;2014;39;296;152;144
Alytus d. mun.;2014;40;311;176;135
Alytus d. mun.;2014;41;347;180;167
Alytus d. mun.;2014;42;382;208;174
Alytus d. mun.;2014;43;379;225;154
Alytus d. mun.;2014;44;419;196;223
Alytus d. mun.;2014;45;375;175;200
Alytus d. mun.;2014;46;415;218;197
Alytus d. mun.;2014;47;402;213;189
Alytus d. mun.;2014;48;433;240;193
Alytus d. mun.;2014;49;460;251;209
Alytus d. mun.;2014;50;440;229;211
Alytus d. mun.;2014;51;431;225;206
Alytus d. mun.;2014;52;471;268;203
Alytus d. mun.;2014;53;493;246;247
Alytus d. mun.;2014;54;468;260;208
Alytus d. mun.;2014;55;429;244;185
Alytus d. mun.;2014;56;405;221;184
Alytus d. mun.;2014;57;368;184;184
Alytus d. mun.;2014;58;373;199;174
Alytus d. mun.;2014;59;330;170;160
Alytus d. mun.;2014;60;331;176;155
Alytus d. mun.;2014;61;320;144;176
Alytus d. mun.;2014;62;314;160;154
Alytus d. mun.;2014;63;326;154;172
Alytus d. mun.;2014;64;332;152;180
Alytus d. mun.;2014;65;307;144;163
Alytus d. mun.;2014;66;279;146;133
Alytus d. mun.;2014;67;256;116;140
Alytus d. mun.;2014;68;314;126;188
Alytus d. mun.;2014;69;261;104;157
Alytus d. mun.;2014;70;304;132;172
Alytus d. mun.;2014;71;293;124;169
Alytus d. mun.;2014;72;307;112;195
Alytus d. mun.;2014;73;287;102;185
Alytus d. mun.;2014;74;253;96;157
Alytus d. mun.;2014;75;320;110;210
Alytus d. mun.;2014;76;274;101;173
Alytus d. mun.;2014;77;298;104;194
Alytus d. mun.;2014;78;297;113;184
Alytus d. mun.;2014;79;243;84;159
Alytus d. mun.;2014;80;305;100;205
Alytus d. mun.;2014;81;265;73;192
Alytus d. mun.;2014;82;230;61;169
Alytus d. mun.;2014;83;261;73;188
Alytus d. mun.;2014;84;192;57;135
Alytus d. mun.;2014;85;804;180;624
Alytus d. mun.;2015;-1;27126;13244;13882
Alytus d. mun.;2015;0;240;114;126
Alytus d. mun.;2015;1;247;123;124
Alytus d. mun.;2015;2;234;119;115
Alytus d. mun.;2015;3;216;120;96
Alytus d. mun.;2015;4;230;136;94
Alytus d. mun.;2015;5;216;98;118
Alytus d. mun.;2015;6;220;131;89
Alytus d. mun.;2015;7;210;102;108
Alytus d. mun.;2015;8;231;111;120
Alytus d. mun.;2015;9;215;112;103
Alytus d. mun.;2015;10;203;107;96
Alytus d. mun.;2015;11;272;142;130
Alytus d. mun.;2015;12;251;131;120
Alytus d. mun.;2015;13;303;142;161
Alytus d. mun.;2015;14;283;145;138
Alytus d. mun.;2015;15;313;162;151
Alytus d. mun.;2015;16;333;176;157
Alytus d. mun.;2015;17;328;173;155
Alytus d. mun.;2015;18;335;173;162
Alytus d. mun.;2015;19;372;187;185
Alytus d. mun.;2015;20;348;185;163
Alytus d. mun.;2015;21;406;230;176
Alytus d. mun.;2015;22;409;221;188
Alytus d. mun.;2015;23;397;217;180
Alytus d. mun.;2015;24;335;175;160
Alytus d. mun.;2015;25;306;179;127
Alytus d. mun.;2015;26;306;185;121
Alytus d. mun.;2015;27;263;149;114
Alytus d. mun.;2015;28;259;159;100
Alytus d. mun.;2015;29;226;130;96
Alytus d. mun.;2015;30;217;128;89
Alytus d. mun.;2015;31;300;154;146
Alytus d. mun.;2015;32;231;117;114
Alytus d. mun.;2015;33;262;149;113
Alytus d. mun.;2015;34;203;96;107
Alytus d. mun.;2015;35;245;133;112
Alytus d. mun.;2015;36;264;146;118
Alytus d. mun.;2015;37;245;124;121
Alytus d. mun.;2015;38;284;130;154
Alytus d. mun.;2015;39;295;153;142
Alytus d. mun.;2015;40;301;154;147
Alytus d. mun.;2015;41;317;178;139
Alytus d. mun.;2015;42;350;184;166
Alytus d. mun.;2015;43;380;206;174
Alytus d. mun.;2015;44;382;224;158
Alytus d. mun.;2015;45;420;193;227
Alytus d. mun.;2015;46;377;175;202
Alytus d. mun.;2015;47;423;223;200
Alytus d. mun.;2015;48;395;210;185
Alytus d. mun.;2015;49;425;234;191
Alytus d. mun.;2015;50;455;247;208
Alytus d. mun.;2015;51;436;226;210
Alytus d. mun.;2015;52;435;227;208
Alytus d. mun.;2015;53;475;272;203
Alytus d. mun.;2015;54;495;250;245
Alytus d. mun.;2015;55;464;257;207
Alytus d. mun.;2015;56;422;238;184
Alytus d. mun.;2015;57;410;224;186
Alytus d. mun.;2015;58;368;184;184
Alytus d. mun.;2015;59;376;202;174
Alytus d. mun.;2015;60;330;170;160
Alytus d. mun.;2015;61;331;178;153
Alytus d. mun.;2015;62;320;144;176
Alytus d. mun.;2015;63;322;162;160
Alytus d. mun.;2015;64;317;147;170
Alytus d. mun.;2015;65;328;150;178
Alytus d. mun.;2015;66;308;144;164
Alytus d. mun.;2015;67;276;143;133
Alytus d. mun.;2015;68;244;110;134
Alytus d. mun.;2015;69;308;122;186
Alytus d. mun.;2015;70;255;101;154
Alytus d. mun.;2015;71;294;124;170
Alytus d. mun.;2015;72;289;120;169
Alytus d. mun.;2015;73;294;105;189
Alytus d. mun.;2015;74;280;99;181
Alytus d. mun.;2015;75;247;92;155
Alytus d. mun.;2015;76;311;106;205
Alytus d. mun.;2015;77;264;94;170
Alytus d. mun.;2015;78;286;95;191
Alytus d. mun.;2015;79;283;105;178
Alytus d. mun.;2015;80;232;78;154
Alytus d. mun.;2015;81;290;93;197
Alytus d. mun.;2015;82;248;67;181
Alytus d. mun.;2015;83;212;56;156
Alytus d. mun.;2015;84;241;66;175
Alytus d. mun.;2015;85;857;201;656
Alytus d. mun.;2016;-1;26831;13080;13751
Alytus d. mun.;2016;0;241;109;132
Alytus d. mun.;2016;1;242;117;125
Alytus d. mun.;2016;2;244;120;124
Alytus d. mun.;2016;3;230;119;111
Alytus d. mun.;2016;4;207;119;88
Alytus d. mun.;2016;5;221;127;94
Alytus d. mun.;2016;6;213;96;117
Alytus d. mun.;2016;7;220;130;90
Alytus d. mun.;2016;8;222;110;112
Alytus d. mun.;2016;9;233;112;121
Alytus d. mun.;2016;10;214;113;101
Alytus d. mun.;2016;11;204;105;99
Alytus d. mun.;2016;12;272;145;127
Alytus d. mun.;2016;13;254;133;121
Alytus d. mun.;2016;14;308;147;161
Alytus d. mun.;2016;15;281;139;142
Alytus d. mun.;2016;16;317;167;150
Alytus d. mun.;2016;17;337;175;162
Alytus d. mun.;2016;18;329;173;156
Alytus d. mun.;2016;19;331;168;163
Alytus d. mun.;2016;20;366;178;188
Alytus d. mun.;2016;21;340;179;161
Alytus d. mun.;2016;22;405;227;178
Alytus d. mun.;2016;23;396;218;178
Alytus d. mun.;2016;24;374;201;173
Alytus d. mun.;2016;25;316;166;150
Alytus d. mun.;2016;26;298;180;118
Alytus d. mun.;2016;27;292;176;116
Alytus d. mun.;2016;28;234;135;99
Alytus d. mun.;2016;29;238;146;92
Alytus d. mun.;2016;30;231;131;100
Alytus d. mun.;2016;31;210;121;89
Alytus d. mun.;2016;32;277;146;131
Alytus d. mun.;2016;33;228;117;111
Alytus d. mun.;2016;34;254;143;111
Alytus d. mun.;2016;35;207;97;110
Alytus d. mun.;2016;36;240;130;110
Alytus d. mun.;2016;37;261;142;119
Alytus d. mun.;2016;38;255;123;132
Alytus d. mun.;2016;39;291;131;160
Alytus d. mun.;2016;40;295;151;144
Alytus d. mun.;2016;41;310;163;147
Alytus d. mun.;2016;42;317;177;140
Alytus d. mun.;2016;43;351;184;167
Alytus d. mun.;2016;44;387;205;182
Alytus d. mun.;2016;45;383;226;157
Alytus d. mun.;2016;46;427;198;229
Alytus d. mun.;2016;47;382;179;203
Alytus d. mun.;2016;48;420;219;201
Alytus d. mun.;2016;49;398;215;183
Alytus d. mun.;2016;50;425;234;191
Alytus d. mun.;2016;51;445;244;201
Alytus d. mun.;2016;52;438;223;215
Alytus d. mun.;2016;53;433;226;207
Alytus d. mun.;2016;54;479;276;203
Alytus d. mun.;2016;55;493;250;243
Alytus d. mun.;2016;56;455;250;205
Alytus d. mun.;2016;57;426;238;188
Alytus d. mun.;2016;58;416;228;188
Alytus d. mun.;2016;59;367;183;184
Alytus d. mun.;2016;60;374;199;175
Alytus d. mun.;2016;61;326;164;162
Alytus d. mun.;2016;62;329;174;155
Alytus d. mun.;2016;63;320;142;178
Alytus d. mun.;2016;64;318;159;159
Alytus d. mun.;2016;65;319;149;170
Alytus d. mun.;2016;66;323;144;179
Alytus d. mun.;2016;67;298;135;163
Alytus d. mun.;2016;68;269;142;127
Alytus d. mun.;2016;69;242;108;134
Alytus d. mun.;2016;70;303;117;186
Alytus d. mun.;2016;71;249;98;151
Alytus d. mun.;2016;72;286;118;168
Alytus d. mun.;2016;73;278;112;166
Alytus d. mun.;2016;74;286;100;186
Alytus d. mun.;2016;75;273;93;180
Alytus d. mun.;2016;76;240;89;151
Alytus d. mun.;2016;77;297;97;200
Alytus d. mun.;2016;78;251;88;163
Alytus d. mun.;2016;79;271;87;184
Alytus d. mun.;2016;80;271;98;173
Alytus d. mun.;2016;81;221;73;148
Alytus d. mun.;2016;82;273;81;192
Alytus d. mun.;2016;83;232;60;172
Alytus d. mun.;2016;84;190;51;139
Alytus d. mun.;2016;85;912;222;690
Alytus d. mun.;2017;-1;26563;12989;13574
Alytus d. mun.;2017;0;212;102;110
Alytus d. mun.;2017;1;241;106;135
Alytus d. mun.;2017;2;243;117;126
Alytus d. mun.;2017;3;241;113;128
Alytus d. mun.;2017;4;229;111;118
Alytus d. mun.;2017;5;210;121;89
Alytus d. mun.;2017;6;221;130;91
Alytus d. mun.;2017;7;214;97;117
Alytus d. mun.;2017;8;222;129;93
Alytus d. mun.;2017;9;221;108;113
Alytus d. mun.;2017;10;242;118;124
Alytus d. mun.;2017;11;214;117;97
Alytus d. mun.;2017;12;200;100;100
Alytus d. mun.;2017;13;279;150;129
Alytus d. mun.;2017;14;257;136;121
Alytus d. mun.;2017;15;312;150;162
Alytus d. mun.;2017;16;273;136;137
Alytus d. mun.;2017;17;324;168;156
Alytus d. mun.;2017;18;334;178;156
Alytus d. mun.;2017;19;317;168;149
Alytus d. mun.;2017;20;328;168;160
Alytus d. mun.;2017;21;363;181;182
Alytus d. mun.;2017;22;341;179;162
Alytus d. mun.;2017;23;406;232;174
Alytus d. mun.;2017;24;385;214;171
Alytus d. mun.;2017;25;371;206;165
Alytus d. mun.;2017;26;298;159;139
Alytus d. mun.;2017;27;286;180;106
Alytus d. mun.;2017;28;288;172;116
Alytus d. mun.;2017;29;215;126;89
Alytus d. mun.;2017;30;228;137;91
Alytus d. mun.;2017;31;206;118;88
Alytus d. mun.;2017;32;200;114;86
Alytus d. mun.;2017;33;266;137;129
Alytus d. mun.;2017;34;221;112;109
Alytus d. mun.;2017;35;244;133;111
Alytus d. mun.;2017;36;205;99;106
Alytus d. mun.;2017;37;237;129;108
Alytus d. mun.;2017;38;265;143;122
Alytus d. mun.;2017;39;246;114;132
Alytus d. mun.;2017;40;293;134;159
Alytus d. mun.;2017;41;290;145;145
Alytus d. mun.;2017;42;320;173;147
Alytus d. mun.;2017;43;313;177;136
Alytus d. mun.;2017;44;357;184;173
Alytus d. mun.;2017;45;391;212;179
Alytus d. mun.;2017;46;387;228;159
Alytus d. mun.;2017;47;429;200;229
Alytus d. mun.;2017;48;387;181;206
Alytus d. mun.;2017;49;421;219;202
Alytus d. mun.;2017;50;402;215;187
Alytus d. mun.;2017;51;431;233;198
Alytus d. mun.;2017;52;449;249;200
Alytus d. mun.;2017;53;431;216;215
Alytus d. mun.;2017;54;433;223;210
Alytus d. mun.;2017;55;475;272;203
Alytus d. mun.;2017;56;487;247;240
Alytus d. mun.;2017;57;459;256;203
Alytus d. mun.;2017;58;422;236;186
Alytus d. mun.;2017;59;413;222;191
Alytus d. mun.;2017;60;363;178;185
Alytus d. mun.;2017;61;371;195;176
Alytus d. mun.;2017;62;326;164;162
Alytus d. mun.;2017;63;327;171;156
Alytus d. mun.;2017;64;321;144;177
Alytus d. mun.;2017;65;309;152;157
Alytus d. mun.;2017;66;315;146;169
Alytus d. mun.;2017;67;317;145;172
Alytus d. mun.;2017;68;295;132;163
Alytus d. mun.;2017;69;271;142;129
Alytus d. mun.;2017;70;234;104;130
Alytus d. mun.;2017;71;287;105;182
Alytus d. mun.;2017;72;245;94;151
Alytus d. mun.;2017;73;280;115;165
Alytus d. mun.;2017;74;272;110;162
Alytus d. mun.;2017;75;277;99;178
Alytus d. mun.;2017;76;266;92;174
Alytus d. mun.;2017;77;226;83;143
Alytus d. mun.;2017;78;286;91;195
Alytus d. mun.;2017;79;247;87;160
Alytus d. mun.;2017;80;255;79;176
Alytus d. mun.;2017;81;256;93;163
Alytus d. mun.;2017;82;206;70;136
Alytus d. mun.;2017;83;257;75;182
Alytus d. mun.;2017;84;221;56;165
Alytus d. mun.;2017;85;938;237;701
Alytus d. mun.;2018;-1;26077;12737;13340
Alytus d. mun.;2018;0;234;116;118
Alytus d. mun.;2018;1;213;102;111
Alytus d. mun.;2018;2;233;102;131
Alytus d. mun.;2018;3;244;117;127
Alytus d. mun.;2018;4;232;108;124
Alytus d. mun.;2018;5;239;118;121
Alytus d. mun.;2018;6;209;116;93
Alytus d. mun.;2018;7;225;130;95
Alytus d. mun.;2018;8;215;101;114
Alytus d. mun.;2018;9;223;132;91
Alytus d. mun.;2018;10;215;106;109
Alytus d. mun.;2018;11;236;115;121
Alytus d. mun.;2018;12;223;118;105
Alytus d. mun.;2018;13;199;99;100
Alytus d. mun.;2018;14;277;151;126
Alytus d. mun.;2018;15;257;133;124
Alytus d. mun.;2018;16;316;151;165
Alytus d. mun.;2018;17;272;134;138
Alytus d. mun.;2018;18;319;162;157
Alytus d. mun.;2018;19;324;180;144
Alytus d. mun.;2018;20;312;166;146
Alytus d. mun.;2018;21;325;165;160
Alytus d. mun.;2018;22;344;173;171
Alytus d. mun.;2018;23;318;167;151
Alytus d. mun.;2018;24;376;219;157
Alytus d. mun.;2018;25;358;201;157
Alytus d. mun.;2018;26;330;188;142
Alytus d. mun.;2018;27;260;143;117
Alytus d. mun.;2018;28;269;167;102
Alytus d. mun.;2018;29;260;154;106
Alytus d. mun.;2018;30;197;107;90
Alytus d. mun.;2018;31;216;125;91
Alytus d. mun.;2018;32;195;117;78
Alytus d. mun.;2018;33;186;97;89
Alytus d. mun.;2018;34;262;132;130
Alytus d. mun.;2018;35;221;106;115
Alytus d. mun.;2018;36;249;140;109
Alytus d. mun.;2018;37;199;96;103
Alytus d. mun.;2018;38;232;128;104
Alytus d. mun.;2018;39;253;133;120
Alytus d. mun.;2018;40;247;115;132
Alytus d. mun.;2018;41;295;135;160
Alytus d. mun.;2018;42;281;139;142
Alytus d. mun.;2018;43;320;171;149
Alytus d. mun.;2018;44;318;179;139
Alytus d. mun.;2018;45;357;181;176
Alytus d. mun.;2018;46;392;215;177
Alytus d. mun.;2018;47;382;226;156
Alytus d. mun.;2018;48;428;199;229
Alytus d. mun.;2018;49;389;182;207
Alytus d. mun.;2018;50;419;219;200
Alytus d. mun.;2018;51;404;214;190
Alytus d. mun.;2018;52;429;231;198
Alytus d. mun.;2018;53;459;254;205
Alytus d. mun.;2018;54;431;215;216
Alytus d. mun.;2018;55;431;223;208
Alytus d. mun.;2018;56;476;269;207
Alytus d. mun.;2018;57;492;248;244
Alytus d. mun.;2018;58;457;252;205
Alytus d. mun.;2018;59;421;235;186
Alytus d. mun.;2018;60;408;219;189
Alytus d. mun.;2018;61;364;176;188
Alytus d. mun.;2018;62;369;191;178
Alytus d. mun.;2018;63;324;163;161
Alytus d. mun.;2018;64;331;175;156
Alytus d. mun.;2018;65;321;142;179
Alytus d. mun.;2018;66;308;151;157
Alytus d. mun.;2018;67;309;141;168
Alytus d. mun.;2018;68;310;140;170
Alytus d. mun.;2018;69;294;130;164
Alytus d. mun.;2018;70;260;137;123
Alytus d. mun.;2018;71;220;96;124
Alytus d. mun.;2018;72;284;104;180
Alytus d. mun.;2018;73;240;93;147
Alytus d. mun.;2018;74;272;112;160
Alytus d. mun.;2018;75;268;108;160
Alytus d. mun.;2018;76;265;91;174
Alytus d. mun.;2018;77;256;86;170
Alytus d. mun.;2018;78;210;76;134
Alytus d. mun.;2018;79;271;80;191
Alytus d. mun.;2018;80;233;83;150
Alytus d. mun.;2018;81;247;74;173
Alytus d. mun.;2018;82;243;85;158
Alytus d. mun.;2018;83;179;58;121
Alytus d. mun.;2018;84;233;64;169
Alytus d. mun.;2018;85;963;245;718
Alytus t. mun.;2001;-1;71460;34396;37064
Alytus t. mun.;2001;0;757;395;362
Alytus t. mun.;2001;1;848;412;436
Alytus t. mun.;2001;2;825;409;416
Alytus t. mun.;2001;3;848;463;385
Alytus t. mun.;2001;4;855;416;439
Alytus t. mun.;2001;5;908;450;458
Alytus t. mun.;2001;6;972;504;468
Alytus t. mun.;2001;7;1023;520;503
Alytus t. mun.;2001;8;1158;578;580
Alytus t. mun.;2001;9;1192;613;579
Alytus t. mun.;2001;10;1202;629;573
Alytus t. mun.;2001;11;1166;562;604
Alytus t. mun.;2001;12;1124;585;539
Alytus t. mun.;2001;13;1119;572;547
Alytus t. mun.;2001;14;1244;628;616
Alytus t. mun.;2001;15;1214;599;615
Alytus t. mun.;2001;16;1171;599;572
Alytus t. mun.;2001;17;1261;629;632
Alytus t. mun.;2001;18;994;515;479
Alytus t. mun.;2001;19;977;529;448
Alytus t. mun.;2001;20;941;529;412
Alytus t. mun.;2001;21;952;541;411
Alytus t. mun.;2001;22;1041;577;464
Alytus t. mun.;2001;23;1077;570;507
Alytus t. mun.;2001;24;1180;631;549
Alytus t. mun.;2001;25;1158;629;529
Alytus t. mun.;2001;26;1124;569;555
Alytus t. mun.;2001;27;1168;603;565
Alytus t. mun.;2001;28;1211;591;620
Alytus t. mun.;2001;29;1250;636;614
Alytus t. mun.;2001;30;1109;555;554
Alytus t. mun.;2001;31;1129;557;572
Alytus t. mun.;2001;32;1164;565;599
Alytus t. mun.;2001;33;1136;580;556
Alytus t. mun.;2001;34;1118;552;566
Alytus t. mun.;2001;35;1136;541;595
Alytus t. mun.;2001;36;1209;641;568
Alytus t. mun.;2001;37;1204;590;614
Alytus t. mun.;2001;38;1267;618;649
Alytus t. mun.;2001;39;1244;581;663
Alytus t. mun.;2001;40;1256;602;654
Alytus t. mun.;2001;41;1254;620;634
Alytus t. mun.;2001;42;1260;589;671
Alytus t. mun.;2001;43;1064;498;566
Alytus t. mun.;2001;44;1003;470;533
Alytus t. mun.;2001;45;1007;452;555
Alytus t. mun.;2001;46;962;437;525
Alytus t. mun.;2001;47;1022;489;533
Alytus t. mun.;2001;48;1049;485;564
Alytus t. mun.;2001;49;1069;460;609
Alytus t. mun.;2001;50;955;445;510
Alytus t. mun.;2001;51;1016;420;596
Alytus t. mun.;2001;52;888;399;489
Alytus t. mun.;2001;53;807;392;415
Alytus t. mun.;2001;54;715;324;391
Alytus t. mun.;2001;55;783;398;385
Alytus t. mun.;2001;56;688;312;376
Alytus t. mun.;2001;57;756;373;383
Alytus t. mun.;2001;58;706;340;366
Alytus t. mun.;2001;59;672;323;349
Alytus t. mun.;2001;60;614;281;333
Alytus t. mun.;2001;61;632;272;360
Alytus t. mun.;2001;62;568;221;347
Alytus t. mun.;2001;63;524;245;279
Alytus t. mun.;2001;64;543;229;314
Alytus t. mun.;2001;65;464;215;249
Alytus t. mun.;2001;66;451;189;262
Alytus t. mun.;2001;67;414;185;229
Alytus t. mun.;2001;68;421;161;260
Alytus t. mun.;2001;69;416;150;266
Alytus t. mun.;2001;70;390;151;239
Alytus t. mun.;2001;71;355;132;223
Alytus t. mun.;2001;72;362;114;248
Alytus t. mun.;2001;73;336;114;222
Alytus t. mun.;2001;74;291;86;205
Alytus t. mun.;2001;75;261;75;186
Alytus t. mun.;2001;76;261;74;187
Alytus t. mun.;2001;77;239;82;157
Alytus t. mun.;2001;78;219;65;154
Alytus t. mun.;2001;79;151;41;110
Alytus t. mun.;2001;80;135;33;102
Alytus t. mun.;2001;81;119;30;89
Alytus t. mun.;2001;82;78;15;63
Alytus t. mun.;2001;83;60;17;43
Alytus t. mun.;2001;84;81;12;69
Alytus t. mun.;2001;85;467;116;351
Alytus t. mun.;2002;-1;71261;34120;37141
Alytus t. mun.;2002;0;655;337;318
Alytus t. mun.;2002;1;775;404;371
Alytus t. mun.;2002;2;859;413;446
Alytus t. mun.;2002;3;828;406;422
Alytus t. mun.;2002;4;849;460;389
Alytus t. mun.;2002;5;856;412;444
Alytus t. mun.;2002;6;908;449;459
Alytus t. mun.;2002;7;973;499;474
Alytus t. mun.;2002;8;1019;516;503
Alytus t. mun.;2002;9;1155;571;584
Alytus t. mun.;2002;10;1185;608;577
Alytus t. mun.;2002;11;1197;626;571
Alytus t. mun.;2002;12;1159;554;605
Alytus t. mun.;2002;13;1111;574;537
Alytus t. mun.;2002;14;1104;559;545
Alytus t. mun.;2002;15;1232;618;614
Alytus t. mun.;2002;16;1209;595;614
Alytus t. mun.;2002;17;1156;587;569
Alytus t. mun.;2002;18;1233;617;616
Alytus t. mun.;2002;19;977;498;479
Alytus t. mun.;2002;20;964;523;441
Alytus t. mun.;2002;21;919;514;405
Alytus t. mun.;2002;22;939;521;418
Alytus t. mun.;2002;23;1049;579;470
Alytus t. mun.;2002;24;1064;563;501
Alytus t. mun.;2002;25;1177;630;547
Alytus t. mun.;2002;26;1139;617;522
Alytus t. mun.;2002;27;1112;559;553
Alytus t. mun.;2002;28;1157;587;570
Alytus t. mun.;2002;29;1189;580;609
Alytus t. mun.;2002;30;1232;621;611
Alytus t. mun.;2002;31;1104;552;552
Alytus t. mun.;2002;32;1109;545;564
Alytus t. mun.;2002;33;1153;554;599
Alytus t. mun.;2002;34;1119;564;555
Alytus t. mun.;2002;35;1106;539;567
Alytus t. mun.;2002;36;1120;529;591
Alytus t. mun.;2002;37;1195;627;568
Alytus t. mun.;2002;38;1188;579;609
Alytus t. mun.;2002;39;1245;603;642
Alytus t. mun.;2002;40;1219;564;655
Alytus t. mun.;2002;41;1249;599;650
Alytus t. mun.;2002;42;1246;613;633
Alytus t. mun.;2002;43;1252;584;668
Alytus t. mun.;2002;44;1046;488;558
Alytus t. mun.;2002;45;982;460;522
Alytus t. mun.;2002;46;998;447;551
Alytus t. mun.;2002;47;957;435;522
Alytus t. mun.;2002;48;1001;475;526
Alytus t. mun.;2002;49;1030;475;555
Alytus t. mun.;2002;50;1056;449;607
Alytus t. mun.;2002;51;941;437;504
Alytus t. mun.;2002;52;1014;419;595
Alytus t. mun.;2002;53;871;384;487
Alytus t. mun.;2002;54;791;388;403
Alytus t. mun.;2002;55;700;318;382
Alytus t. mun.;2002;56;764;389;375
Alytus t. mun.;2002;57;677;309;368
Alytus t. mun.;2002;58;737;364;373
Alytus t. mun.;2002;59;698;333;365
Alytus t. mun.;2002;60;670;322;348
Alytus t. mun.;2002;61;612;279;333
Alytus t. mun.;2002;62;629;268;361
Alytus t. mun.;2002;63;561;217;344
Alytus t. mun.;2002;64;522;241;281
Alytus t. mun.;2002;65;534;222;312
Alytus t. mun.;2002;66;460;208;252
Alytus t. mun.;2002;67;456;191;265
Alytus t. mun.;2002;68;405;177;228
Alytus t. mun.;2002;69;414;158;256
Alytus t. mun.;2002;70;411;144;267
Alytus t. mun.;2002;71;387;148;239
Alytus t. mun.;2002;72;345;124;221
Alytus t. mun.;2002;73;346;104;242
Alytus t. mun.;2002;74;325;105;220
Alytus t. mun.;2002;75;283;84;199
Alytus t. mun.;2002;76;263;75;188
Alytus t. mun.;2002;77;264;75;189
Alytus t. mun.;2002;78;236;78;158
Alytus t. mun.;2002;79;213;62;151
Alytus t. mun.;2002;80;139;38;101
Alytus t. mun.;2002;81;127;26;101
Alytus t. mun.;2002;82;107;25;82
Alytus t. mun.;2002;83;71;12;59
Alytus t. mun.;2002;84;51;10;41
Alytus t. mun.;2002;85;481;108;373
Alytus t. mun.;2003;-1;71012;33924;37088
Alytus t. mun.;2003;0;649;341;308
Alytus t. mun.;2003;1;665;342;323
Alytus t. mun.;2003;2;774;400;374
Alytus t. mun.;2003;3;855;408;447
Alytus t. mun.;2003;4;824;403;421
Alytus t. mun.;2003;5;846;459;387
Alytus t. mun.;2003;6;849;408;441
Alytus t. mun.;2003;7;900;444;456
Alytus t. mun.;2003;8;964;495;469
Alytus t. mun.;2003;9;1019;513;506
Alytus t. mun.;2003;10;1148;571;577
Alytus t. mun.;2003;11;1171;598;573
Alytus t. mun.;2003;12;1182;617;565
Alytus t. mun.;2003;13;1143;547;596
Alytus t. mun.;2003;14;1099;563;536
Alytus t. mun.;2003;15;1090;551;539
Alytus t. mun.;2003;16;1217;609;608
Alytus t. mun.;2003;17;1194;583;611
Alytus t. mun.;2003;18;1139;578;561
Alytus t. mun.;2003;19;1209;606;603
Alytus t. mun.;2003;20;946;484;462
Alytus t. mun.;2003;21;948;511;437
Alytus t. mun.;2003;22;917;512;405
Alytus t. mun.;2003;23;932;516;416
Alytus t. mun.;2003;24;1045;570;475
Alytus t. mun.;2003;25;1049;551;498
Alytus t. mun.;2003;26;1154;618;536
Alytus t. mun.;2003;27;1129;606;523
Alytus t. mun.;2003;28;1111;555;556
Alytus t. mun.;2003;29;1148;579;569
Alytus t. mun.;2003;30;1186;580;606
Alytus t. mun.;2003;31;1227;616;611
Alytus t. mun.;2003;32;1088;550;538
Alytus t. mun.;2003;33;1109;551;558
Alytus t. mun.;2003;34;1140;548;592
Alytus t. mun.;2003;35;1101;549;552
Alytus t. mun.;2003;36;1096;532;564
Alytus t. mun.;2003;37;1107;521;586
Alytus t. mun.;2003;38;1195;625;570
Alytus t. mun.;2003;39;1178;576;602
Alytus t. mun.;2003;40;1241;599;642
Alytus t. mun.;2003;41;1217;565;652
Alytus t. mun.;2003;42;1241;594;647
Alytus t. mun.;2003;43;1233;609;624
Alytus t. mun.;2003;44;1249;584;665
Alytus t. mun.;2003;45;1030;477;553
Alytus t. mun.;2003;46;973;456;517
Alytus t. mun.;2003;47;990;444;546
Alytus t. mun.;2003;48;940;426;514
Alytus t. mun.;2003;49;982;463;519
Alytus t. mun.;2003;50;1010;466;544
Alytus t. mun.;2003;51;1038;438;600
Alytus t. mun.;2003;52;929;425;504
Alytus t. mun.;2003;53;1009;418;591
Alytus t. mun.;2003;54;856;378;478
Alytus t. mun.;2003;55;773;380;393
Alytus t. mun.;2003;56;690;308;382
Alytus t. mun.;2003;57;749;378;371
Alytus t. mun.;2003;58;665;303;362
Alytus t. mun.;2003;59;734;362;372
Alytus t. mun.;2003;60;682;325;357
Alytus t. mun.;2003;61;665;322;343
Alytus t. mun.;2003;62;602;270;332
Alytus t. mun.;2003;63;626;268;358
Alytus t. mun.;2003;64;556;212;344
Alytus t. mun.;2003;65;515;233;282
Alytus t. mun.;2003;66;533;220;313
Alytus t. mun.;2003;67;451;202;249
Alytus t. mun.;2003;68;446;182;264
Alytus t. mun.;2003;69;401;172;229
Alytus t. mun.;2003;70;404;148;256
Alytus t. mun.;2003;71;402;136;266
Alytus t. mun.;2003;72;381;142;239
Alytus t. mun.;2003;73;335;116;219
Alytus t. mun.;2003;74;339;98;241
Alytus t. mun.;2003;75;316;101;215
Alytus t. mun.;2003;76;275;75;200
Alytus t. mun.;2003;77;254;69;185
Alytus t. mun.;2003;78;257;69;188
Alytus t. mun.;2003;79;219;65;154
Alytus t. mun.;2003;80;198;58;140
Alytus t. mun.;2003;81;132;35;97
Alytus t. mun.;2003;82;116;20;96
Alytus t. mun.;2003;83;103;27;76
Alytus t. mun.;2003;84;66;10;56
Alytus t. mun.;2003;85;446;90;356
Alytus t. mun.;2004;-1;70053;33395;36658
Alytus t. mun.;2004;0;661;345;316
Alytus t. mun.;2004;1;649;342;307
Alytus t. mun.;2004;2;660;341;319
Alytus t. mun.;2004;3;759;391;368
Alytus t. mun.;2004;4;839;397;442
Alytus t. mun.;2004;5;811;398;413
Alytus t. mun.;2004;6;835;455;380
Alytus t. mun.;2004;7;836;398;438
Alytus t. mun.;2004;8;887;439;448
Alytus t. mun.;2004;9;957;491;466
Alytus t. mun.;2004;10;1007;508;499
Alytus t. mun.;2004;11;1137;566;571
Alytus t. mun.;2004;12;1158;591;567
Alytus t. mun.;2004;13;1159;609;550
Alytus t. mun.;2004;14;1121;535;586
Alytus t. mun.;2004;15;1080;553;527
Alytus t. mun.;2004;16;1072;540;532
Alytus t. mun.;2004;17;1198;601;597
Alytus t. mun.;2004;18;1161;567;594
Alytus t. mun.;2004;19;1110;568;542
Alytus t. mun.;2004;20;1171;587;584
Alytus t. mun.;2004;21;906;471;435
Alytus t. mun.;2004;22;925;494;431
Alytus t. mun.;2004;23;907;497;410
Alytus t. mun.;2004;24;908;503;405
Alytus t. mun.;2004;25;1019;546;473
Alytus t. mun.;2004;26;1019;532;487
Alytus t. mun.;2004;27;1101;594;507
Alytus t. mun.;2004;28;1089;581;508
Alytus t. mun.;2004;29;1070;539;531
Alytus t. mun.;2004;30;1119;563;556
Alytus t. mun.;2004;31;1156;567;589
Alytus t. mun.;2004;32;1194;600;594
Alytus t. mun.;2004;33;1060;537;523
Alytus t. mun.;2004;34;1084;534;550
Alytus t. mun.;2004;35;1112;532;580
Alytus t. mun.;2004;36;1083;542;541
Alytus t. mun.;2004;37;1078;523;555
Alytus t. mun.;2004;38;1081;511;570
Alytus t. mun.;2004;39;1168;612;556
Alytus t. mun.;2004;40;1156;568;588
Alytus t. mun.;2004;41;1218;589;629
Alytus t. mun.;2004;42;1192;552;640
Alytus t. mun.;2004;43;1225;585;640
Alytus t. mun.;2004;44;1202;585;617
Alytus t. mun.;2004;45;1212;572;640
Alytus t. mun.;2004;46;1004;460;544
Alytus t. mun.;2004;47;962;449;513
Alytus t. mun.;2004;48;968;431;537
Alytus t. mun.;2004;49;924;415;509
Alytus t. mun.;2004;50;965;457;508
Alytus t. mun.;2004;51;985;457;528
Alytus t. mun.;2004;52;1022;429;593
Alytus t. mun.;2004;53;906;411;495
Alytus t. mun.;2004;54;986;409;577
Alytus t. mun.;2004;55;851;380;471
Alytus t. mun.;2004;56;756;369;387
Alytus t. mun.;2004;57;682;303;379
Alytus t. mun.;2004;58;732;362;370
Alytus t. mun.;2004;59;648;293;355
Alytus t. mun.;2004;60;711;348;363
Alytus t. mun.;2004;61;662;313;349
Alytus t. mun.;2004;62;648;309;339
Alytus t. mun.;2004;63;588;260;328
Alytus t. mun.;2004;64;614;256;358
Alytus t. mun.;2004;65;544;203;341
Alytus t. mun.;2004;66;505;224;281
Alytus t. mun.;2004;67;521;210;311
Alytus t. mun.;2004;68;446;194;252
Alytus t. mun.;2004;69;431;169;262
Alytus t. mun.;2004;70;387;162;225
Alytus t. mun.;2004;71;400;147;253
Alytus t. mun.;2004;72;401;133;268
Alytus t. mun.;2004;73;370;135;235
Alytus t. mun.;2004;74;333;113;220
Alytus t. mun.;2004;75;336;95;241
Alytus t. mun.;2004;76;308;94;214
Alytus t. mun.;2004;77;262;72;190
Alytus t. mun.;2004;78;242;61;181
Alytus t. mun.;2004;79;245;65;180
Alytus t. mun.;2004;80;199;53;146
Alytus t. mun.;2004;81;189;56;133
Alytus t. mun.;2004;82;123;28;95
Alytus t. mun.;2004;83;112;17;95
Alytus t. mun.;2004;84;95;24;71
Alytus t. mun.;2004;85;438;78;360
Alytus t. mun.;2005;-1;68838;32679;36159
Alytus t. mun.;2005;0;628;318;310
Alytus t. mun.;2005;1;659;343;316
Alytus t. mun.;2005;2;643;340;303
Alytus t. mun.;2005;3;655;339;316
Alytus t. mun.;2005;4;741;383;358
Alytus t. mun.;2005;5;822;387;435
Alytus t. mun.;2005;6;803;398;405
Alytus t. mun.;2005;7;823;447;376
Alytus t. mun.;2005;8;831;393;438
Alytus t. mun.;2005;9;876;434;442
Alytus t. mun.;2005;10;949;482;467
Alytus t. mun.;2005;11;997;501;496
Alytus t. mun.;2005;12;1127;561;566
Alytus t. mun.;2005;13;1142;579;563
Alytus t. mun.;2005;14;1136;596;540
Alytus t. mun.;2005;15;1101;525;576
Alytus t. mun.;2005;16;1047;533;514
Alytus t. mun.;2005;17;1046;523;523
Alytus t. mun.;2005;18;1173;586;587
Alytus t. mun.;2005;19;1122;544;578
Alytus t. mun.;2005;20;1063;545;518
Alytus t. mun.;2005;21;1118;557;561
Alytus t. mun.;2005;22;863;450;413
Alytus t. mun.;2005;23;890;481;409
Alytus t. mun.;2005;24;870;475;395
Alytus t. mun.;2005;25;864;483;381
Alytus t. mun.;2005;26;971;517;454
Alytus t. mun.;2005;27;977;512;465
Alytus t. mun.;2005;28;1044;563;481
Alytus t. mun.;2005;29;1037;550;487
Alytus t. mun.;2005;30;1032;513;519
Alytus t. mun.;2005;31;1085;538;547
Alytus t. mun.;2005;32;1129;547;582
Alytus t. mun.;2005;33;1146;571;575
Alytus t. mun.;2005;34;1026;523;503
Alytus t. mun.;2005;35;1037;510;527
Alytus t. mun.;2005;36;1080;518;562
Alytus t. mun.;2005;37;1055;527;528
Alytus t. mun.;2005;38;1057;507;550
Alytus t. mun.;2005;39;1057;500;557
Alytus t. mun.;2005;40;1149;599;550
Alytus t. mun.;2005;41;1134;552;582
Alytus t. mun.;2005;42;1191;578;613
Alytus t. mun.;2005;43;1164;534;630
Alytus t. mun.;2005;44;1213;577;636
Alytus t. mun.;2005;45;1178;576;602
Alytus t. mun.;2005;46;1190;558;632
Alytus t. mun.;2005;47;990;452;538
Alytus t. mun.;2005;48;940;436;504
Alytus t. mun.;2005;49;947;424;523
Alytus t. mun.;2005;50;906;407;499
Alytus t. mun.;2005;51;940;441;499
Alytus t. mun.;2005;52;959;445;514
Alytus t. mun.;2005;53;997;411;586
Alytus t. mun.;2005;54;880;399;481
Alytus t. mun.;2005;55;964;398;566
Alytus t. mun.;2005;56;843;372;471
Alytus t. mun.;2005;57;740;356;384
Alytus t. mun.;2005;58;658;286;372
Alytus t. mun.;2005;59;710;345;365
Alytus t. mun.;2005;60;637;287;350
Alytus t. mun.;2005;61;699;344;355
Alytus t. mun.;2005;62;646;299;347
Alytus t. mun.;2005;63;625;293;332
Alytus t. mun.;2005;64;577;254;323
Alytus t. mun.;2005;65;603;248;355
Alytus t. mun.;2005;66;532;196;336
Alytus t. mun.;2005;67;494;215;279
Alytus t. mun.;2005;68;514;202;312
Alytus t. mun.;2005;69;433;184;249
Alytus t. mun.;2005;70;430;167;263
Alytus t. mun.;2005;71;374;154;220
Alytus t. mun.;2005;72;388;136;252
Alytus t. mun.;2005;73;386;125;261
Alytus t. mun.;2005;74;356;127;229
Alytus t. mun.;2005;75;326;107;219
Alytus t. mun.;2005;76;322;91;231
Alytus t. mun.;2005;77;306;92;214
Alytus t. mun.;2005;78;255;70;185
Alytus t. mun.;2005;79;233;57;176
Alytus t. mun.;2005;80;229;60;169
Alytus t. mun.;2005;81;189;46;143
Alytus t. mun.;2005;82;176;51;125
Alytus t. mun.;2005;83;119;27;92
Alytus t. mun.;2005;84;106;14;92
Alytus t. mun.;2005;85;468;88;380
Alytus t. mun.;2006;-1;67443;31867;35576
Alytus t. mun.;2006;0;536;279;257
Alytus t. mun.;2006;1;626;317;309
Alytus t. mun.;2006;2;652;339;313
Alytus t. mun.;2006;3;632;332;300
Alytus t. mun.;2006;4;634;326;308
Alytus t. mun.;2006;5;737;380;357
Alytus t. mun.;2006;6;812;380;432
Alytus t. mun.;2006;7;793;392;401
Alytus t. mun.;2006;8;812;440;372
Alytus t. mun.;2006;9;827;394;433
Alytus t. mun.;2006;10;872;431;441
Alytus t. mun.;2006;11;945;480;465
Alytus t. mun.;2006;12;988;496;492
Alytus t. mun.;2006;13;1114;555;559
Alytus t. mun.;2006;14;1125;572;553
Alytus t. mun.;2006;15;1104;579;525
Alytus t. mun.;2006;16;1064;506;558
Alytus t. mun.;2006;17;1022;516;506
Alytus t. mun.;2006;18;1016;506;510
Alytus t. mun.;2006;19;1109;551;558
Alytus t. mun.;2006;20;1068;516;552
Alytus t. mun.;2006;21;1000;514;486
Alytus t. mun.;2006;22;1058;525;533
Alytus t. mun.;2006;23;822;424;398
Alytus t. mun.;2006;24;834;452;382
Alytus t. mun.;2006;25;790;430;360
Alytus t. mun.;2006;26;828;468;360
Alytus t. mun.;2006;27;937;498;439
Alytus t. mun.;2006;28;935;490;445
Alytus t. mun.;2006;29;1006;539;467
Alytus t. mun.;2006;30;1017;534;483
Alytus t. mun.;2006;31;1003;497;506
Alytus t. mun.;2006;32;1051;520;531
Alytus t. mun.;2006;33;1090;523;567
Alytus t. mun.;2006;34;1116;549;567
Alytus t. mun.;2006;35;992;499;493
Alytus t. mun.;2006;36;1008;490;518
Alytus t. mun.;2006;37;1049;500;549
Alytus t. mun.;2006;38;1030;510;520
Alytus t. mun.;2006;39;1027;489;538
Alytus t. mun.;2006;40;1035;488;547
Alytus t. mun.;2006;41;1121;585;536
Alytus t. mun.;2006;42;1110;536;574
Alytus t. mun.;2006;43;1168;567;601
Alytus t. mun.;2006;44;1152;529;623
Alytus t. mun.;2006;45;1188;564;624
Alytus t. mun.;2006;46;1157;567;590
Alytus t. mun.;2006;47;1177;549;628
Alytus t. mun.;2006;48;974;444;530
Alytus t. mun.;2006;49;920;426;494
Alytus t. mun.;2006;50;931;416;515
Alytus t. mun.;2006;51;889;394;495
Alytus t. mun.;2006;52;925;433;492
Alytus t. mun.;2006;53;933;430;503
Alytus t. mun.;2006;54;972;402;570
Alytus t. mun.;2006;55;862;395;467
Alytus t. mun.;2006;56;932;376;556
Alytus t. mun.;2006;57;829;364;465
Alytus t. mun.;2006;58;718;339;379
Alytus t. mun.;2006;59;640;273;367
Alytus t. mun.;2006;60;696;337;359
Alytus t. mun.;2006;61;618;276;342
Alytus t. mun.;2006;62;685;332;353
Alytus t. mun.;2006;63;628;284;344
Alytus t. mun.;2006;64;604;281;323
Alytus t. mun.;2006;65;560;240;320
Alytus t. mun.;2006;66;573;229;344
Alytus t. mun.;2006;67;518;186;332
Alytus t. mun.;2006;68;491;211;280
Alytus t. mun.;2006;69;497;194;303
Alytus t. mun.;2006;70;417;173;244
Alytus t. mun.;2006;71;432;165;267
Alytus t. mun.;2006;72;358;148;210
Alytus t. mun.;2006;73;387;132;255
Alytus t. mun.;2006;74;376;118;258
Alytus t. mun.;2006;75;346;122;224
Alytus t. mun.;2006;76;318;103;215
Alytus t. mun.;2006;77;315;87;228
Alytus t. mun.;2006;78;295;86;209
Alytus t. mun.;2006;79;241;65;176
Alytus t. mun.;2006;80;217;51;166
Alytus t. mun.;2006;81;217;54;163
Alytus t. mun.;2006;82;170;40;130
Alytus t. mun.;2006;83;156;43;113
Alytus t. mun.;2006;84;106;20;86
Alytus t. mun.;2006;85;508;75;433
Alytus t. mun.;2007;-1;66749;31382;35367
Alytus t. mun.;2007;0;621;308;313
Alytus t. mun.;2007;1;532;278;254
Alytus t. mun.;2007;2;625;316;309
Alytus t. mun.;2007;3;640;328;312
Alytus t. mun.;2007;4;622;327;295
Alytus t. mun.;2007;5;627;315;312
Alytus t. mun.;2007;6;738;382;356
Alytus t. mun.;2007;7;801;372;429
Alytus t. mun.;2007;8;783;385;398
Alytus t. mun.;2007;9;813;442;371
Alytus t. mun.;2007;10;823;394;429
Alytus t. mun.;2007;11;862;428;434
Alytus t. mun.;2007;12;940;473;467
Alytus t. mun.;2007;13;981;492;489
Alytus t. mun.;2007;14;1106;548;558
Alytus t. mun.;2007;15;1117;569;548
Alytus t. mun.;2007;16;1094;574;520
Alytus t. mun.;2007;17;1054;502;552
Alytus t. mun.;2007;18;1007;509;498
Alytus t. mun.;2007;19;995;497;498
Alytus t. mun.;2007;20;1090;538;552
Alytus t. mun.;2007;21;1044;504;540
Alytus t. mun.;2007;22;977;500;477
Alytus t. mun.;2007;23;1039;508;531
Alytus t. mun.;2007;24;797;407;390
Alytus t. mun.;2007;25;811;444;367
Alytus t. mun.;2007;26;761;409;352
Alytus t. mun.;2007;27;807;452;355
Alytus t. mun.;2007;28;927;489;438
Alytus t. mun.;2007;29;927;481;446
Alytus t. mun.;2007;30;981;522;459
Alytus t. mun.;2007;31;1003;534;469
Alytus t. mun.;2007;32;978;481;497
Alytus t. mun.;2007;33;1029;506;523
Alytus t. mun.;2007;34;1073;506;567
Alytus t. mun.;2007;35;1096;539;557
Alytus t. mun.;2007;36;964;482;482
Alytus t. mun.;2007;37;987;475;512
Alytus t. mun.;2007;38;1031;491;540
Alytus t. mun.;2007;39;1007;497;510
Alytus t. mun.;2007;40;1012;481;531
Alytus t. mun.;2007;41;1018;475;543
Alytus t. mun.;2007;42;1096;571;525
Alytus t. mun.;2007;43;1098;530;568
Alytus t. mun.;2007;44;1140;553;587
Alytus t. mun.;2007;45;1120;510;610
Alytus t. mun.;2007;46;1177;560;617
Alytus t. mun.;2007;47;1137;559;578
Alytus t. mun.;2007;48;1157;534;623
Alytus t. mun.;2007;49;964;437;527
Alytus t. mun.;2007;50;900;413;487
Alytus t. mun.;2007;51;919;406;513
Alytus t. mun.;2007;52;893;394;499
Alytus t. mun.;2007;53;898;416;482
Alytus t. mun.;2007;54;919;418;501
Alytus t. mun.;2007;55;947;386;561
Alytus t. mun.;2007;56;843;381;462
Alytus t. mun.;2007;57;911;362;549
Alytus t. mun.;2007;58;810;352;458
Alytus t. mun.;2007;59;704;329;375
Alytus t. mun.;2007;60;620;260;360
Alytus t. mun.;2007;61;672;319;353
Alytus t. mun.;2007;62;606;269;337
Alytus t. mun.;2007;63;662;318;344
Alytus t. mun.;2007;64;611;268;343
Alytus t. mun.;2007;65;594;275;319
Alytus t. mun.;2007;66;550;230;320
Alytus t. mun.;2007;67;558;216;342
Alytus t. mun.;2007;68;514;184;330
Alytus t. mun.;2007;69;479;205;274
Alytus t. mun.;2007;70;492;192;300
Alytus t. mun.;2007;71;410;166;244
Alytus t. mun.;2007;72;416;153;263
Alytus t. mun.;2007;73;356;143;213
Alytus t. mun.;2007;74;370;122;248
Alytus t. mun.;2007;75;360;110;250
Alytus t. mun.;2007;76;336;117;219
Alytus t. mun.;2007;77;301;98;203
Alytus t. mun.;2007;78;295;80;215
Alytus t. mun.;2007;79;283;80;203
Alytus t. mun.;2007;80;226;60;166
Alytus t. mun.;2007;81;209;47;162
Alytus t. mun.;2007;82;205;49;156
Alytus t. mun.;2007;83;151;32;119
Alytus t. mun.;2007;84;146;38;108
Alytus t. mun.;2007;85;554;80;474
Alytus t. mun.;2008;-1;65856;30817;35039
Alytus t. mun.;2008;0;582;293;289
Alytus t. mun.;2008;1;616;303;313
Alytus t. mun.;2008;2;531;274;257
Alytus t. mun.;2008;3;621;317;304
Alytus t. mun.;2008;4;632;321;311
Alytus t. mun.;2008;5;608;318;290
Alytus t. mun.;2008;6;615;307;308
Alytus t. mun.;2008;7;724;376;348
Alytus t. mun.;2008;8;800;372;428
Alytus t. mun.;2008;9;775;378;397
Alytus t. mun.;2008;10;802;430;372
Alytus t. mun.;2008;11;811;388;423
Alytus t. mun.;2008;12;847;419;428
Alytus t. mun.;2008;13;930;465;465
Alytus t. mun.;2008;14;972;489;483
Alytus t. mun.;2008;15;1093;542;551
Alytus t. mun.;2008;16;1106;557;549
Alytus t. mun.;2008;17;1076;564;512
Alytus t. mun.;2008;18;1037;494;543
Alytus t. mun.;2008;19;988;498;490
Alytus t. mun.;2008;20;977;489;488
Alytus t. mun.;2008;21;1066;528;538
Alytus t. mun.;2008;22;1018;491;527
Alytus t. mun.;2008;23;955;486;469
Alytus t. mun.;2008;24;1008;491;517
Alytus t. mun.;2008;25;767;387;380
Alytus t. mun.;2008;26;783;432;351
Alytus t. mun.;2008;27;722;386;336
Alytus t. mun.;2008;28;786;443;343
Alytus t. mun.;2008;29;913;479;434
Alytus t. mun.;2008;30;913;475;438
Alytus t. mun.;2008;31;954;503;451
Alytus t. mun.;2008;32;991;525;466
Alytus t. mun.;2008;33;958;467;491
Alytus t. mun.;2008;34;1006;496;510
Alytus t. mun.;2008;35;1059;496;563
Alytus t. mun.;2008;36;1075;533;542
Alytus t. mun.;2008;37;947;469;478
Alytus t. mun.;2008;38;975;472;503
Alytus t. mun.;2008;39;1006;479;527
Alytus t. mun.;2008;40;977;476;501
Alytus t. mun.;2008;41;999;478;521
Alytus t. mun.;2008;42;1003;463;540
Alytus t. mun.;2008;43;1078;562;516
Alytus t. mun.;2008;44;1088;527;561
Alytus t. mun.;2008;45;1123;542;581
Alytus t. mun.;2008;46;1097;496;601
Alytus t. mun.;2008;47;1151;542;609
Alytus t. mun.;2008;48;1117;543;574
Alytus t. mun.;2008;49;1131;518;613
Alytus t. mun.;2008;50;961;435;526
Alytus t. mun.;2008;51;882;401;481
Alytus t. mun.;2008;52;903;395;508
Alytus t. mun.;2008;53;880;390;490
Alytus t. mun.;2008;54;881;402;479
Alytus t. mun.;2008;55;892;399;493
Alytus t. mun.;2008;56;934;376;558
Alytus t. mun.;2008;57;821;371;450
Alytus t. mun.;2008;58;890;348;542
Alytus t. mun.;2008;59;785;333;452
Alytus t. mun.;2008;60;690;316;374
Alytus t. mun.;2008;61;601;247;354
Alytus t. mun.;2008;62;657;306;351
Alytus t. mun.;2008;63;590;257;333
Alytus t. mun.;2008;64;647;307;340
Alytus t. mun.;2008;65;599;257;342
Alytus t. mun.;2008;66;572;261;311
Alytus t. mun.;2008;67;538;222;316
Alytus t. mun.;2008;68;537;198;339
Alytus t. mun.;2008;69;505;179;326
Alytus t. mun.;2008;70;474;197;277
Alytus t. mun.;2008;71;475;179;296
Alytus t. mun.;2008;72;402;158;244
Alytus t. mun.;2008;73;404;148;256
Alytus t. mun.;2008;74;343;132;211
Alytus t. mun.;2008;75;355;113;242
Alytus t. mun.;2008;76;342;95;247
Alytus t. mun.;2008;77;316;107;209
Alytus t. mun.;2008;78;283;88;195
Alytus t. mun.;2008;79;287;71;216
Alytus t. mun.;2008;80;267;72;195
Alytus t. mun.;2008;81;215;57;158
Alytus t. mun.;2008;82;193;43;150
Alytus t. mun.;2008;83;193;45;148
Alytus t. mun.;2008;84;140;30;110
Alytus t. mun.;2008;85;593;103;490
Alytus t. mun.;2009;-1;64770;30216;34554
Alytus t. mun.;2009;0;562;291;271
Alytus t. mun.;2009;1;573;290;283
Alytus t. mun.;2009;2;609;300;309
Alytus t. mun.;2009;3;522;270;252
Alytus t. mun.;2009;4;607;308;299
Alytus t. mun.;2009;5;617;312;305
Alytus t. mun.;2009;6;599;310;289
Alytus t. mun.;2009;7;610;302;308
Alytus t. mun.;2009;8;719;374;345
Alytus t. mun.;2009;9;800;373;427
Alytus t. mun.;2009;10;763;371;392
Alytus t. mun.;2009;11;790;426;364
Alytus t. mun.;2009;12;796;379;417
Alytus t. mun.;2009;13;829;405;424
Alytus t. mun.;2009;14;906;456;450
Alytus t. mun.;2009;15;961;486;475
Alytus t. mun.;2009;16;1091;539;552
Alytus t. mun.;2009;17;1086;550;536
Alytus t. mun.;2009;18;1062;558;504
Alytus t. mun.;2009;19;1020;486;534
Alytus t. mun.;2009;20;965;483;482
Alytus t. mun.;2009;21;950;473;477
Alytus t. mun.;2009;22;1041;512;529
Alytus t. mun.;2009;23;989;478;511
Alytus t. mun.;2009;24;915;459;456
Alytus t. mun.;2009;25;973;478;495
Alytus t. mun.;2009;26;730;371;359
Alytus t. mun.;2009;27;740;412;328
Alytus t. mun.;2009;28;699;376;323
Alytus t. mun.;2009;29;767;428;339
Alytus t. mun.;2009;30;890;465;425
Alytus t. mun.;2009;31;891;462;429
Alytus t. mun.;2009;32;923;494;429
Alytus t. mun.;2009;33;952;502;450
Alytus t. mun.;2009;34;920;447;473
Alytus t. mun.;2009;35;982;482;500
Alytus t. mun.;2009;36;1028;484;544
Alytus t. mun.;2009;37;1053;524;529
Alytus t. mun.;2009;38;925;448;477
Alytus t. mun.;2009;39;959;459;500
Alytus t. mun.;2009;40;985;470;515
Alytus t. mun.;2009;41;960;462;498
Alytus t. mun.;2009;42;986;468;518
Alytus t. mun.;2009;43;994;460;534
Alytus t. mun.;2009;44;1061;550;511
Alytus t. mun.;2009;45;1062;515;547
Alytus t. mun.;2009;46;1100;528;572
Alytus t. mun.;2009;47;1077;484;593
Alytus t. mun.;2009;48;1129;528;601
Alytus t. mun.;2009;49;1100;536;564
Alytus t. mun.;2009;50;1100;498;602
Alytus t. mun.;2009;51;938;422;516
Alytus t. mun.;2009;52;867;392;475
Alytus t. mun.;2009;53;889;389;500
Alytus t. mun.;2009;54;863;379;484
Alytus t. mun.;2009;55;862;390;472
Alytus t. mun.;2009;56;864;383;481
Alytus t. mun.;2009;57;908;360;548
Alytus t. mun.;2009;58;808;362;446
Alytus t. mun.;2009;59;873;334;539
Alytus t. mun.;2009;60;770;322;448
Alytus t. mun.;2009;61;672;306;366
Alytus t. mun.;2009;62;583;234;349
Alytus t. mun.;2009;63;638;296;342
Alytus t. mun.;2009;64;583;252;331
Alytus t. mun.;2009;65;635;299;336
Alytus t. mun.;2009;66;583;248;335
Alytus t. mun.;2009;67;552;249;303
Alytus t. mun.;2009;68;525;212;313
Alytus t. mun.;2009;69;520;186;334
Alytus t. mun.;2009;70;490;169;321
Alytus t. mun.;2009;71;468;195;273
Alytus t. mun.;2009;72;459;170;289
Alytus t. mun.;2009;73;383;146;237
Alytus t. mun.;2009;74;398;144;254
Alytus t. mun.;2009;75;328;124;204
Alytus t. mun.;2009;76;340;102;238
Alytus t. mun.;2009;77;319;84;235
Alytus t. mun.;2009;78;302;102;200
Alytus t. mun.;2009;79;275;86;189
Alytus t. mun.;2009;80;274;66;208
Alytus t. mun.;2009;81;246;67;179
Alytus t. mun.;2009;82;194;52;142
Alytus t. mun.;2009;83;172;32;140
Alytus t. mun.;2009;84;184;43;141
Alytus t. mun.;2009;85;637;97;540
Alytus t. mun.;2010;-1;63630;29583;34047
Alytus t. mun.;2010;0;590;287;303
Alytus t. mun.;2010;1;553;284;269
Alytus t. mun.;2010;2;560;282;278
Alytus t. mun.;2010;3;588;288;300
Alytus t. mun.;2010;4;505;258;247
Alytus t. mun.;2010;5;588;298;290
Alytus t. mun.;2010;6;607;305;302
Alytus t. mun.;2010;7;589;309;280
Alytus t. mun.;2010;8;599;296;303
Alytus t. mun.;2010;9;702;363;339
Alytus t. mun.;2010;10;797;370;427
Alytus t. mun.;2010;11;748;367;381
Alytus t. mun.;2010;12;789;426;363
Alytus t. mun.;2010;13;790;373;417
Alytus t. mun.;2010;14;823;409;414
Alytus t. mun.;2010;15;908;454;454
Alytus t. mun.;2010;16;951;480;471
Alytus t. mun.;2010;17;1078;532;546
Alytus t. mun.;2010;18;1079;547;532
Alytus t. mun.;2010;19;1029;545;484
Alytus t. mun.;2010;20;994;473;521
Alytus t. mun.;2010;21;932;468;464
Alytus t. mun.;2010;22;917;457;460
Alytus t. mun.;2010;23;992;488;504
Alytus t. mun.;2010;24;942;456;486
Alytus t. mun.;2010;25;872;441;431
Alytus t. mun.;2010;26;902;445;457
Alytus t. mun.;2010;27;680;344;336
Alytus t. mun.;2010;28;710;395;315
Alytus t. mun.;2010;29;670;360;310
Alytus t. mun.;2010;30;734;407;327
Alytus t. mun.;2010;31;851;444;407
Alytus t. mun.;2010;32;875;454;421
Alytus t. mun.;2010;33;905;492;413
Alytus t. mun.;2010;34;925;483;442
Alytus t. mun.;2010;35;891;438;453
Alytus t. mun.;2010;36;952;468;484
Alytus t. mun.;2010;37;1010;471;539
Alytus t. mun.;2010;38;1019;506;513
Alytus t. mun.;2010;39;904;437;467
Alytus t. mun.;2010;40;935;444;491
Alytus t. mun.;2010;41;968;461;507
Alytus t. mun.;2010;42;941;446;495
Alytus t. mun.;2010;43;973;460;513
Alytus t. mun.;2010;44;973;449;524
Alytus t. mun.;2010;45;1037;534;503
Alytus t. mun.;2010;46;1042;504;538
Alytus t. mun.;2010;47;1082;522;560
Alytus t. mun.;2010;48;1055;473;582
Alytus t. mun.;2010;49;1110;521;589
Alytus t. mun.;2010;50;1076;517;559
Alytus t. mun.;2010;51;1082;486;596
Alytus t. mun.;2010;52;923;413;510
Alytus t. mun.;2010;53;843;381;462
Alytus t. mun.;2010;54;869;381;488
Alytus t. mun.;2010;55;847;368;479
Alytus t. mun.;2010;56;848;380;468
Alytus t. mun.;2010;57;850;376;474
Alytus t. mun.;2010;58;894;353;541
Alytus t. mun.;2010;59;792;349;443
Alytus t. mun.;2010;60;862;323;539
Alytus t. mun.;2010;61;752;309;443
Alytus t. mun.;2010;62;655;294;361
Alytus t. mun.;2010;63;573;225;348
Alytus t. mun.;2010;64;615;280;335
Alytus t. mun.;2010;65;569;241;328
Alytus t. mun.;2010;66;624;287;337
Alytus t. mun.;2010;67;563;232;331
Alytus t. mun.;2010;68;531;236;295
Alytus t. mun.;2010;69;498;198;300
Alytus t. mun.;2010;70;506;179;327
Alytus t. mun.;2010;71;472;161;311
Alytus t. mun.;2010;72;456;186;270
Alytus t. mun.;2010;73;456;169;287
Alytus t. mun.;2010;74;368;133;235
Alytus t. mun.;2010;75;389;138;251
Alytus t. mun.;2010;76;315;118;197
Alytus t. mun.;2010;77;321;91;230
Alytus t. mun.;2010;78;302;77;225
Alytus t. mun.;2010;79;290;96;194
Alytus t. mun.;2010;80;258;80;178
Alytus t. mun.;2010;81;263;63;200
Alytus t. mun.;2010;82;225;58;167
Alytus t. mun.;2010;83;179;44;135
Alytus t. mun.;2010;84;157;28;129
Alytus t. mun.;2010;85;741;119;622
Alytus t. mun.;2011;-1;60302;27968;32334
Alytus t. mun.;2011;0;486;248;238
Alytus t. mun.;2011;1;550;284;266
Alytus t. mun.;2011;2;518;260;258
Alytus t. mun.;2011;3;500;254;246
Alytus t. mun.;2011;4;528;257;271
Alytus t. mun.;2011;5;480;237;243
Alytus t. mun.;2011;6;549;281;268
Alytus t. mun.;2011;7;564;292;272
Alytus t. mun.;2011;8;539;288;251
Alytus t. mun.;2011;9;590;308;282
Alytus t. mun.;2011;10;660;334;326
Alytus t. mun.;2011;11;725;347;378
Alytus t. mun.;2011;12;693;335;358
Alytus t. mun.;2011;13;738;398;340
Alytus t. mun.;2011;14;756;363;393
Alytus t. mun.;2011;15;787;391;396
Alytus t. mun.;2011;16;870;437;433
Alytus t. mun.;2011;17;893;450;443
Alytus t. mun.;2011;18;1046;508;538
Alytus t. mun.;2011;19;912;482;430
Alytus t. mun.;2011;20;847;479;368
Alytus t. mun.;2011;21;837;436;401
Alytus t. mun.;2011;22;792;432;360
Alytus t. mun.;2011;23;809;429;380
Alytus t. mun.;2011;24;811;431;380
Alytus t. mun.;2011;25;757;403;354
Alytus t. mun.;2011;26;735;402;333
Alytus t. mun.;2011;27;744;400;344
Alytus t. mun.;2011;28;652;353;299
Alytus t. mun.;2011;29;720;381;339
Alytus t. mun.;2011;30;711;372;339
Alytus t. mun.;2011;31;705;378;327
Alytus t. mun.;2011;32;768;403;365
Alytus t. mun.;2011;33;801;423;378
Alytus t. mun.;2011;34;837;433;404
Alytus t. mun.;2011;35;882;450;432
Alytus t. mun.;2011;36;850;399;451
Alytus t. mun.;2011;37;883;408;475
Alytus t. mun.;2011;38;914;401;513
Alytus t. mun.;2011;39;964;470;494
Alytus t. mun.;2011;40;907;454;453
Alytus t. mun.;2011;41;883;419;464
Alytus t. mun.;2011;42;932;428;504
Alytus t. mun.;2011;43;926;423;503
Alytus t. mun.;2011;44;923;428;495
Alytus t. mun.;2011;45;921;413;508
Alytus t. mun.;2011;46;954;478;476
Alytus t. mun.;2011;47;1006;475;531
Alytus t. mun.;2011;48;1021;478;543
Alytus t. mun.;2011;49;1025;467;558
Alytus t. mun.;2011;50;1044;486;558
Alytus t. mun.;2011;51;990;462;528
Alytus t. mun.;2011;52;1019;458;561
Alytus t. mun.;2011;53;845;376;469
Alytus t. mun.;2011;54;796;351;445
Alytus t. mun.;2011;55;836;349;487
Alytus t. mun.;2011;56;788;339;449
Alytus t. mun.;2011;57;829;368;461
Alytus t. mun.;2011;58;858;371;487
Alytus t. mun.;2011;59;873;332;541
Alytus t. mun.;2011;60;789;328;461
Alytus t. mun.;2011;61;835;315;520
Alytus t. mun.;2011;62;743;311;432
Alytus t. mun.;2011;63;631;266;365
Alytus t. mun.;2011;64;560;214;346
Alytus t. mun.;2011;65;638;283;355
Alytus t. mun.;2011;66;548;234;314
Alytus t. mun.;2011;67;610;268;342
Alytus t. mun.;2011;68;566;230;336
Alytus t. mun.;2011;69;558;245;313
Alytus t. mun.;2011;70;506;189;317
Alytus t. mun.;2011;71;524;192;332
Alytus t. mun.;2011;72;477;157;320
Alytus t. mun.;2011;73;430;163;267
Alytus t. mun.;2011;74;456;161;295
Alytus t. mun.;2011;75;380;133;247
Alytus t. mun.;2011;76;375;123;252
Alytus t. mun.;2011;77;336;119;217
Alytus t. mun.;2011;78;326;94;232
Alytus t. mun.;2011;79;316;83;233
Alytus t. mun.;2011;80;297;101;196
Alytus t. mun.;2011;81;262;77;185
Alytus t. mun.;2011;82;264;67;197
Alytus t. mun.;2011;83;214;55;159
Alytus t. mun.;2011;84;170;35;135
Alytus t. mun.;2011;85;712;133;579
Alytus t. mun.;2012;-1;58515;27010;31505
Alytus t. mun.;2012;0;492;246;246
Alytus t. mun.;2012;1;478;243;235
Alytus t. mun.;2012;2;535;278;257
Alytus t. mun.;2012;3;497;246;251
Alytus t. mun.;2012;4;493;258;235
Alytus t. mun.;2012;5;508;249;259
Alytus t. mun.;2012;6;473;233;240
Alytus t. mun.;2012;7;532;273;259
Alytus t. mun.;2012;8;557;292;265
Alytus t. mun.;2012;9;529;287;242
Alytus t. mun.;2012;10;581;300;281
Alytus t. mun.;2012;11;644;325;319
Alytus t. mun.;2012;12;709;339;370
Alytus t. mun.;2012;13;677;330;347
Alytus t. mun.;2012;14;724;388;336
Alytus t. mun.;2012;15;745;357;388
Alytus t. mun.;2012;16;776;388;388
Alytus t. mun.;2012;17;850;428;422
Alytus t. mun.;2012;18;868;438;430
Alytus t. mun.;2012;19;993;485;508
Alytus t. mun.;2012;20;866;460;406
Alytus t. mun.;2012;21;808;449;359
Alytus t. mun.;2012;22;772;396;376
Alytus t. mun.;2012;23;708;385;323
Alytus t. mun.;2012;24;748;405;343
Alytus t. mun.;2012;25;736;381;355
Alytus t. mun.;2012;26;696;371;325
Alytus t. mun.;2012;27;683;372;311
Alytus t. mun.;2012;28;682;358;324
Alytus t. mun.;2012;29;592;318;274
Alytus t. mun.;2012;30;671;348;323
Alytus t. mun.;2012;31;659;345;314
Alytus t. mun.;2012;32;651;350;301
Alytus t. mun.;2012;33;717;365;352
Alytus t. mun.;2012;34;778;400;378
Alytus t. mun.;2012;35;791;407;384
Alytus t. mun.;2012;36;848;430;418
Alytus t. mun.;2012;37;818;383;435
Alytus t. mun.;2012;38;848;387;461
Alytus t. mun.;2012;39;881;382;499
Alytus t. mun.;2012;40;938;455;483
Alytus t. mun.;2012;41;878;443;435
Alytus t. mun.;2012;42;856;406;450
Alytus t. mun.;2012;43;903;409;494
Alytus t. mun.;2012;44;899;407;492
Alytus t. mun.;2012;45;898;414;484
Alytus t. mun.;2012;46;906;404;502
Alytus t. mun.;2012;47;936;471;465
Alytus t. mun.;2012;48;984;460;524
Alytus t. mun.;2012;49;990;466;524
Alytus t. mun.;2012;50;1006;458;548
Alytus t. mun.;2012;51;1030;480;550
Alytus t. mun.;2012;52;965;445;520
Alytus t. mun.;2012;53;994;448;546
Alytus t. mun.;2012;54;821;360;461
Alytus t. mun.;2012;55;775;338;437
Alytus t. mun.;2012;56;823;339;484
Alytus t. mun.;2012;57;773;333;440
Alytus t. mun.;2012;58;813;357;456
Alytus t. mun.;2012;59;840;366;474
Alytus t. mun.;2012;60;854;319;535
Alytus t. mun.;2012;61;776;319;457
Alytus t. mun.;2012;62;812;303;509
Alytus t. mun.;2012;63;730;301;429
Alytus t. mun.;2012;64;611;250;361
Alytus t. mun.;2012;65;538;204;334
Alytus t. mun.;2012;66;621;275;346
Alytus t. mun.;2012;67;530;219;311
Alytus t. mun.;2012;68;584;253;331
Alytus t. mun.;2012;69;539;212;327
Alytus t. mun.;2012;70;546;239;307
Alytus t. mun.;2012;71;488;176;312
Alytus t. mun.;2012;72;513;189;324
Alytus t. mun.;2012;73;464;150;314
Alytus t. mun.;2012;74;422;157;265
Alytus t. mun.;2012;75;442;157;285
Alytus t. mun.;2012;76;369;128;241
Alytus t. mun.;2012;77;365;118;247
Alytus t. mun.;2012;78;313;108;205
Alytus t. mun.;2012;79;311;90;221
Alytus t. mun.;2012;80;299;75;224
Alytus t. mun.;2012;81;286;98;188
Alytus t. mun.;2012;82;248;76;172
Alytus t. mun.;2012;83;245;65;180
Alytus t. mun.;2012;84;201;50;151
Alytus t. mun.;2012;85;766;145;621
Alytus t. mun.;2013;-1;57281;26315;30966
Alytus t. mun.;2013;0;509;247;262
Alytus t. mun.;2013;1;492;252;240
Alytus t. mun.;2013;2;467;230;237
Alytus t. mun.;2013;3;512;264;248
Alytus t. mun.;2013;4;480;239;241
Alytus t. mun.;2013;5;474;244;230
Alytus t. mun.;2013;6;501;248;253
Alytus t. mun.;2013;7;466;232;234
Alytus t. mun.;2013;8;529;270;259
Alytus t. mun.;2013;9;544;287;257
Alytus t. mun.;2013;10;519;281;238
Alytus t. mun.;2013;11;574;295;279
Alytus t. mun.;2013;12;630;317;313
Alytus t. mun.;2013;13;699;335;364
Alytus t. mun.;2013;14;664;324;340
Alytus t. mun.;2013;15;713;385;328
Alytus t. mun.;2013;16;725;344;381
Alytus t. mun.;2013;17;774;387;387
Alytus t. mun.;2013;18;830;421;409
Alytus t. mun.;2013;19;852;434;418
Alytus t. mun.;2013;20;958;468;490
Alytus t. mun.;2013;21;830;435;395
Alytus t. mun.;2013;22;762;428;334
Alytus t. mun.;2013;23;714;370;344
Alytus t. mun.;2013;24;688;379;309
Alytus t. mun.;2013;25;705;374;331
Alytus t. mun.;2013;26;682;347;335
Alytus t. mun.;2013;27;640;340;300
Alytus t. mun.;2013;28;640;348;292
Alytus t. mun.;2013;29;642;349;293
Alytus t. mun.;2013;30;570;304;266
Alytus t. mun.;2013;31;646;332;314
Alytus t. mun.;2013;32;626;329;297
Alytus t. mun.;2013;33;605;322;283
Alytus t. mun.;2013;34;702;349;353
Alytus t. mun.;2013;35;756;389;367
Alytus t. mun.;2013;36;775;402;373
Alytus t. mun.;2013;37;830;416;414
Alytus t. mun.;2013;38;812;383;429
Alytus t. mun.;2013;39;830;371;459
Alytus t. mun.;2013;40;863;370;493
Alytus t. mun.;2013;41;906;442;464
Alytus t. mun.;2013;42;861;433;428
Alytus t. mun.;2013;43;837;402;435
Alytus t. mun.;2013;44;888;397;491
Alytus t. mun.;2013;45;867;386;481
Alytus t. mun.;2013;46;892;411;481
Alytus t. mun.;2013;47;900;396;504
Alytus t. mun.;2013;48;916;453;463
Alytus t. mun.;2013;49;968;451;517
Alytus t. mun.;2013;50;978;458;520
Alytus t. mun.;2013;51;995;452;543
Alytus t. mun.;2013;52;1015;476;539
Alytus t. mun.;2013;53;948;435;513
Alytus t. mun.;2013;54;985;444;541
Alytus t. mun.;2013;55;802;351;451
Alytus t. mun.;2013;56;764;331;433
Alytus t. mun.;2013;57;809;332;477
Alytus t. mun.;2013;58;755;318;437
Alytus t. mun.;2013;59;790;343;447
Alytus t. mun.;2013;60;826;356;470
Alytus t. mun.;2013;61;838;308;530
Alytus t. mun.;2013;62;756;304;452
Alytus t. mun.;2013;63;791;287;504
Alytus t. mun.;2013;64;718;293;425
Alytus t. mun.;2013;65;588;232;356
Alytus t. mun.;2013;66;530;197;333
Alytus t. mun.;2013;67;603;260;343
Alytus t. mun.;2013;68;518;214;304
Alytus t. mun.;2013;69;567;239;328
Alytus t. mun.;2013;70;528;206;322
Alytus t. mun.;2013;71;523;221;302
Alytus t. mun.;2013;72;471;168;303
Alytus t. mun.;2013;73;494;176;318
Alytus t. mun.;2013;74;445;139;306
Alytus t. mun.;2013;75;412;151;261
Alytus t. mun.;2013;76;421;144;277
Alytus t. mun.;2013;77;352;116;236
Alytus t. mun.;2013;78;350;112;238
Alytus t. mun.;2013;79;295;98;197
Alytus t. mun.;2013;80;297;85;212
Alytus t. mun.;2013;81;286;72;214
Alytus t. mun.;2013;82;270;90;180
Alytus t. mun.;2013;83;228;69;159
Alytus t. mun.;2013;84;224;57;167
Alytus t. mun.;2013;85;844;169;675
Alytus t. mun.;2014;-1;56357;25915;30442
Alytus t. mun.;2014;0;461;244;217
Alytus t. mun.;2014;1;502;249;253
Alytus t. mun.;2014;2;479;248;231
Alytus t. mun.;2014;3;453;225;228
Alytus t. mun.;2014;4;503;260;243
Alytus t. mun.;2014;5;451;220;231
Alytus t. mun.;2014;6;445;230;215
Alytus t. mun.;2014;7;491;242;249
Alytus t. mun.;2014;8;455;226;229
Alytus t. mun.;2014;9;525;267;258
Alytus t. mun.;2014;10;528;275;253
Alytus t. mun.;2014;11;505;275;230
Alytus t. mun.;2014;12;562;291;271
Alytus t. mun.;2014;13;617;312;305
Alytus t. mun.;2014;14;685;331;354
Alytus t. mun.;2014;15;646;317;329
Alytus t. mun.;2014;16;705;384;321
Alytus t. mun.;2014;17;713;340;373
Alytus t. mun.;2014;18;767;381;386
Alytus t. mun.;2014;19;806;409;397
Alytus t. mun.;2014;20;823;415;408
Alytus t. mun.;2014;21;939;445;494
Alytus t. mun.;2014;22;799;419;380
Alytus t. mun.;2014;23;723;413;310
Alytus t. mun.;2014;24;687;362;325
Alytus t. mun.;2014;25;662;365;297
Alytus t. mun.;2014;26;675;363;312
Alytus t. mun.;2014;27;668;350;318
Alytus t. mun.;2014;28;611;332;279
Alytus t. mun.;2014;29;622;354;268
Alytus t. mun.;2014;30;621;342;279
Alytus t. mun.;2014;31;552;298;254
Alytus t. mun.;2014;32;637;331;306
Alytus t. mun.;2014;33;609;314;295
Alytus t. mun.;2014;34;587;306;281
Alytus t. mun.;2014;35;675;338;337
Alytus t. mun.;2014;36;743;384;359
Alytus t. mun.;2014;37;764;392;372
Alytus t. mun.;2014;38;807;407;400
Alytus t. mun.;2014;39;793;378;415
Alytus t. mun.;2014;40;811;361;450
Alytus t. mun.;2014;41;858;369;489
Alytus t. mun.;2014;42;881;434;447
Alytus t. mun.;2014;43;843;426;417
Alytus t. mun.;2014;44;828;399;429
Alytus t. mun.;2014;45;874;388;486
Alytus t. mun.;2014;46;858;383;475
Alytus t. mun.;2014;47;886;406;480
Alytus t. mun.;2014;48;894;392;502
Alytus t. mun.;2014;49;900;446;454
Alytus t. mun.;2014;50;961;446;515
Alytus t. mun.;2014;51;976;457;519
Alytus t. mun.;2014;52;978;444;534
Alytus t. mun.;2014;53;1004;471;533
Alytus t. mun.;2014;54;939;429;510
Alytus t. mun.;2014;55;974;437;537
Alytus t. mun.;2014;56;798;348;450
Alytus t. mun.;2014;57;746;319;427
Alytus t. mun.;2014;58;810;332;478
Alytus t. mun.;2014;59;743;308;435
Alytus t. mun.;2014;60;784;338;446
Alytus t. mun.;2014;61;812;351;461
Alytus t. mun.;2014;62;835;304;531
Alytus t. mun.;2014;63;747;299;448
Alytus t. mun.;2014;64;770;277;493
Alytus t. mun.;2014;65;704;285;419
Alytus t. mun.;2014;66;586;229;357
Alytus t. mun.;2014;67;520;190;330
Alytus t. mun.;2014;68;587;248;339
Alytus t. mun.;2014;69;502;206;296
Alytus t. mun.;2014;70;553;224;329
Alytus t. mun.;2014;71;512;193;319
Alytus t. mun.;2014;72;516;215;301
Alytus t. mun.;2014;73;460;158;302
Alytus t. mun.;2014;74;480;169;311
Alytus t. mun.;2014;75;434;133;301
Alytus t. mun.;2014;76;390;142;248
Alytus t. mun.;2014;77;402;137;265
Alytus t. mun.;2014;78;340;110;230
Alytus t. mun.;2014;79;334;103;231
Alytus t. mun.;2014;80;290;96;194
Alytus t. mun.;2014;81;282;78;204
Alytus t. mun.;2014;82;268;63;205
Alytus t. mun.;2014;83;247;80;167
Alytus t. mun.;2014;84;211;63;148
Alytus t. mun.;2014;85;933;195;738
Alytus t. mun.;2015;-1;55614;25528;30086
Alytus t. mun.;2015;0;500;241;259
Alytus t. mun.;2015;1;467;244;223
Alytus t. mun.;2015;2;496;244;252
Alytus t. mun.;2015;3;468;240;228
Alytus t. mun.;2015;4;444;225;219
Alytus t. mun.;2015;5;483;254;229
Alytus t. mun.;2015;6;448;219;229
Alytus t. mun.;2015;7;437;228;209
Alytus t. mun.;2015;8;486;236;250
Alytus t. mun.;2015;9;457;226;231
Alytus t. mun.;2015;10;509;256;253
Alytus t. mun.;2015;11;517;273;244
Alytus t. mun.;2015;12;489;269;220
Alytus t. mun.;2015;13;553;288;265
Alytus t. mun.;2015;14;616;308;308
Alytus t. mun.;2015;15;671;322;349
Alytus t. mun.;2015;16;642;312;330
Alytus t. mun.;2015;17;694;374;320
Alytus t. mun.;2015;18;706;339;367
Alytus t. mun.;2015;19;740;369;371
Alytus t. mun.;2015;20;789;404;385
Alytus t. mun.;2015;21;804;400;404
Alytus t. mun.;2015;22;916;441;475
Alytus t. mun.;2015;23;785;407;378
Alytus t. mun.;2015;24;696;396;300
Alytus t. mun.;2015;25;695;374;321
Alytus t. mun.;2015;26;649;364;285
Alytus t. mun.;2015;27;661;353;308
Alytus t. mun.;2015;28;651;341;310
Alytus t. mun.;2015;29;597;323;274
Alytus t. mun.;2015;30;604;352;252
Alytus t. mun.;2015;31;614;331;283
Alytus t. mun.;2015;32;542;292;250
Alytus t. mun.;2015;33;606;323;283
Alytus t. mun.;2015;34;586;299;287
Alytus t. mun.;2015;35;575;301;274
Alytus t. mun.;2015;36;660;332;328
Alytus t. mun.;2015;37;719;378;341
Alytus t. mun.;2015;38;761;387;374
Alytus t. mun.;2015;39;787;397;390
Alytus t. mun.;2015;40;774;362;412
Alytus t. mun.;2015;41;799;357;442
Alytus t. mun.;2015;42;834;357;477
Alytus t. mun.;2015;43;881;435;446
Alytus t. mun.;2015;44;837;423;414
Alytus t. mun.;2015;45;818;395;423
Alytus t. mun.;2015;46;870;387;483
Alytus t. mun.;2015;47;834;371;463
Alytus t. mun.;2015;48;880;400;480
Alytus t. mun.;2015;49;883;380;503
Alytus t. mun.;2015;50;889;444;445
Alytus t. mun.;2015;51;943;435;508
Alytus t. mun.;2015;52;966;456;510
Alytus t. mun.;2015;53;973;442;531
Alytus t. mun.;2015;54;989;463;526
Alytus t. mun.;2015;55;930;427;503
Alytus t. mun.;2015;56;965;430;535
Alytus t. mun.;2015;57;780;335;445
Alytus t. mun.;2015;58;733;312;421
Alytus t. mun.;2015;59;795;321;474
Alytus t. mun.;2015;60;731;299;432
Alytus t. mun.;2015;61;773;329;444
Alytus t. mun.;2015;62;789;341;448
Alytus t. mun.;2015;63;814;291;523
Alytus t. mun.;2015;64;730;289;441
Alytus t. mun.;2015;65;752;266;486
Alytus t. mun.;2015;66;686;273;413
Alytus t. mun.;2015;67;575;224;351
Alytus t. mun.;2015;68;509;181;328
Alytus t. mun.;2015;69;575;239;336
Alytus t. mun.;2015;70;488;195;293
Alytus t. mun.;2015;71;538;215;323
Alytus t. mun.;2015;72;495;180;315
Alytus t. mun.;2015;73;503;206;297
Alytus t. mun.;2015;74;448;149;299
Alytus t. mun.;2015;75;469;162;307
Alytus t. mun.;2015;76;411;123;288
Alytus t. mun.;2015;77;374;134;240
Alytus t. mun.;2015;78;386;132;254
Alytus t. mun.;2015;79;331;105;226
Alytus t. mun.;2015;80;316;95;221
Alytus t. mun.;2015;81;265;84;181
Alytus t. mun.;2015;82;267;70;197
Alytus t. mun.;2015;83;247;57;190
Alytus t. mun.;2015;84;221;72;149
Alytus t. mun.;2015;85;1028;223;805
Alytus t. mun.;2016;-1;54431;24896;29535
Alytus t. mun.;2016;0;509;257;252
Alytus t. mun.;2016;1;495;241;254
Alytus t. mun.;2016;2;450;237;213
Alytus t. mun.;2016;3;496;239;257
Alytus t. mun.;2016;4;458;230;228
Alytus t. mun.;2016;5;440;226;214
Alytus t. mun.;2016;6;470;251;219
Alytus t. mun.;2016;7;441;215;226
Alytus t. mun.;2016;8;418;218;200
Alytus t. mun.;2016;9;479;234;245
Alytus t. mun.;2016;10;445;219;226
Alytus t. mun.;2016;11;496;251;245
Alytus t. mun.;2016;12;504;266;238
Alytus t. mun.;2016;13;479;264;215
Alytus t. mun.;2016;14;533;275;258
Alytus t. mun.;2016;15;594;301;293
Alytus t. mun.;2016;16;652;308;344
Alytus t. mun.;2016;17;625;304;321
Alytus t. mun.;2016;18;679;362;317
Alytus t. mun.;2016;19;674;319;355
Alytus t. mun.;2016;20;724;366;358
Alytus t. mun.;2016;21;760;387;373
Alytus t. mun.;2016;22;774;376;398
Alytus t. mun.;2016;23;874;414;460
Alytus t. mun.;2016;24;745;389;356
Alytus t. mun.;2016;25;663;377;286
Alytus t. mun.;2016;26;656;358;298
Alytus t. mun.;2016;27;631;356;275
Alytus t. mun.;2016;28;637;348;289
Alytus t. mun.;2016;29;620;323;297
Alytus t. mun.;2016;30;577;309;268
Alytus t. mun.;2016;31;581;338;243
Alytus t. mun.;2016;32;578;303;275
Alytus t. mun.;2016;33;517;277;240
Alytus t. mun.;2016;34;596;319;277
Alytus t. mun.;2016;35;570;288;282
Alytus t. mun.;2016;36;557;295;262
Alytus t. mun.;2016;37;642;322;320
Alytus t. mun.;2016;38;704;371;333
Alytus t. mun.;2016;39;737;376;361
Alytus t. mun.;2016;40;766;384;382
Alytus t. mun.;2016;41;756;352;404
Alytus t. mun.;2016;42;783;347;436
Alytus t. mun.;2016;43;832;357;475
Alytus t. mun.;2016;44;858;421;437
Alytus t. mun.;2016;45;807;410;397
Alytus t. mun.;2016;46;787;377;410
Alytus t. mun.;2016;47;834;361;473
Alytus t. mun.;2016;48;819;365;454
Alytus t. mun.;2016;49;859;383;476
Alytus t. mun.;2016;50;871;373;498
Alytus t. mun.;2016;51;876;435;441
Alytus t. mun.;2016;52;928;427;501
Alytus t. mun.;2016;53;957;455;502
Alytus t. mun.;2016;54;954;431;523
Alytus t. mun.;2016;55;976;452;524
Alytus t. mun.;2016;56;911;421;490
Alytus t. mun.;2016;57;947;420;527
Alytus t. mun.;2016;58;761;321;440
Alytus t. mun.;2016;59;718;300;418
Alytus t. mun.;2016;60;778;308;470
Alytus t. mun.;2016;61;714;291;423
Alytus t. mun.;2016;62;756;318;438
Alytus t. mun.;2016;63;767;329;438
Alytus t. mun.;2016;64;798;282;516
Alytus t. mun.;2016;65;711;277;434
Alytus t. mun.;2016;66;739;256;483
Alytus t. mun.;2016;67;674;265;409
Alytus t. mun.;2016;68;563;217;346
Alytus t. mun.;2016;69;499;177;322
Alytus t. mun.;2016;70;556;230;326
Alytus t. mun.;2016;71;468;182;286
Alytus t. mun.;2016;72;519;206;313
Alytus t. mun.;2016;73;476;171;305
Alytus t. mun.;2016;74;489;196;293
Alytus t. mun.;2016;75;433;141;292
Alytus t. mun.;2016;76;448;152;296
Alytus t. mun.;2016;77;387;114;273
Alytus t. mun.;2016;78;362;127;235
Alytus t. mun.;2016;79;370;126;244
Alytus t. mun.;2016;80;311;95;216
Alytus t. mun.;2016;81;302;87;215
Alytus t. mun.;2016;82;252;77;175
Alytus t. mun.;2016;83;248;64;184
Alytus t. mun.;2016;84;226;50;176
Alytus t. mun.;2016;85;1105;257;848
Alytus t. mun.;2017;-1;52792;24119;28673
Alytus t. mun.;2017;0;474;256;218
Alytus t. mun.;2017;1;500;251;249
Alytus t. mun.;2017;2;487;243;244
Alytus t. mun.;2017;3;434;235;199
Alytus t. mun.;2017;4;475;235;240
Alytus t. mun.;2017;5;436;220;216
Alytus t. mun.;2017;6;422;212;210
Alytus t. mun.;2017;7;456;242;214
Alytus t. mun.;2017;8;423;209;214
Alytus t. mun.;2017;9;416;215;201
Alytus t. mun.;2017;10;458;223;235
Alytus t. mun.;2017;11;433;215;218
Alytus t. mun.;2017;12;486;246;240
Alytus t. mun.;2017;13;485;261;224
Alytus t. mun.;2017;14;463;253;210
Alytus t. mun.;2017;15;517;267;250
Alytus t. mun.;2017;16;583;294;289
Alytus t. mun.;2017;17;635;304;331
Alytus t. mun.;2017;18;604;298;306
Alytus t. mun.;2017;19;647;350;297
Alytus t. mun.;2017;20;639;300;339
Alytus t. mun.;2017;21;696;352;344
Alytus t. mun.;2017;22;714;358;356
Alytus t. mun.;2017;23;729;360;369
Alytus t. mun.;2017;24;808;394;414
Alytus t. mun.;2017;25;688;357;331
Alytus t. mun.;2017;26;618;359;259
Alytus t. mun.;2017;27;607;337;270
Alytus t. mun.;2017;28;567;329;238
Alytus t. mun.;2017;29;572;314;258
Alytus t. mun.;2017;30;575;305;270
Alytus t. mun.;2017;31;528;285;243
Alytus t. mun.;2017;32;553;325;228
Alytus t. mun.;2017;33;557;290;267
Alytus t. mun.;2017;34;502;266;236
Alytus t. mun.;2017;35;552;293;259
Alytus t. mun.;2017;36;538;271;267
Alytus t. mun.;2017;37;537;284;253
Alytus t. mun.;2017;38;619;310;309
Alytus t. mun.;2017;39;687;364;323
Alytus t. mun.;2017;40;696;357;339
Alytus t. mun.;2017;41;735;366;369
Alytus t. mun.;2017;42;724;331;393
Alytus t. mun.;2017;43;754;330;424
Alytus t. mun.;2017;44;806;347;459
Alytus t. mun.;2017;45;837;407;430
Alytus t. mun.;2017;46;785;398;387
Alytus t. mun.;2017;47;758;362;396
Alytus t. mun.;2017;48;803;343;460
Alytus t. mun.;2017;49;801;352;449
Alytus t. mun.;2017;50;828;363;465
Alytus t. mun.;2017;51;850;366;484
Alytus t. mun.;2017;52;864;424;440
Alytus t. mun.;2017;53;917;423;494
Alytus t. mun.;2017;54;927;437;490
Alytus t. mun.;2017;55;923;413;510
Alytus t. mun.;2017;56;959;442;517
Alytus t. mun.;2017;57;891;406;485
Alytus t. mun.;2017;58;926;409;517
Alytus t. mun.;2017;59;746;311;435
Alytus t. mun.;2017;60;706;293;413
Alytus t. mun.;2017;61;758;298;460
Alytus t. mun.;2017;62;704;282;422
Alytus t. mun.;2017;63;747;317;430
Alytus t. mun.;2017;64;756;321;435
Alytus t. mun.;2017;65;784;272;512
Alytus t. mun.;2017;66;695;268;427
Alytus t. mun.;2017;67;722;248;474
Alytus t. mun.;2017;68;661;257;404
Alytus t. mun.;2017;69;547;211;336
Alytus t. mun.;2017;70;492;171;321
Alytus t. mun.;2017;71;540;218;322
Alytus t. mun.;2017;72;461;176;285
Alytus t. mun.;2017;73;501;191;310
Alytus t. mun.;2017;74;459;158;301
Alytus t. mun.;2017;75;471;185;286
Alytus t. mun.;2017;76;419;130;289
Alytus t. mun.;2017;77;432;146;286
Alytus t. mun.;2017;78;373;105;268
Alytus t. mun.;2017;79;340;115;225
Alytus t. mun.;2017;80;356;116;240
Alytus t. mun.;2017;81;293;94;199
Alytus t. mun.;2017;82;286;80;206
Alytus t. mun.;2017;83;237;71;166
Alytus t. mun.;2017;84;233;60;173
Alytus t. mun.;2017;85;1169;267;902
Alytus t. mun.;2018;-1;51534;23530;28004
Alytus t. mun.;2018;0;493;253;240
Alytus t. mun.;2018;1;463;249;214
Alytus t. mun.;2018;2;482;242;240
Alytus t. mun.;2018;3;470;231;239
Alytus t. mun.;2018;4;427;231;196
Alytus t. mun.;2018;5;443;218;225
Alytus t. mun.;2018;6;423;222;201
Alytus t. mun.;2018;7;408;208;200
Alytus t. mun.;2018;8;449;236;213
Alytus t. mun.;2018;9;416;206;210
Alytus t. mun.;2018;10;416;216;200
Alytus t. mun.;2018;11;456;223;233
Alytus t. mun.;2018;12;413;207;206
Alytus t. mun.;2018;13;480;242;238
Alytus t. mun.;2018;14;480;259;221
Alytus t. mun.;2018;15;456;249;207
Alytus t. mun.;2018;16;501;259;242
Alytus t. mun.;2018;17;579;291;288
Alytus t. mun.;2018;18;626;300;326
Alytus t. mun.;2018;19;570;282;288
Alytus t. mun.;2018;20;604;323;281
Alytus t. mun.;2018;21;602;279;323
Alytus t. mun.;2018;22;646;329;317
Alytus t. mun.;2018;23;679;343;336
Alytus t. mun.;2018;24;689;338;351
Alytus t. mun.;2018;25;748;371;377
Alytus t. mun.;2018;26;644;336;308
Alytus t. mun.;2018;27;564;325;239
Alytus t. mun.;2018;28;559;316;243
Alytus t. mun.;2018;29;534;313;221
Alytus t. mun.;2018;30;532;300;232
Alytus t. mun.;2018;31;526;273;253
Alytus t. mun.;2018;32;519;278;241
Alytus t. mun.;2018;33;538;316;222
Alytus t. mun.;2018;34;538;282;256
Alytus t. mun.;2018;35;485;261;224
Alytus t. mun.;2018;36;523;272;251
Alytus t. mun.;2018;37;531;268;263
Alytus t. mun.;2018;38;523;276;247
Alytus t. mun.;2018;39;604;301;303
Alytus t. mun.;2018;40;680;359;321
Alytus t. mun.;2018;41;686;354;332
Alytus t. mun.;2018;42;717;357;360
Alytus t. mun.;2018;43;706;324;382
Alytus t. mun.;2018;44;737;322;415
Alytus t. mun.;2018;45;788;342;446
Alytus t. mun.;2018;46;818;397;421
Alytus t. mun.;2018;47;780;400;380
Alytus t. mun.;2018;48;757;365;392
Alytus t. mun.;2018;49;798;343;455
Alytus t. mun.;2018;50;792;346;446
Alytus t. mun.;2018;51;808;353;455
Alytus t. mun.;2018;52;842;364;478
Alytus t. mun.;2018;53;845;411;434
Alytus t. mun.;2018;54;905;417;488
Alytus t. mun.;2018;55;913;426;487
Alytus t. mun.;2018;56;909;408;501
Alytus t. mun.;2018;57;933;426;507
Alytus t. mun.;2018;58;877;400;477
Alytus t. mun.;2018;59;909;399;510
Alytus t. mun.;2018;60;730;299;431
Alytus t. mun.;2018;61;690;286;404
Alytus t. mun.;2018;62;746;289;457
Alytus t. mun.;2018;63;697;280;417
Alytus t. mun.;2018;64;729;309;420
Alytus t. mun.;2018;65;741;313;428
Alytus t. mun.;2018;66;757;253;504
Alytus t. mun.;2018;67;682;262;420
Alytus t. mun.;2018;68;707;240;467
Alytus t. mun.;2018;69;641;245;396
Alytus t. mun.;2018;70;533;205;328
Alytus t. mun.;2018;71;482;165;317
Alytus t. mun.;2018;72;518;207;311
Alytus t. mun.;2018;73;447;168;279
Alytus t. mun.;2018;74;488;180;308
Alytus t. mun.;2018;75;437;147;290
Alytus t. mun.;2018;76;451;173;278
Alytus t. mun.;2018;77;401;121;280
Alytus t. mun.;2018;78;413;138;275
Alytus t. mun.;2018;79;362;101;261
Alytus t. mun.;2018;80;321;103;218
Alytus t. mun.;2018;81;337;109;228
Alytus t. mun.;2018;82;266;78;188
Alytus t. mun.;2018;83;260;73;187
Alytus t. mun.;2018;84;222;67;155
Alytus t. mun.;2018;85;1237;282;955
Anykščiai d. mun.;2001;-1;35150;16497;18653
Anykščiai d. mun.;2001;0;310;158;152
Anykščiai d. mun.;2001;1;343;174;169
Anykščiai d. mun.;2001;2;335;168;167
Anykščiai d. mun.;2001;3;353;157;196
Anykščiai d. mun.;2001;4;341;179;162
Anykščiai d. mun.;2001;5;363;179;184
Anykščiai d. mun.;2001;6;390;210;180
Anykščiai d. mun.;2001;7;475;251;224
Anykščiai d. mun.;2001;8;554;288;266
Anykščiai d. mun.;2001;9;512;284;228
Anykščiai d. mun.;2001;10;535;283;252
Anykščiai d. mun.;2001;11;521;289;232
Anykščiai d. mun.;2001;12;546;284;262
Anykščiai d. mun.;2001;13;615;317;298
Anykščiai d. mun.;2001;14;542;286;256
Anykščiai d. mun.;2001;15;519;276;243
Anykščiai d. mun.;2001;16;474;235;239
Anykščiai d. mun.;2001;17;491;260;231
Anykščiai d. mun.;2001;18;353;175;178
Anykščiai d. mun.;2001;19;269;165;104
Anykščiai d. mun.;2001;20;256;150;106
Anykščiai d. mun.;2001;21;321;179;142
Anykščiai d. mun.;2001;22;308;173;135
Anykščiai d. mun.;2001;23;313;169;144
Anykščiai d. mun.;2001;24;313;169;144
Anykščiai d. mun.;2001;25;327;176;151
Anykščiai d. mun.;2001;26;357;194;163
Anykščiai d. mun.;2001;27;351;180;171
Anykščiai d. mun.;2001;28;419;234;185
Anykščiai d. mun.;2001;29;417;214;203
Anykščiai d. mun.;2001;30;436;216;220
Anykščiai d. mun.;2001;31;443;214;229
Anykščiai d. mun.;2001;32;465;231;234
Anykščiai d. mun.;2001;33;490;236;254
Anykščiai d. mun.;2001;34;476;233;243
Anykščiai d. mun.;2001;35;531;272;259
Anykščiai d. mun.;2001;36;486;265;221
Anykščiai d. mun.;2001;37;488;272;216
Anykščiai d. mun.;2001;38;541;284;257
Anykščiai d. mun.;2001;39;531;258;273
Anykščiai d. mun.;2001;40;520;271;249
Anykščiai d. mun.;2001;41;503;245;258
Anykščiai d. mun.;2001;42;470;262;208
Anykščiai d. mun.;2001;43;457;215;242
Anykščiai d. mun.;2001;44;401;195;206
Anykščiai d. mun.;2001;45;435;217;218
Anykščiai d. mun.;2001;46;342;187;155
Anykščiai d. mun.;2001;47;380;195;185
Anykščiai d. mun.;2001;48;372;183;189
Anykščiai d. mun.;2001;49;424;227;197
Anykščiai d. mun.;2001;50;398;214;184
Anykščiai d. mun.;2001;51;405;191;214
Anykščiai d. mun.;2001;52;399;209;190
Anykščiai d. mun.;2001;53;304;150;154
Anykščiai d. mun.;2001;54;318;148;170
Anykščiai d. mun.;2001;55;438;201;237
Anykščiai d. mun.;2001;56;343;167;176
Anykščiai d. mun.;2001;57;406;172;234
Anykščiai d. mun.;2001;58;472;205;267
Anykščiai d. mun.;2001;59;490;224;266
Anykščiai d. mun.;2001;60;435;174;261
Anykščiai d. mun.;2001;61;511;212;299
Anykščiai d. mun.;2001;62;488;205;283
Anykščiai d. mun.;2001;63;454;182;272
Anykščiai d. mun.;2001;64;495;195;300
Anykščiai d. mun.;2001;65;459;197;262
Anykščiai d. mun.;2001;66;416;159;257
Anykščiai d. mun.;2001;67;488;189;299
Anykščiai d. mun.;2001;68;488;190;298
Anykščiai d. mun.;2001;69;420;158;262
Anykščiai d. mun.;2001;70;472;154;318
Anykščiai d. mun.;2001;71;416;146;270
Anykščiai d. mun.;2001;72;451;170;281
Anykščiai d. mun.;2001;73;446;162;284
Anykščiai d. mun.;2001;74;348;101;247
Anykščiai d. mun.;2001;75;354;104;250
Anykščiai d. mun.;2001;76;342;98;244
Anykščiai d. mun.;2001;77;339;113;226
Anykščiai d. mun.;2001;78;253;88;165
Anykščiai d. mun.;2001;79;265;71;194
Anykščiai d. mun.;2001;80;245;81;164
Anykščiai d. mun.;2001;81;150;44;106
Anykščiai d. mun.;2001;82;102;26;76
Anykščiai d. mun.;2001;83;122;33;89
Anykščiai d. mun.;2001;84;118;35;83
Anykščiai d. mun.;2001;85;686;195;491
Anykščiai d. mun.;2002;-1;34752;16303;18449
Anykščiai d. mun.;2002;0;259;140;119
Anykščiai d. mun.;2002;1;308;151;157
Anykščiai d. mun.;2002;2;333;171;162
Anykščiai d. mun.;2002;3;333;167;166
Anykščiai d. mun.;2002;4;348;154;194
Anykščiai d. mun.;2002;5;339;178;161
Anykščiai d. mun.;2002;6;357;177;180
Anykščiai d. mun.;2002;7;391;210;181
Anykščiai d. mun.;2002;8;472;250;222
Anykščiai d. mun.;2002;9;544;279;265
Anykščiai d. mun.;2002;10;511;284;227
Anykščiai d. mun.;2002;11;530;279;251
Anykščiai d. mun.;2002;12;517;284;233
Anykščiai d. mun.;2002;13;539;281;258
Anykščiai d. mun.;2002;14;608;313;295
Anykščiai d. mun.;2002;15;535;282;253
Anykščiai d. mun.;2002;16;514;273;241
Anykščiai d. mun.;2002;17;470;233;237
Anykščiai d. mun.;2002;18;489;258;231
Anykščiai d. mun.;2002;19;343;172;171
Anykščiai d. mun.;2002;20;264;163;101
Anykščiai d. mun.;2002;21;258;153;105
Anykščiai d. mun.;2002;22;319;175;144
Anykščiai d. mun.;2002;23;314;171;143
Anykščiai d. mun.;2002;24;319;174;145
Anykščiai d. mun.;2002;25;317;168;149
Anykščiai d. mun.;2002;26;320;172;148
Anykščiai d. mun.;2002;27;355;191;164
Anykščiai d. mun.;2002;28;347;178;169
Anykščiai d. mun.;2002;29;405;224;181
Anykščiai d. mun.;2002;30;401;208;193
Anykščiai d. mun.;2002;31;423;210;213
Anykščiai d. mun.;2002;32;434;212;222
Anykščiai d. mun.;2002;33;462;229;233
Anykščiai d. mun.;2002;34;484;233;251
Anykščiai d. mun.;2002;35;470;228;242
Anykščiai d. mun.;2002;36;525;269;256
Anykščiai d. mun.;2002;37;477;260;217
Anykščiai d. mun.;2002;38;481;268;213
Anykščiai d. mun.;2002;39;531;274;257
Anykščiai d. mun.;2002;40;520;251;269
Anykščiai d. mun.;2002;41;510;266;244
Anykščiai d. mun.;2002;42;501;242;259
Anykščiai d. mun.;2002;43;473;265;208
Anykščiai d. mun.;2002;44;455;215;240
Anykščiai d. mun.;2002;45;396;192;204
Anykščiai d. mun.;2002;46;431;214;217
Anykščiai d. mun.;2002;47;344;188;156
Anykščiai d. mun.;2002;48;378;195;183
Anykščiai d. mun.;2002;49;367;182;185
Anykščiai d. mun.;2002;50;415;219;196
Anykščiai d. mun.;2002;51;381;202;179
Anykščiai d. mun.;2002;52;402;189;213
Anykščiai d. mun.;2002;53;395;206;189
Anykščiai d. mun.;2002;54;300;148;152
Anykščiai d. mun.;2002;55;312;145;167
Anykščiai d. mun.;2002;56;422;190;232
Anykščiai d. mun.;2002;57;341;167;174
Anykščiai d. mun.;2002;58;400;170;230
Anykščiai d. mun.;2002;59;461;200;261
Anykščiai d. mun.;2002;60;486;221;265
Anykščiai d. mun.;2002;61;433;170;263
Anykščiai d. mun.;2002;62;500;203;297
Anykščiai d. mun.;2002;63;481;199;282
Anykščiai d. mun.;2002;64;447;178;269
Anykščiai d. mun.;2002;65;498;195;303
Anykščiai d. mun.;2002;66;461;195;266
Anykščiai d. mun.;2002;67;411;157;254
Anykščiai d. mun.;2002;68;479;185;294
Anykščiai d. mun.;2002;69;480;183;297
Anykščiai d. mun.;2002;70;417;157;260
Anykščiai d. mun.;2002;71;466;148;318
Anykščiai d. mun.;2002;72;408;134;274
Anykščiai d. mun.;2002;73;442;166;276
Anykščiai d. mun.;2002;74;438;159;279
Anykščiai d. mun.;2002;75;333;97;236
Anykščiai d. mun.;2002;76;341;99;242
Anykščiai d. mun.;2002;77;327;91;236
Anykščiai d. mun.;2002;78;326;109;217
Anykščiai d. mun.;2002;79;237;85;152
Anykščiai d. mun.;2002;80;252;66;186
Anykščiai d. mun.;2002;81;225;74;151
Anykščiai d. mun.;2002;82;142;42;100
Anykščiai d. mun.;2002;83;98;26;72
Anykščiai d. mun.;2002;84;111;31;80
Anykščiai d. mun.;2002;85;663;191;472
Anykščiai d. mun.;2003;-1;34297;16071;18226
Anykščiai d. mun.;2003;0;234;105;129
Anykščiai d. mun.;2003;1;256;141;115
Anykščiai d. mun.;2003;2;305;150;155
Anykščiai d. mun.;2003;3;325;166;159
Anykščiai d. mun.;2003;4;331;167;164
Anykščiai d. mun.;2003;5;351;156;195
Anykščiai d. mun.;2003;6;337;177;160
Anykščiai d. mun.;2003;7;355;178;177
Anykščiai d. mun.;2003;8;390;209;181
Anykščiai d. mun.;2003;9;466;246;220
Anykščiai d. mun.;2003;10;541;279;262
Anykščiai d. mun.;2003;11;508;284;224
Anykščiai d. mun.;2003;12;520;275;245
Anykščiai d. mun.;2003;13;505;277;228
Anykščiai d. mun.;2003;14;539;278;261
Anykščiai d. mun.;2003;15;594;303;291
Anykščiai d. mun.;2003;16;526;277;249
Anykščiai d. mun.;2003;17;505;267;238
Anykščiai d. mun.;2003;18;465;233;232
Anykščiai d. mun.;2003;19;486;255;231
Anykščiai d. mun.;2003;20;340;170;170
Anykščiai d. mun.;2003;21;262;163;99
Anykščiai d. mun.;2003;22;253;151;102
Anykščiai d. mun.;2003;23;321;175;146
Anykščiai d. mun.;2003;24;315;169;146
Anykščiai d. mun.;2003;25;322;175;147
Anykščiai d. mun.;2003;26;310;165;145
Anykščiai d. mun.;2003;27;310;163;147
Anykščiai d. mun.;2003;28;340;185;155
Anykščiai d. mun.;2003;29;337;171;166
Anykščiai d. mun.;2003;30;399;220;179
Anykščiai d. mun.;2003;31;396;208;188
Anykščiai d. mun.;2003;32;415;206;209
Anykščiai d. mun.;2003;33;433;211;222
Anykščiai d. mun.;2003;34;456;226;230
Anykščiai d. mun.;2003;35;477;229;248
Anykščiai d. mun.;2003;36;462;225;237
Anykščiai d. mun.;2003;37;514;262;252
Anykščiai d. mun.;2003;38;472;254;218
Anykščiai d. mun.;2003;39;477;266;211
Anykščiai d. mun.;2003;40;528;272;256
Anykščiai d. mun.;2003;41;520;250;270
Anykščiai d. mun.;2003;42;514;269;245
Anykščiai d. mun.;2003;43;498;242;256
Anykščiai d. mun.;2003;44;477;268;209
Anykščiai d. mun.;2003;45;446;210;236
Anykščiai d. mun.;2003;46;394;190;204
Anykščiai d. mun.;2003;47;433;215;218
Anykščiai d. mun.;2003;48;346;191;155
Anykščiai d. mun.;2003;49;377;194;183
Anykščiai d. mun.;2003;50;364;182;182
Anykščiai d. mun.;2003;51;410;215;195
Anykščiai d. mun.;2003;52;381;202;179
Anykščiai d. mun.;2003;53;396;187;209
Anykščiai d. mun.;2003;54;390;204;186
Anykščiai d. mun.;2003;55;292;140;152
Anykščiai d. mun.;2003;56;308;142;166
Anykščiai d. mun.;2003;57;418;189;229
Anykščiai d. mun.;2003;58;337;163;174
Anykščiai d. mun.;2003;59;394;166;228
Anykščiai d. mun.;2003;60;449;192;257
Anykščiai d. mun.;2003;61;472;213;259
Anykščiai d. mun.;2003;62;429;169;260
Anykščiai d. mun.;2003;63;495;202;293
Anykščiai d. mun.;2003;64;473;195;278
Anykščiai d. mun.;2003;65;445;176;269
Anykščiai d. mun.;2003;66;492;191;301
Anykščiai d. mun.;2003;67;453;189;264
Anykščiai d. mun.;2003;68;405;152;253
Anykščiai d. mun.;2003;69;468;180;288
Anykščiai d. mun.;2003;70;470;175;295
Anykščiai d. mun.;2003;71;391;145;246
Anykščiai d. mun.;2003;72;458;145;313
Anykščiai d. mun.;2003;73;394;125;269
Anykščiai d. mun.;2003;74;421;151;270
Anykščiai d. mun.;2003;75;421;147;274
Anykščiai d. mun.;2003;76;328;93;235
Anykščiai d. mun.;2003;77;328;95;233
Anykščiai d. mun.;2003;78;311;86;225
Anykščiai d. mun.;2003;79;296;93;203
Anykščiai d. mun.;2003;80;214;72;142
Anykščiai d. mun.;2003;81;234;62;172
Anykščiai d. mun.;2003;82;209;71;138
Anykščiai d. mun.;2003;83;131;37;94
Anykščiai d. mun.;2003;84;88;23;65
Anykščiai d. mun.;2003;85;649;184;465
Anykščiai d. mun.;2004;-1;33783;15827;17956
Anykščiai d. mun.;2004;0;249;122;127
Anykščiai d. mun.;2004;1;233;105;128
Anykščiai d. mun.;2004;2;252;141;111
Anykščiai d. mun.;2004;3;302;152;150
Anykščiai d. mun.;2004;4;330;168;162
Anykščiai d. mun.;2004;5;328;164;164
Anykščiai d. mun.;2004;6;353;157;196
Anykščiai d. mun.;2004;7;340;179;161
Anykščiai d. mun.;2004;8;357;178;179
Anykščiai d. mun.;2004;9;392;211;181
Anykščiai d. mun.;2004;10;459;239;220
Anykščiai d. mun.;2004;11;537;279;258
Anykščiai d. mun.;2004;12;498;280;218
Anykščiai d. mun.;2004;13;520;275;245
Anykščiai d. mun.;2004;14;493;274;219
Anykščiai d. mun.;2004;15;530;276;254
Anykščiai d. mun.;2004;16;587;301;286
Anykščiai d. mun.;2004;17;515;271;244
Anykščiai d. mun.;2004;18;493;261;232
Anykščiai d. mun.;2004;19;457;230;227
Anykščiai d. mun.;2004;20;474;250;224
Anykščiai d. mun.;2004;21;333;167;166
Anykščiai d. mun.;2004;22;255;160;95
Anykščiai d. mun.;2004;23;245;146;99
Anykščiai d. mun.;2004;24;316;172;144
Anykščiai d. mun.;2004;25;310;165;145
Anykščiai d. mun.;2004;26;307;169;138
Anykščiai d. mun.;2004;27;298;161;137
Anykščiai d. mun.;2004;28;297;156;141
Anykščiai d. mun.;2004;29;331;179;152
Anykščiai d. mun.;2004;30;323;167;156
Anykščiai d. mun.;2004;31;391;213;178
Anykščiai d. mun.;2004;32;395;206;189
Anykščiai d. mun.;2004;33;410;206;204
Anykščiai d. mun.;2004;34;418;205;213
Anykščiai d. mun.;2004;35;447;223;224
Anykščiai d. mun.;2004;36;469;224;245
Anykščiai d. mun.;2004;37;447;216;231
Anykščiai d. mun.;2004;38;502;256;246
Anykščiai d. mun.;2004;39;466;250;216
Anykščiai d. mun.;2004;40;472;261;211
Anykščiai d. mun.;2004;41;526;268;258
Anykščiai d. mun.;2004;42;510;246;264
Anykščiai d. mun.;2004;43;509;265;244
Anykščiai d. mun.;2004;44;490;237;253
Anykščiai d. mun.;2004;45;471;269;202
Anykščiai d. mun.;2004;46;444;208;236
Anykščiai d. mun.;2004;47;390;189;201
Anykščiai d. mun.;2004;48;424;208;216
Anykščiai d. mun.;2004;49;341;187;154
Anykščiai d. mun.;2004;50;375;194;181
Anykščiai d. mun.;2004;51;360;180;180
Anykščiai d. mun.;2004;52;408;215;193
Anykščiai d. mun.;2004;53;378;198;180
Anykščiai d. mun.;2004;54;395;186;209
Anykščiai d. mun.;2004;55;386;200;186
Anykščiai d. mun.;2004;56;289;139;150
Anykščiai d. mun.;2004;57;305;141;164
Anykščiai d. mun.;2004;58;413;187;226
Anykščiai d. mun.;2004;59;335;159;176
Anykščiai d. mun.;2004;60;383;160;223
Anykščiai d. mun.;2004;61;444;189;255
Anykščiai d. mun.;2004;62;473;216;257
Anykščiai d. mun.;2004;63;423;164;259
Anykščiai d. mun.;2004;64;485;195;290
Anykščiai d. mun.;2004;65;474;197;277
Anykščiai d. mun.;2004;66;442;173;269
Anykščiai d. mun.;2004;67;482;183;299
Anykščiai d. mun.;2004;68;442;183;259
Anykščiai d. mun.;2004;69;399;147;252
Anykščiai d. mun.;2004;70;451;167;284
Anykščiai d. mun.;2004;71;457;173;284
Anykščiai d. mun.;2004;72;385;140;245
Anykščiai d. mun.;2004;73;445;141;304
Anykščiai d. mun.;2004;74;379;116;263
Anykščiai d. mun.;2004;75;410;145;265
Anykščiai d. mun.;2004;76;396;134;262
Anykščiai d. mun.;2004;77;310;86;224
Anykščiai d. mun.;2004;78;305;78;227
Anykščiai d. mun.;2004;79;298;79;219
Anykščiai d. mun.;2004;80;274;84;190
Anykščiai d. mun.;2004;81;201;69;132
Anykščiai d. mun.;2004;82;219;57;162
Anykščiai d. mun.;2004;83;188;62;126
Anykščiai d. mun.;2004;84;121;33;88
Anykščiai d. mun.;2004;85;617;165;452
Anykščiai d. mun.;2005;-1;33119;15489;17630
Anykščiai d. mun.;2005;0;278;150;128
Anykščiai d. mun.;2005;1;240;120;120
Anykščiai d. mun.;2005;2;237;106;131
Anykščiai d. mun.;2005;3;250;140;110
Anykščiai d. mun.;2005;4;298;147;151
Anykščiai d. mun.;2005;5;325;170;155
Anykščiai d. mun.;2005;6;329;165;164
Anykščiai d. mun.;2005;7;352;157;195
Anykščiai d. mun.;2005;8;339;178;161
Anykščiai d. mun.;2005;9;357;178;179
Anykščiai d. mun.;2005;10;390;209;181
Anykščiai d. mun.;2005;11;455;239;216
Anykščiai d. mun.;2005;12;534;280;254
Anykščiai d. mun.;2005;13;498;278;220
Anykščiai d. mun.;2005;14;509;269;240
Anykščiai d. mun.;2005;15;489;271;218
Anykščiai d. mun.;2005;16;520;273;247
Anykščiai d. mun.;2005;17;573;292;281
Anykščiai d. mun.;2005;18;507;265;242
Anykščiai d. mun.;2005;19;481;255;226
Anykščiai d. mun.;2005;20;441;222;219
Anykščiai d. mun.;2005;21;460;241;219
Anykščiai d. mun.;2005;22;318;162;156
Anykščiai d. mun.;2005;23;240;156;84
Anykščiai d. mun.;2005;24;226;134;92
Anykščiai d. mun.;2005;25;307;168;139
Anykščiai d. mun.;2005;26;305;165;140
Anykščiai d. mun.;2005;27;280;152;128
Anykščiai d. mun.;2005;28;290;158;132
Anykščiai d. mun.;2005;29;285;153;132
Anykščiai d. mun.;2005;30;312;172;140
Anykščiai d. mun.;2005;31;308;157;151
Anykščiai d. mun.;2005;32;375;206;169
Anykščiai d. mun.;2005;33;388;199;189
Anykščiai d. mun.;2005;34;394;200;194
Anykščiai d. mun.;2005;35;414;201;213
Anykščiai d. mun.;2005;36;441;217;224
Anykščiai d. mun.;2005;37;461;219;242
Anykščiai d. mun.;2005;38;437;212;225
Anykščiai d. mun.;2005;39;494;249;245
Anykščiai d. mun.;2005;40;460;246;214
Anykščiai d. mun.;2005;41;464;255;209
Anykščiai d. mun.;2005;42;512;262;250
Anykščiai d. mun.;2005;43;511;248;263
Anykščiai d. mun.;2005;44;502;260;242
Anykščiai d. mun.;2005;45;487;238;249
Anykščiai d. mun.;2005;46;466;265;201
Anykščiai d. mun.;2005;47;440;207;233
Anykščiai d. mun.;2005;48;382;183;199
Anykščiai d. mun.;2005;49;419;204;215
Anykščiai d. mun.;2005;50;332;185;147
Anykščiai d. mun.;2005;51;372;192;180
Anykščiai d. mun.;2005;52;354;176;178
Anykščiai d. mun.;2005;53;397;210;187
Anykščiai d. mun.;2005;54;369;189;180
Anykščiai d. mun.;2005;55;391;183;208
Anykščiai d. mun.;2005;56;381;195;186
Anykščiai d. mun.;2005;57;285;137;148
Anykščiai d. mun.;2005;58;304;137;167
Anykščiai d. mun.;2005;59;413;187;226
Anykščiai d. mun.;2005;60;334;156;178
Anykščiai d. mun.;2005;61;380;157;223
Anykščiai d. mun.;2005;62;437;182;255
Anykščiai d. mun.;2005;63;459;204;255
Anykščiai d. mun.;2005;64;412;158;254
Anykščiai d. mun.;2005;65;476;186;290
Anykščiai d. mun.;2005;66;456;185;271
Anykščiai d. mun.;2005;67;426;160;266
Anykščiai d. mun.;2005;68;469;173;296
Anykščiai d. mun.;2005;69;435;179;256
Anykščiai d. mun.;2005;70;391;143;248
Anykščiai d. mun.;2005;71;436;156;280
Anykščiai d. mun.;2005;72;440;165;275
Anykščiai d. mun.;2005;73;371;134;237
Anykščiai d. mun.;2005;74;432;132;300
Anykščiai d. mun.;2005;75;363;111;252
Anykščiai d. mun.;2005;76;393;132;261
Anykščiai d. mun.;2005;77;379;124;255
Anykščiai d. mun.;2005;78;294;78;216
Anykščiai d. mun.;2005;79;283;68;215
Anykščiai d. mun.;2005;80;273;62;211
Anykščiai d. mun.;2005;81;261;77;184
Anykščiai d. mun.;2005;82;186;61;125
Anykščiai d. mun.;2005;83;200;55;145
Anykščiai d. mun.;2005;84;167;49;118
Anykščiai d. mun.;2005;85;588;158;430
Anykščiai d. mun.;2006;-1;32275;15047;17228
Anykščiai d. mun.;2006;0;246;112;134
Anykščiai d. mun.;2006;1;270;147;123
Anykščiai d. mun.;2006;2;237;121;116
Anykščiai d. mun.;2006;3;231;101;130
Anykščiai d. mun.;2006;4;247;138;109
Anykščiai d. mun.;2006;5;294;146;148
Anykščiai d. mun.;2006;6;324;169;155
Anykščiai d. mun.;2006;7;323;163;160
Anykščiai d. mun.;2006;8;350;154;196
Anykščiai d. mun.;2006;9;340;179;161
Anykščiai d. mun.;2006;10;354;177;177
Anykščiai d. mun.;2006;11;387;209;178
Anykščiai d. mun.;2006;12;450;235;215
Anykščiai d. mun.;2006;13;524;274;250
Anykščiai d. mun.;2006;14;489;272;217
Anykščiai d. mun.;2006;15;497;260;237
Anykščiai d. mun.;2006;16;475;262;213
Anykščiai d. mun.;2006;17;506;264;242
Anykščiai d. mun.;2006;18;553;280;273
Anykščiai d. mun.;2006;19;477;251;226
Anykščiai d. mun.;2006;20;455;239;216
Anykščiai d. mun.;2006;21;412;207;205
Anykščiai d. mun.;2006;22;434;231;203
Anykščiai d. mun.;2006;23;293;151;142
Anykščiai d. mun.;2006;24;224;147;77
Anykščiai d. mun.;2006;25;202;123;79
Anykščiai d. mun.;2006;26;289;158;131
Anykščiai d. mun.;2006;27;296;162;134
Anykščiai d. mun.;2006;28;255;140;115
Anykščiai d. mun.;2006;29;271;146;125
Anykščiai d. mun.;2006;30;270;143;127
Anykščiai d. mun.;2006;31;296;163;133
Anykščiai d. mun.;2006;32;298;155;143
Anykščiai d. mun.;2006;33;359;197;162
Anykščiai d. mun.;2006;34;373;191;182
Anykščiai d. mun.;2006;35;378;189;189
Anykščiai d. mun.;2006;36;408;199;209
Anykščiai d. mun.;2006;37;429;208;221
Anykščiai d. mun.;2006;38;449;211;238
Anykščiai d. mun.;2006;39;431;207;224
Anykščiai d. mun.;2006;40;492;247;245
Anykščiai d. mun.;2006;41;453;243;210
Anykščiai d. mun.;2006;42;453;249;204
Anykščiai d. mun.;2006;43;500;255;245
Anykščiai d. mun.;2006;44;506;244;262
Anykščiai d. mun.;2006;45;501;258;243
Anykščiai d. mun.;2006;46;482;238;244
Anykščiai d. mun.;2006;47;460;260;200
Anykščiai d. mun.;2006;48;432;202;230
Anykščiai d. mun.;2006;49;375;180;195
Anykščiai d. mun.;2006;50;412;200;212
Anykščiai d. mun.;2006;51;329;183;146
Anykščiai d. mun.;2006;52;363;186;177
Anykščiai d. mun.;2006;53;342;167;175
Anykščiai d. mun.;2006;54;392;203;189
Anykščiai d. mun.;2006;55;367;189;178
Anykščiai d. mun.;2006;56;382;177;205
Anykščiai d. mun.;2006;57;370;187;183
Anykščiai d. mun.;2006;58;280;132;148
Anykščiai d. mun.;2006;59;298;134;164
Anykščiai d. mun.;2006;60;398;176;222
Anykščiai d. mun.;2006;61;333;154;179
Anykščiai d. mun.;2006;62;372;152;220
Anykščiai d. mun.;2006;63;432;178;254
Anykščiai d. mun.;2006;64;451;197;254
Anykščiai d. mun.;2006;65;412;154;258
Anykščiai d. mun.;2006;66;472;182;290
Anykščiai d. mun.;2006;67;446;178;268
Anykščiai d. mun.;2006;68;407;154;253
Anykščiai d. mun.;2006;69;462;170;292
Anykščiai d. mun.;2006;70;428;174;254
Anykščiai d. mun.;2006;71;382;138;244
Anykščiai d. mun.;2006;72;424;152;272
Anykščiai d. mun.;2006;73;425;155;270
Anykščiai d. mun.;2006;74;365;128;237
Anykščiai d. mun.;2006;75;415;121;294
Anykščiai d. mun.;2006;76;350;102;248
Anykščiai d. mun.;2006;77;373;120;253
Anykščiai d. mun.;2006;78;358;117;241
Anykščiai d. mun.;2006;79;279;70;209
Anykščiai d. mun.;2006;80;263;60;203
Anykščiai d. mun.;2006;81;255;59;196
Anykščiai d. mun.;2006;82;235;72;163
Anykščiai d. mun.;2006;83;173;58;115
Anykščiai d. mun.;2006;84;169;43;126
Anykščiai d. mun.;2006;85;611;168;443
Anykščiai d. mun.;2007;-1;31583;14689;16894
Anykščiai d. mun.;2007;0;210;114;96
Anykščiai d. mun.;2007;1;242;110;132
Anykščiai d. mun.;2007;2;268;146;122
Anykščiai d. mun.;2007;3;237;116;121
Anykščiai d. mun.;2007;4;227;98;129
Anykščiai d. mun.;2007;5;241;134;107
Anykščiai d. mun.;2007;6;291;145;146
Anykščiai d. mun.;2007;7;322;165;157
Anykščiai d. mun.;2007;8;321;162;159
Anykščiai d. mun.;2007;9;351;156;195
Anykščiai d. mun.;2007;10;339;179;160
Anykščiai d. mun.;2007;11;355;176;179
Anykščiai d. mun.;2007;12;385;205;180
Anykščiai d. mun.;2007;13;449;235;214
Anykščiai d. mun.;2007;14;520;272;248
Anykščiai d. mun.;2007;15;483;269;214
Anykščiai d. mun.;2007;16;492;258;234
Anykščiai d. mun.;2007;17;469;257;212
Anykščiai d. mun.;2007;18;489;254;235
Anykščiai d. mun.;2007;19;539;275;264
Anykščiai d. mun.;2007;20;462;245;217
Anykščiai d. mun.;2007;21;443;232;211
Anykščiai d. mun.;2007;22;403;203;200
Anykščiai d. mun.;2007;23;422;224;198
Anykščiai d. mun.;2007;24;288;148;140
Anykščiai d. mun.;2007;25;213;146;67
Anykščiai d. mun.;2007;26;185;108;77
Anykščiai d. mun.;2007;27;281;151;130
Anykščiai d. mun.;2007;28;287;158;129
Anykščiai d. mun.;2007;29;242;135;107
Anykščiai d. mun.;2007;30;262;141;121
Anykščiai d. mun.;2007;31;262;138;124
Anykščiai d. mun.;2007;32;283;153;130
Anykščiai d. mun.;2007;33;286;150;136
Anykščiai d. mun.;2007;34;353;194;159
Anykščiai d. mun.;2007;35;365;187;178
Anykščiai d. mun.;2007;36;368;184;184
Anykščiai d. mun.;2007;37;401;195;206
Anykščiai d. mun.;2007;38;422;201;221
Anykščiai d. mun.;2007;39;444;211;233
Anykščiai d. mun.;2007;40;424;202;222
Anykščiai d. mun.;2007;41;486;244;242
Anykščiai d. mun.;2007;42;447;240;207
Anykščiai d. mun.;2007;43;447;246;201
Anykščiai d. mun.;2007;44;493;248;245
Anykščiai d. mun.;2007;45;501;238;263
Anykščiai d. mun.;2007;46;489;252;237
Anykščiai d. mun.;2007;47;476;234;242
Anykščiai d. mun.;2007;48;457;257;200
Anykščiai d. mun.;2007;49;429;201;228
Anykščiai d. mun.;2007;50;364;172;192
Anykščiai d. mun.;2007;51;407;195;212
Anykščiai d. mun.;2007;52;327;180;147
Anykščiai d. mun.;2007;53;357;181;176
Anykščiai d. mun.;2007;54;336;162;174
Anykščiai d. mun.;2007;55;383;198;185
Anykščiai d. mun.;2007;56;361;184;177
Anykščiai d. mun.;2007;57;372;170;202
Anykščiai d. mun.;2007;58;367;184;183
Anykščiai d. mun.;2007;59;267;122;145
Anykščiai d. mun.;2007;60;291;129;162
Anykščiai d. mun.;2007;61;391;172;219
Anykščiai d. mun.;2007;62;333;152;181
Anykščiai d. mun.;2007;63;365;146;219
Anykščiai d. mun.;2007;64;418;168;250
Anykščiai d. mun.;2007;65;442;191;251
Anykščiai d. mun.;2007;66;404;148;256
Anykščiai d. mun.;2007;67;467;178;289
Anykščiai d. mun.;2007;68;434;172;262
Anykščiai d. mun.;2007;69;395;147;248
Anykščiai d. mun.;2007;70;447;162;285
Anykščiai d. mun.;2007;71;414;167;247
Anykščiai d. mun.;2007;72;369;129;240
Anykščiai d. mun.;2007;73;416;148;268
Anykščiai d. mun.;2007;74;410;146;264
Anykščiai d. mun.;2007;75;349;118;231
Anykščiai d. mun.;2007;76;406;113;293
Anykščiai d. mun.;2007;77;335;97;238
Anykščiai d. mun.;2007;78;350;108;242
Anykščiai d. mun.;2007;79;332;105;227
Anykščiai d. mun.;2007;80;265;66;199
Anykščiai d. mun.;2007;81;243;52;191
Anykščiai d. mun.;2007;82;233;51;182
Anykščiai d. mun.;2007;83;206;65;141
Anykščiai d. mun.;2007;84;155;51;104
Anykščiai d. mun.;2007;85;621;168;453
Anykščiai d. mun.;2008;-1;30929;14323;16606
Anykščiai d. mun.;2008;0;191;102;89
Anykščiai d. mun.;2008;1;206;112;94
Anykščiai d. mun.;2008;2;241;108;133
Anykščiai d. mun.;2008;3;263;142;121
Anykščiai d. mun.;2008;4;232;114;118
Anykščiai d. mun.;2008;5;223;97;126
Anykščiai d. mun.;2008;6;246;137;109
Anykščiai d. mun.;2008;7;287;143;144
Anykščiai d. mun.;2008;8;319;164;155
Anykščiai d. mun.;2008;9;322;160;162
Anykščiai d. mun.;2008;10;354;157;197
Anykščiai d. mun.;2008;11;342;181;161
Anykščiai d. mun.;2008;12;353;174;179
Anykščiai d. mun.;2008;13;389;210;179
Anykščiai d. mun.;2008;14;446;234;212
Anykščiai d. mun.;2008;15;517;270;247
Anykščiai d. mun.;2008;16;479;265;214
Anykščiai d. mun.;2008;17;486;253;233
Anykščiai d. mun.;2008;18;463;253;210
Anykščiai d. mun.;2008;19;480;249;231
Anykščiai d. mun.;2008;20;528;267;261
Anykščiai d. mun.;2008;21;450;239;211
Anykščiai d. mun.;2008;22;435;226;209
Anykščiai d. mun.;2008;23;388;194;194
Anykščiai d. mun.;2008;24;407;218;189
Anykščiai d. mun.;2008;25;277;145;132
Anykščiai d. mun.;2008;26;199;135;64
Anykščiai d. mun.;2008;27;175;100;75
Anykščiai d. mun.;2008;28;262;142;120
Anykščiai d. mun.;2008;29;275;150;125
Anykščiai d. mun.;2008;30;225;124;101
Anykščiai d. mun.;2008;31;252;136;116
Anykščiai d. mun.;2008;32;261;139;122
Anykščiai d. mun.;2008;33;281;151;130
Anykščiai d. mun.;2008;34;281;148;133
Anykščiai d. mun.;2008;35;344;187;157
Anykščiai d. mun.;2008;36;358;184;174
Anykščiai d. mun.;2008;37;367;181;186
Anykščiai d. mun.;2008;38;393;190;203
Anykščiai d. mun.;2008;39;414;197;217
Anykščiai d. mun.;2008;40;437;205;232
Anykščiai d. mun.;2008;41;418;199;219
Anykščiai d. mun.;2008;42;480;241;239
Anykščiai d. mun.;2008;43;443;235;208
Anykščiai d. mun.;2008;44;440;241;199
Anykščiai d. mun.;2008;45;481;242;239
Anykščiai d. mun.;2008;46;497;236;261
Anykščiai d. mun.;2008;47;488;252;236
Anykščiai d. mun.;2008;48;470;229;241
Anykščiai d. mun.;2008;49;450;252;198
Anykščiai d. mun.;2008;50;429;201;228
Anykščiai d. mun.;2008;51;363;171;192
Anykščiai d. mun.;2008;52;406;195;211
Anykščiai d. mun.;2008;53;326;180;146
Anykščiai d. mun.;2008;54;350;176;174
Anykščiai d. mun.;2008;55;328;156;172
Anykščiai d. mun.;2008;56;379;196;183
Anykščiai d. mun.;2008;57;353;179;174
Anykščiai d. mun.;2008;58;370;170;200
Anykščiai d. mun.;2008;59;361;179;182
Anykščiai d. mun.;2008;60;259;115;144
Anykščiai d. mun.;2008;61;289;128;161
Anykščiai d. mun.;2008;62;381;163;218
Anykščiai d. mun.;2008;63;323;142;181
Anykščiai d. mun.;2008;64;358;141;217
Anykščiai d. mun.;2008;65;413;165;248
Anykščiai d. mun.;2008;66;431;183;248
Anykščiai d. mun.;2008;67;384;132;252
Anykščiai d. mun.;2008;68;459;173;286
Anykščiai d. mun.;2008;69;426;163;263
Anykščiai d. mun.;2008;70;384;144;240
Anykščiai d. mun.;2008;71;432;157;275
Anykščiai d. mun.;2008;72;396;155;241
Anykščiai d. mun.;2008;73;349;119;230
Anykščiai d. mun.;2008;74;394;137;257
Anykščiai d. mun.;2008;75;392;134;258
Anykščiai d. mun.;2008;76;339;112;227
Anykščiai d. mun.;2008;77;384;104;280
Anykščiai d. mun.;2008;78;321;88;233
Anykščiai d. mun.;2008;79;333;96;237
Anykščiai d. mun.;2008;80;307;92;215
Anykščiai d. mun.;2008;81;245;57;188
Anykščiai d. mun.;2008;82;227;46;181
Anykščiai d. mun.;2008;83;212;45;167
Anykščiai d. mun.;2008;84;179;50;129
Anykščiai d. mun.;2008;85;632;169;463
Anykščiai d. mun.;2009;-1;30285;14016;16269
Anykščiai d. mun.;2009;0;237;116;121
Anykščiai d. mun.;2009;1;195;104;91
Anykščiai d. mun.;2009;2;205;112;93
Anykščiai d. mun.;2009;3;239;106;133
Anykščiai d. mun.;2009;4;252;136;116
Anykščiai d. mun.;2009;5;228;112;116
Anykščiai d. mun.;2009;6;222;97;125
Anykščiai d. mun.;2009;7;246;138;108
Anykščiai d. mun.;2009;8;281;140;141
Anykščiai d. mun.;2009;9;324;166;158
Anykščiai d. mun.;2009;10;320;157;163
Anykščiai d. mun.;2009;11;357;159;198
Anykščiai d. mun.;2009;12;341;182;159
Anykščiai d. mun.;2009;13;352;174;178
Anykščiai d. mun.;2009;14;387;206;181
Anykščiai d. mun.;2009;15;443;230;213
Anykščiai d. mun.;2009;16;515;271;244
Anykščiai d. mun.;2009;17;476;261;215
Anykščiai d. mun.;2009;18;478;251;227
Anykščiai d. mun.;2009;19;452;248;204
Anykščiai d. mun.;2009;20;473;246;227
Anykščiai d. mun.;2009;21;518;259;259
Anykščiai d. mun.;2009;22;442;235;207
Anykščiai d. mun.;2009;23;426;221;205
Anykščiai d. mun.;2009;24;378;192;186
Anykščiai d. mun.;2009;25;388;213;175
Anykščiai d. mun.;2009;26;253;135;118
Anykščiai d. mun.;2009;27;176;125;51
Anykščiai d. mun.;2009;28;171;99;72
Anykščiai d. mun.;2009;29;250;135;115
Anykščiai d. mun.;2009;30;265;148;117
Anykščiai d. mun.;2009;31;213;121;92
Anykščiai d. mun.;2009;32;243;131;112
Anykščiai d. mun.;2009;33;246;129;117
Anykščiai d. mun.;2009;34;279;150;129
Anykščiai d. mun.;2009;35;271;139;132
Anykščiai d. mun.;2009;36;340;182;158
Anykščiai d. mun.;2009;37;358;185;173
Anykščiai d. mun.;2009;38;358;173;185
Anykščiai d. mun.;2009;39;390;188;202
Anykščiai d. mun.;2009;40;410;194;216
Anykščiai d. mun.;2009;41;433;202;231
Anykščiai d. mun.;2009;42;418;199;219
Anykščiai d. mun.;2009;43;472;238;234
Anykščiai d. mun.;2009;44;437;230;207
Anykščiai d. mun.;2009;45;436;240;196
Anykščiai d. mun.;2009;46;476;239;237
Anykščiai d. mun.;2009;47;492;231;261
Anykščiai d. mun.;2009;48;476;243;233
Anykščiai d. mun.;2009;49;460;222;238
Anykščiai d. mun.;2009;50;433;240;193
Anykščiai d. mun.;2009;51;417;195;222
Anykščiai d. mun.;2009;52;355;164;191
Anykščiai d. mun.;2009;53;400;191;209
Anykščiai d. mun.;2009;54;323;176;147
Anykščiai d. mun.;2009;55;340;169;171
Anykščiai d. mun.;2009;56;325;152;173
Anykščiai d. mun.;2009;57;370;192;178
Anykščiai d. mun.;2009;58;345;173;172
Anykščiai d. mun.;2009;59;373;171;202
Anykščiai d. mun.;2009;60;359;179;180
Anykščiai d. mun.;2009;61;255;111;144
Anykščiai d. mun.;2009;62;288;127;161
Anykščiai d. mun.;2009;63;374;158;216
Anykščiai d. mun.;2009;64;315;137;178
Anykščiai d. mun.;2009;65;350;135;215
Anykščiai d. mun.;2009;66;405;163;242
Anykščiai d. mun.;2009;67;420;175;245
Anykščiai d. mun.;2009;68;377;125;252
Anykščiai d. mun.;2009;69;444;163;281
Anykščiai d. mun.;2009;70;406;154;252
Anykščiai d. mun.;2009;71;377;141;236
Anykščiai d. mun.;2009;72;416;149;267
Anykščiai d. mun.;2009;73;380;149;231
Anykščiai d. mun.;2009;74;331;111;220
Anykščiai d. mun.;2009;75;374;124;250
Anykščiai d. mun.;2009;76;373;126;247
Anykščiai d. mun.;2009;77;327;104;223
Anykščiai d. mun.;2009;78;366;94;272
Anykščiai d. mun.;2009;79;306;83;223
Anykščiai d. mun.;2009;80;306;84;222
Anykščiai d. mun.;2009;81;285;82;203
Anykščiai d. mun.;2009;82;222;51;171
Anykščiai d. mun.;2009;83;215;44;171
Anykščiai d. mun.;2009;84;183;37;146
Anykščiai d. mun.;2009;85;652;177;475
Anykščiai d. mun.;2010;-1;29632;13698;15934
Anykščiai d. mun.;2010;0;173;91;82
Anykščiai d. mun.;2010;1;236;115;121
Anykščiai d. mun.;2010;2;197;106;91
Anykščiai d. mun.;2010;3;199;108;91
Anykščiai d. mun.;2010;4;237;105;132
Anykščiai d. mun.;2010;5;249;134;115
Anykščiai d. mun.;2010;6;227;112;115
Anykščiai d. mun.;2010;7;220;95;125
Anykščiai d. mun.;2010;8;240;137;103
Anykščiai d. mun.;2010;9;279;140;139
Anykščiai d. mun.;2010;10;322;165;157
Anykščiai d. mun.;2010;11;319;157;162
Anykščiai d. mun.;2010;12;360;161;199
Anykščiai d. mun.;2010;13;336;179;157
Anykščiai d. mun.;2010;14;346;171;175
Anykščiai d. mun.;2010;15;385;207;178
Anykščiai d. mun.;2010;16;436;226;210
Anykščiai d. mun.;2010;17;515;270;245
Anykščiai d. mun.;2010;18;477;261;216
Anykščiai d. mun.;2010;19;475;250;225
Anykščiai d. mun.;2010;20;444;243;201
Anykščiai d. mun.;2010;21;457;240;217
Anykščiai d. mun.;2010;22;503;254;249
Anykščiai d. mun.;2010;23;424;223;201
Anykščiai d. mun.;2010;24;411;213;198
Anykščiai d. mun.;2010;25;355;183;172
Anykščiai d. mun.;2010;26;368;203;165
Anykščiai d. mun.;2010;27;243;134;109
Anykščiai d. mun.;2010;28;168;122;46
Anykščiai d. mun.;2010;29;161;92;69
Anykščiai d. mun.;2010;30;248;133;115
Anykščiai d. mun.;2010;31;255;143;112
Anykščiai d. mun.;2010;32;204;120;84
Anykščiai d. mun.;2010;33;233;127;106
Anykščiai d. mun.;2010;34;248;130;118
Anykščiai d. mun.;2010;35;261;141;120
Anykščiai d. mun.;2010;36;262;134;128
Anykščiai d. mun.;2010;37;334;177;157
Anykščiai d. mun.;2010;38;356;184;172
Anykščiai d. mun.;2010;39;350;165;185
Anykščiai d. mun.;2010;40;383;183;200
Anykščiai d. mun.;2010;41;398;186;212
Anykščiai d. mun.;2010;42;431;202;229
Anykščiai d. mun.;2010;43;409;192;217
Anykščiai d. mun.;2010;44;466;233;233
Anykščiai d. mun.;2010;45;430;225;205
Anykščiai d. mun.;2010;46;422;232;190
Anykščiai d. mun.;2010;47;480;243;237
Anykščiai d. mun.;2010;48;491;230;261
Anykščiai d. mun.;2010;49;473;239;234
Anykščiai d. mun.;2010;50;458;220;238
Anykščiai d. mun.;2010;51;433;241;192
Anykščiai d. mun.;2010;52;409;189;220
Anykščiai d. mun.;2010;53;356;166;190
Anykščiai d. mun.;2010;54;392;184;208
Anykščiai d. mun.;2010;55;316;169;147
Anykščiai d. mun.;2010;56;337;164;173
Anykščiai d. mun.;2010;57;324;150;174
Anykščiai d. mun.;2010;58;366;189;177
Anykščiai d. mun.;2010;59;336;164;172
Anykščiai d. mun.;2010;60;366;164;202
Anykščiai d. mun.;2010;61;356;175;181
Anykščiai d. mun.;2010;62;246;103;143
Anykščiai d. mun.;2010;63;284;124;160
Anykščiai d. mun.;2010;64;362;149;213
Anykščiai d. mun.;2010;65;304;129;175
Anykščiai d. mun.;2010;66;343;129;214
Anykščiai d. mun.;2010;67;397;159;238
Anykščiai d. mun.;2010;68;414;169;245
Anykščiai d. mun.;2010;69;367;120;247
Anykščiai d. mun.;2010;70;434;156;278
Anykščiai d. mun.;2010;71;396;143;253
Anykščiai d. mun.;2010;72;365;133;232
Anykščiai d. mun.;2010;73;404;140;264
Anykščiai d. mun.;2010;74;364;141;223
Anykščiai d. mun.;2010;75;319;106;213
Anykščiai d. mun.;2010;76;366;121;245
Anykščiai d. mun.;2010;77;352;118;234
Anykščiai d. mun.;2010;78;307;90;217
Anykščiai d. mun.;2010;79;343;83;260
Anykščiai d. mun.;2010;80;293;81;212
Anykščiai d. mun.;2010;81;284;79;205
Anykščiai d. mun.;2010;82;260;71;189
Anykščiai d. mun.;2010;83;202;45;157
Anykščiai d. mun.;2010;84;193;39;154
Anykščiai d. mun.;2010;85;688;179;509
Anykščiai d. mun.;2011;-1;28782;13307;15475
Anykščiai d. mun.;2011;0;174;87;87
Anykščiai d. mun.;2011;1;138;75;63
Anykščiai d. mun.;2011;2;194;89;105
Anykščiai d. mun.;2011;3;178;88;90
Anykščiai d. mun.;2011;4;189;97;92
Anykščiai d. mun.;2011;5;225;106;119
Anykščiai d. mun.;2011;6;231;125;106
Anykščiai d. mun.;2011;7;211;105;106
Anykščiai d. mun.;2011;8;227;102;125
Anykščiai d. mun.;2011;9;229;132;97
Anykščiai d. mun.;2011;10;285;140;145
Anykščiai d. mun.;2011;11;319;164;155
Anykščiai d. mun.;2011;12;304;141;163
Anykščiai d. mun.;2011;13;344;154;190
Anykščiai d. mun.;2011;14;321;169;152
Anykščiai d. mun.;2011;15;341;172;169
Anykščiai d. mun.;2011;16;373;198;175
Anykščiai d. mun.;2011;17;439;232;207
Anykščiai d. mun.;2011;18;513;274;239
Anykščiai d. mun.;2011;19;440;249;191
Anykščiai d. mun.;2011;20;382;219;163
Anykščiai d. mun.;2011;21;361;207;154
Anykščiai d. mun.;2011;22;379;208;171
Anykščiai d. mun.;2011;23;364;198;166
Anykščiai d. mun.;2011;24;330;184;146
Anykščiai d. mun.;2011;25;292;160;132
Anykščiai d. mun.;2011;26;270;150;120
Anykščiai d. mun.;2011;27;239;132;107
Anykščiai d. mun.;2011;28;226;115;111
Anykščiai d. mun.;2011;29;227;126;101
Anykščiai d. mun.;2011;30;206;116;90
Anykščiai d. mun.;2011;31;239;121;118
Anykščiai d. mun.;2011;32;260;125;135
Anykščiai d. mun.;2011;33;272;139;133
Anykščiai d. mun.;2011;34;261;140;121
Anykščiai d. mun.;2011;35;285;153;132
Anykščiai d. mun.;2011;36;296;150;146
Anykščiai d. mun.;2011;37;296;146;150
Anykščiai d. mun.;2011;38;358;196;162
Anykščiai d. mun.;2011;39;391;193;198
Anykščiai d. mun.;2011;40;392;184;208
Anykščiai d. mun.;2011;41;410;200;210
Anykščiai d. mun.;2011;42;404;201;203
Anykščiai d. mun.;2011;43;448;206;242
Anykščiai d. mun.;2011;44;442;211;231
Anykščiai d. mun.;2011;45;480;248;232
Anykščiai d. mun.;2011;46;465;241;224
Anykščiai d. mun.;2011;47;446;243;203
Anykščiai d. mun.;2011;48;508;266;242
Anykščiai d. mun.;2011;49;494;231;263
Anykščiai d. mun.;2011;50;474;240;234
Anykščiai d. mun.;2011;51;482;233;249
Anykščiai d. mun.;2011;52;414;230;184
Anykščiai d. mun.;2011;53;409;195;214
Anykščiai d. mun.;2011;54;340;152;188
Anykščiai d. mun.;2011;55;404;197;207
Anykščiai d. mun.;2011;56;313;160;153
Anykščiai d. mun.;2011;57;340;158;182
Anykščiai d. mun.;2011;58;319;150;169
Anykščiai d. mun.;2011;59;362;182;180
Anykščiai d. mun.;2011;60;341;168;173
Anykščiai d. mun.;2011;61;349;154;195
Anykščiai d. mun.;2011;62;353;171;182
Anykščiai d. mun.;2011;63;252;107;145
Anykščiai d. mun.;2011;64;264;114;150
Anykščiai d. mun.;2011;65;361;142;219
Anykščiai d. mun.;2011;66;312;134;178
Anykščiai d. mun.;2011;67;348;126;222
Anykščiai d. mun.;2011;68;389;149;240
Anykščiai d. mun.;2011;69;412;162;250
Anykščiai d. mun.;2011;70;357;126;231
Anykščiai d. mun.;2011;71;413;147;266
Anykščiai d. mun.;2011;72;374;124;250
Anykščiai d. mun.;2011;73;352;132;220
Anykščiai d. mun.;2011;74;386;131;255
Anykščiai d. mun.;2011;75;348;132;216
Anykščiai d. mun.;2011;76;298;91;207
Anykščiai d. mun.;2011;77;353;112;241
Anykščiai d. mun.;2011;78;338;115;223
Anykščiai d. mun.;2011;79;274;76;198
Anykščiai d. mun.;2011;80;305;73;232
Anykščiai d. mun.;2011;81;268;73;195
Anykščiai d. mun.;2011;82;248;68;180
Anykščiai d. mun.;2011;83;221;63;158
Anykščiai d. mun.;2011;84;168;32;136
Anykščiai d. mun.;2011;85;743;180;563
Anykščiai d. mun.;2012;-1;28116;13008;15108
Anykščiai d. mun.;2012;0;174;91;83
Anykščiai d. mun.;2012;1;171;88;83
Anykščiai d. mun.;2012;2;142;79;63
Anykščiai d. mun.;2012;3;189;87;102
Anykščiai d. mun.;2012;4;177;86;91
Anykščiai d. mun.;2012;5;185;94;91
Anykščiai d. mun.;2012;6;222;106;116
Anykščiai d. mun.;2012;7;226;121;105
Anykščiai d. mun.;2012;8;208;105;103
Anykščiai d. mun.;2012;9;224;100;124
Anykščiai d. mun.;2012;10;226;132;94
Anykščiai d. mun.;2012;11;287;141;146
Anykščiai d. mun.;2012;12;313;162;151
Anykščiai d. mun.;2012;13;299;139;160
Anykščiai d. mun.;2012;14;339;152;187
Anykščiai d. mun.;2012;15;323;171;152
Anykščiai d. mun.;2012;16;334;167;167
Anykščiai d. mun.;2012;17;366;194;172
Anykščiai d. mun.;2012;18;436;230;206
Anykščiai d. mun.;2012;19;495;263;232
Anykščiai d. mun.;2012;20;424;242;182
Anykščiai d. mun.;2012;21;368;215;153
Anykščiai d. mun.;2012;22;345;199;146
Anykščiai d. mun.;2012;23;365;200;165
Anykščiai d. mun.;2012;24;327;182;145
Anykščiai d. mun.;2012;25;320;183;137
Anykščiai d. mun.;2012;26;260;144;116
Anykščiai d. mun.;2012;27;260;145;115
Anykščiai d. mun.;2012;28;222;121;101
Anykščiai d. mun.;2012;29;208;109;99
Anykščiai d. mun.;2012;30;221;120;101
Anykščiai d. mun.;2012;31;202;115;87
Anykščiai d. mun.;2012;32;231;115;116
Anykščiai d. mun.;2012;33;255;125;130
Anykščiai d. mun.;2012;34;260;128;132
Anykščiai d. mun.;2012;35;256;140;116
Anykščiai d. mun.;2012;36;281;150;131
Anykščiai d. mun.;2012;37;295;150;145
Anykščiai d. mun.;2012;38;291;144;147
Anykščiai d. mun.;2012;39;353;197;156
Anykščiai d. mun.;2012;40;380;183;197
Anykščiai d. mun.;2012;41;393;186;207
Anykščiai d. mun.;2012;42;410;199;211
Anykščiai d. mun.;2012;43;395;195;200
Anykščiai d. mun.;2012;44;447;205;242
Anykščiai d. mun.;2012;45;437;206;231
Anykščiai d. mun.;2012;46;472;243;229
Anykščiai d. mun.;2012;47;455;237;218
Anykščiai d. mun.;2012;48;445;244;201
Anykščiai d. mun.;2012;49;502;261;241
Anykščiai d. mun.;2012;50;489;226;263
Anykščiai d. mun.;2012;51;471;238;233
Anykščiai d. mun.;2012;52;478;231;247
Anykščiai d. mun.;2012;53;407;222;185
Anykščiai d. mun.;2012;54;404;191;213
Anykščiai d. mun.;2012;55;336;149;187
Anykščiai d. mun.;2012;56;405;197;208
Anykščiai d. mun.;2012;57;309;156;153
Anykščiai d. mun.;2012;58;338;156;182
Anykščiai d. mun.;2012;59;314;147;167
Anykščiai d. mun.;2012;60;358;181;177
Anykščiai d. mun.;2012;61;341;169;172
Anykščiai d. mun.;2012;62;344;154;190
Anykščiai d. mun.;2012;63;350;170;180
Anykščiai d. mun.;2012;64;255;108;147
Anykščiai d. mun.;2012;65;261;110;151
Anykščiai d. mun.;2012;66;358;140;218
Anykščiai d. mun.;2012;67;299;124;175
Anykščiai d. mun.;2012;68;342;123;219
Anykščiai d. mun.;2012;69;383;148;235
Anykščiai d. mun.;2012;70;401;152;249
Anykščiai d. mun.;2012;71;344;120;224
Anykščiai d. mun.;2012;72;400;140;260
Anykščiai d. mun.;2012;73;364;118;246
Anykščiai d. mun.;2012;74;341;127;214
Anykščiai d. mun.;2012;75;368;120;248
Anykščiai d. mun.;2012;76;330;123;207
Anykščiai d. mun.;2012;77;287;87;200
Anykščiai d. mun.;2012;78;334;102;232
Anykščiai d. mun.;2012;79;317;102;215
Anykščiai d. mun.;2012;80;248;69;179
Anykščiai d. mun.;2012;81;271;61;210
Anykščiai d. mun.;2012;82;242;66;176
Anykščiai d. mun.;2012;83;234;63;171
Anykščiai d. mun.;2012;84;202;51;151
Anykščiai d. mun.;2012;85;775;176;599
Anykščiai d. mun.;2013;-1;27479;12772;14707
Anykščiai d. mun.;2013;0;184;103;81
Anykščiai d. mun.;2013;1;163;87;76
Anykščiai d. mun.;2013;2;158;79;79
Anykščiai d. mun.;2013;3;134;76;58
Anykščiai d. mun.;2013;4;189;85;104
Anykščiai d. mun.;2013;5;173;83;90
Anykščiai d. mun.;2013;6;174;87;87
Anykščiai d. mun.;2013;7;216;103;113
Anykščiai d. mun.;2013;8;226;121;105
Anykščiai d. mun.;2013;9;202;101;101
Anykščiai d. mun.;2013;10;224;102;122
Anykščiai d. mun.;2013;11;227;133;94
Anykščiai d. mun.;2013;12;288;139;149
Anykščiai d. mun.;2013;13;309;160;149
Anykščiai d. mun.;2013;14;295;138;157
Anykščiai d. mun.;2013;15;337;149;188
Anykščiai d. mun.;2013;16;325;170;155
Anykščiai d. mun.;2013;17;335;168;167
Anykščiai d. mun.;2013;18;365;193;172
Anykščiai d. mun.;2013;19;429;229;200
Anykščiai d. mun.;2013;20;485;259;226
Anykščiai d. mun.;2013;21;424;244;180
Anykščiai d. mun.;2013;22;359;213;146
Anykščiai d. mun.;2013;23;327;190;137
Anykščiai d. mun.;2013;24;340;187;153
Anykščiai d. mun.;2013;25;302;173;129
Anykščiai d. mun.;2013;26;301;173;128
Anykščiai d. mun.;2013;27;227;136;91
Anykščiai d. mun.;2013;28;231;136;95
Anykščiai d. mun.;2013;29;205;111;94
Anykščiai d. mun.;2013;30;194;101;93
Anykščiai d. mun.;2013;31;221;122;99
Anykščiai d. mun.;2013;32;198;116;82
Anykščiai d. mun.;2013;33;224;111;113
Anykščiai d. mun.;2013;34;242;119;123
Anykščiai d. mun.;2013;35;239;117;122
Anykščiai d. mun.;2013;36;246;137;109
Anykščiai d. mun.;2013;37;274;145;129
Anykščiai d. mun.;2013;38;285;142;143
Anykščiai d. mun.;2013;39;294;145;149
Anykščiai d. mun.;2013;40;347;198;149
Anykščiai d. mun.;2013;41;375;182;193
Anykščiai d. mun.;2013;42;397;190;207
Anykščiai d. mun.;2013;43;407;199;208
Anykščiai d. mun.;2013;44;395;195;200
Anykščiai d. mun.;2013;45;446;201;245
Anykščiai d. mun.;2013;46;437;205;232
Anykščiai d. mun.;2013;47;472;242;230
Anykščiai d. mun.;2013;48;456;239;217
Anykščiai d. mun.;2013;49;444;244;200
Anykščiai d. mun.;2013;50;497;261;236
Anykščiai d. mun.;2013;51;492;230;262
Anykščiai d. mun.;2013;52;468;239;229
Anykščiai d. mun.;2013;53;475;231;244
Anykščiai d. mun.;2013;54;408;224;184
Anykščiai d. mun.;2013;55;401;187;214
Anykščiai d. mun.;2013;56;334;147;187
Anykščiai d. mun.;2013;57;404;196;208
Anykščiai d. mun.;2013;58;309;157;152
Anykščiai d. mun.;2013;59;335;154;181
Anykščiai d. mun.;2013;60;310;143;167
Anykščiai d. mun.;2013;61;350;174;176
Anykščiai d. mun.;2013;62;332;161;171
Anykščiai d. mun.;2013;63;342;150;192
Anykščiai d. mun.;2013;64;337;161;176
Anykščiai d. mun.;2013;65;249;104;145
Anykščiai d. mun.;2013;66;260;111;149
Anykščiai d. mun.;2013;67;346;134;212
Anykščiai d. mun.;2013;68;288;120;168
Anykščiai d. mun.;2013;69;330;114;216
Anykščiai d. mun.;2013;70;379;143;236
Anykščiai d. mun.;2013;71;386;142;244
Anykščiai d. mun.;2013;72;336;118;218
Anykščiai d. mun.;2013;73;382;131;251
Anykščiai d. mun.;2013;74;355;110;245
Anykščiai d. mun.;2013;75;326;123;203
Anykščiai d. mun.;2013;76;355;116;239
Anykščiai d. mun.;2013;77;315;117;198
Anykščiai d. mun.;2013;78;272;82;190
Anykščiai d. mun.;2013;79;319;93;226
Anykščiai d. mun.;2013;80;295;93;202
Anykščiai d. mun.;2013;81;230;61;169
Anykščiai d. mun.;2013;82;251;58;193
Anykščiai d. mun.;2013;83;219;58;161
Anykščiai d. mun.;2013;84;219;61;158
Anykščiai d. mun.;2013;85;826;190;636
Anykščiai d. mun.;2014;-1;26890;12536;14354
Anykščiai d. mun.;2014;0;211;112;99
Anykščiai d. mun.;2014;1;180;102;78
Anykščiai d. mun.;2014;2;168;89;79
Anykščiai d. mun.;2014;3;155;74;81
Anykščiai d. mun.;2014;4;129;73;56
Anykščiai d. mun.;2014;5;188;84;104
Anykščiai d. mun.;2014;6;171;81;90
Anykščiai d. mun.;2014;7;170;84;86
Anykščiai d. mun.;2014;8;213;104;109
Anykščiai d. mun.;2014;9;225;120;105
Anykščiai d. mun.;2014;10;199;100;99
Anykščiai d. mun.;2014;11;222;99;123
Anykščiai d. mun.;2014;12;225;132;93
Anykščiai d. mun.;2014;13;283;140;143
Anykščiai d. mun.;2014;14;310;161;149
Anykščiai d. mun.;2014;15;293;137;156
Anykščiai d. mun.;2014;16;336;149;187
Anykščiai d. mun.;2014;17;326;170;156
Anykščiai d. mun.;2014;18;333;167;166
Anykščiai d. mun.;2014;19;357;186;171
Anykščiai d. mun.;2014;20;415;219;196
Anykščiai d. mun.;2014;21;461;248;213
Anykščiai d. mun.;2014;22;410;237;173
Anykščiai d. mun.;2014;23;325;196;129
Anykščiai d. mun.;2014;24;312;188;124
Anykščiai d. mun.;2014;25;335;185;150
Anykščiai d. mun.;2014;26;285;168;117
Anykščiai d. mun.;2014;27;284;164;120
Anykščiai d. mun.;2014;28;210;130;80
Anykščiai d. mun.;2014;29;206;124;82
Anykščiai d. mun.;2014;30;193;106;87
Anykščiai d. mun.;2014;31;189;98;91
Anykščiai d. mun.;2014;32;212;118;94
Anykščiai d. mun.;2014;33;193;114;79
Anykščiai d. mun.;2014;34;223;110;113
Anykščiai d. mun.;2014;35;238;116;122
Anykščiai d. mun.;2014;36;237;118;119
Anykščiai d. mun.;2014;37;239;134;105
Anykščiai d. mun.;2014;38;265;140;125
Anykščiai d. mun.;2014;39;280;139;141
Anykščiai d. mun.;2014;40;290;141;149
Anykščiai d. mun.;2014;41;351;200;151
Anykščiai d. mun.;2014;42;367;176;191
Anykščiai d. mun.;2014;43;392;189;203
Anykščiai d. mun.;2014;44;409;200;209
Anykščiai d. mun.;2014;45;391;198;193
Anykščiai d. mun.;2014;46;439;200;239
Anykščiai d. mun.;2014;47;427;200;227
Anykščiai d. mun.;2014;48;463;237;226
Anykščiai d. mun.;2014;49;452;239;213
Anykščiai d. mun.;2014;50;445;241;204
Anykščiai d. mun.;2014;51;496;259;237
Anykščiai d. mun.;2014;52;491;232;259
Anykščiai d. mun.;2014;53;463;234;229
Anykščiai d. mun.;2014;54;468;225;243
Anykščiai d. mun.;2014;55;401;222;179
Anykščiai d. mun.;2014;56;397;186;211
Anykščiai d. mun.;2014;57;329;144;185
Anykščiai d. mun.;2014;58;401;193;208
Anykščiai d. mun.;2014;59;303;151;152
Anykščiai d. mun.;2014;60;332;152;180
Anykščiai d. mun.;2014;61;307;142;165
Anykščiai d. mun.;2014;62;345;170;175
Anykščiai d. mun.;2014;63;325;154;171
Anykščiai d. mun.;2014;64;335;146;189
Anykščiai d. mun.;2014;65;337;161;176
Anykščiai d. mun.;2014;66;247;103;144
Anykščiai d. mun.;2014;67;256;106;150
Anykščiai d. mun.;2014;68;336;126;210
Anykščiai d. mun.;2014;69;286;118;168
Anykščiai d. mun.;2014;70;325;111;214
Anykščiai d. mun.;2014;71;365;134;231
Anykščiai d. mun.;2014;72;376;137;239
Anykščiai d. mun.;2014;73;324;110;214
Anykščiai d. mun.;2014;74;369;125;244
Anykščiai d. mun.;2014;75;341;103;238
Anykščiai d. mun.;2014;76;311;116;195
Anykščiai d. mun.;2014;77;334;104;230
Anykščiai d. mun.;2014;78;299;113;186
Anykščiai d. mun.;2014;79;255;77;178
Anykščiai d. mun.;2014;80;298;90;208
Anykščiai d. mun.;2014;81;275;87;188
Anykščiai d. mun.;2014;82;205;54;151
Anykščiai d. mun.;2014;83;229;52;177
Anykščiai d. mun.;2014;84;200;51;149
Anykščiai d. mun.;2014;85;897;211;686
Anykščiai d. mun.;2015;-1;26393;12355;14038
Anykščiai d. mun.;2015;0;209;117;92
Anykščiai d. mun.;2015;1;203;107;96
Anykščiai d. mun.;2015;2;173;96;77
Anykščiai d. mun.;2015;3;164;88;76
Anykščiai d. mun.;2015;4;155;73;82
Anykščiai d. mun.;2015;5;128;73;55
Anykščiai d. mun.;2015;6;183;78;105
Anykščiai d. mun.;2015;7;164;79;85
Anykščiai d. mun.;2015;8;170;83;87
Anykščiai d. mun.;2015;9;216;107;109
Anykščiai d. mun.;2015;10;229;123;106
Anykščiai d. mun.;2015;11;197;100;97
Anykščiai d. mun.;2015;12;224;101;123
Anykščiai d. mun.;2015;13;225;132;93
Anykščiai d. mun.;2015;14;283;143;140
Anykščiai d. mun.;2015;15;309;161;148
Anykščiai d. mun.;2015;16;292;136;156
Anykščiai d. mun.;2015;17;332;147;185
Anykščiai d. mun.;2015;18;321;169;152
Anykščiai d. mun.;2015;19;325;166;159
Anykščiai d. mun.;2015;20;354;184;170
Anykščiai d. mun.;2015;21;404;218;186
Anykščiai d. mun.;2015;22;452;247;205
Anykščiai d. mun.;2015;23;406;235;171
Anykščiai d. mun.;2015;24;319;196;123
Anykščiai d. mun.;2015;25;304;186;118
Anykščiai d. mun.;2015;26;320;187;133
Anykščiai d. mun.;2015;27;274;158;116
Anykščiai d. mun.;2015;28;270;159;111
Anykščiai d. mun.;2015;29;199;126;73
Anykščiai d. mun.;2015;30;192;117;75
Anykščiai d. mun.;2015;31;189;101;88
Anykščiai d. mun.;2015;32;196;101;95
Anykščiai d. mun.;2015;33;210;117;93
Anykščiai d. mun.;2015;34;185;114;71
Anykščiai d. mun.;2015;35;217;105;112
Anykščiai d. mun.;2015;36;237;113;124
Anykščiai d. mun.;2015;37;230;113;117
Anykščiai d. mun.;2015;38;230;129;101
Anykščiai d. mun.;2015;39;265;141;124
Anykščiai d. mun.;2015;40;275;137;138
Anykščiai d. mun.;2015;41;287;142;145
Anykščiai d. mun.;2015;42;347;199;148
Anykščiai d. mun.;2015;43;358;174;184
Anykščiai d. mun.;2015;44;389;188;201
Anykščiai d. mun.;2015;45;397;192;205
Anykščiai d. mun.;2015;46;386;195;191
Anykščiai d. mun.;2015;47;441;199;242
Anykščiai d. mun.;2015;48;424;200;224
Anykščiai d. mun.;2015;49;463;236;227
Anykščiai d. mun.;2015;50;449;234;215
Anykščiai d. mun.;2015;51;444;239;205
Anykščiai d. mun.;2015;52;499;262;237
Anykščiai d. mun.;2015;53;489;232;257
Anykščiai d. mun.;2015;54;459;233;226
Anykščiai d. mun.;2015;55;464;221;243
Anykščiai d. mun.;2015;56;400;222;178
Anykščiai d. mun.;2015;57;393;188;205
Anykščiai d. mun.;2015;58;321;139;182
Anykščiai d. mun.;2015;59;392;187;205
Anykščiai d. mun.;2015;60;294;143;151
Anykščiai d. mun.;2015;61;330;148;182
Anykščiai d. mun.;2015;62;305;138;167
Anykščiai d. mun.;2015;63;338;164;174
Anykščiai d. mun.;2015;64;315;146;169
Anykščiai d. mun.;2015;65;332;146;186
Anykščiai d. mun.;2015;66;332;157;175
Anykščiai d. mun.;2015;67;243;98;145
Anykščiai d. mun.;2015;68;255;103;152
Anykščiai d. mun.;2015;69;327;120;207
Anykščiai d. mun.;2015;70;278;114;164
Anykščiai d. mun.;2015;71;316;105;211
Anykščiai d. mun.;2015;72;361;130;231
Anykščiai d. mun.;2015;73;358;130;228
Anykščiai d. mun.;2015;74;313;108;205
Anykščiai d. mun.;2015;75;349;114;235
Anykščiai d. mun.;2015;76;333;99;234
Anykščiai d. mun.;2015;77;299;111;188
Anykščiai d. mun.;2015;78;315;92;223
Anykščiai d. mun.;2015;79;286;108;178
Anykščiai d. mun.;2015;80;242;73;169
Anykščiai d. mun.;2015;81;279;81;198
Anykščiai d. mun.;2015;82;258;78;180
Anykščiai d. mun.;2015;83;194;49;145
Anykščiai d. mun.;2015;84;200;46;154
Anykščiai d. mun.;2015;85;909;209;700
Anykščiai d. mun.;2016;-1;25755;12077;13678
Anykščiai d. mun.;2016;0;189;101;88
Anykščiai d. mun.;2016;1;208;118;90
Anykščiai d. mun.;2016;2;193;102;91
Anykščiai d. mun.;2016;3;173;97;76
Anykščiai d. mun.;2016;4;159;88;71
Anykščiai d. mun.;2016;5;161;79;82
Anykščiai d. mun.;2016;6;126;75;51
Anykščiai d. mun.;2016;7;176;75;101
Anykščiai d. mun.;2016;8;164;81;83
Anykščiai d. mun.;2016;9;170;83;87
Anykščiai d. mun.;2016;10;213;104;109
Anykščiai d. mun.;2016;11;229;123;106
Anykščiai d. mun.;2016;12;196;100;96
Anykščiai d. mun.;2016;13;221;101;120
Anykščiai d. mun.;2016;14;221;131;90
Anykščiai d. mun.;2016;15;284;143;141
Anykščiai d. mun.;2016;16;307;159;148
Anykščiai d. mun.;2016;17;287;131;156
Anykščiai d. mun.;2016;18;325;147;178
Anykščiai d. mun.;2016;19;315;166;149
Anykščiai d. mun.;2016;20;312;158;154
Anykščiai d. mun.;2016;21;347;180;167
Anykščiai d. mun.;2016;22;395;210;185
Anykščiai d. mun.;2016;23;432;236;196
Anykščiai d. mun.;2016;24;387;223;164
Anykščiai d. mun.;2016;25;291;175;116
Anykščiai d. mun.;2016;26;291;178;113
Anykščiai d. mun.;2016;27;292;178;114
Anykščiai d. mun.;2016;28;248;147;101
Anykščiai d. mun.;2016;29;257;154;103
Anykščiai d. mun.;2016;30;193;124;69
Anykščiai d. mun.;2016;31;179;110;69
Anykščiai d. mun.;2016;32;169;88;81
Anykščiai d. mun.;2016;33;183;91;92
Anykščiai d. mun.;2016;34;200;113;87
Anykščiai d. mun.;2016;35;192;119;73
Anykščiai d. mun.;2016;36;212;104;108
Anykščiai d. mun.;2016;37;231;112;119
Anykščiai d. mun.;2016;38;219;104;115
Anykščiai d. mun.;2016;39;231;127;104
Anykščiai d. mun.;2016;40;262;140;122
Anykščiai d. mun.;2016;41;269;133;136
Anykščiai d. mun.;2016;42;289;142;147
Anykščiai d. mun.;2016;43;343;197;146
Anykščiai d. mun.;2016;44;354;173;181
Anykščiai d. mun.;2016;45;389;188;201
Anykščiai d. mun.;2016;46;395;194;201
Anykščiai d. mun.;2016;47;380;189;191
Anykščiai d. mun.;2016;48;435;194;241
Anykščiai d. mun.;2016;49;418;197;221
Anykščiai d. mun.;2016;50;457;231;226
Anykščiai d. mun.;2016;51;450;236;214
Anykščiai d. mun.;2016;52;442;239;203
Anykščiai d. mun.;2016;53;494;259;235
Anykščiai d. mun.;2016;54;492;233;259
Anykščiai d. mun.;2016;55;450;226;224
Anykščiai d. mun.;2016;56;464;221;243
Anykščiai d. mun.;2016;57;389;215;174
Anykščiai d. mun.;2016;58;392;187;205
Anykščiai d. mun.;2016;59;319;140;179
Anykščiai d. mun.;2016;60;387;184;203
Anykščiai d. mun.;2016;61;297;145;152
Anykščiai d. mun.;2016;62;321;138;183
Anykščiai d. mun.;2016;63;298;131;167
Anykščiai d. mun.;2016;64;333;163;170
Anykščiai d. mun.;2016;65;309;140;169
Anykščiai d. mun.;2016;66;328;143;185
Anykščiai d. mun.;2016;67;318;148;170
Anykščiai d. mun.;2016;68;236;96;140
Anykščiai d. mun.;2016;69;248;99;149
Anykščiai d. mun.;2016;70;317;113;204
Anykščiai d. mun.;2016;71;266;105;161
Anykščiai d. mun.;2016;72;308;99;209
Anykščiai d. mun.;2016;73;345;120;225
Anykščiai d. mun.;2016;74;342;121;221
Anykščiai d. mun.;2016;75;293;99;194
Anykščiai d. mun.;2016;76;339;109;230
Anykščiai d. mun.;2016;77;316;93;223
Anykščiai d. mun.;2016;78;285;106;179
Anykščiai d. mun.;2016;79;300;87;213
Anykščiai d. mun.;2016;80;273;99;174
Anykščiai d. mun.;2016;81;238;70;168
Anykščiai d. mun.;2016;82;255;72;183
Anykščiai d. mun.;2016;83;234;72;162
Anykščiai d. mun.;2016;84;176;42;134
Anykščiai d. mun.;2016;85;932;214;718
Anykščiai d. mun.;2017;-1;24999;11729;13270
Anykščiai d. mun.;2017;0;199;113;86
Anykščiai d. mun.;2017;1;189;105;84
Anykščiai d. mun.;2017;2;214;119;95
Anykščiai d. mun.;2017;3;181;100;81
Anykščiai d. mun.;2017;4;180;102;78
Anykščiai d. mun.;2017;5;158;86;72
Anykščiai d. mun.;2017;6;155;79;76
Anykščiai d. mun.;2017;7;121;72;49
Anykščiai d. mun.;2017;8;171;79;92
Anykščiai d. mun.;2017;9;159;81;78
Anykščiai d. mun.;2017;10;168;82;86
Anykščiai d. mun.;2017;11;211;103;108
Anykščiai d. mun.;2017;12;226;121;105
Anykščiai d. mun.;2017;13;194;99;95
Anykščiai d. mun.;2017;14;218;100;118
Anykščiai d. mun.;2017;15;224;132;92
Anykščiai d. mun.;2017;16;283;144;139
Anykščiai d. mun.;2017;17;303;155;148
Anykščiai d. mun.;2017;18;282;126;156
Anykščiai d. mun.;2017;19;319;137;182
Anykščiai d. mun.;2017;20;309;163;146
Anykščiai d. mun.;2017;21;299;155;144
Anykščiai d. mun.;2017;22;332;171;161
Anykščiai d. mun.;2017;23;376;205;171
Anykščiai d. mun.;2017;24;403;222;181
Anykščiai d. mun.;2017;25;364;211;153
Anykščiai d. mun.;2017;26;254;163;91
Anykščiai d. mun.;2017;27;270;170;100
Anykščiai d. mun.;2017;28;266;165;101
Anykščiai d. mun.;2017;29;222;134;88
Anykščiai d. mun.;2017;30;235;137;98
Anykščiai d. mun.;2017;31;172;115;57
Anykščiai d. mun.;2017;32;169;98;71
Anykščiai d. mun.;2017;33;153;76;77
Anykščiai d. mun.;2017;34;173;85;88
Anykščiai d. mun.;2017;35;182;99;83
Anykščiai d. mun.;2017;36;169;107;62
Anykščiai d. mun.;2017;37;199;99;100
Anykščiai d. mun.;2017;38;226;105;121
Anykščiai d. mun.;2017;39;212;97;115
Anykščiai d. mun.;2017;40;226;123;103
Anykščiai d. mun.;2017;41;260;137;123
Anykščiai d. mun.;2017;42;268;137;131
Anykščiai d. mun.;2017;43;288;142;146
Anykščiai d. mun.;2017;44;329;191;138
Anykščiai d. mun.;2017;45;349;174;175
Anykščiai d. mun.;2017;46;381;178;203
Anykščiai d. mun.;2017;47;386;189;197
Anykščiai d. mun.;2017;48;373;188;185
Anykščiai d. mun.;2017;49;432;192;240
Anykščiai d. mun.;2017;50;412;192;220
Anykščiai d. mun.;2017;51;446;224;222
Anykščiai d. mun.;2017;52;448;231;217
Anykščiai d. mun.;2017;53;436;234;202
Anykščiai d. mun.;2017;54;489;254;235
Anykščiai d. mun.;2017;55;480;228;252
Anykščiai d. mun.;2017;56;446;222;224
Anykščiai d. mun.;2017;57;458;218;240
Anykščiai d. mun.;2017;58;383;212;171
Anykščiai d. mun.;2017;59;386;183;203
Anykščiai d. mun.;2017;60;311;135;176
Anykščiai d. mun.;2017;61;384;181;203
Anykščiai d. mun.;2017;62;295;143;152
Anykščiai d. mun.;2017;63;323;138;185
Anykščiai d. mun.;2017;64;291;126;165
Anykščiai d. mun.;2017;65;320;151;169
Anykščiai d. mun.;2017;66;303;135;168
Anykščiai d. mun.;2017;67;323;139;184
Anykščiai d. mun.;2017;68;312;145;167
Anykščiai d. mun.;2017;69;234;93;141
Anykščiai d. mun.;2017;70;245;96;149
Anykščiai d. mun.;2017;71;308;108;200
Anykščiai d. mun.;2017;72;260;102;158
Anykščiai d. mun.;2017;73;303;98;205
Anykščiai d. mun.;2017;74;330;110;220
Anykščiai d. mun.;2017;75;330;114;216
Anykščiai d. mun.;2017;76;282;93;189
Anykščiai d. mun.;2017;77;320;102;218
Anykščiai d. mun.;2017;78;304;90;214
Anykščiai d. mun.;2017;79;269;97;172
Anykščiai d. mun.;2017;80;284;81;203
Anykščiai d. mun.;2017;81;246;85;161
Anykščiai d. mun.;2017;82;219;65;154
Anykščiai d. mun.;2017;83;238;68;170
Anykščiai d. mun.;2017;84;210;66;144
Anykščiai d. mun.;2017;85;939;207;732
Anykščiai d. mun.;2018;-1;24149;11334;12815
Anykščiai d. mun.;2018;0;170;87;83
Anykščiai d. mun.;2018;1;189;108;81
Anykščiai d. mun.;2018;2;181;100;81
Anykščiai d. mun.;2018;3;206;114;92
Anykščiai d. mun.;2018;4;182;98;84
Anykščiai d. mun.;2018;5;178;103;75
Anykščiai d. mun.;2018;6;159;86;73
Anykščiai d. mun.;2018;7;153;80;73
Anykščiai d. mun.;2018;8;124;74;50
Anykščiai d. mun.;2018;9;170;77;93
Anykščiai d. mun.;2018;10;159;82;77
Anykščiai d. mun.;2018;11;166;80;86
Anykščiai d. mun.;2018;12;206;101;105
Anykščiai d. mun.;2018;13;223;119;104
Anykščiai d. mun.;2018;14;192;98;94
Anykščiai d. mun.;2018;15;219;104;115
Anykščiai d. mun.;2018;16;220;128;92
Anykščiai d. mun.;2018;17;280;142;138
Anykščiai d. mun.;2018;18;299;154;145
Anykščiai d. mun.;2018;19;267;120;147
Anykščiai d. mun.;2018;20;294;123;171
Anykščiai d. mun.;2018;21;290;152;138
Anykščiai d. mun.;2018;22;288;151;137
Anykščiai d. mun.;2018;23;301;158;143
Anykščiai d. mun.;2018;24;347;190;157
Anykščiai d. mun.;2018;25;368;210;158
Anykščiai d. mun.;2018;26;342;200;142
Anykščiai d. mun.;2018;27;230;156;74
Anykščiai d. mun.;2018;28;231;144;87
Anykščiai d. mun.;2018;29;235;144;91
Anykščiai d. mun.;2018;30;191;116;75
Anykščiai d. mun.;2018;31;209;127;82
Anykščiai d. mun.;2018;32;152;102;50
Anykščiai d. mun.;2018;33;151;87;64
Anykščiai d. mun.;2018;34;139;69;70
Anykščiai d. mun.;2018;35;165;79;86
Anykščiai d. mun.;2018;36;171;93;78
Anykščiai d. mun.;2018;37;169;106;63
Anykščiai d. mun.;2018;38;192;96;96
Anykščiai d. mun.;2018;39;221;104;117
Anykščiai d. mun.;2018;40;199;93;106
Anykščiai d. mun.;2018;41;219;117;102
Anykščiai d. mun.;2018;42;254;131;123
Anykščiai d. mun.;2018;43;272;141;131
Anykščiai d. mun.;2018;44;284;140;144
Anykščiai d. mun.;2018;45;319;181;138
Anykščiai d. mun.;2018;46;345;172;173
Anykščiai d. mun.;2018;47;374;174;200
Anykščiai d. mun.;2018;48;384;188;196
Anykščiai d. mun.;2018;49;373;191;182
Anykščiai d. mun.;2018;50;429;195;234
Anykščiai d. mun.;2018;51;405;187;218
Anykščiai d. mun.;2018;52;439;220;219
Anykščiai d. mun.;2018;53;444;228;216
Anykščiai d. mun.;2018;54;435;233;202
Anykščiai d. mun.;2018;55;480;248;232
Anykščiai d. mun.;2018;56;474;220;254
Anykščiai d. mun.;2018;57;440;219;221
Anykščiai d. mun.;2018;58;459;216;243
Anykščiai d. mun.;2018;59;380;208;172
Anykščiai d. mun.;2018;60;381;181;200
Anykščiai d. mun.;2018;61;314;135;179
Anykščiai d. mun.;2018;62;380;178;202
Anykščiai d. mun.;2018;63;295;139;156
Anykščiai d. mun.;2018;64;320;137;183
Anykščiai d. mun.;2018;65;285;122;163
Anykščiai d. mun.;2018;66;317;148;169
Anykščiai d. mun.;2018;67;295;130;165
Anykščiai d. mun.;2018;68;315;131;184
Anykščiai d. mun.;2018;69;300;138;162
Anykščiai d. mun.;2018;70;230;90;140
Anykščiai d. mun.;2018;71;243;95;148
Anykščiai d. mun.;2018;72;296;102;194
Anykščiai d. mun.;2018;73;253;101;152
Anykščiai d. mun.;2018;74;290;93;197
Anykščiai d. mun.;2018;75;315;104;211
Anykščiai d. mun.;2018;76;314;104;210
Anykščiai d. mun.;2018;77;273;91;182
Anykščiai d. mun.;2018;78;305;92;213
Anykščiai d. mun.;2018;79;289;85;204
Anykščiai d. mun.;2018;80;251;91;160
Anykščiai d. mun.;2018;81;263;75;188
Anykščiai d. mun.;2018;82;220;74;146
Anykščiai d. mun.;2018;83;201;59;142
Anykščiai d. mun.;2018;84;205;55;150
Anykščiai d. mun.;2018;85;962;220;742
Birštonas mun.;2001;-1;5458;2516;2942
Birštonas mun.;2001;0;34;13;21
Birštonas mun.;2001;1;41;21;20
Birštonas mun.;2001;2;45;25;20
Birštonas mun.;2001;3;42;25;17
Birštonas mun.;2001;4;48;25;23
Birštonas mun.;2001;5;74;40;34
Birštonas mun.;2001;6;67;30;37
Birštonas mun.;2001;7;97;47;50
Birštonas mun.;2001;8;87;49;38
Birštonas mun.;2001;9;89;49;40
Birštonas mun.;2001;10;67;32;35
Birštonas mun.;2001;11;107;61;46
Birštonas mun.;2001;12;80;38;42
Birštonas mun.;2001;13;88;42;46
Birštonas mun.;2001;14;95;49;46
Birštonas mun.;2001;15;107;53;54
Birštonas mun.;2001;16;96;53;43
Birštonas mun.;2001;17;94;54;40
Birštonas mun.;2001;18;73;33;40
Birštonas mun.;2001;19;55;33;22
Birštonas mun.;2001;20;42;23;19
Birštonas mun.;2001;21;50;32;18
Birštonas mun.;2001;22;40;17;23
Birštonas mun.;2001;23;45;26;19
Birštonas mun.;2001;24;44;25;19
Birštonas mun.;2001;25;47;16;31
Birštonas mun.;2001;26;61;31;30
Birštonas mun.;2001;27;49;20;29
Birštonas mun.;2001;28;75;38;37
Birštonas mun.;2001;29;67;32;35
Birštonas mun.;2001;30;65;32;33
Birštonas mun.;2001;31;63;26;37
Birštonas mun.;2001;32;82;41;41
Birštonas mun.;2001;33;79;40;39
Birštonas mun.;2001;34;63;35;28
Birštonas mun.;2001;35;80;28;52
Birštonas mun.;2001;36;90;45;45
Birštonas mun.;2001;37;80;37;43
Birštonas mun.;2001;38;86;45;41
Birštonas mun.;2001;39;101;55;46
Birštonas mun.;2001;40;110;48;62
Birštonas mun.;2001;41;85;36;49
Birštonas mun.;2001;42;82;44;38
Birštonas mun.;2001;43;102;39;63
Birštonas mun.;2001;44;84;39;45
Birštonas mun.;2001;45;90;49;41
Birštonas mun.;2001;46;80;40;40
Birštonas mun.;2001;47;70;40;30
Birštonas mun.;2001;48;69;42;27
Birštonas mun.;2001;49;59;28;31
Birštonas mun.;2001;50;70;41;29
Birštonas mun.;2001;51;53;25;28
Birštonas mun.;2001;52;55;23;32
Birštonas mun.;2001;53;60;27;33
Birštonas mun.;2001;54;34;13;21
Birštonas mun.;2001;55;57;23;34
Birštonas mun.;2001;56;54;21;33
Birštonas mun.;2001;57;60;30;30
Birštonas mun.;2001;58;69;32;37
Birštonas mun.;2001;59;49;19;30
Birštonas mun.;2001;60;61;33;28
Birštonas mun.;2001;61;53;21;32
Birštonas mun.;2001;62;70;25;45
Birštonas mun.;2001;63;46;16;30
Birštonas mun.;2001;64;61;24;37
Birštonas mun.;2001;65;60;17;43
Birštonas mun.;2001;66;63;18;45
Birštonas mun.;2001;67;62;21;41
Birštonas mun.;2001;68;58;18;40
Birštonas mun.;2001;69;60;24;36
Birštonas mun.;2001;70;78;30;48
Birštonas mun.;2001;71;54;19;35
Birštonas mun.;2001;72;52;20;32
Birštonas mun.;2001;73;64;24;40
Birštonas mun.;2001;74;40;12;28
Birštonas mun.;2001;75;57;15;42
Birštonas mun.;2001;76;28;12;16
Birštonas mun.;2001;77;56;18;38
Birštonas mun.;2001;78;32;12;20
Birštonas mun.;2001;79;32;12;20
Birštonas mun.;2001;80;31;8;23
Birštonas mun.;2001;81;24;6;18
Birštonas mun.;2001;82;19;5;14
Birštonas mun.;2001;83;15;2;13
Birštonas mun.;2001;84;16;4;12
Birštonas mun.;2001;85;79;25;54
Birštonas mun.;2002;-1;5362;2464;2898
Birštonas mun.;2002;0;33;20;13
Birštonas mun.;2002;1;34;13;21
Birštonas mun.;2002;2;41;21;20
Birštonas mun.;2002;3;46;25;21
Birštonas mun.;2002;4;42;25;17
Birštonas mun.;2002;5;48;25;23
Birštonas mun.;2002;6;75;40;35
Birštonas mun.;2002;7;67;30;37
Birštonas mun.;2002;8;96;46;50
Birštonas mun.;2002;9;86;48;38
Birštonas mun.;2002;10;88;49;39
Birštonas mun.;2002;11;67;32;35
Birštonas mun.;2002;12;107;60;47
Birštonas mun.;2002;13;79;37;42
Birštonas mun.;2002;14;88;42;46
Birštonas mun.;2002;15;93;49;44
Birštonas mun.;2002;16;102;51;51
Birštonas mun.;2002;17;94;51;43
Birštonas mun.;2002;18;93;54;39
Birštonas mun.;2002;19;69;32;37
Birštonas mun.;2002;20;52;32;20
Birštonas mun.;2002;21;39;24;15
Birštonas mun.;2002;22;50;30;20
Birštonas mun.;2002;23;40;17;23
Birštonas mun.;2002;24;43;25;18
Birštonas mun.;2002;25;45;27;18
Birštonas mun.;2002;26;45;15;30
Birštonas mun.;2002;27;60;30;30
Birštonas mun.;2002;28;49;19;30
Birštonas mun.;2002;29;70;35;35
Birštonas mun.;2002;30;66;32;34
Birštonas mun.;2002;31;65;32;33
Birštonas mun.;2002;32;63;26;37
Birštonas mun.;2002;33;84;42;42
Birštonas mun.;2002;34;78;39;39
Birštonas mun.;2002;35;62;34;28
Birštonas mun.;2002;36;78;27;51
Birštonas mun.;2002;37;88;44;44
Birštonas mun.;2002;38;77;35;42
Birštonas mun.;2002;39;83;42;41
Birštonas mun.;2002;40;99;53;46
Birštonas mun.;2002;41;108;48;60
Birštonas mun.;2002;42;85;37;48
Birštonas mun.;2002;43;80;42;38
Birštonas mun.;2002;44;100;38;62
Birštonas mun.;2002;45;80;36;44
Birštonas mun.;2002;46;86;48;38
Birštonas mun.;2002;47;79;39;40
Birštonas mun.;2002;48;68;39;29
Birštonas mun.;2002;49;66;39;27
Birštonas mun.;2002;50;57;26;31
Birštonas mun.;2002;51;68;39;29
Birštonas mun.;2002;52;53;25;28
Birštonas mun.;2002;53;55;23;32
Birštonas mun.;2002;54;59;27;32
Birštonas mun.;2002;55;34;13;21
Birštonas mun.;2002;56;56;24;32
Birštonas mun.;2002;57;53;21;32
Birštonas mun.;2002;58;59;29;30
Birštonas mun.;2002;59;70;33;37
Birštonas mun.;2002;60;48;18;30
Birštonas mun.;2002;61;60;32;28
Birštonas mun.;2002;62;54;21;33
Birštonas mun.;2002;63;65;20;45
Birštonas mun.;2002;64;45;15;30
Birštonas mun.;2002;65;61;24;37
Birštonas mun.;2002;66;60;18;42
Birštonas mun.;2002;67;63;18;45
Birštonas mun.;2002;68;61;21;40
Birštonas mun.;2002;69;57;17;40
Birštonas mun.;2002;70;55;22;33
Birštonas mun.;2002;71;75;29;46
Birštonas mun.;2002;72;51;17;34
Birštonas mun.;2002;73;51;20;31
Birštonas mun.;2002;74;61;22;39
Birštonas mun.;2002;75;39;13;26
Birštonas mun.;2002;76;54;13;41
Birštonas mun.;2002;77;26;12;14
Birštonas mun.;2002;78;55;18;37
Birštonas mun.;2002;79;25;10;15
Birštonas mun.;2002;80;26;7;19
Birštonas mun.;2002;81;28;6;22
Birštonas mun.;2002;82;22;4;18
Birštonas mun.;2002;83;17;5;12
Birštonas mun.;2002;84;15;2;13
Birštonas mun.;2002;85;88;24;64
Birštonas mun.;2003;-1;5296;2417;2879
Birštonas mun.;2003;0;39;14;25
Birštonas mun.;2003;1;35;20;15
Birštonas mun.;2003;2;34;13;21
Birštonas mun.;2003;3;41;21;20
Birštonas mun.;2003;4;48;24;24
Birštonas mun.;2003;5;42;25;17
Birštonas mun.;2003;6;47;25;22
Birštonas mun.;2003;7;74;39;35
Birštonas mun.;2003;8;67;29;38
Birštonas mun.;2003;9;93;44;49
Birštonas mun.;2003;10;86;47;39
Birštonas mun.;2003;11;85;47;38
Birštonas mun.;2003;12;66;31;35
Birštonas mun.;2003;13;105;59;46
Birštonas mun.;2003;14;78;37;41
Birštonas mun.;2003;15;86;41;45
Birštonas mun.;2003;16;93;49;44
Birštonas mun.;2003;17;101;50;51
Birštonas mun.;2003;18;90;49;41
Birštonas mun.;2003;19;91;52;39
Birštonas mun.;2003;20;69;32;37
Birštonas mun.;2003;21;53;33;20
Birštonas mun.;2003;22;44;26;18
Birštonas mun.;2003;23;52;31;21
Birštonas mun.;2003;24;39;17;22
Birštonas mun.;2003;25;45;24;21
Birštonas mun.;2003;26;44;26;18
Birštonas mun.;2003;27;46;13;33
Birštonas mun.;2003;28;63;32;31
Birštonas mun.;2003;29;50;19;31
Birštonas mun.;2003;30;66;33;33
Birštonas mun.;2003;31;64;31;33
Birštonas mun.;2003;32;62;31;31
Birštonas mun.;2003;33;60;26;34
Birštonas mun.;2003;34;82;40;42
Birštonas mun.;2003;35;78;40;38
Birštonas mun.;2003;36;61;33;28
Birštonas mun.;2003;37;77;27;50
Birštonas mun.;2003;38;87;45;42
Birštonas mun.;2003;39;75;34;41
Birštonas mun.;2003;40;85;43;42
Birštonas mun.;2003;41;99;53;46
Birštonas mun.;2003;42;107;47;60
Birštonas mun.;2003;43;83;36;47
Birštonas mun.;2003;44;80;42;38
Birštonas mun.;2003;45;100;39;61
Birštonas mun.;2003;46;78;35;43
Birštonas mun.;2003;47;86;48;38
Birštonas mun.;2003;48;80;39;41
Birštonas mun.;2003;49;68;39;29
Birštonas mun.;2003;50;63;37;26
Birštonas mun.;2003;51;57;27;30
Birštonas mun.;2003;52;68;39;29
Birštonas mun.;2003;53;53;25;28
Birštonas mun.;2003;54;57;23;34
Birštonas mun.;2003;55;56;25;31
Birštonas mun.;2003;56;33;13;20
Birštonas mun.;2003;57;51;19;32
Birštonas mun.;2003;58;51;20;31
Birštonas mun.;2003;59;57;28;29
Birštonas mun.;2003;60;64;28;36
Birštonas mun.;2003;61;47;17;30
Birštonas mun.;2003;62;62;34;28
Birštonas mun.;2003;63;51;19;32
Birštonas mun.;2003;64;63;19;44
Birštonas mun.;2003;65;41;12;29
Birštonas mun.;2003;66;60;24;36
Birštonas mun.;2003;67;56;16;40
Birštonas mun.;2003;68;62;18;44
Birštonas mun.;2003;69;60;21;39
Birštonas mun.;2003;70;58;17;41
Birštonas mun.;2003;71;53;21;32
Birštonas mun.;2003;72;72;26;46
Birštonas mun.;2003;73;50;17;33
Birštonas mun.;2003;74;52;20;32
Birštonas mun.;2003;75;61;22;39
Birštonas mun.;2003;76;38;13;25
Birštonas mun.;2003;77;50;12;38
Birštonas mun.;2003;78;25;11;14
Birštonas mun.;2003;79;55;15;40
Birštonas mun.;2003;80;21;7;14
Birštonas mun.;2003;81;26;7;19
Birštonas mun.;2003;82;24;6;18
Birštonas mun.;2003;83;20;4;16
Birštonas mun.;2003;84;15;4;11
Birštonas mun.;2003;85;80;21;59
Birštonas mun.;2004;-1;5240;2388;2852
Birštonas mun.;2004;0;46;27;19
Birštonas mun.;2004;1;40;16;24
Birštonas mun.;2004;2;38;21;17
Birštonas mun.;2004;3;36;14;22
Birštonas mun.;2004;4;45;22;23
Birštonas mun.;2004;5;47;23;24
Birštonas mun.;2004;6;40;23;17
Birštonas mun.;2004;7;46;24;22
Birštonas mun.;2004;8;76;40;36
Birštonas mun.;2004;9;66;29;37
Birštonas mun.;2004;10;97;46;51
Birštonas mun.;2004;11;87;49;38
Birštonas mun.;2004;12;88;47;41
Birštonas mun.;2004;13;65;32;33
Birštonas mun.;2004;14;107;59;48
Birštonas mun.;2004;15;77;36;41
Birštonas mun.;2004;16;85;41;44
Birštonas mun.;2004;17;92;49;43
Birštonas mun.;2004;18;94;45;49
Birštonas mun.;2004;19;90;48;42
Birštonas mun.;2004;20;87;50;37
Birštonas mun.;2004;21;69;32;37
Birštonas mun.;2004;22;50;31;19
Birštonas mun.;2004;23;44;25;19
Birštonas mun.;2004;24;47;30;17
Birštonas mun.;2004;25;36;16;20
Birštonas mun.;2004;26;38;23;15
Birštonas mun.;2004;27;41;24;17
Birštonas mun.;2004;28;44;14;30
Birštonas mun.;2004;29;59;30;29
Birštonas mun.;2004;30;46;17;29
Birštonas mun.;2004;31;67;31;36
Birštonas mun.;2004;32;65;32;33
Birštonas mun.;2004;33;60;30;30
Birštonas mun.;2004;34;59;26;33
Birštonas mun.;2004;35;77;38;39
Birštonas mun.;2004;36;76;39;37
Birštonas mun.;2004;37;60;32;28
Birštonas mun.;2004;38;80;30;50
Birštonas mun.;2004;39;87;44;43
Birštonas mun.;2004;40;75;34;41
Birštonas mun.;2004;41;84;43;41
Birštonas mun.;2004;42;98;54;44
Birštonas mun.;2004;43;101;44;57
Birštonas mun.;2004;44;82;35;47
Birštonas mun.;2004;45;78;41;37
Birštonas mun.;2004;46;97;37;60
Birštonas mun.;2004;47;80;34;46
Birštonas mun.;2004;48;84;48;36
Birštonas mun.;2004;49;78;38;40
Birštonas mun.;2004;50;67;39;28
Birštonas mun.;2004;51;62;36;26
Birštonas mun.;2004;52;58;26;32
Birštonas mun.;2004;53;67;39;28
Birštonas mun.;2004;54;54;26;28
Birštonas mun.;2004;55;55;22;33
Birštonas mun.;2004;56;54;23;31
Birštonas mun.;2004;57;30;11;19
Birštonas mun.;2004;58;49;17;32
Birštonas mun.;2004;59;49;19;30
Birštonas mun.;2004;60;58;29;29
Birštonas mun.;2004;61;64;27;37
Birštonas mun.;2004;62;49;18;31
Birštonas mun.;2004;63;63;34;29
Birštonas mun.;2004;64;48;18;30
Birštonas mun.;2004;65;64;18;46
Birštonas mun.;2004;66;43;13;30
Birštonas mun.;2004;67;60;22;38
Birštonas mun.;2004;68;54;16;38
Birštonas mun.;2004;69;62;18;44
Birštonas mun.;2004;70;58;20;38
Birštonas mun.;2004;71;60;18;42
Birštonas mun.;2004;72;51;18;33
Birštonas mun.;2004;73;68;24;44
Birštonas mun.;2004;74;50;17;33
Birštonas mun.;2004;75;50;20;30
Birštonas mun.;2004;76;58;22;36
Birštonas mun.;2004;77;34;10;24
Birštonas mun.;2004;78;49;12;37
Birštonas mun.;2004;79;24;11;13
Birštonas mun.;2004;80;52;12;40
Birštonas mun.;2004;81;19;5;14
Birštonas mun.;2004;82;25;6;19
Birštonas mun.;2004;83;22;5;17
Birštonas mun.;2004;84;18;3;15
Birštonas mun.;2004;85;81;21;60
Birštonas mun.;2005;-1;5120;2311;2809
Birštonas mun.;2005;0;38;20;18
Birštonas mun.;2005;1;47;28;19
Birštonas mun.;2005;2;39;15;24
Birštonas mun.;2005;3;35;19;16
Birštonas mun.;2005;4;36;14;22
Birštonas mun.;2005;5;42;22;20
Birštonas mun.;2005;6;46;22;24
Birštonas mun.;2005;7;39;23;16
Birštonas mun.;2005;8;43;24;19
Birštonas mun.;2005;9;74;38;36
Birštonas mun.;2005;10;66;28;38
Birštonas mun.;2005;11;97;44;53
Birštonas mun.;2005;12;85;47;38
Birštonas mun.;2005;13;85;45;40
Birštonas mun.;2005;14;64;31;33
Birštonas mun.;2005;15;107;58;49
Birštonas mun.;2005;16;74;33;41
Birštonas mun.;2005;17;81;38;43
Birštonas mun.;2005;18;86;47;39
Birštonas mun.;2005;19;92;45;47
Birštonas mun.;2005;20;86;45;41
Birštonas mun.;2005;21;85;48;37
Birštonas mun.;2005;22;64;29;35
Birštonas mun.;2005;23;51;30;21
Birštonas mun.;2005;24;43;25;18
Birštonas mun.;2005;25;42;26;16
Birštonas mun.;2005;26;32;13;19
Birštonas mun.;2005;27;35;22;13
Birštonas mun.;2005;28;41;24;17
Birštonas mun.;2005;29;42;13;29
Birštonas mun.;2005;30;57;26;31
Birštonas mun.;2005;31;48;17;31
Birštonas mun.;2005;32;63;29;34
Birštonas mun.;2005;33;62;30;32
Birštonas mun.;2005;34;57;27;30
Birštonas mun.;2005;35;57;25;32
Birštonas mun.;2005;36;79;38;41
Birštonas mun.;2005;37;74;38;36
Birštonas mun.;2005;38;60;32;28
Birštonas mun.;2005;39;80;31;49
Birštonas mun.;2005;40;82;42;40
Birštonas mun.;2005;41;74;34;40
Birštonas mun.;2005;42;84;42;42
Birštonas mun.;2005;43;95;53;42
Birštonas mun.;2005;44;98;43;55
Birštonas mun.;2005;45;78;32;46
Birštonas mun.;2005;46;78;42;36
Birštonas mun.;2005;47;98;37;61
Birštonas mun.;2005;48;78;32;46
Birštonas mun.;2005;49;82;47;35
Birštonas mun.;2005;50;78;38;40
Birštonas mun.;2005;51;63;35;28
Birštonas mun.;2005;52;59;34;25
Birštonas mun.;2005;53;53;22;31
Birštonas mun.;2005;54;67;40;27
Birštonas mun.;2005;55;51;25;26
Birštonas mun.;2005;56;53;21;32
Birštonas mun.;2005;57;53;22;31
Birštonas mun.;2005;58;31;12;19
Birštonas mun.;2005;59;51;18;33
Birštonas mun.;2005;60;51;19;32
Birštonas mun.;2005;61;55;27;28
Birštonas mun.;2005;62;63;25;38
Birštonas mun.;2005;63;45;16;29
Birštonas mun.;2005;64;63;34;29
Birštonas mun.;2005;65;47;18;29
Birštonas mun.;2005;66;65;18;47
Birštonas mun.;2005;67;42;13;29
Birštonas mun.;2005;68;61;23;38
Birštonas mun.;2005;69;53;14;39
Birštonas mun.;2005;70;63;19;44
Birštonas mun.;2005;71;54;17;37
Birštonas mun.;2005;72;54;16;38
Birštonas mun.;2005;73;52;18;34
Birštonas mun.;2005;74;66;25;41
Birštonas mun.;2005;75;49;15;34
Birštonas mun.;2005;76;52;20;32
Birštonas mun.;2005;77;57;22;35
Birštonas mun.;2005;78;30;8;22
Birštonas mun.;2005;79;44;11;33
Birštonas mun.;2005;80;20;10;10
Birštonas mun.;2005;81;51;11;40
Birštonas mun.;2005;82;15;3;12
Birštonas mun.;2005;83;23;5;18
Birštonas mun.;2005;84;21;4;17
Birštonas mun.;2005;85;84;20;64
Birštonas mun.;2006;-1;4971;2251;2720
Birštonas mun.;2006;0;33;17;16
Birštonas mun.;2006;1;37;20;17
Birštonas mun.;2006;2;45;26;19
Birštonas mun.;2006;3;40;16;24
Birštonas mun.;2006;4;36;20;16
Birštonas mun.;2006;5;35;13;22
Birštonas mun.;2006;6;43;22;21
Birštonas mun.;2006;7;46;22;24
Birštonas mun.;2006;8;39;23;16
Birštonas mun.;2006;9;43;24;19
Birštonas mun.;2006;10;73;38;35
Birštonas mun.;2006;11;65;28;37
Birštonas mun.;2006;12;97;44;53
Birštonas mun.;2006;13;84;47;37
Birštonas mun.;2006;14;82;46;36
Birštonas mun.;2006;15;60;29;31
Birštonas mun.;2006;16;104;57;47
Birštonas mun.;2006;17;71;32;39
Birštonas mun.;2006;18;78;36;42
Birštonas mun.;2006;19;84;45;39
Birštonas mun.;2006;20;90;44;46
Birštonas mun.;2006;21;79;42;37
Birštonas mun.;2006;22;78;45;33
Birštonas mun.;2006;23;59;29;30
Birštonas mun.;2006;24;46;28;18
Birštonas mun.;2006;25;41;23;18
Birštonas mun.;2006;26;38;26;12
Birštonas mun.;2006;27;30;12;18
Birštonas mun.;2006;28;32;21;11
Birštonas mun.;2006;29;38;22;16
Birštonas mun.;2006;30;42;14;28
Birštonas mun.;2006;31;55;25;30
Birštonas mun.;2006;32;48;16;32
Birštonas mun.;2006;33;62;27;35
Birštonas mun.;2006;34;59;28;31
Birštonas mun.;2006;35;56;27;29
Birštonas mun.;2006;36;55;24;31
Birštonas mun.;2006;37;75;35;40
Birštonas mun.;2006;38;77;40;37
Birštonas mun.;2006;39;55;28;27
Birštonas mun.;2006;40;79;29;50
Birštonas mun.;2006;41;81;41;40
Birštonas mun.;2006;42;71;33;38
Birštonas mun.;2006;43;80;39;41
Birštonas mun.;2006;44;94;54;40
Birštonas mun.;2006;45;92;39;53
Birštonas mun.;2006;46;74;30;44
Birštonas mun.;2006;47;76;42;34
Birštonas mun.;2006;48;96;35;61
Birštonas mun.;2006;49;77;32;45
Birštonas mun.;2006;50;81;47;34
Birštonas mun.;2006;51;74;34;40
Birštonas mun.;2006;52;60;33;27
Birštonas mun.;2006;53;56;31;25
Birštonas mun.;2006;54;51;21;30
Birštonas mun.;2006;55;67;39;28
Birštonas mun.;2006;56;49;24;25
Birštonas mun.;2006;57;53;21;32
Birštonas mun.;2006;58;51;19;32
Birštonas mun.;2006;59;33;12;21
Birštonas mun.;2006;60;50;18;32
Birštonas mun.;2006;61;51;18;33
Birštonas mun.;2006;62;56;27;29
Birštonas mun.;2006;63;62;25;37
Birštonas mun.;2006;64;45;15;30
Birštonas mun.;2006;65;60;32;28
Birštonas mun.;2006;66;47;19;28
Birštonas mun.;2006;67;61;18;43
Birštonas mun.;2006;68;41;13;28
Birštonas mun.;2006;69;59;24;35
Birštonas mun.;2006;70;51;14;37
Birštonas mun.;2006;71;56;16;40
Birštonas mun.;2006;72;52;15;37
Birštonas mun.;2006;73;49;14;35
Birštonas mun.;2006;74;51;18;33
Birštonas mun.;2006;75;60;22;38
Birštonas mun.;2006;76;47;14;33
Birštonas mun.;2006;77;47;20;27
Birštonas mun.;2006;78;55;22;33
Birštonas mun.;2006;79;29;8;21
Birštonas mun.;2006;80;42;11;31
Birštonas mun.;2006;81;19;9;10
Birštonas mun.;2006;82;47;10;37
Birštonas mun.;2006;83;14;3;11
Birštonas mun.;2006;84;24;5;19
Birštonas mun.;2006;85;91;25;66
Birštonas mun.;2007;-1;4901;2215;2686
Birštonas mun.;2007;0;26;10;16
Birštonas mun.;2007;1;33;17;16
Birštonas mun.;2007;2;37;20;17
Birštonas mun.;2007;3;41;23;18
Birštonas mun.;2007;4;38;14;24
Birštonas mun.;2007;5;36;20;16
Birštonas mun.;2007;6;35;13;22
Birštonas mun.;2007;7;47;25;22
Birštonas mun.;2007;8;48;24;24
Birštonas mun.;2007;9;40;24;16
Birštonas mun.;2007;10;43;23;20
Birštonas mun.;2007;11;72;38;34
Birštonas mun.;2007;12;65;28;37
Birštonas mun.;2007;13;99;44;55
Birštonas mun.;2007;14;82;47;35
Birštonas mun.;2007;15;80;44;36
Birštonas mun.;2007;16;60;29;31
Birštonas mun.;2007;17;101;56;45
Birštonas mun.;2007;18;67;31;36
Birštonas mun.;2007;19;76;36;40
Birštonas mun.;2007;20;84;44;40
Birštonas mun.;2007;21;90;43;47
Birštonas mun.;2007;22;79;41;38
Birštonas mun.;2007;23;78;43;35
Birštonas mun.;2007;24;61;29;32
Birštonas mun.;2007;25;40;27;13
Birštonas mun.;2007;26;42;22;20
Birštonas mun.;2007;27;39;24;15
Birštonas mun.;2007;28;28;13;15
Birštonas mun.;2007;29;34;23;11
Birštonas mun.;2007;30;40;23;17
Birštonas mun.;2007;31;42;14;28
Birštonas mun.;2007;32;56;25;31
Birštonas mun.;2007;33;49;17;32
Birštonas mun.;2007;34;65;29;36
Birštonas mun.;2007;35;58;27;31
Birštonas mun.;2007;36;57;27;30
Birštonas mun.;2007;37;55;23;32
Birštonas mun.;2007;38;73;35;38
Birštonas mun.;2007;39;76;40;36
Birštonas mun.;2007;40;56;30;26
Birštonas mun.;2007;41;78;29;49
Birštonas mun.;2007;42;78;39;39
Birštonas mun.;2007;43;71;33;38
Birštonas mun.;2007;44;79;38;41
Birštonas mun.;2007;45;89;52;37
Birštonas mun.;2007;46;90;40;50
Birštonas mun.;2007;47;72;28;44
Birštonas mun.;2007;48;74;39;35
Birštonas mun.;2007;49;96;34;62
Birštonas mun.;2007;50;73;29;44
Birštonas mun.;2007;51;83;48;35
Birštonas mun.;2007;52;69;31;38
Birštonas mun.;2007;53;60;33;27
Birštonas mun.;2007;54;56;32;24
Birštonas mun.;2007;55;49;20;29
Birštonas mun.;2007;56;67;39;28
Birštonas mun.;2007;57;49;24;25
Birštonas mun.;2007;58;53;21;32
Birštonas mun.;2007;59;51;19;32
Birštonas mun.;2007;60;33;12;21
Birštonas mun.;2007;61;49;17;32
Birštonas mun.;2007;62;48;18;30
Birštonas mun.;2007;63;54;25;29
Birštonas mun.;2007;64;61;25;36
Birštonas mun.;2007;65;44;15;29
Birštonas mun.;2007;66;60;31;29
Birštonas mun.;2007;67;44;16;28
Birštonas mun.;2007;68;63;19;44
Birštonas mun.;2007;69;41;14;27
Birštonas mun.;2007;70;55;23;32
Birštonas mun.;2007;71;49;15;34
Birštonas mun.;2007;72;55;14;41
Birštonas mun.;2007;73;53;14;39
Birštonas mun.;2007;74;46;13;33
Birštonas mun.;2007;75;48;17;31
Birštonas mun.;2007;76;59;21;38
Birštonas mun.;2007;77;46;12;34
Birštonas mun.;2007;78;43;16;27
Birštonas mun.;2007;79;48;20;28
Birštonas mun.;2007;80;28;7;21
Birštonas mun.;2007;81;41;11;30
Birštonas mun.;2007;82;18;9;9
Birštonas mun.;2007;83;39;9;30
Birštonas mun.;2007;84;12;3;9
Birštonas mun.;2007;85;99;26;73
Birštonas mun.;2008;-1;4861;2197;2664
Birštonas mun.;2008;0;33;15;18
Birštonas mun.;2008;1;25;10;15
Birštonas mun.;2008;2;33;17;16
Birštonas mun.;2008;3;37;20;17
Birštonas mun.;2008;4;47;28;19
Birštonas mun.;2008;5;42;18;24
Birštonas mun.;2008;6;36;19;17
Birštonas mun.;2008;7;36;14;22
Birštonas mun.;2008;8;45;23;22
Birštonas mun.;2008;9;47;24;23
Birštonas mun.;2008;10;39;22;17
Birštonas mun.;2008;11;43;22;21
Birštonas mun.;2008;12;72;38;34
Birštonas mun.;2008;13;65;28;37
Birštonas mun.;2008;14;98;44;54
Birštonas mun.;2008;15;82;47;35
Birštonas mun.;2008;16;81;45;36
Birštonas mun.;2008;17;60;29;31
Birštonas mun.;2008;18;99;55;44
Birštonas mun.;2008;19;69;33;36
Birštonas mun.;2008;20;81;40;41
Birštonas mun.;2008;21;84;45;39
Birštonas mun.;2008;22;88;41;47
Birštonas mun.;2008;23;78;40;38
Birštonas mun.;2008;24;79;44;35
Birštonas mun.;2008;25;62;30;32
Birštonas mun.;2008;26;42;26;16
Birštonas mun.;2008;27;43;25;18
Birštonas mun.;2008;28;41;25;16
Birštonas mun.;2008;29;28;14;14
Birštonas mun.;2008;30;35;23;12
Birštonas mun.;2008;31;39;24;15
Birštonas mun.;2008;32;42;13;29
Birštonas mun.;2008;33;55;25;30
Birštonas mun.;2008;34;49;16;33
Birštonas mun.;2008;35;65;28;37
Birštonas mun.;2008;36;61;29;32
Birštonas mun.;2008;37;55;26;29
Birštonas mun.;2008;38;59;25;34
Birštonas mun.;2008;39;76;35;41
Birštonas mun.;2008;40;76;40;36
Birštonas mun.;2008;41;55;30;25
Birštonas mun.;2008;42;76;29;47
Birštonas mun.;2008;43;77;38;39
Birštonas mun.;2008;44;69;32;37
Birštonas mun.;2008;45;79;37;42
Birštonas mun.;2008;46;90;53;37
Birštonas mun.;2008;47;90;39;51
Birštonas mun.;2008;48;75;30;45
Birštonas mun.;2008;49;71;36;35
Birštonas mun.;2008;50;97;34;63
Birštonas mun.;2008;51;72;31;41
Birštonas mun.;2008;52;83;47;36
Birštonas mun.;2008;53;67;29;38
Birštonas mun.;2008;54;57;31;26
Birštonas mun.;2008;55;55;32;23
Birštonas mun.;2008;56;48;20;28
Birštonas mun.;2008;57;62;34;28
Birštonas mun.;2008;58;48;23;25
Birštonas mun.;2008;59;53;21;32
Birštonas mun.;2008;60;49;18;31
Birštonas mun.;2008;61;34;11;23
Birštonas mun.;2008;62;47;15;32
Birštonas mun.;2008;63;43;15;28
Birštonas mun.;2008;64;51;23;28
Birštonas mun.;2008;65;59;23;36
Birštonas mun.;2008;66;43;15;28
Birštonas mun.;2008;67;57;28;29
Birštonas mun.;2008;68;44;16;28
Birštonas mun.;2008;69;63;19;44
Birštonas mun.;2008;70;38;12;26
Birštonas mun.;2008;71;53;21;32
Birštonas mun.;2008;72;47;15;32
Birštonas mun.;2008;73;54;14;40
Birštonas mun.;2008;74;53;14;39
Birštonas mun.;2008;75;46;13;33
Birštonas mun.;2008;76;45;15;30
Birštonas mun.;2008;77;55;22;33
Birštonas mun.;2008;78;40;9;31
Birštonas mun.;2008;79;37;14;23
Birštonas mun.;2008;80;45;19;26
Birštonas mun.;2008;81;28;7;21
Birštonas mun.;2008;82;36;10;26
Birštonas mun.;2008;83;13;6;7
Birštonas mun.;2008;84;39;8;31
Birštonas mun.;2008;85;91;24;67
Birštonas mun.;2009;-1;4771;2153;2618
Birštonas mun.;2009;0;32;20;12
Birštonas mun.;2009;1;31;13;18
Birštonas mun.;2009;2;26;10;16
Birštonas mun.;2009;3;35;19;16
Birštonas mun.;2009;4;37;20;17
Birštonas mun.;2009;5;46;27;19
Birštonas mun.;2009;6;39;16;23
Birštonas mun.;2009;7;33;18;15
Birštonas mun.;2009;8;36;14;22
Birštonas mun.;2009;9;44;22;22
Birštonas mun.;2009;10;45;24;21
Birštonas mun.;2009;11;38;21;17
Birštonas mun.;2009;12;42;21;21
Birštonas mun.;2009;13;71;38;33
Birštonas mun.;2009;14;65;28;37
Birštonas mun.;2009;15;95;42;53
Birštonas mun.;2009;16;78;44;34
Birštonas mun.;2009;17;80;45;35
Birštonas mun.;2009;18;60;29;31
Birštonas mun.;2009;19;98;53;45
Birštonas mun.;2009;20;68;33;35
Birštonas mun.;2009;21;78;37;41
Birštonas mun.;2009;22;84;44;40
Birštonas mun.;2009;23;86;39;47
Birštonas mun.;2009;24;74;39;35
Birštonas mun.;2009;25;75;43;32
Birštonas mun.;2009;26;62;33;29
Birštonas mun.;2009;27;40;24;16
Birštonas mun.;2009;28;44;25;19
Birštonas mun.;2009;29;43;27;16
Birštonas mun.;2009;30;28;13;15
Birštonas mun.;2009;31;31;21;10
Birštonas mun.;2009;32;39;24;15
Birštonas mun.;2009;33;45;14;31
Birštonas mun.;2009;34;54;24;30
Birštonas mun.;2009;35;47;15;32
Birštonas mun.;2009;36;64;27;37
Birštonas mun.;2009;37;60;28;32
Birštonas mun.;2009;38;56;28;28
Birštonas mun.;2009;39;56;24;32
Birštonas mun.;2009;40;73;33;40
Birštonas mun.;2009;41;72;39;33
Birštonas mun.;2009;42;55;30;25
Birštonas mun.;2009;43;72;27;45
Birštonas mun.;2009;44;76;37;39
Birštonas mun.;2009;45;64;28;36
Birštonas mun.;2009;46;79;37;42
Birštonas mun.;2009;47;88;52;36
Birštonas mun.;2009;48;89;38;51
Birštonas mun.;2009;49;71;27;44
Birštonas mun.;2009;50;72;36;36
Birštonas mun.;2009;51;97;34;63
Birštonas mun.;2009;52;70;30;40
Birštonas mun.;2009;53;82;46;36
Birštonas mun.;2009;54;67;29;38
Birštonas mun.;2009;55;56;30;26
Birštonas mun.;2009;56;54;30;24
Birštonas mun.;2009;57;49;20;29
Birštonas mun.;2009;58;62;34;28
Birštonas mun.;2009;59;48;23;25
Birštonas mun.;2009;60;54;21;33
Birštonas mun.;2009;61;48;17;31
Birštonas mun.;2009;62;33;11;22
Birštonas mun.;2009;63;50;17;33
Birštonas mun.;2009;64;43;15;28
Birštonas mun.;2009;65;48;20;28
Birštonas mun.;2009;66;55;22;33
Birštonas mun.;2009;67;44;15;29
Birštonas mun.;2009;68;56;27;29
Birštonas mun.;2009;69;43;15;28
Birštonas mun.;2009;70;59;17;42
Birštonas mun.;2009;71;38;13;25
Birštonas mun.;2009;72;52;21;31
Birštonas mun.;2009;73;45;14;31
Birštonas mun.;2009;74;52;14;38
Birštonas mun.;2009;75;51;14;37
Birštonas mun.;2009;76;42;12;30
Birštonas mun.;2009;77;44;15;29
Birštonas mun.;2009;78;51;19;32
Birštonas mun.;2009;79;38;9;29
Birštonas mun.;2009;80;35;14;21
Birštonas mun.;2009;81;42;18;24
Birštonas mun.;2009;82;28;7;21
Birštonas mun.;2009;83;34;8;26
Birštonas mun.;2009;84;10;5;5
Birštonas mun.;2009;85;115;27;88
Birštonas mun.;2010;-1;4679;2094;2585
Birštonas mun.;2010;0;51;26;25
Birštonas mun.;2010;1;31;19;12
Birštonas mun.;2010;2;31;13;18
Birštonas mun.;2010;3;24;9;15
Birštonas mun.;2010;4;36;20;16
Birštonas mun.;2010;5;38;22;16
Birštonas mun.;2010;6;45;26;19
Birštonas mun.;2010;7;37;14;23
Birštonas mun.;2010;8;36;18;18
Birštonas mun.;2010;9;33;12;21
Birštonas mun.;2010;10;41;21;20
Birštonas mun.;2010;11;46;23;23
Birštonas mun.;2010;12;38;21;17
Birštonas mun.;2010;13;43;21;22
Birštonas mun.;2010;14;68;37;31
Birštonas mun.;2010;15;65;29;36
Birštonas mun.;2010;16;91;41;50
Birštonas mun.;2010;17;78;44;34
Birštonas mun.;2010;18;78;43;35
Birštonas mun.;2010;19;54;25;29
Birštonas mun.;2010;20;97;53;44
Birštonas mun.;2010;21;67;32;35
Birštonas mun.;2010;22;71;33;38
Birštonas mun.;2010;23;83;43;40
Birštonas mun.;2010;24;83;38;45
Birštonas mun.;2010;25;67;36;31
Birštonas mun.;2010;26;67;40;27
Birštonas mun.;2010;27;63;34;29
Birštonas mun.;2010;28;41;24;17
Birštonas mun.;2010;29;45;25;20
Birštonas mun.;2010;30;42;27;15
Birštonas mun.;2010;31;27;12;15
Birštonas mun.;2010;32;32;21;11
Birštonas mun.;2010;33;39;23;16
Birštonas mun.;2010;34;45;13;32
Birštonas mun.;2010;35;55;24;31
Birštonas mun.;2010;36;47;15;32
Birštonas mun.;2010;37;63;27;36
Birštonas mun.;2010;38;61;29;32
Birštonas mun.;2010;39;57;27;30
Birštonas mun.;2010;40;54;23;31
Birštonas mun.;2010;41;73;34;39
Birštonas mun.;2010;42;70;37;33
Birštonas mun.;2010;43;54;31;23
Birštonas mun.;2010;44;69;23;46
Birštonas mun.;2010;45;74;37;37
Birštonas mun.;2010;46;59;27;32
Birštonas mun.;2010;47;77;35;42
Birštonas mun.;2010;48;85;50;35
Birštonas mun.;2010;49;87;38;49
Birštonas mun.;2010;50;72;27;45
Birštonas mun.;2010;51;69;34;35
Birštonas mun.;2010;52;94;31;63
Birštonas mun.;2010;53;69;29;40
Birštonas mun.;2010;54;80;44;36
Birštonas mun.;2010;55;67;29;38
Birštonas mun.;2010;56;55;29;26
Birštonas mun.;2010;57;51;28;23
Birštonas mun.;2010;58;47;19;28
Birštonas mun.;2010;59;60;31;29
Birštonas mun.;2010;60;47;22;25
Birštonas mun.;2010;61;52;20;32
Birštonas mun.;2010;62;49;17;32
Birštonas mun.;2010;63;33;10;23
Birštonas mun.;2010;64;49;16;33
Birštonas mun.;2010;65;42;15;27
Birštonas mun.;2010;66;46;18;28
Birštonas mun.;2010;67;54;21;33
Birštonas mun.;2010;68;44;16;28
Birštonas mun.;2010;69;56;27;29
Birštonas mun.;2010;70;43;14;29
Birštonas mun.;2010;71;58;16;42
Birštonas mun.;2010;72;36;12;24
Birštonas mun.;2010;73;51;21;30
Birštonas mun.;2010;74;42;13;29
Birštonas mun.;2010;75;49;13;36
Birštonas mun.;2010;76;47;12;35
Birštonas mun.;2010;77;37;11;26
Birštonas mun.;2010;78;44;15;29
Birštonas mun.;2010;79;49;17;32
Birštonas mun.;2010;80;34;6;28
Birštonas mun.;2010;81;30;11;19
Birštonas mun.;2010;82;37;16;21
Birštonas mun.;2010;83;27;6;21
Birštonas mun.;2010;84;31;7;24
Birštonas mun.;2010;85;110;26;84
Birštonas mun.;2011;-1;4593;2056;2537
Birštonas mun.;2011;0;45;26;19
Birštonas mun.;2011;1;48;25;23
Birštonas mun.;2011;2;29;19;10
Birštonas mun.;2011;3;31;9;22
Birštonas mun.;2011;4;33;11;22
Birštonas mun.;2011;5;30;15;15
Birštonas mun.;2011;6;36;19;17
Birštonas mun.;2011;7;44;26;18
Birštonas mun.;2011;8;31;14;17
Birštonas mun.;2011;9;38;19;19
Birštonas mun.;2011;10;39;18;21
Birštonas mun.;2011;11;44;18;26
Birštonas mun.;2011;12;38;24;14
Birštonas mun.;2011;13;38;23;15
Birštonas mun.;2011;14;44;24;20
Birštonas mun.;2011;15;63;34;29
Birštonas mun.;2011;16;64;31;33
Birštonas mun.;2011;17;92;42;50
Birštonas mun.;2011;18;72;41;31
Birštonas mun.;2011;19;62;37;25
Birštonas mun.;2011;20;51;26;25
Birštonas mun.;2011;21;81;49;32
Birštonas mun.;2011;22;62;33;29
Birštonas mun.;2011;23;57;25;32
Birštonas mun.;2011;24;74;36;38
Birštonas mun.;2011;25;63;34;29
Birštonas mun.;2011;26;48;26;22
Birštonas mun.;2011;27;49;26;23
Birštonas mun.;2011;28;49;28;21
Birštonas mun.;2011;29;38;22;16
Birštonas mun.;2011;30;39;19;20
Birštonas mun.;2011;31;51;24;27
Birštonas mun.;2011;32;32;17;15
Birštonas mun.;2011;33;39;20;19
Birštonas mun.;2011;34;33;17;16
Birštonas mun.;2011;35;42;17;25
Birštonas mun.;2011;36;44;20;24
Birštonas mun.;2011;37;44;19;25
Birštonas mun.;2011;38;68;31;37
Birštonas mun.;2011;39;63;30;33
Birštonas mun.;2011;40;57;26;31
Birštonas mun.;2011;41;64;28;36
Birštonas mun.;2011;42;70;33;37
Birštonas mun.;2011;43;63;28;35
Birštonas mun.;2011;44;60;33;27
Birštonas mun.;2011;45;75;26;49
Birštonas mun.;2011;46;71;34;37
Birštonas mun.;2011;47;57;22;35
Birštonas mun.;2011;48;74;40;34
Birštonas mun.;2011;49;87;43;44
Birštonas mun.;2011;50;90;39;51
Birštonas mun.;2011;51;83;41;42
Birštonas mun.;2011;52;72;37;35
Birštonas mun.;2011;53;96;34;62
Birštonas mun.;2011;54;77;32;45
Birštonas mun.;2011;55;72;42;30
Birštonas mun.;2011;56;65;27;38
Birštonas mun.;2011;57;61;31;30
Birštonas mun.;2011;58;53;30;23
Birštonas mun.;2011;59;49;22;27
Birštonas mun.;2011;60;57;27;30
Birštonas mun.;2011;61;47;22;25
Birštonas mun.;2011;62;50;18;32
Birštonas mun.;2011;63;46;19;27
Birštonas mun.;2011;64;35;13;22
Birštonas mun.;2011;65;48;18;30
Birštonas mun.;2011;66;42;14;28
Birštonas mun.;2011;67;41;12;29
Birštonas mun.;2011;68;55;22;33
Birštonas mun.;2011;69;48;18;30
Birštonas mun.;2011;70;58;27;31
Birštonas mun.;2011;71;48;16;32
Birštonas mun.;2011;72;62;18;44
Birštonas mun.;2011;73;38;14;24
Birštonas mun.;2011;74;47;16;31
Birštonas mun.;2011;75;41;12;29
Birštonas mun.;2011;76;49;12;37
Birštonas mun.;2011;77;48;12;36
Birštonas mun.;2011;78;39;9;30
Birštonas mun.;2011;79;45;13;32
Birštonas mun.;2011;80;49;18;31
Birštonas mun.;2011;81;34;6;28
Birštonas mun.;2011;82;34;15;19
Birštonas mun.;2011;83;38;13;25
Birštonas mun.;2011;84;24;5;19
Birštonas mun.;2011;85;126;25;101
Birštonas mun.;2012;-1;4532;2023;2509
Birštonas mun.;2012;0;40;23;17
Birštonas mun.;2012;1;47;27;20
Birštonas mun.;2012;2;47;25;22
Birštonas mun.;2012;3;28;19;9
Birštonas mun.;2012;4;31;9;22
Birštonas mun.;2012;5;33;10;23
Birštonas mun.;2012;6;31;16;15
Birštonas mun.;2012;7;37;18;19
Birštonas mun.;2012;8;45;26;19
Birštonas mun.;2012;9;32;15;17
Birštonas mun.;2012;10;35;18;17
Birštonas mun.;2012;11;38;17;21
Birštonas mun.;2012;12;43;18;25
Birštonas mun.;2012;13;37;23;14
Birštonas mun.;2012;14;38;23;15
Birštonas mun.;2012;15;43;23;20
Birštonas mun.;2012;16;64;35;29
Birštonas mun.;2012;17;63;31;32
Birštonas mun.;2012;18;93;42;51
Birštonas mun.;2012;19;72;42;30
Birštonas mun.;2012;20;60;35;25
Birštonas mun.;2012;21;50;25;25
Birštonas mun.;2012;22;74;45;29
Birštonas mun.;2012;23;59;34;25
Birštonas mun.;2012;24;56;25;31
Birštonas mun.;2012;25;67;32;35
Birštonas mun.;2012;26;66;36;30
Birštonas mun.;2012;27;45;21;24
Birštonas mun.;2012;28;44;22;22
Birštonas mun.;2012;29;42;28;14
Birštonas mun.;2012;30;37;24;13
Birštonas mun.;2012;31;41;22;19
Birštonas mun.;2012;32;51;23;28
Birštonas mun.;2012;33;32;17;15
Birštonas mun.;2012;34;39;17;22
Birštonas mun.;2012;35;28;15;13
Birštonas mun.;2012;36;41;16;25
Birštonas mun.;2012;37;46;21;25
Birštonas mun.;2012;38;46;20;26
Birštonas mun.;2012;39;68;33;35
Birštonas mun.;2012;40;61;27;34
Birštonas mun.;2012;41;57;25;32
Birštonas mun.;2012;42;63;27;36
Birštonas mun.;2012;43;69;31;38
Birštonas mun.;2012;44;59;25;34
Birštonas mun.;2012;45;63;33;30
Birštonas mun.;2012;46;72;26;46
Birštonas mun.;2012;47;72;34;38
Birštonas mun.;2012;48;54;20;34
Birštonas mun.;2012;49;73;39;34
Birštonas mun.;2012;50;88;44;44
Birštonas mun.;2012;51;87;37;50
Birštonas mun.;2012;52;84;42;42
Birštonas mun.;2012;53;70;35;35
Birštonas mun.;2012;54;96;34;62
Birštonas mun.;2012;55;76;30;46
Birštonas mun.;2012;56;72;42;30
Birštonas mun.;2012;57;65;27;38
Birštonas mun.;2012;58;61;30;31
Birštonas mun.;2012;59;53;30;23
Birštonas mun.;2012;60;48;20;28
Birštonas mun.;2012;61;59;28;31
Birštonas mun.;2012;62;47;23;24
Birštonas mun.;2012;63;49;16;33
Birštonas mun.;2012;64;46;19;27
Birštonas mun.;2012;65;35;13;22
Birštonas mun.;2012;66;46;15;31
Birštonas mun.;2012;67;42;13;29
Birštonas mun.;2012;68;42;12;30
Birštonas mun.;2012;69;54;23;31
Birštonas mun.;2012;70;47;18;29
Birštonas mun.;2012;71;59;26;33
Birštonas mun.;2012;72;49;17;32
Birštonas mun.;2012;73;63;18;45
Birštonas mun.;2012;74;38;13;25
Birštonas mun.;2012;75;47;17;30
Birštonas mun.;2012;76;41;12;29
Birštonas mun.;2012;77;49;11;38
Birštonas mun.;2012;78;46;12;34
Birštonas mun.;2012;79;37;9;28
Birštonas mun.;2012;80;45;12;33
Birštonas mun.;2012;81;48;18;30
Birštonas mun.;2012;82;29;5;24
Birštonas mun.;2012;83;28;13;15
Birštonas mun.;2012;84;37;12;25
Birštonas mun.;2012;85;117;19;98
Birštonas mun.;2013;-1;4460;1988;2472
Birštonas mun.;2013;0;35;17;18
Birštonas mun.;2013;1;37;20;17
Birštonas mun.;2013;2;49;28;21
Birštonas mun.;2013;3;48;25;23
Birštonas mun.;2013;4;27;18;9
Birštonas mun.;2013;5;35;9;26
Birštonas mun.;2013;6;35;11;24
Birštonas mun.;2013;7;30;15;15
Birštonas mun.;2013;8;37;18;19
Birštonas mun.;2013;9;45;25;20
Birštonas mun.;2013;10;32;16;16
Birštonas mun.;2013;11;34;18;16
Birštonas mun.;2013;12;39;17;22
Birštonas mun.;2013;13;41;16;25
Birštonas mun.;2013;14;38;23;15
Birštonas mun.;2013;15;36;21;15
Birštonas mun.;2013;16;42;22;20
Birštonas mun.;2013;17;64;36;28
Birštonas mun.;2013;18;64;31;33
Birštonas mun.;2013;19;91;41;50
Birštonas mun.;2013;20;71;43;28
Birštonas mun.;2013;21;59;35;24
Birštonas mun.;2013;22;46;21;25
Birštonas mun.;2013;23;67;42;25
Birštonas mun.;2013;24;57;34;23
Birštonas mun.;2013;25;55;25;30
Birštonas mun.;2013;26;65;32;33
Birštonas mun.;2013;27;58;31;27
Birštonas mun.;2013;28;42;21;21
Birštonas mun.;2013;29;40;18;22
Birštonas mun.;2013;30;33;24;9
Birštonas mun.;2013;31;30;21;9
Birštonas mun.;2013;32;36;18;18
Birštonas mun.;2013;33;53;25;28
Birštonas mun.;2013;34;28;17;11
Birštonas mun.;2013;35;37;15;22
Birštonas mun.;2013;36;25;17;8
Birštonas mun.;2013;37;42;16;26
Birštonas mun.;2013;38;46;20;26
Birštonas mun.;2013;39;42;18;24
Birštonas mun.;2013;40;70;33;37
Birštonas mun.;2013;41;64;30;34
Birštonas mun.;2013;42;58;26;32
Birštonas mun.;2013;43;63;28;35
Birštonas mun.;2013;44;65;28;37
Birštonas mun.;2013;45;59;25;34
Birštonas mun.;2013;46;66;36;30
Birštonas mun.;2013;47;72;27;45
Birštonas mun.;2013;48;71;33;38
Birštonas mun.;2013;49;54;20;34
Birštonas mun.;2013;50;71;38;33
Birštonas mun.;2013;51;88;45;43
Birštonas mun.;2013;52;87;38;49
Birštonas mun.;2013;53;87;42;45
Birštonas mun.;2013;54;73;37;36
Birštonas mun.;2013;55;94;33;61
Birštonas mun.;2013;56;75;30;45
Birštonas mun.;2013;57;73;42;31
Birštonas mun.;2013;58;61;24;37
Birštonas mun.;2013;59;61;30;31
Birštonas mun.;2013;60;54;30;24
Birštonas mun.;2013;61;51;20;31
Birštonas mun.;2013;62;57;28;29
Birštonas mun.;2013;63;46;22;24
Birštonas mun.;2013;64;47;15;32
Birštonas mun.;2013;65;47;20;27
Birštonas mun.;2013;66;35;13;22
Birštonas mun.;2013;67;47;16;31
Birštonas mun.;2013;68;42;13;29
Birštonas mun.;2013;69;40;11;29
Birštonas mun.;2013;70;53;23;30
Birštonas mun.;2013;71;46;18;28
Birštonas mun.;2013;72;60;26;34
Birštonas mun.;2013;73;48;16;32
Birštonas mun.;2013;74;62;17;45
Birštonas mun.;2013;75;38;13;25
Birštonas mun.;2013;76;43;16;27
Birštonas mun.;2013;77;38;10;28
Birštonas mun.;2013;78;48;10;38
Birštonas mun.;2013;79;45;12;33
Birštonas mun.;2013;80;36;9;27
Birštonas mun.;2013;81;44;12;32
Birštonas mun.;2013;82;43;14;29
Birštonas mun.;2013;83;30;5;25
Birštonas mun.;2013;84;25;13;12
Birštonas mun.;2013;85;132;21;111
Birštonas mun.;2014;-1;4369;1944;2425
Birštonas mun.;2014;0;40;21;19
Birštonas mun.;2014;1;37;18;19
Birštonas mun.;2014;2;38;19;19
Birštonas mun.;2014;3;47;27;20
Birštonas mun.;2014;4;45;23;22
Birštonas mun.;2014;5;28;17;11
Birštonas mun.;2014;6;33;8;25
Birštonas mun.;2014;7;34;12;22
Birštonas mun.;2014;8;32;16;16
Birštonas mun.;2014;9;36;18;18
Birštonas mun.;2014;10;44;24;20
Birštonas mun.;2014;11;33;16;17
Birštonas mun.;2014;12;35;19;16
Birštonas mun.;2014;13;38;17;21
Birštonas mun.;2014;14;39;15;24
Birštonas mun.;2014;15;38;23;15
Birštonas mun.;2014;16;36;22;14
Birštonas mun.;2014;17;42;22;20
Birštonas mun.;2014;18;64;36;28
Birštonas mun.;2014;19;62;30;32
Birštonas mun.;2014;20;83;37;46
Birštonas mun.;2014;21;69;44;25
Birštonas mun.;2014;22;59;35;24
Birštonas mun.;2014;23;51;23;28
Birštonas mun.;2014;24;62;41;21
Birštonas mun.;2014;25;53;33;20
Birštonas mun.;2014;26;53;24;29
Birštonas mun.;2014;27;63;30;33
Birštonas mun.;2014;28;53;32;21
Birštonas mun.;2014;29;37;18;19
Birštonas mun.;2014;30;35;17;18
Birštonas mun.;2014;31;29;20;9
Birštonas mun.;2014;32;29;21;8
Birštonas mun.;2014;33;34;15;19
Birštonas mun.;2014;34;51;24;27
Birštonas mun.;2014;35;31;18;13
Birštonas mun.;2014;36;35;14;21
Birštonas mun.;2014;37;24;16;8
Birštonas mun.;2014;38;39;15;24
Birštonas mun.;2014;39;46;21;25
Birštonas mun.;2014;40;40;16;24
Birštonas mun.;2014;41;70;32;38
Birštonas mun.;2014;42;61;29;32
Birštonas mun.;2014;43;55;26;29
Birštonas mun.;2014;44;61;26;35
Birštonas mun.;2014;45;67;29;38
Birštonas mun.;2014;46;59;25;34
Birštonas mun.;2014;47;65;35;30
Birštonas mun.;2014;48;72;27;45
Birštonas mun.;2014;49;71;32;39
Birštonas mun.;2014;50;54;20;34
Birštonas mun.;2014;51;69;38;31
Birštonas mun.;2014;52;86;45;41
Birštonas mun.;2014;53;85;37;48
Birštonas mun.;2014;54;86;41;45
Birštonas mun.;2014;55;75;38;37
Birštonas mun.;2014;56;95;33;62
Birštonas mun.;2014;57;76;29;47
Birštonas mun.;2014;58;73;42;31
Birštonas mun.;2014;59;62;25;37
Birštonas mun.;2014;60;59;28;31
Birštonas mun.;2014;61;51;27;24
Birštonas mun.;2014;62;49;19;30
Birštonas mun.;2014;63;57;28;29
Birštonas mun.;2014;64;44;20;24
Birštonas mun.;2014;65;49;16;33
Birštonas mun.;2014;66;46;19;27
Birštonas mun.;2014;67;34;12;22
Birštonas mun.;2014;68;44;12;32
Birštonas mun.;2014;69;40;13;27
Birštonas mun.;2014;70;39;11;28
Birštonas mun.;2014;71;51;21;30
Birštonas mun.;2014;72;44;16;28
Birštonas mun.;2014;73;56;24;32
Birštonas mun.;2014;74;46;15;31
Birštonas mun.;2014;75;59;17;42
Birštonas mun.;2014;76;37;12;25
Birštonas mun.;2014;77;42;15;27
Birštonas mun.;2014;78;35;8;27
Birštonas mun.;2014;79;47;9;38
Birštonas mun.;2014;80;43;11;32
Birštonas mun.;2014;81;34;9;25
Birštonas mun.;2014;82;45;11;34
Birštonas mun.;2014;83;38;13;25
Birštonas mun.;2014;84;30;6;24
Birštonas mun.;2014;85;131;26;105
Birštonas mun.;2015;-1;4371;1940;2431
Birštonas mun.;2015;0;40;18;22
Birštonas mun.;2015;1;40;22;18
Birštonas mun.;2015;2;38;20;18
Birštonas mun.;2015;3;37;17;20
Birštonas mun.;2015;4;46;26;20
Birštonas mun.;2015;5;45;23;22
Birštonas mun.;2015;6;30;18;12
Birštonas mun.;2015;7;32;7;25
Birštonas mun.;2015;8;34;11;23
Birštonas mun.;2015;9;31;15;16
Birštonas mun.;2015;10;37;18;19
Birštonas mun.;2015;11;45;25;20
Birštonas mun.;2015;12;33;16;17
Birštonas mun.;2015;13;36;20;16
Birštonas mun.;2015;14;39;17;22
Birštonas mun.;2015;15;39;15;24
Birštonas mun.;2015;16;38;23;15
Birštonas mun.;2015;17;36;22;14
Birštonas mun.;2015;18;42;22;20
Birštonas mun.;2015;19;62;35;27
Birštonas mun.;2015;20;62;30;32
Birštonas mun.;2015;21;81;37;44
Birštonas mun.;2015;22;69;46;23
Birštonas mun.;2015;23;60;34;26
Birštonas mun.;2015;24;50;23;27
Birštonas mun.;2015;25;60;38;22
Birštonas mun.;2015;26;57;35;22
Birštonas mun.;2015;27;51;22;29
Birštonas mun.;2015;28;64;28;36
Birštonas mun.;2015;29;51;30;21
Birštonas mun.;2015;30;36;19;17
Birštonas mun.;2015;31;34;18;16
Birštonas mun.;2015;32;28;19;9
Birštonas mun.;2015;33;30;22;8
Birštonas mun.;2015;34;37;17;20
Birštonas mun.;2015;35;48;20;28
Birštonas mun.;2015;36;32;18;14
Birštonas mun.;2015;37;39;15;24
Birštonas mun.;2015;38;26;17;9
Birštonas mun.;2015;39;41;16;25
Birštonas mun.;2015;40;44;20;24
Birštonas mun.;2015;41;42;17;25
Birštonas mun.;2015;42;71;32;39
Birštonas mun.;2015;43;62;30;32
Birštonas mun.;2015;44;58;27;31
Birštonas mun.;2015;45;61;26;35
Birštonas mun.;2015;46;64;29;35
Birštonas mun.;2015;47;58;24;34
Birštonas mun.;2015;48;64;34;30
Birštonas mun.;2015;49;72;25;47
Birštonas mun.;2015;50;73;32;41
Birštonas mun.;2015;51;52;19;33
Birštonas mun.;2015;52;67;37;30
Birštonas mun.;2015;53;80;43;37
Birštonas mun.;2015;54;86;38;48
Birštonas mun.;2015;55;88;44;44
Birštonas mun.;2015;56;76;39;37
Birštonas mun.;2015;57;95;34;61
Birštonas mun.;2015;58;77;29;48
Birštonas mun.;2015;59;74;43;31
Birštonas mun.;2015;60;63;26;37
Birštonas mun.;2015;61;60;29;31
Birštonas mun.;2015;62;51;26;25
Birštonas mun.;2015;63;49;19;30
Birštonas mun.;2015;64;57;28;29
Birštonas mun.;2015;65;43;20;23
Birštonas mun.;2015;66;47;13;34
Birštonas mun.;2015;67;44;17;27
Birštonas mun.;2015;68;36;14;22
Birštonas mun.;2015;69;46;14;32
Birštonas mun.;2015;70;38;13;25
Birštonas mun.;2015;71;39;11;28
Birštonas mun.;2015;72;48;18;30
Birštonas mun.;2015;73;44;16;28
Birštonas mun.;2015;74;56;24;32
Birštonas mun.;2015;75;43;13;30
Birštonas mun.;2015;76;55;15;40
Birštonas mun.;2015;77;38;13;25
Birštonas mun.;2015;78;42;15;27
Birštonas mun.;2015;79;32;7;25
Birštonas mun.;2015;80;45;7;38
Birštonas mun.;2015;81;39;8;31
Birštonas mun.;2015;82;34;9;25
Birštonas mun.;2015;83;44;10;34
Birštonas mun.;2015;84;32;10;22
Birštonas mun.;2015;85;146;29;117
Birštonas mun.;2016;-1;4330;1923;2407
Birštonas mun.;2016;0;37;19;18
Birštonas mun.;2016;1;34;14;20
Birštonas mun.;2016;2;42;23;19
Birštonas mun.;2016;3;42;24;18
Birštonas mun.;2016;4;36;16;20
Birštonas mun.;2016;5;46;25;21
Birštonas mun.;2016;6;47;23;24
Birštonas mun.;2016;7;28;17;11
Birštonas mun.;2016;8;31;7;24
Birštonas mun.;2016;9;35;12;23
Birštonas mun.;2016;10;30;15;15
Birštonas mun.;2016;11;35;18;17
Birštonas mun.;2016;12;43;23;20
Birštonas mun.;2016;13;33;16;17
Birštonas mun.;2016;14;37;20;17
Birštonas mun.;2016;15;37;15;22
Birštonas mun.;2016;16;38;14;24
Birštonas mun.;2016;17;40;23;17
Birštonas mun.;2016;18;35;21;14
Birštonas mun.;2016;19;40;22;18
Birštonas mun.;2016;20;60;32;28
Birštonas mun.;2016;21;60;29;31
Birštonas mun.;2016;22;80;38;42
Birštonas mun.;2016;23;67;45;22
Birštonas mun.;2016;24;63;36;27
Birštonas mun.;2016;25;48;20;28
Birštonas mun.;2016;26;53;35;18
Birštonas mun.;2016;27;62;36;26
Birštonas mun.;2016;28;47;22;25
Birštonas mun.;2016;29;61;27;34
Birštonas mun.;2016;30;52;30;22
Birštonas mun.;2016;31;35;18;17
Birštonas mun.;2016;32;32;15;17
Birštonas mun.;2016;33;27;19;8
Birštonas mun.;2016;34;28;20;8
Birštonas mun.;2016;35;39;20;19
Birštonas mun.;2016;36;47;21;26
Birštonas mun.;2016;37;28;15;13
Birštonas mun.;2016;38;38;14;24
Birštonas mun.;2016;39;27;17;10
Birštonas mun.;2016;40;44;17;27
Birštonas mun.;2016;41;43;19;24
Birštonas mun.;2016;42;40;17;23
Birštonas mun.;2016;43;69;31;38
Birštonas mun.;2016;44;61;30;31
Birštonas mun.;2016;45;56;24;32
Birštonas mun.;2016;46;63;29;34
Birštonas mun.;2016;47;64;28;36
Birštonas mun.;2016;48;60;25;35
Birštonas mun.;2016;49;63;33;30
Birštonas mun.;2016;50;71;25;46
Birštonas mun.;2016;51;73;33;40
Birštonas mun.;2016;52;54;20;34
Birštonas mun.;2016;53;69;39;30
Birštonas mun.;2016;54;86;43;43
Birštonas mun.;2016;55;84;37;47
Birštonas mun.;2016;56;88;43;45
Birštonas mun.;2016;57;76;39;37
Birštonas mun.;2016;58;93;32;61
Birštonas mun.;2016;59;78;30;48
Birštonas mun.;2016;60;75;43;32
Birštonas mun.;2016;61;61;24;37
Birštonas mun.;2016;62;59;28;31
Birštonas mun.;2016;63;50;25;25
Birštonas mun.;2016;64;45;15;30
Birštonas mun.;2016;65;56;27;29
Birštonas mun.;2016;66;43;20;23
Birštonas mun.;2016;67;49;15;34
Birštonas mun.;2016;68;45;18;27
Birštonas mun.;2016;69;35;14;21
Birštonas mun.;2016;70;45;14;31
Birštonas mun.;2016;71;38;12;26
Birštonas mun.;2016;72;38;11;27
Birštonas mun.;2016;73;49;19;30
Birštonas mun.;2016;74;46;18;28
Birštonas mun.;2016;75;55;23;32
Birštonas mun.;2016;76;41;13;28
Birštonas mun.;2016;77;53;12;41
Birštonas mun.;2016;78;37;13;24
Birštonas mun.;2016;79;40;14;26
Birštonas mun.;2016;80;32;7;25
Birštonas mun.;2016;81;42;7;35
Birštonas mun.;2016;82;35;8;27
Birštonas mun.;2016;83;33;8;25
Birštonas mun.;2016;84;41;10;31
Birštonas mun.;2016;85;152;35;117
Birštonas mun.;2017;-1;4254;1888;2366
Birštonas mun.;2017;0;48;22;26
Birštonas mun.;2017;1;40;19;21
Birštonas mun.;2017;2;35;16;19
Birštonas mun.;2017;3;40;22;18
Birštonas mun.;2017;4;45;27;18
Birštonas mun.;2017;5;35;15;20
Birštonas mun.;2017;6;45;22;23
Birštonas mun.;2017;7;48;23;25
Birštonas mun.;2017;8;27;15;12
Birštonas mun.;2017;9;29;6;23
Birštonas mun.;2017;10;32;9;23
Birštonas mun.;2017;11;29;14;15
Birštonas mun.;2017;12;35;18;17
Birštonas mun.;2017;13;44;23;21
Birštonas mun.;2017;14;33;16;17
Birštonas mun.;2017;15;37;20;17
Birštonas mun.;2017;16;36;14;22
Birštonas mun.;2017;17;37;15;22
Birštonas mun.;2017;18;34;21;13
Birštonas mun.;2017;19;32;20;12
Birštonas mun.;2017;20;39;22;17
Birštonas mun.;2017;21;58;32;26
Birštonas mun.;2017;22;56;29;27
Birštonas mun.;2017;23;75;37;38
Birštonas mun.;2017;24;66;42;24
Birštonas mun.;2017;25;56;34;22
Birštonas mun.;2017;26;46;20;26
Birštonas mun.;2017;27;55;33;22
Birštonas mun.;2017;28;60;35;25
Birštonas mun.;2017;29;43;21;22
Birštonas mun.;2017;30;54;21;33
Birštonas mun.;2017;31;47;28;19
Birštonas mun.;2017;32;31;18;13
Birštonas mun.;2017;33;31;13;18
Birštonas mun.;2017;34;27;18;9
Birštonas mun.;2017;35;26;19;7
Birštonas mun.;2017;36;36;19;17
Birštonas mun.;2017;37;47;21;26
Birštonas mun.;2017;38;28;14;14
Birštonas mun.;2017;39;34;13;21
Birštonas mun.;2017;40;24;18;6
Birštonas mun.;2017;41;45;17;28
Birštonas mun.;2017;42;42;19;23
Birštonas mun.;2017;43;39;16;23
Birštonas mun.;2017;44;68;30;38
Birštonas mun.;2017;45;61;28;33
Birštonas mun.;2017;46;55;22;33
Birštonas mun.;2017;47;64;29;35
Birštonas mun.;2017;48;64;29;35
Birštonas mun.;2017;49;58;24;34
Birštonas mun.;2017;50;63;34;29
Birštonas mun.;2017;51;73;27;46
Birštonas mun.;2017;52;72;33;39
Birštonas mun.;2017;53;51;18;33
Birštonas mun.;2017;54;69;40;29
Birštonas mun.;2017;55;85;41;44
Birštonas mun.;2017;56;85;37;48
Birštonas mun.;2017;57;88;43;45
Birštonas mun.;2017;58;75;39;36
Birštonas mun.;2017;59;90;32;58
Birštonas mun.;2017;60;78;30;48
Birštonas mun.;2017;61;74;43;31
Birštonas mun.;2017;62;60;23;37
Birštonas mun.;2017;63;61;30;31
Birštonas mun.;2017;64;49;25;24
Birštonas mun.;2017;65;46;15;31
Birštonas mun.;2017;66;56;27;29
Birštonas mun.;2017;67;44;20;24
Birštonas mun.;2017;68;48;15;33
Birštonas mun.;2017;69;42;18;24
Birštonas mun.;2017;70;35;14;21
Birštonas mun.;2017;71;42;13;29
Birštonas mun.;2017;72;36;11;25
Birštonas mun.;2017;73;37;10;27
Birštonas mun.;2017;74;47;18;29
Birštonas mun.;2017;75;46;18;28
Birštonas mun.;2017;76;57;24;33
Birštonas mun.;2017;77;40;12;28
Birštonas mun.;2017;78;51;12;39
Birštonas mun.;2017;79;34;10;24
Birštonas mun.;2017;80;40;14;26
Birštonas mun.;2017;81;28;4;24
Birštonas mun.;2017;82;35;5;30
Birštonas mun.;2017;83;34;8;26
Birštonas mun.;2017;84;33;8;25
Birštonas mun.;2017;85;174;39;135
Birštonas mun.;2018;-1;4168;1851;2317
Birštonas mun.;2018;0;36;19;17
Birštonas mun.;2018;1;46;21;25
Birštonas mun.;2018;2;34;16;18
Birštonas mun.;2018;3;36;16;20
Birštonas mun.;2018;4;38;23;15
Birštonas mun.;2018;5;44;26;18
Birštonas mun.;2018;6;33;15;18
Birštonas mun.;2018;7;44;23;21
Birštonas mun.;2018;8;46;23;23
Birštonas mun.;2018;9;26;16;10
Birštonas mun.;2018;10;27;6;21
Birštonas mun.;2018;11;30;8;22
Birštonas mun.;2018;12;28;13;15
Birštonas mun.;2018;13;36;20;16
Birštonas mun.;2018;14;43;23;20
Birštonas mun.;2018;15;34;16;18
Birštonas mun.;2018;16;36;19;17
Birštonas mun.;2018;17;36;14;22
Birštonas mun.;2018;18;35;15;20
Birštonas mun.;2018;19;33;21;12
Birštonas mun.;2018;20;33;19;14
Birštonas mun.;2018;21;39;22;17
Birštonas mun.;2018;22;56;30;26
Birštonas mun.;2018;23;55;26;29
Birštonas mun.;2018;24;71;36;35
Birštonas mun.;2018;25;68;40;28
Birštonas mun.;2018;26;54;32;22
Birštonas mun.;2018;27;41;18;23
Birštonas mun.;2018;28;51;29;22
Birštonas mun.;2018;29;56;33;23
Birštonas mun.;2018;30;42;21;21
Birštonas mun.;2018;31;53;22;31
Birštonas mun.;2018;32;41;25;16
Birštonas mun.;2018;33;31;18;13
Birštonas mun.;2018;34;32;14;18
Birštonas mun.;2018;35;25;18;7
Birštonas mun.;2018;36;27;20;7
Birštonas mun.;2018;37;31;16;15
Birštonas mun.;2018;38;46;19;27
Birštonas mun.;2018;39;23;11;12
Birštonas mun.;2018;40;31;12;19
Birštonas mun.;2018;41;24;17;7
Birštonas mun.;2018;42;43;17;26
Birštonas mun.;2018;43;39;19;20
Birštonas mun.;2018;44;38;16;22
Birštonas mun.;2018;45;68;30;38
Birštonas mun.;2018;46;60;28;32
Birštonas mun.;2018;47;55;22;33
Birštonas mun.;2018;48;64;30;34
Birštonas mun.;2018;49;63;27;36
Birštonas mun.;2018;50;55;21;34
Birštonas mun.;2018;51;63;35;28
Birštonas mun.;2018;52;75;28;47
Birštonas mun.;2018;53;71;33;38
Birštonas mun.;2018;54;52;19;33
Birštonas mun.;2018;55;69;41;28
Birštonas mun.;2018;56;85;40;45
Birštonas mun.;2018;57;85;37;48
Birštonas mun.;2018;58;88;42;46
Birštonas mun.;2018;59;77;39;38
Birštonas mun.;2018;60;90;32;58
Birštonas mun.;2018;61;80;31;49
Birštonas mun.;2018;62;72;41;31
Birštonas mun.;2018;63;57;18;39
Birštonas mun.;2018;64;59;30;29
Birštonas mun.;2018;65;49;25;24
Birštonas mun.;2018;66;46;14;32
Birštonas mun.;2018;67;56;28;28
Birštonas mun.;2018;68;46;19;27
Birštonas mun.;2018;69;49;15;34
Birštonas mun.;2018;70;41;18;23
Birštonas mun.;2018;71;33;13;20
Birštonas mun.;2018;72;39;11;28
Birštonas mun.;2018;73;35;10;25
Birštonas mun.;2018;74;35;9;26
Birštonas mun.;2018;75;44;16;28
Birštonas mun.;2018;76;44;18;26
Birštonas mun.;2018;77;55;23;32
Birštonas mun.;2018;78;39;11;28
Birštonas mun.;2018;79;48;12;36
Birštonas mun.;2018;80;35;10;25
Birštonas mun.;2018;81;40;14;26
Birštonas mun.;2018;82;28;5;23
Birštonas mun.;2018;83;35;6;29
Birštonas mun.;2018;84;29;7;22
Birštonas mun.;2018;85;183;40;143
Biržai d. mun.;2001;-1;35498;16672;18826
Biržai d. mun.;2001;0;348;191;157
Biržai d. mun.;2001;1;386;176;210
Biržai d. mun.;2001;2;401;205;196
Biržai d. mun.;2001;3;372;204;168
Biržai d. mun.;2001;4;427;223;204
Biržai d. mun.;2001;5;435;220;215
Biržai d. mun.;2001;6;443;227;216
Biržai d. mun.;2001;7;520;285;235
Biržai d. mun.;2001;8;591;309;282
Biržai d. mun.;2001;9;545;270;275
Biržai d. mun.;2001;10;540;284;256
Biržai d. mun.;2001;11;554;287;267
Biržai d. mun.;2001;12;539;265;274
Biržai d. mun.;2001;13;565;279;286
Biržai d. mun.;2001;14;584;302;282
Biržai d. mun.;2001;15;512;246;266
Biržai d. mun.;2001;16;532;264;268
Biržai d. mun.;2001;17;532;277;255
Biržai d. mun.;2001;18;369;206;163
Biržai d. mun.;2001;19;305;164;141
Biržai d. mun.;2001;20;305;194;111
Biržai d. mun.;2001;21;295;157;138
Biržai d. mun.;2001;22;352;199;153
Biržai d. mun.;2001;23;387;207;180
Biržai d. mun.;2001;24;387;208;179
Biržai d. mun.;2001;25;429;221;208
Biržai d. mun.;2001;26;413;212;201
Biržai d. mun.;2001;27;478;235;243
Biržai d. mun.;2001;28;505;262;243
Biržai d. mun.;2001;29;505;250;255
Biržai d. mun.;2001;30;484;252;232
Biržai d. mun.;2001;31;517;274;243
Biržai d. mun.;2001;32;497;255;242
Biržai d. mun.;2001;33;518;255;263
Biržai d. mun.;2001;34;472;240;232
Biržai d. mun.;2001;35;453;236;217
Biržai d. mun.;2001;36;490;255;235
Biržai d. mun.;2001;37;492;243;249
Biržai d. mun.;2001;38;485;238;247
Biržai d. mun.;2001;39;491;246;245
Biržai d. mun.;2001;40;516;267;249
Biržai d. mun.;2001;41;488;254;234
Biržai d. mun.;2001;42;494;248;246
Biržai d. mun.;2001;43;430;207;223
Biržai d. mun.;2001;44;396;188;208
Biržai d. mun.;2001;45;455;219;236
Biržai d. mun.;2001;46;396;186;210
Biržai d. mun.;2001;47;359;184;175
Biržai d. mun.;2001;48;375;198;177
Biržai d. mun.;2001;49;425;198;227
Biržai d. mun.;2001;50;424;208;216
Biržai d. mun.;2001;51;422;199;223
Biržai d. mun.;2001;52;377;168;209
Biržai d. mun.;2001;53;403;185;218
Biržai d. mun.;2001;54;343;172;171
Biržai d. mun.;2001;55;379;171;208
Biržai d. mun.;2001;56;368;185;183
Biržai d. mun.;2001;57;448;204;244
Biržai d. mun.;2001;58;461;209;252
Biržai d. mun.;2001;59;481;212;269
Biržai d. mun.;2001;60;412;180;232
Biržai d. mun.;2001;61;444;199;245
Biržai d. mun.;2001;62;415;173;242
Biržai d. mun.;2001;63;437;168;269
Biržai d. mun.;2001;64;439;189;250
Biržai d. mun.;2001;65;404;162;242
Biržai d. mun.;2001;66;428;166;262
Biržai d. mun.;2001;67;428;185;243
Biržai d. mun.;2001;68;427;171;256
Biržai d. mun.;2001;69;378;152;226
Biržai d. mun.;2001;70;386;143;243
Biržai d. mun.;2001;71;360;125;235
Biržai d. mun.;2001;72;389;135;254
Biržai d. mun.;2001;73;342;115;227
Biržai d. mun.;2001;74;335;105;230
Biržai d. mun.;2001;75;326;87;239
Biržai d. mun.;2001;76;281;84;197
Biržai d. mun.;2001;77;293;97;196
Biržai d. mun.;2001;78;260;83;177
Biržai d. mun.;2001;79;252;78;174
Biržai d. mun.;2001;80;211;54;157
Biržai d. mun.;2001;81;122;29;93
Biržai d. mun.;2001;82;84;13;71
Biržai d. mun.;2001;83;80;21;59
Biržai d. mun.;2001;84;78;28;50
Biržai d. mun.;2001;85;592;145;447
Biržai d. mun.;2002;-1;35063;16464;18599
Biržai d. mun.;2002;0;308;174;134
Biržai d. mun.;2002;1;345;189;156
Biržai d. mun.;2002;2;382;171;211
Biržai d. mun.;2002;3;397;202;195
Biržai d. mun.;2002;4;371;202;169
Biržai d. mun.;2002;5;421;218;203
Biržai d. mun.;2002;6;434;218;216
Biržai d. mun.;2002;7;439;222;217
Biržai d. mun.;2002;8;518;283;235
Biržai d. mun.;2002;9;584;303;281
Biržai d. mun.;2002;10;538;267;271
Biržai d. mun.;2002;11;537;280;257
Biržai d. mun.;2002;12;545;284;261
Biržai d. mun.;2002;13;531;260;271
Biržai d. mun.;2002;14;556;274;282
Biržai d. mun.;2002;15;579;299;280
Biržai d. mun.;2002;16;504;243;261
Biržai d. mun.;2002;17;524;260;264
Biržai d. mun.;2002;18;521;270;251
Biržai d. mun.;2002;19;358;203;155
Biržai d. mun.;2002;20;304;164;140
Biržai d. mun.;2002;21;305;192;113
Biržai d. mun.;2002;22;293;153;140
Biržai d. mun.;2002;23;349;196;153
Biržai d. mun.;2002;24;376;200;176
Biržai d. mun.;2002;25;380;203;177
Biržai d. mun.;2002;26;422;219;203
Biržai d. mun.;2002;27;401;205;196
Biržai d. mun.;2002;28;464;225;239
Biržai d. mun.;2002;29;488;252;236
Biržai d. mun.;2002;30;493;244;249
Biržai d. mun.;2002;31;474;247;227
Biržai d. mun.;2002;32;507;267;240
Biržai d. mun.;2002;33;489;248;241
Biržai d. mun.;2002;34;512;251;261
Biržai d. mun.;2002;35;463;233;230
Biržai d. mun.;2002;36;447;233;214
Biržai d. mun.;2002;37;484;251;233
Biržai d. mun.;2002;38;480;237;243
Biržai d. mun.;2002;39;478;235;243
Biržai d. mun.;2002;40;484;241;243
Biržai d. mun.;2002;41;509;262;247
Biržai d. mun.;2002;42;481;251;230
Biržai d. mun.;2002;43;490;247;243
Biržai d. mun.;2002;44;428;207;221
Biržai d. mun.;2002;45;389;186;203
Biržai d. mun.;2002;46;446;213;233
Biržai d. mun.;2002;47;395;187;208
Biržai d. mun.;2002;48;355;181;174
Biržai d. mun.;2002;49;364;190;174
Biržai d. mun.;2002;50;419;194;225
Biržai d. mun.;2002;51;414;202;212
Biržai d. mun.;2002;52;419;196;223
Biržai d. mun.;2002;53;372;168;204
Biržai d. mun.;2002;54;396;181;215
Biržai d. mun.;2002;55;332;165;167
Biržai d. mun.;2002;56;369;167;202
Biržai d. mun.;2002;57;361;181;180
Biržai d. mun.;2002;58;434;197;237
Biržai d. mun.;2002;59;450;204;246
Biržai d. mun.;2002;60;478;210;268
Biržai d. mun.;2002;61;406;172;234
Biržai d. mun.;2002;62;438;198;240
Biržai d. mun.;2002;63;415;173;242
Biržai d. mun.;2002;64;434;165;269
Biržai d. mun.;2002;65;431;181;250
Biržai d. mun.;2002;66;391;156;235
Biržai d. mun.;2002;67;422;164;258
Biržai d. mun.;2002;68;423;182;241
Biržai d. mun.;2002;69;412;160;252
Biržai d. mun.;2002;70;376;151;225
Biržai d. mun.;2002;71;376;135;241
Biržai d. mun.;2002;72;349;118;231
Biržai d. mun.;2002;73;379;129;250
Biržai d. mun.;2002;74;331;112;219
Biržai d. mun.;2002;75;325;100;225
Biržai d. mun.;2002;76;319;85;234
Biržai d. mun.;2002;77;267;77;190
Biržai d. mun.;2002;78;276;92;184
Biržai d. mun.;2002;79;240;74;166
Biržai d. mun.;2002;80;245;78;167
Biržai d. mun.;2002;81;189;45;144
Biržai d. mun.;2002;82;111;26;85
Biržai d. mun.;2002;83;78;13;65
Biržai d. mun.;2002;84;78;19;59
Biržai d. mun.;2002;85;566;152;414
Biržai d. mun.;2003;-1;34715;16281;18434
Biržai d. mun.;2003;0;315;165;150
Biržai d. mun.;2003;1;315;178;137
Biržai d. mun.;2003;2;340;185;155
Biržai d. mun.;2003;3;376;169;207
Biržai d. mun.;2003;4;395;199;196
Biržai d. mun.;2003;5;369;201;168
Biržai d. mun.;2003;6;416;218;198
Biržai d. mun.;2003;7;428;216;212
Biržai d. mun.;2003;8;443;223;220
Biržai d. mun.;2003;9;513;283;230
Biržai d. mun.;2003;10;576;300;276
Biržai d. mun.;2003;11;533;264;269
Biržai d. mun.;2003;12;524;271;253
Biržai d. mun.;2003;13;540;282;258
Biržai d. mun.;2003;14;522;254;268
Biržai d. mun.;2003;15;550;269;281
Biržai d. mun.;2003;16;567;293;274
Biržai d. mun.;2003;17;496;238;258
Biržai d. mun.;2003;18;516;257;259
Biržai d. mun.;2003;19;518;268;250
Biržai d. mun.;2003;20;349;199;150
Biržai d. mun.;2003;21;299;161;138
Biržai d. mun.;2003;22;312;193;119
Biržai d. mun.;2003;23;291;150;141
Biržai d. mun.;2003;24;346;192;154
Biržai d. mun.;2003;25;365;198;167
Biržai d. mun.;2003;26;373;197;176
Biržai d. mun.;2003;27;412;209;203
Biržai d. mun.;2003;28;394;200;194
Biržai d. mun.;2003;29;462;225;237
Biržai d. mun.;2003;30;475;250;225
Biržai d. mun.;2003;31;486;240;246
Biržai d. mun.;2003;32;476;246;230
Biržai d. mun.;2003;33;501;263;238
Biržai d. mun.;2003;34;484;246;238
Biržai d. mun.;2003;35;505;247;258
Biržai d. mun.;2003;36;462;231;231
Biržai d. mun.;2003;37;444;230;214
Biržai d. mun.;2003;38;482;250;232
Biržai d. mun.;2003;39;478;236;242
Biržai d. mun.;2003;40;468;228;240
Biržai d. mun.;2003;41;478;238;240
Biržai d. mun.;2003;42;503;258;245
Biržai d. mun.;2003;43;474;248;226
Biržai d. mun.;2003;44;490;248;242
Biržai d. mun.;2003;45;425;206;219
Biržai d. mun.;2003;46;384;183;201
Biržai d. mun.;2003;47;438;208;230
Biržai d. mun.;2003;48;391;184;207
Biržai d. mun.;2003;49;349;176;173
Biržai d. mun.;2003;50;362;190;172
Biržai d. mun.;2003;51;415;193;222
Biržai d. mun.;2003;52;406;198;208
Biržai d. mun.;2003;53;417;195;222
Biržai d. mun.;2003;54;368;165;203
Biržai d. mun.;2003;55;391;177;214
Biržai d. mun.;2003;56;326;161;165
Biržai d. mun.;2003;57;362;162;200
Biržai d. mun.;2003;58;354;176;178
Biržai d. mun.;2003;59;430;194;236
Biržai d. mun.;2003;60;443;198;245
Biržai d. mun.;2003;61;471;206;265
Biržai d. mun.;2003;62;403;169;234
Biržai d. mun.;2003;63;438;200;238
Biržai d. mun.;2003;64;407;170;237
Biržai d. mun.;2003;65;431;164;267
Biržai d. mun.;2003;66;426;175;251
Biržai d. mun.;2003;67;390;154;236
Biržai d. mun.;2003;68;408;150;258
Biržai d. mun.;2003;69;419;177;242
Biržai d. mun.;2003;70;405;155;250
Biržai d. mun.;2003;71;365;144;221
Biržai d. mun.;2003;72;360;128;232
Biržai d. mun.;2003;73;333;110;223
Biržai d. mun.;2003;74;364;120;244
Biržai d. mun.;2003;75;316;102;214
Biržai d. mun.;2003;76;311;91;220
Biržai d. mun.;2003;77;304;78;226
Biržai d. mun.;2003;78;252;73;179
Biržai d. mun.;2003;79;262;85;177
Biržai d. mun.;2003;80;221;63;158
Biržai d. mun.;2003;81;229;70;159
Biržai d. mun.;2003;82;175;42;133
Biržai d. mun.;2003;83;102;24;78
Biržai d. mun.;2003;84;76;12;64
Biržai d. mun.;2003;85;525;137;388
Biržai d. mun.;2004;-1;34266;16075;18191
Biržai d. mun.;2004;0;301;171;130
Biržai d. mun.;2004;1;314;163;151
Biržai d. mun.;2004;2;311;174;137
Biržai d. mun.;2004;3;338;185;153
Biržai d. mun.;2004;4;377;167;210
Biržai d. mun.;2004;5;395;198;197
Biržai d. mun.;2004;6;362;198;164
Biržai d. mun.;2004;7;417;219;198
Biržai d. mun.;2004;8;431;218;213
Biržai d. mun.;2004;9;444;223;221
Biržai d. mun.;2004;10;513;281;232
Biržai d. mun.;2004;11;572;296;276
Biržai d. mun.;2004;12;527;261;266
Biržai d. mun.;2004;13;518;271;247
Biržai d. mun.;2004;14;528;277;251
Biržai d. mun.;2004;15;516;251;265
Biržai d. mun.;2004;16;542;266;276
Biržai d. mun.;2004;17;555;288;267
Biržai d. mun.;2004;18;484;232;252
Biržai d. mun.;2004;19;506;252;254
Biržai d. mun.;2004;20;503;260;243
Biržai d. mun.;2004;21;341;195;146
Biržai d. mun.;2004;22;291;156;135
Biržai d. mun.;2004;23;306;186;120
Biržai d. mun.;2004;24;289;148;141
Biržai d. mun.;2004;25;339;188;151
Biržai d. mun.;2004;26;355;186;169
Biržai d. mun.;2004;27;360;192;168
Biržai d. mun.;2004;28;394;200;194
Biržai d. mun.;2004;29;377;188;189
Biržai d. mun.;2004;30;457;222;235
Biržai d. mun.;2004;31;468;245;223
Biržai d. mun.;2004;32;475;233;242
Biržai d. mun.;2004;33;463;237;226
Biržai d. mun.;2004;34;491;255;236
Biržai d. mun.;2004;35;478;246;232
Biržai d. mun.;2004;36;502;245;257
Biržai d. mun.;2004;37;453;224;229
Biržai d. mun.;2004;38;443;228;215
Biržai d. mun.;2004;39;477;247;230
Biržai d. mun.;2004;40;472;233;239
Biržai d. mun.;2004;41;464;227;237
Biržai d. mun.;2004;42;475;237;238
Biržai d. mun.;2004;43;495;254;241
Biržai d. mun.;2004;44;462;241;221
Biržai d. mun.;2004;45;491;250;241
Biržai d. mun.;2004;46;424;206;218
Biržai d. mun.;2004;47;381;181;200
Biržai d. mun.;2004;48;431;205;226
Biržai d. mun.;2004;49;393;186;207
Biržai d. mun.;2004;50;348;173;175
Biržai d. mun.;2004;51;358;188;170
Biržai d. mun.;2004;52;409;190;219
Biržai d. mun.;2004;53;403;196;207
Biržai d. mun.;2004;54;414;195;219
Biržai d. mun.;2004;55;358;157;201
Biržai d. mun.;2004;56;387;174;213
Biržai d. mun.;2004;57;319;157;162
Biržai d. mun.;2004;58;357;162;195
Biržai d. mun.;2004;59;351;175;176
Biržai d. mun.;2004;60;425;192;233
Biržai d. mun.;2004;61;436;194;242
Biržai d. mun.;2004;62;463;204;259
Biržai d. mun.;2004;63;393;163;230
Biržai d. mun.;2004;64;420;190;230
Biržai d. mun.;2004;65;405;164;241
Biržai d. mun.;2004;66;427;159;268
Biržai d. mun.;2004;67;414;166;248
Biržai d. mun.;2004;68;380;148;232
Biržai d. mun.;2004;69;404;146;258
Biržai d. mun.;2004;70;406;169;237
Biržai d. mun.;2004;71;400;153;247
Biržai d. mun.;2004;72;352;133;219
Biržai d. mun.;2004;73;356;125;231
Biržai d. mun.;2004;74;321;104;217
Biržai d. mun.;2004;75;350;114;236
Biržai d. mun.;2004;76;307;100;207
Biržai d. mun.;2004;77;295;80;215
Biržai d. mun.;2004;78;289;68;221
Biržai d. mun.;2004;79;228;62;166
Biržai d. mun.;2004;80;250;81;169
Biržai d. mun.;2004;81;209;61;148
Biržai d. mun.;2004;82;215;64;151
Biržai d. mun.;2004;83;154;36;118
Biržai d. mun.;2004;84;90;22;68
Biržai d. mun.;2004;85;472;118;354
Biržai d. mun.;2005;-1;33551;15747;17804
Biržai d. mun.;2005;0;282;157;125
Biržai d. mun.;2005;1;291;166;125
Biržai d. mun.;2005;2;308;161;147
Biržai d. mun.;2005;3;307;173;134
Biržai d. mun.;2005;4;333;182;151
Biržai d. mun.;2005;5;370;164;206
Biržai d. mun.;2005;6;387;194;193
Biržai d. mun.;2005;7;361;198;163
Biržai d. mun.;2005;8;415;218;197
Biržai d. mun.;2005;9;425;216;209
Biržai d. mun.;2005;10;439;220;219
Biržai d. mun.;2005;11;508;279;229
Biržai d. mun.;2005;12;565;291;274
Biržai d. mun.;2005;13;523;261;262
Biržai d. mun.;2005;14;509;267;242
Biržai d. mun.;2005;15;521;273;248
Biržai d. mun.;2005;16;503;242;261
Biržai d. mun.;2005;17;530;261;269
Biržai d. mun.;2005;18;538;278;260
Biržai d. mun.;2005;19;461;220;241
Biržai d. mun.;2005;20;491;243;248
Biržai d. mun.;2005;21;486;247;239
Biržai d. mun.;2005;22;321;183;138
Biržai d. mun.;2005;23;283;149;134
Biržai d. mun.;2005;24;289;181;108
Biržai d. mun.;2005;25;275;145;130
Biržai d. mun.;2005;26;321;180;141
Biržai d. mun.;2005;27;342;176;166
Biržai d. mun.;2005;28;346;182;164
Biržai d. mun.;2005;29;383;196;187
Biržai d. mun.;2005;30;364;187;177
Biržai d. mun.;2005;31;439;216;223
Biržai d. mun.;2005;32;455;238;217
Biržai d. mun.;2005;33;462;228;234
Biržai d. mun.;2005;34;449;230;219
Biržai d. mun.;2005;35;480;249;231
Biržai d. mun.;2005;36;466;236;230
Biržai d. mun.;2005;37;488;239;249
Biržai d. mun.;2005;38;442;217;225
Biržai d. mun.;2005;39;431;221;210
Biržai d. mun.;2005;40;467;241;226
Biržai d. mun.;2005;41;465;229;236
Biržai d. mun.;2005;42;454;221;233
Biržai d. mun.;2005;43;470;235;235
Biržai d. mun.;2005;44;490;252;238
Biržai d. mun.;2005;45;456;238;218
Biržai d. mun.;2005;46;485;247;238
Biržai d. mun.;2005;47;416;201;215
Biržai d. mun.;2005;48;371;174;197
Biržai d. mun.;2005;49;424;203;221
Biržai d. mun.;2005;50;386;180;206
Biržai d. mun.;2005;51;339;166;173
Biržai d. mun.;2005;52;353;186;167
Biržai d. mun.;2005;53;402;185;217
Biržai d. mun.;2005;54;393;189;204
Biržai d. mun.;2005;55;411;191;220
Biržai d. mun.;2005;56;353;154;199
Biržai d. mun.;2005;57;382;171;211
Biržai d. mun.;2005;58;314;155;159
Biržai d. mun.;2005;59;353;159;194
Biržai d. mun.;2005;60;346;169;177
Biržai d. mun.;2005;61;414;184;230
Biržai d. mun.;2005;62;428;189;239
Biržai d. mun.;2005;63;452;198;254
Biržai d. mun.;2005;64;388;160;228
Biržai d. mun.;2005;65;410;184;226
Biržai d. mun.;2005;66;395;156;239
Biržai d. mun.;2005;67;420;155;265
Biržai d. mun.;2005;68;405;158;247
Biržai d. mun.;2005;69;368;141;227
Biržai d. mun.;2005;70;393;142;251
Biržai d. mun.;2005;71;392;158;234
Biržai d. mun.;2005;72;392;148;244
Biržai d. mun.;2005;73;345;132;213
Biržai d. mun.;2005;74;349;122;227
Biržai d. mun.;2005;75;305;97;208
Biržai d. mun.;2005;76;338;109;229
Biržai d. mun.;2005;77;287;88;199
Biržai d. mun.;2005;78;288;77;211
Biržai d. mun.;2005;79;272;65;207
Biržai d. mun.;2005;80;206;55;151
Biržai d. mun.;2005;81;225;72;153
Biržai d. mun.;2005;82;181;48;133
Biržai d. mun.;2005;83;196;58;138
Biržai d. mun.;2005;84;134;32;102
Biržai d. mun.;2005;85;449;109;340
Biržai d. mun.;2006;-1;32515;15205;17310
Biržai d. mun.;2006;0;265;134;131
Biržai d. mun.;2006;1;272;149;123
Biržai d. mun.;2006;2;285;164;121
Biržai d. mun.;2006;3;301;158;143
Biržai d. mun.;2006;4;302;170;132
Biržai d. mun.;2006;5;326;176;150
Biržai d. mun.;2006;6;363;163;200
Biržai d. mun.;2006;7;383;191;192
Biržai d. mun.;2006;8;358;198;160
Biržai d. mun.;2006;9;410;216;194
Biržai d. mun.;2006;10;421;213;208
Biržai d. mun.;2006;11;438;221;217
Biržai d. mun.;2006;12;504;275;229
Biržai d. mun.;2006;13;552;283;269
Biržai d. mun.;2006;14;511;255;256
Biržai d. mun.;2006;15;494;261;233
Biržai d. mun.;2006;16;501;261;240
Biržai d. mun.;2006;17;488;234;254
Biržai d. mun.;2006;18;510;251;259
Biržai d. mun.;2006;19;507;263;244
Biržai d. mun.;2006;20;427;204;223
Biržai d. mun.;2006;21;456;228;228
Biržai d. mun.;2006;22;454;236;218
Biržai d. mun.;2006;23;302;173;129
Biržai d. mun.;2006;24;260;138;122
Biržai d. mun.;2006;25;262;158;104
Biržai d. mun.;2006;26;254;132;122
Biržai d. mun.;2006;27;297;166;131
Biržai d. mun.;2006;28;322;166;156
Biržai d. mun.;2006;29;334;180;154
Biržai d. mun.;2006;30;374;192;182
Biržai d. mun.;2006;31;345;177;168
Biržai d. mun.;2006;32;426;207;219
Biržai d. mun.;2006;33;438;225;213
Biržai d. mun.;2006;34;446;219;227
Biržai d. mun.;2006;35;441;222;219
Biržai d. mun.;2006;36;466;240;226
Biržai d. mun.;2006;37;447;226;221
Biržai d. mun.;2006;38;477;236;241
Biržai d. mun.;2006;39;430;209;221
Biržai d. mun.;2006;40;419;213;206
Biržai d. mun.;2006;41;452;230;222
Biržai d. mun.;2006;42;452;221;231
Biržai d. mun.;2006;43;447;214;233
Biržai d. mun.;2006;44;457;228;229
Biržai d. mun.;2006;45;486;248;238
Biržai d. mun.;2006;46;447;233;214
Biržai d. mun.;2006;47;473;240;233
Biržai d. mun.;2006;48;410;198;212
Biržai d. mun.;2006;49;359;166;193
Biržai d. mun.;2006;50;412;194;218
Biržai d. mun.;2006;51;374;173;201
Biržai d. mun.;2006;52;326;158;168
Biržai d. mun.;2006;53;343;179;164
Biržai d. mun.;2006;54;388;176;212
Biržai d. mun.;2006;55;383;183;200
Biržai d. mun.;2006;56;402;186;216
Biržai d. mun.;2006;57;344;149;195
Biržai d. mun.;2006;58;373;167;206
Biržai d. mun.;2006;59;305;150;155
Biržai d. mun.;2006;60;336;145;191
Biržai d. mun.;2006;61;333;161;172
Biržai d. mun.;2006;62;404;178;226
Biržai d. mun.;2006;63;416;181;235
Biržai d. mun.;2006;64;433;187;246
Biržai d. mun.;2006;65;379;153;226
Biržai d. mun.;2006;66;398;176;222
Biržai d. mun.;2006;67;380;145;235
Biržai d. mun.;2006;68;410;150;260
Biržai d. mun.;2006;69;395;153;242
Biržai d. mun.;2006;70;356;136;220
Biržai d. mun.;2006;71;377;136;241
Biržai d. mun.;2006;72;382;151;231
Biržai d. mun.;2006;73;373;137;236
Biržai d. mun.;2006;74;325;120;205
Biržai d. mun.;2006;75;325;105;220
Biržai d. mun.;2006;76;295;93;202
Biržai d. mun.;2006;77;325;105;220
Biržai d. mun.;2006;78;265;76;189
Biržai d. mun.;2006;79;268;71;197
Biržai d. mun.;2006;80;254;61;193
Biržai d. mun.;2006;81;186;47;139
Biržai d. mun.;2006;82;205;62;143
Biržai d. mun.;2006;83;167;42;125
Biržai d. mun.;2006;84;168;52;116
Biržai d. mun.;2006;85;459;106;353
Biržai d. mun.;2007;-1;31766;14804;16962
Biržai d. mun.;2007;0;232;119;113
Biržai d. mun.;2007;1;259;131;128
Biržai d. mun.;2007;2;269;146;123
Biržai d. mun.;2007;3;279;160;119
Biržai d. mun.;2007;4;297;155;142
Biržai d. mun.;2007;5;300;167;133
Biržai d. mun.;2007;6;320;174;146
Biržai d. mun.;2007;7;357;159;198
Biržai d. mun.;2007;8;374;186;188
Biržai d. mun.;2007;9;353;195;158
Biržai d. mun.;2007;10;408;214;194
Biržai d. mun.;2007;11;419;211;208
Biržai d. mun.;2007;12;430;215;215
Biržai d. mun.;2007;13;498;269;229
Biržai d. mun.;2007;14;546;280;266
Biržai d. mun.;2007;15;503;251;252
Biržai d. mun.;2007;16;487;258;229
Biržai d. mun.;2007;17;491;255;236
Biržai d. mun.;2007;18;474;227;247
Biržai d. mun.;2007;19;500;244;256
Biržai d. mun.;2007;20;490;256;234
Biržai d. mun.;2007;21;405;195;210
Biržai d. mun.;2007;22;440;219;221
Biržai d. mun.;2007;23;435;225;210
Biržai d. mun.;2007;24;289;168;121
Biržai d. mun.;2007;25;247;127;120
Biržai d. mun.;2007;26;245;149;96
Biržai d. mun.;2007;27;239;126;113
Biržai d. mun.;2007;28;290;160;130
Biržai d. mun.;2007;29;308;159;149
Biržai d. mun.;2007;30;323;177;146
Biržai d. mun.;2007;31;362;185;177
Biržai d. mun.;2007;32;338;172;166
Biržai d. mun.;2007;33;417;199;218
Biržai d. mun.;2007;34;427;219;208
Biržai d. mun.;2007;35;438;214;224
Biržai d. mun.;2007;36;426;214;212
Biržai d. mun.;2007;37;459;235;224
Biržai d. mun.;2007;38;441;223;218
Biržai d. mun.;2007;39;467;232;235
Biržai d. mun.;2007;40;420;202;218
Biržai d. mun.;2007;41;412;209;203
Biržai d. mun.;2007;42;445;225;220
Biržai d. mun.;2007;43;442;214;228
Biržai d. mun.;2007;44;443;211;232
Biržai d. mun.;2007;45;451;224;227
Biržai d. mun.;2007;46;481;242;239
Biržai d. mun.;2007;47;445;234;211
Biržai d. mun.;2007;48;462;232;230
Biržai d. mun.;2007;49;395;191;204
Biržai d. mun.;2007;50;351;162;189
Biržai d. mun.;2007;51;402;189;213
Biržai d. mun.;2007;52;368;168;200
Biržai d. mun.;2007;53;317;151;166
Biržai d. mun.;2007;54;342;175;167
Biržai d. mun.;2007;55;381;171;210
Biržai d. mun.;2007;56;370;174;196
Biržai d. mun.;2007;57;391;179;212
Biržai d. mun.;2007;58;337;145;192
Biržai d. mun.;2007;59;366;162;204
Biržai d. mun.;2007;60;293;142;151
Biržai d. mun.;2007;61;330;142;188
Biržai d. mun.;2007;62;323;153;170
Biržai d. mun.;2007;63;387;167;220
Biržai d. mun.;2007;64;403;173;230
Biržai d. mun.;2007;65;421;180;241
Biržai d. mun.;2007;66;366;148;218
Biržai d. mun.;2007;67;391;172;219
Biržai d. mun.;2007;68;368;138;230
Biržai d. mun.;2007;69;397;140;257
Biržai d. mun.;2007;70;378;140;238
Biržai d. mun.;2007;71;334;123;211
Biržai d. mun.;2007;72;368;130;238
Biržai d. mun.;2007;73;371;144;227
Biržai d. mun.;2007;74;361;131;230
Biržai d. mun.;2007;75;311;114;197
Biržai d. mun.;2007;76;305;98;207
Biržai d. mun.;2007;77;281;85;196
Biržai d. mun.;2007;78;296;93;203
Biržai d. mun.;2007;79;250;76;174
Biržai d. mun.;2007;80;259;69;190
Biržai d. mun.;2007;81;235;53;182
Biržai d. mun.;2007;82;166;40;126
Biržai d. mun.;2007;83;186;55;131
Biržai d. mun.;2007;84;155;36;119
Biržai d. mun.;2007;85;528;132;396
Biržai d. mun.;2008;-1;30959;14392;16567
Biržai d. mun.;2008;0;225;114;111
Biržai d. mun.;2008;1;227;118;109
Biržai d. mun.;2008;2;256;132;124
Biržai d. mun.;2008;3;261;144;117
Biržai d. mun.;2008;4;275;158;117
Biržai d. mun.;2008;5;292;153;139
Biržai d. mun.;2008;6;296;164;132
Biržai d. mun.;2008;7;316;171;145
Biržai d. mun.;2008;8;352;157;195
Biržai d. mun.;2008;9;367;182;185
Biržai d. mun.;2008;10;352;193;159
Biržai d. mun.;2008;11;398;210;188
Biržai d. mun.;2008;12;416;210;206
Biržai d. mun.;2008;13;425;213;212
Biržai d. mun.;2008;14;494;267;227
Biržai d. mun.;2008;15;536;276;260
Biržai d. mun.;2008;16;497;248;249
Biržai d. mun.;2008;17;476;251;225
Biržai d. mun.;2008;18;485;252;233
Biržai d. mun.;2008;19;465;226;239
Biržai d. mun.;2008;20;482;237;245
Biržai d. mun.;2008;21;475;250;225
Biržai d. mun.;2008;22;389;188;201
Biržai d. mun.;2008;23;419;208;211
Biržai d. mun.;2008;24;414;220;194
Biržai d. mun.;2008;25;272;159;113
Biržai d. mun.;2008;26;238;120;118
Biržai d. mun.;2008;27;232;142;90
Biržai d. mun.;2008;28;227;115;112
Biržai d. mun.;2008;29;271;152;119
Biržai d. mun.;2008;30;302;157;145
Biržai d. mun.;2008;31;310;167;143
Biržai d. mun.;2008;32;351;178;173
Biržai d. mun.;2008;33;330;168;162
Biržai d. mun.;2008;34;409;192;217
Biržai d. mun.;2008;35;416;218;198
Biržai d. mun.;2008;36;428;207;221
Biržai d. mun.;2008;37;420;210;210
Biržai d. mun.;2008;38;444;228;216
Biržai d. mun.;2008;39;426;215;211
Biržai d. mun.;2008;40;457;226;231
Biržai d. mun.;2008;41;410;195;215
Biržai d. mun.;2008;42;401;203;198
Biržai d. mun.;2008;43;431;219;212
Biržai d. mun.;2008;44;437;212;225
Biržai d. mun.;2008;45;435;207;228
Biržai d. mun.;2008;46;443;218;225
Biržai d. mun.;2008;47;474;237;237
Biržai d. mun.;2008;48;435;227;208
Biržai d. mun.;2008;49;452;223;229
Biržai d. mun.;2008;50;394;190;204
Biržai d. mun.;2008;51;342;159;183
Biržai d. mun.;2008;52;392;183;209
Biržai d. mun.;2008;53;362;164;198
Biržai d. mun.;2008;54;309;146;163
Biržai d. mun.;2008;55;332;169;163
Biržai d. mun.;2008;56;365;161;204
Biržai d. mun.;2008;57;360;167;193
Biržai d. mun.;2008;58;378;170;208
Biržai d. mun.;2008;59;323;134;189
Biržai d. mun.;2008;60;364;162;202
Biržai d. mun.;2008;61;286;139;147
Biržai d. mun.;2008;62;323;135;188
Biržai d. mun.;2008;63;309;143;166
Biržai d. mun.;2008;64;376;161;215
Biržai d. mun.;2008;65;393;167;226
Biržai d. mun.;2008;66;407;171;236
Biržai d. mun.;2008;67;350;138;212
Biržai d. mun.;2008;68;378;163;215
Biržai d. mun.;2008;69;354;128;226
Biržai d. mun.;2008;70;392;137;255
Biržai d. mun.;2008;71;369;133;236
Biržai d. mun.;2008;72;322;118;204
Biržai d. mun.;2008;73;354;121;233
Biržai d. mun.;2008;74;350;132;218
Biržai d. mun.;2008;75;347;122;225
Biržai d. mun.;2008;76;291;107;184
Biržai d. mun.;2008;77;285;89;196
Biržai d. mun.;2008;78;264;75;189
Biržai d. mun.;2008;79;276;82;194
Biržai d. mun.;2008;80;231;66;165
Biržai d. mun.;2008;81;236;60;176
Biržai d. mun.;2008;82;211;45;166
Biržai d. mun.;2008;83;149;35;114
Biržai d. mun.;2008;84;169;49;120
Biržai d. mun.;2008;85;575;134;441
Biržai d. mun.;2009;-1;30178;13996;16182
Biržai d. mun.;2009;0;238;125;113
Biržai d. mun.;2009;1;225;114;111
Biržai d. mun.;2009;2;226;119;107
Biržai d. mun.;2009;3;255;130;125
Biržai d. mun.;2009;4;254;141;113
Biržai d. mun.;2009;5;271;154;117
Biržai d. mun.;2009;6;287;150;137
Biržai d. mun.;2009;7;295;165;130
Biržai d. mun.;2009;8;312;169;143
Biržai d. mun.;2009;9;344;154;190
Biržai d. mun.;2009;10;364;178;186
Biržai d. mun.;2009;11;346;190;156
Biržai d. mun.;2009;12;398;210;188
Biržai d. mun.;2009;13;411;206;205
Biržai d. mun.;2009;14;419;211;208
Biržai d. mun.;2009;15;485;262;223
Biržai d. mun.;2009;16;535;277;258
Biržai d. mun.;2009;17;494;245;249
Biržai d. mun.;2009;18;467;246;221
Biržai d. mun.;2009;19;478;248;230
Biržai d. mun.;2009;20;448;217;231
Biržai d. mun.;2009;21;466;228;238
Biržai d. mun.;2009;22;465;243;222
Biržai d. mun.;2009;23;373;182;191
Biržai d. mun.;2009;24;400;205;195
Biržai d. mun.;2009;25;396;211;185
Biržai d. mun.;2009;26;252;147;105
Biržai d. mun.;2009;27;221;111;110
Biržai d. mun.;2009;28;216;134;82
Biržai d. mun.;2009;29;208;108;100
Biržai d. mun.;2009;30;265;148;117
Biržai d. mun.;2009;31;295;150;145
Biržai d. mun.;2009;32;293;158;135
Biržai d. mun.;2009;33;340;171;169
Biržai d. mun.;2009;34;316;158;158
Biržai d. mun.;2009;35;396;185;211
Biržai d. mun.;2009;36;408;212;196
Biržai d. mun.;2009;37;417;204;213
Biržai d. mun.;2009;38;406;201;205
Biržai d. mun.;2009;39;435;223;212
Biržai d. mun.;2009;40;410;205;205
Biržai d. mun.;2009;41;449;220;229
Biržai d. mun.;2009;42;399;188;211
Biržai d. mun.;2009;43;395;199;196
Biržai d. mun.;2009;44;422;214;208
Biržai d. mun.;2009;45;428;205;223
Biržai d. mun.;2009;46;428;202;226
Biržai d. mun.;2009;47;430;210;220
Biržai d. mun.;2009;48;466;233;233
Biržai d. mun.;2009;49;423;219;204
Biržai d. mun.;2009;50;443;217;226
Biržai d. mun.;2009;51;386;185;201
Biržai d. mun.;2009;52;336;155;181
Biržai d. mun.;2009;53;382;177;205
Biržai d. mun.;2009;54;349;156;193
Biržai d. mun.;2009;55;303;141;162
Biržai d. mun.;2009;56;326;164;162
Biržai d. mun.;2009;57;356;155;201
Biržai d. mun.;2009;58;347;159;188
Biržai d. mun.;2009;59;370;164;206
Biržai d. mun.;2009;60;313;128;185
Biržai d. mun.;2009;61;358;159;199
Biržai d. mun.;2009;62;280;137;143
Biržai d. mun.;2009;63;316;130;186
Biržai d. mun.;2009;64;299;134;165
Biržai d. mun.;2009;65;367;154;213
Biržai d. mun.;2009;66;379;159;220
Biržai d. mun.;2009;67;380;154;226
Biržai d. mun.;2009;68;336;131;205
Biržai d. mun.;2009;69;366;157;209
Biržai d. mun.;2009;70;347;125;222
Biržai d. mun.;2009;71;375;125;250
Biržai d. mun.;2009;72;356;126;230
Biržai d. mun.;2009;73;314;115;199
Biržai d. mun.;2009;74;342;118;224
Biržai d. mun.;2009;75;340;124;216
Biržai d. mun.;2009;76;328;109;219
Biržai d. mun.;2009;77;278;101;177
Biržai d. mun.;2009;78;268;84;184
Biržai d. mun.;2009;79;246;64;182
Biržai d. mun.;2009;80;260;75;185
Biržai d. mun.;2009;81;209;56;153
Biržai d. mun.;2009;82;219;56;163
Biržai d. mun.;2009;83;183;34;149
Biržai d. mun.;2009;84;141;33;108
Biržai d. mun.;2009;85;610;150;460
Biržai d. mun.;2010;-1;29439;13617;15822
Biržai d. mun.;2010;0;253;140;113
Biržai d. mun.;2010;1;235;124;111
Biržai d. mun.;2010;2;221;109;112
Biržai d. mun.;2010;3;224;116;108
Biržai d. mun.;2010;4;252;126;126
Biržai d. mun.;2010;5;250;137;113
Biržai d. mun.;2010;6;268;150;118
Biržai d. mun.;2010;7;286;146;140
Biržai d. mun.;2010;8;291;162;129
Biržai d. mun.;2010;9;310;169;141
Biržai d. mun.;2010;10;342;153;189
Biržai d. mun.;2010;11;360;178;182
Biržai d. mun.;2010;12;344;188;156
Biržai d. mun.;2010;13;390;206;184
Biržai d. mun.;2010;14;411;208;203
Biržai d. mun.;2010;15;413;205;208
Biržai d. mun.;2010;16;482;261;221
Biržai d. mun.;2010;17;531;273;258
Biržai d. mun.;2010;18;485;242;243
Biržai d. mun.;2010;19;458;242;216
Biržai d. mun.;2010;20;470;244;226
Biržai d. mun.;2010;21;439;211;228
Biržai d. mun.;2010;22;451;218;233
Biržai d. mun.;2010;23;448;234;214
Biržai d. mun.;2010;24;351;175;176
Biržai d. mun.;2010;25;381;192;189
Biržai d. mun.;2010;26;368;196;172
Biržai d. mun.;2010;27;241;141;100
Biržai d. mun.;2010;28;208;107;101
Biržai d. mun.;2010;29;209;129;80
Biržai d. mun.;2010;30;201;103;98
Biržai d. mun.;2010;31;255;143;112
Biržai d. mun.;2010;32;284;142;142
Biržai d. mun.;2010;33;275;149;126
Biržai d. mun.;2010;34;329;166;163
Biržai d. mun.;2010;35;308;155;153
Biržai d. mun.;2010;36;383;180;203
Biržai d. mun.;2010;37;396;204;192
Biržai d. mun.;2010;38;407;198;209
Biržai d. mun.;2010;39;396;194;202
Biržai d. mun.;2010;40;431;218;213
Biržai d. mun.;2010;41;406;201;205
Biržai d. mun.;2010;42;440;213;227
Biržai d. mun.;2010;43;393;186;207
Biržai d. mun.;2010;44;388;194;194
Biržai d. mun.;2010;45;411;210;201
Biržai d. mun.;2010;46;422;200;222
Biržai d. mun.;2010;47;422;201;221
Biržai d. mun.;2010;48;423;206;217
Biržai d. mun.;2010;49;458;229;229
Biržai d. mun.;2010;50;419;216;203
Biržai d. mun.;2010;51;435;212;223
Biržai d. mun.;2010;52;378;180;198
Biržai d. mun.;2010;53;330;150;180
Biržai d. mun.;2010;54;375;173;202
Biržai d. mun.;2010;55;337;149;188
Biržai d. mun.;2010;56;294;139;155
Biržai d. mun.;2010;57;320;163;157
Biržai d. mun.;2010;58;349;151;198
Biržai d. mun.;2010;59;344;156;188
Biržai d. mun.;2010;60;359;157;202
Biržai d. mun.;2010;61;304;123;181
Biržai d. mun.;2010;62;346;150;196
Biržai d. mun.;2010;63;273;133;140
Biržai d. mun.;2010;64;303;122;181
Biržai d. mun.;2010;65;280;121;159
Biržai d. mun.;2010;66;349;145;204
Biržai d. mun.;2010;67;369;154;215
Biržai d. mun.;2010;68;361;139;222
Biržai d. mun.;2010;69;320;121;199
Biržai d. mun.;2010;70;353;145;208
Biržai d. mun.;2010;71;336;119;217
Biržai d. mun.;2010;72;364;117;247
Biržai d. mun.;2010;73;342;121;221
Biržai d. mun.;2010;74;288;97;191
Biržai d. mun.;2010;75;321;104;217
Biržai d. mun.;2010;76;319;114;205
Biržai d. mun.;2010;77;317;104;213
Biržai d. mun.;2010;78;256;88;168
Biržai d. mun.;2010;79;252;75;177
Biržai d. mun.;2010;80;230;59;171
Biržai d. mun.;2010;81;238;70;168
Biržai d. mun.;2010;82;187;47;140
Biržai d. mun.;2010;83;198;51;147
Biržai d. mun.;2010;84;165;31;134
Biržai d. mun.;2010;85;628;147;481
Biržai d. mun.;2011;-1;28322;13109;15213
Biržai d. mun.;2011;0;176;98;78
Biržai d. mun.;2011;1;217;111;106
Biržai d. mun.;2011;2;202;111;91
Biržai d. mun.;2011;3;192;98;94
Biržai d. mun.;2011;4;213;110;103
Biržai d. mun.;2011;5;227;113;114
Biržai d. mun.;2011;6;255;143;112
Biržai d. mun.;2011;7;252;138;114
Biržai d. mun.;2011;8;271;147;124
Biržai d. mun.;2011;9;286;158;128
Biržai d. mun.;2011;10;300;165;135
Biržai d. mun.;2011;11;340;156;184
Biržai d. mun.;2011;12;341;173;168
Biržai d. mun.;2011;13;332;182;150
Biržai d. mun.;2011;14;397;209;188
Biržai d. mun.;2011;15;402;203;199
Biržai d. mun.;2011;16;406;199;207
Biržai d. mun.;2011;17;470;258;212
Biržai d. mun.;2011;18;519;271;248
Biržai d. mun.;2011;19;393;210;183
Biržai d. mun.;2011;20;352;192;160
Biržai d. mun.;2011;21;366;201;165
Biržai d. mun.;2011;22;319;164;155
Biržai d. mun.;2011;23;331;167;164
Biržai d. mun.;2011;24;337;176;161
Biržai d. mun.;2011;25;212;117;95
Biržai d. mun.;2011;26;251;129;122
Biržai d. mun.;2011;27;242;127;115
Biržai d. mun.;2011;28;191;107;84
Biržai d. mun.;2011;29;235;111;124
Biržai d. mun.;2011;30;210;119;91
Biržai d. mun.;2011;31;208;101;107
Biržai d. mun.;2011;32;271;139;132
Biržai d. mun.;2011;33;289;148;141
Biržai d. mun.;2011;34;289;143;146
Biržai d. mun.;2011;35;332;166;166
Biržai d. mun.;2011;36;323;154;169
Biržai d. mun.;2011;37;381;170;211
Biržai d. mun.;2011;38;416;214;202
Biržai d. mun.;2011;39;425;201;224
Biržai d. mun.;2011;40;407;204;203
Biržai d. mun.;2011;41;441;224;217
Biržai d. mun.;2011;42;424;215;209
Biržai d. mun.;2011;43;441;217;224
Biržai d. mun.;2011;44;395;194;201
Biržai d. mun.;2011;45;383;194;189
Biržai d. mun.;2011;46;421;220;201
Biržai d. mun.;2011;47;435;207;228
Biržai d. mun.;2011;48;429;211;218
Biržai d. mun.;2011;49;432;210;222
Biržai d. mun.;2011;50;467;240;227
Biržai d. mun.;2011;51;431;215;216
Biržai d. mun.;2011;52;443;216;227
Biržai d. mun.;2011;53;380;181;199
Biržai d. mun.;2011;54;351;160;191
Biržai d. mun.;2011;55;392;181;211
Biržai d. mun.;2011;56;344;147;197
Biržai d. mun.;2011;57;301;148;153
Biržai d. mun.;2011;58;329;165;164
Biržai d. mun.;2011;59;359;152;207
Biržai d. mun.;2011;60;369;168;201
Biržai d. mun.;2011;61;355;152;203
Biržai d. mun.;2011;62;309;123;186
Biržai d. mun.;2011;63;351;153;198
Biržai d. mun.;2011;64;278;131;147
Biržai d. mun.;2011;65;307;127;180
Biržai d. mun.;2011;66;285;126;159
Biržai d. mun.;2011;67;357;142;215
Biržai d. mun.;2011;68;365;151;214
Biržai d. mun.;2011;69;355;133;222
Biržai d. mun.;2011;70;314;116;198
Biržai d. mun.;2011;71;357;146;211
Biržai d. mun.;2011;72;325;115;210
Biržai d. mun.;2011;73;356;112;244
Biržai d. mun.;2011;74;334;120;214
Biržai d. mun.;2011;75;284;97;187
Biržai d. mun.;2011;76;312;104;208
Biržai d. mun.;2011;77;316;114;202
Biržai d. mun.;2011;78;300;94;206
Biržai d. mun.;2011;79;241;77;164
Biržai d. mun.;2011;80;235;68;167
Biržai d. mun.;2011;81;210;54;156
Biržai d. mun.;2011;82;222;64;158
Biržai d. mun.;2011;83;182;46;136
Biržai d. mun.;2011;84;178;39;139
Biržai d. mun.;2011;85;649;137;512
Biržai d. mun.;2012;-1;27632;12769;14863
Biržai d. mun.;2012;0;212;112;100
Biržai d. mun.;2012;1;172;94;78
Biržai d. mun.;2012;2;214;108;106
Biržai d. mun.;2012;3;205;112;93
Biržai d. mun.;2012;4;184;95;89
Biržai d. mun.;2012;5;208;107;101
Biržai d. mun.;2012;6;223;110;113
Biržai d. mun.;2012;7;255;141;114
Biržai d. mun.;2012;8;253;138;115
Biržai d. mun.;2012;9;266;145;121
Biržai d. mun.;2012;10;284;158;126
Biržai d. mun.;2012;11;296;163;133
Biržai d. mun.;2012;12;331;153;178
Biržai d. mun.;2012;13;338;173;165
Biržai d. mun.;2012;14;327;179;148
Biržai d. mun.;2012;15;392;209;183
Biržai d. mun.;2012;16;395;200;195
Biržai d. mun.;2012;17;405;199;206
Biržai d. mun.;2012;18;464;252;212
Biržai d. mun.;2012;19;502;265;237
Biržai d. mun.;2012;20;369;201;168
Biržai d. mun.;2012;21;338;185;153
Biržai d. mun.;2012;22;342;189;153
Biržai d. mun.;2012;23;298;155;143
Biržai d. mun.;2012;24;308;156;152
Biržai d. mun.;2012;25;315;164;151
Biržai d. mun.;2012;26;184;105;79
Biržai d. mun.;2012;27;228;118;110
Biržai d. mun.;2012;28;228;124;104
Biržai d. mun.;2012;29;173;95;78
Biržai d. mun.;2012;30;213;96;117
Biržai d. mun.;2012;31;194;110;84
Biržai d. mun.;2012;32;198;92;106
Biržai d. mun.;2012;33;252;129;123
Biržai d. mun.;2012;34;273;142;131
Biržai d. mun.;2012;35;276;134;142
Biržai d. mun.;2012;36;326;166;160
Biržai d. mun.;2012;37;317;154;163
Biržai d. mun.;2012;38;367;163;204
Biržai d. mun.;2012;39;413;211;202
Biržai d. mun.;2012;40;421;196;225
Biržai d. mun.;2012;41;402;202;200
Biržai d. mun.;2012;42;434;219;215
Biržai d. mun.;2012;43;417;212;205
Biržai d. mun.;2012;44;438;217;221
Biržai d. mun.;2012;45;387;189;198
Biržai d. mun.;2012;46;382;195;187
Biržai d. mun.;2012;47;411;212;199
Biržai d. mun.;2012;48;437;209;228
Biržai d. mun.;2012;49;419;201;218
Biržai d. mun.;2012;50;426;205;221
Biržai d. mun.;2012;51;461;236;225
Biržai d. mun.;2012;52;426;211;215
Biržai d. mun.;2012;53;442;214;228
Biržai d. mun.;2012;54;369;172;197
Biržai d. mun.;2012;55;341;152;189
Biržai d. mun.;2012;56;388;181;207
Biržai d. mun.;2012;57;340;143;197
Biržai d. mun.;2012;58;299;147;152
Biržai d. mun.;2012;59;325;162;163
Biržai d. mun.;2012;60;352;148;204
Biržai d. mun.;2012;61;363;166;197
Biržai d. mun.;2012;62;351;149;202
Biržai d. mun.;2012;63;306;121;185
Biržai d. mun.;2012;64;340;143;197
Biržai d. mun.;2012;65;273;126;147
Biržai d. mun.;2012;66;306;126;180
Biržai d. mun.;2012;67;275;122;153
Biržai d. mun.;2012;68;349;138;211
Biržai d. mun.;2012;69;354;146;208
Biržai d. mun.;2012;70;350;128;222
Biržai d. mun.;2012;71;308;113;195
Biržai d. mun.;2012;72;352;140;212
Biržai d. mun.;2012;73;311;108;203
Biržai d. mun.;2012;74;342;105;237
Biržai d. mun.;2012;75;324;112;212
Biržai d. mun.;2012;76;274;92;182
Biržai d. mun.;2012;77;294;94;200
Biržai d. mun.;2012;78;301;104;197
Biržai d. mun.;2012;79;283;87;196
Biržai d. mun.;2012;80;226;67;159
Biržai d. mun.;2012;81;216;61;155
Biržai d. mun.;2012;82;194;50;144
Biržai d. mun.;2012;83;208;59;149
Biržai d. mun.;2012;84;169;39;130
Biržai d. mun.;2012;85;708;148;560
Biržai d. mun.;2013;-1;27026;12501;14525
Biržai d. mun.;2013;0;224;113;111
Biržai d. mun.;2013;1;209;108;101
Biržai d. mun.;2013;2;164;91;73
Biržai d. mun.;2013;3;210;104;106
Biržai d. mun.;2013;4;203;111;92
Biržai d. mun.;2013;5;181;94;87
Biržai d. mun.;2013;6;206;107;99
Biržai d. mun.;2013;7;217;108;109
Biržai d. mun.;2013;8;254;141;113
Biržai d. mun.;2013;9;251;138;113
Biržai d. mun.;2013;10;263;145;118
Biržai d. mun.;2013;11;285;159;126
Biržai d. mun.;2013;12;292;160;132
Biržai d. mun.;2013;13;329;152;177
Biržai d. mun.;2013;14;337;175;162
Biržai d. mun.;2013;15;324;178;146
Biržai d. mun.;2013;16;391;207;184
Biržai d. mun.;2013;17;392;199;193
Biržai d. mun.;2013;18;401;195;206
Biržai d. mun.;2013;19;452;247;205
Biržai d. mun.;2013;20;496;264;232
Biržai d. mun.;2013;21;363;198;165
Biržai d. mun.;2013;22;325;180;145
Biržai d. mun.;2013;23;322;177;145
Biržai d. mun.;2013;24;284;150;134
Biržai d. mun.;2013;25;290;152;138
Biržai d. mun.;2013;26;283;151;132
Biržai d. mun.;2013;27;161;94;67
Biržai d. mun.;2013;28;209;112;97
Biržai d. mun.;2013;29;216;116;100
Biržai d. mun.;2013;30;165;90;75
Biržai d. mun.;2013;31;202;90;112
Biržai d. mun.;2013;32;193;110;83
Biržai d. mun.;2013;33;189;86;103
Biržai d. mun.;2013;34;241;123;118
Biržai d. mun.;2013;35;259;132;127
Biržai d. mun.;2013;36;275;134;141
Biržai d. mun.;2013;37;314;162;152
Biržai d. mun.;2013;38;307;145;162
Biržai d. mun.;2013;39;364;161;203
Biržai d. mun.;2013;40;403;209;194
Biržai d. mun.;2013;41;410;191;219
Biržai d. mun.;2013;42;396;199;197
Biržai d. mun.;2013;43;427;212;215
Biržai d. mun.;2013;44;414;207;207
Biržai d. mun.;2013;45;433;218;215
Biržai d. mun.;2013;46;382;185;197
Biržai d. mun.;2013;47;377;191;186
Biržai d. mun.;2013;48;408;211;197
Biržai d. mun.;2013;49;432;208;224
Biržai d. mun.;2013;50;412;197;215
Biržai d. mun.;2013;51;421;202;219
Biržai d. mun.;2013;52;459;235;224
Biržai d. mun.;2013;53;419;207;212
Biržai d. mun.;2013;54;437;210;227
Biržai d. mun.;2013;55;362;169;193
Biržai d. mun.;2013;56;341;152;189
Biržai d. mun.;2013;57;382;176;206
Biržai d. mun.;2013;58;335;138;197
Biržai d. mun.;2013;59;296;145;151
Biržai d. mun.;2013;60;320;156;164
Biržai d. mun.;2013;61;345;142;203
Biržai d. mun.;2013;62;359;163;196
Biržai d. mun.;2013;63;342;143;199
Biržai d. mun.;2013;64;303;120;183
Biržai d. mun.;2013;65;326;138;188
Biržai d. mun.;2013;66;266;122;144
Biržai d. mun.;2013;67;296;117;179
Biržai d. mun.;2013;68;265;118;147
Biržai d. mun.;2013;69;335;131;204
Biržai d. mun.;2013;70;345;141;204
Biržai d. mun.;2013;71;341;122;219
Biržai d. mun.;2013;72;296;109;187
Biržai d. mun.;2013;73;340;129;211
Biržai d. mun.;2013;74;299;99;200
Biržai d. mun.;2013;75;334;103;231
Biržai d. mun.;2013;76;315;109;206
Biržai d. mun.;2013;77;262;88;174
Biržai d. mun.;2013;78;284;89;195
Biržai d. mun.;2013;79;290;94;196
Biržai d. mun.;2013;80;255;78;177
Biržai d. mun.;2013;81;212;62;150
Biržai d. mun.;2013;82;204;55;149
Biržai d. mun.;2013;83;173;42;131
Biržai d. mun.;2013;84;187;49;138
Biržai d. mun.;2013;85;743;161;582
Biržai d. mun.;2014;-1;26473;12248;14225
Biržai d. mun.;2014;0;224;119;105
Biržai d. mun.;2014;1;221;110;111
Biržai d. mun.;2014;2;198;100;98
Biržai d. mun.;2014;3;161;89;72
Biržai d. mun.;2014;4;209;102;107
Biržai d. mun.;2014;5;198;106;92
Biržai d. mun.;2014;6;180;94;86
Biržai d. mun.;2014;7;203;105;98
Biržai d. mun.;2014;8;213;106;107
Biržai d. mun.;2014;9;254;141;113
Biržai d. mun.;2014;10;252;141;111
Biržai d. mun.;2014;11;260;144;116
Biržai d. mun.;2014;12;283;158;125
Biržai d. mun.;2014;13;289;158;131
Biržai d. mun.;2014;14;329;151;178
Biržai d. mun.;2014;15;339;174;165
Biržai d. mun.;2014;16;325;181;144
Biržai d. mun.;2014;17;391;207;184
Biržai d. mun.;2014;18;392;199;193
Biržai d. mun.;2014;19;397;193;204
Biržai d. mun.;2014;20;442;243;199
Biržai d. mun.;2014;21;485;252;233
Biržai d. mun.;2014;22;360;197;163
Biržai d. mun.;2014;23;320;177;143
Biržai d. mun.;2014;24;310;169;141
Biržai d. mun.;2014;25;263;137;126
Biržai d. mun.;2014;26;279;147;132
Biržai d. mun.;2014;27;263;140;123
Biržai d. mun.;2014;28;144;88;56
Biržai d. mun.;2014;29;195;103;92
Biržai d. mun.;2014;30;200;107;93
Biržai d. mun.;2014;31;151;85;66
Biržai d. mun.;2014;32;191;84;107
Biržai d. mun.;2014;33;191;109;82
Biržai d. mun.;2014;34;181;85;96
Biržai d. mun.;2014;35;227;117;110
Biržai d. mun.;2014;36;251;126;125
Biržai d. mun.;2014;37;274;134;140
Biržai d. mun.;2014;38;308;160;148
Biržai d. mun.;2014;39;303;143;160
Biržai d. mun.;2014;40;360;159;201
Biržai d. mun.;2014;41;399;205;194
Biržai d. mun.;2014;42;413;191;222
Biržai d. mun.;2014;43;391;199;192
Biržai d. mun.;2014;44;426;212;214
Biržai d. mun.;2014;45;417;210;207
Biržai d. mun.;2014;46;421;206;215
Biržai d. mun.;2014;47;382;186;196
Biržai d. mun.;2014;48;373;188;185
Biržai d. mun.;2014;49;406;210;196
Biržai d. mun.;2014;50;429;207;222
Biržai d. mun.;2014;51;411;196;215
Biržai d. mun.;2014;52;413;197;216
Biržai d. mun.;2014;53;453;229;224
Biržai d. mun.;2014;54;415;204;211
Biržai d. mun.;2014;55;431;204;227
Biržai d. mun.;2014;56;359;166;193
Biržai d. mun.;2014;57;334;147;187
Biržai d. mun.;2014;58;382;175;207
Biržai d. mun.;2014;59;328;136;192
Biržai d. mun.;2014;60;290;140;150
Biržai d. mun.;2014;61;316;152;164
Biržai d. mun.;2014;62;343;140;203
Biržai d. mun.;2014;63;349;158;191
Biržai d. mun.;2014;64;338;138;200
Biržai d. mun.;2014;65;300;117;183
Biržai d. mun.;2014;66;318;135;183
Biržai d. mun.;2014;67;257;115;142
Biržai d. mun.;2014;68;282;109;173
Biržai d. mun.;2014;69;250;107;143
Biržai d. mun.;2014;70;320;122;198
Biržai d. mun.;2014;71;337;136;201
Biržai d. mun.;2014;72;330;115;215
Biržai d. mun.;2014;73;280;101;179
Biržai d. mun.;2014;74;320;119;201
Biržai d. mun.;2014;75;291;93;198
Biržai d. mun.;2014;76;320;97;223
Biržai d. mun.;2014;77;300;100;200
Biržai d. mun.;2014;78;247;82;165
Biržai d. mun.;2014;79;264;83;181
Biržai d. mun.;2014;80;274;88;186
Biržai d. mun.;2014;81;232;69;163
Biržai d. mun.;2014;82;190;53;137
Biržai d. mun.;2014;83;190;50;140
Biržai d. mun.;2014;84;157;39;118
Biržai d. mun.;2014;85;779;182;597
Biržai d. mun.;2015;-1;25937;11998;13939
Biržai d. mun.;2015;0;216;114;102
Biržai d. mun.;2015;1;226;118;108
Biržai d. mun.;2015;2;219;110;109
Biržai d. mun.;2015;3;191;97;94
Biržai d. mun.;2015;4;160;88;72
Biržai d. mun.;2015;5;204;100;104
Biržai d. mun.;2015;6;194;104;90
Biržai d. mun.;2015;7;178;95;83
Biržai d. mun.;2015;8;202;104;98
Biržai d. mun.;2015;9;214;108;106
Biržai d. mun.;2015;10;254;140;114
Biržai d. mun.;2015;11;249;139;110
Biržai d. mun.;2015;12;257;141;116
Biržai d. mun.;2015;13;280;155;125
Biržai d. mun.;2015;14;288;155;133
Biržai d. mun.;2015;15;326;150;176
Biržai d. mun.;2015;16;339;174;165
Biržai d. mun.;2015;17;321;178;143
Biržai d. mun.;2015;18;386;203;183
Biržai d. mun.;2015;19;390;198;192
Biržai d. mun.;2015;20;386;190;196
Biržai d. mun.;2015;21;431;237;194
Biržai d. mun.;2015;22;471;248;223
Biržai d. mun.;2015;23;355;190;165
Biržai d. mun.;2015;24;315;174;141
Biržai d. mun.;2015;25;297;170;127
Biržai d. mun.;2015;26;249;130;119
Biržai d. mun.;2015;27;263;145;118
Biržai d. mun.;2015;28;247;134;113
Biržai d. mun.;2015;29;134;82;52
Biržai d. mun.;2015;30;177;93;84
Biržai d. mun.;2015;31;187;100;87
Biržai d. mun.;2015;32;150;84;66
Biržai d. mun.;2015;33;187;79;108
Biržai d. mun.;2015;34;182;104;78
Biržai d. mun.;2015;35;171;79;92
Biržai d. mun.;2015;36;224;114;110
Biržai d. mun.;2015;37;251;123;128
Biržai d. mun.;2015;38;262;125;137
Biržai d. mun.;2015;39;302;155;147
Biržai d. mun.;2015;40;301;144;157
Biržai d. mun.;2015;41;359;158;201
Biržai d. mun.;2015;42;395;203;192
Biržai d. mun.;2015;43;406;186;220
Biržai d. mun.;2015;44;387;198;189
Biržai d. mun.;2015;45;422;210;212
Biržai d. mun.;2015;46;412;209;203
Biržai d. mun.;2015;47;419;205;214
Biržai d. mun.;2015;48;380;181;199
Biržai d. mun.;2015;49;372;186;186
Biržai d. mun.;2015;50;405;209;196
Biržai d. mun.;2015;51;430;207;223
Biržai d. mun.;2015;52;405;195;210
Biržai d. mun.;2015;53;407;194;213
Biržai d. mun.;2015;54;449;226;223
Biržai d. mun.;2015;55;405;197;208
Biržai d. mun.;2015;56;426;201;225
Biržai d. mun.;2015;57;352;162;190
Biržai d. mun.;2015;58;327;143;184
Biržai d. mun.;2015;59;378;172;206
Biržai d. mun.;2015;60;328;135;193
Biržai d. mun.;2015;61;285;137;148
Biržai d. mun.;2015;62;313;149;164
Biržai d. mun.;2015;63;335;131;204
Biržai d. mun.;2015;64;339;151;188
Biržai d. mun.;2015;65;334;135;199
Biržai d. mun.;2015;66;293;112;181
Biržai d. mun.;2015;67;317;134;183
Biržai d. mun.;2015;68;246;105;141
Biržai d. mun.;2015;69;274;104;170
Biržai d. mun.;2015;70;242;99;143
Biržai d. mun.;2015;71;310;117;193
Biržai d. mun.;2015;72;320;123;197
Biržai d. mun.;2015;73;316;107;209
Biržai d. mun.;2015;74;260;93;167
Biržai d. mun.;2015;75;307;112;195
Biržai d. mun.;2015;76;274;88;186
Biržai d. mun.;2015;77;307;92;215
Biržai d. mun.;2015;78;290;95;195
Biržai d. mun.;2015;79;232;76;156
Biržai d. mun.;2015;80;250;78;172
Biržai d. mun.;2015;81;260;83;177
Biržai d. mun.;2015;82;218;62;156
Biržai d. mun.;2015;83;171;45;126
Biržai d. mun.;2015;84;177;45;132
Biržai d. mun.;2015;85;767;177;590
Biržai d. mun.;2016;-1;25418;11751;13667
Biržai d. mun.;2016;0;229;118;111
Biržai d. mun.;2016;1;216;114;102
Biržai d. mun.;2016;2;220;115;105
Biržai d. mun.;2016;3;219;110;109
Biržai d. mun.;2016;4;187;97;90
Biržai d. mun.;2016;5;155;82;73
Biržai d. mun.;2016;6;196;95;101
Biržai d. mun.;2016;7;193;104;89
Biržai d. mun.;2016;8;183;98;85
Biržai d. mun.;2016;9;202;103;99
Biržai d. mun.;2016;10;212;106;106
Biržai d. mun.;2016;11;256;143;113
Biržai d. mun.;2016;12;248;139;109
Biržai d. mun.;2016;13;252;139;113
Biržai d. mun.;2016;14;277;153;124
Biržai d. mun.;2016;15;286;154;132
Biržai d. mun.;2016;16;323;149;174
Biržai d. mun.;2016;17;335;173;162
Biržai d. mun.;2016;18;314;172;142
Biržai d. mun.;2016;19;382;202;180
Biržai d. mun.;2016;20;381;192;189
Biržai d. mun.;2016;21;382;188;194
Biržai d. mun.;2016;22;427;237;190
Biržai d. mun.;2016;23;455;242;213
Biržai d. mun.;2016;24;331;175;156
Biržai d. mun.;2016;25;298;160;138
Biržai d. mun.;2016;26;265;153;112
Biržai d. mun.;2016;27;230;125;105
Biržai d. mun.;2016;28;246;137;109
Biržai d. mun.;2016;29;233;129;104
Biržai d. mun.;2016;30;129;76;53
Biržai d. mun.;2016;31;169;88;81
Biržai d. mun.;2016;32;182;98;84
Biržai d. mun.;2016;33;146;83;63
Biržai d. mun.;2016;34;180;76;104
Biržai d. mun.;2016;35;178;101;77
Biržai d. mun.;2016;36;164;77;87
Biržai d. mun.;2016;37;222;109;113
Biržai d. mun.;2016;38;246;123;123
Biržai d. mun.;2016;39;255;122;133
Biržai d. mun.;2016;40;298;156;142
Biržai d. mun.;2016;41;290;137;153
Biržai d. mun.;2016;42;354;157;197
Biržai d. mun.;2016;43;393;201;192
Biržai d. mun.;2016;44;404;187;217
Biržai d. mun.;2016;45;384;194;190
Biržai d. mun.;2016;46;423;210;213
Biržai d. mun.;2016;47;415;209;206
Biržai d. mun.;2016;48;412;199;213
Biržai d. mun.;2016;49;379;177;202
Biržai d. mun.;2016;50;373;185;188
Biržai d. mun.;2016;51;401;205;196
Biržai d. mun.;2016;52;420;199;221
Biržai d. mun.;2016;53;402;194;208
Biržai d. mun.;2016;54;405;192;213
Biržai d. mun.;2016;55;440;220;220
Biržai d. mun.;2016;56;395;192;203
Biržai d. mun.;2016;57;420;200;220
Biržai d. mun.;2016;58;350;160;190
Biržai d. mun.;2016;59;322;137;185
Biržai d. mun.;2016;60;372;170;202
Biržai d. mun.;2016;61;329;135;194
Biržai d. mun.;2016;62;274;128;146
Biržai d. mun.;2016;63;307;147;160
Biržai d. mun.;2016;64;329;128;201
Biržai d. mun.;2016;65;336;148;188
Biržai d. mun.;2016;66;329;132;197
Biržai d. mun.;2016;67;290;109;181
Biržai d. mun.;2016;68;310;131;179
Biržai d. mun.;2016;69;237;101;136
Biržai d. mun.;2016;70;269;101;168
Biržai d. mun.;2016;71;232;91;141
Biržai d. mun.;2016;72;301;112;189
Biržai d. mun.;2016;73;308;116;192
Biržai d. mun.;2016;74;307;102;205
Biržai d. mun.;2016;75;252;89;163
Biržai d. mun.;2016;76;288;101;187
Biržai d. mun.;2016;77;266;83;183
Biržai d. mun.;2016;78;295;86;209
Biržai d. mun.;2016;79;279;90;189
Biržai d. mun.;2016;80;207;63;144
Biržai d. mun.;2016;81;232;73;159
Biržai d. mun.;2016;82;236;71;165
Biržai d. mun.;2016;83;201;57;144
Biržai d. mun.;2016;84;160;42;118
Biržai d. mun.;2016;85;788;177;611
Biržai d. mun.;2017;-1;24645;11411;13234
Biržai d. mun.;2017;0;194;103;91
Biržai d. mun.;2017;1;228;116;112
Biržai d. mun.;2017;2;215;115;100
Biržai d. mun.;2017;3;213;111;102
Biržai d. mun.;2017;4;216;109;107
Biržai d. mun.;2017;5;186;94;92
Biržai d. mun.;2017;6;148;78;70
Biržai d. mun.;2017;7;197;94;103
Biržai d. mun.;2017;8;186;97;89
Biržai d. mun.;2017;9;183;98;85
Biržai d. mun.;2017;10;198;101;97
Biržai d. mun.;2017;11;208;103;105
Biržai d. mun.;2017;12;252;140;112
Biržai d. mun.;2017;13;245;136;109
Biržai d. mun.;2017;14;245;134;111
Biržai d. mun.;2017;15;276;154;122
Biržai d. mun.;2017;16;282;150;132
Biržai d. mun.;2017;17;320;148;172
Biržai d. mun.;2017;18;329;171;158
Biržai d. mun.;2017;19;305;168;137
Biržai d. mun.;2017;20;371;196;175
Biržai d. mun.;2017;21;370;184;186
Biržai d. mun.;2017;22;370;181;189
Biržai d. mun.;2017;23;402;226;176
Biržai d. mun.;2017;24;425;233;192
Biržai d. mun.;2017;25;307;169;138
Biržai d. mun.;2017;26;270;146;124
Biržai d. mun.;2017;27;240;143;97
Biržai d. mun.;2017;28;205;112;93
Biržai d. mun.;2017;29;236;131;105
Biržai d. mun.;2017;30;205;114;91
Biržai d. mun.;2017;31;116;66;50
Biržai d. mun.;2017;32;159;86;73
Biržai d. mun.;2017;33;162;92;70
Biržai d. mun.;2017;34;135;78;57
Biržai d. mun.;2017;35;173;73;100
Biržai d. mun.;2017;36;169;95;74
Biržai d. mun.;2017;37;153;72;81
Biržai d. mun.;2017;38;205;101;104
Biržai d. mun.;2017;39;239;119;120
Biržai d. mun.;2017;40;255;126;129
Biržai d. mun.;2017;41;286;151;135
Biržai d. mun.;2017;42;283;132;151
Biržai d. mun.;2017;43;351;155;196
Biržai d. mun.;2017;44;382;198;184
Biržai d. mun.;2017;45;391;180;211
Biržai d. mun.;2017;46;381;192;189
Biržai d. mun.;2017;47;415;206;209
Biržai d. mun.;2017;48;409;205;204
Biržai d. mun.;2017;49;410;197;213
Biržai d. mun.;2017;50;368;171;197
Biržai d. mun.;2017;51;371;184;187
Biržai d. mun.;2017;52;393;201;192
Biržai d. mun.;2017;53;415;194;221
Biržai d. mun.;2017;54;394;192;202
Biržai d. mun.;2017;55;396;187;209
Biržai d. mun.;2017;56;434;217;217
Biržai d. mun.;2017;57;386;184;202
Biržai d. mun.;2017;58;417;198;219
Biržai d. mun.;2017;59;349;159;190
Biržai d. mun.;2017;60;317;135;182
Biržai d. mun.;2017;61;367;167;200
Biržai d. mun.;2017;62;322;130;192
Biržai d. mun.;2017;63;269;124;145
Biržai d. mun.;2017;64;305;145;160
Biržai d. mun.;2017;65;315;120;195
Biržai d. mun.;2017;66;328;145;183
Biržai d. mun.;2017;67;310;120;190
Biržai d. mun.;2017;68;285;107;178
Biržai d. mun.;2017;69;302;126;176
Biržai d. mun.;2017;70;227;98;129
Biržai d. mun.;2017;71;258;94;164
Biržai d. mun.;2017;72;225;90;135
Biržai d. mun.;2017;73;290;104;186
Biržai d. mun.;2017;74;293;108;185
Biržai d. mun.;2017;75;291;94;197
Biržai d. mun.;2017;76;244;81;163
Biržai d. mun.;2017;77;275;94;181
Biržai d. mun.;2017;78;257;77;180
Biržai d. mun.;2017;79;284;80;204
Biržai d. mun.;2017;80;257;79;178
Biržai d. mun.;2017;81;199;60;139
Biržai d. mun.;2017;82;219;69;150
Biržai d. mun.;2017;83;217;65;152
Biržai d. mun.;2017;84;182;52;130
Biržai d. mun.;2017;85;783;181;602
Biržai d. mun.;2018;-1;23778;10974;12804
Biržai d. mun.;2018;0;219;124;95
Biržai d. mun.;2018;1;192;99;93
Biržai d. mun.;2018;2;217;109;108
Biržai d. mun.;2018;3;209;109;100
Biržai d. mun.;2018;4;210;112;98
Biržai d. mun.;2018;5;214;107;107
Biržai d. mun.;2018;6;179;93;86
Biržai d. mun.;2018;7;144;76;68
Biržai d. mun.;2018;8;189;88;101
Biržai d. mun.;2018;9;180;95;85
Biržai d. mun.;2018;10;173;92;81
Biržai d. mun.;2018;11;200;101;99
Biržai d. mun.;2018;12;207;102;105
Biržai d. mun.;2018;13;252;139;113
Biržai d. mun.;2018;14;236;129;107
Biržai d. mun.;2018;15;239;130;109
Biržai d. mun.;2018;16;273;151;122
Biržai d. mun.;2018;17;278;147;131
Biržai d. mun.;2018;18;308;140;168
Biržai d. mun.;2018;19;311;168;143
Biržai d. mun.;2018;20;292;160;132
Biržai d. mun.;2018;21;348;181;167
Biržai d. mun.;2018;22;339;173;166
Biržai d. mun.;2018;23;345;172;173
Biržai d. mun.;2018;24;367;203;164
Biržai d. mun.;2018;25;386;215;171
Biržai d. mun.;2018;26;274;156;118
Biržai d. mun.;2018;27;247;136;111
Biržai d. mun.;2018;28;214;130;84
Biržai d. mun.;2018;29;178;103;75
Biržai d. mun.;2018;30;207;120;87
Biržai d. mun.;2018;31;184;104;80
Biržai d. mun.;2018;32;100;57;43
Biržai d. mun.;2018;33;138;72;66
Biržai d. mun.;2018;34;139;81;58
Biržai d. mun.;2018;35;121;71;50
Biržai d. mun.;2018;36;170;73;97
Biržai d. mun.;2018;37;167;95;72
Biržai d. mun.;2018;38;148;70;78
Biržai d. mun.;2018;39;201;98;103
Biržai d. mun.;2018;40;229;111;118
Biržai d. mun.;2018;41;247;122;125
Biržai d. mun.;2018;42;284;149;135
Biržai d. mun.;2018;43;282;129;153
Biržai d. mun.;2018;44;344;152;192
Biržai d. mun.;2018;45;367;185;182
Biržai d. mun.;2018;46;380;176;204
Biržai d. mun.;2018;47;371;186;185
Biržai d. mun.;2018;48;408;200;208
Biržai d. mun.;2018;49;398;199;199
Biržai d. mun.;2018;50;404;196;208
Biržai d. mun.;2018;51;361;166;195
Biržai d. mun.;2018;52;365;181;184
Biržai d. mun.;2018;53;384;196;188
Biržai d. mun.;2018;54;409;191;218
Biržai d. mun.;2018;55;386;186;200
Biržai d. mun.;2018;56;389;180;209
Biržai d. mun.;2018;57;428;214;214
Biržai d. mun.;2018;58;380;178;202
Biržai d. mun.;2018;59;408;192;216
Biržai d. mun.;2018;60;347;156;191
Biržai d. mun.;2018;61;313;132;181
Biržai d. mun.;2018;62;360;163;197
Biržai d. mun.;2018;63;317;125;192
Biržai d. mun.;2018;64;260;117;143
Biržai d. mun.;2018;65;300;144;156
Biržai d. mun.;2018;66;305;115;190
Biržai d. mun.;2018;67;311;135;176
Biržai d. mun.;2018;68;302;117;185
Biržai d. mun.;2018;69;275;101;174
Biržai d. mun.;2018;70;289;120;169
Biržai d. mun.;2018;71;217;91;126
Biržai d. mun.;2018;72;249;88;161
Biržai d. mun.;2018;73;216;86;130
Biržai d. mun.;2018;74;280;97;183
Biržai d. mun.;2018;75;277;97;180
Biržai d. mun.;2018;76;282;88;194
Biržai d. mun.;2018;77;232;74;158
Biržai d. mun.;2018;78;257;81;176
Biržai d. mun.;2018;79;248;72;176
Biržai d. mun.;2018;80;271;73;198
Biržai d. mun.;2018;81;238;68;170
Biržai d. mun.;2018;82;184;51;133
Biržai d. mun.;2018;83;204;63;141
Biržai d. mun.;2018;84;199;56;143
Biržai d. mun.;2018;85;826;194;632
Druskininkai mun.;2001;-1;25500;11756;13744
Druskininkai mun.;2001;0;212;94;118
Druskininkai mun.;2001;1;243;116;127
Druskininkai mun.;2001;2;214;108;106
Druskininkai mun.;2001;3;257;125;132
Druskininkai mun.;2001;4;256;134;122
Druskininkai mun.;2001;5;307;149;158
Druskininkai mun.;2001;6;333;186;147
Druskininkai mun.;2001;7;382;184;198
Druskininkai mun.;2001;8;398;186;212
Druskininkai mun.;2001;9;410;218;192
Druskininkai mun.;2001;10;413;208;205
Druskininkai mun.;2001;11;425;222;203
Druskininkai mun.;2001;12;410;235;175
Druskininkai mun.;2001;13;452;237;215
Druskininkai mun.;2001;14;448;227;221
Druskininkai mun.;2001;15;432;214;218
Druskininkai mun.;2001;16;442;217;225
Druskininkai mun.;2001;17;388;201;187
Druskininkai mun.;2001;18;310;153;157
Druskininkai mun.;2001;19;248;146;102
Druskininkai mun.;2001;20;198;104;94
Druskininkai mun.;2001;21;231;131;100
Druskininkai mun.;2001;22;242;133;109
Druskininkai mun.;2001;23;231;110;121
Druskininkai mun.;2001;24;297;141;156
Druskininkai mun.;2001;25;268;150;118
Druskininkai mun.;2001;26;290;156;134
Druskininkai mun.;2001;27;310;144;166
Druskininkai mun.;2001;28;340;177;163
Druskininkai mun.;2001;29;368;174;194
Druskininkai mun.;2001;30;361;180;181
Druskininkai mun.;2001;31;358;176;182
Druskininkai mun.;2001;32;413;199;214
Druskininkai mun.;2001;33;399;199;200
Druskininkai mun.;2001;34;387;193;194
Druskininkai mun.;2001;35;395;187;208
Druskininkai mun.;2001;36;406;177;229
Druskininkai mun.;2001;37;426;208;218
Druskininkai mun.;2001;38;452;207;245
Druskininkai mun.;2001;39;452;203;249
Druskininkai mun.;2001;40;430;204;226
Druskininkai mun.;2001;41;467;212;255
Druskininkai mun.;2001;42;449;222;227
Druskininkai mun.;2001;43;359;186;173
Druskininkai mun.;2001;44;348;147;201
Druskininkai mun.;2001;45;323;147;176
Druskininkai mun.;2001;46;272;131;141
Druskininkai mun.;2001;47;289;133;156
Druskininkai mun.;2001;48;345;152;193
Druskininkai mun.;2001;49;300;146;154
Druskininkai mun.;2001;50;332;149;183
Druskininkai mun.;2001;51;302;145;157
Druskininkai mun.;2001;52;264;120;144
Druskininkai mun.;2001;53;284;113;171
Druskininkai mun.;2001;54;252;114;138
Druskininkai mun.;2001;55;306;125;181
Druskininkai mun.;2001;56;240;110;130
Druskininkai mun.;2001;57;295;130;165
Druskininkai mun.;2001;58;324;121;203
Druskininkai mun.;2001;59;275;104;171
Druskininkai mun.;2001;60;290;131;159
Druskininkai mun.;2001;61;295;132;163
Druskininkai mun.;2001;62;302;127;175
Druskininkai mun.;2001;63;311;120;191
Druskininkai mun.;2001;64;308;118;190
Druskininkai mun.;2001;65;298;114;184
Druskininkai mun.;2001;66;251;106;145
Druskininkai mun.;2001;67;264;105;159
Druskininkai mun.;2001;68;228;94;134
Druskininkai mun.;2001;69;261;96;165
Druskininkai mun.;2001;70;255;100;155
Druskininkai mun.;2001;71;236;83;153
Druskininkai mun.;2001;72;234;79;155
Druskininkai mun.;2001;73;197;58;139
Druskininkai mun.;2001;74;187;63;124
Druskininkai mun.;2001;75;178;52;126
Druskininkai mun.;2001;76;169;65;104
Druskininkai mun.;2001;77;137;44;93
Druskininkai mun.;2001;78;126;34;92
Druskininkai mun.;2001;79;92;30;62
Druskininkai mun.;2001;80;71;23;48
Druskininkai mun.;2001;81;83;24;59
Druskininkai mun.;2001;82;53;17;36
Druskininkai mun.;2001;83;45;16;29
Druskininkai mun.;2001;84;56;14;42
Druskininkai mun.;2001;85;313;91;222
Druskininkai mun.;2002;-1;25169;11549;13620
Druskininkai mun.;2002;0;182;89;93
Druskininkai mun.;2002;1;208;94;114
Druskininkai mun.;2002;2;240;115;125
Druskininkai mun.;2002;3;210;104;106
Druskininkai mun.;2002;4;255;124;131
Druskininkai mun.;2002;5;251;131;120
Druskininkai mun.;2002;6;301;147;154
Druskininkai mun.;2002;7;336;187;149
Druskininkai mun.;2002;8;380;184;196
Druskininkai mun.;2002;9;396;185;211
Druskininkai mun.;2002;10;410;221;189
Druskininkai mun.;2002;11;412;207;205
Druskininkai mun.;2002;12;419;218;201
Druskininkai mun.;2002;13;399;227;172
Druskininkai mun.;2002;14;451;236;215
Druskininkai mun.;2002;15;444;224;220
Druskininkai mun.;2002;16;426;211;215
Druskininkai mun.;2002;17;435;212;223
Druskininkai mun.;2002;18;381;194;187
Druskininkai mun.;2002;19;296;146;150
Druskininkai mun.;2002;20;240;139;101
Druskininkai mun.;2002;21;196;101;95
Druskininkai mun.;2002;22;224;128;96
Druskininkai mun.;2002;23;233;127;106
Druskininkai mun.;2002;24;225;107;118
Druskininkai mun.;2002;25;291;140;151
Druskininkai mun.;2002;26;259;141;118
Druskininkai mun.;2002;27;276;151;125
Druskininkai mun.;2002;28;303;138;165
Druskininkai mun.;2002;29;330;171;159
Druskininkai mun.;2002;30;357;170;187
Druskininkai mun.;2002;31;349;172;177
Druskininkai mun.;2002;32;349;172;177
Druskininkai mun.;2002;33;405;194;211
Druskininkai mun.;2002;34;396;196;200
Druskininkai mun.;2002;35;382;188;194
Druskininkai mun.;2002;36;389;183;206
Druskininkai mun.;2002;37;397;172;225
Druskininkai mun.;2002;38;421;205;216
Druskininkai mun.;2002;39;445;202;243
Druskininkai mun.;2002;40;446;199;247
Druskininkai mun.;2002;41;426;202;224
Druskininkai mun.;2002;42;460;208;252
Druskininkai mun.;2002;43;443;218;225
Druskininkai mun.;2002;44;358;185;173
Druskininkai mun.;2002;45;342;145;197
Druskininkai mun.;2002;46;317;144;173
Druskininkai mun.;2002;47;270;131;139
Druskininkai mun.;2002;48;283;131;152
Druskininkai mun.;2002;49;340;148;192
Druskininkai mun.;2002;50;293;141;152
Druskininkai mun.;2002;51;329;147;182
Druskininkai mun.;2002;52;300;143;157
Druskininkai mun.;2002;53;263;120;143
Druskininkai mun.;2002;54;276;110;166
Druskininkai mun.;2002;55;244;111;133
Druskininkai mun.;2002;56;304;123;181
Druskininkai mun.;2002;57;232;103;129
Druskininkai mun.;2002;58;292;128;164
Druskininkai mun.;2002;59;316;116;200
Druskininkai mun.;2002;60;272;103;169
Druskininkai mun.;2002;61;289;129;160
Druskininkai mun.;2002;62;293;130;163
Druskininkai mun.;2002;63;299;127;172
Druskininkai mun.;2002;64;307;116;191
Druskininkai mun.;2002;65;303;113;190
Druskininkai mun.;2002;66;290;110;180
Druskininkai mun.;2002;67;245;101;144
Druskininkai mun.;2002;68;263;104;159
Druskininkai mun.;2002;69;225;93;132
Druskininkai mun.;2002;70;259;93;166
Druskininkai mun.;2002;71;250;98;152
Druskininkai mun.;2002;72;233;77;156
Druskininkai mun.;2002;73;231;77;154
Druskininkai mun.;2002;74;196;59;137
Druskininkai mun.;2002;75;179;59;120
Druskininkai mun.;2002;76;170;50;120
Druskininkai mun.;2002;77;161;57;104
Druskininkai mun.;2002;78;126;38;88
Druskininkai mun.;2002;79;122;32;90
Druskininkai mun.;2002;80;88;27;61
Druskininkai mun.;2002;81;68;23;45
Druskininkai mun.;2002;82;79;20;59
Druskininkai mun.;2002;83;47;16;31
Druskininkai mun.;2002;84;41;13;28
Druskininkai mun.;2002;85;300;78;222
Druskininkai mun.;2003;-1;24965;11406;13559
Druskininkai mun.;2003;0;148;70;78
Druskininkai mun.;2003;1;174;85;89
Druskininkai mun.;2003;2;205;91;114
Druskininkai mun.;2003;3;241;116;125
Druskininkai mun.;2003;4;207;102;105
Druskininkai mun.;2003;5;253;123;130
Druskininkai mun.;2003;6;251;130;121
Druskininkai mun.;2003;7;301;147;154
Druskininkai mun.;2003;8;334;188;146
Druskininkai mun.;2003;9;378;184;194
Druskininkai mun.;2003;10;392;183;209
Druskininkai mun.;2003;11;412;222;190
Druskininkai mun.;2003;12;405;203;202
Druskininkai mun.;2003;13;416;215;201
Druskininkai mun.;2003;14;394;223;171
Druskininkai mun.;2003;15;440;230;210
Druskininkai mun.;2003;16;436;219;217
Druskininkai mun.;2003;17;419;206;213
Druskininkai mun.;2003;18;428;205;223
Druskininkai mun.;2003;19;381;194;187
Druskininkai mun.;2003;20;291;145;146
Druskininkai mun.;2003;21;234;138;96
Druskininkai mun.;2003;22;199;99;100
Druskininkai mun.;2003;23;223;124;99
Druskininkai mun.;2003;24;232;128;104
Druskininkai mun.;2003;25;222;107;115
Druskininkai mun.;2003;26;284;139;145
Druskininkai mun.;2003;27;246;136;110
Druskininkai mun.;2003;28;272;148;124
Druskininkai mun.;2003;29;300;138;162
Druskininkai mun.;2003;30;319;164;155
Druskininkai mun.;2003;31;356;166;190
Druskininkai mun.;2003;32;349;172;177
Druskininkai mun.;2003;33;352;174;178
Druskininkai mun.;2003;34;403;194;209
Druskininkai mun.;2003;35;390;189;201
Druskininkai mun.;2003;36;376;185;191
Druskininkai mun.;2003;37;385;181;204
Druskininkai mun.;2003;38;396;174;222
Druskininkai mun.;2003;39;416;203;213
Druskininkai mun.;2003;40;444;202;242
Druskininkai mun.;2003;41;437;194;243
Druskininkai mun.;2003;42;427;201;226
Druskininkai mun.;2003;43;458;206;252
Druskininkai mun.;2003;44;441;217;224
Druskininkai mun.;2003;45;352;178;174
Druskininkai mun.;2003;46;337;140;197
Druskininkai mun.;2003;47;317;144;173
Druskininkai mun.;2003;48;268;130;138
Druskininkai mun.;2003;49;281;129;152
Druskininkai mun.;2003;50;338;146;192
Druskininkai mun.;2003;51;290;139;151
Druskininkai mun.;2003;52;330;146;184
Druskininkai mun.;2003;53;294;141;153
Druskininkai mun.;2003;54;262;119;143
Druskininkai mun.;2003;55;275;111;164
Druskininkai mun.;2003;56;244;110;134
Druskininkai mun.;2003;57;300;122;178
Druskininkai mun.;2003;58;233;103;130
Druskininkai mun.;2003;59;286;124;162
Druskininkai mun.;2003;60;316;116;200
Druskininkai mun.;2003;61;266;98;168
Druskininkai mun.;2003;62;280;121;159
Druskininkai mun.;2003;63;295;130;165
Druskininkai mun.;2003;64;299;127;172
Druskininkai mun.;2003;65;311;116;195
Druskininkai mun.;2003;66;303;112;191
Druskininkai mun.;2003;67;283;108;175
Druskininkai mun.;2003;68;239;96;143
Druskininkai mun.;2003;69;258;101;157
Druskininkai mun.;2003;70;216;84;132
Druskininkai mun.;2003;71;254;89;165
Druskininkai mun.;2003;72;246;94;152
Druskininkai mun.;2003;73;230;76;154
Druskininkai mun.;2003;74;226;76;150
Druskininkai mun.;2003;75;196;55;141
Druskininkai mun.;2003;76;176;56;120
Druskininkai mun.;2003;77;170;50;120
Druskininkai mun.;2003;78;150;47;103
Druskininkai mun.;2003;79;119;33;86
Druskininkai mun.;2003;80;118;31;87
Druskininkai mun.;2003;81;80;23;57
Druskininkai mun.;2003;82;57;19;38
Druskininkai mun.;2003;83;73;21;52
Druskininkai mun.;2003;84;45;16;29
Druskininkai mun.;2003;85;285;69;216
Druskininkai mun.;2004;-1;24665;11210;13455
Druskininkai mun.;2004;0;162;87;75
Druskininkai mun.;2004;1;146;67;79
Druskininkai mun.;2004;2;178;86;92
Druskininkai mun.;2004;3;204;92;112
Druskininkai mun.;2004;4;239;116;123
Druskininkai mun.;2004;5;204;102;102
Druskininkai mun.;2004;6;252;121;131
Druskininkai mun.;2004;7;248;130;118
Druskininkai mun.;2004;8;299;146;153
Druskininkai mun.;2004;9;334;186;148
Druskininkai mun.;2004;10;372;181;191
Druskininkai mun.;2004;11;392;183;209
Druskininkai mun.;2004;12;409;221;188
Druskininkai mun.;2004;13;403;201;202
Druskininkai mun.;2004;14;408;212;196
Druskininkai mun.;2004;15;391;222;169
Druskininkai mun.;2004;16;432;224;208
Druskininkai mun.;2004;17;430;216;214
Druskininkai mun.;2004;18;408;199;209
Druskininkai mun.;2004;19;418;199;219
Druskininkai mun.;2004;20;365;184;181
Druskininkai mun.;2004;21;281;135;146
Druskininkai mun.;2004;22;227;138;89
Druskininkai mun.;2004;23;186;93;93
Druskininkai mun.;2004;24;211;118;93
Druskininkai mun.;2004;25;224;127;97
Druskininkai mun.;2004;26;212;103;109
Druskininkai mun.;2004;27;278;135;143
Druskininkai mun.;2004;28;247;131;116
Druskininkai mun.;2004;29;257;134;123
Druskininkai mun.;2004;30;304;140;164
Druskininkai mun.;2004;31;307;155;152
Druskininkai mun.;2004;32;350;164;186
Druskininkai mun.;2004;33;344;169;175
Druskininkai mun.;2004;34;350;176;174
Druskininkai mun.;2004;35;391;184;207
Druskininkai mun.;2004;36;384;187;197
Druskininkai mun.;2004;37;386;189;197
Druskininkai mun.;2004;38;385;180;205
Druskininkai mun.;2004;39;390;169;221
Druskininkai mun.;2004;40;410;200;210
Druskininkai mun.;2004;41;434;199;235
Druskininkai mun.;2004;42;430;190;240
Druskininkai mun.;2004;43;427;202;225
Druskininkai mun.;2004;44;450;202;248
Druskininkai mun.;2004;45;432;210;222
Druskininkai mun.;2004;46;352;176;176
Druskininkai mun.;2004;47;337;139;198
Druskininkai mun.;2004;48;312;138;174
Druskininkai mun.;2004;49;268;131;137
Druskininkai mun.;2004;50;280;128;152
Druskininkai mun.;2004;51;331;142;189
Druskininkai mun.;2004;52;279;131;148
Druskininkai mun.;2004;53;331;146;185
Druskininkai mun.;2004;54;288;136;152
Druskininkai mun.;2004;55;258;117;141
Druskininkai mun.;2004;56;276;112;164
Druskininkai mun.;2004;57;243;108;135
Druskininkai mun.;2004;58;295;120;175
Druskininkai mun.;2004;59;230;100;130
Druskininkai mun.;2004;60;275;118;157
Druskininkai mun.;2004;61;309;111;198
Druskininkai mun.;2004;62;263;94;169
Druskininkai mun.;2004;63;274;115;159
Druskininkai mun.;2004;64;291;128;163
Druskininkai mun.;2004;65;292;121;171
Druskininkai mun.;2004;66;306;109;197
Druskininkai mun.;2004;67;299;108;191
Druskininkai mun.;2004;68;273;104;169
Druskininkai mun.;2004;69;237;94;143
Druskininkai mun.;2004;70;255;97;158
Druskininkai mun.;2004;71;210;82;128
Druskininkai mun.;2004;72;249;86;163
Druskininkai mun.;2004;73;244;92;152
Druskininkai mun.;2004;74;223;72;151
Druskininkai mun.;2004;75;213;70;143
Druskininkai mun.;2004;76;184;51;133
Druskininkai mun.;2004;77;172;55;117
Druskininkai mun.;2004;78;165;48;117
Druskininkai mun.;2004;79;143;45;98
Druskininkai mun.;2004;80;112;29;83
Druskininkai mun.;2004;81;117;30;87
Druskininkai mun.;2004;82;78;19;59
Druskininkai mun.;2004;83;54;16;38
Druskininkai mun.;2004;84;73;21;52
Druskininkai mun.;2004;85;283;66;217
Druskininkai mun.;2005;-1;24252;11011;13241
Druskininkai mun.;2005;0;161;84;77
Druskininkai mun.;2005;1;161;85;76
Druskininkai mun.;2005;2;146;68;78
Druskininkai mun.;2005;3;176;85;91
Druskininkai mun.;2005;4;202;91;111
Druskininkai mun.;2005;5;234;114;120
Druskininkai mun.;2005;6;201;100;101
Druskininkai mun.;2005;7;250;121;129
Druskininkai mun.;2005;8;248;129;119
Druskininkai mun.;2005;9;294;144;150
Druskininkai mun.;2005;10;331;185;146
Druskininkai mun.;2005;11;372;181;191
Druskininkai mun.;2005;12;385;181;204
Druskininkai mun.;2005;13;404;219;185
Druskininkai mun.;2005;14;393;195;198
Druskininkai mun.;2005;15;404;209;195
Druskininkai mun.;2005;16;382;217;165
Druskininkai mun.;2005;17;422;218;204
Druskininkai mun.;2005;18;422;211;211
Druskininkai mun.;2005;19;402;197;205
Druskininkai mun.;2005;20;405;192;213
Druskininkai mun.;2005;21;355;182;173
Druskininkai mun.;2005;22;289;138;151
Druskininkai mun.;2005;23;222;136;86
Druskininkai mun.;2005;24;183;91;92
Druskininkai mun.;2005;25;206;121;85
Druskininkai mun.;2005;26;221;127;94
Druskininkai mun.;2005;27;218;107;111
Druskininkai mun.;2005;28;266;129;137
Druskininkai mun.;2005;29;239;131;108
Druskininkai mun.;2005;30;252;127;125
Druskininkai mun.;2005;31;305;144;161
Druskininkai mun.;2005;32;299;150;149
Druskininkai mun.;2005;33;339;159;180
Druskininkai mun.;2005;34;337;165;172
Druskininkai mun.;2005;35;345;172;173
Druskininkai mun.;2005;36;389;183;206
Druskininkai mun.;2005;37;376;184;192
Druskininkai mun.;2005;38;380;186;194
Druskininkai mun.;2005;39;372;173;199
Druskininkai mun.;2005;40;379;163;216
Druskininkai mun.;2005;41;402;196;206
Druskininkai mun.;2005;42;431;197;234
Druskininkai mun.;2005;43;426;189;237
Druskininkai mun.;2005;44;421;200;221
Druskininkai mun.;2005;45;437;197;240
Druskininkai mun.;2005;46;429;205;224
Druskininkai mun.;2005;47;350;177;173
Druskininkai mun.;2005;48;327;134;193
Druskininkai mun.;2005;49;310;136;174
Druskininkai mun.;2005;50;267;129;138
Druskininkai mun.;2005;51;276;125;151
Druskininkai mun.;2005;52;328;139;189
Druskininkai mun.;2005;53;276;127;149
Druskininkai mun.;2005;54;325;143;182
Druskininkai mun.;2005;55;276;128;148
Druskininkai mun.;2005;56;253;116;137
Druskininkai mun.;2005;57;272;107;165
Druskininkai mun.;2005;58;239;105;134
Druskininkai mun.;2005;59;289;119;170
Druskininkai mun.;2005;60;228;97;131
Druskininkai mun.;2005;61;265;112;153
Druskininkai mun.;2005;62;303;106;197
Druskininkai mun.;2005;63;259;93;166
Druskininkai mun.;2005;64;268;110;158
Druskininkai mun.;2005;65;282;123;159
Druskininkai mun.;2005;66;282;117;165
Druskininkai mun.;2005;67;294;103;191
Druskininkai mun.;2005;68;297;106;191
Druskininkai mun.;2005;69;261;95;166
Druskininkai mun.;2005;70;228;87;141
Druskininkai mun.;2005;71;245;91;154
Druskininkai mun.;2005;72;204;79;125
Druskininkai mun.;2005;73;237;77;160
Druskininkai mun.;2005;74;227;82;145
Druskininkai mun.;2005;75;218;69;149
Druskininkai mun.;2005;76;205;68;137
Druskininkai mun.;2005;77;173;48;125
Druskininkai mun.;2005;78;162;50;112
Druskininkai mun.;2005;79;152;45;107
Druskininkai mun.;2005;80;131;40;91
Druskininkai mun.;2005;81;102;26;76
Druskininkai mun.;2005;82;110;25;85
Druskininkai mun.;2005;83;69;14;55
Druskininkai mun.;2005;84;45;13;32
Druskininkai mun.;2005;85;304;72;232
Druskininkai mun.;2006;-1;23865;10788;13077
Druskininkai mun.;2006;0;193;97;96
Druskininkai mun.;2006;1;159;82;77
Druskininkai mun.;2006;2;156;83;73
Druskininkai mun.;2006;3;146;67;79
Druskininkai mun.;2006;4;175;83;92
Druskininkai mun.;2006;5;201;92;109
Druskininkai mun.;2006;6;232;115;117
Druskininkai mun.;2006;7;200;98;102
Druskininkai mun.;2006;8;247;118;129
Druskininkai mun.;2006;9;250;131;119
Druskininkai mun.;2006;10;293;142;151
Druskininkai mun.;2006;11;329;185;144
Druskininkai mun.;2006;12;369;178;191
Druskininkai mun.;2006;13;378;178;200
Druskininkai mun.;2006;14;404;213;191
Druskininkai mun.;2006;15;386;190;196
Druskininkai mun.;2006;16;393;202;191
Druskininkai mun.;2006;17;371;208;163
Druskininkai mun.;2006;18;408;210;198
Druskininkai mun.;2006;19;403;198;205
Druskininkai mun.;2006;20;378;183;195
Druskininkai mun.;2006;21;386;183;203
Druskininkai mun.;2006;22;343;176;167
Druskininkai mun.;2006;23;266;127;139
Druskininkai mun.;2006;24;209;130;79
Druskininkai mun.;2006;25;173;92;81
Druskininkai mun.;2006;26;194;121;73
Druskininkai mun.;2006;27;218;123;95
Druskininkai mun.;2006;28;201;98;103
Druskininkai mun.;2006;29;263;126;137
Druskininkai mun.;2006;30;232;126;106
Druskininkai mun.;2006;31;247;124;123
Druskininkai mun.;2006;32;302;138;164
Druskininkai mun.;2006;33;293;148;145
Druskininkai mun.;2006;34;328;152;176
Druskininkai mun.;2006;35;340;168;172
Druskininkai mun.;2006;36;342;169;173
Druskininkai mun.;2006;37;389;182;207
Druskininkai mun.;2006;38;360;172;188
Druskininkai mun.;2006;39;380;186;194
Druskininkai mun.;2006;40;367;170;197
Druskininkai mun.;2006;41;375;163;212
Druskininkai mun.;2006;42;393;190;203
Druskininkai mun.;2006;43;417;188;229
Druskininkai mun.;2006;44;421;185;236
Druskininkai mun.;2006;45;415;199;216
Druskininkai mun.;2006;46;432;193;239
Druskininkai mun.;2006;47;423;200;223
Druskininkai mun.;2006;48;350;178;172
Druskininkai mun.;2006;49;320;129;191
Druskininkai mun.;2006;50;307;136;171
Druskininkai mun.;2006;51;260;126;134
Druskininkai mun.;2006;52;268;119;149
Druskininkai mun.;2006;53;319;135;184
Druskininkai mun.;2006;54;267;121;146
Druskininkai mun.;2006;55;319;140;179
Druskininkai mun.;2006;56;271;126;145
Druskininkai mun.;2006;57;247;114;133
Druskininkai mun.;2006;58;270;104;166
Druskininkai mun.;2006;59;235;101;134
Druskininkai mun.;2006;60;282;115;167
Druskininkai mun.;2006;61;228;96;132
Druskininkai mun.;2006;62;259;107;152
Druskininkai mun.;2006;63;299;106;193
Druskininkai mun.;2006;64;259;93;166
Druskininkai mun.;2006;65;265;105;160
Druskininkai mun.;2006;66;279;122;157
Druskininkai mun.;2006;67;277;112;165
Druskininkai mun.;2006;68;284;95;189
Druskininkai mun.;2006;69;291;101;190
Druskininkai mun.;2006;70;263;93;170
Druskininkai mun.;2006;71;225;82;143
Druskininkai mun.;2006;72;235;86;149
Druskininkai mun.;2006;73;201;77;124
Druskininkai mun.;2006;74;229;72;157
Druskininkai mun.;2006;75;213;77;136
Druskininkai mun.;2006;76;209;66;143
Druskininkai mun.;2006;77;198;64;134
Druskininkai mun.;2006;78;169;44;125
Druskininkai mun.;2006;79;145;41;104
Druskininkai mun.;2006;80;147;43;104
Druskininkai mun.;2006;81;127;42;85
Druskininkai mun.;2006;82;96;25;71
Druskininkai mun.;2006;83;102;24;78
Druskininkai mun.;2006;84;66;14;52
Druskininkai mun.;2006;85;304;75;229
Druskininkai mun.;2007;-1;23469;10549;12920
Druskininkai mun.;2007;0;166;81;85
Druskininkai mun.;2007;1;186;94;92
Druskininkai mun.;2007;2;157;81;76
Druskininkai mun.;2007;3;158;85;73
Druskininkai mun.;2007;4;146;65;81
Druskininkai mun.;2007;5;176;84;92
Druskininkai mun.;2007;6;201;89;112
Druskininkai mun.;2007;7;233;116;117
Druskininkai mun.;2007;8;203;101;102
Druskininkai mun.;2007;9;248;118;130
Druskininkai mun.;2007;10;247;128;119
Druskininkai mun.;2007;11;295;143;152
Druskininkai mun.;2007;12;324;182;142
Druskininkai mun.;2007;13;367;177;190
Druskininkai mun.;2007;14;374;173;201
Druskininkai mun.;2007;15;402;210;192
Druskininkai mun.;2007;16;382;187;195
Druskininkai mun.;2007;17;388;199;189
Druskininkai mun.;2007;18;362;201;161
Druskininkai mun.;2007;19;400;206;194
Druskininkai mun.;2007;20;397;194;203
Druskininkai mun.;2007;21;370;180;190
Druskininkai mun.;2007;22;376;176;200
Druskininkai mun.;2007;23;335;170;165
Druskininkai mun.;2007;24;260;123;137
Druskininkai mun.;2007;25;201;127;74
Druskininkai mun.;2007;26;159;85;74
Druskininkai mun.;2007;27;192;123;69
Druskininkai mun.;2007;28;207;117;90
Druskininkai mun.;2007;29;196;96;100
Druskininkai mun.;2007;30;261;125;136
Druskininkai mun.;2007;31;231;124;107
Druskininkai mun.;2007;32;240;120;120
Druskininkai mun.;2007;33;298;133;165
Druskininkai mun.;2007;34;291;142;149
Druskininkai mun.;2007;35;327;152;175
Druskininkai mun.;2007;36;337;166;171
Druskininkai mun.;2007;37;334;165;169
Druskininkai mun.;2007;38;381;174;207
Druskininkai mun.;2007;39;355;169;186
Druskininkai mun.;2007;40;374;183;191
Druskininkai mun.;2007;41;357;165;192
Druskininkai mun.;2007;42;369;160;209
Druskininkai mun.;2007;43;389;184;205
Druskininkai mun.;2007;44;414;185;229
Druskininkai mun.;2007;45;413;181;232
Druskininkai mun.;2007;46;410;193;217
Druskininkai mun.;2007;47;424;189;235
Druskininkai mun.;2007;48;414;192;222
Druskininkai mun.;2007;49;344;175;169
Druskininkai mun.;2007;50;313;126;187
Druskininkai mun.;2007;51;301;132;169
Druskininkai mun.;2007;52;255;121;134
Druskininkai mun.;2007;53;257;114;143
Druskininkai mun.;2007;54;315;132;183
Druskininkai mun.;2007;55;262;118;144
Druskininkai mun.;2007;56;313;135;178
Druskininkai mun.;2007;57;269;124;145
Druskininkai mun.;2007;58;248;114;134
Druskininkai mun.;2007;59;265;103;162
Druskininkai mun.;2007;60;225;97;128
Druskininkai mun.;2007;61;274;108;166
Druskininkai mun.;2007;62;229;94;135
Druskininkai mun.;2007;63;255;105;150
Druskininkai mun.;2007;64;297;104;193
Druskininkai mun.;2007;65;255;89;166
Druskininkai mun.;2007;66;259;103;156
Druskininkai mun.;2007;67;268;115;153
Druskininkai mun.;2007;68;272;108;164
Druskininkai mun.;2007;69;280;91;189
Druskininkai mun.;2007;70;283;98;185
Druskininkai mun.;2007;71;252;83;169
Druskininkai mun.;2007;72;220;80;140
Druskininkai mun.;2007;73;229;80;149
Druskininkai mun.;2007;74;190;73;117
Druskininkai mun.;2007;75;218;67;151
Druskininkai mun.;2007;76;196;68;128
Druskininkai mun.;2007;77;203;64;139
Druskininkai mun.;2007;78;183;56;127
Druskininkai mun.;2007;79;155;38;117
Druskininkai mun.;2007;80;135;38;97
Druskininkai mun.;2007;81;139;36;103
Druskininkai mun.;2007;82;115;37;78
Druskininkai mun.;2007;83;80;21;59
Druskininkai mun.;2007;84;98;24;74
Druskininkai mun.;2007;85;290;65;225
Druskininkai mun.;2008;-1;23187;10404;12783
Druskininkai mun.;2008;0;151;81;70
Druskininkai mun.;2008;1;164;78;86
Druskininkai mun.;2008;2;186;95;91
Druskininkai mun.;2008;3;152;80;72
Druskininkai mun.;2008;4;157;83;74
Druskininkai mun.;2008;5;146;65;81
Druskininkai mun.;2008;6;178;85;93
Druskininkai mun.;2008;7;198;88;110
Druskininkai mun.;2008;8;233;118;115
Druskininkai mun.;2008;9;202;101;101
Druskininkai mun.;2008;10;245;116;129
Druskininkai mun.;2008;11;245;128;117
Druskininkai mun.;2008;12;292;142;150
Druskininkai mun.;2008;13;324;179;145
Druskininkai mun.;2008;14;367;177;190
Druskininkai mun.;2008;15;376;174;202
Druskininkai mun.;2008;16;396;208;188
Druskininkai mun.;2008;17;379;187;192
Druskininkai mun.;2008;18;379;193;186
Druskininkai mun.;2008;19;356;198;158
Druskininkai mun.;2008;20;390;200;190
Druskininkai mun.;2008;21;387;188;199
Druskininkai mun.;2008;22;360;176;184
Druskininkai mun.;2008;23;364;173;191
Druskininkai mun.;2008;24;326;165;161
Druskininkai mun.;2008;25;245;117;128
Druskininkai mun.;2008;26;194;119;75
Druskininkai mun.;2008;27;165;92;73
Druskininkai mun.;2008;28;189;120;69
Druskininkai mun.;2008;29;205;118;87
Druskininkai mun.;2008;30;190;91;99
Druskininkai mun.;2008;31;261;123;138
Druskininkai mun.;2008;32;230;126;104
Druskininkai mun.;2008;33;234;116;118
Druskininkai mun.;2008;34;299;131;168
Druskininkai mun.;2008;35;293;145;148
Druskininkai mun.;2008;36;325;152;173
Druskininkai mun.;2008;37;332;165;167
Druskininkai mun.;2008;38;330;162;168
Druskininkai mun.;2008;39;373;170;203
Druskininkai mun.;2008;40;351;169;182
Druskininkai mun.;2008;41;375;185;190
Druskininkai mun.;2008;42;355;166;189
Druskininkai mun.;2008;43;366;155;211
Druskininkai mun.;2008;44;389;185;204
Druskininkai mun.;2008;45;412;187;225
Druskininkai mun.;2008;46;411;177;234
Druskininkai mun.;2008;47;402;186;216
Druskininkai mun.;2008;48;422;184;238
Druskininkai mun.;2008;49;414;190;224
Druskininkai mun.;2008;50;337;168;169
Druskininkai mun.;2008;51;308;123;185
Druskininkai mun.;2008;52;296;129;167
Druskininkai mun.;2008;53;257;120;137
Druskininkai mun.;2008;54;257;112;145
Druskininkai mun.;2008;55;312;130;182
Druskininkai mun.;2008;56;255;113;142
Druskininkai mun.;2008;57;308;132;176
Druskininkai mun.;2008;58;263;118;145
Druskininkai mun.;2008;59;244;113;131
Druskininkai mun.;2008;60;262;102;160
Druskininkai mun.;2008;61;224;96;128
Druskininkai mun.;2008;62;273;108;165
Druskininkai mun.;2008;63;224;88;136
Druskininkai mun.;2008;64;251;102;149
Druskininkai mun.;2008;65;290;101;189
Druskininkai mun.;2008;66;248;85;163
Druskininkai mun.;2008;67;253;99;154
Druskininkai mun.;2008;68;267;112;155
Druskininkai mun.;2008;69;265;103;162
Druskininkai mun.;2008;70;269;82;187
Druskininkai mun.;2008;71;278;95;183
Druskininkai mun.;2008;72;247;80;167
Druskininkai mun.;2008;73;214;78;136
Druskininkai mun.;2008;74;218;75;143
Druskininkai mun.;2008;75;185;71;114
Druskininkai mun.;2008;76;206;62;144
Druskininkai mun.;2008;77;187;65;122
Druskininkai mun.;2008;78;188;59;129
Druskininkai mun.;2008;79;172;54;118
Druskininkai mun.;2008;80;144;34;110
Druskininkai mun.;2008;81;128;36;92
Druskininkai mun.;2008;82;132;34;98
Druskininkai mun.;2008;83;104;31;73
Druskininkai mun.;2008;84;69;17;52
Druskininkai mun.;2008;85;337;68;269
Druskininkai mun.;2009;-1;22954;10276;12678
Druskininkai mun.;2009;0;197;94;103
Druskininkai mun.;2009;1;149;77;72
Druskininkai mun.;2009;2;167;81;86
Druskininkai mun.;2009;3;186;93;93
Druskininkai mun.;2009;4;155;83;72
Druskininkai mun.;2009;5;158;87;71
Druskininkai mun.;2009;6;144;66;78
Druskininkai mun.;2009;7;179;86;93
Druskininkai mun.;2009;8;199;88;111
Druskininkai mun.;2009;9;232;118;114
Druskininkai mun.;2009;10;202;100;102
Druskininkai mun.;2009;11;244;114;130
Druskininkai mun.;2009;12;244;129;115
Druskininkai mun.;2009;13;289;139;150
Druskininkai mun.;2009;14;317;175;142
Druskininkai mun.;2009;15;367;177;190
Druskininkai mun.;2009;16;375;172;203
Druskininkai mun.;2009;17;401;210;191
Druskininkai mun.;2009;18;380;187;193
Druskininkai mun.;2009;19;374;189;185
Druskininkai mun.;2009;20;356;198;158
Druskininkai mun.;2009;21;378;193;185
Druskininkai mun.;2009;22;382;188;194
Druskininkai mun.;2009;23;360;176;184
Druskininkai mun.;2009;24;350;168;182
Druskininkai mun.;2009;25;315;159;156
Druskininkai mun.;2009;26;239;117;122
Druskininkai mun.;2009;27;186;116;70
Druskininkai mun.;2009;28;156;87;69
Druskininkai mun.;2009;29;188;119;69
Druskininkai mun.;2009;30;207;123;84
Druskininkai mun.;2009;31;186;94;92
Druskininkai mun.;2009;32;257;118;139
Druskininkai mun.;2009;33;223;120;103
Druskininkai mun.;2009;34;235;116;119
Druskininkai mun.;2009;35;300;128;172
Druskininkai mun.;2009;36;294;145;149
Druskininkai mun.;2009;37;314;147;167
Druskininkai mun.;2009;38;333;165;168
Druskininkai mun.;2009;39;335;164;171
Druskininkai mun.;2009;40;368;163;205
Druskininkai mun.;2009;41;353;170;183
Druskininkai mun.;2009;42;373;184;189
Druskininkai mun.;2009;43;348;162;186
Druskininkai mun.;2009;44;360;149;211
Druskininkai mun.;2009;45;387;185;202
Druskininkai mun.;2009;46;411;183;228
Druskininkai mun.;2009;47;404;172;232
Druskininkai mun.;2009;48;399;183;216
Druskininkai mun.;2009;49;411;174;237
Druskininkai mun.;2009;50;408;182;226
Druskininkai mun.;2009;51;332;165;167
Druskininkai mun.;2009;52;303;120;183
Druskininkai mun.;2009;53;290;126;164
Druskininkai mun.;2009;54;255;118;137
Druskininkai mun.;2009;55;245;104;141
Druskininkai mun.;2009;56;309;128;181
Druskininkai mun.;2009;57;251;110;141
Druskininkai mun.;2009;58;304;128;176
Druskininkai mun.;2009;59;256;112;144
Druskininkai mun.;2009;60;240;109;131
Druskininkai mun.;2009;61;255;99;156
Druskininkai mun.;2009;62;224;97;127
Druskininkai mun.;2009;63;267;104;163
Druskininkai mun.;2009;64;223;89;134
Druskininkai mun.;2009;65;245;96;149
Druskininkai mun.;2009;66;283;97;186
Druskininkai mun.;2009;67;244;82;162
Druskininkai mun.;2009;68;247;94;153
Druskininkai mun.;2009;69;263;110;153
Druskininkai mun.;2009;70;257;99;158
Druskininkai mun.;2009;71;265;83;182
Druskininkai mun.;2009;72;273;92;181
Druskininkai mun.;2009;73;236;75;161
Druskininkai mun.;2009;74;207;73;134
Druskininkai mun.;2009;75;209;71;138
Druskininkai mun.;2009;76;174;65;109
Druskininkai mun.;2009;77;195;58;137
Druskininkai mun.;2009;78;175;60;115
Druskininkai mun.;2009;79;178;54;124
Druskininkai mun.;2009;80;161;52;109
Druskininkai mun.;2009;81;139;33;106
Druskininkai mun.;2009;82;110;29;81
Druskininkai mun.;2009;83;120;32;88
Druskininkai mun.;2009;84;99;29;70
Druskininkai mun.;2009;85;345;70;275
Druskininkai mun.;2010;-1;22656;10099;12557
Druskininkai mun.;2010;0;187;95;92
Druskininkai mun.;2010;1;194;91;103
Druskininkai mun.;2010;2;153;80;73
Druskininkai mun.;2010;3;168;82;86
Druskininkai mun.;2010;4;189;96;93
Druskininkai mun.;2010;5;156;82;74
Druskininkai mun.;2010;6;155;87;68
Druskininkai mun.;2010;7;143;65;78
Druskininkai mun.;2010;8;176;85;91
Druskininkai mun.;2010;9;197;87;110
Druskininkai mun.;2010;10;228;117;111
Druskininkai mun.;2010;11;204;100;104
Druskininkai mun.;2010;12;242;113;129
Druskininkai mun.;2010;13;243;128;115
Druskininkai mun.;2010;14;289;141;148
Druskininkai mun.;2010;15;310;172;138
Druskininkai mun.;2010;16;364;175;189
Druskininkai mun.;2010;17;370;169;201
Druskininkai mun.;2010;18;396;208;188
Druskininkai mun.;2010;19;375;183;192
Druskininkai mun.;2010;20;367;187;180
Druskininkai mun.;2010;21;346;191;155
Druskininkai mun.;2010;22;367;185;182
Druskininkai mun.;2010;23;368;180;188
Druskininkai mun.;2010;24;343;168;175
Druskininkai mun.;2010;25;339;162;177
Druskininkai mun.;2010;26;305;154;151
Druskininkai mun.;2010;27;232;116;116
Druskininkai mun.;2010;28;173;111;62
Druskininkai mun.;2010;29;151;85;66
Druskininkai mun.;2010;30;183;112;71
Druskininkai mun.;2010;31;207;123;84
Druskininkai mun.;2010;32;181;87;94
Druskininkai mun.;2010;33;253;118;135
Druskininkai mun.;2010;34;217;115;102
Druskininkai mun.;2010;35;234;118;116
Druskininkai mun.;2010;36;300;131;169
Druskininkai mun.;2010;37;286;138;148
Druskininkai mun.;2010;38;317;151;166
Druskininkai mun.;2010;39;331;161;170
Druskininkai mun.;2010;40;331;160;171
Druskininkai mun.;2010;41;361;157;204
Druskininkai mun.;2010;42;350;167;183
Druskininkai mun.;2010;43;367;177;190
Druskininkai mun.;2010;44;341;157;184
Druskininkai mun.;2010;45;356;143;213
Druskininkai mun.;2010;46;382;184;198
Druskininkai mun.;2010;47;407;180;227
Druskininkai mun.;2010;48;398;168;230
Druskininkai mun.;2010;49;394;180;214
Druskininkai mun.;2010;50;405;168;237
Druskininkai mun.;2010;51;406;179;227
Druskininkai mun.;2010;52;330;165;165
Druskininkai mun.;2010;53;306;121;185
Druskininkai mun.;2010;54;286;125;161
Druskininkai mun.;2010;55;251;118;133
Druskininkai mun.;2010;56;239;102;137
Druskininkai mun.;2010;57;307;127;180
Druskininkai mun.;2010;58;243;105;138
Druskininkai mun.;2010;59;300;125;175
Druskininkai mun.;2010;60;253;110;143
Druskininkai mun.;2010;61;234;105;129
Druskininkai mun.;2010;62;252;96;156
Druskininkai mun.;2010;63;219;93;126
Druskininkai mun.;2010;64;262;100;162
Druskininkai mun.;2010;65;218;85;133
Druskininkai mun.;2010;66;241;92;149
Druskininkai mun.;2010;67;275;89;186
Druskininkai mun.;2010;68;242;80;162
Druskininkai mun.;2010;69;248;95;153
Druskininkai mun.;2010;70;256;104;152
Druskininkai mun.;2010;71;255;96;159
Druskininkai mun.;2010;72;259;77;182
Druskininkai mun.;2010;73;268;90;178
Druskininkai mun.;2010;74;227;69;158
Druskininkai mun.;2010;75;195;69;126
Druskininkai mun.;2010;76;201;65;136
Druskininkai mun.;2010;77;171;62;109
Druskininkai mun.;2010;78;185;56;129
Druskininkai mun.;2010;79;167;58;109
Druskininkai mun.;2010;80;157;46;111
Druskininkai mun.;2010;81;147;47;100
Druskininkai mun.;2010;82;126;29;97
Druskininkai mun.;2010;83;94;21;73
Druskininkai mun.;2010;84;106;26;80
Druskininkai mun.;2010;85;399;82;317
Druskininkai mun.;2011;-1;21876;9738;12138
Druskininkai mun.;2011;0;172;86;86
Druskininkai mun.;2011;1;167;89;78
Druskininkai mun.;2011;2;171;82;89
Druskininkai mun.;2011;3;134;64;70
Druskininkai mun.;2011;4;160;80;80
Druskininkai mun.;2011;5;174;88;86
Druskininkai mun.;2011;6;160;84;76
Druskininkai mun.;2011;7;144;74;70
Druskininkai mun.;2011;8;162;76;86
Druskininkai mun.;2011;9;174;84;90
Druskininkai mun.;2011;10;197;92;105
Druskininkai mun.;2011;11;237;117;120
Druskininkai mun.;2011;12;196;102;94
Druskininkai mun.;2011;13;244;117;127
Druskininkai mun.;2011;14;247;132;115
Druskininkai mun.;2011;15;294;144;150
Druskininkai mun.;2011;16;318;176;142
Druskininkai mun.;2011;17;362;168;194
Druskininkai mun.;2011;18;357;158;199
Druskininkai mun.;2011;19;318;170;148
Druskininkai mun.;2011;20;294;147;147
Druskininkai mun.;2011;21;289;141;148
Druskininkai mun.;2011;22;290;156;134
Druskininkai mun.;2011;23;286;146;140
Druskininkai mun.;2011;24;295;150;145
Druskininkai mun.;2011;25;272;132;140
Druskininkai mun.;2011;26;251;134;117
Druskininkai mun.;2011;27;228;116;112
Druskininkai mun.;2011;28;238;114;124
Druskininkai mun.;2011;29;205;110;95
Druskininkai mun.;2011;30;196;102;94
Druskininkai mun.;2011;31;180;106;74
Druskininkai mun.;2011;32;198;108;90
Druskininkai mun.;2011;33;188;89;99
Druskininkai mun.;2011;34;236;109;127
Druskininkai mun.;2011;35;211;105;106
Druskininkai mun.;2011;36;244;119;125
Druskininkai mun.;2011;37;278;119;159
Druskininkai mun.;2011;38;295;143;152
Druskininkai mun.;2011;39;318;143;175
Druskininkai mun.;2011;40;321;147;174
Druskininkai mun.;2011;41;322;157;165
Druskininkai mun.;2011;42;360;163;197
Druskininkai mun.;2011;43;361;171;190
Druskininkai mun.;2011;44;356;171;185
Druskininkai mun.;2011;45;338;158;180
Druskininkai mun.;2011;46;362;155;207
Druskininkai mun.;2011;47;389;187;202
Druskininkai mun.;2011;48;387;171;216
Druskininkai mun.;2011;49;400;177;223
Druskininkai mun.;2011;50;397;183;214
Druskininkai mun.;2011;51;408;179;229
Druskininkai mun.;2011;52;398;182;216
Druskininkai mun.;2011;53;332;169;163
Druskininkai mun.;2011;54;310;129;181
Druskininkai mun.;2011;55;290;123;167
Druskininkai mun.;2011;56;240;115;125
Druskininkai mun.;2011;57;248;107;141
Druskininkai mun.;2011;58;311;126;185
Druskininkai mun.;2011;59;246;105;141
Druskininkai mun.;2011;60;304;131;173
Druskininkai mun.;2011;61;266;117;149
Druskininkai mun.;2011;62;235;103;132
Druskininkai mun.;2011;63;245;92;153
Druskininkai mun.;2011;64;206;84;122
Druskininkai mun.;2011;65;270;102;168
Druskininkai mun.;2011;66;228;93;135
Druskininkai mun.;2011;67;240;92;148
Druskininkai mun.;2011;68;273;89;184
Druskininkai mun.;2011;69;231;70;161
Druskininkai mun.;2011;70;250;97;153
Druskininkai mun.;2011;71;246;95;151
Druskininkai mun.;2011;72;251;96;155
Druskininkai mun.;2011;73;241;75;166
Druskininkai mun.;2011;74;252;81;171
Druskininkai mun.;2011;75;223;70;153
Druskininkai mun.;2011;76;185;63;122
Druskininkai mun.;2011;77;198;68;130
Druskininkai mun.;2011;78;164;56;108
Druskininkai mun.;2011;79;179;50;129
Druskininkai mun.;2011;80;155;47;108
Druskininkai mun.;2011;81;149;38;111
Druskininkai mun.;2011;82;142;45;97
Druskininkai mun.;2011;83;114;29;85
Druskininkai mun.;2011;84;81;18;63
Druskininkai mun.;2011;85;392;90;302
Druskininkai mun.;2012;-1;21495;9525;11970
Druskininkai mun.;2012;0;175;90;85
Druskininkai mun.;2012;1;175;88;87
Druskininkai mun.;2012;2;169;92;77
Druskininkai mun.;2012;3;168;79;89
Druskininkai mun.;2012;4;135;65;70
Druskininkai mun.;2012;5;156;77;79
Druskininkai mun.;2012;6;168;86;82
Druskininkai mun.;2012;7;159;84;75
Druskininkai mun.;2012;8;144;72;72
Druskininkai mun.;2012;9;162;76;86
Druskininkai mun.;2012;10;178;86;92
Druskininkai mun.;2012;11;192;91;101
Druskininkai mun.;2012;12;235;116;119
Druskininkai mun.;2012;13;191;97;94
Druskininkai mun.;2012;14;243;114;129
Druskininkai mun.;2012;15;246;131;115
Druskininkai mun.;2012;16;292;145;147
Druskininkai mun.;2012;17;315;174;141
Druskininkai mun.;2012;18;356;166;190
Druskininkai mun.;2012;19;333;148;185
Druskininkai mun.;2012;20;310;168;142
Druskininkai mun.;2012;21;285;137;148
Druskininkai mun.;2012;22;273;130;143
Druskininkai mun.;2012;23;281;151;130
Druskininkai mun.;2012;24;263;144;119
Druskininkai mun.;2012;25;266;137;129
Druskininkai mun.;2012;26;244;113;131
Druskininkai mun.;2012;27;239;125;114
Druskininkai mun.;2012;28;207;105;102
Druskininkai mun.;2012;29;219;96;123
Druskininkai mun.;2012;30;197;102;95
Druskininkai mun.;2012;31;186;96;90
Druskininkai mun.;2012;32;160;94;66
Druskininkai mun.;2012;33;184;102;82
Druskininkai mun.;2012;34;189;88;101
Druskininkai mun.;2012;35;234;108;126
Druskininkai mun.;2012;36;210;104;106
Druskininkai mun.;2012;37;239;121;118
Druskininkai mun.;2012;38;276;121;155
Druskininkai mun.;2012;39;293;142;151
Druskininkai mun.;2012;40;318;145;173
Druskininkai mun.;2012;41;323;146;177
Druskininkai mun.;2012;42;321;157;164
Druskininkai mun.;2012;43;356;163;193
Druskininkai mun.;2012;44;350;163;187
Druskininkai mun.;2012;45;351;166;185
Druskininkai mun.;2012;46;338;161;177
Druskininkai mun.;2012;47;356;154;202
Druskininkai mun.;2012;48;381;182;199
Druskininkai mun.;2012;49;385;171;214
Druskininkai mun.;2012;50;390;172;218
Druskininkai mun.;2012;51;397;180;217
Druskininkai mun.;2012;52;407;176;231
Druskininkai mun.;2012;53;396;184;212
Druskininkai mun.;2012;54;330;168;162
Druskininkai mun.;2012;55;308;126;182
Druskininkai mun.;2012;56;288;122;166
Druskininkai mun.;2012;57;240;115;125
Druskininkai mun.;2012;58;244;102;142
Druskininkai mun.;2012;59;303;117;186
Druskininkai mun.;2012;60;247;104;143
Druskininkai mun.;2012;61;301;129;172
Druskininkai mun.;2012;62;265;112;153
Druskininkai mun.;2012;63;229;96;133
Druskininkai mun.;2012;64;242;88;154
Druskininkai mun.;2012;65;208;84;124
Druskininkai mun.;2012;66;267;99;168
Druskininkai mun.;2012;67;223;93;130
Druskininkai mun.;2012;68;230;85;145
Druskininkai mun.;2012;69;271;89;182
Druskininkai mun.;2012;70;225;67;158
Druskininkai mun.;2012;71;244;94;150
Druskininkai mun.;2012;72;241;91;150
Druskininkai mun.;2012;73;245;92;153
Druskininkai mun.;2012;74;231;68;163
Druskininkai mun.;2012;75;243;72;171
Druskininkai mun.;2012;76;217;69;148
Druskininkai mun.;2012;77;177;58;119
Druskininkai mun.;2012;78;192;66;126
Druskininkai mun.;2012;79;155;51;104
Druskininkai mun.;2012;80;175;47;128
Druskininkai mun.;2012;81;149;44;105
Druskininkai mun.;2012;82;141;35;106
Druskininkai mun.;2012;83;132;41;91
Druskininkai mun.;2012;84;106;28;78
Druskininkai mun.;2012;85;410;92;318
Druskininkai mun.;2013;-1;21221;9362;11859
Druskininkai mun.;2013;0;188;82;106
Druskininkai mun.;2013;1;177;92;85
Druskininkai mun.;2013;2;170;84;86
Druskininkai mun.;2013;3;162;89;73
Druskininkai mun.;2013;4;165;78;87
Druskininkai mun.;2013;5;132;61;71
Druskininkai mun.;2013;6;153;74;79
Druskininkai mun.;2013;7;168;86;82
Druskininkai mun.;2013;8;157;83;74
Druskininkai mun.;2013;9;145;73;72
Druskininkai mun.;2013;10;158;75;83
Druskininkai mun.;2013;11;174;85;89
Druskininkai mun.;2013;12;188;86;102
Druskininkai mun.;2013;13;233;115;118
Druskininkai mun.;2013;14;193;99;94
Druskininkai mun.;2013;15;241;113;128
Druskininkai mun.;2013;16;247;132;115
Druskininkai mun.;2013;17;294;146;148
Druskininkai mun.;2013;18;313;173;140
Druskininkai mun.;2013;19;344;157;187
Druskininkai mun.;2013;20;323;142;181
Druskininkai mun.;2013;21;296;159;137
Druskininkai mun.;2013;22;282;142;140
Druskininkai mun.;2013;23;255;124;131
Druskininkai mun.;2013;24;273;144;129
Druskininkai mun.;2013;25;254;136;118
Druskininkai mun.;2013;26;241;126;115
Druskininkai mun.;2013;27;244;108;136
Druskininkai mun.;2013;28;232;120;112
Druskininkai mun.;2013;29;196;98;98
Druskininkai mun.;2013;30;213;97;116
Druskininkai mun.;2013;31;185;94;91
Druskininkai mun.;2013;32;181;91;90
Druskininkai mun.;2013;33;153;88;65
Druskininkai mun.;2013;34;185;104;81
Druskininkai mun.;2013;35;190;88;102
Druskininkai mun.;2013;36;228;107;121
Druskininkai mun.;2013;37;210;103;107
Druskininkai mun.;2013;38;246;127;119
Druskininkai mun.;2013;39;271;115;156
Druskininkai mun.;2013;40;298;147;151
Druskininkai mun.;2013;41;312;142;170
Druskininkai mun.;2013;42;316;140;176
Druskininkai mun.;2013;43;327;160;167
Druskininkai mun.;2013;44;354;162;192
Druskininkai mun.;2013;45;354;169;185
Druskininkai mun.;2013;46;345;164;181
Druskininkai mun.;2013;47;335;159;176
Druskininkai mun.;2013;48;355;154;201
Druskininkai mun.;2013;49;385;182;203
Druskininkai mun.;2013;50;385;173;212
Druskininkai mun.;2013;51;388;168;220
Druskininkai mun.;2013;52;390;176;214
Druskininkai mun.;2013;53;401;171;230
Druskininkai mun.;2013;54;386;175;211
Druskininkai mun.;2013;55;328;164;164
Druskininkai mun.;2013;56;304;124;180
Druskininkai mun.;2013;57;289;122;167
Druskininkai mun.;2013;58;237;111;126
Druskininkai mun.;2013;59;244;101;143
Druskininkai mun.;2013;60;297;112;185
Druskininkai mun.;2013;61;245;104;141
Druskininkai mun.;2013;62;297;127;170
Druskininkai mun.;2013;63;261;109;152
Druskininkai mun.;2013;64;226;93;133
Druskininkai mun.;2013;65;238;83;155
Druskininkai mun.;2013;66;202;81;121
Druskininkai mun.;2013;67;260;95;165
Druskininkai mun.;2013;68;222;92;130
Druskininkai mun.;2013;69;231;85;146
Druskininkai mun.;2013;70;264;85;179
Druskininkai mun.;2013;71;218;63;155
Druskininkai mun.;2013;72;237;90;147
Druskininkai mun.;2013;73;234;87;147
Druskininkai mun.;2013;74;236;87;149
Druskininkai mun.;2013;75;223;63;160
Druskininkai mun.;2013;76;228;64;164
Druskininkai mun.;2013;77;208;68;140
Druskininkai mun.;2013;78;168;53;115
Druskininkai mun.;2013;79;182;60;122
Druskininkai mun.;2013;80;149;49;100
Druskininkai mun.;2013;81;161;40;121
Druskininkai mun.;2013;82;139;42;97
Druskininkai mun.;2013;83;130;29;101
Druskininkai mun.;2013;84;118;35;83
Druskininkai mun.;2013;85;454;106;348
Druskininkai mun.;2014;-1;20943;9241;11702
Druskininkai mun.;2014;0;185;91;94
Druskininkai mun.;2014;1;192;86;106
Druskininkai mun.;2014;2;179;95;84
Druskininkai mun.;2014;3;174;90;84
Druskininkai mun.;2014;4;166;91;75
Druskininkai mun.;2014;5;167;77;90
Druskininkai mun.;2014;6;127;59;68
Druskininkai mun.;2014;7;151;76;75
Druskininkai mun.;2014;8;167;86;81
Druskininkai mun.;2014;9;156;85;71
Druskininkai mun.;2014;10;140;72;68
Druskininkai mun.;2014;11;154;73;81
Druskininkai mun.;2014;12;177;87;90
Druskininkai mun.;2014;13;190;87;103
Druskininkai mun.;2014;14;230;112;118
Druskininkai mun.;2014;15;194;99;95
Druskininkai mun.;2014;16;236;109;127
Druskininkai mun.;2014;17;245;131;114
Druskininkai mun.;2014;18;289;143;146
Druskininkai mun.;2014;19;304;169;135
Druskininkai mun.;2014;20;332;145;187
Druskininkai mun.;2014;21;325;141;184
Druskininkai mun.;2014;22;282;149;133
Druskininkai mun.;2014;23;254;135;119
Druskininkai mun.;2014;24;237;121;116
Druskininkai mun.;2014;25;267;134;133
Druskininkai mun.;2014;26;249;132;117
Druskininkai mun.;2014;27;225;121;104
Druskininkai mun.;2014;28;232;103;129
Druskininkai mun.;2014;29;237;118;119
Druskininkai mun.;2014;30;193;98;95
Druskininkai mun.;2014;31;205;95;110
Druskininkai mun.;2014;32;176;93;83
Druskininkai mun.;2014;33;183;90;93
Druskininkai mun.;2014;34;155;87;68
Druskininkai mun.;2014;35;187;102;85
Druskininkai mun.;2014;36;194;87;107
Druskininkai mun.;2014;37;220;100;120
Druskininkai mun.;2014;38;215;107;108
Druskininkai mun.;2014;39;247;130;117
Druskininkai mun.;2014;40;263;112;151
Druskininkai mun.;2014;41;300;148;152
Druskininkai mun.;2014;42;301;131;170
Druskininkai mun.;2014;43;314;136;178
Druskininkai mun.;2014;44;324;157;167
Druskininkai mun.;2014;45;346;157;189
Druskininkai mun.;2014;46;355;170;185
Druskininkai mun.;2014;47;341;161;180
Druskininkai mun.;2014;48;338;162;176
Druskininkai mun.;2014;49;349;151;198
Druskininkai mun.;2014;50;383;180;203
Druskininkai mun.;2014;51;378;169;209
Druskininkai mun.;2014;52;387;168;219
Druskininkai mun.;2014;53;382;173;209
Druskininkai mun.;2014;54;396;169;227
Druskininkai mun.;2014;55;379;171;208
Druskininkai mun.;2014;56;329;164;165
Druskininkai mun.;2014;57;305;124;181
Druskininkai mun.;2014;58;283;117;166
Druskininkai mun.;2014;59;237;112;125
Druskininkai mun.;2014;60;241;98;143
Druskininkai mun.;2014;61;298;110;188
Druskininkai mun.;2014;62;241;103;138
Druskininkai mun.;2014;63;289;123;166
Druskininkai mun.;2014;64;256;107;149
Druskininkai mun.;2014;65;220;91;129
Druskininkai mun.;2014;66;229;78;151
Druskininkai mun.;2014;67;197;80;117
Druskininkai mun.;2014;68;246;89;157
Druskininkai mun.;2014;69;217;91;126
Druskininkai mun.;2014;70;224;82;142
Druskininkai mun.;2014;71;260;81;179
Druskininkai mun.;2014;72;210;58;152
Druskininkai mun.;2014;73;228;85;143
Druskininkai mun.;2014;74;224;84;140
Druskininkai mun.;2014;75;223;80;143
Druskininkai mun.;2014;76;222;64;158
Druskininkai mun.;2014;77;221;61;160
Druskininkai mun.;2014;78;197;62;135
Druskininkai mun.;2014;79;161;50;111
Druskininkai mun.;2014;80;174;59;115
Druskininkai mun.;2014;81;141;46;95
Druskininkai mun.;2014;82;152;37;115
Druskininkai mun.;2014;83;128;39;89
Druskininkai mun.;2014;84;115;19;96
Druskininkai mun.;2014;85;501;126;375
Druskininkai mun.;2015;-1;20728;9119;11609
Druskininkai mun.;2015;0;186;98;88
Druskininkai mun.;2015;1;191;94;97
Druskininkai mun.;2015;2;190;85;105
Druskininkai mun.;2015;3;181;93;88
Druskininkai mun.;2015;4;168;85;83
Druskininkai mun.;2015;5;165;89;76
Druskininkai mun.;2015;6;165;78;87
Druskininkai mun.;2015;7;125;58;67
Druskininkai mun.;2015;8;150;77;73
Druskininkai mun.;2015;9;163;84;79
Druskininkai mun.;2015;10;155;84;71
Druskininkai mun.;2015;11;142;73;69
Druskininkai mun.;2015;12;158;76;82
Druskininkai mun.;2015;13;178;87;91
Druskininkai mun.;2015;14;191;90;101
Druskininkai mun.;2015;15;228;112;116
Druskininkai mun.;2015;16;192;99;93
Druskininkai mun.;2015;17;239;110;129
Druskininkai mun.;2015;18;243;132;111
Druskininkai mun.;2015;19;285;142;143
Druskininkai mun.;2015;20;296;162;134
Druskininkai mun.;2015;21;325;142;183
Druskininkai mun.;2015;22;317;140;177
Druskininkai mun.;2015;23;260;141;119
Druskininkai mun.;2015;24;252;131;121
Druskininkai mun.;2015;25;228;114;114
Druskininkai mun.;2015;26;255;129;126
Druskininkai mun.;2015;27;245;130;115
Druskininkai mun.;2015;28;211;112;99
Druskininkai mun.;2015;29;225;102;123
Druskininkai mun.;2015;30;225;110;115
Druskininkai mun.;2015;31;198;97;101
Druskininkai mun.;2015;32;187;86;101
Druskininkai mun.;2015;33;182;92;90
Druskininkai mun.;2015;34;180;87;93
Druskininkai mun.;2015;35;156;86;70
Druskininkai mun.;2015;36;191;103;88
Druskininkai mun.;2015;37;195;84;111
Druskininkai mun.;2015;38;218;96;122
Druskininkai mun.;2015;39;211;105;106
Druskininkai mun.;2015;40;244;128;116
Druskininkai mun.;2015;41;259;108;151
Druskininkai mun.;2015;42;302;145;157
Druskininkai mun.;2015;43;299;130;169
Druskininkai mun.;2015;44;307;133;174
Druskininkai mun.;2015;45;321;157;164
Druskininkai mun.;2015;46;344;155;189
Druskininkai mun.;2015;47;357;172;185
Druskininkai mun.;2015;48;336;156;180
Druskininkai mun.;2015;49;334;160;174
Druskininkai mun.;2015;50;347;148;199
Druskininkai mun.;2015;51;388;185;203
Druskininkai mun.;2015;52;373;165;208
Druskininkai mun.;2015;53;396;171;225
Druskininkai mun.;2015;54;381;172;209
Druskininkai mun.;2015;55;390;164;226
Druskininkai mun.;2015;56;377;170;207
Druskininkai mun.;2015;57;326;158;168
Druskininkai mun.;2015;58;307;124;183
Druskininkai mun.;2015;59;283;115;168
Druskininkai mun.;2015;60;234;107;127
Druskininkai mun.;2015;61;239;98;141
Druskininkai mun.;2015;62;293;106;187
Druskininkai mun.;2015;63;241;100;141
Druskininkai mun.;2015;64;282;120;162
Druskininkai mun.;2015;65;255;106;149
Druskininkai mun.;2015;66;217;89;128
Druskininkai mun.;2015;67;229;78;151
Druskininkai mun.;2015;68;195;76;119
Druskininkai mun.;2015;69;245;88;157
Druskininkai mun.;2015;70;211;89;122
Druskininkai mun.;2015;71;223;79;144
Druskininkai mun.;2015;72;251;78;173
Druskininkai mun.;2015;73;205;55;150
Druskininkai mun.;2015;74;216;77;139
Druskininkai mun.;2015;75;213;80;133
Druskininkai mun.;2015;76;213;75;138
Druskininkai mun.;2015;77;214;60;154
Druskininkai mun.;2015;78;212;59;153
Druskininkai mun.;2015;79;188;59;129
Druskininkai mun.;2015;80;152;48;104
Druskininkai mun.;2015;81;166;55;111
Druskininkai mun.;2015;82;132;43;89
Druskininkai mun.;2015;83;141;35;106
Druskininkai mun.;2015;84;118;35;83
Druskininkai mun.;2015;85;520;113;407
Druskininkai mun.;2016;-1;20400;8938;11462
Druskininkai mun.;2016;0;211;97;114
Druskininkai mun.;2016;1;187;100;87
Druskininkai mun.;2016;2;183;91;92
Druskininkai mun.;2016;3;191;85;106
Druskininkai mun.;2016;4;182;94;88
Druskininkai mun.;2016;5;173;88;85
Druskininkai mun.;2016;6;160;86;74
Druskininkai mun.;2016;7;165;77;88
Druskininkai mun.;2016;8;127;62;65
Druskininkai mun.;2016;9;145;76;69
Druskininkai mun.;2016;10;162;85;77
Druskininkai mun.;2016;11;153;83;70
Druskininkai mun.;2016;12;144;72;72
Druskininkai mun.;2016;13;157;75;82
Druskininkai mun.;2016;14;185;91;94
Druskininkai mun.;2016;15;189;88;101
Druskininkai mun.;2016;16;230;111;119
Druskininkai mun.;2016;17;191;97;94
Druskininkai mun.;2016;18;235;105;130
Druskininkai mun.;2016;19;238;129;109
Druskininkai mun.;2016;20;282;140;142
Druskininkai mun.;2016;21;296;157;139
Druskininkai mun.;2016;22;316;138;178
Druskininkai mun.;2016;23;304;130;174
Druskininkai mun.;2016;24;254;136;118
Druskininkai mun.;2016;25;238;121;117
Druskininkai mun.;2016;26;212;109;103
Druskininkai mun.;2016;27;244;127;117
Druskininkai mun.;2016;28;234;124;110
Druskininkai mun.;2016;29;209;111;98
Druskininkai mun.;2016;30;205;91;114
Druskininkai mun.;2016;31;217;109;108
Druskininkai mun.;2016;32;190;89;101
Druskininkai mun.;2016;33;184;82;102
Druskininkai mun.;2016;34;169;87;82
Druskininkai mun.;2016;35;178;87;91
Druskininkai mun.;2016;36;154;88;66
Druskininkai mun.;2016;37;192;105;87
Druskininkai mun.;2016;38;188;80;108
Druskininkai mun.;2016;39;215;98;117
Druskininkai mun.;2016;40;211;106;105
Druskininkai mun.;2016;41;239;125;114
Druskininkai mun.;2016;42;254;110;144
Druskininkai mun.;2016;43;291;138;153
Druskininkai mun.;2016;44;295;131;164
Druskininkai mun.;2016;45;310;131;179
Druskininkai mun.;2016;46;313;148;165
Druskininkai mun.;2016;47;337;152;185
Druskininkai mun.;2016;48;348;168;180
Druskininkai mun.;2016;49;333;152;181
Druskininkai mun.;2016;50;330;153;177
Druskininkai mun.;2016;51;344;143;201
Druskininkai mun.;2016;52;377;176;201
Druskininkai mun.;2016;53;369;164;205
Druskininkai mun.;2016;54;386;166;220
Druskininkai mun.;2016;55;376;169;207
Druskininkai mun.;2016;56;383;160;223
Druskininkai mun.;2016;57;367;166;201
Druskininkai mun.;2016;58;315;150;165
Druskininkai mun.;2016;59;301;122;179
Druskininkai mun.;2016;60;277;110;167
Druskininkai mun.;2016;61;227;104;123
Druskininkai mun.;2016;62;238;97;141
Druskininkai mun.;2016;63;292;106;186
Druskininkai mun.;2016;64;234;97;137
Druskininkai mun.;2016;65;274;116;158
Druskininkai mun.;2016;66;248;101;147
Druskininkai mun.;2016;67;211;85;126
Druskininkai mun.;2016;68;225;75;150
Druskininkai mun.;2016;69;191;74;117
Druskininkai mun.;2016;70;236;83;153
Druskininkai mun.;2016;71;208;86;122
Druskininkai mun.;2016;72;216;73;143
Druskininkai mun.;2016;73;246;75;171
Druskininkai mun.;2016;74;199;51;148
Druskininkai mun.;2016;75;204;71;133
Druskininkai mun.;2016;76;208;76;132
Druskininkai mun.;2016;77;207;72;135
Druskininkai mun.;2016;78;208;57;151
Druskininkai mun.;2016;79;205;55;150
Druskininkai mun.;2016;80;176;54;122
Druskininkai mun.;2016;81;146;47;99
Druskininkai mun.;2016;82;149;46;103
Druskininkai mun.;2016;83;118;36;82
Druskininkai mun.;2016;84;123;31;92
Druskininkai mun.;2016;85;566;129;437
Druskininkai mun.;2017;-1;20041;8756;11285
Druskininkai mun.;2017;0;199;113;86
Druskininkai mun.;2017;1;207;95;112
Druskininkai mun.;2017;2;175;88;87
Druskininkai mun.;2017;3;184;91;93
Druskininkai mun.;2017;4;190;87;103
Druskininkai mun.;2017;5;178;92;86
Druskininkai mun.;2017;6;169;85;84
Druskininkai mun.;2017;7;153;84;69
Druskininkai mun.;2017;8;162;75;87
Druskininkai mun.;2017;9;123;59;64
Druskininkai mun.;2017;10;149;78;71
Druskininkai mun.;2017;11;160;84;76
Druskininkai mun.;2017;12;156;83;73
Druskininkai mun.;2017;13;145;71;74
Druskininkai mun.;2017;14;153;74;79
Druskininkai mun.;2017;15;186;93;93
Druskininkai mun.;2017;16;186;88;98
Druskininkai mun.;2017;17;231;111;120
Druskininkai mun.;2017;18;186;97;89
Druskininkai mun.;2017;19;220;97;123
Druskininkai mun.;2017;20;230;126;104
Druskininkai mun.;2017;21;274;134;140
Druskininkai mun.;2017;22;294;156;138
Druskininkai mun.;2017;23;297;132;165
Druskininkai mun.;2017;24;292;128;164
Druskininkai mun.;2017;25;232;125;107
Druskininkai mun.;2017;26;218;119;99
Druskininkai mun.;2017;27;209;105;104
Druskininkai mun.;2017;28;230;118;112
Druskininkai mun.;2017;29;237;124;113
Druskininkai mun.;2017;30;193;98;95
Druskininkai mun.;2017;31;190;85;105
Druskininkai mun.;2017;32;198;101;97
Druskininkai mun.;2017;33;186;86;100
Druskininkai mun.;2017;34;181;82;99
Druskininkai mun.;2017;35;164;79;85
Druskininkai mun.;2017;36;175;83;92
Druskininkai mun.;2017;37;146;83;63
Druskininkai mun.;2017;38;184;100;84
Druskininkai mun.;2017;39;189;81;108
Druskininkai mun.;2017;40;215;100;115
Druskininkai mun.;2017;41;213;104;109
Druskininkai mun.;2017;42;239;128;111
Druskininkai mun.;2017;43;249;104;145
Druskininkai mun.;2017;44;291;141;150
Druskininkai mun.;2017;45;284;126;158
Druskininkai mun.;2017;46;308;132;176
Druskininkai mun.;2017;47;315;149;166
Druskininkai mun.;2017;48;331;144;187
Druskininkai mun.;2017;49;344;165;179
Druskininkai mun.;2017;50;328;145;183
Druskininkai mun.;2017;51;329;152;177
Druskininkai mun.;2017;52;337;139;198
Druskininkai mun.;2017;53;373;174;199
Druskininkai mun.;2017;54;360;157;203
Druskininkai mun.;2017;55;376;163;213
Druskininkai mun.;2017;56;375;168;207
Druskininkai mun.;2017;57;385;162;223
Druskininkai mun.;2017;58;367;165;202
Druskininkai mun.;2017;59;305;144;161
Druskininkai mun.;2017;60;298;119;179
Druskininkai mun.;2017;61;271;99;172
Druskininkai mun.;2017;62;222;102;120
Druskininkai mun.;2017;63;235;94;141
Druskininkai mun.;2017;64;281;99;182
Druskininkai mun.;2017;65;230;94;136
Druskininkai mun.;2017;66;273;114;159
Druskininkai mun.;2017;67;245;97;148
Druskininkai mun.;2017;68;211;86;125
Druskininkai mun.;2017;69;221;72;149
Druskininkai mun.;2017;70;189;70;119
Druskininkai mun.;2017;71;235;80;155
Druskininkai mun.;2017;72;201;79;122
Druskininkai mun.;2017;73;209;71;138
Druskininkai mun.;2017;74;235;71;164
Druskininkai mun.;2017;75;194;47;147
Druskininkai mun.;2017;76;202;69;133
Druskininkai mun.;2017;77;201;71;130
Druskininkai mun.;2017;78;201;66;135
Druskininkai mun.;2017;79;203;56;147
Druskininkai mun.;2017;80;194;51;143
Druskininkai mun.;2017;81;159;47;112
Druskininkai mun.;2017;82;134;43;91
Druskininkai mun.;2017;83;135;39;96
Druskininkai mun.;2017;84;112;33;79
Druskininkai mun.;2017;85;595;135;460
Druskininkai mun.;2018;-1;19605;8578;11027
Druskininkai mun.;2018;0;169;85;84
Druskininkai mun.;2018;1;200;115;85
Druskininkai mun.;2018;2;206;95;111
Druskininkai mun.;2018;3;178;89;89
Druskininkai mun.;2018;4;184;90;94
Druskininkai mun.;2018;5;193;88;105
Druskininkai mun.;2018;6;179;93;86
Druskininkai mun.;2018;7;172;86;86
Druskininkai mun.;2018;8;151;83;68
Druskininkai mun.;2018;9;158;72;86
Druskininkai mun.;2018;10;119;58;61
Druskininkai mun.;2018;11;147;77;70
Druskininkai mun.;2018;12;158;85;73
Druskininkai mun.;2018;13;158;82;76
Druskininkai mun.;2018;14;141;68;73
Druskininkai mun.;2018;15;153;74;79
Druskininkai mun.;2018;16;184;92;92
Druskininkai mun.;2018;17;185;90;95
Druskininkai mun.;2018;18;226;113;113
Druskininkai mun.;2018;19;166;87;79
Druskininkai mun.;2018;20;210;95;115
Druskininkai mun.;2018;21;216;116;100
Druskininkai mun.;2018;22;260;129;131
Druskininkai mun.;2018;23;275;143;132
Druskininkai mun.;2018;24;269;121;148
Druskininkai mun.;2018;25;269;119;150
Druskininkai mun.;2018;26;227;127;100
Druskininkai mun.;2018;27;194;109;85
Druskininkai mun.;2018;28;194;98;96
Druskininkai mun.;2018;29;213;117;96
Druskininkai mun.;2018;30;218;118;100
Druskininkai mun.;2018;31;183;97;86
Druskininkai mun.;2018;32;176;78;98
Druskininkai mun.;2018;33;192;104;88
Druskininkai mun.;2018;34;182;84;98
Druskininkai mun.;2018;35;178;80;98
Druskininkai mun.;2018;36;163;79;84
Druskininkai mun.;2018;37;166;80;86
Druskininkai mun.;2018;38;146;82;64
Druskininkai mun.;2018;39;175;91;84
Druskininkai mun.;2018;40;179;77;102
Druskininkai mun.;2018;41;210;98;112
Druskininkai mun.;2018;42;212;106;106
Druskininkai mun.;2018;43;231;123;108
Druskininkai mun.;2018;44;251;106;145
Druskininkai mun.;2018;45;287;139;148
Druskininkai mun.;2018;46;279;123;156
Druskininkai mun.;2018;47;306;132;174
Druskininkai mun.;2018;48;311;148;163
Druskininkai mun.;2018;49;326;143;183
Druskininkai mun.;2018;50;347;165;182
Druskininkai mun.;2018;51;323;141;182
Druskininkai mun.;2018;52;322;148;174
Druskininkai mun.;2018;53;338;138;200
Druskininkai mun.;2018;54;367;169;198
Druskininkai mun.;2018;55;358;157;201
Druskininkai mun.;2018;56;376;163;213
Druskininkai mun.;2018;57;371;165;206
Druskininkai mun.;2018;58;385;163;222
Druskininkai mun.;2018;59;369;164;205
Druskininkai mun.;2018;60;299;143;156
Druskininkai mun.;2018;61;298;120;178
Druskininkai mun.;2018;62;269;98;171
Druskininkai mun.;2018;63;223;99;124
Druskininkai mun.;2018;64;230;90;140
Druskininkai mun.;2018;65;281;99;182
Druskininkai mun.;2018;66;230;93;137
Druskininkai mun.;2018;67;270;113;157
Druskininkai mun.;2018;68;236;92;144
Druskininkai mun.;2018;69;209;83;126
Druskininkai mun.;2018;70;217;68;149
Druskininkai mun.;2018;71;183;65;118
Druskininkai mun.;2018;72;228;74;154
Druskininkai mun.;2018;73;199;79;120
Druskininkai mun.;2018;74;203;68;135
Druskininkai mun.;2018;75;230;66;164
Druskininkai mun.;2018;76;189;46;143
Druskininkai mun.;2018;77;198;66;132
Druskininkai mun.;2018;78;192;65;127
Druskininkai mun.;2018;79;189;58;131
Druskininkai mun.;2018;80;179;45;134
Druskininkai mun.;2018;81;180;46;134
Druskininkai mun.;2018;82;149;43;106
Druskininkai mun.;2018;83;118;32;86
Druskininkai mun.;2018;84;125;36;89
Druskininkai mun.;2018;85;600;134;466
Elektrėnai mun.;2001;-1;28976;13898;15078
Elektrėnai mun.;2001;0;278;132;146
Elektrėnai mun.;2001;1;278;148;130
Elektrėnai mun.;2001;2;294;153;141
Elektrėnai mun.;2001;3;339;184;155
Elektrėnai mun.;2001;4;291;142;149
Elektrėnai mun.;2001;5;295;156;139
Elektrėnai mun.;2001;6;301;156;145
Elektrėnai mun.;2001;7;359;178;181
Elektrėnai mun.;2001;8;423;222;201
Elektrėnai mun.;2001;9;472;246;226
Elektrėnai mun.;2001;10;477;245;232
Elektrėnai mun.;2001;11;459;251;208
Elektrėnai mun.;2001;12;490;259;231
Elektrėnai mun.;2001;13;521;275;246
Elektrėnai mun.;2001;14;489;250;239
Elektrėnai mun.;2001;15;552;262;290
Elektrėnai mun.;2001;16;471;236;235
Elektrėnai mun.;2001;17;492;265;227
Elektrėnai mun.;2001;18;405;230;175
Elektrėnai mun.;2001;19;380;217;163
Elektrėnai mun.;2001;20;352;197;155
Elektrėnai mun.;2001;21;348;171;177
Elektrėnai mun.;2001;22;332;177;155
Elektrėnai mun.;2001;23;320;171;149
Elektrėnai mun.;2001;24;327;160;167
Elektrėnai mun.;2001;25;339;186;153
Elektrėnai mun.;2001;26;366;193;173
Elektrėnai mun.;2001;27;398;205;193
Elektrėnai mun.;2001;28;407;201;206
Elektrėnai mun.;2001;29;412;200;212
Elektrėnai mun.;2001;30;451;244;207
Elektrėnai mun.;2001;31;380;183;197
Elektrėnai mun.;2001;32;414;213;201
Elektrėnai mun.;2001;33;403;179;224
Elektrėnai mun.;2001;34;426;230;196
Elektrėnai mun.;2001;35;440;220;220
Elektrėnai mun.;2001;36;450;225;225
Elektrėnai mun.;2001;37;437;219;218
Elektrėnai mun.;2001;38;541;276;265
Elektrėnai mun.;2001;39;537;260;277
Elektrėnai mun.;2001;40;546;263;283
Elektrėnai mun.;2001;41;514;240;274
Elektrėnai mun.;2001;42;479;244;235
Elektrėnai mun.;2001;43;447;227;220
Elektrėnai mun.;2001;44;434;205;229
Elektrėnai mun.;2001;45;372;182;190
Elektrėnai mun.;2001;46;381;186;195
Elektrėnai mun.;2001;47;348;189;159
Elektrėnai mun.;2001;48;348;158;190
Elektrėnai mun.;2001;49;349;150;199
Elektrėnai mun.;2001;50;338;172;166
Elektrėnai mun.;2001;51;360;176;184
Elektrėnai mun.;2001;52;304;147;157
Elektrėnai mun.;2001;53;279;126;153
Elektrėnai mun.;2001;54;305;139;166
Elektrėnai mun.;2001;55;329;155;174
Elektrėnai mun.;2001;56;256;119;137
Elektrėnai mun.;2001;57;347;142;205
Elektrėnai mun.;2001;58;380;157;223
Elektrėnai mun.;2001;59;330;162;168
Elektrėnai mun.;2001;60;332;164;168
Elektrėnai mun.;2001;61;310;141;169
Elektrėnai mun.;2001;62;368;165;203
Elektrėnai mun.;2001;63;317;128;189
Elektrėnai mun.;2001;64;344;155;189
Elektrėnai mun.;2001;65;288;110;178
Elektrėnai mun.;2001;66;293;122;171
Elektrėnai mun.;2001;67;252;88;164
Elektrėnai mun.;2001;68;297;127;170
Elektrėnai mun.;2001;69;252;94;158
Elektrėnai mun.;2001;70;251;103;148
Elektrėnai mun.;2001;71;202;66;136
Elektrėnai mun.;2001;72;196;68;128
Elektrėnai mun.;2001;73;227;85;142
Elektrėnai mun.;2001;74;195;62;133
Elektrėnai mun.;2001;75;157;45;112
Elektrėnai mun.;2001;76;155;43;112
Elektrėnai mun.;2001;77;142;39;103
Elektrėnai mun.;2001;78;113;42;71
Elektrėnai mun.;2001;79;95;35;60
Elektrėnai mun.;2001;80;94;32;62
Elektrėnai mun.;2001;81;66;16;50
Elektrėnai mun.;2001;82;48;13;35
Elektrėnai mun.;2001;83;57;16;41
Elektrėnai mun.;2001;84;47;13;34
Elektrėnai mun.;2001;85;286;70;216
Elektrėnai mun.;2002;-1;28576;13641;14935
Elektrėnai mun.;2002;0;228;112;116
Elektrėnai mun.;2002;1;278;133;145
Elektrėnai mun.;2002;2;277;146;131
Elektrėnai mun.;2002;3;293;153;140
Elektrėnai mun.;2002;4;337;182;155
Elektrėnai mun.;2002;5;292;141;151
Elektrėnai mun.;2002;6;291;154;137
Elektrėnai mun.;2002;7;296;150;146
Elektrėnai mun.;2002;8;357;177;180
Elektrėnai mun.;2002;9;421;219;202
Elektrėnai mun.;2002;10;466;244;222
Elektrėnai mun.;2002;11;470;240;230
Elektrėnai mun.;2002;12;456;248;208
Elektrėnai mun.;2002;13;476;251;225
Elektrėnai mun.;2002;14;513;271;242
Elektrėnai mun.;2002;15;484;247;237
Elektrėnai mun.;2002;16;548;261;287
Elektrėnai mun.;2002;17;462;232;230
Elektrėnai mun.;2002;18;483;256;227
Elektrėnai mun.;2002;19;393;223;170
Elektrėnai mun.;2002;20;372;214;158
Elektrėnai mun.;2002;21;349;194;155
Elektrėnai mun.;2002;22;344;165;179
Elektrėnai mun.;2002;23;317;166;151
Elektrėnai mun.;2002;24;314;168;146
Elektrėnai mun.;2002;25;327;160;167
Elektrėnai mun.;2002;26;332;181;151
Elektrėnai mun.;2002;27;364;190;174
Elektrėnai mun.;2002;28;383;195;188
Elektrėnai mun.;2002;29;396;192;204
Elektrėnai mun.;2002;30;402;199;203
Elektrėnai mun.;2002;31;442;237;205
Elektrėnai mun.;2002;32;370;176;194
Elektrėnai mun.;2002;33;408;208;200
Elektrėnai mun.;2002;34;399;179;220
Elektrėnai mun.;2002;35;418;222;196
Elektrėnai mun.;2002;36;428;214;214
Elektrėnai mun.;2002;37;446;223;223
Elektrėnai mun.;2002;38;431;215;216
Elektrėnai mun.;2002;39;525;265;260
Elektrėnai mun.;2002;40;525;252;273
Elektrėnai mun.;2002;41;538;257;281
Elektrėnai mun.;2002;42;509;238;271
Elektrėnai mun.;2002;43;476;243;233
Elektrėnai mun.;2002;44;443;224;219
Elektrėnai mun.;2002;45;421;199;222
Elektrėnai mun.;2002;46;367;178;189
Elektrėnai mun.;2002;47;377;185;192
Elektrėnai mun.;2002;48;337;181;156
Elektrėnai mun.;2002;49;337;154;183
Elektrėnai mun.;2002;50;344;145;199
Elektrėnai mun.;2002;51;331;167;164
Elektrėnai mun.;2002;52;354;171;183
Elektrėnai mun.;2002;53;294;141;153
Elektrėnai mun.;2002;54;272;123;149
Elektrėnai mun.;2002;55;294;134;160
Elektrėnai mun.;2002;56;317;150;167
Elektrėnai mun.;2002;57;253;119;134
Elektrėnai mun.;2002;58;331;133;198
Elektrėnai mun.;2002;59;372;151;221
Elektrėnai mun.;2002;60;326;160;166
Elektrėnai mun.;2002;61;320;155;165
Elektrėnai mun.;2002;62;301;140;161
Elektrėnai mun.;2002;63;358;157;201
Elektrėnai mun.;2002;64;313;124;189
Elektrėnai mun.;2002;65;345;152;193
Elektrėnai mun.;2002;66;288;107;181
Elektrėnai mun.;2002;67;285;119;166
Elektrėnai mun.;2002;68;245;80;165
Elektrėnai mun.;2002;69;281;117;164
Elektrėnai mun.;2002;70;246;90;156
Elektrėnai mun.;2002;71;243;99;144
Elektrėnai mun.;2002;72;193;62;131
Elektrėnai mun.;2002;73;187;63;124
Elektrėnai mun.;2002;74;219;81;138
Elektrėnai mun.;2002;75;195;63;132
Elektrėnai mun.;2002;76;147;38;109
Elektrėnai mun.;2002;77;148;39;109
Elektrėnai mun.;2002;78;138;37;101
Elektrėnai mun.;2002;79;109;40;69
Elektrėnai mun.;2002;80;89;32;57
Elektrėnai mun.;2002;81;82;28;54
Elektrėnai mun.;2002;82;62;16;46
Elektrėnai mun.;2002;83;44;12;32
Elektrėnai mun.;2002;84;53;14;39
Elektrėnai mun.;2002;85;279;68;211
Elektrėnai mun.;2003;-1;28333;13468;14865
Elektrėnai mun.;2003;0;207;103;104
Elektrėnai mun.;2003;1;223;107;116
Elektrėnai mun.;2003;2;273;129;144
Elektrėnai mun.;2003;3;278;148;130
Elektrėnai mun.;2003;4;287;148;139
Elektrėnai mun.;2003;5;331;180;151
Elektrėnai mun.;2003;6;289;139;150
Elektrėnai mun.;2003;7;286;151;135
Elektrėnai mun.;2003;8;290;148;142
Elektrėnai mun.;2003;9;355;177;178
Elektrėnai mun.;2003;10;419;216;203
Elektrėnai mun.;2003;11;460;240;220
Elektrėnai mun.;2003;12;468;241;227
Elektrėnai mun.;2003;13;453;246;207
Elektrėnai mun.;2003;14;463;244;219
Elektrėnai mun.;2003;15;505;266;239
Elektrėnai mun.;2003;16;480;244;236
Elektrėnai mun.;2003;17;539;253;286
Elektrėnai mun.;2003;18;450;227;223
Elektrėnai mun.;2003;19;475;249;226
Elektrėnai mun.;2003;20;386;220;166
Elektrėnai mun.;2003;21;370;211;159
Elektrėnai mun.;2003;22;349;193;156
Elektrėnai mun.;2003;23;349;167;182
Elektrėnai mun.;2003;24;318;165;153
Elektrėnai mun.;2003;25;318;169;149
Elektrėnai mun.;2003;26;325;159;166
Elektrėnai mun.;2003;27;325;179;146
Elektrėnai mun.;2003;28;357;184;173
Elektrėnai mun.;2003;29;387;197;190
Elektrėnai mun.;2003;30;385;187;198
Elektrėnai mun.;2003;31;388;188;200
Elektrėnai mun.;2003;32;440;236;204
Elektrėnai mun.;2003;33;365;175;190
Elektrėnai mun.;2003;34;406;206;200
Elektrėnai mun.;2003;35;387;170;217
Elektrėnai mun.;2003;36;415;222;193
Elektrėnai mun.;2003;37;423;211;212
Elektrėnai mun.;2003;38;435;217;218
Elektrėnai mun.;2003;39;426;213;213
Elektrėnai mun.;2003;40;518;262;256
Elektrėnai mun.;2003;41;522;249;273
Elektrėnai mun.;2003;42;536;255;281
Elektrėnai mun.;2003;43;511;238;273
Elektrėnai mun.;2003;44;477;243;234
Elektrėnai mun.;2003;45;441;224;217
Elektrėnai mun.;2003;46;416;194;222
Elektrėnai mun.;2003;47;363;176;187
Elektrėnai mun.;2003;48;373;185;188
Elektrėnai mun.;2003;49;329;174;155
Elektrėnai mun.;2003;50;337;153;184
Elektrėnai mun.;2003;51;337;139;198
Elektrėnai mun.;2003;52;322;161;161
Elektrėnai mun.;2003;53;353;169;184
Elektrėnai mun.;2003;54;291;139;152
Elektrėnai mun.;2003;55;268;118;150
Elektrėnai mun.;2003;56;287;127;160
Elektrėnai mun.;2003;57;312;149;163
Elektrėnai mun.;2003;58;248;115;133
Elektrėnai mun.;2003;59;330;132;198
Elektrėnai mun.;2003;60;361;146;215
Elektrėnai mun.;2003;61;317;151;166
Elektrėnai mun.;2003;62;317;154;163
Elektrėnai mun.;2003;63;296;137;159
Elektrėnai mun.;2003;64;361;159;202
Elektrėnai mun.;2003;65;309;124;185
Elektrėnai mun.;2003;66;337;146;191
Elektrėnai mun.;2003;67;280;104;176
Elektrėnai mun.;2003;68;278;117;161
Elektrėnai mun.;2003;69;240;77;163
Elektrėnai mun.;2003;70;274;114;160
Elektrėnai mun.;2003;71;240;84;156
Elektrėnai mun.;2003;72;240;95;145
Elektrėnai mun.;2003;73;189;61;128
Elektrėnai mun.;2003;74;175;58;117
Elektrėnai mun.;2003;75;217;79;138
Elektrėnai mun.;2003;76;189;58;131
Elektrėnai mun.;2003;77;142;36;106
Elektrėnai mun.;2003;78;143;35;108
Elektrėnai mun.;2003;79;129;35;94
Elektrėnai mun.;2003;80;107;41;66
Elektrėnai mun.;2003;81;80;24;56
Elektrėnai mun.;2003;82;77;25;52
Elektrėnai mun.;2003;83;59;10;49
Elektrėnai mun.;2003;84;41;11;30
Elektrėnai mun.;2003;85;279;60;219
Elektrėnai mun.;2004;-1;28015;13286;14729
Elektrėnai mun.;2004;0;220;103;117
Elektrėnai mun.;2004;1;204;102;102
Elektrėnai mun.;2004;2;223;107;116
Elektrėnai mun.;2004;3;278;132;146
Elektrėnai mun.;2004;4;278;146;132
Elektrėnai mun.;2004;5;283;147;136
Elektrėnai mun.;2004;6;328;179;149
Elektrėnai mun.;2004;7;291;140;151
Elektrėnai mun.;2004;8;286;151;135
Elektrėnai mun.;2004;9;290;148;142
Elektrėnai mun.;2004;10;355;177;178
Elektrėnai mun.;2004;11;415;214;201
Elektrėnai mun.;2004;12;460;240;220
Elektrėnai mun.;2004;13;463;239;224
Elektrėnai mun.;2004;14;448;241;207
Elektrėnai mun.;2004;15;461;244;217
Elektrėnai mun.;2004;16;499;264;235
Elektrėnai mun.;2004;17;472;242;230
Elektrėnai mun.;2004;18;525;247;278
Elektrėnai mun.;2004;19;443;224;219
Elektrėnai mun.;2004;20;470;246;224
Elektrėnai mun.;2004;21;380;217;163
Elektrėnai mun.;2004;22;359;204;155
Elektrėnai mun.;2004;23;343;195;148
Elektrėnai mun.;2004;24;349;164;185
Elektrėnai mun.;2004;25;310;164;146
Elektrėnai mun.;2004;26;303;164;139
Elektrėnai mun.;2004;27;317;156;161
Elektrėnai mun.;2004;28;324;175;149
Elektrėnai mun.;2004;29;347;178;169
Elektrėnai mun.;2004;30;376;191;185
Elektrėnai mun.;2004;31;384;184;200
Elektrėnai mun.;2004;32;374;181;193
Elektrėnai mun.;2004;33;428;230;198
Elektrėnai mun.;2004;34;361;173;188
Elektrėnai mun.;2004;35;403;207;196
Elektrėnai mun.;2004;36;384;167;217
Elektrėnai mun.;2004;37;408;218;190
Elektrėnai mun.;2004;38;421;207;214
Elektrėnai mun.;2004;39;431;212;219
Elektrėnai mun.;2004;40;421;212;209
Elektrėnai mun.;2004;41;509;258;251
Elektrėnai mun.;2004;42;508;242;266
Elektrėnai mun.;2004;43;530;250;280
Elektrėnai mun.;2004;44;502;235;267
Elektrėnai mun.;2004;45;472;240;232
Elektrėnai mun.;2004;46;432;221;211
Elektrėnai mun.;2004;47;410;192;218
Elektrėnai mun.;2004;48;354;169;185
Elektrėnai mun.;2004;49;363;179;184
Elektrėnai mun.;2004;50;323;170;153
Elektrėnai mun.;2004;51;334;153;181
Elektrėnai mun.;2004;52;325;135;190
Elektrėnai mun.;2004;53;317;157;160
Elektrėnai mun.;2004;54;351;171;180
Elektrėnai mun.;2004;55;283;132;151
Elektrėnai mun.;2004;56;268;116;152
Elektrėnai mun.;2004;57;280;127;153
Elektrėnai mun.;2004;58;308;148;160
Elektrėnai mun.;2004;59;246;115;131
Elektrėnai mun.;2004;60;325;126;199
Elektrėnai mun.;2004;61;353;142;211
Elektrėnai mun.;2004;62;309;143;166
Elektrėnai mun.;2004;63;313;149;164
Elektrėnai mun.;2004;64;291;137;154
Elektrėnai mun.;2004;65;353;152;201
Elektrėnai mun.;2004;66;302;117;185
Elektrėnai mun.;2004;67;334;141;193
Elektrėnai mun.;2004;68;277;100;177
Elektrėnai mun.;2004;69;272;111;161
Elektrėnai mun.;2004;70;236;75;161
Elektrėnai mun.;2004;71;269;110;159
Elektrėnai mun.;2004;72;238;83;155
Elektrėnai mun.;2004;73;236;94;142
Elektrėnai mun.;2004;74;185;59;126
Elektrėnai mun.;2004;75;170;53;117
Elektrėnai mun.;2004;76;206;72;134
Elektrėnai mun.;2004;77;179;53;126
Elektrėnai mun.;2004;78;133;32;101
Elektrėnai mun.;2004;79;132;31;101
Elektrėnai mun.;2004;80;113;30;83
Elektrėnai mun.;2004;81;93;31;62
Elektrėnai mun.;2004;82;73;23;50
Elektrėnai mun.;2004;83;64;19;45
Elektrėnai mun.;2004;84;49;6;43
Elektrėnai mun.;2004;85;280;55;225
Elektrėnai mun.;2005;-1;27649;13092;14557
Elektrėnai mun.;2005;0;226;108;118
Elektrėnai mun.;2005;1;222;105;117
Elektrėnai mun.;2005;2;202;101;101
Elektrėnai mun.;2005;3;220;105;115
Elektrėnai mun.;2005;4;274;130;144
Elektrėnai mun.;2005;5;275;144;131
Elektrėnai mun.;2005;6;284;147;137
Elektrėnai mun.;2005;7;327;178;149
Elektrėnai mun.;2005;8;289;139;150
Elektrėnai mun.;2005;9;287;152;135
Elektrėnai mun.;2005;10;289;147;142
Elektrėnai mun.;2005;11;352;176;176
Elektrėnai mun.;2005;12;409;211;198
Elektrėnai mun.;2005;13;457;239;218
Elektrėnai mun.;2005;14;457;235;222
Elektrėnai mun.;2005;15;445;239;206
Elektrėnai mun.;2005;16;450;235;215
Elektrėnai mun.;2005;17;489;256;233
Elektrėnai mun.;2005;18;458;233;225
Elektrėnai mun.;2005;19;505;236;269
Elektrėnai mun.;2005;20;427;216;211
Elektrėnai mun.;2005;21;456;242;214
Elektrėnai mun.;2005;22;373;214;159
Elektrėnai mun.;2005;23;359;207;152
Elektrėnai mun.;2005;24;332;188;144
Elektrėnai mun.;2005;25;337;158;179
Elektrėnai mun.;2005;26;312;164;148
Elektrėnai mun.;2005;27;296;161;135
Elektrėnai mun.;2005;28;305;149;156
Elektrėnai mun.;2005;29;317;174;143
Elektrėnai mun.;2005;30;337;175;162
Elektrėnai mun.;2005;31;372;189;183
Elektrėnai mun.;2005;32;379;175;204
Elektrėnai mun.;2005;33;375;182;193
Elektrėnai mun.;2005;34;425;226;199
Elektrėnai mun.;2005;35;356;170;186
Elektrėnai mun.;2005;36;398;204;194
Elektrėnai mun.;2005;37;380;166;214
Elektrėnai mun.;2005;38;399;213;186
Elektrėnai mun.;2005;39;409;201;208
Elektrėnai mun.;2005;40;415;201;214
Elektrėnai mun.;2005;41;412;207;205
Elektrėnai mun.;2005;42;499;252;247
Elektrėnai mun.;2005;43;504;243;261
Elektrėnai mun.;2005;44;525;248;277
Elektrėnai mun.;2005;45;496;234;262
Elektrėnai mun.;2005;46;462;234;228
Elektrėnai mun.;2005;47;425;217;208
Elektrėnai mun.;2005;48;403;190;213
Elektrėnai mun.;2005;49;350;168;182
Elektrėnai mun.;2005;50;354;173;181
Elektrėnai mun.;2005;51;317;166;151
Elektrėnai mun.;2005;52;329;151;178
Elektrėnai mun.;2005;53;318;133;185
Elektrėnai mun.;2005;54;313;156;157
Elektrėnai mun.;2005;55;345;168;177
Elektrėnai mun.;2005;56;280;128;152
Elektrėnai mun.;2005;57;263;112;151
Elektrėnai mun.;2005;58;275;124;151
Elektrėnai mun.;2005;59;307;149;158
Elektrėnai mun.;2005;60;242;110;132
Elektrėnai mun.;2005;61;324;127;197
Elektrėnai mun.;2005;62;351;141;210
Elektrėnai mun.;2005;63;304;139;165
Elektrėnai mun.;2005;64;306;144;162
Elektrėnai mun.;2005;65;283;131;152
Elektrėnai mun.;2005;66;343;148;195
Elektrėnai mun.;2005;67;295;115;180
Elektrėnai mun.;2005;68;325;135;190
Elektrėnai mun.;2005;69;268;91;177
Elektrėnai mun.;2005;70;261;105;156
Elektrėnai mun.;2005;71;229;71;158
Elektrėnai mun.;2005;72;256;100;156
Elektrėnai mun.;2005;73;226;78;148
Elektrėnai mun.;2005;74;224;88;136
Elektrėnai mun.;2005;75;173;50;123
Elektrėnai mun.;2005;76;162;52;110
Elektrėnai mun.;2005;77;195;67;128
Elektrėnai mun.;2005;78;175;51;124
Elektrėnai mun.;2005;79;119;26;93
Elektrėnai mun.;2005;80;127;29;98
Elektrėnai mun.;2005;81;109;27;82
Elektrėnai mun.;2005;82;83;25;58
Elektrėnai mun.;2005;83;69;20;49
Elektrėnai mun.;2005;84;65;23;42
Elektrėnai mun.;2005;85;282;55;227
Elektrėnai mun.;2006;-1;26973;12675;14298
Elektrėnai mun.;2006;0;239;124;115
Elektrėnai mun.;2006;1;218;101;117
Elektrėnai mun.;2006;2;219;104;115
Elektrėnai mun.;2006;3;197;98;99
Elektrėnai mun.;2006;4;217;103;114
Elektrėnai mun.;2006;5;272;127;145
Elektrėnai mun.;2006;6;273;143;130
Elektrėnai mun.;2006;7;280;144;136
Elektrėnai mun.;2006;8;323;175;148
Elektrėnai mun.;2006;9;286;137;149
Elektrėnai mun.;2006;10;286;151;135
Elektrėnai mun.;2006;11;288;145;143
Elektrėnai mun.;2006;12;349;174;175
Elektrėnai mun.;2006;13;399;204;195
Elektrėnai mun.;2006;14;451;236;215
Elektrėnai mun.;2006;15;440;225;215
Elektrėnai mun.;2006;16;428;227;201
Elektrėnai mun.;2006;17;434;224;210
Elektrėnai mun.;2006;18;472;247;225
Elektrėnai mun.;2006;19;431;216;215
Elektrėnai mun.;2006;20;479;222;257
Elektrėnai mun.;2006;21;403;203;200
Elektrėnai mun.;2006;22;430;231;199
Elektrėnai mun.;2006;23;355;205;150
Elektrėnai mun.;2006;24;344;192;152
Elektrėnai mun.;2006;25;316;177;139
Elektrėnai mun.;2006;26;324;150;174
Elektrėnai mun.;2006;27;294;156;138
Elektrėnai mun.;2006;28;289;154;135
Elektrėnai mun.;2006;29;304;147;157
Elektrėnai mun.;2006;30;312;168;144
Elektrėnai mun.;2006;31;329;172;157
Elektrėnai mun.;2006;32;358;180;178
Elektrėnai mun.;2006;33;371;171;200
Elektrėnai mun.;2006;34;364;173;191
Elektrėnai mun.;2006;35;412;218;194
Elektrėnai mun.;2006;36;353;169;184
Elektrėnai mun.;2006;37;390;197;193
Elektrėnai mun.;2006;38;367;156;211
Elektrėnai mun.;2006;39;384;201;183
Elektrėnai mun.;2006;40;405;198;207
Elektrėnai mun.;2006;41;403;192;211
Elektrėnai mun.;2006;42;402;200;202
Elektrėnai mun.;2006;43;491;247;244
Elektrėnai mun.;2006;44;492;237;255
Elektrėnai mun.;2006;45;516;243;273
Elektrėnai mun.;2006;46;482;229;253
Elektrėnai mun.;2006;47;456;229;227
Elektrėnai mun.;2006;48;418;208;210
Elektrėnai mun.;2006;49;390;183;207
Elektrėnai mun.;2006;50;346;166;180
Elektrėnai mun.;2006;51;346;167;179
Elektrėnai mun.;2006;52;311;165;146
Elektrėnai mun.;2006;53;321;148;173
Elektrėnai mun.;2006;54;306;125;181
Elektrėnai mun.;2006;55;308;153;155
Elektrėnai mun.;2006;56;341;166;175
Elektrėnai mun.;2006;57;270;122;148
Elektrėnai mun.;2006;58;257;108;149
Elektrėnai mun.;2006;59;270;118;152
Elektrėnai mun.;2006;60;301;145;156
Elektrėnai mun.;2006;61;230;100;130
Elektrėnai mun.;2006;62;313;120;193
Elektrėnai mun.;2006;63;338;134;204
Elektrėnai mun.;2006;64;294;135;159
Elektrėnai mun.;2006;65;288;131;157
Elektrėnai mun.;2006;66;272;124;148
Elektrėnai mun.;2006;67;332;141;191
Elektrėnai mun.;2006;68;289;110;179
Elektrėnai mun.;2006;69;309;124;185
Elektrėnai mun.;2006;70;251;79;172
Elektrėnai mun.;2006;71;251;97;154
Elektrėnai mun.;2006;72;222;66;156
Elektrėnai mun.;2006;73;247;94;153
Elektrėnai mun.;2006;74;211;73;138
Elektrėnai mun.;2006;75;215;83;132
Elektrėnai mun.;2006;76;166;46;120
Elektrėnai mun.;2006;77;153;50;103
Elektrėnai mun.;2006;78;186;61;125
Elektrėnai mun.;2006;79;163;47;116
Elektrėnai mun.;2006;80;113;24;89
Elektrėnai mun.;2006;81;118;28;90
Elektrėnai mun.;2006;82;97;24;73
Elektrėnai mun.;2006;83;77;20;57
Elektrėnai mun.;2006;84;59;17;42
Elektrėnai mun.;2006;85;267;51;216
Elektrėnai mun.;2007;-1;26654;12523;14131
Elektrėnai mun.;2007;0;226;114;112
Elektrėnai mun.;2007;1;237;124;113
Elektrėnai mun.;2007;2;214;101;113
Elektrėnai mun.;2007;3;220;106;114
Elektrėnai mun.;2007;4;199;98;101
Elektrėnai mun.;2007;5;217;102;115
Elektrėnai mun.;2007;6;271;127;144
Elektrėnai mun.;2007;7;268;142;126
Elektrėnai mun.;2007;8;281;147;134
Elektrėnai mun.;2007;9;324;175;149
Elektrėnai mun.;2007;10;286;140;146
Elektrėnai mun.;2007;11;284;149;135
Elektrėnai mun.;2007;12;284;142;142
Elektrėnai mun.;2007;13;352;177;175
Elektrėnai mun.;2007;14;398;204;194
Elektrėnai mun.;2007;15;449;235;214
Elektrėnai mun.;2007;16;433;221;212
Elektrėnai mun.;2007;17;423;222;201
Elektrėnai mun.;2007;18;430;221;209
Elektrėnai mun.;2007;19;462;240;222
Elektrėnai mun.;2007;20;414;210;204
Elektrėnai mun.;2007;21;475;218;257
Elektrėnai mun.;2007;22;384;194;190
Elektrėnai mun.;2007;23;421;227;194
Elektrėnai mun.;2007;24;343;198;145
Elektrėnai mun.;2007;25;330;191;139
Elektrėnai mun.;2007;26;307;172;135
Elektrėnai mun.;2007;27;314;145;169
Elektrėnai mun.;2007;28;298;160;138
Elektrėnai mun.;2007;29;277;147;130
Elektrėnai mun.;2007;30;303;145;158
Elektrėnai mun.;2007;31;304;163;141
Elektrėnai mun.;2007;32;329;173;156
Elektrėnai mun.;2007;33;353;175;178
Elektrėnai mun.;2007;34;373;175;198
Elektrėnai mun.;2007;35;361;170;191
Elektrėnai mun.;2007;36;406;216;190
Elektrėnai mun.;2007;37;349;170;179
Elektrėnai mun.;2007;38;392;197;195
Elektrėnai mun.;2007;39;365;153;212
Elektrėnai mun.;2007;40;377;196;181
Elektrėnai mun.;2007;41;399;196;203
Elektrėnai mun.;2007;42;400;191;209
Elektrėnai mun.;2007;43;400;198;202
Elektrėnai mun.;2007;44;480;238;242
Elektrėnai mun.;2007;45;483;230;253
Elektrėnai mun.;2007;46;514;247;267
Elektrėnai mun.;2007;47;472;223;249
Elektrėnai mun.;2007;48;449;222;227
Elektrėnai mun.;2007;49;411;202;209
Elektrėnai mun.;2007;50;380;178;202
Elektrėnai mun.;2007;51;335;160;175
Elektrėnai mun.;2007;52;341;167;174
Elektrėnai mun.;2007;53;305;160;145
Elektrėnai mun.;2007;54;317;144;173
Elektrėnai mun.;2007;55;300;122;178
Elektrėnai mun.;2007;56;299;145;154
Elektrėnai mun.;2007;57;337;165;172
Elektrėnai mun.;2007;58;271;123;148
Elektrėnai mun.;2007;59;254;105;149
Elektrėnai mun.;2007;60;260;111;149
Elektrėnai mun.;2007;61;291;136;155
Elektrėnai mun.;2007;62;227;101;126
Elektrėnai mun.;2007;63;311;119;192
Elektrėnai mun.;2007;64;332;133;199
Elektrėnai mun.;2007;65;288;130;158
Elektrėnai mun.;2007;66;278;126;152
Elektrėnai mun.;2007;67;263;117;146
Elektrėnai mun.;2007;68;328;140;188
Elektrėnai mun.;2007;69;277;100;177
Elektrėnai mun.;2007;70;299;120;179
Elektrėnai mun.;2007;71;241;73;168
Elektrėnai mun.;2007;72;240;91;149
Elektrėnai mun.;2007;73;217;65;152
Elektrėnai mun.;2007;74;239;91;148
Elektrėnai mun.;2007;75;206;70;136
Elektrėnai mun.;2007;76;202;74;128
Elektrėnai mun.;2007;77;164;45;119
Elektrėnai mun.;2007;78;144;46;98
Elektrėnai mun.;2007;79;173;56;117
Elektrėnai mun.;2007;80;147;40;107
Elektrėnai mun.;2007;81;101;20;81
Elektrėnai mun.;2007;82;112;26;86
Elektrėnai mun.;2007;83;90;22;68
Elektrėnai mun.;2007;84;71;17;54
Elektrėnai mun.;2007;85;273;56;217
Elektrėnai mun.;2008;-1;26338;12367;13971
Elektrėnai mun.;2008;0;239;137;102
Elektrėnai mun.;2008;1;220;110;110
Elektrėnai mun.;2008;2;236;124;112
Elektrėnai mun.;2008;3;215;99;116
Elektrėnai mun.;2008;4;219;103;116
Elektrėnai mun.;2008;5;196;97;99
Elektrėnai mun.;2008;6;217;100;117
Elektrėnai mun.;2008;7;266;124;142
Elektrėnai mun.;2008;8;269;142;127
Elektrėnai mun.;2008;9;278;145;133
Elektrėnai mun.;2008;10;322;178;144
Elektrėnai mun.;2008;11;291;142;149
Elektrėnai mun.;2008;12;287;149;138
Elektrėnai mun.;2008;13;283;142;141
Elektrėnai mun.;2008;14;354;177;177
Elektrėnai mun.;2008;15;399;204;195
Elektrėnai mun.;2008;16;449;233;216
Elektrėnai mun.;2008;17;434;222;212
Elektrėnai mun.;2008;18;420;221;199
Elektrėnai mun.;2008;19;417;215;202
Elektrėnai mun.;2008;20;456;234;222
Elektrėnai mun.;2008;21;403;204;199
Elektrėnai mun.;2008;22;461;211;250
Elektrėnai mun.;2008;23;377;193;184
Elektrėnai mun.;2008;24;417;229;188
Elektrėnai mun.;2008;25;331;188;143
Elektrėnai mun.;2008;26;320;186;134
Elektrėnai mun.;2008;27;298;171;127
Elektrėnai mun.;2008;28;303;144;159
Elektrėnai mun.;2008;29;294;159;135
Elektrėnai mun.;2008;30;273;146;127
Elektrėnai mun.;2008;31;305;148;157
Elektrėnai mun.;2008;32;303;161;142
Elektrėnai mun.;2008;33;325;170;155
Elektrėnai mun.;2008;34;348;174;174
Elektrėnai mun.;2008;35;359;168;191
Elektrėnai mun.;2008;36;349;160;189
Elektrėnai mun.;2008;37;406;215;191
Elektrėnai mun.;2008;38;353;171;182
Elektrėnai mun.;2008;39;381;191;190
Elektrėnai mun.;2008;40;361;151;210
Elektrėnai mun.;2008;41;368;190;178
Elektrėnai mun.;2008;42;391;188;203
Elektrėnai mun.;2008;43;389;185;204
Elektrėnai mun.;2008;44;390;193;197
Elektrėnai mun.;2008;45;475;235;240
Elektrėnai mun.;2008;46;483;229;254
Elektrėnai mun.;2008;47;512;244;268
Elektrėnai mun.;2008;48;466;219;247
Elektrėnai mun.;2008;49;449;221;228
Elektrėnai mun.;2008;50;409;199;210
Elektrėnai mun.;2008;51;373;174;199
Elektrėnai mun.;2008;52;331;157;174
Elektrėnai mun.;2008;53;333;160;173
Elektrėnai mun.;2008;54;294;153;141
Elektrėnai mun.;2008;55;311;143;168
Elektrėnai mun.;2008;56;291;114;177
Elektrėnai mun.;2008;57;290;141;149
Elektrėnai mun.;2008;58;327;160;167
Elektrėnai mun.;2008;59;264;119;145
Elektrėnai mun.;2008;60;247;100;147
Elektrėnai mun.;2008;61;254;108;146
Elektrėnai mun.;2008;62;287;135;152
Elektrėnai mun.;2008;63;222;98;124
Elektrėnai mun.;2008;64;303;117;186
Elektrėnai mun.;2008;65;326;129;197
Elektrėnai mun.;2008;66;285;129;156
Elektrėnai mun.;2008;67;266;116;150
Elektrėnai mun.;2008;68;254;111;143
Elektrėnai mun.;2008;69;320;134;186
Elektrėnai mun.;2008;70;264;90;174
Elektrėnai mun.;2008;71;286;113;173
Elektrėnai mun.;2008;72;231;69;162
Elektrėnai mun.;2008;73;232;87;145
Elektrėnai mun.;2008;74;204;59;145
Elektrėnai mun.;2008;75;225;86;139
Elektrėnai mun.;2008;76;196;64;132
Elektrėnai mun.;2008;77;199;73;126
Elektrėnai mun.;2008;78;154;42;112
Elektrėnai mun.;2008;79;134;41;93
Elektrėnai mun.;2008;80;161;49;112
Elektrėnai mun.;2008;81;139;36;103
Elektrėnai mun.;2008;82;92;17;75
Elektrėnai mun.;2008;83;105;23;82
Elektrėnai mun.;2008;84;83;19;64
Elektrėnai mun.;2008;85;289;60;229
Elektrėnai mun.;2009;-1;26041;12220;13821
Elektrėnai mun.;2009;0;243;119;124
Elektrėnai mun.;2009;1;236;135;101
Elektrėnai mun.;2009;2;216;111;105
Elektrėnai mun.;2009;3;233;122;111
Elektrėnai mun.;2009;4;215;99;116
Elektrėnai mun.;2009;5;219;105;114
Elektrėnai mun.;2009;6;195;98;97
Elektrėnai mun.;2009;7;216;101;115
Elektrėnai mun.;2009;8;259;120;139
Elektrėnai mun.;2009;9;270;143;127
Elektrėnai mun.;2009;10;269;141;128
Elektrėnai mun.;2009;11;327;180;147
Elektrėnai mun.;2009;12;293;140;153
Elektrėnai mun.;2009;13;291;152;139
Elektrėnai mun.;2009;14;286;144;142
Elektrėnai mun.;2009;15;354;179;175
Elektrėnai mun.;2009;16;399;205;194
Elektrėnai mun.;2009;17;444;232;212
Elektrėnai mun.;2009;18;435;222;213
Elektrėnai mun.;2009;19;418;220;198
Elektrėnai mun.;2009;20;414;213;201
Elektrėnai mun.;2009;21;444;231;213
Elektrėnai mun.;2009;22;397;201;196
Elektrėnai mun.;2009;23;451;209;242
Elektrėnai mun.;2009;24;369;192;177
Elektrėnai mun.;2009;25;402;220;182
Elektrėnai mun.;2009;26;317;180;137
Elektrėnai mun.;2009;27;307;178;129
Elektrėnai mun.;2009;28;298;171;127
Elektrėnai mun.;2009;29;292;142;150
Elektrėnai mun.;2009;30;291;160;131
Elektrėnai mun.;2009;31;268;140;128
Elektrėnai mun.;2009;32;295;142;153
Elektrėnai mun.;2009;33;300;156;144
Elektrėnai mun.;2009;34;321;167;154
Elektrėnai mun.;2009;35;347;172;175
Elektrėnai mun.;2009;36;359;169;190
Elektrėnai mun.;2009;37;351;163;188
Elektrėnai mun.;2009;38;406;215;191
Elektrėnai mun.;2009;39;345;167;178
Elektrėnai mun.;2009;40;378;187;191
Elektrėnai mun.;2009;41;359;147;212
Elektrėnai mun.;2009;42;367;188;179
Elektrėnai mun.;2009;43;389;185;204
Elektrėnai mun.;2009;44;387;183;204
Elektrėnai mun.;2009;45;388;189;199
Elektrėnai mun.;2009;46;471;230;241
Elektrėnai mun.;2009;47;479;227;252
Elektrėnai mun.;2009;48;507;244;263
Elektrėnai mun.;2009;49;458;213;245
Elektrėnai mun.;2009;50;445;220;225
Elektrėnai mun.;2009;51;399;196;203
Elektrėnai mun.;2009;52;367;170;197
Elektrėnai mun.;2009;53;327;155;172
Elektrėnai mun.;2009;54;328;155;173
Elektrėnai mun.;2009;55;290;151;139
Elektrėnai mun.;2009;56;307;137;170
Elektrėnai mun.;2009;57;280;109;171
Elektrėnai mun.;2009;58;290;140;150
Elektrėnai mun.;2009;59;328;160;168
Elektrėnai mun.;2009;60;266;118;148
Elektrėnai mun.;2009;61;241;96;145
Elektrėnai mun.;2009;62;243;105;138
Elektrėnai mun.;2009;63;276;130;146
Elektrėnai mun.;2009;64;220;98;122
Elektrėnai mun.;2009;65;297;111;186
Elektrėnai mun.;2009;66;317;121;196
Elektrėnai mun.;2009;67;277;119;158
Elektrėnai mun.;2009;68;262;111;151
Elektrėnai mun.;2009;69;245;107;138
Elektrėnai mun.;2009;70;306;125;181
Elektrėnai mun.;2009;71;260;88;172
Elektrėnai mun.;2009;72;268;101;167
Elektrėnai mun.;2009;73;225;67;158
Elektrėnai mun.;2009;74;220;79;141
Elektrėnai mun.;2009;75;196;58;138
Elektrėnai mun.;2009;76;212;78;134
Elektrėnai mun.;2009;77;190;60;130
Elektrėnai mun.;2009;78;185;66;119
Elektrėnai mun.;2009;79;142;36;106
Elektrėnai mun.;2009;80;125;37;88
Elektrėnai mun.;2009;81;140;46;94
Elektrėnai mun.;2009;82;126;27;99
Elektrėnai mun.;2009;83;84;16;68
Elektrėnai mun.;2009;84;92;20;72
Elektrėnai mun.;2009;85;290;58;232
Elektrėnai mun.;2010;-1;25802;12153;13649
Elektrėnai mun.;2010;0;243;127;116
Elektrėnai mun.;2010;1;245;121;124
Elektrėnai mun.;2010;2;231;131;100
Elektrėnai mun.;2010;3;214;109;105
Elektrėnai mun.;2010;4;234;123;111
Elektrėnai mun.;2010;5;216;99;117
Elektrėnai mun.;2010;6;217;105;112
Elektrėnai mun.;2010;7;195;99;96
Elektrėnai mun.;2010;8;217;101;116
Elektrėnai mun.;2010;9;260;119;141
Elektrėnai mun.;2010;10;271;143;128
Elektrėnai mun.;2010;11;269;140;129
Elektrėnai mun.;2010;12;331;182;149
Elektrėnai mun.;2010;13;291;140;151
Elektrėnai mun.;2010;14;293;155;138
Elektrėnai mun.;2010;15;289;149;140
Elektrėnai mun.;2010;16;357;182;175
Elektrėnai mun.;2010;17;399;204;195
Elektrėnai mun.;2010;18;442;234;208
Elektrėnai mun.;2010;19;431;218;213
Elektrėnai mun.;2010;20;410;217;193
Elektrėnai mun.;2010;21;397;206;191
Elektrėnai mun.;2010;22;437;228;209
Elektrėnai mun.;2010;23;385;196;189
Elektrėnai mun.;2010;24;434;203;231
Elektrėnai mun.;2010;25;362;191;171
Elektrėnai mun.;2010;26;401;223;178
Elektrėnai mun.;2010;27;305;177;128
Elektrėnai mun.;2010;28;294;167;127
Elektrėnai mun.;2010;29;286;167;119
Elektrėnai mun.;2010;30;295;142;153
Elektrėnai mun.;2010;31;286;155;131
Elektrėnai mun.;2010;32;262;138;124
Elektrėnai mun.;2010;33;283;134;149
Elektrėnai mun.;2010;34;298;155;143
Elektrėnai mun.;2010;35;314;163;151
Elektrėnai mun.;2010;36;346;173;173
Elektrėnai mun.;2010;37;351;166;185
Elektrėnai mun.;2010;38;345;156;189
Elektrėnai mun.;2010;39;401;213;188
Elektrėnai mun.;2010;40;344;167;177
Elektrėnai mun.;2010;41;373;187;186
Elektrėnai mun.;2010;42;358;148;210
Elektrėnai mun.;2010;43;368;187;181
Elektrėnai mun.;2010;44;389;186;203
Elektrėnai mun.;2010;45;383;184;199
Elektrėnai mun.;2010;46;382;185;197
Elektrėnai mun.;2010;47;466;228;238
Elektrėnai mun.;2010;48;477;224;253
Elektrėnai mun.;2010;49;498;238;260
Elektrėnai mun.;2010;50;456;213;243
Elektrėnai mun.;2010;51;434;213;221
Elektrėnai mun.;2010;52;398;197;201
Elektrėnai mun.;2010;53;364;168;196
Elektrėnai mun.;2010;54;324;153;171
Elektrėnai mun.;2010;55;329;156;173
Elektrėnai mun.;2010;56;286;149;137
Elektrėnai mun.;2010;57;301;134;167
Elektrėnai mun.;2010;58;280;108;172
Elektrėnai mun.;2010;59;283;135;148
Elektrėnai mun.;2010;60;325;156;169
Elektrėnai mun.;2010;61;260;115;145
Elektrėnai mun.;2010;62;238;95;143
Elektrėnai mun.;2010;63;235;102;133
Elektrėnai mun.;2010;64;273;127;146
Elektrėnai mun.;2010;65;218;98;120
Elektrėnai mun.;2010;66;289;108;181
Elektrėnai mun.;2010;67;314;120;194
Elektrėnai mun.;2010;68;273;116;157
Elektrėnai mun.;2010;69;254;104;150
Elektrėnai mun.;2010;70;232;98;134
Elektrėnai mun.;2010;71;300;123;177
Elektrėnai mun.;2010;72;252;85;167
Elektrėnai mun.;2010;73;256;95;161
Elektrėnai mun.;2010;74;212;63;149
Elektrėnai mun.;2010;75;209;75;134
Elektrėnai mun.;2010;76;191;57;134
Elektrėnai mun.;2010;77;197;71;126
Elektrėnai mun.;2010;78;179;55;124
Elektrėnai mun.;2010;79;173;63;110
Elektrėnai mun.;2010;80;137;35;102
Elektrėnai mun.;2010;81;120;35;85
Elektrėnai mun.;2010;82;122;41;81
Elektrėnai mun.;2010;83;116;25;91
Elektrėnai mun.;2010;84;76;13;63
Elektrėnai mun.;2010;85;321;67;254
Elektrėnai mun.;2011;-1;25061;11813;13248
Elektrėnai mun.;2011;0;223;108;115
Elektrėnai mun.;2011;1;243;131;112
Elektrėnai mun.;2011;2;237;135;102
Elektrėnai mun.;2011;3;239;135;104
Elektrėnai mun.;2011;4;214;119;95
Elektrėnai mun.;2011;5;235;133;102
Elektrėnai mun.;2011;6;209;102;107
Elektrėnai mun.;2011;7;221;109;112
Elektrėnai mun.;2011;8;194;95;99
Elektrėnai mun.;2011;9;233;115;118
Elektrėnai mun.;2011;10;269;131;138
Elektrėnai mun.;2011;11;258;138;120
Elektrėnai mun.;2011;12;261;131;130
Elektrėnai mun.;2011;13;330;171;159
Elektrėnai mun.;2011;14;276;128;148
Elektrėnai mun.;2011;15;281;150;131
Elektrėnai mun.;2011;16;294;155;139
Elektrėnai mun.;2011;17;357;186;171
Elektrėnai mun.;2011;18;389;204;185
Elektrėnai mun.;2011;19;371;193;178
Elektrėnai mun.;2011;20;380;192;188
Elektrėnai mun.;2011;21;339;181;158
Elektrėnai mun.;2011;22;363;194;169
Elektrėnai mun.;2011;23;379;202;177
Elektrėnai mun.;2011;24;349;174;175
Elektrėnai mun.;2011;25;374;180;194
Elektrėnai mun.;2011;26;324;173;151
Elektrėnai mun.;2011;27;357;203;154
Elektrėnai mun.;2011;28;318;178;140
Elektrėnai mun.;2011;29;311;161;150
Elektrėnai mun.;2011;30;301;151;150
Elektrėnai mun.;2011;31;315;144;171
Elektrėnai mun.;2011;32;292;152;140
Elektrėnai mun.;2011;33;272;154;118
Elektrėnai mun.;2011;34;266;126;140
Elektrėnai mun.;2011;35;300;156;144
Elektrėnai mun.;2011;36;311;158;153
Elektrėnai mun.;2011;37;339;168;171
Elektrėnai mun.;2011;38;364;165;199
Elektrėnai mun.;2011;39;363;161;202
Elektrėnai mun.;2011;40;391;210;181
Elektrėnai mun.;2011;41;361;171;190
Elektrėnai mun.;2011;42;372;188;184
Elektrėnai mun.;2011;43;353;157;196
Elektrėnai mun.;2011;44;366;189;177
Elektrėnai mun.;2011;45;362;185;177
Elektrėnai mun.;2011;46;383;188;195
Elektrėnai mun.;2011;47;386;190;196
Elektrėnai mun.;2011;48;461;223;238
Elektrėnai mun.;2011;49;464;212;252
Elektrėnai mun.;2011;50;481;231;250
Elektrėnai mun.;2011;51;435;202;233
Elektrėnai mun.;2011;52;432;213;219
Elektrėnai mun.;2011;53;388;190;198
Elektrėnai mun.;2011;54;350;159;191
Elektrėnai mun.;2011;55;314;150;164
Elektrėnai mun.;2011;56;311;154;157
Elektrėnai mun.;2011;57;277;140;137
Elektrėnai mun.;2011;58;303;134;169
Elektrėnai mun.;2011;59;281;107;174
Elektrėnai mun.;2011;60;285;138;147
Elektrėnai mun.;2011;61;314;150;164
Elektrėnai mun.;2011;62;247;105;142
Elektrėnai mun.;2011;63;224;87;137
Elektrėnai mun.;2011;64;241;100;141
Elektrėnai mun.;2011;65;251;116;135
Elektrėnai mun.;2011;66;219;96;123
Elektrėnai mun.;2011;67;291;110;181
Elektrėnai mun.;2011;68;313;117;196
Elektrėnai mun.;2011;69;266;115;151
Elektrėnai mun.;2011;70;259;99;160
Elektrėnai mun.;2011;71;222;88;134
Elektrėnai mun.;2011;72;283;110;173
Elektrėnai mun.;2011;73;235;74;161
Elektrėnai mun.;2011;74;249;88;161
Elektrėnai mun.;2011;75;196;59;137
Elektrėnai mun.;2011;76;187;56;131
Elektrėnai mun.;2011;77;170;49;121
Elektrėnai mun.;2011;78;176;62;114
Elektrėnai mun.;2011;79;155;43;112
Elektrėnai mun.;2011;80;145;51;94
Elektrėnai mun.;2011;81;111;27;84
Elektrėnai mun.;2011;82;103;31;72
Elektrėnai mun.;2011;83;106;34;72
Elektrėnai mun.;2011;84;83;13;70
Elektrėnai mun.;2011;85;308;60;248
Elektrėnai mun.;2012;-1;24700;11638;13062
Elektrėnai mun.;2012;0;239;130;109
Elektrėnai mun.;2012;1;227;108;119
Elektrėnai mun.;2012;2;240;132;108
Elektrėnai mun.;2012;3;236;139;97
Elektrėnai mun.;2012;4;236;135;101
Elektrėnai mun.;2012;5;212;116;96
Elektrėnai mun.;2012;6;233;133;100
Elektrėnai mun.;2012;7;209;101;108
Elektrėnai mun.;2012;8;216;110;106
Elektrėnai mun.;2012;9;192;93;99
Elektrėnai mun.;2012;10;232;114;118
Elektrėnai mun.;2012;11;270;134;136
Elektrėnai mun.;2012;12;251;133;118
Elektrėnai mun.;2012;13;257;129;128
Elektrėnai mun.;2012;14;331;171;160
Elektrėnai mun.;2012;15;270;126;144
Elektrėnai mun.;2012;16;277;148;129
Elektrėnai mun.;2012;17;289;149;140
Elektrėnai mun.;2012;18;356;184;172
Elektrėnai mun.;2012;19;377;196;181
Elektrėnai mun.;2012;20;365;191;174
Elektrėnai mun.;2012;21;379;194;185
Elektrėnai mun.;2012;22;329;172;157
Elektrėnai mun.;2012;23;361;192;169
Elektrėnai mun.;2012;24;368;197;171
Elektrėnai mun.;2012;25;328;167;161
Elektrėnai mun.;2012;26;355;165;190
Elektrėnai mun.;2012;27;310;170;140
Elektrėnai mun.;2012;28;332;186;146
Elektrėnai mun.;2012;29;308;171;137
Elektrėnai mun.;2012;30;303;158;145
Elektrėnai mun.;2012;31;287;144;143
Elektrėnai mun.;2012;32;308;140;168
Elektrėnai mun.;2012;33;286;151;135
Elektrėnai mun.;2012;34;265;150;115
Elektrėnai mun.;2012;35;261;120;141
Elektrėnai mun.;2012;36;295;154;141
Elektrėnai mun.;2012;37;306;157;149
Elektrėnai mun.;2012;38;332;164;168
Elektrėnai mun.;2012;39;356;160;196
Elektrėnai mun.;2012;40;360;162;198
Elektrėnai mun.;2012;41;390;212;178
Elektrėnai mun.;2012;42;359;170;189
Elektrėnai mun.;2012;43;364;182;182
Elektrėnai mun.;2012;44;352;158;194
Elektrėnai mun.;2012;45;360;187;173
Elektrėnai mun.;2012;46;362;184;178
Elektrėnai mun.;2012;47;379;190;189
Elektrėnai mun.;2012;48;380;185;195
Elektrėnai mun.;2012;49;451;219;232
Elektrėnai mun.;2012;50;461;211;250
Elektrėnai mun.;2012;51;475;226;249
Elektrėnai mun.;2012;52;419;191;228
Elektrėnai mun.;2012;53;428;207;221
Elektrėnai mun.;2012;54;379;183;196
Elektrėnai mun.;2012;55;342;155;187
Elektrėnai mun.;2012;56;305;144;161
Elektrėnai mun.;2012;57;306;153;153
Elektrėnai mun.;2012;58;269;136;133
Elektrėnai mun.;2012;59;298;129;169
Elektrėnai mun.;2012;60;274;103;171
Elektrėnai mun.;2012;61;276;130;146
Elektrėnai mun.;2012;62;310;146;164
Elektrėnai mun.;2012;63;240;99;141
Elektrėnai mun.;2012;64;219;87;132
Elektrėnai mun.;2012;65;239;100;139
Elektrėnai mun.;2012;66;245;112;133
Elektrėnai mun.;2012;67;216;93;123
Elektrėnai mun.;2012;68;283;104;179
Elektrėnai mun.;2012;69;308;113;195
Elektrėnai mun.;2012;70;259;110;149
Elektrėnai mun.;2012;71;253;94;159
Elektrėnai mun.;2012;72;215;83;132
Elektrėnai mun.;2012;73;277;106;171
Elektrėnai mun.;2012;74;225;69;156
Elektrėnai mun.;2012;75;237;81;156
Elektrėnai mun.;2012;76;193;57;136
Elektrėnai mun.;2012;77;177;51;126
Elektrėnai mun.;2012;78;161;43;118
Elektrėnai mun.;2012;79;169;57;112
Elektrėnai mun.;2012;80;147;40;107
Elektrėnai mun.;2012;81;129;44;85
Elektrėnai mun.;2012;82;104;24;80
Elektrėnai mun.;2012;83;97;28;69
Elektrėnai mun.;2012;84;99;30;69
Elektrėnai mun.;2012;85;325;66;259
Elektrėnai mun.;2013;-1;24396;11533;12863
Elektrėnai mun.;2013;0;263;142;121
Elektrėnai mun.;2013;1;235;127;108
Elektrėnai mun.;2013;2;225;109;116
Elektrėnai mun.;2013;3;241;135;106
Elektrėnai mun.;2013;4;225;134;91
Elektrėnai mun.;2013;5;237;136;101
Elektrėnai mun.;2013;6;208;114;94
Elektrėnai mun.;2013;7;221;126;95
Elektrėnai mun.;2013;8;203;99;104
Elektrėnai mun.;2013;9;214;109;105
Elektrėnai mun.;2013;10;186;92;94
Elektrėnai mun.;2013;11;231;113;118
Elektrėnai mun.;2013;12;266;132;134
Elektrėnai mun.;2013;13;252;132;120
Elektrėnai mun.;2013;14;254;128;126
Elektrėnai mun.;2013;15;329;169;160
Elektrėnai mun.;2013;16;269;125;144
Elektrėnai mun.;2013;17;277;148;129
Elektrėnai mun.;2013;18;283;145;138
Elektrėnai mun.;2013;19;354;184;170
Elektrėnai mun.;2013;20;375;195;180
Elektrėnai mun.;2013;21;359;188;171
Elektrėnai mun.;2013;22;378;193;185
Elektrėnai mun.;2013;23;315;168;147
Elektrėnai mun.;2013;24;350;188;162
Elektrėnai mun.;2013;25;356;197;159
Elektrėnai mun.;2013;26;314;158;156
Elektrėnai mun.;2013;27;342;162;180
Elektrėnai mun.;2013;28;301;168;133
Elektrėnai mun.;2013;29;315;180;135
Elektrėnai mun.;2013;30;303;170;133
Elektrėnai mun.;2013;31;291;153;138
Elektrėnai mun.;2013;32;281;139;142
Elektrėnai mun.;2013;33;299;137;162
Elektrėnai mun.;2013;34;278;146;132
Elektrėnai mun.;2013;35;259;149;110
Elektrėnai mun.;2013;36;254;112;142
Elektrėnai mun.;2013;37;291;153;138
Elektrėnai mun.;2013;38;304;155;149
Elektrėnai mun.;2013;39;326;163;163
Elektrėnai mun.;2013;40;350;156;194
Elektrėnai mun.;2013;41;361;163;198
Elektrėnai mun.;2013;42;381;206;175
Elektrėnai mun.;2013;43;354;166;188
Elektrėnai mun.;2013;44;360;182;178
Elektrėnai mun.;2013;45;347;155;192
Elektrėnai mun.;2013;46;358;187;171
Elektrėnai mun.;2013;47;354;178;176
Elektrėnai mun.;2013;48;373;186;187
Elektrėnai mun.;2013;49;370;178;192
Elektrėnai mun.;2013;50;450;218;232
Elektrėnai mun.;2013;51;453;207;246
Elektrėnai mun.;2013;52;471;221;250
Elektrėnai mun.;2013;53;415;191;224
Elektrėnai mun.;2013;54;419;204;215
Elektrėnai mun.;2013;55;377;183;194
Elektrėnai mun.;2013;56;339;153;186
Elektrėnai mun.;2013;57;304;145;159
Elektrėnai mun.;2013;58;304;152;152
Elektrėnai mun.;2013;59;266;134;132
Elektrėnai mun.;2013;60;286;122;164
Elektrėnai mun.;2013;61;274;104;170
Elektrėnai mun.;2013;62;277;132;145
Elektrėnai mun.;2013;63;307;146;161
Elektrėnai mun.;2013;64;235;97;138
Elektrėnai mun.;2013;65;217;84;133
Elektrėnai mun.;2013;66;238;99;139
Elektrėnai mun.;2013;67;236;106;130
Elektrėnai mun.;2013;68;212;90;122
Elektrėnai mun.;2013;69;275;98;177
Elektrėnai mun.;2013;70;303;109;194
Elektrėnai mun.;2013;71;247;104;143
Elektrėnai mun.;2013;72;248;89;159
Elektrėnai mun.;2013;73;210;82;128
Elektrėnai mun.;2013;74;264;99;165
Elektrėnai mun.;2013;75;211;61;150
Elektrėnai mun.;2013;76;229;77;152
Elektrėnai mun.;2013;77;181;53;128
Elektrėnai mun.;2013;78;162;47;115
Elektrėnai mun.;2013;79;151;38;113
Elektrėnai mun.;2013;80;165;55;110
Elektrėnai mun.;2013;81;142;37;105
Elektrėnai mun.;2013;82;108;33;75
Elektrėnai mun.;2013;83;93;21;72
Elektrėnai mun.;2013;84;90;26;64
Elektrėnai mun.;2013;85;365;86;279
Elektrėnai mun.;2014;-1;24234;11454;12780
Elektrėnai mun.;2014;0;243;127;116
Elektrėnai mun.;2014;1;266;144;122
Elektrėnai mun.;2014;2;231;127;104
Elektrėnai mun.;2014;3;222;106;116
Elektrėnai mun.;2014;4;235;133;102
Elektrėnai mun.;2014;5;224;134;90
Elektrėnai mun.;2014;6;241;137;104
Elektrėnai mun.;2014;7;207;112;95
Elektrėnai mun.;2014;8;220;128;92
Elektrėnai mun.;2014;9;201;100;101
Elektrėnai mun.;2014;10;207;104;103
Elektrėnai mun.;2014;11;182;90;92
Elektrėnai mun.;2014;12;233;114;119
Elektrėnai mun.;2014;13;267;133;134
Elektrėnai mun.;2014;14;255;134;121
Elektrėnai mun.;2014;15;255;128;127
Elektrėnai mun.;2014;16;327;167;160
Elektrėnai mun.;2014;17;264;123;141
Elektrėnai mun.;2014;18;279;147;132
Elektrėnai mun.;2014;19;279;142;137
Elektrėnai mun.;2014;20;348;184;164
Elektrėnai mun.;2014;21;370;189;181
Elektrėnai mun.;2014;22;346;181;165
Elektrėnai mun.;2014;23;374;193;181
Elektrėnai mun.;2014;24;302;161;141
Elektrėnai mun.;2014;25;343;183;160
Elektrėnai mun.;2014;26;356;195;161
Elektrėnai mun.;2014;27;303;151;152
Elektrėnai mun.;2014;28;315;149;166
Elektrėnai mun.;2014;29;297;170;127
Elektrėnai mun.;2014;30;307;176;131
Elektrėnai mun.;2014;31;296;173;123
Elektrėnai mun.;2014;32;284;152;132
Elektrėnai mun.;2014;33;277;132;145
Elektrėnai mun.;2014;34;304;139;165
Elektrėnai mun.;2014;35;277;147;130
Elektrėnai mun.;2014;36;261;150;111
Elektrėnai mun.;2014;37;255;110;145
Elektrėnai mun.;2014;38;294;155;139
Elektrėnai mun.;2014;39;305;157;148
Elektrėnai mun.;2014;40;320;160;160
Elektrėnai mun.;2014;41;352;157;195
Elektrėnai mun.;2014;42;359;163;196
Elektrėnai mun.;2014;43;373;201;172
Elektrėnai mun.;2014;44;354;166;188
Elektrėnai mun.;2014;45;352;179;173
Elektrėnai mun.;2014;46;347;153;194
Elektrėnai mun.;2014;47;357;186;171
Elektrėnai mun.;2014;48;351;175;176
Elektrėnai mun.;2014;49;369;185;184
Elektrėnai mun.;2014;50;371;179;192
Elektrėnai mun.;2014;51;440;211;229
Elektrėnai mun.;2014;52;445;203;242
Elektrėnai mun.;2014;53;463;213;250
Elektrėnai mun.;2014;54;408;187;221
Elektrėnai mun.;2014;55;420;205;215
Elektrėnai mun.;2014;56;368;176;192
Elektrėnai mun.;2014;57;339;153;186
Elektrėnai mun.;2014;58;306;146;160
Elektrėnai mun.;2014;59;301;146;155
Elektrėnai mun.;2014;60;260;127;133
Elektrėnai mun.;2014;61;284;120;164
Elektrėnai mun.;2014;62;266;101;165
Elektrėnai mun.;2014;63;276;130;146
Elektrėnai mun.;2014;64;307;145;162
Elektrėnai mun.;2014;65;235;97;138
Elektrėnai mun.;2014;66;213;79;134
Elektrėnai mun.;2014;67;237;101;136
Elektrėnai mun.;2014;68;230;104;126
Elektrėnai mun.;2014;69;204;84;120
Elektrėnai mun.;2014;70;264;93;171
Elektrėnai mun.;2014;71;294;105;189
Elektrėnai mun.;2014;72;237;97;140
Elektrėnai mun.;2014;73;237;83;154
Elektrėnai mun.;2014;74;206;79;127
Elektrėnai mun.;2014;75;249;92;157
Elektrėnai mun.;2014;76;206;58;148
Elektrėnai mun.;2014;77;221;73;148
Elektrėnai mun.;2014;78;178;51;127
Elektrėnai mun.;2014;79;157;44;113
Elektrėnai mun.;2014;80;140;34;106
Elektrėnai mun.;2014;81;153;49;104
Elektrėnai mun.;2014;82;132;34;98
Elektrėnai mun.;2014;83;106;33;73
Elektrėnai mun.;2014;84;88;22;66
Elektrėnai mun.;2014;85;407;98;309
Elektrėnai mun.;2015;-1;24164;11443;12721
Elektrėnai mun.;2015;0;251;118;133
Elektrėnai mun.;2015;1;246;131;115
Elektrėnai mun.;2015;2;257;138;119
Elektrėnai mun.;2015;3;225;124;101
Elektrėnai mun.;2015;4;225;109;116
Elektrėnai mun.;2015;5;234;134;100
Elektrėnai mun.;2015;6;220;133;87
Elektrėnai mun.;2015;7;237;135;102
Elektrėnai mun.;2015;8;212;115;97
Elektrėnai mun.;2015;9;225;131;94
Elektrėnai mun.;2015;10;200;98;102
Elektrėnai mun.;2015;11;206;105;101
Elektrėnai mun.;2015;12;182;90;92
Elektrėnai mun.;2015;13;233;116;117
Elektrėnai mun.;2015;14;267;133;134
Elektrėnai mun.;2015;15;255;134;121
Elektrėnai mun.;2015;16;257;128;129
Elektrėnai mun.;2015;17;330;166;164
Elektrėnai mun.;2015;18;270;126;144
Elektrėnai mun.;2015;19;274;144;130
Elektrėnai mun.;2015;20;281;145;136
Elektrėnai mun.;2015;21;349;182;167
Elektrėnai mun.;2015;22;366;190;176
Elektrėnai mun.;2015;23;345;181;164
Elektrėnai mun.;2015;24;366;192;174
Elektrėnai mun.;2015;25;297;162;135
Elektrėnai mun.;2015;26;334;180;154
Elektrėnai mun.;2015;27;353;194;159
Elektrėnai mun.;2015;28;303;146;157
Elektrėnai mun.;2015;29;323;161;162
Elektrėnai mun.;2015;30;299;172;127
Elektrėnai mun.;2015;31;303;177;126
Elektrėnai mun.;2015;32;296;174;122
Elektrėnai mun.;2015;33;269;146;123
Elektrėnai mun.;2015;34;275;130;145
Elektrėnai mun.;2015;35;303;136;167
Elektrėnai mun.;2015;36;268;140;128
Elektrėnai mun.;2015;37;263;151;112
Elektrėnai mun.;2015;38;252;111;141
Elektrėnai mun.;2015;39;300;159;141
Elektrėnai mun.;2015;40;304;157;147
Elektrėnai mun.;2015;41;322;160;162
Elektrėnai mun.;2015;42;356;160;196
Elektrėnai mun.;2015;43;366;168;198
Elektrėnai mun.;2015;44;365;195;170
Elektrėnai mun.;2015;45;358;168;190
Elektrėnai mun.;2015;46;351;177;174
Elektrėnai mun.;2015;47;353;155;198
Elektrėnai mun.;2015;48;352;184;168
Elektrėnai mun.;2015;49;343;171;172
Elektrėnai mun.;2015;50;366;183;183
Elektrėnai mun.;2015;51;367;180;187
Elektrėnai mun.;2015;52;432;203;229
Elektrėnai mun.;2015;53;440;199;241
Elektrėnai mun.;2015;54;455;211;244
Elektrėnai mun.;2015;55;403;188;215
Elektrėnai mun.;2015;56;410;198;212
Elektrėnai mun.;2015;57;367;172;195
Elektrėnai mun.;2015;58;339;154;185
Elektrėnai mun.;2015;59;301;142;159
Elektrėnai mun.;2015;60;294;141;153
Elektrėnai mun.;2015;61;260;127;133
Elektrėnai mun.;2015;62;288;121;167
Elektrėnai mun.;2015;63;265;102;163
Elektrėnai mun.;2015;64;272;126;146
Elektrėnai mun.;2015;65;303;143;160
Elektrėnai mun.;2015;66;232;93;139
Elektrėnai mun.;2015;67;209;77;132
Elektrėnai mun.;2015;68;234;98;136
Elektrėnai mun.;2015;69;223;103;120
Elektrėnai mun.;2015;70;201;82;119
Elektrėnai mun.;2015;71;258;88;170
Elektrėnai mun.;2015;72;286;100;186
Elektrėnai mun.;2015;73;232;93;139
Elektrėnai mun.;2015;74;231;81;150
Elektrėnai mun.;2015;75;197;77;120
Elektrėnai mun.;2015;76;244;86;158
Elektrėnai mun.;2015;77;200;55;145
Elektrėnai mun.;2015;78;213;70;143
Elektrėnai mun.;2015;79;169;48;121
Elektrėnai mun.;2015;80;151;39;112
Elektrėnai mun.;2015;81;134;34;100
Elektrėnai mun.;2015;82;142;43;99
Elektrėnai mun.;2015;83;116;30;86
Elektrėnai mun.;2015;84;98;32;66
Elektrėnai mun.;2015;85;411;92;319
Elektrėnai mun.;2016;-1;23959;11345;12614
Elektrėnai mun.;2016;0;280;138;142
Elektrėnai mun.;2016;1;250;118;132
Elektrėnai mun.;2016;2;242;130;112
Elektrėnai mun.;2016;3;255;137;118
Elektrėnai mun.;2016;4;228;123;105
Elektrėnai mun.;2016;5;217;104;113
Elektrėnai mun.;2016;6;227;133;94
Elektrėnai mun.;2016;7;218;136;82
Elektrėnai mun.;2016;8;241;138;103
Elektrėnai mun.;2016;9;209;112;97
Elektrėnai mun.;2016;10;225;130;95
Elektrėnai mun.;2016;11;191;96;95
Elektrėnai mun.;2016;12;201;103;98
Elektrėnai mun.;2016;13;178;88;90
Elektrėnai mun.;2016;14;236;117;119
Elektrėnai mun.;2016;15;261;131;130
Elektrėnai mun.;2016;16;255;133;122
Elektrėnai mun.;2016;17;255;127;128
Elektrėnai mun.;2016;18;327;163;164
Elektrėnai mun.;2016;19;262;122;140
Elektrėnai mun.;2016;20;274;143;131
Elektrėnai mun.;2016;21;275;142;133
Elektrėnai mun.;2016;22;343;177;166
Elektrėnai mun.;2016;23;356;184;172
Elektrėnai mun.;2016;24;335;172;163
Elektrėnai mun.;2016;25;360;185;175
Elektrėnai mun.;2016;26;296;157;139
Elektrėnai mun.;2016;27;314;171;143
Elektrėnai mun.;2016;28;351;194;157
Elektrėnai mun.;2016;29;292;143;149
Elektrėnai mun.;2016;30;311;150;161
Elektrėnai mun.;2016;31;287;164;123
Elektrėnai mun.;2016;32;291;167;124
Elektrėnai mun.;2016;33;290;170;120
Elektrėnai mun.;2016;34;271;146;125
Elektrėnai mun.;2016;35;265;128;137
Elektrėnai mun.;2016;36;298;130;168
Elektrėnai mun.;2016;37;271;141;130
Elektrėnai mun.;2016;38;261;153;108
Elektrėnai mun.;2016;39;250;111;139
Elektrėnai mun.;2016;40;299;161;138
Elektrėnai mun.;2016;41;308;159;149
Elektrėnai mun.;2016;42;313;154;159
Elektrėnai mun.;2016;43;356;161;195
Elektrėnai mun.;2016;44;367;171;196
Elektrėnai mun.;2016;45;359;193;166
Elektrėnai mun.;2016;46;355;167;188
Elektrėnai mun.;2016;47;358;182;176
Elektrėnai mun.;2016;48;355;156;199
Elektrėnai mun.;2016;49;352;182;170
Elektrėnai mun.;2016;50;336;169;167
Elektrėnai mun.;2016;51;367;182;185
Elektrėnai mun.;2016;52;368;180;188
Elektrėnai mun.;2016;53;431;202;229
Elektrėnai mun.;2016;54;444;200;244
Elektrėnai mun.;2016;55;450;206;244
Elektrėnai mun.;2016;56;401;188;213
Elektrėnai mun.;2016;57;402;190;212
Elektrėnai mun.;2016;58;362;167;195
Elektrėnai mun.;2016;59;334;152;182
Elektrėnai mun.;2016;60;297;140;157
Elektrėnai mun.;2016;61;287;136;151
Elektrėnai mun.;2016;62;259;126;133
Elektrėnai mun.;2016;63;286;119;167
Elektrėnai mun.;2016;64;260;97;163
Elektrėnai mun.;2016;65;270;123;147
Elektrėnai mun.;2016;66;296;141;155
Elektrėnai mun.;2016;67;228;90;138
Elektrėnai mun.;2016;68;203;72;131
Elektrėnai mun.;2016;69;232;96;136
Elektrėnai mun.;2016;70;216;100;116
Elektrėnai mun.;2016;71;196;80;116
Elektrėnai mun.;2016;72;251;83;168
Elektrėnai mun.;2016;73;275;93;182
Elektrėnai mun.;2016;74;225;89;136
Elektrėnai mun.;2016;75;223;78;145
Elektrėnai mun.;2016;76;186;69;117
Elektrėnai mun.;2016;77;232;81;151
Elektrėnai mun.;2016;78;195;51;144
Elektrėnai mun.;2016;79;202;64;138
Elektrėnai mun.;2016;80;152;43;109
Elektrėnai mun.;2016;81;139;38;101
Elektrėnai mun.;2016;82;119;29;90
Elektrėnai mun.;2016;83;136;41;95
Elektrėnai mun.;2016;84;109;28;81
Elektrėnai mun.;2016;85;419;109;310
Elektrėnai mun.;2017;-1;23770;11312;12458
Elektrėnai mun.;2017;0;252;129;123
Elektrėnai mun.;2017;1;278;139;139
Elektrėnai mun.;2017;2;248;116;132
Elektrėnai mun.;2017;3;237;128;109
Elektrėnai mun.;2017;4;247;133;114
Elektrėnai mun.;2017;5;229;119;110
Elektrėnai mun.;2017;6;212;103;109
Elektrėnai mun.;2017;7;224;137;87
Elektrėnai mun.;2017;8;221;133;88
Elektrėnai mun.;2017;9;236;133;103
Elektrėnai mun.;2017;10;209;110;99
Elektrėnai mun.;2017;11;217;126;91
Elektrėnai mun.;2017;12;190;95;95
Elektrėnai mun.;2017;13;203;105;98
Elektrėnai mun.;2017;14;178;88;90
Elektrėnai mun.;2017;15;236;116;120
Elektrėnai mun.;2017;16;260;131;129
Elektrėnai mun.;2017;17;256;134;122
Elektrėnai mun.;2017;18;252;123;129
Elektrėnai mun.;2017;19;315;155;160
Elektrėnai mun.;2017;20;258;122;136
Elektrėnai mun.;2017;21;267;138;129
Elektrėnai mun.;2017;22;268;138;130
Elektrėnai mun.;2017;23;340;175;165
Elektrėnai mun.;2017;24;339;178;161
Elektrėnai mun.;2017;25;316;163;153
Elektrėnai mun.;2017;26;345;181;164
Elektrėnai mun.;2017;27;292;156;136
Elektrėnai mun.;2017;28;307;170;137
Elektrėnai mun.;2017;29;349;193;156
Elektrėnai mun.;2017;30;289;145;144
Elektrėnai mun.;2017;31;291;144;147
Elektrėnai mun.;2017;32;285;166;119
Elektrėnai mun.;2017;33;282;162;120
Elektrėnai mun.;2017;34;281;164;117
Elektrėnai mun.;2017;35;278;153;125
Elektrėnai mun.;2017;36;268;133;135
Elektrėnai mun.;2017;37;298;132;166
Elektrėnai mun.;2017;38;281;152;129
Elektrėnai mun.;2017;39;265;155;110
Elektrėnai mun.;2017;40;248;111;137
Elektrėnai mun.;2017;41;301;163;138
Elektrėnai mun.;2017;42;309;161;148
Elektrėnai mun.;2017;43;320;162;158
Elektrėnai mun.;2017;44;360;164;196
Elektrėnai mun.;2017;45;375;183;192
Elektrėnai mun.;2017;46;373;205;168
Elektrėnai mun.;2017;47;357;172;185
Elektrėnai mun.;2017;48;358;182;176
Elektrėnai mun.;2017;49;350;160;190
Elektrėnai mun.;2017;50;354;186;168
Elektrėnai mun.;2017;51;329;166;163
Elektrėnai mun.;2017;52;369;187;182
Elektrėnai mun.;2017;53;372;183;189
Elektrėnai mun.;2017;54;425;201;224
Elektrėnai mun.;2017;55;432;196;236
Elektrėnai mun.;2017;56;447;208;239
Elektrėnai mun.;2017;57;397;185;212
Elektrėnai mun.;2017;58;402;189;213
Elektrėnai mun.;2017;59;353;161;192
Elektrėnai mun.;2017;60;327;145;182
Elektrėnai mun.;2017;61;289;135;154
Elektrėnai mun.;2017;62;285;134;151
Elektrėnai mun.;2017;63;257;123;134
Elektrėnai mun.;2017;64;279;114;165
Elektrėnai mun.;2017;65;259;95;164
Elektrėnai mun.;2017;66;264;118;146
Elektrėnai mun.;2017;67;287;133;154
Elektrėnai mun.;2017;68;215;79;136
Elektrėnai mun.;2017;69;203;71;132
Elektrėnai mun.;2017;70;230;93;137
Elektrėnai mun.;2017;71;211;99;112
Elektrėnai mun.;2017;72;191;74;117
Elektrėnai mun.;2017;73;248;81;167
Elektrėnai mun.;2017;74;267;85;182
Elektrėnai mun.;2017;75;209;81;128
Elektrėnai mun.;2017;76;213;73;140
Elektrėnai mun.;2017;77;176;64;112
Elektrėnai mun.;2017;78;216;74;142
Elektrėnai mun.;2017;79;188;46;142
Elektrėnai mun.;2017;80;187;52;135
Elektrėnai mun.;2017;81;143;42;101
Elektrėnai mun.;2017;82;121;30;91
Elektrėnai mun.;2017;83;108;26;82
Elektrėnai mun.;2017;84;125;39;86
Elektrėnai mun.;2017;85;442;108;334
Elektrėnai mun.;2018;-1;23724;11454;12270
Elektrėnai mun.;2018;0;241;119;122
Elektrėnai mun.;2018;1;246;126;120
Elektrėnai mun.;2018;2;275;136;139
Elektrėnai mun.;2018;3;244;117;127
Elektrėnai mun.;2018;4;236;126;110
Elektrėnai mun.;2018;5;242;131;111
Elektrėnai mun.;2018;6;226;119;107
Elektrėnai mun.;2018;7;213;103;110
Elektrėnai mun.;2018;8;226;136;90
Elektrėnai mun.;2018;9;222;132;90
Elektrėnai mun.;2018;10;230;131;99
Elektrėnai mun.;2018;11;202;107;95
Elektrėnai mun.;2018;12;220;128;92
Elektrėnai mun.;2018;13;189;95;94
Elektrėnai mun.;2018;14;195;100;95
Elektrėnai mun.;2018;15;171;84;87
Elektrėnai mun.;2018;16;232;114;118
Elektrėnai mun.;2018;17;254;130;124
Elektrėnai mun.;2018;18;248;131;117
Elektrėnai mun.;2018;19;246;122;124
Elektrėnai mun.;2018;20;305;151;154
Elektrėnai mun.;2018;21;245;115;130
Elektrėnai mun.;2018;22;265;140;125
Elektrėnai mun.;2018;23;255;135;120
Elektrėnai mun.;2018;24;323;165;158
Elektrėnai mun.;2018;25;330;175;155
Elektrėnai mun.;2018;26;308;160;148
Elektrėnai mun.;2018;27;332;175;157
Elektrėnai mun.;2018;28;282;151;131
Elektrėnai mun.;2018;29;311;173;138
Elektrėnai mun.;2018;30;342;189;153
Elektrėnai mun.;2018;31;304;160;144
Elektrėnai mun.;2018;32;287;143;144
Elektrėnai mun.;2018;33;290;171;119
Elektrėnai mun.;2018;34;282;166;116
Elektrėnai mun.;2018;35;289;172;117
Elektrėnai mun.;2018;36;293;172;121
Elektrėnai mun.;2018;37;274;139;135
Elektrėnai mun.;2018;38;302;142;160
Elektrėnai mun.;2018;39;286;158;128
Elektrėnai mun.;2018;40;273;164;109
Elektrėnai mun.;2018;41;266;129;137
Elektrėnai mun.;2018;42;315;179;136
Elektrėnai mun.;2018;43;316;170;146
Elektrėnai mun.;2018;44;329;171;158
Elektrėnai mun.;2018;45;363;175;188
Elektrėnai mun.;2018;46;377;191;186
Elektrėnai mun.;2018;47;378;213;165
Elektrėnai mun.;2018;48;372;188;184
Elektrėnai mun.;2018;49;357;183;174
Elektrėnai mun.;2018;50;361;171;190
Elektrėnai mun.;2018;51;357;190;167
Elektrėnai mun.;2018;52;330;170;160
Elektrėnai mun.;2018;53;376;194;182
Elektrėnai mun.;2018;54;370;182;188
Elektrėnai mun.;2018;55;430;210;220
Elektrėnai mun.;2018;56;433;197;236
Elektrėnai mun.;2018;57;447;211;236
Elektrėnai mun.;2018;58;405;194;211
Elektrėnai mun.;2018;59;406;194;212
Elektrėnai mun.;2018;60;349;158;191
Elektrėnai mun.;2018;61;323;146;177
Elektrėnai mun.;2018;62;286;133;153
Elektrėnai mun.;2018;63;277;128;149
Elektrėnai mun.;2018;64;251;119;132
Elektrėnai mun.;2018;65;276;114;162
Elektrėnai mun.;2018;66;251;93;158
Elektrėnai mun.;2018;67;263;117;146
Elektrėnai mun.;2018;68;282;127;155
Elektrėnai mun.;2018;69;212;76;136
Elektrėnai mun.;2018;70;197;67;130
Elektrėnai mun.;2018;71;221;87;134
Elektrėnai mun.;2018;72;207;93;114
Elektrėnai mun.;2018;73;185;70;115
Elektrėnai mun.;2018;74;243;80;163
Elektrėnai mun.;2018;75;251;79;172
Elektrėnai mun.;2018;76;204;78;126
Elektrėnai mun.;2018;77;200;65;135
Elektrėnai mun.;2018;78;165;57;108
Elektrėnai mun.;2018;79;198;64;134
Elektrėnai mun.;2018;80;173;37;136
Elektrėnai mun.;2018;81;172;43;129
Elektrėnai mun.;2018;82;130;39;91
Elektrėnai mun.;2018;83;117;27;90
Elektrėnai mun.;2018;84;94;22;72
Elektrėnai mun.;2018;85;473;120;353
Ignalina d. mun.;2001;-1;23033;10907;12126
Ignalina d. mun.;2001;0;196;108;88
Ignalina d. mun.;2001;1;180;89;91
Ignalina d. mun.;2001;2;190;101;89
Ignalina d. mun.;2001;3;217;124;93
Ignalina d. mun.;2001;4;180;96;84
Ignalina d. mun.;2001;5;244;132;112
Ignalina d. mun.;2001;6;225;123;102
Ignalina d. mun.;2001;7;277;146;131
Ignalina d. mun.;2001;8;302;143;159
Ignalina d. mun.;2001;9;289;160;129
Ignalina d. mun.;2001;10;304;163;141
Ignalina d. mun.;2001;11;322;174;148
Ignalina d. mun.;2001;12;343;178;165
Ignalina d. mun.;2001;13;316;158;158
Ignalina d. mun.;2001;14;329;170;159
Ignalina d. mun.;2001;15;354;185;169
Ignalina d. mun.;2001;16;303;157;146
Ignalina d. mun.;2001;17;310;147;163
Ignalina d. mun.;2001;18;272;149;123
Ignalina d. mun.;2001;19;213;130;83
Ignalina d. mun.;2001;20;204;133;71
Ignalina d. mun.;2001;21;188;118;70
Ignalina d. mun.;2001;22;199;123;76
Ignalina d. mun.;2001;23;198;99;99
Ignalina d. mun.;2001;24;214;109;105
Ignalina d. mun.;2001;25;218;115;103
Ignalina d. mun.;2001;26;218;123;95
Ignalina d. mun.;2001;27;259;138;121
Ignalina d. mun.;2001;28;273;146;127
Ignalina d. mun.;2001;29;275;163;112
Ignalina d. mun.;2001;30;250;116;134
Ignalina d. mun.;2001;31;256;136;120
Ignalina d. mun.;2001;32;292;153;139
Ignalina d. mun.;2001;33;266;141;125
Ignalina d. mun.;2001;34;291;157;134
Ignalina d. mun.;2001;35;298;175;123
Ignalina d. mun.;2001;36;272;143;129
Ignalina d. mun.;2001;37;359;196;163
Ignalina d. mun.;2001;38;316;159;157
Ignalina d. mun.;2001;39;338;176;162
Ignalina d. mun.;2001;40;341;171;170
Ignalina d. mun.;2001;41;327;165;162
Ignalina d. mun.;2001;42;301;152;149
Ignalina d. mun.;2001;43;298;165;133
Ignalina d. mun.;2001;44;303;152;151
Ignalina d. mun.;2001;45;271;141;130
Ignalina d. mun.;2001;46;284;133;151
Ignalina d. mun.;2001;47;264;138;126
Ignalina d. mun.;2001;48;295;147;148
Ignalina d. mun.;2001;49;270;136;134
Ignalina d. mun.;2001;50;300;170;130
Ignalina d. mun.;2001;51;296;146;150
Ignalina d. mun.;2001;52;271;128;143
Ignalina d. mun.;2001;53;259;133;126
Ignalina d. mun.;2001;54;212;109;103
Ignalina d. mun.;2001;55;274;127;147
Ignalina d. mun.;2001;56;255;129;126
Ignalina d. mun.;2001;57;288;117;171
Ignalina d. mun.;2001;58;327;158;169
Ignalina d. mun.;2001;59;303;131;172
Ignalina d. mun.;2001;60;339;158;181
Ignalina d. mun.;2001;61;302;133;169
Ignalina d. mun.;2001;62;339;163;176
Ignalina d. mun.;2001;63;338;147;191
Ignalina d. mun.;2001;64;332;143;189
Ignalina d. mun.;2001;65;315;131;184
Ignalina d. mun.;2001;66;334;127;207
Ignalina d. mun.;2001;67;338;127;211
Ignalina d. mun.;2001;68;358;112;246
Ignalina d. mun.;2001;69;303;120;183
Ignalina d. mun.;2001;70;329;123;206
Ignalina d. mun.;2001;71;291;95;196
Ignalina d. mun.;2001;72;293;94;199
Ignalina d. mun.;2001;73;279;87;192
Ignalina d. mun.;2001;74;253;74;179
Ignalina d. mun.;2001;75;279;82;197
Ignalina d. mun.;2001;76;248;61;187
Ignalina d. mun.;2001;77;219;70;149
Ignalina d. mun.;2001;78;209;63;146
Ignalina d. mun.;2001;79;174;43;131
Ignalina d. mun.;2001;80;141;53;88
Ignalina d. mun.;2001;81;86;28;58
Ignalina d. mun.;2001;82;62;15;47
Ignalina d. mun.;2001;83;61;17;44
Ignalina d. mun.;2001;84;48;11;37
Ignalina d. mun.;2001;85;474;130;344
Ignalina d. mun.;2002;-1;22952;10868;12084
Ignalina d. mun.;2002;0;170;87;83
Ignalina d. mun.;2002;1;199;110;89
Ignalina d. mun.;2002;2;184;92;92
Ignalina d. mun.;2002;3;192;102;90
Ignalina d. mun.;2002;4;220;125;95
Ignalina d. mun.;2002;5;185;99;86
Ignalina d. mun.;2002;6;245;132;113
Ignalina d. mun.;2002;7;230;124;106
Ignalina d. mun.;2002;8;278;149;129
Ignalina d. mun.;2002;9;301;142;159
Ignalina d. mun.;2002;10;291;162;129
Ignalina d. mun.;2002;11;304;162;142
Ignalina d. mun.;2002;12;325;174;151
Ignalina d. mun.;2002;13;343;179;164
Ignalina d. mun.;2002;14;317;157;160
Ignalina d. mun.;2002;15;330;168;162
Ignalina d. mun.;2002;16;356;188;168
Ignalina d. mun.;2002;17;301;154;147
Ignalina d. mun.;2002;18;307;144;163
Ignalina d. mun.;2002;19;269;145;124
Ignalina d. mun.;2002;20;216;132;84
Ignalina d. mun.;2002;21;202;130;72
Ignalina d. mun.;2002;22;192;118;74
Ignalina d. mun.;2002;23;199;122;77
Ignalina d. mun.;2002;24;195;94;101
Ignalina d. mun.;2002;25;215;108;107
Ignalina d. mun.;2002;26;216;114;102
Ignalina d. mun.;2002;27;220;125;95
Ignalina d. mun.;2002;28;248;131;117
Ignalina d. mun.;2002;29;267;139;128
Ignalina d. mun.;2002;30;267;157;110
Ignalina d. mun.;2002;31;248;116;132
Ignalina d. mun.;2002;32;259;138;121
Ignalina d. mun.;2002;33;290;152;138
Ignalina d. mun.;2002;34;265;141;124
Ignalina d. mun.;2002;35;289;157;132
Ignalina d. mun.;2002;36;303;178;125
Ignalina d. mun.;2002;37;271;141;130
Ignalina d. mun.;2002;38;356;196;160
Ignalina d. mun.;2002;39;308;154;154
Ignalina d. mun.;2002;40;342;178;164
Ignalina d. mun.;2002;41;336;169;167
Ignalina d. mun.;2002;42;331;170;161
Ignalina d. mun.;2002;43;306;158;148
Ignalina d. mun.;2002;44;302;170;132
Ignalina d. mun.;2002;45;305;153;152
Ignalina d. mun.;2002;46;268;140;128
Ignalina d. mun.;2002;47;282;133;149
Ignalina d. mun.;2002;48;259;133;126
Ignalina d. mun.;2002;49;291;145;146
Ignalina d. mun.;2002;50;271;137;134
Ignalina d. mun.;2002;51;297;169;128
Ignalina d. mun.;2002;52;302;149;153
Ignalina d. mun.;2002;53;275;130;145
Ignalina d. mun.;2002;54;256;131;125
Ignalina d. mun.;2002;55;210;109;101
Ignalina d. mun.;2002;56;267;123;144
Ignalina d. mun.;2002;57;256;129;127
Ignalina d. mun.;2002;58;283;114;169
Ignalina d. mun.;2002;59;322;156;166
Ignalina d. mun.;2002;60;301;130;171
Ignalina d. mun.;2002;61;336;155;181
Ignalina d. mun.;2002;62;300;133;167
Ignalina d. mun.;2002;63;345;164;181
Ignalina d. mun.;2002;64;341;148;193
Ignalina d. mun.;2002;65;328;140;188
Ignalina d. mun.;2002;66;314;131;183
Ignalina d. mun.;2002;67;325;124;201
Ignalina d. mun.;2002;68;332;122;210
Ignalina d. mun.;2002;69;347;107;240
Ignalina d. mun.;2002;70;297;115;182
Ignalina d. mun.;2002;71;322;117;205
Ignalina d. mun.;2002;72;280;87;193
Ignalina d. mun.;2002;73;290;92;198
Ignalina d. mun.;2002;74;274;85;189
Ignalina d. mun.;2002;75;249;73;176
Ignalina d. mun.;2002;76;265;77;188
Ignalina d. mun.;2002;77;237;54;183
Ignalina d. mun.;2002;78;209;63;146
Ignalina d. mun.;2002;79;197;57;140
Ignalina d. mun.;2002;80;164;42;122
Ignalina d. mun.;2002;81;136;52;84
Ignalina d. mun.;2002;82;77;25;52
Ignalina d. mun.;2002;83;54;9;45
Ignalina d. mun.;2002;84;61;16;45
Ignalina d. mun.;2002;85;437;116;321
Ignalina d. mun.;2003;-1;22653;10701;11952
Ignalina d. mun.;2003;0;173;89;84
Ignalina d. mun.;2003;1;168;86;82
Ignalina d. mun.;2003;2;199;110;89
Ignalina d. mun.;2003;3;179;88;91
Ignalina d. mun.;2003;4;194;102;92
Ignalina d. mun.;2003;5;219;123;96
Ignalina d. mun.;2003;6;185;100;85
Ignalina d. mun.;2003;7;243;130;113
Ignalina d. mun.;2003;8;229;123;106
Ignalina d. mun.;2003;9;274;146;128
Ignalina d. mun.;2003;10;300;142;158
Ignalina d. mun.;2003;11;287;158;129
Ignalina d. mun.;2003;12;297;158;139
Ignalina d. mun.;2003;13;326;174;152
Ignalina d. mun.;2003;14;333;171;162
Ignalina d. mun.;2003;15;309;150;159
Ignalina d. mun.;2003;16;324;163;161
Ignalina d. mun.;2003;17;352;186;166
Ignalina d. mun.;2003;18;298;155;143
Ignalina d. mun.;2003;19;305;144;161
Ignalina d. mun.;2003;20;265;144;121
Ignalina d. mun.;2003;21;220;131;89
Ignalina d. mun.;2003;22;204;130;74
Ignalina d. mun.;2003;23;202;123;79
Ignalina d. mun.;2003;24;198;121;77
Ignalina d. mun.;2003;25;189;93;96
Ignalina d. mun.;2003;26;217;107;110
Ignalina d. mun.;2003;27;216;114;102
Ignalina d. mun.;2003;28;221;127;94
Ignalina d. mun.;2003;29;244;131;113
Ignalina d. mun.;2003;30;270;140;130
Ignalina d. mun.;2003;31;269;160;109
Ignalina d. mun.;2003;32;242;113;129
Ignalina d. mun.;2003;33;259;137;122
Ignalina d. mun.;2003;34;293;154;139
Ignalina d. mun.;2003;35;262;140;122
Ignalina d. mun.;2003;36;285;157;128
Ignalina d. mun.;2003;37;292;174;118
Ignalina d. mun.;2003;38;275;144;131
Ignalina d. mun.;2003;39;357;198;159
Ignalina d. mun.;2003;40;299;150;149
Ignalina d. mun.;2003;41;338;175;163
Ignalina d. mun.;2003;42;332;167;165
Ignalina d. mun.;2003;43;328;167;161
Ignalina d. mun.;2003;44;302;156;146
Ignalina d. mun.;2003;45;301;168;133
Ignalina d. mun.;2003;46;296;147;149
Ignalina d. mun.;2003;47;261;133;128
Ignalina d. mun.;2003;48;282;131;151
Ignalina d. mun.;2003;49;255;129;126
Ignalina d. mun.;2003;50;289;143;146
Ignalina d. mun.;2003;51;265;132;133
Ignalina d. mun.;2003;52;293;169;124
Ignalina d. mun.;2003;53;295;144;151
Ignalina d. mun.;2003;54;267;124;143
Ignalina d. mun.;2003;55;251;128;123
Ignalina d. mun.;2003;56;207;106;101
Ignalina d. mun.;2003;57;265;122;143
Ignalina d. mun.;2003;58;248;123;125
Ignalina d. mun.;2003;59;283;110;173
Ignalina d. mun.;2003;60;319;152;167
Ignalina d. mun.;2003;61;297;129;168
Ignalina d. mun.;2003;62;329;150;179
Ignalina d. mun.;2003;63;294;126;168
Ignalina d. mun.;2003;64;341;162;179
Ignalina d. mun.;2003;65;332;143;189
Ignalina d. mun.;2003;66;325;138;187
Ignalina d. mun.;2003;67;308;126;182
Ignalina d. mun.;2003;68;318;118;200
Ignalina d. mun.;2003;69;323;116;207
Ignalina d. mun.;2003;70;344;102;242
Ignalina d. mun.;2003;71;285;109;176
Ignalina d. mun.;2003;72;314;111;203
Ignalina d. mun.;2003;73;273;81;192
Ignalina d. mun.;2003;74;278;83;195
Ignalina d. mun.;2003;75;260;79;181
Ignalina d. mun.;2003;76;229;62;167
Ignalina d. mun.;2003;77;261;75;186
Ignalina d. mun.;2003;78;230;56;174
Ignalina d. mun.;2003;79;188;56;132
Ignalina d. mun.;2003;80;185;52;133
Ignalina d. mun.;2003;81;146;37;109
Ignalina d. mun.;2003;82;120;43;77
Ignalina d. mun.;2003;83;67;20;47
Ignalina d. mun.;2003;84;51;7;44
Ignalina d. mun.;2003;85;405;108;297
Ignalina d. mun.;2004;-1;21944;10351;11593
Ignalina d. mun.;2004;0;170;104;66
Ignalina d. mun.;2004;1;179;91;88
Ignalina d. mun.;2004;2;171;86;85
Ignalina d. mun.;2004;3;194;107;87
Ignalina d. mun.;2004;4;172;82;90
Ignalina d. mun.;2004;5;191;101;90
Ignalina d. mun.;2004;6;215;121;94
Ignalina d. mun.;2004;7;186;102;84
Ignalina d. mun.;2004;8;241;129;112
Ignalina d. mun.;2004;9;228;123;105
Ignalina d. mun.;2004;10;272;146;126
Ignalina d. mun.;2004;11;299;141;158
Ignalina d. mun.;2004;12;280;152;128
Ignalina d. mun.;2004;13;296;158;138
Ignalina d. mun.;2004;14;311;165;146
Ignalina d. mun.;2004;15;323;165;158
Ignalina d. mun.;2004;16;294;144;150
Ignalina d. mun.;2004;17;314;160;154
Ignalina d. mun.;2004;18;342;178;164
Ignalina d. mun.;2004;19;282;147;135
Ignalina d. mun.;2004;20;298;141;157
Ignalina d. mun.;2004;21;251;137;114
Ignalina d. mun.;2004;22;214;129;85
Ignalina d. mun.;2004;23;193;126;67
Ignalina d. mun.;2004;24;191;120;71
Ignalina d. mun.;2004;25;189;112;77
Ignalina d. mun.;2004;26;182;85;97
Ignalina d. mun.;2004;27;205;100;105
Ignalina d. mun.;2004;28;204;110;94
Ignalina d. mun.;2004;29;218;127;91
Ignalina d. mun.;2004;30;237;132;105
Ignalina d. mun.;2004;31;249;124;125
Ignalina d. mun.;2004;32;264;158;106
Ignalina d. mun.;2004;33;233;108;125
Ignalina d. mun.;2004;34;255;136;119
Ignalina d. mun.;2004;35;283;149;134
Ignalina d. mun.;2004;36;253;134;119
Ignalina d. mun.;2004;37;280;150;130
Ignalina d. mun.;2004;38;284;169;115
Ignalina d. mun.;2004;39;266;136;130
Ignalina d. mun.;2004;40;340;189;151
Ignalina d. mun.;2004;41;290;143;147
Ignalina d. mun.;2004;42;328;167;161
Ignalina d. mun.;2004;43;321;160;161
Ignalina d. mun.;2004;44;312;156;156
Ignalina d. mun.;2004;45;296;153;143
Ignalina d. mun.;2004;46;294;165;129
Ignalina d. mun.;2004;47;288;143;145
Ignalina d. mun.;2004;48;251;126;125
Ignalina d. mun.;2004;49;269;126;143
Ignalina d. mun.;2004;50;246;127;119
Ignalina d. mun.;2004;51;281;137;144
Ignalina d. mun.;2004;52;248;118;130
Ignalina d. mun.;2004;53;291;166;125
Ignalina d. mun.;2004;54;285;139;146
Ignalina d. mun.;2004;55;251;112;139
Ignalina d. mun.;2004;56;247;123;124
Ignalina d. mun.;2004;57;199;101;98
Ignalina d. mun.;2004;58;261;120;141
Ignalina d. mun.;2004;59;236;113;123
Ignalina d. mun.;2004;60;274;106;168
Ignalina d. mun.;2004;61;308;148;160
Ignalina d. mun.;2004;62;276;116;160
Ignalina d. mun.;2004;63;321;142;179
Ignalina d. mun.;2004;64;284;120;164
Ignalina d. mun.;2004;65;338;163;175
Ignalina d. mun.;2004;66;326;141;185
Ignalina d. mun.;2004;67;310;128;182
Ignalina d. mun.;2004;68;297;119;178
Ignalina d. mun.;2004;69;313;115;198
Ignalina d. mun.;2004;70;308;109;199
Ignalina d. mun.;2004;71;340;96;244
Ignalina d. mun.;2004;72;266;98;168
Ignalina d. mun.;2004;73;305;106;199
Ignalina d. mun.;2004;74;268;79;189
Ignalina d. mun.;2004;75;264;76;188
Ignalina d. mun.;2004;76;253;79;174
Ignalina d. mun.;2004;77;214;60;154
Ignalina d. mun.;2004;78;242;59;183
Ignalina d. mun.;2004;79;203;41;162
Ignalina d. mun.;2004;80;177;52;125
Ignalina d. mun.;2004;81;168;47;121
Ignalina d. mun.;2004;82;132;33;99
Ignalina d. mun.;2004;83;105;37;68
Ignalina d. mun.;2004;84;57;17;40
Ignalina d. mun.;2004;85;352;95;257
Ignalina d. mun.;2005;-1;21463;10119;11344
Ignalina d. mun.;2005;0;159;92;67
Ignalina d. mun.;2005;1;168;105;63
Ignalina d. mun.;2005;2;180;91;89
Ignalina d. mun.;2005;3;167;83;84
Ignalina d. mun.;2005;4;192;105;87
Ignalina d. mun.;2005;5;177;84;93
Ignalina d. mun.;2005;6;194;102;92
Ignalina d. mun.;2005;7;213;121;92
Ignalina d. mun.;2005;8;185;101;84
Ignalina d. mun.;2005;9;242;129;113
Ignalina d. mun.;2005;10;225;121;104
Ignalina d. mun.;2005;11;276;149;127
Ignalina d. mun.;2005;12;298;140;158
Ignalina d. mun.;2005;13;277;151;126
Ignalina d. mun.;2005;14;295;156;139
Ignalina d. mun.;2005;15;307;163;144
Ignalina d. mun.;2005;16;317;160;157
Ignalina d. mun.;2005;17;292;140;152
Ignalina d. mun.;2005;18;307;158;149
Ignalina d. mun.;2005;19;330;172;158
Ignalina d. mun.;2005;20;274;148;126
Ignalina d. mun.;2005;21;282;137;145
Ignalina d. mun.;2005;22;245;135;110
Ignalina d. mun.;2005;23;196;124;72
Ignalina d. mun.;2005;24;188;121;67
Ignalina d. mun.;2005;25;176;115;61
Ignalina d. mun.;2005;26;188;111;77
Ignalina d. mun.;2005;27;181;88;93
Ignalina d. mun.;2005;28;191;90;101
Ignalina d. mun.;2005;29;192;103;89
Ignalina d. mun.;2005;30;208;117;91
Ignalina d. mun.;2005;31;228;125;103
Ignalina d. mun.;2005;32;241;123;118
Ignalina d. mun.;2005;33;259;158;101
Ignalina d. mun.;2005;34;231;107;124
Ignalina d. mun.;2005;35;245;129;116
Ignalina d. mun.;2005;36;277;146;131
Ignalina d. mun.;2005;37;246;132;114
Ignalina d. mun.;2005;38;277;149;128
Ignalina d. mun.;2005;39;276;165;111
Ignalina d. mun.;2005;40;255;131;124
Ignalina d. mun.;2005;41;325;180;145
Ignalina d. mun.;2005;42;284;141;143
Ignalina d. mun.;2005;43;322;169;153
Ignalina d. mun.;2005;44;324;161;163
Ignalina d. mun.;2005;45;306;148;158
Ignalina d. mun.;2005;46;294;154;140
Ignalina d. mun.;2005;47;288;160;128
Ignalina d. mun.;2005;48;282;139;143
Ignalina d. mun.;2005;49;240;123;117
Ignalina d. mun.;2005;50;269;127;142
Ignalina d. mun.;2005;51;247;124;123
Ignalina d. mun.;2005;52;266;131;135
Ignalina d. mun.;2005;53;244;117;127
Ignalina d. mun.;2005;54;281;161;120
Ignalina d. mun.;2005;55;280;135;145
Ignalina d. mun.;2005;56;242;106;136
Ignalina d. mun.;2005;57;241;120;121
Ignalina d. mun.;2005;58;196;98;98
Ignalina d. mun.;2005;59;252;114;138
Ignalina d. mun.;2005;60;240;111;129
Ignalina d. mun.;2005;61;268;103;165
Ignalina d. mun.;2005;62;303;144;159
Ignalina d. mun.;2005;63;271;113;158
Ignalina d. mun.;2005;64;315;136;179
Ignalina d. mun.;2005;65;280;114;166
Ignalina d. mun.;2005;66;326;153;173
Ignalina d. mun.;2005;67;319;135;184
Ignalina d. mun.;2005;68;296;121;175
Ignalina d. mun.;2005;69;295;115;180
Ignalina d. mun.;2005;70;308;112;196
Ignalina d. mun.;2005;71;296;100;196
Ignalina d. mun.;2005;72;330;90;240
Ignalina d. mun.;2005;73;258;91;167
Ignalina d. mun.;2005;74;296;100;196
Ignalina d. mun.;2005;75;256;70;186
Ignalina d. mun.;2005;76;248;71;177
Ignalina d. mun.;2005;77;246;73;173
Ignalina d. mun.;2005;78;201;57;144
Ignalina d. mun.;2005;79;220;50;170
Ignalina d. mun.;2005;80;196;37;159
Ignalina d. mun.;2005;81;161;49;112
Ignalina d. mun.;2005;82;154;42;112
Ignalina d. mun.;2005;83;125;36;89
Ignalina d. mun.;2005;84;101;36;65
Ignalina d. mun.;2005;85;314;75;239
Ignalina d. mun.;2006;-1;20893;9813;11080
Ignalina d. mun.;2006;0;153;77;76
Ignalina d. mun.;2006;1;158;90;68
Ignalina d. mun.;2006;2;164;102;62
Ignalina d. mun.;2006;3;177;91;86
Ignalina d. mun.;2006;4;166;82;84
Ignalina d. mun.;2006;5;190;104;86
Ignalina d. mun.;2006;6;174;84;90
Ignalina d. mun.;2006;7;195;100;95
Ignalina d. mun.;2006;8;213;121;92
Ignalina d. mun.;2006;9;184;102;82
Ignalina d. mun.;2006;10;240;130;110
Ignalina d. mun.;2006;11;227;122;105
Ignalina d. mun.;2006;12;276;149;127
Ignalina d. mun.;2006;13;292;138;154
Ignalina d. mun.;2006;14;275;150;125
Ignalina d. mun.;2006;15;287;153;134
Ignalina d. mun.;2006;16;297;158;139
Ignalina d. mun.;2006;17;306;153;153
Ignalina d. mun.;2006;18;281;136;145
Ignalina d. mun.;2006;19;292;152;140
Ignalina d. mun.;2006;20;314;165;149
Ignalina d. mun.;2006;21;261;139;122
Ignalina d. mun.;2006;22;266;130;136
Ignalina d. mun.;2006;23;234;131;103
Ignalina d. mun.;2006;24;180;118;62
Ignalina d. mun.;2006;25;175;110;65
Ignalina d. mun.;2006;26;173;117;56
Ignalina d. mun.;2006;27;181;106;75
Ignalina d. mun.;2006;28;164;75;89
Ignalina d. mun.;2006;29;186;89;97
Ignalina d. mun.;2006;30;180;97;83
Ignalina d. mun.;2006;31;203;114;89
Ignalina d. mun.;2006;32;217;118;99
Ignalina d. mun.;2006;33;233;118;115
Ignalina d. mun.;2006;34;250;150;100
Ignalina d. mun.;2006;35;228;108;120
Ignalina d. mun.;2006;36;237;127;110
Ignalina d. mun.;2006;37;268;139;129
Ignalina d. mun.;2006;38;244;130;114
Ignalina d. mun.;2006;39;268;141;127
Ignalina d. mun.;2006;40;272;162;110
Ignalina d. mun.;2006;41;248;126;122
Ignalina d. mun.;2006;42;319;177;142
Ignalina d. mun.;2006;43;280;140;140
Ignalina d. mun.;2006;44;318;166;152
Ignalina d. mun.;2006;45;318;156;162
Ignalina d. mun.;2006;46;306;147;159
Ignalina d. mun.;2006;47;292;150;142
Ignalina d. mun.;2006;48;281;154;127
Ignalina d. mun.;2006;49;272;132;140
Ignalina d. mun.;2006;50;231;113;118
Ignalina d. mun.;2006;51;271;131;140
Ignalina d. mun.;2006;52;236;120;116
Ignalina d. mun.;2006;53;264;128;136
Ignalina d. mun.;2006;54;240;114;126
Ignalina d. mun.;2006;55;279;156;123
Ignalina d. mun.;2006;56;279;134;145
Ignalina d. mun.;2006;57;242;105;137
Ignalina d. mun.;2006;58;240;119;121
Ignalina d. mun.;2006;59;190;94;96
Ignalina d. mun.;2006;60;245;108;137
Ignalina d. mun.;2006;61;233;105;128
Ignalina d. mun.;2006;62;261;99;162
Ignalina d. mun.;2006;63;298;137;161
Ignalina d. mun.;2006;64;267;111;156
Ignalina d. mun.;2006;65;308;133;175
Ignalina d. mun.;2006;66;266;105;161
Ignalina d. mun.;2006;67;314;142;172
Ignalina d. mun.;2006;68;301;125;176
Ignalina d. mun.;2006;69;289;113;176
Ignalina d. mun.;2006;70;284;108;176
Ignalina d. mun.;2006;71;300;109;191
Ignalina d. mun.;2006;72;284;94;190
Ignalina d. mun.;2006;73;320;89;231
Ignalina d. mun.;2006;74;249;87;162
Ignalina d. mun.;2006;75;288;95;193
Ignalina d. mun.;2006;76;239;65;174
Ignalina d. mun.;2006;77;238;66;172
Ignalina d. mun.;2006;78;232;64;168
Ignalina d. mun.;2006;79;192;54;138
Ignalina d. mun.;2006;80;210;47;163
Ignalina d. mun.;2006;81;177;34;143
Ignalina d. mun.;2006;82;147;46;101
Ignalina d. mun.;2006;83;130;33;97
Ignalina d. mun.;2006;84;102;23;79
Ignalina d. mun.;2006;85;332;81;251
Ignalina d. mun.;2007;-1;20368;9528;10840
Ignalina d. mun.;2007;0;135;62;73
Ignalina d. mun.;2007;1;153;77;76
Ignalina d. mun.;2007;2;155;92;63
Ignalina d. mun.;2007;3;161;100;61
Ignalina d. mun.;2007;4;175;92;83
Ignalina d. mun.;2007;5;167;84;83
Ignalina d. mun.;2007;6;189;102;87
Ignalina d. mun.;2007;7;173;84;89
Ignalina d. mun.;2007;8;192;97;95
Ignalina d. mun.;2007;9;214;123;91
Ignalina d. mun.;2007;10;187;103;84
Ignalina d. mun.;2007;11;240;132;108
Ignalina d. mun.;2007;12;229;121;108
Ignalina d. mun.;2007;13;272;146;126
Ignalina d. mun.;2007;14;288;136;152
Ignalina d. mun.;2007;15;274;149;125
Ignalina d. mun.;2007;16;281;151;130
Ignalina d. mun.;2007;17;290;154;136
Ignalina d. mun.;2007;18;302;152;150
Ignalina d. mun.;2007;19;276;134;142
Ignalina d. mun.;2007;20;278;146;132
Ignalina d. mun.;2007;21;300;157;143
Ignalina d. mun.;2007;22;251;133;118
Ignalina d. mun.;2007;23;254;124;130
Ignalina d. mun.;2007;24;219;123;96
Ignalina d. mun.;2007;25;162;111;51
Ignalina d. mun.;2007;26;162;102;60
Ignalina d. mun.;2007;27;159;106;53
Ignalina d. mun.;2007;28;162;98;64
Ignalina d. mun.;2007;29;159;73;86
Ignalina d. mun.;2007;30;181;85;96
Ignalina d. mun.;2007;31;178;97;81
Ignalina d. mun.;2007;32;203;114;89
Ignalina d. mun.;2007;33;213;116;97
Ignalina d. mun.;2007;34;229;116;113
Ignalina d. mun.;2007;35;248;148;100
Ignalina d. mun.;2007;36;225;108;117
Ignalina d. mun.;2007;37;229;122;107
Ignalina d. mun.;2007;38;263;133;130
Ignalina d. mun.;2007;39;243;130;113
Ignalina d. mun.;2007;40;263;138;125
Ignalina d. mun.;2007;41;268;159;109
Ignalina d. mun.;2007;42;242;124;118
Ignalina d. mun.;2007;43;311;171;140
Ignalina d. mun.;2007;44;273;134;139
Ignalina d. mun.;2007;45;307;157;150
Ignalina d. mun.;2007;46;316;154;162
Ignalina d. mun.;2007;47;298;140;158
Ignalina d. mun.;2007;48;284;144;140
Ignalina d. mun.;2007;49;278;153;125
Ignalina d. mun.;2007;50;264;125;139
Ignalina d. mun.;2007;51;224;107;117
Ignalina d. mun.;2007;52;265;126;139
Ignalina d. mun.;2007;53;234;118;116
Ignalina d. mun.;2007;54;262;129;133
Ignalina d. mun.;2007;55;233;110;123
Ignalina d. mun.;2007;56;273;151;122
Ignalina d. mun.;2007;57;275;129;146
Ignalina d. mun.;2007;58;243;103;140
Ignalina d. mun.;2007;59;233;113;120
Ignalina d. mun.;2007;60;182;88;94
Ignalina d. mun.;2007;61;239;103;136
Ignalina d. mun.;2007;62;222;96;126
Ignalina d. mun.;2007;63;249;89;160
Ignalina d. mun.;2007;64;292;133;159
Ignalina d. mun.;2007;65;260;107;153
Ignalina d. mun.;2007;66;299;125;174
Ignalina d. mun.;2007;67;257;97;160
Ignalina d. mun.;2007;68;304;135;169
Ignalina d. mun.;2007;69;293;121;172
Ignalina d. mun.;2007;70;278;103;175
Ignalina d. mun.;2007;71;272;99;173
Ignalina d. mun.;2007;72;291;105;186
Ignalina d. mun.;2007;73;276;86;190
Ignalina d. mun.;2007;74;306;86;220
Ignalina d. mun.;2007;75;245;85;160
Ignalina d. mun.;2007;76;269;89;180
Ignalina d. mun.;2007;77;225;59;166
Ignalina d. mun.;2007;78;222;59;163
Ignalina d. mun.;2007;79;218;60;158
Ignalina d. mun.;2007;80;180;50;130
Ignalina d. mun.;2007;81;202;43;159
Ignalina d. mun.;2007;82;157;29;128
Ignalina d. mun.;2007;83;127;39;88
Ignalina d. mun.;2007;84;112;26;86
Ignalina d. mun.;2007;85;374;98;276
Ignalina d. mun.;2008;-1;19838;9290;10548
Ignalina d. mun.;2008;0;123;68;55
Ignalina d. mun.;2008;1;137;63;74
Ignalina d. mun.;2008;2;153;76;77
Ignalina d. mun.;2008;3;153;91;62
Ignalina d. mun.;2008;4;159;100;59
Ignalina d. mun.;2008;5;170;90;80
Ignalina d. mun.;2008;6;163;83;80
Ignalina d. mun.;2008;7;180;98;82
Ignalina d. mun.;2008;8;170;82;88
Ignalina d. mun.;2008;9;192;98;94
Ignalina d. mun.;2008;10;212;122;90
Ignalina d. mun.;2008;11;186;102;84
Ignalina d. mun.;2008;12;238;131;107
Ignalina d. mun.;2008;13;227;119;108
Ignalina d. mun.;2008;14;271;145;126
Ignalina d. mun.;2008;15;285;135;150
Ignalina d. mun.;2008;16;272;148;124
Ignalina d. mun.;2008;17;276;149;127
Ignalina d. mun.;2008;18;286;152;134
Ignalina d. mun.;2008;19;296;150;146
Ignalina d. mun.;2008;20;269;131;138
Ignalina d. mun.;2008;21;263;142;121
Ignalina d. mun.;2008;22;289;153;136
Ignalina d. mun.;2008;23;248;128;120
Ignalina d. mun.;2008;24;252;122;130
Ignalina d. mun.;2008;25;206;119;87
Ignalina d. mun.;2008;26;157;109;48
Ignalina d. mun.;2008;27;153;95;58
Ignalina d. mun.;2008;28;150;102;48
Ignalina d. mun.;2008;29;151;91;60
Ignalina d. mun.;2008;30;151;68;83
Ignalina d. mun.;2008;31;177;83;94
Ignalina d. mun.;2008;32;175;98;77
Ignalina d. mun.;2008;33;195;112;83
Ignalina d. mun.;2008;34;206;108;98
Ignalina d. mun.;2008;35;220;114;106
Ignalina d. mun.;2008;36;239;145;94
Ignalina d. mun.;2008;37;228;109;119
Ignalina d. mun.;2008;38;227;122;105
Ignalina d. mun.;2008;39;258;130;128
Ignalina d. mun.;2008;40;239;127;112
Ignalina d. mun.;2008;41;254;132;122
Ignalina d. mun.;2008;42;267;159;108
Ignalina d. mun.;2008;43;243;126;117
Ignalina d. mun.;2008;44;303;167;136
Ignalina d. mun.;2008;45;271;132;139
Ignalina d. mun.;2008;46;302;154;148
Ignalina d. mun.;2008;47;312;149;163
Ignalina d. mun.;2008;48;290;134;156
Ignalina d. mun.;2008;49;278;143;135
Ignalina d. mun.;2008;50;266;143;123
Ignalina d. mun.;2008;51;262;123;139
Ignalina d. mun.;2008;52;224;108;116
Ignalina d. mun.;2008;53;260;124;136
Ignalina d. mun.;2008;54;227;111;116
Ignalina d. mun.;2008;55;254;123;131
Ignalina d. mun.;2008;56;228;104;124
Ignalina d. mun.;2008;57;266;144;122
Ignalina d. mun.;2008;58;272;125;147
Ignalina d. mun.;2008;59;234;99;135
Ignalina d. mun.;2008;60;225;110;115
Ignalina d. mun.;2008;61;182;88;94
Ignalina d. mun.;2008;62;232;97;135
Ignalina d. mun.;2008;63;223;93;130
Ignalina d. mun.;2008;64;252;92;160
Ignalina d. mun.;2008;65;285;128;157
Ignalina d. mun.;2008;66;251;103;148
Ignalina d. mun.;2008;67;291;122;169
Ignalina d. mun.;2008;68;258;99;159
Ignalina d. mun.;2008;69;287;122;165
Ignalina d. mun.;2008;70;282;114;168
Ignalina d. mun.;2008;71;268;97;171
Ignalina d. mun.;2008;72;257;89;168
Ignalina d. mun.;2008;73;283;100;183
Ignalina d. mun.;2008;74;262;79;183
Ignalina d. mun.;2008;75;297;80;217
Ignalina d. mun.;2008;76;238;81;157
Ignalina d. mun.;2008;77;251;79;172
Ignalina d. mun.;2008;78;216;54;162
Ignalina d. mun.;2008;79;213;56;157
Ignalina d. mun.;2008;80;205;53;152
Ignalina d. mun.;2008;81;166;46;120
Ignalina d. mun.;2008;82;184;39;145
Ignalina d. mun.;2008;83;137;25;112
Ignalina d. mun.;2008;84;120;37;83
Ignalina d. mun.;2008;85;358;97;261
Ignalina d. mun.;2009;-1;19415;9076;10339
Ignalina d. mun.;2009;0;157;73;84
Ignalina d. mun.;2009;1;120;66;54
Ignalina d. mun.;2009;2;136;64;72
Ignalina d. mun.;2009;3;154;76;78
Ignalina d. mun.;2009;4;148;90;58
Ignalina d. mun.;2009;5;157;98;59
Ignalina d. mun.;2009;6;169;88;81
Ignalina d. mun.;2009;7;165;83;82
Ignalina d. mun.;2009;8;185;99;86
Ignalina d. mun.;2009;9;176;86;90
Ignalina d. mun.;2009;10;194;98;96
Ignalina d. mun.;2009;11;213;123;90
Ignalina d. mun.;2009;12;186;103;83
Ignalina d. mun.;2009;13;234;127;107
Ignalina d. mun.;2009;14;224;119;105
Ignalina d. mun.;2009;15;266;142;124
Ignalina d. mun.;2009;16;280;134;146
Ignalina d. mun.;2009;17;266;143;123
Ignalina d. mun.;2009;18;270;146;124
Ignalina d. mun.;2009;19;278;148;130
Ignalina d. mun.;2009;20;290;148;142
Ignalina d. mun.;2009;21;268;129;139
Ignalina d. mun.;2009;22;258;140;118
Ignalina d. mun.;2009;23;279;148;131
Ignalina d. mun.;2009;24;235;121;114
Ignalina d. mun.;2009;25;241;117;124
Ignalina d. mun.;2009;26;190;108;82
Ignalina d. mun.;2009;27;147;104;43
Ignalina d. mun.;2009;28;150;92;58
Ignalina d. mun.;2009;29;141;97;44
Ignalina d. mun.;2009;30;150;94;56
Ignalina d. mun.;2009;31;146;64;82
Ignalina d. mun.;2009;32;169;78;91
Ignalina d. mun.;2009;33;169;94;75
Ignalina d. mun.;2009;34;183;103;80
Ignalina d. mun.;2009;35;196;106;90
Ignalina d. mun.;2009;36;213;110;103
Ignalina d. mun.;2009;37;236;140;96
Ignalina d. mun.;2009;38;225;108;117
Ignalina d. mun.;2009;39;230;122;108
Ignalina d. mun.;2009;40;256;128;128
Ignalina d. mun.;2009;41;237;126;111
Ignalina d. mun.;2009;42;248;130;118
Ignalina d. mun.;2009;43;260;153;107
Ignalina d. mun.;2009;44;241;124;117
Ignalina d. mun.;2009;45;297;161;136
Ignalina d. mun.;2009;46;268;131;137
Ignalina d. mun.;2009;47;297;152;145
Ignalina d. mun.;2009;48;309;148;161
Ignalina d. mun.;2009;49;288;133;155
Ignalina d. mun.;2009;50;275;142;133
Ignalina d. mun.;2009;51;265;141;124
Ignalina d. mun.;2009;52;256;118;138
Ignalina d. mun.;2009;53;219;103;116
Ignalina d. mun.;2009;54;259;122;137
Ignalina d. mun.;2009;55;229;113;116
Ignalina d. mun.;2009;56;250;120;130
Ignalina d. mun.;2009;57;230;104;126
Ignalina d. mun.;2009;58;267;144;123
Ignalina d. mun.;2009;59;265;120;145
Ignalina d. mun.;2009;60;229;96;133
Ignalina d. mun.;2009;61;215;101;114
Ignalina d. mun.;2009;62;179;89;90
Ignalina d. mun.;2009;63;228;95;133
Ignalina d. mun.;2009;64;215;91;124
Ignalina d. mun.;2009;65;252;92;160
Ignalina d. mun.;2009;66;272;120;152
Ignalina d. mun.;2009;67;245;96;149
Ignalina d. mun.;2009;68;285;118;167
Ignalina d. mun.;2009;69;249;94;155
Ignalina d. mun.;2009;70;278;117;161
Ignalina d. mun.;2009;71;272;105;167
Ignalina d. mun.;2009;72;264;96;168
Ignalina d. mun.;2009;73;245;80;165
Ignalina d. mun.;2009;74;272;95;177
Ignalina d. mun.;2009;75;248;77;171
Ignalina d. mun.;2009;76;283;73;210
Ignalina d. mun.;2009;77;221;75;146
Ignalina d. mun.;2009;78;229;69;160
Ignalina d. mun.;2009;79;200;49;151
Ignalina d. mun.;2009;80;202;52;150
Ignalina d. mun.;2009;81;192;50;142
Ignalina d. mun.;2009;82;151;41;110
Ignalina d. mun.;2009;83;168;32;136
Ignalina d. mun.;2009;84;117;16;101
Ignalina d. mun.;2009;85;394;115;279
Ignalina d. mun.;2010;-1;18961;8821;10140
Ignalina d. mun.;2010;0;129;68;61
Ignalina d. mun.;2010;1;155;71;84
Ignalina d. mun.;2010;2;118;63;55
Ignalina d. mun.;2010;3;134;65;69
Ignalina d. mun.;2010;4;154;78;76
Ignalina d. mun.;2010;5;146;89;57
Ignalina d. mun.;2010;6;156;97;59
Ignalina d. mun.;2010;7;169;88;81
Ignalina d. mun.;2010;8;163;81;82
Ignalina d. mun.;2010;9;182;97;85
Ignalina d. mun.;2010;10;177;86;91
Ignalina d. mun.;2010;11;189;96;93
Ignalina d. mun.;2010;12;210;121;89
Ignalina d. mun.;2010;13;186;103;83
Ignalina d. mun.;2010;14;235;129;106
Ignalina d. mun.;2010;15;223;119;104
Ignalina d. mun.;2010;16;262;141;121
Ignalina d. mun.;2010;17;277;132;145
Ignalina d. mun.;2010;18;265;144;121
Ignalina d. mun.;2010;19;270;146;124
Ignalina d. mun.;2010;20;273;146;127
Ignalina d. mun.;2010;21;283;144;139
Ignalina d. mun.;2010;22;254;123;131
Ignalina d. mun.;2010;23;246;133;113
Ignalina d. mun.;2010;24;268;143;125
Ignalina d. mun.;2010;25;227;118;109
Ignalina d. mun.;2010;26;233;116;117
Ignalina d. mun.;2010;27;179;100;79
Ignalina d. mun.;2010;28;137;98;39
Ignalina d. mun.;2010;29;142;85;57
Ignalina d. mun.;2010;30;131;93;38
Ignalina d. mun.;2010;31;140;86;54
Ignalina d. mun.;2010;32;140;59;81
Ignalina d. mun.;2010;33;164;73;91
Ignalina d. mun.;2010;34;166;93;73
Ignalina d. mun.;2010;35;173;94;79
Ignalina d. mun.;2010;36;191;102;89
Ignalina d. mun.;2010;37;210;107;103
Ignalina d. mun.;2010;38;229;134;95
Ignalina d. mun.;2010;39;222;106;116
Ignalina d. mun.;2010;40;226;119;107
Ignalina d. mun.;2010;41;251;124;127
Ignalina d. mun.;2010;42;239;125;114
Ignalina d. mun.;2010;43;245;127;118
Ignalina d. mun.;2010;44;252;144;108
Ignalina d. mun.;2010;45;237;122;115
Ignalina d. mun.;2010;46;288;157;131
Ignalina d. mun.;2010;47;267;127;140
Ignalina d. mun.;2010;48;297;152;145
Ignalina d. mun.;2010;49;304;143;161
Ignalina d. mun.;2010;50;281;128;153
Ignalina d. mun.;2010;51;265;135;130
Ignalina d. mun.;2010;52;257;137;120
Ignalina d. mun.;2010;53;252;115;137
Ignalina d. mun.;2010;54;215;100;115
Ignalina d. mun.;2010;55;257;120;137
Ignalina d. mun.;2010;56;228;112;116
Ignalina d. mun.;2010;57;250;117;133
Ignalina d. mun.;2010;58;227;100;127
Ignalina d. mun.;2010;59;259;138;121
Ignalina d. mun.;2010;60;254;115;139
Ignalina d. mun.;2010;61;224;92;132
Ignalina d. mun.;2010;62;213;102;111
Ignalina d. mun.;2010;63;176;84;92
Ignalina d. mun.;2010;64;224;93;131
Ignalina d. mun.;2010;65;203;82;121
Ignalina d. mun.;2010;66;248;90;158
Ignalina d. mun.;2010;67;270;116;154
Ignalina d. mun.;2010;68;237;89;148
Ignalina d. mun.;2010;69;281;114;167
Ignalina d. mun.;2010;70;242;89;153
Ignalina d. mun.;2010;71;266;110;156
Ignalina d. mun.;2010;72;257;98;159
Ignalina d. mun.;2010;73;253;91;162
Ignalina d. mun.;2010;74;237;77;160
Ignalina d. mun.;2010;75;266;89;177
Ignalina d. mun.;2010;76;241;72;169
Ignalina d. mun.;2010;77;274;68;206
Ignalina d. mun.;2010;78;210;68;142
Ignalina d. mun.;2010;79;211;61;150
Ignalina d. mun.;2010;80;181;41;140
Ignalina d. mun.;2010;81;197;49;148
Ignalina d. mun.;2010;82;181;44;137
Ignalina d. mun.;2010;83;133;37;96
Ignalina d. mun.;2010;84;153;31;122
Ignalina d. mun.;2010;85;424;110;314
Ignalina d. mun.;2011;-1;18468;8614;9854
Ignalina d. mun.;2011;0;111;57;54
Ignalina d. mun.;2011;1;109;54;55
Ignalina d. mun.;2011;2;134;64;70
Ignalina d. mun.;2011;3;102;49;53
Ignalina d. mun.;2011;4;105;47;58
Ignalina d. mun.;2011;5;123;62;61
Ignalina d. mun.;2011;6;131;79;52
Ignalina d. mun.;2011;7;148;94;54
Ignalina d. mun.;2011;8;162;82;80
Ignalina d. mun.;2011;9;154;80;74
Ignalina d. mun.;2011;10;178;90;88
Ignalina d. mun.;2011;11;164;84;80
Ignalina d. mun.;2011;12;177;91;86
Ignalina d. mun.;2011;13;200;110;90
Ignalina d. mun.;2011;14;164;86;78
Ignalina d. mun.;2011;15;228;123;105
Ignalina d. mun.;2011;16;207;111;96
Ignalina d. mun.;2011;17;266;141;125
Ignalina d. mun.;2011;18;273;128;145
Ignalina d. mun.;2011;19;233;134;99
Ignalina d. mun.;2011;20;229;122;107
Ignalina d. mun.;2011;21;228;138;90
Ignalina d. mun.;2011;22;231;126;105
Ignalina d. mun.;2011;23;217;110;107
Ignalina d. mun.;2011;24;209;114;95
Ignalina d. mun.;2011;25;203;114;89
Ignalina d. mun.;2011;26;165;88;77
Ignalina d. mun.;2011;27;153;76;77
Ignalina d. mun.;2011;28;167;94;73
Ignalina d. mun.;2011;29;162;96;66
Ignalina d. mun.;2011;30;162;91;71
Ignalina d. mun.;2011;31;161;84;77
Ignalina d. mun.;2011;32;176;102;74
Ignalina d. mun.;2011;33;178;82;96
Ignalina d. mun.;2011;34;193;88;105
Ignalina d. mun.;2011;35;199;103;96
Ignalina d. mun.;2011;36;190;107;83
Ignalina d. mun.;2011;37;230;110;120
Ignalina d. mun.;2011;38;249;132;117
Ignalina d. mun.;2011;39;248;136;112
Ignalina d. mun.;2011;40;239;111;128
Ignalina d. mun.;2011;41;228;116;112
Ignalina d. mun.;2011;42;266;134;132
Ignalina d. mun.;2011;43;257;134;123
Ignalina d. mun.;2011;44;252;133;119
Ignalina d. mun.;2011;45;269;149;120
Ignalina d. mun.;2011;46;261;141;120
Ignalina d. mun.;2011;47;321;178;143
Ignalina d. mun.;2011;48;277;140;137
Ignalina d. mun.;2011;49;302;155;147
Ignalina d. mun.;2011;50;301;139;162
Ignalina d. mun.;2011;51;285;139;146
Ignalina d. mun.;2011;52;252;125;127
Ignalina d. mun.;2011;53;265;132;133
Ignalina d. mun.;2011;54;253;119;134
Ignalina d. mun.;2011;55;230;118;112
Ignalina d. mun.;2011;56;255;119;136
Ignalina d. mun.;2011;57;216;106;110
Ignalina d. mun.;2011;58;258;123;135
Ignalina d. mun.;2011;59;237;109;128
Ignalina d. mun.;2011;60;258;128;130
Ignalina d. mun.;2011;61;256;118;138
Ignalina d. mun.;2011;62;226;96;130
Ignalina d. mun.;2011;63;217;102;115
Ignalina d. mun.;2011;64;174;82;92
Ignalina d. mun.;2011;65;223;97;126
Ignalina d. mun.;2011;66;215;91;124
Ignalina d. mun.;2011;67;244;93;151
Ignalina d. mun.;2011;68;258;113;145
Ignalina d. mun.;2011;69;230;82;148
Ignalina d. mun.;2011;70;268;111;157
Ignalina d. mun.;2011;71;234;87;147
Ignalina d. mun.;2011;72;246;104;142
Ignalina d. mun.;2011;73;227;85;142
Ignalina d. mun.;2011;74;235;82;153
Ignalina d. mun.;2011;75;227;76;151
Ignalina d. mun.;2011;76;234;75;159
Ignalina d. mun.;2011;77;229;72;157
Ignalina d. mun.;2011;78;238;56;182
Ignalina d. mun.;2011;79;194;64;130
Ignalina d. mun.;2011;80;175;48;127
Ignalina d. mun.;2011;81;166;36;130
Ignalina d. mun.;2011;82;162;38;124
Ignalina d. mun.;2011;83;151;36;115
Ignalina d. mun.;2011;84;120;30;90
Ignalina d. mun.;2011;85;518;113;405
Ignalina d. mun.;2012;-1;18030;8414;9616
Ignalina d. mun.;2012;0;132;63;69
Ignalina d. mun.;2012;1;112;56;56
Ignalina d. mun.;2012;2;108;54;54
Ignalina d. mun.;2012;3;135;63;72
Ignalina d. mun.;2012;4;99;44;55
Ignalina d. mun.;2012;5;96;42;54
Ignalina d. mun.;2012;6;122;62;60
Ignalina d. mun.;2012;7;132;80;52
Ignalina d. mun.;2012;8;147;93;54
Ignalina d. mun.;2012;9;164;83;81
Ignalina d. mun.;2012;10;155;83;72
Ignalina d. mun.;2012;11;174;89;85
Ignalina d. mun.;2012;12;161;82;79
Ignalina d. mun.;2012;13;176;91;85
Ignalina d. mun.;2012;14;198;109;89
Ignalina d. mun.;2012;15;165;87;78
Ignalina d. mun.;2012;16;226;121;105
Ignalina d. mun.;2012;17;209;112;97
Ignalina d. mun.;2012;18;262;140;122
Ignalina d. mun.;2012;19;269;131;138
Ignalina d. mun.;2012;20;230;132;98
Ignalina d. mun.;2012;21;228;123;105
Ignalina d. mun.;2012;22;219;133;86
Ignalina d. mun.;2012;23;224;123;101
Ignalina d. mun.;2012;24;207;108;99
Ignalina d. mun.;2012;25;190;107;83
Ignalina d. mun.;2012;26;190;108;82
Ignalina d. mun.;2012;27;162;94;68
Ignalina d. mun.;2012;28;144;73;71
Ignalina d. mun.;2012;29;154;89;65
Ignalina d. mun.;2012;30;147;84;63
Ignalina d. mun.;2012;31;155;88;67
Ignalina d. mun.;2012;32;155;83;72
Ignalina d. mun.;2012;33;172;99;73
Ignalina d. mun.;2012;34;172;76;96
Ignalina d. mun.;2012;35;191;88;103
Ignalina d. mun.;2012;36;194;101;93
Ignalina d. mun.;2012;37;187;105;82
Ignalina d. mun.;2012;38;229;108;121
Ignalina d. mun.;2012;39;252;132;120
Ignalina d. mun.;2012;40;245;133;112
Ignalina d. mun.;2012;41;240;111;129
Ignalina d. mun.;2012;42;226;115;111
Ignalina d. mun.;2012;43;264;134;130
Ignalina d. mun.;2012;44;255;132;123
Ignalina d. mun.;2012;45;250;131;119
Ignalina d. mun.;2012;46;263;146;117
Ignalina d. mun.;2012;47;256;140;116
Ignalina d. mun.;2012;48;320;175;145
Ignalina d. mun.;2012;49;272;136;136
Ignalina d. mun.;2012;50;299;153;146
Ignalina d. mun.;2012;51;305;142;163
Ignalina d. mun.;2012;52;284;138;146
Ignalina d. mun.;2012;53;238;116;122
Ignalina d. mun.;2012;54;260;130;130
Ignalina d. mun.;2012;55;245;112;133
Ignalina d. mun.;2012;56;227;118;109
Ignalina d. mun.;2012;57;252;120;132
Ignalina d. mun.;2012;58;208;101;107
Ignalina d. mun.;2012;59;247;116;131
Ignalina d. mun.;2012;60;235;107;128
Ignalina d. mun.;2012;61;249;120;129
Ignalina d. mun.;2012;62;251;112;139
Ignalina d. mun.;2012;63;221;92;129
Ignalina d. mun.;2012;64;211;98;113
Ignalina d. mun.;2012;65;169;78;91
Ignalina d. mun.;2012;66;215;88;127
Ignalina d. mun.;2012;67;215;92;123
Ignalina d. mun.;2012;68;242;92;150
Ignalina d. mun.;2012;69;252;106;146
Ignalina d. mun.;2012;70;224;77;147
Ignalina d. mun.;2012;71;261;107;154
Ignalina d. mun.;2012;72;226;81;145
Ignalina d. mun.;2012;73;241;100;141
Ignalina d. mun.;2012;74;212;78;134
Ignalina d. mun.;2012;75;224;77;147
Ignalina d. mun.;2012;76;221;74;147
Ignalina d. mun.;2012;77;222;67;155
Ignalina d. mun.;2012;78;215;68;147
Ignalina d. mun.;2012;79;227;51;176
Ignalina d. mun.;2012;80;177;54;123
Ignalina d. mun.;2012;81;161;42;119
Ignalina d. mun.;2012;82;154;34;120
Ignalina d. mun.;2012;83;140;30;110
Ignalina d. mun.;2012;84;137;31;106
Ignalina d. mun.;2012;85;528;120;408
Ignalina d. mun.;2013;-1;17568;8219;9349
Ignalina d. mun.;2013;0;125;58;67
Ignalina d. mun.;2013;1;130;64;66
Ignalina d. mun.;2013;2;104;58;46
Ignalina d. mun.;2013;3;102;52;50
Ignalina d. mun.;2013;4;134;65;69
Ignalina d. mun.;2013;5;96;43;53
Ignalina d. mun.;2013;6;90;40;50
Ignalina d. mun.;2013;7;118;58;60
Ignalina d. mun.;2013;8;127;78;49
Ignalina d. mun.;2013;9;146;93;53
Ignalina d. mun.;2013;10;165;84;81
Ignalina d. mun.;2013;11;151;81;70
Ignalina d. mun.;2013;12;178;92;86
Ignalina d. mun.;2013;13;159;80;79
Ignalina d. mun.;2013;14;172;86;86
Ignalina d. mun.;2013;15;199;111;88
Ignalina d. mun.;2013;16;162;87;75
Ignalina d. mun.;2013;17;222;117;105
Ignalina d. mun.;2013;18;209;111;98
Ignalina d. mun.;2013;19;251;136;115
Ignalina d. mun.;2013;20;263;123;140
Ignalina d. mun.;2013;21;218;132;86
Ignalina d. mun.;2013;22;229;123;106
Ignalina d. mun.;2013;23;200;125;75
Ignalina d. mun.;2013;24;209;115;94
Ignalina d. mun.;2013;25;200;107;93
Ignalina d. mun.;2013;26;171;100;71
Ignalina d. mun.;2013;27;179;106;73
Ignalina d. mun.;2013;28;145;84;61
Ignalina d. mun.;2013;29;126;65;61
Ignalina d. mun.;2013;30;138;82;56
Ignalina d. mun.;2013;31;131;80;51
Ignalina d. mun.;2013;32;151;81;70
Ignalina d. mun.;2013;33;146;79;67
Ignalina d. mun.;2013;34;160;90;70
Ignalina d. mun.;2013;35;168;77;91
Ignalina d. mun.;2013;36;188;84;104
Ignalina d. mun.;2013;37;188;99;89
Ignalina d. mun.;2013;38;192;110;82
Ignalina d. mun.;2013;39;225;109;116
Ignalina d. mun.;2013;40;249;130;119
Ignalina d. mun.;2013;41;237;128;109
Ignalina d. mun.;2013;42;238;111;127
Ignalina d. mun.;2013;43;220;110;110
Ignalina d. mun.;2013;44;265;133;132
Ignalina d. mun.;2013;45;262;137;125
Ignalina d. mun.;2013;46;245;124;121
Ignalina d. mun.;2013;47;260;142;118
Ignalina d. mun.;2013;48;257;142;115
Ignalina d. mun.;2013;49;317;172;145
Ignalina d. mun.;2013;50;270;133;137
Ignalina d. mun.;2013;51;298;154;144
Ignalina d. mun.;2013;52;301;139;162
Ignalina d. mun.;2013;53;287;140;147
Ignalina d. mun.;2013;54;235;116;119
Ignalina d. mun.;2013;55;258;129;129
Ignalina d. mun.;2013;56;246;113;133
Ignalina d. mun.;2013;57;228;120;108
Ignalina d. mun.;2013;58;251;119;132
Ignalina d. mun.;2013;59;203;98;105
Ignalina d. mun.;2013;60;246;116;130
Ignalina d. mun.;2013;61;235;106;129
Ignalina d. mun.;2013;62;242;114;128
Ignalina d. mun.;2013;63;246;112;134
Ignalina d. mun.;2013;64;219;89;130
Ignalina d. mun.;2013;65;208;98;110
Ignalina d. mun.;2013;66;162;70;92
Ignalina d. mun.;2013;67;208;82;126
Ignalina d. mun.;2013;68;214;92;122
Ignalina d. mun.;2013;69;239;90;149
Ignalina d. mun.;2013;70;242;102;140
Ignalina d. mun.;2013;71;214;74;140
Ignalina d. mun.;2013;72;249;101;148
Ignalina d. mun.;2013;73;219;79;140
Ignalina d. mun.;2013;74;231;95;136
Ignalina d. mun.;2013;75;206;74;132
Ignalina d. mun.;2013;76;213;71;142
Ignalina d. mun.;2013;77;213;68;145
Ignalina d. mun.;2013;78;213;59;154
Ignalina d. mun.;2013;79;203;61;142
Ignalina d. mun.;2013;80;218;46;172
Ignalina d. mun.;2013;81;171;50;121
Ignalina d. mun.;2013;82;145;37;108
Ignalina d. mun.;2013;83;144;32;112
Ignalina d. mun.;2013;84;126;26;100
Ignalina d. mun.;2013;85;548;120;428
Ignalina d. mun.;2014;-1;17141;8011;9130
Ignalina d. mun.;2014;0;133;67;66
Ignalina d. mun.;2014;1;127;56;71
Ignalina d. mun.;2014;2;125;63;62
Ignalina d. mun.;2014;3;104;58;46
Ignalina d. mun.;2014;4;100;50;50
Ignalina d. mun.;2014;5;132;64;68
Ignalina d. mun.;2014;6;95;42;53
Ignalina d. mun.;2014;7;93;40;53
Ignalina d. mun.;2014;8;119;58;61
Ignalina d. mun.;2014;9;126;79;47
Ignalina d. mun.;2014;10;146;91;55
Ignalina d. mun.;2014;11;161;82;79
Ignalina d. mun.;2014;12;151;80;71
Ignalina d. mun.;2014;13;178;94;84
Ignalina d. mun.;2014;14;155;76;79
Ignalina d. mun.;2014;15;170;86;84
Ignalina d. mun.;2014;16;197;110;87
Ignalina d. mun.;2014;17;162;88;74
Ignalina d. mun.;2014;18;216;114;102
Ignalina d. mun.;2014;19;205;111;94
Ignalina d. mun.;2014;20;242;131;111
Ignalina d. mun.;2014;21;260;124;136
Ignalina d. mun.;2014;22;203;125;78
Ignalina d. mun.;2014;23;221;121;100
Ignalina d. mun.;2014;24;194;120;74
Ignalina d. mun.;2014;25;190;103;87
Ignalina d. mun.;2014;26;191;98;93
Ignalina d. mun.;2014;27;165;97;68
Ignalina d. mun.;2014;28;163;100;63
Ignalina d. mun.;2014;29;132;81;51
Ignalina d. mun.;2014;30;118;64;54
Ignalina d. mun.;2014;31;127;76;51
Ignalina d. mun.;2014;32;129;76;53
Ignalina d. mun.;2014;33;148;79;69
Ignalina d. mun.;2014;34;137;74;63
Ignalina d. mun.;2014;35;151;85;66
Ignalina d. mun.;2014;36;167;75;92
Ignalina d. mun.;2014;37;189;85;104
Ignalina d. mun.;2014;38;185;99;86
Ignalina d. mun.;2014;39;184;107;77
Ignalina d. mun.;2014;40;220;103;117
Ignalina d. mun.;2014;41;243;127;116
Ignalina d. mun.;2014;42;236;128;108
Ignalina d. mun.;2014;43;235;109;126
Ignalina d. mun.;2014;44;217;106;111
Ignalina d. mun.;2014;45;267;135;132
Ignalina d. mun.;2014;46;264;138;126
Ignalina d. mun.;2014;47;239;119;120
Ignalina d. mun.;2014;48;263;144;119
Ignalina d. mun.;2014;49;253;138;115
Ignalina d. mun.;2014;50;315;172;143
Ignalina d. mun.;2014;51;268;132;136
Ignalina d. mun.;2014;52;301;156;145
Ignalina d. mun.;2014;53;295;136;159
Ignalina d. mun.;2014;54;287;142;145
Ignalina d. mun.;2014;55;233;113;120
Ignalina d. mun.;2014;56;251;124;127
Ignalina d. mun.;2014;57;245;113;132
Ignalina d. mun.;2014;58;221;114;107
Ignalina d. mun.;2014;59;248;115;133
Ignalina d. mun.;2014;60;191;91;100
Ignalina d. mun.;2014;61;235;112;123
Ignalina d. mun.;2014;62;231;101;130
Ignalina d. mun.;2014;63;242;112;130
Ignalina d. mun.;2014;64;239;109;130
Ignalina d. mun.;2014;65;217;88;129
Ignalina d. mun.;2014;66;205;97;108
Ignalina d. mun.;2014;67;159;68;91
Ignalina d. mun.;2014;68;206;81;125
Ignalina d. mun.;2014;69;205;85;120
Ignalina d. mun.;2014;70;230;82;148
Ignalina d. mun.;2014;71;235;97;138
Ignalina d. mun.;2014;72;207;71;136
Ignalina d. mun.;2014;73;244;97;147
Ignalina d. mun.;2014;74;207;74;133
Ignalina d. mun.;2014;75;218;87;131
Ignalina d. mun.;2014;76;194;65;129
Ignalina d. mun.;2014;77;202;63;139
Ignalina d. mun.;2014;78;204;66;138
Ignalina d. mun.;2014;79;199;54;145
Ignalina d. mun.;2014;80;190;54;136
Ignalina d. mun.;2014;81;208;44;164
Ignalina d. mun.;2014;82;152;43;109
Ignalina d. mun.;2014;83;138;35;103
Ignalina d. mun.;2014;84;126;27;99
Ignalina d. mun.;2014;85;565;115;450
Ignalina d. mun.;2015;-1;16806;7890;8916
Ignalina d. mun.;2015;0;111;65;46
Ignalina d. mun.;2015;1;133;65;68
Ignalina d. mun.;2015;2;123;54;69
Ignalina d. mun.;2015;3;129;63;66
Ignalina d. mun.;2015;4;106;58;48
Ignalina d. mun.;2015;5;99;50;49
Ignalina d. mun.;2015;6;138;67;71
Ignalina d. mun.;2015;7;93;41;52
Ignalina d. mun.;2015;8;89;37;52
Ignalina d. mun.;2015;9;124;61;63
Ignalina d. mun.;2015;10;127;80;47
Ignalina d. mun.;2015;11;145;91;54
Ignalina d. mun.;2015;12;160;81;79
Ignalina d. mun.;2015;13;147;79;68
Ignalina d. mun.;2015;14;178;95;83
Ignalina d. mun.;2015;15;151;75;76
Ignalina d. mun.;2015;16;168;88;80
Ignalina d. mun.;2015;17;199;113;86
Ignalina d. mun.;2015;18;163;88;75
Ignalina d. mun.;2015;19;212;111;101
Ignalina d. mun.;2015;20;203;110;93
Ignalina d. mun.;2015;21;240;130;110
Ignalina d. mun.;2015;22;256;122;134
Ignalina d. mun.;2015;23;204;131;73
Ignalina d. mun.;2015;24;212;121;91
Ignalina d. mun.;2015;25;189;119;70
Ignalina d. mun.;2015;26;183;98;85
Ignalina d. mun.;2015;27;171;90;81
Ignalina d. mun.;2015;28;156;96;60
Ignalina d. mun.;2015;29;147;88;59
Ignalina d. mun.;2015;30;132;80;52
Ignalina d. mun.;2015;31;112;60;52
Ignalina d. mun.;2015;32;123;74;49
Ignalina d. mun.;2015;33;134;80;54
Ignalina d. mun.;2015;34;148;82;66
Ignalina d. mun.;2015;35;127;67;60
Ignalina d. mun.;2015;36;148;82;66
Ignalina d. mun.;2015;37;171;78;93
Ignalina d. mun.;2015;38;187;86;101
Ignalina d. mun.;2015;39;184;99;85
Ignalina d. mun.;2015;40;188;113;75
Ignalina d. mun.;2015;41;218;102;116
Ignalina d. mun.;2015;42;242;127;115
Ignalina d. mun.;2015;43;235;127;108
Ignalina d. mun.;2015;44;227;105;122
Ignalina d. mun.;2015;45;214;103;111
Ignalina d. mun.;2015;46;266;134;132
Ignalina d. mun.;2015;47;258;134;124
Ignalina d. mun.;2015;48;238;117;121
Ignalina d. mun.;2015;49;257;140;117
Ignalina d. mun.;2015;50;251;136;115
Ignalina d. mun.;2015;51;317;173;144
Ignalina d. mun.;2015;52;269;132;137
Ignalina d. mun.;2015;53;304;156;148
Ignalina d. mun.;2015;54;291;131;160
Ignalina d. mun.;2015;55;287;142;145
Ignalina d. mun.;2015;56;235;113;122
Ignalina d. mun.;2015;57;256;127;129
Ignalina d. mun.;2015;58;241;112;129
Ignalina d. mun.;2015;59;220;112;108
Ignalina d. mun.;2015;60;246;113;133
Ignalina d. mun.;2015;61;188;88;100
Ignalina d. mun.;2015;62;232;109;123
Ignalina d. mun.;2015;63;224;95;129
Ignalina d. mun.;2015;64;238;107;131
Ignalina d. mun.;2015;65;233;104;129
Ignalina d. mun.;2015;66;214;86;128
Ignalina d. mun.;2015;67;199;91;108
Ignalina d. mun.;2015;68;154;66;88
Ignalina d. mun.;2015;69;198;74;124
Ignalina d. mun.;2015;70;199;80;119
Ignalina d. mun.;2015;71;228;80;148
Ignalina d. mun.;2015;72;224;91;133
Ignalina d. mun.;2015;73;205;70;135
Ignalina d. mun.;2015;74;240;95;145
Ignalina d. mun.;2015;75;201;69;132
Ignalina d. mun.;2015;76;202;80;122
Ignalina d. mun.;2015;77;183;61;122
Ignalina d. mun.;2015;78;186;55;131
Ignalina d. mun.;2015;79;192;60;132
Ignalina d. mun.;2015;80;188;49;139
Ignalina d. mun.;2015;81;170;47;123
Ignalina d. mun.;2015;82;196;44;152
Ignalina d. mun.;2015;83;136;35;101
Ignalina d. mun.;2015;84;124;28;96
Ignalina d. mun.;2015;85;570;122;448
Ignalina d. mun.;2016;-1;16325;7666;8659
Ignalina d. mun.;2016;0;135;74;61
Ignalina d. mun.;2016;1;111;62;49
Ignalina d. mun.;2016;2;127;60;67
Ignalina d. mun.;2016;3;118;51;67
Ignalina d. mun.;2016;4;125;62;63
Ignalina d. mun.;2016;5;101;59;42
Ignalina d. mun.;2016;6;99;51;48
Ignalina d. mun.;2016;7;138;66;72
Ignalina d. mun.;2016;8;89;40;49
Ignalina d. mun.;2016;9;89;36;53
Ignalina d. mun.;2016;10;123;60;63
Ignalina d. mun.;2016;11;125;79;46
Ignalina d. mun.;2016;12;146;91;55
Ignalina d. mun.;2016;13;158;79;79
Ignalina d. mun.;2016;14;145;80;65
Ignalina d. mun.;2016;15;177;95;82
Ignalina d. mun.;2016;16;150;74;76
Ignalina d. mun.;2016;17;169;87;82
Ignalina d. mun.;2016;18;195;110;85
Ignalina d. mun.;2016;19;156;83;73
Ignalina d. mun.;2016;20;212;116;96
Ignalina d. mun.;2016;21;199;109;90
Ignalina d. mun.;2016;22;232;123;109
Ignalina d. mun.;2016;23;249;119;130
Ignalina d. mun.;2016;24;189;117;72
Ignalina d. mun.;2016;25;204;121;83
Ignalina d. mun.;2016;26;180;116;64
Ignalina d. mun.;2016;27;168;94;74
Ignalina d. mun.;2016;28;156;80;76
Ignalina d. mun.;2016;29;136;88;48
Ignalina d. mun.;2016;30;135;86;49
Ignalina d. mun.;2016;31;119;71;48
Ignalina d. mun.;2016;32;103;56;47
Ignalina d. mun.;2016;33;114;70;44
Ignalina d. mun.;2016;34;132;82;50
Ignalina d. mun.;2016;35;146;81;65
Ignalina d. mun.;2016;36;124;67;57
Ignalina d. mun.;2016;37;146;79;67
Ignalina d. mun.;2016;38;166;74;92
Ignalina d. mun.;2016;39;182;79;103
Ignalina d. mun.;2016;40;178;95;83
Ignalina d. mun.;2016;41;179;105;74
Ignalina d. mun.;2016;42;217;101;116
Ignalina d. mun.;2016;43;239;125;114
Ignalina d. mun.;2016;44;237;131;106
Ignalina d. mun.;2016;45;220;102;118
Ignalina d. mun.;2016;46;211;101;110
Ignalina d. mun.;2016;47;262;132;130
Ignalina d. mun.;2016;48;260;134;126
Ignalina d. mun.;2016;49;237;115;122
Ignalina d. mun.;2016;50;256;140;116
Ignalina d. mun.;2016;51;241;130;111
Ignalina d. mun.;2016;52;313;170;143
Ignalina d. mun.;2016;53;264;131;133
Ignalina d. mun.;2016;54;301;154;147
Ignalina d. mun.;2016;55;284;129;155
Ignalina d. mun.;2016;56;280;137;143
Ignalina d. mun.;2016;57;228;106;122
Ignalina d. mun.;2016;58;252;124;128
Ignalina d. mun.;2016;59;236;108;128
Ignalina d. mun.;2016;60;215;110;105
Ignalina d. mun.;2016;61;242;110;132
Ignalina d. mun.;2016;62;186;84;102
Ignalina d. mun.;2016;63;226;104;122
Ignalina d. mun.;2016;64;220;92;128
Ignalina d. mun.;2016;65;230;100;130
Ignalina d. mun.;2016;66;230;102;128
Ignalina d. mun.;2016;67;208;82;126
Ignalina d. mun.;2016;68;193;89;104
Ignalina d. mun.;2016;69;148;60;88
Ignalina d. mun.;2016;70;191;69;122
Ignalina d. mun.;2016;71;192;76;116
Ignalina d. mun.;2016;72;221;74;147
Ignalina d. mun.;2016;73;214;85;129
Ignalina d. mun.;2016;74;193;63;130
Ignalina d. mun.;2016;75;233;89;144
Ignalina d. mun.;2016;76;190;62;128
Ignalina d. mun.;2016;77;198;78;120
Ignalina d. mun.;2016;78;179;58;121
Ignalina d. mun.;2016;79;172;48;124
Ignalina d. mun.;2016;80;180;58;122
Ignalina d. mun.;2016;81;171;43;128
Ignalina d. mun.;2016;82;156;43;113
Ignalina d. mun.;2016;83;184;41;143
Ignalina d. mun.;2016;84;123;27;96
Ignalina d. mun.;2016;85;567;122;445
Ignalina d. mun.;2017;-1;15892;7505;8387
Ignalina d. mun.;2017;0;107;71;36
Ignalina d. mun.;2017;1;129;72;57
Ignalina d. mun.;2017;2;106;56;50
Ignalina d. mun.;2017;3;126;61;65
Ignalina d. mun.;2017;4;118;53;65
Ignalina d. mun.;2017;5;124;63;61
Ignalina d. mun.;2017;6;97;56;41
Ignalina d. mun.;2017;7;100;52;48
Ignalina d. mun.;2017;8;136;66;70
Ignalina d. mun.;2017;9;90;40;50
Ignalina d. mun.;2017;10;91;36;55
Ignalina d. mun.;2017;11;120;58;62
Ignalina d. mun.;2017;12;120;77;43
Ignalina d. mun.;2017;13;147;91;56
Ignalina d. mun.;2017;14;154;77;77
Ignalina d. mun.;2017;15;146;79;67
Ignalina d. mun.;2017;16;178;95;83
Ignalina d. mun.;2017;17;148;72;76
Ignalina d. mun.;2017;18;170;86;84
Ignalina d. mun.;2017;19;186;105;81
Ignalina d. mun.;2017;20;151;80;71
Ignalina d. mun.;2017;21;209;113;96
Ignalina d. mun.;2017;22;195;108;87
Ignalina d. mun.;2017;23;224;119;105
Ignalina d. mun.;2017;24;237;112;125
Ignalina d. mun.;2017;25;185;117;68
Ignalina d. mun.;2017;26;192;119;73
Ignalina d. mun.;2017;27;160;110;50
Ignalina d. mun.;2017;28;154;92;62
Ignalina d. mun.;2017;29;139;73;66
Ignalina d. mun.;2017;30;116;74;42
Ignalina d. mun.;2017;31;129;82;47
Ignalina d. mun.;2017;32;101;60;41
Ignalina d. mun.;2017;33;99;54;45
Ignalina d. mun.;2017;34;104;67;37
Ignalina d. mun.;2017;35;121;77;44
Ignalina d. mun.;2017;36;139;74;65
Ignalina d. mun.;2017;37;124;69;55
Ignalina d. mun.;2017;38;145;80;65
Ignalina d. mun.;2017;39;163;75;88
Ignalina d. mun.;2017;40;179;78;101
Ignalina d. mun.;2017;41;177;94;83
Ignalina d. mun.;2017;42;175;104;71
Ignalina d. mun.;2017;43;212;97;115
Ignalina d. mun.;2017;44;237;125;112
Ignalina d. mun.;2017;45;237;129;108
Ignalina d. mun.;2017;46;221;104;117
Ignalina d. mun.;2017;47;208;100;108
Ignalina d. mun.;2017;48;258;128;130
Ignalina d. mun.;2017;49;254;130;124
Ignalina d. mun.;2017;50;234;114;120
Ignalina d. mun.;2017;51;253;136;117
Ignalina d. mun.;2017;52;238;128;110
Ignalina d. mun.;2017;53;313;168;145
Ignalina d. mun.;2017;54;262;130;132
Ignalina d. mun.;2017;55;299;152;147
Ignalina d. mun.;2017;56;287;128;159
Ignalina d. mun.;2017;57;277;135;142
Ignalina d. mun.;2017;58;224;103;121
Ignalina d. mun.;2017;59;247;120;127
Ignalina d. mun.;2017;60;236;108;128
Ignalina d. mun.;2017;61;216;110;106
Ignalina d. mun.;2017;62;239;107;132
Ignalina d. mun.;2017;63;183;83;100
Ignalina d. mun.;2017;64;224;104;120
Ignalina d. mun.;2017;65;219;91;128
Ignalina d. mun.;2017;66;225;96;129
Ignalina d. mun.;2017;67;225;98;127
Ignalina d. mun.;2017;68;205;79;126
Ignalina d. mun.;2017;69;185;84;101
Ignalina d. mun.;2017;70;143;56;87
Ignalina d. mun.;2017;71;186;70;116
Ignalina d. mun.;2017;72;186;74;112
Ignalina d. mun.;2017;73;216;71;145
Ignalina d. mun.;2017;74;208;80;128
Ignalina d. mun.;2017;75;190;62;128
Ignalina d. mun.;2017;76;223;83;140
Ignalina d. mun.;2017;77;182;59;123
Ignalina d. mun.;2017;78;190;74;116
Ignalina d. mun.;2017;79;172;56;116
Ignalina d. mun.;2017;80;162;45;117
Ignalina d. mun.;2017;81;171;55;116
Ignalina d. mun.;2017;82;157;40;117
Ignalina d. mun.;2017;83;145;38;107
Ignalina d. mun.;2017;84;167;40;127
Ignalina d. mun.;2017;85;565;118;447
Ignalina d. mun.;2018;-1;15366;7269;8097
Ignalina d. mun.;2018;0;108;53;55
Ignalina d. mun.;2018;1;107;69;38
Ignalina d. mun.;2018;2;122;66;56
Ignalina d. mun.;2018;3;106;56;50
Ignalina d. mun.;2018;4;127;62;65
Ignalina d. mun.;2018;5;113;49;64
Ignalina d. mun.;2018;6;122;63;59
Ignalina d. mun.;2018;7;98;56;42
Ignalina d. mun.;2018;8;104;53;51
Ignalina d. mun.;2018;9;137;66;71
Ignalina d. mun.;2018;10;88;40;48
Ignalina d. mun.;2018;11;89;34;55
Ignalina d. mun.;2018;12;120;58;62
Ignalina d. mun.;2018;13;119;77;42
Ignalina d. mun.;2018;14;144;91;53
Ignalina d. mun.;2018;15;152;75;77
Ignalina d. mun.;2018;16;143;78;65
Ignalina d. mun.;2018;17;177;95;82
Ignalina d. mun.;2018;18;145;71;74
Ignalina d. mun.;2018;19;168;86;82
Ignalina d. mun.;2018;20;180;102;78
Ignalina d. mun.;2018;21;148;78;70
Ignalina d. mun.;2018;22;200;103;97
Ignalina d. mun.;2018;23;183;107;76
Ignalina d. mun.;2018;24;218;116;102
Ignalina d. mun.;2018;25;216;107;109
Ignalina d. mun.;2018;26;170;109;61
Ignalina d. mun.;2018;27;186;116;70
Ignalina d. mun.;2018;28;150;106;44
Ignalina d. mun.;2018;29;136;85;51
Ignalina d. mun.;2018;30;127;71;56
Ignalina d. mun.;2018;31;95;64;31
Ignalina d. mun.;2018;32;118;74;44
Ignalina d. mun.;2018;33;89;55;34
Ignalina d. mun.;2018;34;91;51;40
Ignalina d. mun.;2018;35;101;66;35
Ignalina d. mun.;2018;36;108;69;39
Ignalina d. mun.;2018;37;134;71;63
Ignalina d. mun.;2018;38;110;60;50
Ignalina d. mun.;2018;39;143;80;63
Ignalina d. mun.;2018;40;159;73;86
Ignalina d. mun.;2018;41;172;75;97
Ignalina d. mun.;2018;42;181;96;85
Ignalina d. mun.;2018;43;178;105;73
Ignalina d. mun.;2018;44;209;95;114
Ignalina d. mun.;2018;45;230;121;109
Ignalina d. mun.;2018;46;237;128;109
Ignalina d. mun.;2018;47;221;102;119
Ignalina d. mun.;2018;48;206;97;109
Ignalina d. mun.;2018;49;259;130;129
Ignalina d. mun.;2018;50;251;129;122
Ignalina d. mun.;2018;51;227;111;116
Ignalina d. mun.;2018;52;247;134;113
Ignalina d. mun.;2018;53;232;123;109
Ignalina d. mun.;2018;54;311;166;145
Ignalina d. mun.;2018;55;260;128;132
Ignalina d. mun.;2018;56;294;147;147
Ignalina d. mun.;2018;57;281;124;157
Ignalina d. mun.;2018;58;272;133;139
Ignalina d. mun.;2018;59;222;103;119
Ignalina d. mun.;2018;60;247;118;129
Ignalina d. mun.;2018;61;229;102;127
Ignalina d. mun.;2018;62;212;106;106
Ignalina d. mun.;2018;63;234;103;131
Ignalina d. mun.;2018;64;177;79;98
Ignalina d. mun.;2018;65;219;102;117
Ignalina d. mun.;2018;66;215;87;128
Ignalina d. mun.;2018;67;224;96;128
Ignalina d. mun.;2018;68;216;92;124
Ignalina d. mun.;2018;69;196;71;125
Ignalina d. mun.;2018;70;179;81;98
Ignalina d. mun.;2018;71;134;50;84
Ignalina d. mun.;2018;72;180;66;114
Ignalina d. mun.;2018;73;176;68;108
Ignalina d. mun.;2018;74;205;66;139
Ignalina d. mun.;2018;75;200;77;123
Ignalina d. mun.;2018;76;188;61;127
Ignalina d. mun.;2018;77;210;74;136
Ignalina d. mun.;2018;78;174;54;120
Ignalina d. mun.;2018;79;171;63;108
Ignalina d. mun.;2018;80;161;52;109
Ignalina d. mun.;2018;81;152;42;110
Ignalina d. mun.;2018;82;163;51;112
Ignalina d. mun.;2018;83;140;36;104
Ignalina d. mun.;2018;84;131;35;96
Ignalina d. mun.;2018;85;592;129;463
Jonava d. mun.;2001;-1;52258;24615;27643
Jonava d. mun.;2001;0;598;323;275
Jonava d. mun.;2001;1;630;307;323
Jonava d. mun.;2001;2;622;310;312
Jonava d. mun.;2001;3;697;348;349
Jonava d. mun.;2001;4;685;363;322
Jonava d. mun.;2001;5;611;330;281
Jonava d. mun.;2001;6;626;297;329
Jonava d. mun.;2001;7;804;385;419
Jonava d. mun.;2001;8;876;461;415
Jonava d. mun.;2001;9;864;464;400
Jonava d. mun.;2001;10;804;414;390
Jonava d. mun.;2001;11;720;364;356
Jonava d. mun.;2001;12;797;420;377
Jonava d. mun.;2001;13;919;482;437
Jonava d. mun.;2001;14;981;498;483
Jonava d. mun.;2001;15;882;421;461
Jonava d. mun.;2001;16;816;425;391
Jonava d. mun.;2001;17;799;415;384
Jonava d. mun.;2001;18;722;366;356
Jonava d. mun.;2001;19;628;335;293
Jonava d. mun.;2001;20;697;386;311
Jonava d. mun.;2001;21;691;375;316
Jonava d. mun.;2001;22;712;357;355
Jonava d. mun.;2001;23;740;399;341
Jonava d. mun.;2001;24;688;341;347
Jonava d. mun.;2001;25;733;387;346
Jonava d. mun.;2001;26;759;389;370
Jonava d. mun.;2001;27;775;422;353
Jonava d. mun.;2001;28;816;436;380
Jonava d. mun.;2001;29;795;393;402
Jonava d. mun.;2001;30;839;431;408
Jonava d. mun.;2001;31;772;368;404
Jonava d. mun.;2001;32;759;359;400
Jonava d. mun.;2001;33;781;382;399
Jonava d. mun.;2001;34;814;394;420
Jonava d. mun.;2001;35;772;378;394
Jonava d. mun.;2001;36;833;409;424
Jonava d. mun.;2001;37;818;409;409
Jonava d. mun.;2001;38;836;416;420
Jonava d. mun.;2001;39;890;421;469
Jonava d. mun.;2001;40;814;397;417
Jonava d. mun.;2001;41;819;371;448
Jonava d. mun.;2001;42;714;337;377
Jonava d. mun.;2001;43;777;376;401
Jonava d. mun.;2001;44;692;320;372
Jonava d. mun.;2001;45;728;342;386
Jonava d. mun.;2001;46;684;299;385
Jonava d. mun.;2001;47;656;310;346
Jonava d. mun.;2001;48;718;345;373
Jonava d. mun.;2001;49;726;323;403
Jonava d. mun.;2001;50;652;291;361
Jonava d. mun.;2001;51;690;305;385
Jonava d. mun.;2001;52;626;280;346
Jonava d. mun.;2001;53;589;266;323
Jonava d. mun.;2001;54;561;248;313
Jonava d. mun.;2001;55;548;253;295
Jonava d. mun.;2001;56;494;229;265
Jonava d. mun.;2001;57;545;247;298
Jonava d. mun.;2001;58;607;251;356
Jonava d. mun.;2001;59;615;264;351
Jonava d. mun.;2001;60;531;226;305
Jonava d. mun.;2001;61;514;219;295
Jonava d. mun.;2001;62;517;232;285
Jonava d. mun.;2001;63;448;171;277
Jonava d. mun.;2001;64;503;198;305
Jonava d. mun.;2001;65;486;201;285
Jonava d. mun.;2001;66;414;159;255
Jonava d. mun.;2001;67;427;160;267
Jonava d. mun.;2001;68;404;147;257
Jonava d. mun.;2001;69;381;125;256
Jonava d. mun.;2001;70;405;139;266
Jonava d. mun.;2001;71;362;133;229
Jonava d. mun.;2001;72;343;129;214
Jonava d. mun.;2001;73;326;118;208
Jonava d. mun.;2001;74;267;65;202
Jonava d. mun.;2001;75;246;70;176
Jonava d. mun.;2001;76;268;76;192
Jonava d. mun.;2001;77;206;52;154
Jonava d. mun.;2001;78;200;54;146
Jonava d. mun.;2001;79;190;53;137
Jonava d. mun.;2001;80;152;37;115
Jonava d. mun.;2001;81;117;28;89
Jonava d. mun.;2001;82;77;25;52
Jonava d. mun.;2001;83;75;9;66
Jonava d. mun.;2001;84;81;20;61
Jonava d. mun.;2001;85;462;135;327
Jonava d. mun.;2002;-1;52031;24518;27513
Jonava d. mun.;2002;0;582;298;284
Jonava d. mun.;2002;1;602;325;277
Jonava d. mun.;2002;2;629;309;320
Jonava d. mun.;2002;3;621;309;312
Jonava d. mun.;2002;4;695;345;350
Jonava d. mun.;2002;5;683;363;320
Jonava d. mun.;2002;6;604;324;280
Jonava d. mun.;2002;7;630;301;329
Jonava d. mun.;2002;8;796;382;414
Jonava d. mun.;2002;9;867;455;412
Jonava d. mun.;2002;10;867;466;401
Jonava d. mun.;2002;11;809;418;391
Jonava d. mun.;2002;12;719;366;353
Jonava d. mun.;2002;13;791;417;374
Jonava d. mun.;2002;14;919;479;440
Jonava d. mun.;2002;15;969;489;480
Jonava d. mun.;2002;16;874;420;454
Jonava d. mun.;2002;17;803;417;386
Jonava d. mun.;2002;18;782;408;374
Jonava d. mun.;2002;19;708;361;347
Jonava d. mun.;2002;20;622;332;290
Jonava d. mun.;2002;21;683;378;305
Jonava d. mun.;2002;22;680;366;314
Jonava d. mun.;2002;23;687;350;337
Jonava d. mun.;2002;24;732;391;341
Jonava d. mun.;2002;25;674;333;341
Jonava d. mun.;2002;26;725;382;343
Jonava d. mun.;2002;27;744;382;362
Jonava d. mun.;2002;28;760;411;349
Jonava d. mun.;2002;29;804;430;374
Jonava d. mun.;2002;30;785;386;399
Jonava d. mun.;2002;31;824;422;402
Jonava d. mun.;2002;32;758;359;399
Jonava d. mun.;2002;33;750;356;394
Jonava d. mun.;2002;34;768;372;396
Jonava d. mun.;2002;35;800;384;416
Jonava d. mun.;2002;36;760;375;385
Jonava d. mun.;2002;37;826;407;419
Jonava d. mun.;2002;38;808;404;404
Jonava d. mun.;2002;39;823;407;416
Jonava d. mun.;2002;40;876;411;465
Jonava d. mun.;2002;41;808;395;413
Jonava d. mun.;2002;42;819;371;448
Jonava d. mun.;2002;43;704;335;369
Jonava d. mun.;2002;44;768;372;396
Jonava d. mun.;2002;45;670;310;360
Jonava d. mun.;2002;46;720;337;383
Jonava d. mun.;2002;47;680;300;380
Jonava d. mun.;2002;48;646;307;339
Jonava d. mun.;2002;49;699;335;364
Jonava d. mun.;2002;50;715;314;401
Jonava d. mun.;2002;51;650;291;359
Jonava d. mun.;2002;52;677;297;380
Jonava d. mun.;2002;53;624;279;345
Jonava d. mun.;2002;54;580;264;316
Jonava d. mun.;2002;55;540;238;302
Jonava d. mun.;2002;56;538;247;291
Jonava d. mun.;2002;57;486;223;263
Jonava d. mun.;2002;58;541;241;300
Jonava d. mun.;2002;59;587;241;346
Jonava d. mun.;2002;60;602;256;346
Jonava d. mun.;2002;61;525;222;303
Jonava d. mun.;2002;62;513;217;296
Jonava d. mun.;2002;63;507;219;288
Jonava d. mun.;2002;64;445;169;276
Jonava d. mun.;2002;65;498;195;303
Jonava d. mun.;2002;66;479;202;277
Jonava d. mun.;2002;67;417;162;255
Jonava d. mun.;2002;68;422;159;263
Jonava d. mun.;2002;69;398;141;257
Jonava d. mun.;2002;70;368;118;250
Jonava d. mun.;2002;71;400;136;264
Jonava d. mun.;2002;72;357;132;225
Jonava d. mun.;2002;73;342;130;212
Jonava d. mun.;2002;74;306;116;190
Jonava d. mun.;2002;75;256;65;191
Jonava d. mun.;2002;76;241;69;172
Jonava d. mun.;2002;77;257;70;187
Jonava d. mun.;2002;78;194;45;149
Jonava d. mun.;2002;79;189;50;139
Jonava d. mun.;2002;80;183;51;132
Jonava d. mun.;2002;81;144;33;111
Jonava d. mun.;2002;82;104;24;80
Jonava d. mun.;2002;83;71;22;49
Jonava d. mun.;2002;84;69;9;60
Jonava d. mun.;2002;85;453;119;334
Jonava d. mun.;2003;-1;51734;24316;27418
Jonava d. mun.;2003;0;491;247;244
Jonava d. mun.;2003;1;582;300;282
Jonava d. mun.;2003;2;598;324;274
Jonava d. mun.;2003;3;630;304;326
Jonava d. mun.;2003;4;614;307;307
Jonava d. mun.;2003;5;690;343;347
Jonava d. mun.;2003;6;685;365;320
Jonava d. mun.;2003;7;606;327;279
Jonava d. mun.;2003;8;627;300;327
Jonava d. mun.;2003;9;792;383;409
Jonava d. mun.;2003;10;862;455;407
Jonava d. mun.;2003;11;867;469;398
Jonava d. mun.;2003;12;795;413;382
Jonava d. mun.;2003;13;719;365;354
Jonava d. mun.;2003;14;776;409;367
Jonava d. mun.;2003;15;903;471;432
Jonava d. mun.;2003;16;951;481;470
Jonava d. mun.;2003;17;854;411;443
Jonava d. mun.;2003;18;786;407;379
Jonava d. mun.;2003;19;776;404;372
Jonava d. mun.;2003;20;690;346;344
Jonava d. mun.;2003;21;614;330;284
Jonava d. mun.;2003;22;683;377;306
Jonava d. mun.;2003;23;687;365;322
Jonava d. mun.;2003;24;691;348;343
Jonava d. mun.;2003;25;738;403;335
Jonava d. mun.;2003;26;673;335;338
Jonava d. mun.;2003;27;716;376;340
Jonava d. mun.;2003;28;733;372;361
Jonava d. mun.;2003;29;739;397;342
Jonava d. mun.;2003;30;787;417;370
Jonava d. mun.;2003;31;782;383;399
Jonava d. mun.;2003;32;819;419;400
Jonava d. mun.;2003;33;748;352;396
Jonava d. mun.;2003;34;743;352;391
Jonava d. mun.;2003;35;756;362;394
Jonava d. mun.;2003;36;787;373;414
Jonava d. mun.;2003;37;753;372;381
Jonava d. mun.;2003;38;808;399;409
Jonava d. mun.;2003;39;801;399;402
Jonava d. mun.;2003;40;816;402;414
Jonava d. mun.;2003;41;873;407;466
Jonava d. mun.;2003;42;795;389;406
Jonava d. mun.;2003;43;808;365;443
Jonava d. mun.;2003;44;698;333;365
Jonava d. mun.;2003;45;751;358;393
Jonava d. mun.;2003;46;660;305;355
Jonava d. mun.;2003;47;706;324;382
Jonava d. mun.;2003;48;680;305;375
Jonava d. mun.;2003;49;641;304;337
Jonava d. mun.;2003;50;682;324;358
Jonava d. mun.;2003;51;699;305;394
Jonava d. mun.;2003;52;643;282;361
Jonava d. mun.;2003;53;674;293;381
Jonava d. mun.;2003;54;620;277;343
Jonava d. mun.;2003;55;568;254;314
Jonava d. mun.;2003;56;535;238;297
Jonava d. mun.;2003;57;530;239;291
Jonava d. mun.;2003;58;480;215;265
Jonava d. mun.;2003;59;531;233;298
Jonava d. mun.;2003;60;582;233;349
Jonava d. mun.;2003;61;589;247;342
Jonava d. mun.;2003;62;520;221;299
Jonava d. mun.;2003;63;504;209;295
Jonava d. mun.;2003;64;501;213;288
Jonava d. mun.;2003;65;436;163;273
Jonava d. mun.;2003;66;488;187;301
Jonava d. mun.;2003;67;481;203;278
Jonava d. mun.;2003;68;406;155;251
Jonava d. mun.;2003;69;404;151;253
Jonava d. mun.;2003;70;385;135;250
Jonava d. mun.;2003;71;356;112;244
Jonava d. mun.;2003;72;388;128;260
Jonava d. mun.;2003;73;346;123;223
Jonava d. mun.;2003;74;327;123;204
Jonava d. mun.;2003;75;299;112;187
Jonava d. mun.;2003;76;254;62;192
Jonava d. mun.;2003;77;227;60;167
Jonava d. mun.;2003;78;247;64;183
Jonava d. mun.;2003;79;186;44;142
Jonava d. mun.;2003;80;167;40;127
Jonava d. mun.;2003;81;167;49;118
Jonava d. mun.;2003;82;134;30;104
Jonava d. mun.;2003;83;93;19;74
Jonava d. mun.;2003;84;68;21;47
Jonava d. mun.;2003;85;437;98;339
Jonava d. mun.;2004;-1;51510;24235;27275
Jonava d. mun.;2004;0;509;266;243
Jonava d. mun.;2004;1;499;247;252
Jonava d. mun.;2004;2;583;299;284
Jonava d. mun.;2004;3;602;323;279
Jonava d. mun.;2004;4;640;312;328
Jonava d. mun.;2004;5;615;307;308
Jonava d. mun.;2004;6;693;343;350
Jonava d. mun.;2004;7;677;362;315
Jonava d. mun.;2004;8;604;325;279
Jonava d. mun.;2004;9;628;300;328
Jonava d. mun.;2004;10;782;376;406
Jonava d. mun.;2004;11;864;458;406
Jonava d. mun.;2004;12;860;463;397
Jonava d. mun.;2004;13;788;413;375
Jonava d. mun.;2004;14;715;366;349
Jonava d. mun.;2004;15;766;406;360
Jonava d. mun.;2004;16;888;462;426
Jonava d. mun.;2004;17;932;471;461
Jonava d. mun.;2004;18;843;406;437
Jonava d. mun.;2004;19;772;404;368
Jonava d. mun.;2004;20;769;402;367
Jonava d. mun.;2004;21;682;342;340
Jonava d. mun.;2004;22;619;330;289
Jonava d. mun.;2004;23;685;373;312
Jonava d. mun.;2004;24;686;369;317
Jonava d. mun.;2004;25;690;349;341
Jonava d. mun.;2004;26;739;398;341
Jonava d. mun.;2004;27;673;336;337
Jonava d. mun.;2004;28;721;382;339
Jonava d. mun.;2004;29;744;380;364
Jonava d. mun.;2004;30;723;394;329
Jonava d. mun.;2004;31;780;414;366
Jonava d. mun.;2004;32;771;373;398
Jonava d. mun.;2004;33;815;422;393
Jonava d. mun.;2004;34;741;351;390
Jonava d. mun.;2004;35;742;349;393
Jonava d. mun.;2004;36;749;362;387
Jonava d. mun.;2004;37;773;365;408
Jonava d. mun.;2004;38;732;361;371
Jonava d. mun.;2004;39;797;397;400
Jonava d. mun.;2004;40;790;391;399
Jonava d. mun.;2004;41;802;397;405
Jonava d. mun.;2004;42;874;404;470
Jonava d. mun.;2004;43;797;391;406
Jonava d. mun.;2004;44;790;355;435
Jonava d. mun.;2004;45;687;332;355
Jonava d. mun.;2004;46;738;352;386
Jonava d. mun.;2004;47;653;302;351
Jonava d. mun.;2004;48;702;323;379
Jonava d. mun.;2004;49;669;296;373
Jonava d. mun.;2004;50;630;298;332
Jonava d. mun.;2004;51;682;323;359
Jonava d. mun.;2004;52;686;296;390
Jonava d. mun.;2004;53;631;273;358
Jonava d. mun.;2004;54;666;293;373
Jonava d. mun.;2004;55;604;271;333
Jonava d. mun.;2004;56;565;252;313
Jonava d. mun.;2004;57;529;233;296
Jonava d. mun.;2004;58;524;235;289
Jonava d. mun.;2004;59;466;205;261
Jonava d. mun.;2004;60;519;228;291
Jonava d. mun.;2004;61;575;230;345
Jonava d. mun.;2004;62;582;237;345
Jonava d. mun.;2004;63;514;215;299
Jonava d. mun.;2004;64;490;199;291
Jonava d. mun.;2004;65;489;202;287
Jonava d. mun.;2004;66;433;159;274
Jonava d. mun.;2004;67;476;181;295
Jonava d. mun.;2004;68;480;197;283
Jonava d. mun.;2004;69;396;150;246
Jonava d. mun.;2004;70;395;145;250
Jonava d. mun.;2004;71;368;127;241
Jonava d. mun.;2004;72;345;107;238
Jonava d. mun.;2004;73;373;118;255
Jonava d. mun.;2004;74;324;114;210
Jonava d. mun.;2004;75;313;117;196
Jonava d. mun.;2004;76;283;104;179
Jonava d. mun.;2004;77;237;53;184
Jonava d. mun.;2004;78;215;55;160
Jonava d. mun.;2004;79;236;61;175
Jonava d. mun.;2004;80;169;41;128
Jonava d. mun.;2004;81;156;34;122
Jonava d. mun.;2004;82;146;41;105
Jonava d. mun.;2004;83;120;25;95
Jonava d. mun.;2004;84;83;16;67
Jonava d. mun.;2004;85;417;99;318
Jonava d. mun.;2005;-1;51218;24084;27134
Jonava d. mun.;2005;0;505;260;245
Jonava d. mun.;2005;1;508;262;246
Jonava d. mun.;2005;2;500;249;251
Jonava d. mun.;2005;3;574;293;281
Jonava d. mun.;2005;4;596;322;274
Jonava d. mun.;2005;5;632;307;325
Jonava d. mun.;2005;6;600;304;296
Jonava d. mun.;2005;7;690;342;348
Jonava d. mun.;2005;8;679;363;316
Jonava d. mun.;2005;9;606;324;282
Jonava d. mun.;2005;10;629;300;329
Jonava d. mun.;2005;11;781;373;408
Jonava d. mun.;2005;12;862;456;406
Jonava d. mun.;2005;13;859;461;398
Jonava d. mun.;2005;14;783;409;374
Jonava d. mun.;2005;15;703;365;338
Jonava d. mun.;2005;16;748;395;353
Jonava d. mun.;2005;17;879;460;419
Jonava d. mun.;2005;18;907;455;452
Jonava d. mun.;2005;19;828;401;427
Jonava d. mun.;2005;20;759;398;361
Jonava d. mun.;2005;21;755;397;358
Jonava d. mun.;2005;22;670;336;334
Jonava d. mun.;2005;23;608;326;282
Jonava d. mun.;2005;24;672;373;299
Jonava d. mun.;2005;25;686;374;312
Jonava d. mun.;2005;26;683;346;337
Jonava d. mun.;2005;27;737;388;349
Jonava d. mun.;2005;28;670;330;340
Jonava d. mun.;2005;29;716;380;336
Jonava d. mun.;2005;30;744;380;364
Jonava d. mun.;2005;31;707;388;319
Jonava d. mun.;2005;32;773;407;366
Jonava d. mun.;2005;33;770;372;398
Jonava d. mun.;2005;34;815;422;393
Jonava d. mun.;2005;35;733;352;381
Jonava d. mun.;2005;36;732;346;386
Jonava d. mun.;2005;37;741;360;381
Jonava d. mun.;2005;38;768;358;410
Jonava d. mun.;2005;39;738;366;372
Jonava d. mun.;2005;40;780;391;389
Jonava d. mun.;2005;41;779;381;398
Jonava d. mun.;2005;42;792;391;401
Jonava d. mun.;2005;43;871;403;468
Jonava d. mun.;2005;44;795;393;402
Jonava d. mun.;2005;45;773;342;431
Jonava d. mun.;2005;46;673;324;349
Jonava d. mun.;2005;47;734;346;388
Jonava d. mun.;2005;48;638;292;346
Jonava d. mun.;2005;49;692;315;377
Jonava d. mun.;2005;50;662;293;369
Jonava d. mun.;2005;51;616;288;328
Jonava d. mun.;2005;52;677;320;357
Jonava d. mun.;2005;53;682;292;390
Jonava d. mun.;2005;54;619;265;354
Jonava d. mun.;2005;55;662;291;371
Jonava d. mun.;2005;56;597;263;334
Jonava d. mun.;2005;57;553;245;308
Jonava d. mun.;2005;58;519;225;294
Jonava d. mun.;2005;59;524;234;290
Jonava d. mun.;2005;60;465;202;263
Jonava d. mun.;2005;61;502;217;285
Jonava d. mun.;2005;62;569;224;345
Jonava d. mun.;2005;63;575;230;345
Jonava d. mun.;2005;64;517;213;304
Jonava d. mun.;2005;65;480;190;290
Jonava d. mun.;2005;66;478;195;283
Jonava d. mun.;2005;67;429;155;274
Jonava d. mun.;2005;68;468;180;288
Jonava d. mun.;2005;69;467;189;278
Jonava d. mun.;2005;70;380;139;241
Jonava d. mun.;2005;71;393;143;250
Jonava d. mun.;2005;72;350;114;236
Jonava d. mun.;2005;73;332;99;233
Jonava d. mun.;2005;74;357;109;248
Jonava d. mun.;2005;75;322;111;211
Jonava d. mun.;2005;76;295;108;187
Jonava d. mun.;2005;77;274;95;179
Jonava d. mun.;2005;78;232;50;182
Jonava d. mun.;2005;79;196;50;146
Jonava d. mun.;2005;80;218;55;163
Jonava d. mun.;2005;81;155;35;120
Jonava d. mun.;2005;82;148;33;115
Jonava d. mun.;2005;83;129;33;96
Jonava d. mun.;2005;84;102;22;80
Jonava d. mun.;2005;85;401;99;302
Jonava d. mun.;2006;-1;50373;23646;26727
Jonava d. mun.;2006;0;518;276;242
Jonava d. mun.;2006;1;498;259;239
Jonava d. mun.;2006;2;504;258;246
Jonava d. mun.;2006;3;495;247;248
Jonava d. mun.;2006;4;563;291;272
Jonava d. mun.;2006;5;587;315;272
Jonava d. mun.;2006;6;619;301;318
Jonava d. mun.;2006;7;593;295;298
Jonava d. mun.;2006;8;685;338;347
Jonava d. mun.;2006;9;670;363;307
Jonava d. mun.;2006;10;594;321;273
Jonava d. mun.;2006;11;616;293;323
Jonava d. mun.;2006;12;771;371;400
Jonava d. mun.;2006;13;837;440;397
Jonava d. mun.;2006;14;845;453;392
Jonava d. mun.;2006;15;764;399;365
Jonava d. mun.;2006;16;683;354;329
Jonava d. mun.;2006;17;731;381;350
Jonava d. mun.;2006;18;848;445;403
Jonava d. mun.;2006;19;859;430;429
Jonava d. mun.;2006;20;779;371;408
Jonava d. mun.;2006;21;725;380;345
Jonava d. mun.;2006;22;727;386;341
Jonava d. mun.;2006;23;641;318;323
Jonava d. mun.;2006;24;597;322;275
Jonava d. mun.;2006;25;643;369;274
Jonava d. mun.;2006;26;677;366;311
Jonava d. mun.;2006;27;666;336;330
Jonava d. mun.;2006;28;718;380;338
Jonava d. mun.;2006;29;636;310;326
Jonava d. mun.;2006;30;695;373;322
Jonava d. mun.;2006;31;732;372;360
Jonava d. mun.;2006;32;680;376;304
Jonava d. mun.;2006;33;760;399;361
Jonava d. mun.;2006;34;744;352;392
Jonava d. mun.;2006;35;796;413;383
Jonava d. mun.;2006;36;719;346;373
Jonava d. mun.;2006;37;717;340;377
Jonava d. mun.;2006;38;727;352;375
Jonava d. mun.;2006;39;745;341;404
Jonava d. mun.;2006;40;730;360;370
Jonava d. mun.;2006;41;756;379;377
Jonava d. mun.;2006;42;758;369;389
Jonava d. mun.;2006;43;771;383;388
Jonava d. mun.;2006;44;857;395;462
Jonava d. mun.;2006;45;784;384;400
Jonava d. mun.;2006;46;764;339;425
Jonava d. mun.;2006;47;668;318;350
Jonava d. mun.;2006;48;722;337;385
Jonava d. mun.;2006;49;622;287;335
Jonava d. mun.;2006;50;684;311;373
Jonava d. mun.;2006;51;653;289;364
Jonava d. mun.;2006;52;604;279;325
Jonava d. mun.;2006;53;655;310;345
Jonava d. mun.;2006;54;675;285;390
Jonava d. mun.;2006;55;612;266;346
Jonava d. mun.;2006;56;660;290;370
Jonava d. mun.;2006;57;584;252;332
Jonava d. mun.;2006;58;544;236;308
Jonava d. mun.;2006;59;509;217;292
Jonava d. mun.;2006;60;513;229;284
Jonava d. mun.;2006;61;452;195;257
Jonava d. mun.;2006;62;488;212;276
Jonava d. mun.;2006;63;548;212;336
Jonava d. mun.;2006;64;548;216;332
Jonava d. mun.;2006;65;503;206;297
Jonava d. mun.;2006;66;469;186;283
Jonava d. mun.;2006;67;469;191;278
Jonava d. mun.;2006;68;422;146;276
Jonava d. mun.;2006;69;460;174;286
Jonava d. mun.;2006;70;447;176;271
Jonava d. mun.;2006;71;362;127;235
Jonava d. mun.;2006;72;385;132;253
Jonava d. mun.;2006;73;341;107;234
Jonava d. mun.;2006;74;317;90;227
Jonava d. mun.;2006;75;338;98;240
Jonava d. mun.;2006;76;314;107;207
Jonava d. mun.;2006;77;281;102;179
Jonava d. mun.;2006;78;254;85;169
Jonava d. mun.;2006;79;225;45;180
Jonava d. mun.;2006;80;187;45;142
Jonava d. mun.;2006;81;205;51;154
Jonava d. mun.;2006;82;143;32;111
Jonava d. mun.;2006;83;133;28;105
Jonava d. mun.;2006;84;115;30;85
Jonava d. mun.;2006;85;438;106;332
Jonava d. mun.;2007;-1;49589;23172;26417
Jonava d. mun.;2007;0;464;233;231
Jonava d. mun.;2007;1;514;270;244
Jonava d. mun.;2007;2;487;248;239
Jonava d. mun.;2007;3;490;255;235
Jonava d. mun.;2007;4;487;241;246
Jonava d. mun.;2007;5;556;284;272
Jonava d. mun.;2007;6;577;313;264
Jonava d. mun.;2007;7;617;305;312
Jonava d. mun.;2007;8;584;290;294
Jonava d. mun.;2007;9;677;331;346
Jonava d. mun.;2007;10;663;355;308
Jonava d. mun.;2007;11;588;316;272
Jonava d. mun.;2007;12;610;285;325
Jonava d. mun.;2007;13;762;364;398
Jonava d. mun.;2007;14;826;437;389
Jonava d. mun.;2007;15;831;445;386
Jonava d. mun.;2007;16;749;389;360
Jonava d. mun.;2007;17;670;349;321
Jonava d. mun.;2007;18;714;378;336
Jonava d. mun.;2007;19;823;428;395
Jonava d. mun.;2007;20;833;412;421
Jonava d. mun.;2007;21;754;356;398
Jonava d. mun.;2007;22;693;361;332
Jonava d. mun.;2007;23;704;370;334
Jonava d. mun.;2007;24;628;310;318
Jonava d. mun.;2007;25;580;317;263
Jonava d. mun.;2007;26;626;356;270
Jonava d. mun.;2007;27;666;357;309
Jonava d. mun.;2007;28;654;324;330
Jonava d. mun.;2007;29;713;377;336
Jonava d. mun.;2007;30;631;303;328
Jonava d. mun.;2007;31;692;373;319
Jonava d. mun.;2007;32;709;364;345
Jonava d. mun.;2007;33;675;371;304
Jonava d. mun.;2007;34;730;383;347
Jonava d. mun.;2007;35;719;339;380
Jonava d. mun.;2007;36;775;403;372
Jonava d. mun.;2007;37;703;334;369
Jonava d. mun.;2007;38;715;338;377
Jonava d. mun.;2007;39;708;337;371
Jonava d. mun.;2007;40;737;339;398
Jonava d. mun.;2007;41;722;355;367
Jonava d. mun.;2007;42;739;369;370
Jonava d. mun.;2007;43;736;353;383
Jonava d. mun.;2007;44;747;372;375
Jonava d. mun.;2007;45;835;386;449
Jonava d. mun.;2007;46;767;369;398
Jonava d. mun.;2007;47;747;332;415
Jonava d. mun.;2007;48;667;319;348
Jonava d. mun.;2007;49;707;327;380
Jonava d. mun.;2007;50;610;278;332
Jonava d. mun.;2007;51;673;304;369
Jonava d. mun.;2007;52;656;289;367
Jonava d. mun.;2007;53;590;266;324
Jonava d. mun.;2007;54;645;299;346
Jonava d. mun.;2007;55;659;275;384
Jonava d. mun.;2007;56;599;255;344
Jonava d. mun.;2007;57;653;289;364
Jonava d. mun.;2007;58;561;238;323
Jonava d. mun.;2007;59;534;230;304
Jonava d. mun.;2007;60;495;208;287
Jonava d. mun.;2007;61;503;224;279
Jonava d. mun.;2007;62;442;187;255
Jonava d. mun.;2007;63;471;200;271
Jonava d. mun.;2007;64;531;201;330
Jonava d. mun.;2007;65;532;201;331
Jonava d. mun.;2007;66;490;203;287
Jonava d. mun.;2007;67;448;173;275
Jonava d. mun.;2007;68;457;183;274
Jonava d. mun.;2007;69;410;138;272
Jonava d. mun.;2007;70;443;167;276
Jonava d. mun.;2007;71;424;163;261
Jonava d. mun.;2007;72;347;116;231
Jonava d. mun.;2007;73;369;122;247
Jonava d. mun.;2007;74;332;100;232
Jonava d. mun.;2007;75;310;87;223
Jonava d. mun.;2007;76;324;92;232
Jonava d. mun.;2007;77;301;97;204
Jonava d. mun.;2007;78;266;97;169
Jonava d. mun.;2007;79;231;76;155
Jonava d. mun.;2007;80;214;39;175
Jonava d. mun.;2007;81;177;40;137
Jonava d. mun.;2007;82;187;49;138
Jonava d. mun.;2007;83;130;31;99
Jonava d. mun.;2007;84;113;23;90
Jonava d. mun.;2007;85;461;110;351
Jonava d. mun.;2008;-1;49051;22901;26150
Jonava d. mun.;2008;0;488;237;251
Jonava d. mun.;2008;1;455;226;229
Jonava d. mun.;2008;2;513;271;242
Jonava d. mun.;2008;3;483;249;234
Jonava d. mun.;2008;4;494;252;242
Jonava d. mun.;2008;5;485;243;242
Jonava d. mun.;2008;6;550;281;269
Jonava d. mun.;2008;7;573;309;264
Jonava d. mun.;2008;8;607;301;306
Jonava d. mun.;2008;9;584;291;293
Jonava d. mun.;2008;10;683;335;348
Jonava d. mun.;2008;11;658;354;304
Jonava d. mun.;2008;12;589;318;271
Jonava d. mun.;2008;13;604;285;319
Jonava d. mun.;2008;14;757;364;393
Jonava d. mun.;2008;15;807;430;377
Jonava d. mun.;2008;16;823;442;381
Jonava d. mun.;2008;17;741;390;351
Jonava d. mun.;2008;18;655;339;316
Jonava d. mun.;2008;19;702;367;335
Jonava d. mun.;2008;20;805;418;387
Jonava d. mun.;2008;21;812;402;410
Jonava d. mun.;2008;22;727;344;383
Jonava d. mun.;2008;23;681;354;327
Jonava d. mun.;2008;24;695;366;329
Jonava d. mun.;2008;25;614;309;305
Jonava d. mun.;2008;26;568;310;258
Jonava d. mun.;2008;27;625;361;264
Jonava d. mun.;2008;28;663;358;305
Jonava d. mun.;2008;29;651;323;328
Jonava d. mun.;2008;30;705;375;330
Jonava d. mun.;2008;31;619;297;322
Jonava d. mun.;2008;32;688;366;322
Jonava d. mun.;2008;33;702;358;344
Jonava d. mun.;2008;34;675;373;302
Jonava d. mun.;2008;35;725;384;341
Jonava d. mun.;2008;36;716;335;381
Jonava d. mun.;2008;37;765;397;368
Jonava d. mun.;2008;38;692;326;366
Jonava d. mun.;2008;39;710;336;374
Jonava d. mun.;2008;40;697;337;360
Jonava d. mun.;2008;41;722;325;397
Jonava d. mun.;2008;42;699;337;362
Jonava d. mun.;2008;43;731;365;366
Jonava d. mun.;2008;44;728;349;379
Jonava d. mun.;2008;45;726;362;364
Jonava d. mun.;2008;46;819;379;440
Jonava d. mun.;2008;47;756;361;395
Jonava d. mun.;2008;48;727;321;406
Jonava d. mun.;2008;49;660;314;346
Jonava d. mun.;2008;50;704;325;379
Jonava d. mun.;2008;51;596;269;327
Jonava d. mun.;2008;52;663;300;363
Jonava d. mun.;2008;53;640;280;360
Jonava d. mun.;2008;54;578;257;321
Jonava d. mun.;2008;55;633;291;342
Jonava d. mun.;2008;56;637;264;373
Jonava d. mun.;2008;57;590;246;344
Jonava d. mun.;2008;58;641;282;359
Jonava d. mun.;2008;59;552;227;325
Jonava d. mun.;2008;60;525;224;301
Jonava d. mun.;2008;61;487;208;279
Jonava d. mun.;2008;62;491;216;275
Jonava d. mun.;2008;63;427;178;249
Jonava d. mun.;2008;64;459;190;269
Jonava d. mun.;2008;65;519;193;326
Jonava d. mun.;2008;66;514;187;327
Jonava d. mun.;2008;67;465;187;278
Jonava d. mun.;2008;68;427;163;264
Jonava d. mun.;2008;69;441;173;268
Jonava d. mun.;2008;70;401;129;272
Jonava d. mun.;2008;71;426;156;270
Jonava d. mun.;2008;72;413;158;255
Jonava d. mun.;2008;73;340;111;229
Jonava d. mun.;2008;74;349;111;238
Jonava d. mun.;2008;75;311;94;217
Jonava d. mun.;2008;76;292;76;216
Jonava d. mun.;2008;77;310;85;225
Jonava d. mun.;2008;78;274;89;185
Jonava d. mun.;2008;79;259;84;175
Jonava d. mun.;2008;80;220;73;147
Jonava d. mun.;2008;81;199;35;164
Jonava d. mun.;2008;82;156;32;124
Jonava d. mun.;2008;83;170;43;127
Jonava d. mun.;2008;84;122;27;95
Jonava d. mun.;2008;85;466;112;354
Jonava d. mun.;2009;-1;48792;22752;26040
Jonava d. mun.;2009;0;526;263;263
Jonava d. mun.;2009;1;487;239;248
Jonava d. mun.;2009;2;456;225;231
Jonava d. mun.;2009;3;509;269;240
Jonava d. mun.;2009;4;479;247;232
Jonava d. mun.;2009;5;494;255;239
Jonava d. mun.;2009;6;489;246;243
Jonava d. mun.;2009;7;548;278;270
Jonava d. mun.;2009;8;570;302;268
Jonava d. mun.;2009;9;602;293;309
Jonava d. mun.;2009;10;593;296;297
Jonava d. mun.;2009;11;678;334;344
Jonava d. mun.;2009;12;662;358;304
Jonava d. mun.;2009;13;588;319;269
Jonava d. mun.;2009;14;598;280;318
Jonava d. mun.;2009;15;752;365;387
Jonava d. mun.;2009;16;802;428;374
Jonava d. mun.;2009;17;815;436;379
Jonava d. mun.;2009;18;733;384;349
Jonava d. mun.;2009;19;652;337;315
Jonava d. mun.;2009;20;695;362;333
Jonava d. mun.;2009;21;785;408;377
Jonava d. mun.;2009;22;798;395;403
Jonava d. mun.;2009;23;718;340;378
Jonava d. mun.;2009;24;683;358;325
Jonava d. mun.;2009;25;681;358;323
Jonava d. mun.;2009;26;606;303;303
Jonava d. mun.;2009;27;564;305;259
Jonava d. mun.;2009;28;622;361;261
Jonava d. mun.;2009;29;659;351;308
Jonava d. mun.;2009;30;646;322;324
Jonava d. mun.;2009;31;696;368;328
Jonava d. mun.;2009;32;606;288;318
Jonava d. mun.;2009;33;677;359;318
Jonava d. mun.;2009;34;708;359;349
Jonava d. mun.;2009;35;671;369;302
Jonava d. mun.;2009;36;724;383;341
Jonava d. mun.;2009;37;717;335;382
Jonava d. mun.;2009;38;757;394;363
Jonava d. mun.;2009;39;686;320;366
Jonava d. mun.;2009;40;703;330;373
Jonava d. mun.;2009;41;692;336;356
Jonava d. mun.;2009;42;717;326;391
Jonava d. mun.;2009;43;684;325;359
Jonava d. mun.;2009;44;727;364;363
Jonava d. mun.;2009;45;719;349;370
Jonava d. mun.;2009;46;718;354;364
Jonava d. mun.;2009;47;814;376;438
Jonava d. mun.;2009;48;748;353;395
Jonava d. mun.;2009;49;717;317;400
Jonava d. mun.;2009;50;655;309;346
Jonava d. mun.;2009;51;686;311;375
Jonava d. mun.;2009;52;594;267;327
Jonava d. mun.;2009;53;655;295;360
Jonava d. mun.;2009;54;622;270;352
Jonava d. mun.;2009;55;572;245;327
Jonava d. mun.;2009;56;616;285;331
Jonava d. mun.;2009;57;628;261;367
Jonava d. mun.;2009;58;580;237;343
Jonava d. mun.;2009;59;632;278;354
Jonava d. mun.;2009;60;545;220;325
Jonava d. mun.;2009;61;517;215;302
Jonava d. mun.;2009;62;487;208;279
Jonava d. mun.;2009;63;479;211;268
Jonava d. mun.;2009;64;415;172;243
Jonava d. mun.;2009;65;450;185;265
Jonava d. mun.;2009;66;501;185;316
Jonava d. mun.;2009;67;504;182;322
Jonava d. mun.;2009;68;447;173;274
Jonava d. mun.;2009;69;415;156;259
Jonava d. mun.;2009;70;434;168;266
Jonava d. mun.;2009;71;397;124;273
Jonava d. mun.;2009;72;405;147;258
Jonava d. mun.;2009;73;396;147;249
Jonava d. mun.;2009;74;322;103;219
Jonava d. mun.;2009;75;337;107;230
Jonava d. mun.;2009;76;299;88;211
Jonava d. mun.;2009;77;265;65;200
Jonava d. mun.;2009;78;289;77;212
Jonava d. mun.;2009;79;263;87;176
Jonava d. mun.;2009;80;244;80;164
Jonava d. mun.;2009;81;205;65;140
Jonava d. mun.;2009;82;189;34;155
Jonava d. mun.;2009;83;141;29;112
Jonava d. mun.;2009;84;148;38;110
Jonava d. mun.;2009;85;487;106;381
Jonava d. mun.;2010;-1;48036;22254;25782
Jonava d. mun.;2010;0;472;237;235
Jonava d. mun.;2010;1;519;263;256
Jonava d. mun.;2010;2;485;235;250
Jonava d. mun.;2010;3;459;227;232
Jonava d. mun.;2010;4;500;263;237
Jonava d. mun.;2010;5;473;244;229
Jonava d. mun.;2010;6;486;250;236
Jonava d. mun.;2010;7;485;242;243
Jonava d. mun.;2010;8;545;277;268
Jonava d. mun.;2010;9;566;299;267
Jonava d. mun.;2010;10;596;286;310
Jonava d. mun.;2010;11;578;286;292
Jonava d. mun.;2010;12;672;329;343
Jonava d. mun.;2010;13;654;352;302
Jonava d. mun.;2010;14;589;319;270
Jonava d. mun.;2010;15;594;274;320
Jonava d. mun.;2010;16;745;359;386
Jonava d. mun.;2010;17;803;429;374
Jonava d. mun.;2010;18;799;427;372
Jonava d. mun.;2010;19;720;377;343
Jonava d. mun.;2010;20;637;326;311
Jonava d. mun.;2010;21;667;345;322
Jonava d. mun.;2010;22;751;388;363
Jonava d. mun.;2010;23;771;379;392
Jonava d. mun.;2010;24;688;325;363
Jonava d. mun.;2010;25;655;338;317
Jonava d. mun.;2010;26;644;336;308
Jonava d. mun.;2010;27;580;289;291
Jonava d. mun.;2010;28;551;294;257
Jonava d. mun.;2010;29;606;351;255
Jonava d. mun.;2010;30;639;343;296
Jonava d. mun.;2010;31;635;312;323
Jonava d. mun.;2010;32;687;365;322
Jonava d. mun.;2010;33;601;286;315
Jonava d. mun.;2010;34;673;351;322
Jonava d. mun.;2010;35;697;353;344
Jonava d. mun.;2010;36;654;357;297
Jonava d. mun.;2010;37;706;372;334
Jonava d. mun.;2010;38;704;328;376
Jonava d. mun.;2010;39;744;385;359
Jonava d. mun.;2010;40;677;316;361
Jonava d. mun.;2010;41;691;325;366
Jonava d. mun.;2010;42;673;322;351
Jonava d. mun.;2010;43;702;315;387
Jonava d. mun.;2010;44;671;318;353
Jonava d. mun.;2010;45;713;353;360
Jonava d. mun.;2010;46;702;339;363
Jonava d. mun.;2010;47;706;343;363
Jonava d. mun.;2010;48;795;360;435
Jonava d. mun.;2010;49;733;341;392
Jonava d. mun.;2010;50;701;305;396
Jonava d. mun.;2010;51;641;299;342
Jonava d. mun.;2010;52;667;301;366
Jonava d. mun.;2010;53;590;263;327
Jonava d. mun.;2010;54;637;281;356
Jonava d. mun.;2010;55;616;268;348
Jonava d. mun.;2010;56;557;237;320
Jonava d. mun.;2010;57;601;276;325
Jonava d. mun.;2010;58;612;249;363
Jonava d. mun.;2010;59;570;233;337
Jonava d. mun.;2010;60;623;267;356
Jonava d. mun.;2010;61;538;216;322
Jonava d. mun.;2010;62;504;201;303
Jonava d. mun.;2010;63;474;199;275
Jonava d. mun.;2010;64;463;202;261
Jonava d. mun.;2010;65;403;164;239
Jonava d. mun.;2010;66;438;178;260
Jonava d. mun.;2010;67;488;178;310
Jonava d. mun.;2010;68;476;167;309
Jonava d. mun.;2010;69;430;160;270
Jonava d. mun.;2010;70;405;147;258
Jonava d. mun.;2010;71;422;159;263
Jonava d. mun.;2010;72;387;120;267
Jonava d. mun.;2010;73;394;141;253
Jonava d. mun.;2010;74;377;135;242
Jonava d. mun.;2010;75;301;87;214
Jonava d. mun.;2010;76;319;95;224
Jonava d. mun.;2010;77;289;83;206
Jonava d. mun.;2010;78;257;57;200
Jonava d. mun.;2010;79;267;73;194
Jonava d. mun.;2010;80;250;80;170
Jonava d. mun.;2010;81;227;76;151
Jonava d. mun.;2010;82;191;60;131
Jonava d. mun.;2010;83;172;28;144
Jonava d. mun.;2010;84;128;24;104
Jonava d. mun.;2010;85;528;115;413
Jonava d. mun.;2011;-1;46653;21632;25021
Jonava d. mun.;2011;0;445;237;208
Jonava d. mun.;2011;1;489;239;250
Jonava d. mun.;2011;2;522;258;264
Jonava d. mun.;2011;3;459;225;234
Jonava d. mun.;2011;4;462;224;238
Jonava d. mun.;2011;5;481;250;231
Jonava d. mun.;2011;6;464;246;218
Jonava d. mun.;2011;7;509;253;256
Jonava d. mun.;2011;8;480;246;234
Jonava d. mun.;2011;9;549;287;262
Jonava d. mun.;2011;10;571;311;260
Jonava d. mun.;2011;11;601;295;306
Jonava d. mun.;2011;12;581;283;298
Jonava d. mun.;2011;13;670;343;327
Jonava d. mun.;2011;14;682;359;323
Jonava d. mun.;2011;15;604;322;282
Jonava d. mun.;2011;16;602;294;308
Jonava d. mun.;2011;17;739;351;388
Jonava d. mun.;2011;18;766;406;360
Jonava d. mun.;2011;19;680;379;301
Jonava d. mun.;2011;20;631;338;293
Jonava d. mun.;2011;21;563;282;281
Jonava d. mun.;2011;22;568;289;279
Jonava d. mun.;2011;23;617;323;294
Jonava d. mun.;2011;24;619;323;296
Jonava d. mun.;2011;25;594;281;313
Jonava d. mun.;2011;26;559;287;272
Jonava d. mun.;2011;27;539;276;263
Jonava d. mun.;2011;28;542;265;277
Jonava d. mun.;2011;29;520;270;250
Jonava d. mun.;2011;30;539;306;233
Jonava d. mun.;2011;31;561;302;259
Jonava d. mun.;2011;32;587;278;309
Jonava d. mun.;2011;33;615;310;305
Jonava d. mun.;2011;34;562;258;304
Jonava d. mun.;2011;35;643;319;324
Jonava d. mun.;2011;36;641;323;318
Jonava d. mun.;2011;37;651;352;299
Jonava d. mun.;2011;38;699;350;349
Jonava d. mun.;2011;39;709;345;364
Jonava d. mun.;2011;40;744;391;353
Jonava d. mun.;2011;41;660;305;355
Jonava d. mun.;2011;42;678;320;358
Jonava d. mun.;2011;43;648;307;341
Jonava d. mun.;2011;44;668;305;363
Jonava d. mun.;2011;45;665;325;340
Jonava d. mun.;2011;46;694;343;351
Jonava d. mun.;2011;47;653;309;344
Jonava d. mun.;2011;48;693;331;362
Jonava d. mun.;2011;49;754;352;402
Jonava d. mun.;2011;50;743;352;391
Jonava d. mun.;2011;51;727;324;403
Jonava d. mun.;2011;52;642;294;348
Jonava d. mun.;2011;53;687;326;361
Jonava d. mun.;2011;54;617;277;340
Jonava d. mun.;2011;55;610;269;341
Jonava d. mun.;2011;56;610;255;355
Jonava d. mun.;2011;57;561;243;318
Jonava d. mun.;2011;58;587;260;327
Jonava d. mun.;2011;59;627;261;366
Jonava d. mun.;2011;60;577;247;330
Jonava d. mun.;2011;61;625;268;357
Jonava d. mun.;2011;62;546;226;320
Jonava d. mun.;2011;63;491;195;296
Jonava d. mun.;2011;64;447;182;265
Jonava d. mun.;2011;65;481;208;273
Jonava d. mun.;2011;66;410;168;242
Jonava d. mun.;2011;67;446;186;260
Jonava d. mun.;2011;68;455;163;292
Jonava d. mun.;2011;69;486;179;307
Jonava d. mun.;2011;70;451;175;276
Jonava d. mun.;2011;71;416;151;265
Jonava d. mun.;2011;72;408;147;261
Jonava d. mun.;2011;73;385;124;261
Jonava d. mun.;2011;74;382;137;245
Jonava d. mun.;2011;75;360;127;233
Jonava d. mun.;2011;76;292;85;207
Jonava d. mun.;2011;77;304;92;212
Jonava d. mun.;2011;78;266;80;186
Jonava d. mun.;2011;79;247;60;187
Jonava d. mun.;2011;80;251;71;180
Jonava d. mun.;2011;81;231;68;163
Jonava d. mun.;2011;82;215;66;149
Jonava d. mun.;2011;83;163;54;109
Jonava d. mun.;2011;84;164;27;137
Jonava d. mun.;2011;85;571;112;459
Jonava d. mun.;2012;-1;45713;21177;24536
Jonava d. mun.;2012;0;467;248;219
Jonava d. mun.;2012;1;441;238;203
Jonava d. mun.;2012;2;470;227;243
Jonava d. mun.;2012;3;499;246;253
Jonava d. mun.;2012;4;445;217;228
Jonava d. mun.;2012;5;448;217;231
Jonava d. mun.;2012;6;470;245;225
Jonava d. mun.;2012;7;454;243;211
Jonava d. mun.;2012;8;495;246;249
Jonava d. mun.;2012;9;478;245;233
Jonava d. mun.;2012;10;543;285;258
Jonava d. mun.;2012;11;565;308;257
Jonava d. mun.;2012;12;591;290;301
Jonava d. mun.;2012;13;573;280;293
Jonava d. mun.;2012;14;666;343;323
Jonava d. mun.;2012;15;676;356;320
Jonava d. mun.;2012;16;603;323;280
Jonava d. mun.;2012;17;594;292;302
Jonava d. mun.;2012;18;722;341;381
Jonava d. mun.;2012;19;716;380;336
Jonava d. mun.;2012;20;651;357;294
Jonava d. mun.;2012;21;603;321;282
Jonava d. mun.;2012;22;530;268;262
Jonava d. mun.;2012;23;552;284;268
Jonava d. mun.;2012;24;579;302;277
Jonava d. mun.;2012;25;581;306;275
Jonava d. mun.;2012;26;557;264;293
Jonava d. mun.;2012;27;520;266;254
Jonava d. mun.;2012;28;508;266;242
Jonava d. mun.;2012;29;521;254;267
Jonava d. mun.;2012;30;489;252;237
Jonava d. mun.;2012;31;506;284;222
Jonava d. mun.;2012;32;543;290;253
Jonava d. mun.;2012;33;561;270;291
Jonava d. mun.;2012;34;596;296;300
Jonava d. mun.;2012;35;540;248;292
Jonava d. mun.;2012;36;619;304;315
Jonava d. mun.;2012;37;631;312;319
Jonava d. mun.;2012;38;637;343;294
Jonava d. mun.;2012;39;692;349;343
Jonava d. mun.;2012;40;702;344;358
Jonava d. mun.;2012;41;726;381;345
Jonava d. mun.;2012;42;653;303;350
Jonava d. mun.;2012;43;668;316;352
Jonava d. mun.;2012;44;628;295;333
Jonava d. mun.;2012;45;645;295;350
Jonava d. mun.;2012;46;655;319;336
Jonava d. mun.;2012;47;673;330;343
Jonava d. mun.;2012;48;638;303;335
Jonava d. mun.;2012;49;684;328;356
Jonava d. mun.;2012;50;740;344;396
Jonava d. mun.;2012;51;733;346;387
Jonava d. mun.;2012;52;725;326;399
Jonava d. mun.;2012;53;641;292;349
Jonava d. mun.;2012;54;667;316;351
Jonava d. mun.;2012;55;610;275;335
Jonava d. mun.;2012;56;602;266;336
Jonava d. mun.;2012;57;605;251;354
Jonava d. mun.;2012;58;557;239;318
Jonava d. mun.;2012;59;577;254;323
Jonava d. mun.;2012;60;615;250;365
Jonava d. mun.;2012;61;565;236;329
Jonava d. mun.;2012;62;616;263;353
Jonava d. mun.;2012;63;541;224;317
Jonava d. mun.;2012;64;482;193;289
Jonava d. mun.;2012;65;435;174;261
Jonava d. mun.;2012;66;470;201;269
Jonava d. mun.;2012;67;404;164;240
Jonava d. mun.;2012;68;431;178;253
Jonava d. mun.;2012;69;436;153;283
Jonava d. mun.;2012;70;473;168;305
Jonava d. mun.;2012;71;436;168;268
Jonava d. mun.;2012;72;400;145;255
Jonava d. mun.;2012;73;394;138;256
Jonava d. mun.;2012;74;366;113;253
Jonava d. mun.;2012;75;368;129;239
Jonava d. mun.;2012;76;341;115;226
Jonava d. mun.;2012;77;280;78;202
Jonava d. mun.;2012;78;288;83;205
Jonava d. mun.;2012;79;249;76;173
Jonava d. mun.;2012;80;235;53;182
Jonava d. mun.;2012;81;244;66;178
Jonava d. mun.;2012;82;215;58;157
Jonava d. mun.;2012;83;199;59;140
Jonava d. mun.;2012;84;147;50;97
Jonava d. mun.;2012;85;622;113;509
Jonava d. mun.;2013;-1;45079;20924;24155
Jonava d. mun.;2013;0;474;259;215
Jonava d. mun.;2013;1;448;241;207
Jonava d. mun.;2013;2;427;227;200
Jonava d. mun.;2013;3;448;218;230
Jonava d. mun.;2013;4;490;240;250
Jonava d. mun.;2013;5;429;206;223
Jonava d. mun.;2013;6;442;214;228
Jonava d. mun.;2013;7;471;248;223
Jonava d. mun.;2013;8;454;245;209
Jonava d. mun.;2013;9;494;245;249
Jonava d. mun.;2013;10;475;241;234
Jonava d. mun.;2013;11;537;284;253
Jonava d. mun.;2013;12;559;303;256
Jonava d. mun.;2013;13;579;286;293
Jonava d. mun.;2013;14;562;275;287
Jonava d. mun.;2013;15;663;341;322
Jonava d. mun.;2013;16;670;354;316
Jonava d. mun.;2013;17;596;318;278
Jonava d. mun.;2013;18;594;296;298
Jonava d. mun.;2013;19;701;334;367
Jonava d. mun.;2013;20;688;361;327
Jonava d. mun.;2013;21;638;356;282
Jonava d. mun.;2013;22;585;319;266
Jonava d. mun.;2013;23;515;273;242
Jonava d. mun.;2013;24;537;274;263
Jonava d. mun.;2013;25;556;293;263
Jonava d. mun.;2013;26;558;292;266
Jonava d. mun.;2013;27;525;257;268
Jonava d. mun.;2013;28;507;257;250
Jonava d. mun.;2013;29;498;264;234
Jonava d. mun.;2013;30;494;242;252
Jonava d. mun.;2013;31;499;261;238
Jonava d. mun.;2013;32;495;282;213
Jonava d. mun.;2013;33;533;285;248
Jonava d. mun.;2013;34;557;266;291
Jonava d. mun.;2013;35;590;299;291
Jonava d. mun.;2013;36;532;239;293
Jonava d. mun.;2013;37;596;291;305
Jonava d. mun.;2013;38;617;305;312
Jonava d. mun.;2013;39;623;337;286
Jonava d. mun.;2013;40;685;343;342
Jonava d. mun.;2013;41;690;340;350
Jonava d. mun.;2013;42;714;375;339
Jonava d. mun.;2013;43;640;295;345
Jonava d. mun.;2013;44;658;307;351
Jonava d. mun.;2013;45;629;302;327
Jonava d. mun.;2013;46;645;297;348
Jonava d. mun.;2013;47;651;313;338
Jonava d. mun.;2013;48;659;324;335
Jonava d. mun.;2013;49;628;296;332
Jonava d. mun.;2013;50;671;323;348
Jonava d. mun.;2013;51;721;333;388
Jonava d. mun.;2013;52;724;338;386
Jonava d. mun.;2013;53;717;323;394
Jonava d. mun.;2013;54;632;285;347
Jonava d. mun.;2013;55;656;309;347
Jonava d. mun.;2013;56;602;270;332
Jonava d. mun.;2013;57;591;260;331
Jonava d. mun.;2013;58;600;247;353
Jonava d. mun.;2013;59;551;236;315
Jonava d. mun.;2013;60;565;247;318
Jonava d. mun.;2013;61;606;243;363
Jonava d. mun.;2013;62;562;237;325
Jonava d. mun.;2013;63;603;254;349
Jonava d. mun.;2013;64;529;216;313
Jonava d. mun.;2013;65;469;186;283
Jonava d. mun.;2013;66;422;166;256
Jonava d. mun.;2013;67;455;192;263
Jonava d. mun.;2013;68;392;158;234
Jonava d. mun.;2013;69;422;170;252
Jonava d. mun.;2013;70;420;143;277
Jonava d. mun.;2013;71;459;160;299
Jonava d. mun.;2013;72;419;155;264
Jonava d. mun.;2013;73;382;135;247
Jonava d. mun.;2013;74;376;126;250
Jonava d. mun.;2013;75;355;108;247
Jonava d. mun.;2013;76;360;122;238
Jonava d. mun.;2013;77;324;104;220
Jonava d. mun.;2013;78;264;74;190
Jonava d. mun.;2013;79;268;76;192
Jonava d. mun.;2013;80;235;68;167
Jonava d. mun.;2013;81;222;50;172
Jonava d. mun.;2013;82;229;54;175
Jonava d. mun.;2013;83;198;51;147
Jonava d. mun.;2013;84;177;49;128
Jonava d. mun.;2013;85;646;136;510
Jonava d. mun.;2014;-1;44470;20608;23862
Jonava d. mun.;2014;0;445;240;205
Jonava d. mun.;2014;1;470;258;212
Jonava d. mun.;2014;2;428;228;200
Jonava d. mun.;2014;3;415;225;190
Jonava d. mun.;2014;4;445;221;224
Jonava d. mun.;2014;5;489;234;255
Jonava d. mun.;2014;6;419;197;222
Jonava d. mun.;2014;7;430;208;222
Jonava d. mun.;2014;8;468;246;222
Jonava d. mun.;2014;9;442;238;204
Jonava d. mun.;2014;10;485;244;241
Jonava d. mun.;2014;11;470;238;232
Jonava d. mun.;2014;12;531;283;248
Jonava d. mun.;2014;13;557;303;254
Jonava d. mun.;2014;14;572;284;288
Jonava d. mun.;2014;15;560;274;286
Jonava d. mun.;2014;16;653;336;317
Jonava d. mun.;2014;17;666;355;311
Jonava d. mun.;2014;18;593;312;281
Jonava d. mun.;2014;19;581;290;291
Jonava d. mun.;2014;20;671;318;353
Jonava d. mun.;2014;21;681;356;325
Jonava d. mun.;2014;22;635;354;281
Jonava d. mun.;2014;23;564;305;259
Jonava d. mun.;2014;24;494;262;232
Jonava d. mun.;2014;25;521;266;255
Jonava d. mun.;2014;26;538;284;254
Jonava d. mun.;2014;27;547;274;273
Jonava d. mun.;2014;28;516;259;257
Jonava d. mun.;2014;29;490;252;238
Jonava d. mun.;2014;30;470;245;225
Jonava d. mun.;2014;31;490;245;245
Jonava d. mun.;2014;32;462;239;223
Jonava d. mun.;2014;33;481;276;205
Jonava d. mun.;2014;34;537;288;249
Jonava d. mun.;2014;35;536;253;283
Jonava d. mun.;2014;36;572;289;283
Jonava d. mun.;2014;37;521;230;291
Jonava d. mun.;2014;38;588;288;300
Jonava d. mun.;2014;39;615;304;311
Jonava d. mun.;2014;40;611;327;284
Jonava d. mun.;2014;41;674;334;340
Jonava d. mun.;2014;42;672;328;344
Jonava d. mun.;2014;43;710;372;338
Jonava d. mun.;2014;44;636;293;343
Jonava d. mun.;2014;45;646;304;342
Jonava d. mun.;2014;46;623;298;325
Jonava d. mun.;2014;47;638;291;347
Jonava d. mun.;2014;48;657;315;342
Jonava d. mun.;2014;49;646;316;330
Jonava d. mun.;2014;50;635;300;335
Jonava d. mun.;2014;51;660;310;350
Jonava d. mun.;2014;52;714;326;388
Jonava d. mun.;2014;53;720;332;388
Jonava d. mun.;2014;54;705;314;391
Jonava d. mun.;2014;55;634;290;344
Jonava d. mun.;2014;56;635;292;343
Jonava d. mun.;2014;57;581;256;325
Jonava d. mun.;2014;58;578;252;326
Jonava d. mun.;2014;59;591;239;352
Jonava d. mun.;2014;60;536;227;309
Jonava d. mun.;2014;61;552;241;311
Jonava d. mun.;2014;62;599;236;363
Jonava d. mun.;2014;63;551;228;323
Jonava d. mun.;2014;64;597;249;348
Jonava d. mun.;2014;65;517;210;307
Jonava d. mun.;2014;66;454;177;277
Jonava d. mun.;2014;67;415;163;252
Jonava d. mun.;2014;68;447;186;261
Jonava d. mun.;2014;69;379;149;230
Jonava d. mun.;2014;70;409;165;244
Jonava d. mun.;2014;71;411;136;275
Jonava d. mun.;2014;72;444;152;292
Jonava d. mun.;2014;73;406;148;258
Jonava d. mun.;2014;74;366;125;241
Jonava d. mun.;2014;75;362;117;245
Jonava d. mun.;2014;76;337;98;239
Jonava d. mun.;2014;77;347;119;228
Jonava d. mun.;2014;78;305;98;207
Jonava d. mun.;2014;79;252;68;184
Jonava d. mun.;2014;80;257;69;188
Jonava d. mun.;2014;81;224;64;160
Jonava d. mun.;2014;82;205;45;160
Jonava d. mun.;2014;83;205;44;161
Jonava d. mun.;2014;84;178;48;130
Jonava d. mun.;2014;85;701;156;545
Jonava d. mun.;2015;-1;43875;20356;23519
Jonava d. mun.;2015;0;451;230;221
Jonava d. mun.;2015;1;437;235;202
Jonava d. mun.;2015;2;455;251;204
Jonava d. mun.;2015;3;423;228;195
Jonava d. mun.;2015;4;405;222;183
Jonava d. mun.;2015;5;435;212;223
Jonava d. mun.;2015;6;478;228;250
Jonava d. mun.;2015;7;416;192;224
Jonava d. mun.;2015;8;425;202;223
Jonava d. mun.;2015;9;467;244;223
Jonava d. mun.;2015;10;432;234;198
Jonava d. mun.;2015;11;475;239;236
Jonava d. mun.;2015;12;467;237;230
Jonava d. mun.;2015;13;526;278;248
Jonava d. mun.;2015;14;551;299;252
Jonava d. mun.;2015;15;564;282;282
Jonava d. mun.;2015;16;550;268;282
Jonava d. mun.;2015;17;644;330;314
Jonava d. mun.;2015;18;656;346;310
Jonava d. mun.;2015;19;567;302;265
Jonava d. mun.;2015;20;552;279;273
Jonava d. mun.;2015;21;656;307;349
Jonava d. mun.;2015;22;662;344;318
Jonava d. mun.;2015;23;618;354;264
Jonava d. mun.;2015;24;554;301;253
Jonava d. mun.;2015;25;490;263;227
Jonava d. mun.;2015;26;492;256;236
Jonava d. mun.;2015;27;511;261;250
Jonava d. mun.;2015;28;532;263;269
Jonava d. mun.;2015;29;506;252;254
Jonava d. mun.;2015;30;479;254;225
Jonava d. mun.;2015;31;453;244;209
Jonava d. mun.;2015;32;474;236;238
Jonava d. mun.;2015;33;446;238;208
Jonava d. mun.;2015;34;479;279;200
Jonava d. mun.;2015;35;520;279;241
Jonava d. mun.;2015;36;535;248;287
Jonava d. mun.;2015;37;555;279;276
Jonava d. mun.;2015;38;522;226;296
Jonava d. mun.;2015;39;585;285;300
Jonava d. mun.;2015;40;614;300;314
Jonava d. mun.;2015;41;600;322;278
Jonava d. mun.;2015;42;665;329;336
Jonava d. mun.;2015;43;657;320;337
Jonava d. mun.;2015;44;703;369;334
Jonava d. mun.;2015;45;633;295;338
Jonava d. mun.;2015;46;635;302;333
Jonava d. mun.;2015;47;614;291;323
Jonava d. mun.;2015;48;632;290;342
Jonava d. mun.;2015;49;656;318;338
Jonava d. mun.;2015;50;639;316;323
Jonava d. mun.;2015;51;632;300;332
Jonava d. mun.;2015;52;649;303;346
Jonava d. mun.;2015;53;697;320;377
Jonava d. mun.;2015;54;709;324;385
Jonava d. mun.;2015;55;693;313;380
Jonava d. mun.;2015;56;632;287;345
Jonava d. mun.;2015;57;620;281;339
Jonava d. mun.;2015;58;576;252;324
Jonava d. mun.;2015;59;570;247;323
Jonava d. mun.;2015;60;582;232;350
Jonava d. mun.;2015;61;524;219;305
Jonava d. mun.;2015;62;548;238;310
Jonava d. mun.;2015;63;586;229;357
Jonava d. mun.;2015;64;544;223;321
Jonava d. mun.;2015;65;581;240;341
Jonava d. mun.;2015;66;503;205;298
Jonava d. mun.;2015;67;453;177;276
Jonava d. mun.;2015;68;411;161;250
Jonava d. mun.;2015;69;436;180;256
Jonava d. mun.;2015;70;372;142;230
Jonava d. mun.;2015;71;397;155;242
Jonava d. mun.;2015;72;400;132;268
Jonava d. mun.;2015;73;422;143;279
Jonava d. mun.;2015;74;391;139;252
Jonava d. mun.;2015;75;347;119;228
Jonava d. mun.;2015;76;349;112;237
Jonava d. mun.;2015;77;325;94;231
Jonava d. mun.;2015;78;329;105;224
Jonava d. mun.;2015;79;287;91;196
Jonava d. mun.;2015;80;241;69;172
Jonava d. mun.;2015;81;241;62;179
Jonava d. mun.;2015;82;210;57;153
Jonava d. mun.;2015;83;184;37;147
Jonava d. mun.;2015;84;187;40;147
Jonava d. mun.;2015;85;754;169;585
Jonava d. mun.;2016;-1;43196;19977;23219
Jonava d. mun.;2016;0;470;242;228
Jonava d. mun.;2016;1;438;224;214
Jonava d. mun.;2016;2;423;228;195
Jonava d. mun.;2016;3;438;242;196
Jonava d. mun.;2016;4;409;223;186
Jonava d. mun.;2016;5;401;218;183
Jonava d. mun.;2016;6;431;211;220
Jonava d. mun.;2016;7;458;215;243
Jonava d. mun.;2016;8;411;191;220
Jonava d. mun.;2016;9;424;202;222
Jonava d. mun.;2016;10;466;241;225
Jonava d. mun.;2016;11;427;228;199
Jonava d. mun.;2016;12;463;229;234
Jonava d. mun.;2016;13;469;237;232
Jonava d. mun.;2016;14;512;275;237
Jonava d. mun.;2016;15;547;297;250
Jonava d. mun.;2016;16;552;276;276
Jonava d. mun.;2016;17;546;266;280
Jonava d. mun.;2016;18;633;323;310
Jonava d. mun.;2016;19;634;340;294
Jonava d. mun.;2016;20;556;296;260
Jonava d. mun.;2016;21;540;274;266
Jonava d. mun.;2016;22;642;300;342
Jonava d. mun.;2016;23;645;338;307
Jonava d. mun.;2016;24;594;332;262
Jonava d. mun.;2016;25;525;285;240
Jonava d. mun.;2016;26;468;248;220
Jonava d. mun.;2016;27;466;243;223
Jonava d. mun.;2016;28;475;248;227
Jonava d. mun.;2016;29;515;256;259
Jonava d. mun.;2016;30;485;237;248
Jonava d. mun.;2016;31;469;255;214
Jonava d. mun.;2016;32;434;232;202
Jonava d. mun.;2016;33;450;224;226
Jonava d. mun.;2016;34;432;226;206
Jonava d. mun.;2016;35;463;267;196
Jonava d. mun.;2016;36;512;275;237
Jonava d. mun.;2016;37;519;242;277
Jonava d. mun.;2016;38;545;275;270
Jonava d. mun.;2016;39;521;227;294
Jonava d. mun.;2016;40;575;281;294
Jonava d. mun.;2016;41;603;294;309
Jonava d. mun.;2016;42;602;319;283
Jonava d. mun.;2016;43;657;322;335
Jonava d. mun.;2016;44;637;310;327
Jonava d. mun.;2016;45;696;363;333
Jonava d. mun.;2016;46;618;285;333
Jonava d. mun.;2016;47;633;305;328
Jonava d. mun.;2016;48;603;285;318
Jonava d. mun.;2016;49;623;283;340
Jonava d. mun.;2016;50;644;309;335
Jonava d. mun.;2016;51;636;310;326
Jonava d. mun.;2016;52;630;301;329
Jonava d. mun.;2016;53;637;288;349
Jonava d. mun.;2016;54;695;314;381
Jonava d. mun.;2016;55;697;315;382
Jonava d. mun.;2016;56;686;309;377
Jonava d. mun.;2016;57;626;287;339
Jonava d. mun.;2016;58;620;278;342
Jonava d. mun.;2016;59;564;239;325
Jonava d. mun.;2016;60;558;241;317
Jonava d. mun.;2016;61;579;224;355
Jonava d. mun.;2016;62;513;213;300
Jonava d. mun.;2016;63;541;236;305
Jonava d. mun.;2016;64;565;215;350
Jonava d. mun.;2016;65;536;219;317
Jonava d. mun.;2016;66;564;230;334
Jonava d. mun.;2016;67;499;201;298
Jonava d. mun.;2016;68;446;170;276
Jonava d. mun.;2016;69;400;152;248
Jonava d. mun.;2016;70;425;173;252
Jonava d. mun.;2016;71;360;136;224
Jonava d. mun.;2016;72;388;149;239
Jonava d. mun.;2016;73;383;121;262
Jonava d. mun.;2016;74;411;135;276
Jonava d. mun.;2016;75;376;128;248
Jonava d. mun.;2016;76;329;111;218
Jonava d. mun.;2016;77;340;107;233
Jonava d. mun.;2016;78;310;85;225
Jonava d. mun.;2016;79;305;95;210
Jonava d. mun.;2016;80;272;84;188
Jonava d. mun.;2016;81;224;63;161
Jonava d. mun.;2016;82;217;55;162
Jonava d. mun.;2016;83;188;47;141
Jonava d. mun.;2016;84;170;32;138
Jonava d. mun.;2016;85;807;170;637
Jonava d. mun.;2017;-1;42561;19696;22865
Jonava d. mun.;2017;0;443;223;220
Jonava d. mun.;2017;1;471;240;231
Jonava d. mun.;2017;2;437;224;213
Jonava d. mun.;2017;3;412;222;190
Jonava d. mun.;2017;4;440;243;197
Jonava d. mun.;2017;5;413;224;189
Jonava d. mun.;2017;6;400;219;181
Jonava d. mun.;2017;7;434;211;223
Jonava d. mun.;2017;8;451;210;241
Jonava d. mun.;2017;9;413;192;221
Jonava d. mun.;2017;10;421;206;215
Jonava d. mun.;2017;11;465;242;223
Jonava d. mun.;2017;12;424;222;202
Jonava d. mun.;2017;13;458;229;229
Jonava d. mun.;2017;14;466;236;230
Jonava d. mun.;2017;15;505;273;232
Jonava d. mun.;2017;16;550;297;253
Jonava d. mun.;2017;17;546;271;275
Jonava d. mun.;2017;18;532;260;272
Jonava d. mun.;2017;19;614;318;296
Jonava d. mun.;2017;20;621;335;286
Jonava d. mun.;2017;21;545;291;254
Jonava d. mun.;2017;22;528;265;263
Jonava d. mun.;2017;23;629;295;334
Jonava d. mun.;2017;24;640;340;300
Jonava d. mun.;2017;25;552;316;236
Jonava d. mun.;2017;26;501;275;226
Jonava d. mun.;2017;27;442;239;203
Jonava d. mun.;2017;28;447;240;207
Jonava d. mun.;2017;29;445;225;220
Jonava d. mun.;2017;30;506;256;250
Jonava d. mun.;2017;31;483;239;244
Jonava d. mun.;2017;32;448;245;203
Jonava d. mun.;2017;33;420;222;198
Jonava d. mun.;2017;34;432;223;209
Jonava d. mun.;2017;35;413;219;194
Jonava d. mun.;2017;36;439;249;190
Jonava d. mun.;2017;37;487;258;229
Jonava d. mun.;2017;38;513;237;276
Jonava d. mun.;2017;39;528;266;262
Jonava d. mun.;2017;40;511;216;295
Jonava d. mun.;2017;41;559;268;291
Jonava d. mun.;2017;42;581;289;292
Jonava d. mun.;2017;43;581;309;272
Jonava d. mun.;2017;44;644;316;328
Jonava d. mun.;2017;45;630;309;321
Jonava d. mun.;2017;46;698;366;332
Jonava d. mun.;2017;47;620;291;329
Jonava d. mun.;2017;48;633;303;330
Jonava d. mun.;2017;49;596;278;318
Jonava d. mun.;2017;50;625;280;345
Jonava d. mun.;2017;51;632;298;334
Jonava d. mun.;2017;52;620;301;319
Jonava d. mun.;2017;53;623;296;327
Jonava d. mun.;2017;54;631;285;346
Jonava d. mun.;2017;55;683;308;375
Jonava d. mun.;2017;56;688;309;379
Jonava d. mun.;2017;57;682;308;374
Jonava d. mun.;2017;58;616;282;334
Jonava d. mun.;2017;59;613;271;342
Jonava d. mun.;2017;60;558;239;319
Jonava d. mun.;2017;61;550;235;315
Jonava d. mun.;2017;62;571;216;355
Jonava d. mun.;2017;63;504;205;299
Jonava d. mun.;2017;64;525;223;302
Jonava d. mun.;2017;65;552;211;341
Jonava d. mun.;2017;66;525;210;315
Jonava d. mun.;2017;67;550;223;327
Jonava d. mun.;2017;68;484;191;293
Jonava d. mun.;2017;69;433;163;270
Jonava d. mun.;2017;70;389;143;246
Jonava d. mun.;2017;71;411;170;241
Jonava d. mun.;2017;72;356;136;220
Jonava d. mun.;2017;73;367;133;234
Jonava d. mun.;2017;74;372;113;259
Jonava d. mun.;2017;75;395;129;266
Jonava d. mun.;2017;76;361;121;240
Jonava d. mun.;2017;77;319;106;213
Jonava d. mun.;2017;78;320;96;224
Jonava d. mun.;2017;79;300;78;222
Jonava d. mun.;2017;80;286;85;201
Jonava d. mun.;2017;81;255;78;177
Jonava d. mun.;2017;82;203;58;145
Jonava d. mun.;2017;83;206;51;155
Jonava d. mun.;2017;84;166;42;124
Jonava d. mun.;2017;85;823;161;662
Jonava d. mun.;2018;-1;42052;19482;22570
Jonava d. mun.;2018;0;396;196;200
Jonava d. mun.;2018;1;458;233;225
Jonava d. mun.;2018;2;473;236;237
Jonava d. mun.;2018;3;437;220;217
Jonava d. mun.;2018;4;414;223;191
Jonava d. mun.;2018;5;439;240;199
Jonava d. mun.;2018;6;426;222;204
Jonava d. mun.;2018;7;408;222;186
Jonava d. mun.;2018;8;437;216;221
Jonava d. mun.;2018;9;444;204;240
Jonava d. mun.;2018;10;409;193;216
Jonava d. mun.;2018;11;416;207;209
Jonava d. mun.;2018;12;459;238;221
Jonava d. mun.;2018;13;423;222;201
Jonava d. mun.;2018;14;464;233;231
Jonava d. mun.;2018;15;466;230;236
Jonava d. mun.;2018;16;502;271;231
Jonava d. mun.;2018;17;540;293;247
Jonava d. mun.;2018;18;534;263;271
Jonava d. mun.;2018;19;506;252;254
Jonava d. mun.;2018;20;574;298;276
Jonava d. mun.;2018;21;596;321;275
Jonava d. mun.;2018;22;527;281;246
Jonava d. mun.;2018;23;505;254;251
Jonava d. mun.;2018;24;599;280;319
Jonava d. mun.;2018;25;593;317;276
Jonava d. mun.;2018;26;524;295;229
Jonava d. mun.;2018;27;493;267;226
Jonava d. mun.;2018;28;428;236;192
Jonava d. mun.;2018;29;429;239;190
Jonava d. mun.;2018;30;432;222;210
Jonava d. mun.;2018;31;499;254;245
Jonava d. mun.;2018;32;472;241;231
Jonava d. mun.;2018;33;424;232;192
Jonava d. mun.;2018;34;412;219;193
Jonava d. mun.;2018;35;429;218;211
Jonava d. mun.;2018;36;402;214;188
Jonava d. mun.;2018;37;435;249;186
Jonava d. mun.;2018;38;486;259;227
Jonava d. mun.;2018;39;498;231;267
Jonava d. mun.;2018;40;523;262;261
Jonava d. mun.;2018;41;504;215;289
Jonava d. mun.;2018;42;544;265;279
Jonava d. mun.;2018;43;575;290;285
Jonava d. mun.;2018;44;573;304;269
Jonava d. mun.;2018;45;644;319;325
Jonava d. mun.;2018;46;621;303;318
Jonava d. mun.;2018;47;695;366;329
Jonava d. mun.;2018;48;617;290;327
Jonava d. mun.;2018;49;618;294;324
Jonava d. mun.;2018;50;583;274;309
Jonava d. mun.;2018;51;612;272;340
Jonava d. mun.;2018;52;624;293;331
Jonava d. mun.;2018;53;616;296;320
Jonava d. mun.;2018;54;622;296;326
Jonava d. mun.;2018;55;623;280;343
Jonava d. mun.;2018;56;671;308;363
Jonava d. mun.;2018;57;687;309;378
Jonava d. mun.;2018;58;686;318;368
Jonava d. mun.;2018;59;603;272;331
Jonava d. mun.;2018;60;609;266;343
Jonava d. mun.;2018;61;547;230;317
Jonava d. mun.;2018;62;551;233;318
Jonava d. mun.;2018;63;565;213;352
Jonava d. mun.;2018;64;495;201;294
Jonava d. mun.;2018;65;520;217;303
Jonava d. mun.;2018;66;545;205;340
Jonava d. mun.;2018;67;521;204;317
Jonava d. mun.;2018;68;547;223;324
Jonava d. mun.;2018;69;472;185;287
Jonava d. mun.;2018;70;423;157;266
Jonava d. mun.;2018;71;379;135;244
Jonava d. mun.;2018;72;403;166;237
Jonava d. mun.;2018;73;341;125;216
Jonava d. mun.;2018;74;357;129;228
Jonava d. mun.;2018;75;365;108;257
Jonava d. mun.;2018;76;388;126;262
Jonava d. mun.;2018;77;350;115;235
Jonava d. mun.;2018;78;302;93;209
Jonava d. mun.;2018;79;308;89;219
Jonava d. mun.;2018;80;285;74;211
Jonava d. mun.;2018;81;266;80;186
Jonava d. mun.;2018;82;235;70;165
Jonava d. mun.;2018;83;186;52;134
Jonava d. mun.;2018;84;187;44;143
Jonava d. mun.;2018;85;856;175;681
Joniškis d. mun.;2001;-1;31940;14990;16950
Joniškis d. mun.;2001;0;341;173;168
Joniškis d. mun.;2001;1;363;186;177
Joniškis d. mun.;2001;2;362;187;175
Joniškis d. mun.;2001;3;384;177;207
Joniškis d. mun.;2001;4;362;200;162
Joniškis d. mun.;2001;5;379;179;200
Joniškis d. mun.;2001;6;450;215;235
Joniškis d. mun.;2001;7;514;271;243
Joniškis d. mun.;2001;8;558;274;284
Joniškis d. mun.;2001;9;543;276;267
Joniškis d. mun.;2001;10;542;270;272
Joniškis d. mun.;2001;11;552;273;279
Joniškis d. mun.;2001;12;570;299;271
Joniškis d. mun.;2001;13;548;262;286
Joniškis d. mun.;2001;14;548;289;259
Joniškis d. mun.;2001;15;628;307;321
Joniškis d. mun.;2001;16;572;289;283
Joniškis d. mun.;2001;17;547;263;284
Joniškis d. mun.;2001;18;454;222;232
Joniškis d. mun.;2001;19;314;176;138
Joniškis d. mun.;2001;20;304;174;130
Joniškis d. mun.;2001;21;334;186;148
Joniškis d. mun.;2001;22;359;188;171
Joniškis d. mun.;2001;23;366;179;187
Joniškis d. mun.;2001;24;363;186;177
Joniškis d. mun.;2001;25;376;202;174
Joniškis d. mun.;2001;26;394;216;178
Joniškis d. mun.;2001;27;399;202;197
Joniškis d. mun.;2001;28;404;198;206
Joniškis d. mun.;2001;29;445;192;253
Joniškis d. mun.;2001;30;445;229;216
Joniškis d. mun.;2001;31;392;213;179
Joniškis d. mun.;2001;32;457;236;221
Joniškis d. mun.;2001;33;479;246;233
Joniškis d. mun.;2001;34;457;236;221
Joniškis d. mun.;2001;35;452;216;236
Joniškis d. mun.;2001;36;467;216;251
Joniškis d. mun.;2001;37;471;236;235
Joniškis d. mun.;2001;38;490;257;233
Joniškis d. mun.;2001;39;473;241;232
Joniškis d. mun.;2001;40;511;250;261
Joniškis d. mun.;2001;41;484;244;240
Joniškis d. mun.;2001;42;471;261;210
Joniškis d. mun.;2001;43;402;195;207
Joniškis d. mun.;2001;44;419;223;196
Joniškis d. mun.;2001;45;389;181;208
Joniškis d. mun.;2001;46;381;188;193
Joniškis d. mun.;2001;47;372;192;180
Joniškis d. mun.;2001;48;366;171;195
Joniškis d. mun.;2001;49;374;196;178
Joniškis d. mun.;2001;50;384;168;216
Joniškis d. mun.;2001;51;332;181;151
Joniškis d. mun.;2001;52;309;145;164
Joniškis d. mun.;2001;53;333;148;185
Joniškis d. mun.;2001;54;328;136;192
Joniškis d. mun.;2001;55;329;148;181
Joniškis d. mun.;2001;56;320;157;163
Joniškis d. mun.;2001;57;379;166;213
Joniškis d. mun.;2001;58;386;176;210
Joniškis d. mun.;2001;59;430;184;246
Joniškis d. mun.;2001;60;318;139;179
Joniškis d. mun.;2001;61;348;155;193
Joniškis d. mun.;2001;62;326;139;187
Joniškis d. mun.;2001;63;319;132;187
Joniškis d. mun.;2001;64;378;147;231
Joniškis d. mun.;2001;65;363;145;218
Joniškis d. mun.;2001;66;317;113;204
Joniškis d. mun.;2001;67;313;113;200
Joniškis d. mun.;2001;68;303;115;188
Joniškis d. mun.;2001;69;280;106;174
Joniškis d. mun.;2001;70;304;109;195
Joniškis d. mun.;2001;71;249;105;144
Joniškis d. mun.;2001;72;276;99;177
Joniškis d. mun.;2001;73;256;90;166
Joniškis d. mun.;2001;74;228;66;162
Joniškis d. mun.;2001;75;214;69;145
Joniškis d. mun.;2001;76;191;54;137
Joniškis d. mun.;2001;77;202;62;140
Joniškis d. mun.;2001;78;171;46;125
Joniškis d. mun.;2001;79;155;49;106
Joniškis d. mun.;2001;80;139;31;108
Joniškis d. mun.;2001;81;97;26;71
Joniškis d. mun.;2001;82;74;14;60
Joniškis d. mun.;2001;83;80;15;65
Joniškis d. mun.;2001;84;70;22;48
Joniškis d. mun.;2001;85;412;82;330
Joniškis d. mun.;2002;-1;31656;14874;16782
Joniškis d. mun.;2002;0;288;157;131
Joniškis d. mun.;2002;1;342;173;169
Joniškis d. mun.;2002;2;359;183;176
Joniškis d. mun.;2002;3;357;182;175
Joniškis d. mun.;2002;4;384;176;208
Joniškis d. mun.;2002;5;358;198;160
Joniškis d. mun.;2002;6;379;181;198
Joniškis d. mun.;2002;7;446;216;230
Joniškis d. mun.;2002;8;508;266;242
Joniškis d. mun.;2002;9;552;270;282
Joniškis d. mun.;2002;10;543;275;268
Joniškis d. mun.;2002;11;540;270;270
Joniškis d. mun.;2002;12;544;268;276
Joniškis d. mun.;2002;13;567;298;269
Joniškis d. mun.;2002;14;539;257;282
Joniškis d. mun.;2002;15;538;282;256
Joniškis d. mun.;2002;16;616;300;316
Joniškis d. mun.;2002;17;565;288;277
Joniškis d. mun.;2002;18;544;262;282
Joniškis d. mun.;2002;19;446;215;231
Joniškis d. mun.;2002;20;316;177;139
Joniškis d. mun.;2002;21;300;171;129
Joniškis d. mun.;2002;22;333;183;150
Joniškis d. mun.;2002;23;351;187;164
Joniškis d. mun.;2002;24;359;173;186
Joniškis d. mun.;2002;25;360;184;176
Joniškis d. mun.;2002;26;373;201;172
Joniškis d. mun.;2002;27;381;210;171
Joniškis d. mun.;2002;28;401;203;198
Joniškis d. mun.;2002;29;397;195;202
Joniškis d. mun.;2002;30;438;190;248
Joniškis d. mun.;2002;31;435;222;213
Joniškis d. mun.;2002;32;385;206;179
Joniškis d. mun.;2002;33;450;231;219
Joniškis d. mun.;2002;34;464;234;230
Joniškis d. mun.;2002;35;453;234;219
Joniškis d. mun.;2002;36;446;213;233
Joniškis d. mun.;2002;37;460;213;247
Joniškis d. mun.;2002;38;465;233;232
Joniškis d. mun.;2002;39;482;252;230
Joniškis d. mun.;2002;40;464;236;228
Joniškis d. mun.;2002;41;509;251;258
Joniškis d. mun.;2002;42;479;244;235
Joniškis d. mun.;2002;43;468;260;208
Joniškis d. mun.;2002;44;403;197;206
Joniškis d. mun.;2002;45;406;213;193
Joniškis d. mun.;2002;46;383;179;204
Joniškis d. mun.;2002;47;381;190;191
Joniškis d. mun.;2002;48;362;185;177
Joniškis d. mun.;2002;49;358;168;190
Joniškis d. mun.;2002;50;367;193;174
Joniškis d. mun.;2002;51;377;166;211
Joniškis d. mun.;2002;52;327;176;151
Joniškis d. mun.;2002;53;311;147;164
Joniškis d. mun.;2002;54;327;145;182
Joniškis d. mun.;2002;55;321;133;188
Joniškis d. mun.;2002;56;321;144;177
Joniškis d. mun.;2002;57;314;157;157
Joniškis d. mun.;2002;58;368;160;208
Joniškis d. mun.;2002;59;375;171;204
Joniškis d. mun.;2002;60;427;181;246
Joniškis d. mun.;2002;61;317;137;180
Joniškis d. mun.;2002;62;343;154;189
Joniškis d. mun.;2002;63;321;133;188
Joniškis d. mun.;2002;64;313;129;184
Joniškis d. mun.;2002;65;374;145;229
Joniškis d. mun.;2002;66;353;140;213
Joniškis d. mun.;2002;67;311;112;199
Joniškis d. mun.;2002;68;308;109;199
Joniškis d. mun.;2002;69;297;113;184
Joniškis d. mun.;2002;70;278;107;171
Joniškis d. mun.;2002;71;295;103;192
Joniškis d. mun.;2002;72;243;99;144
Joniškis d. mun.;2002;73;272;96;176
Joniškis d. mun.;2002;74;252;89;163
Joniškis d. mun.;2002;75;220;62;158
Joniškis d. mun.;2002;76;205;63;142
Joniškis d. mun.;2002;77;181;48;133
Joniškis d. mun.;2002;78;197;61;136
Joniškis d. mun.;2002;79;168;47;121
Joniškis d. mun.;2002;80;142;44;98
Joniškis d. mun.;2002;81;129;26;103
Joniškis d. mun.;2002;82;89;23;66
Joniškis d. mun.;2002;83;70;13;57
Joniškis d. mun.;2002;84;71;14;57
Joniškis d. mun.;2002;85;395;82;313
Joniškis d. mun.;2003;-1;31367;14736;16631
Joniškis d. mun.;2003;0;316;168;148
Joniškis d. mun.;2003;1;285;153;132
Joniškis d. mun.;2003;2;336;169;167
Joniškis d. mun.;2003;3;356;183;173
Joniškis d. mun.;2003;4;356;182;174
Joniškis d. mun.;2003;5;383;175;208
Joniškis d. mun.;2003;6;356;197;159
Joniškis d. mun.;2003;7;374;180;194
Joniškis d. mun.;2003;8;447;216;231
Joniškis d. mun.;2003;9;505;266;239
Joniškis d. mun.;2003;10;549;269;280
Joniškis d. mun.;2003;11;537;273;264
Joniškis d. mun.;2003;12;530;264;266
Joniškis d. mun.;2003;13;537;265;272
Joniškis d. mun.;2003;14;556;289;267
Joniškis d. mun.;2003;15;528;250;278
Joniškis d. mun.;2003;16;531;280;251
Joniškis d. mun.;2003;17;606;296;310
Joniškis d. mun.;2003;18;554;282;272
Joniškis d. mun.;2003;19;539;256;283
Joniškis d. mun.;2003;20;441;214;227
Joniškis d. mun.;2003;21;314;174;140
Joniškis d. mun.;2003;22;299;167;132
Joniškis d. mun.;2003;23;331;181;150
Joniškis d. mun.;2003;24;351;187;164
Joniškis d. mun.;2003;25;351;170;181
Joniškis d. mun.;2003;26;347;176;171
Joniškis d. mun.;2003;27;364;196;168
Joniškis d. mun.;2003;28;382;209;173
Joniškis d. mun.;2003;29;387;195;192
Joniškis d. mun.;2003;30;394;193;201
Joniškis d. mun.;2003;31;429;185;244
Joniškis d. mun.;2003;32;429;218;211
Joniškis d. mun.;2003;33;377;201;176
Joniškis d. mun.;2003;34;446;228;218
Joniškis d. mun.;2003;35;461;232;229
Joniškis d. mun.;2003;36;450;232;218
Joniškis d. mun.;2003;37;445;212;233
Joniškis d. mun.;2003;38;454;210;244
Joniškis d. mun.;2003;39;459;228;231
Joniškis d. mun.;2003;40;476;249;227
Joniškis d. mun.;2003;41;451;227;224
Joniškis d. mun.;2003;42;496;242;254
Joniškis d. mun.;2003;43;474;240;234
Joniškis d. mun.;2003;44;467;259;208
Joniškis d. mun.;2003;45;395;193;202
Joniškis d. mun.;2003;46;401;212;189
Joniškis d. mun.;2003;47;379;177;202
Joniškis d. mun.;2003;48;380;190;190
Joniškis d. mun.;2003;49;360;183;177
Joniškis d. mun.;2003;50;357;168;189
Joniškis d. mun.;2003;51;362;191;171
Joniškis d. mun.;2003;52;377;166;211
Joniškis d. mun.;2003;53;327;176;151
Joniškis d. mun.;2003;54;304;145;159
Joniškis d. mun.;2003;55;322;143;179
Joniškis d. mun.;2003;56;319;131;188
Joniškis d. mun.;2003;57;315;139;176
Joniškis d. mun.;2003;58;305;150;155
Joniškis d. mun.;2003;59;361;156;205
Joniškis d. mun.;2003;60;368;164;204
Joniškis d. mun.;2003;61;421;175;246
Joniškis d. mun.;2003;62;315;138;177
Joniškis d. mun.;2003;63;336;150;186
Joniškis d. mun.;2003;64;316;132;184
Joniškis d. mun.;2003;65;308;123;185
Joniškis d. mun.;2003;66;374;145;229
Joniškis d. mun.;2003;67;342;137;205
Joniškis d. mun.;2003;68;307;105;202
Joniškis d. mun.;2003;69;302;104;198
Joniškis d. mun.;2003;70;281;103;178
Joniškis d. mun.;2003;71;273;107;166
Joniškis d. mun.;2003;72;285;99;186
Joniškis d. mun.;2003;73;236;96;140
Joniškis d. mun.;2003;74;254;86;168
Joniškis d. mun.;2003;75;235;85;150
Joniškis d. mun.;2003;76;211;60;151
Joniškis d. mun.;2003;77;188;56;132
Joniškis d. mun.;2003;78;169;45;124
Joniškis d. mun.;2003;79;187;55;132
Joniškis d. mun.;2003;80;156;41;115
Joniškis d. mun.;2003;81;135;40;95
Joniškis d. mun.;2003;82;117;22;95
Joniškis d. mun.;2003;83;78;18;60
Joniškis d. mun.;2003;84;63;11;52
Joniškis d. mun.;2003;85;390;81;309
Joniškis d. mun.;2004;-1;31012;14564;16448
Joniškis d. mun.;2004;0;310;151;159
Joniškis d. mun.;2004;1;309;166;143
Joniškis d. mun.;2004;2;283;153;130
Joniškis d. mun.;2004;3;334;169;165
Joniškis d. mun.;2004;4;351;180;171
Joniškis d. mun.;2004;5;353;180;173
Joniškis d. mun.;2004;6;379;173;206
Joniškis d. mun.;2004;7;355;196;159
Joniškis d. mun.;2004;8;376;180;196
Joniškis d. mun.;2004;9;447;216;231
Joniškis d. mun.;2004;10;505;267;238
Joniškis d. mun.;2004;11;542;267;275
Joniškis d. mun.;2004;12;529;268;261
Joniškis d. mun.;2004;13;524;262;262
Joniškis d. mun.;2004;14;528;262;266
Joniškis d. mun.;2004;15;547;283;264
Joniškis d. mun.;2004;16;516;247;269
Joniškis d. mun.;2004;17;521;276;245
Joniškis d. mun.;2004;18;589;288;301
Joniškis d. mun.;2004;19;535;275;260
Joniškis d. mun.;2004;20;528;255;273
Joniškis d. mun.;2004;21;433;212;221
Joniškis d. mun.;2004;22;307;170;137
Joniškis d. mun.;2004;23;293;164;129
Joniškis d. mun.;2004;24;316;175;141
Joniškis d. mun.;2004;25;328;174;154
Joniškis d. mun.;2004;26;330;157;173
Joniškis d. mun.;2004;27;346;177;169
Joniškis d. mun.;2004;28;363;198;165
Joniškis d. mun.;2004;29;368;201;167
Joniškis d. mun.;2004;30;377;191;186
Joniškis d. mun.;2004;31;386;190;196
Joniškis d. mun.;2004;32;421;180;241
Joniškis d. mun.;2004;33;418;214;204
Joniškis d. mun.;2004;34;369;195;174
Joniškis d. mun.;2004;35;440;222;218
Joniškis d. mun.;2004;36;458;232;226
Joniškis d. mun.;2004;37;441;225;216
Joniškis d. mun.;2004;38;431;207;224
Joniškis d. mun.;2004;39;446;208;238
Joniškis d. mun.;2004;40;452;225;227
Joniškis d. mun.;2004;41;466;243;223
Joniškis d. mun.;2004;42;450;225;225
Joniškis d. mun.;2004;43;493;244;249
Joniškis d. mun.;2004;44;465;233;232
Joniškis d. mun.;2004;45;463;256;207
Joniškis d. mun.;2004;46;395;193;202
Joniškis d. mun.;2004;47;393;205;188
Joniškis d. mun.;2004;48;372;173;199
Joniškis d. mun.;2004;49;376;186;190
Joniškis d. mun.;2004;50;355;181;174
Joniškis d. mun.;2004;51;353;166;187
Joniškis d. mun.;2004;52;355;186;169
Joniškis d. mun.;2004;53;372;162;210
Joniškis d. mun.;2004;54;327;175;152
Joniškis d. mun.;2004;55;300;143;157
Joniškis d. mun.;2004;56;316;141;175
Joniškis d. mun.;2004;57;311;125;186
Joniškis d. mun.;2004;58;312;138;174
Joniškis d. mun.;2004;59;298;144;154
Joniškis d. mun.;2004;60;347;150;197
Joniškis d. mun.;2004;61;352;155;197
Joniškis d. mun.;2004;62;413;170;243
Joniškis d. mun.;2004;63;310;135;175
Joniškis d. mun.;2004;64;325;142;183
Joniškis d. mun.;2004;65;315;131;184
Joniškis d. mun.;2004;66;303;123;180
Joniškis d. mun.;2004;67;368;139;229
Joniškis d. mun.;2004;68;335;132;203
Joniškis d. mun.;2004;69;303;103;200
Joniškis d. mun.;2004;70;295;98;197
Joniškis d. mun.;2004;71;274;97;177
Joniškis d. mun.;2004;72;266;101;165
Joniškis d. mun.;2004;73;280;96;184
Joniškis d. mun.;2004;74;231;94;137
Joniškis d. mun.;2004;75;246;80;166
Joniškis d. mun.;2004;76;224;81;143
Joniškis d. mun.;2004;77;203;56;147
Joniškis d. mun.;2004;78;178;52;126
Joniškis d. mun.;2004;79;159;39;120
Joniškis d. mun.;2004;80;175;49;126
Joniškis d. mun.;2004;81;151;37;114
Joniškis d. mun.;2004;82;131;38;93
Joniškis d. mun.;2004;83;106;17;89
Joniškis d. mun.;2004;84;72;16;56
Joniškis d. mun.;2004;85;394;83;311
Joniškis d. mun.;2005;-1;30536;14317;16219
Joniškis d. mun.;2005;0;305;148;157
Joniškis d. mun.;2005;1;302;146;156
Joniškis d. mun.;2005;2;308;166;142
Joniškis d. mun.;2005;3;281;153;128
Joniškis d. mun.;2005;4;333;169;164
Joniškis d. mun.;2005;5;347;178;169
Joniškis d. mun.;2005;6;352;179;173
Joniškis d. mun.;2005;7;377;174;203
Joniškis d. mun.;2005;8;353;195;158
Joniškis d. mun.;2005;9;374;180;194
Joniškis d. mun.;2005;10;442;214;228
Joniškis d. mun.;2005;11;504;267;237
Joniškis d. mun.;2005;12;537;265;272
Joniškis d. mun.;2005;13;528;266;262
Joniškis d. mun.;2005;14;517;259;258
Joniškis d. mun.;2005;15;523;259;264
Joniškis d. mun.;2005;16;542;279;263
Joniškis d. mun.;2005;17;501;238;263
Joniškis d. mun.;2005;18;503;265;238
Joniškis d. mun.;2005;19;569;281;288
Joniškis d. mun.;2005;20;526;267;259
Joniškis d. mun.;2005;21;501;243;258
Joniškis d. mun.;2005;22;405;204;201
Joniškis d. mun.;2005;23;297;164;133
Joniškis d. mun.;2005;24;282;161;121
Joniškis d. mun.;2005;25;299;163;136
Joniškis d. mun.;2005;26;315;167;148
Joniškis d. mun.;2005;27;320;149;171
Joniškis d. mun.;2005;28;329;168;161
Joniškis d. mun.;2005;29;350;190;160
Joniškis d. mun.;2005;30;354;189;165
Joniškis d. mun.;2005;31;359;181;178
Joniškis d. mun.;2005;32;377;182;195
Joniškis d. mun.;2005;33;408;173;235
Joniškis d. mun.;2005;34;407;210;197
Joniškis d. mun.;2005;35;362;188;174
Joniškis d. mun.;2005;36;436;222;214
Joniškis d. mun.;2005;37;446;224;222
Joniškis d. mun.;2005;38;439;226;213
Joniškis d. mun.;2005;39;429;204;225
Joniškis d. mun.;2005;40;441;204;237
Joniškis d. mun.;2005;41;442;217;225
Joniškis d. mun.;2005;42;461;241;220
Joniškis d. mun.;2005;43;446;223;223
Joniškis d. mun.;2005;44;485;243;242
Joniškis d. mun.;2005;45;459;228;231
Joniškis d. mun.;2005;46;462;256;206
Joniškis d. mun.;2005;47;384;187;197
Joniškis d. mun.;2005;48;388;202;186
Joniškis d. mun.;2005;49;367;169;198
Joniškis d. mun.;2005;50;369;184;185
Joniškis d. mun.;2005;51;349;175;174
Joniškis d. mun.;2005;52;344;161;183
Joniškis d. mun.;2005;53;346;180;166
Joniškis d. mun.;2005;54;368;161;207
Joniškis d. mun.;2005;55;319;168;151
Joniškis d. mun.;2005;56;297;140;157
Joniškis d. mun.;2005;57;310;137;173
Joniškis d. mun.;2005;58;310;124;186
Joniškis d. mun.;2005;59;308;135;173
Joniškis d. mun.;2005;60;291;139;152
Joniškis d. mun.;2005;61;333;142;191
Joniškis d. mun.;2005;62;343;149;194
Joniškis d. mun.;2005;63;407;165;242
Joniškis d. mun.;2005;64;298;127;171
Joniškis d. mun.;2005;65;318;139;179
Joniškis d. mun.;2005;66;308;127;181
Joniškis d. mun.;2005;67;295;120;175
Joniškis d. mun.;2005;68;360;135;225
Joniškis d. mun.;2005;69;327;127;200
Joniškis d. mun.;2005;70;293;96;197
Joniškis d. mun.;2005;71;288;93;195
Joniškis d. mun.;2005;72;265;96;169
Joniškis d. mun.;2005;73;261;98;163
Joniškis d. mun.;2005;74;267;90;177
Joniškis d. mun.;2005;75;220;89;131
Joniškis d. mun.;2005;76;239;77;162
Joniškis d. mun.;2005;77;212;73;139
Joniškis d. mun.;2005;78;198;54;144
Joniškis d. mun.;2005;79;165;48;117
Joniškis d. mun.;2005;80;154;35;119
Joniškis d. mun.;2005;81;169;49;120
Joniškis d. mun.;2005;82;137;33;104
Joniškis d. mun.;2005;83;120;34;86
Joniškis d. mun.;2005;84;94;14;80
Joniškis d. mun.;2005;85;380;77;303
Joniškis d. mun.;2006;-1;29746;13860;15886
Joniškis d. mun.;2006;0;254;129;125
Joniškis d. mun.;2006;1;297;142;155
Joniškis d. mun.;2006;2;288;133;155
Joniškis d. mun.;2006;3;305;164;141
Joniškis d. mun.;2006;4;275;149;126
Joniškis d. mun.;2006;5;328;166;162
Joniškis d. mun.;2006;6;341;175;166
Joniškis d. mun.;2006;7;347;176;171
Joniškis d. mun.;2006;8;373;171;202
Joniškis d. mun.;2006;9;349;191;158
Joniškis d. mun.;2006;10;372;180;192
Joniškis d. mun.;2006;11;437;210;227
Joniškis d. mun.;2006;12;498;264;234
Joniškis d. mun.;2006;13;523;257;266
Joniškis d. mun.;2006;14;520;260;260
Joniškis d. mun.;2006;15;506;252;254
Joniškis d. mun.;2006;16;504;247;257
Joniškis d. mun.;2006;17;529;272;257
Joniškis d. mun.;2006;18;483;227;256
Joniškis d. mun.;2006;19;472;244;228
Joniškis d. mun.;2006;20;536;265;271
Joniškis d. mun.;2006;21;489;245;244
Joniškis d. mun.;2006;22;470;230;240
Joniškis d. mun.;2006;23;379;187;192
Joniškis d. mun.;2006;24;273;153;120
Joniškis d. mun.;2006;25;247;141;106
Joniškis d. mun.;2006;26;283;154;129
Joniškis d. mun.;2006;27;294;156;138
Joniškis d. mun.;2006;28;310;141;169
Joniškis d. mun.;2006;29;317;159;158
Joniškis d. mun.;2006;30;333;179;154
Joniškis d. mun.;2006;31;357;191;166
Joniškis d. mun.;2006;32;339;170;169
Joniškis d. mun.;2006;33;363;174;189
Joniškis d. mun.;2006;34;392;163;229
Joniškis d. mun.;2006;35;395;203;192
Joniškis d. mun.;2006;36;355;181;174
Joniškis d. mun.;2006;37;428;219;209
Joniškis d. mun.;2006;38;431;211;220
Joniškis d. mun.;2006;39;426;217;209
Joniškis d. mun.;2006;40;418;201;217
Joniškis d. mun.;2006;41;432;197;235
Joniškis d. mun.;2006;42;434;208;226
Joniškis d. mun.;2006;43;454;236;218
Joniškis d. mun.;2006;44;436;215;221
Joniškis d. mun.;2006;45;486;244;242
Joniškis d. mun.;2006;46;447;223;224
Joniškis d. mun.;2006;47;453;247;206
Joniškis d. mun.;2006;48;380;186;194
Joniškis d. mun.;2006;49;380;197;183
Joniškis d. mun.;2006;50;359;166;193
Joniškis d. mun.;2006;51;363;182;181
Joniškis d. mun.;2006;52;337;167;170
Joniškis d. mun.;2006;53;337;155;182
Joniškis d. mun.;2006;54;335;173;162
Joniškis d. mun.;2006;55;359;157;202
Joniškis d. mun.;2006;56;314;162;152
Joniškis d. mun.;2006;57;293;137;156
Joniškis d. mun.;2006;58;306;136;170
Joniškis d. mun.;2006;59;304;122;182
Joniškis d. mun.;2006;60;300;130;170
Joniškis d. mun.;2006;61;281;131;150
Joniškis d. mun.;2006;62;329;137;192
Joniškis d. mun.;2006;63;334;143;191
Joniškis d. mun.;2006;64;391;155;236
Joniškis d. mun.;2006;65;290;121;169
Joniškis d. mun.;2006;66;305;128;177
Joniškis d. mun.;2006;67;298;121;177
Joniškis d. mun.;2006;68;287;118;169
Joniškis d. mun.;2006;69;351;129;222
Joniškis d. mun.;2006;70;309;115;194
Joniškis d. mun.;2006;71;281;92;189
Joniškis d. mun.;2006;72;278;86;192
Joniškis d. mun.;2006;73;255;90;165
Joniškis d. mun.;2006;74;248;90;158
Joniškis d. mun.;2006;75;258;88;170
Joniškis d. mun.;2006;76;216;87;129
Joniškis d. mun.;2006;77;226;68;158
Joniškis d. mun.;2006;78;202;69;133
Joniškis d. mun.;2006;79;189;52;137
Joniškis d. mun.;2006;80;153;46;107
Joniškis d. mun.;2006;81;140;31;109
Joniškis d. mun.;2006;82;153;44;109
Joniškis d. mun.;2006;83;123;32;91
Joniškis d. mun.;2006;84;107;31;76
Joniškis d. mun.;2006;85;397;67;330
Joniškis d. mun.;2007;-1;29083;13568;15515
Joniškis d. mun.;2007;0;231;129;102
Joniškis d. mun.;2007;1;252;128;124
Joniškis d. mun.;2007;2;285;136;149
Joniškis d. mun.;2007;3;280;130;150
Joniškis d. mun.;2007;4;299;162;137
Joniškis d. mun.;2007;5;273;150;123
Joniškis d. mun.;2007;6;322;163;159
Joniškis d. mun.;2007;7;333;170;163
Joniškis d. mun.;2007;8;345;174;171
Joniškis d. mun.;2007;9;371;169;202
Joniškis d. mun.;2007;10;349;191;158
Joniškis d. mun.;2007;11;368;180;188
Joniškis d. mun.;2007;12;428;206;222
Joniškis d. mun.;2007;13;494;259;235
Joniškis d. mun.;2007;14;513;250;263
Joniškis d. mun.;2007;15;516;259;257
Joniškis d. mun.;2007;16;500;251;249
Joniškis d. mun.;2007;17;500;247;253
Joniškis d. mun.;2007;18;520;267;253
Joniškis d. mun.;2007;19;465;218;247
Joniškis d. mun.;2007;20;458;239;219
Joniškis d. mun.;2007;21;521;255;266
Joniškis d. mun.;2007;22;465;235;230
Joniškis d. mun.;2007;23;449;223;226
Joniškis d. mun.;2007;24;354;175;179
Joniškis d. mun.;2007;25;253;146;107
Joniškis d. mun.;2007;26;237;134;103
Joniškis d. mun.;2007;27;267;148;119
Joniškis d. mun.;2007;28;285;153;132
Joniškis d. mun.;2007;29;298;134;164
Joniškis d. mun.;2007;30;307;156;151
Joniškis d. mun.;2007;31;327;175;152
Joniškis d. mun.;2007;32;349;181;168
Joniškis d. mun.;2007;33;328;164;164
Joniškis d. mun.;2007;34;350;165;185
Joniškis d. mun.;2007;35;387;161;226
Joniškis d. mun.;2007;36;390;200;190
Joniškis d. mun.;2007;37;348;177;171
Joniškis d. mun.;2007;38;424;217;207
Joniškis d. mun.;2007;39;422;208;214
Joniškis d. mun.;2007;40;419;215;204
Joniškis d. mun.;2007;41;411;196;215
Joniškis d. mun.;2007;42;426;194;232
Joniškis d. mun.;2007;43;425;205;220
Joniškis d. mun.;2007;44;442;227;215
Joniškis d. mun.;2007;45;427;208;219
Joniškis d. mun.;2007;46;476;238;238
Joniškis d. mun.;2007;47;438;217;221
Joniškis d. mun.;2007;48;450;246;204
Joniškis d. mun.;2007;49;374;184;190
Joniškis d. mun.;2007;50;372;191;181
Joniškis d. mun.;2007;51;353;163;190
Joniškis d. mun.;2007;52;357;177;180
Joniškis d. mun.;2007;53;329;161;168
Joniškis d. mun.;2007;54;332;152;180
Joniškis d. mun.;2007;55;333;173;160
Joniškis d. mun.;2007;56;358;157;201
Joniškis d. mun.;2007;57;303;155;148
Joniškis d. mun.;2007;58;285;134;151
Joniškis d. mun.;2007;59;297;129;168
Joniškis d. mun.;2007;60;300;118;182
Joniškis d. mun.;2007;61;292;125;167
Joniškis d. mun.;2007;62;275;129;146
Joniškis d. mun.;2007;63;322;134;188
Joniškis d. mun.;2007;64;323;137;186
Joniškis d. mun.;2007;65;377;145;232
Joniškis d. mun.;2007;66;282;115;167
Joniškis d. mun.;2007;67;295;125;170
Joniškis d. mun.;2007;68;284;113;171
Joniškis d. mun.;2007;69;274;111;163
Joniškis d. mun.;2007;70;339;122;217
Joniškis d. mun.;2007;71;299;109;190
Joniškis d. mun.;2007;72;269;85;184
Joniškis d. mun.;2007;73;266;80;186
Joniškis d. mun.;2007;74;242;86;156
Joniškis d. mun.;2007;75;234;83;151
Joniškis d. mun.;2007;76;246;84;162
Joniškis d. mun.;2007;77;193;76;117
Joniškis d. mun.;2007;78;209;62;147
Joniškis d. mun.;2007;79;187;64;123
Joniškis d. mun.;2007;80;175;49;126
Joniškis d. mun.;2007;81;141;41;100
Joniškis d. mun.;2007;82;132;26;106
Joniškis d. mun.;2007;83;128;34;94
Joniškis d. mun.;2007;84;105;26;79
Joniškis d. mun.;2007;85;424;82;342
Joniškis d. mun.;2008;-1;28543;13302;15241
Joniškis d. mun.;2008;0;236;114;122
Joniškis d. mun.;2008;1;233;129;104
Joniškis d. mun.;2008;2;248;126;122
Joniškis d. mun.;2008;3;287;138;149
Joniškis d. mun.;2008;4;277;127;150
Joniškis d. mun.;2008;5;299;163;136
Joniškis d. mun.;2008;6;269;148;121
Joniškis d. mun.;2008;7;319;161;158
Joniškis d. mun.;2008;8;327;167;160
Joniškis d. mun.;2008;9;344;175;169
Joniškis d. mun.;2008;10;370;171;199
Joniškis d. mun.;2008;11;345;189;156
Joniškis d. mun.;2008;12;366;178;188
Joniškis d. mun.;2008;13;426;203;223
Joniškis d. mun.;2008;14;495;259;236
Joniškis d. mun.;2008;15;508;247;261
Joniškis d. mun.;2008;16;510;254;256
Joniškis d. mun.;2008;17;495;250;245
Joniškis d. mun.;2008;18;491;243;248
Joniškis d. mun.;2008;19;510;262;248
Joniškis d. mun.;2008;20;455;213;242
Joniškis d. mun.;2008;21;446;233;213
Joniškis d. mun.;2008;22;502;243;259
Joniškis d. mun.;2008;23;451;231;220
Joniškis d. mun.;2008;24;432;218;214
Joniškis d. mun.;2008;25;341;168;173
Joniškis d. mun.;2008;26;238;138;100
Joniškis d. mun.;2008;27;227;130;97
Joniškis d. mun.;2008;28;259;144;115
Joniškis d. mun.;2008;29;276;149;127
Joniškis d. mun.;2008;30;286;131;155
Joniškis d. mun.;2008;31;302;149;153
Joniškis d. mun.;2008;32;324;176;148
Joniškis d. mun.;2008;33;343;179;164
Joniškis d. mun.;2008;34;322;159;163
Joniškis d. mun.;2008;35;343;162;181
Joniškis d. mun.;2008;36;382;159;223
Joniškis d. mun.;2008;37;382;194;188
Joniškis d. mun.;2008;38;343;173;170
Joniškis d. mun.;2008;39;418;214;204
Joniškis d. mun.;2008;40;416;205;211
Joniškis d. mun.;2008;41;415;212;203
Joniškis d. mun.;2008;42;400;189;211
Joniškis d. mun.;2008;43;414;187;227
Joniškis d. mun.;2008;44;420;200;220
Joniškis d. mun.;2008;45;432;222;210
Joniškis d. mun.;2008;46;424;206;218
Joniškis d. mun.;2008;47;471;235;236
Joniškis d. mun.;2008;48;439;218;221
Joniškis d. mun.;2008;49;444;239;205
Joniškis d. mun.;2008;50;366;180;186
Joniškis d. mun.;2008;51;363;185;178
Joniškis d. mun.;2008;52;353;162;191
Joniškis d. mun.;2008;53;350;171;179
Joniškis d. mun.;2008;54;319;154;165
Joniškis d. mun.;2008;55;324;147;177
Joniškis d. mun.;2008;56;322;165;157
Joniškis d. mun.;2008;57;351;153;198
Joniškis d. mun.;2008;58;292;144;148
Joniškis d. mun.;2008;59;278;130;148
Joniškis d. mun.;2008;60;291;125;166
Joniškis d. mun.;2008;61;294;113;181
Joniškis d. mun.;2008;62;286;119;167
Joniškis d. mun.;2008;63;266;124;142
Joniškis d. mun.;2008;64;310;125;185
Joniškis d. mun.;2008;65;320;136;184
Joniškis d. mun.;2008;66;367;138;229
Joniškis d. mun.;2008;67;272;108;164
Joniškis d. mun.;2008;68;283;120;163
Joniškis d. mun.;2008;69;273;108;165
Joniškis d. mun.;2008;70;264;105;159
Joniškis d. mun.;2008;71;330;117;213
Joniškis d. mun.;2008;72;286;105;181
Joniškis d. mun.;2008;73;252;80;172
Joniškis d. mun.;2008;74;250;72;178
Joniškis d. mun.;2008;75;227;78;149
Joniškis d. mun.;2008;76;224;79;145
Joniškis d. mun.;2008;77;229;73;156
Joniškis d. mun.;2008;78;187;73;114
Joniškis d. mun.;2008;79;191;53;138
Joniškis d. mun.;2008;80;168;58;110
Joniškis d. mun.;2008;81;169;44;125
Joniškis d. mun.;2008;82;129;38;91
Joniškis d. mun.;2008;83;119;23;96
Joniškis d. mun.;2008;84;109;27;82
Joniškis d. mun.;2008;85;427;90;337
Joniškis d. mun.;2009;-1;28085;13097;14988
Joniškis d. mun.;2009;0;251;127;124
Joniškis d. mun.;2009;1;227;107;120
Joniškis d. mun.;2009;2;230;127;103
Joniškis d. mun.;2009;3;245;126;119
Joniškis d. mun.;2009;4;285;138;147
Joniškis d. mun.;2009;5;271;125;146
Joniškis d. mun.;2009;6;293;162;131
Joniškis d. mun.;2009;7;273;150;123
Joniškis d. mun.;2009;8;319;161;158
Joniškis d. mun.;2009;9;326;167;159
Joniškis d. mun.;2009;10;336;170;166
Joniškis d. mun.;2009;11;369;173;196
Joniškis d. mun.;2009;12;345;188;157
Joniškis d. mun.;2009;13;365;177;188
Joniškis d. mun.;2009;14;425;202;223
Joniškis d. mun.;2009;15;494;259;235
Joniškis d. mun.;2009;16;505;246;259
Joniškis d. mun.;2009;17;505;252;253
Joniškis d. mun.;2009;18;491;250;241
Joniškis d. mun.;2009;19;486;239;247
Joniškis d. mun.;2009;20;494;254;240
Joniškis d. mun.;2009;21;441;207;234
Joniškis d. mun.;2009;22;437;231;206
Joniškis d. mun.;2009;23;485;239;246
Joniškis d. mun.;2009;24;433;220;213
Joniškis d. mun.;2009;25;418;215;203
Joniškis d. mun.;2009;26;329;164;165
Joniškis d. mun.;2009;27;231;131;100
Joniškis d. mun.;2009;28;212;124;88
Joniškis d. mun.;2009;29;240;133;107
Joniškis d. mun.;2009;30;262;140;122
Joniškis d. mun.;2009;31;271;122;149
Joniškis d. mun.;2009;32;300;147;153
Joniškis d. mun.;2009;33;315;172;143
Joniškis d. mun.;2009;34;331;173;158
Joniškis d. mun.;2009;35;325;160;165
Joniškis d. mun.;2009;36;339;160;179
Joniškis d. mun.;2009;37;373;155;218
Joniškis d. mun.;2009;38;372;186;186
Joniškis d. mun.;2009;39;336;167;169
Joniškis d. mun.;2009;40;411;214;197
Joniškis d. mun.;2009;41;413;202;211
Joniškis d. mun.;2009;42;408;209;199
Joniškis d. mun.;2009;43;392;184;208
Joniškis d. mun.;2009;44;415;186;229
Joniškis d. mun.;2009;45;418;201;217
Joniškis d. mun.;2009;46;427;220;207
Joniškis d. mun.;2009;47;417;200;217
Joniškis d. mun.;2009;48;466;231;235
Joniškis d. mun.;2009;49;435;217;218
Joniškis d. mun.;2009;50;439;238;201
Joniškis d. mun.;2009;51;359;175;184
Joniškis d. mun.;2009;52;354;180;174
Joniškis d. mun.;2009;53;352;160;192
Joniškis d. mun.;2009;54;348;171;177
Joniškis d. mun.;2009;55;315;151;164
Joniškis d. mun.;2009;56;317;142;175
Joniškis d. mun.;2009;57;316;160;156
Joniškis d. mun.;2009;58;346;151;195
Joniškis d. mun.;2009;59;280;137;143
Joniškis d. mun.;2009;60;273;126;147
Joniškis d. mun.;2009;61;279;117;162
Joniškis d. mun.;2009;62;287;111;176
Joniškis d. mun.;2009;63;276;109;167
Joniškis d. mun.;2009;64;260;118;142
Joniškis d. mun.;2009;65;305;122;183
Joniškis d. mun.;2009;66;314;132;182
Joniškis d. mun.;2009;67;361;136;225
Joniškis d. mun.;2009;68;265;103;162
Joniškis d. mun.;2009;69;278;117;161
Joniškis d. mun.;2009;70;262;106;156
Joniškis d. mun.;2009;71;256;98;158
Joniškis d. mun.;2009;72;326;114;212
Joniškis d. mun.;2009;73;271;98;173
Joniškis d. mun.;2009;74;244;77;167
Joniškis d. mun.;2009;75;243;68;175
Joniškis d. mun.;2009;76;216;72;144
Joniškis d. mun.;2009;77;206;73;133
Joniškis d. mun.;2009;78;216;66;150
Joniškis d. mun.;2009;79;174;64;110
Joniškis d. mun.;2009;80;175;48;127
Joniškis d. mun.;2009;81;156;53;103
Joniškis d. mun.;2009;82;151;39;112
Joniškis d. mun.;2009;83;121;34;87
Joniškis d. mun.;2009;84;105;19;86
Joniškis d. mun.;2009;85;452;102;350
Joniškis d. mun.;2010;-1;27427;12762;14665
Joniškis d. mun.;2010;0;241;127;114
Joniškis d. mun.;2010;1;244;124;120
Joniškis d. mun.;2010;2;223;103;120
Joniškis d. mun.;2010;3;217;119;98
Joniškis d. mun.;2010;4;240;124;116
Joniškis d. mun.;2010;5;282;137;145
Joniškis d. mun.;2010;6;260;121;139
Joniškis d. mun.;2010;7;292;161;131
Joniškis d. mun.;2010;8;263;144;119
Joniškis d. mun.;2010;9;316;159;157
Joniškis d. mun.;2010;10;322;166;156
Joniškis d. mun.;2010;11;334;170;164
Joniškis d. mun.;2010;12;368;172;196
Joniškis d. mun.;2010;13;340;186;154
Joniškis d. mun.;2010;14;365;180;185
Joniškis d. mun.;2010;15;417;198;219
Joniškis d. mun.;2010;16;486;254;232
Joniškis d. mun.;2010;17;507;243;264
Joniškis d. mun.;2010;18;496;249;247
Joniškis d. mun.;2010;19;480;247;233
Joniškis d. mun.;2010;20;470;230;240
Joniškis d. mun.;2010;21;477;247;230
Joniškis d. mun.;2010;22;421;200;221
Joniškis d. mun.;2010;23;414;219;195
Joniškis d. mun.;2010;24;454;225;229
Joniškis d. mun.;2010;25;409;210;199
Joniškis d. mun.;2010;26;390;199;191
Joniškis d. mun.;2010;27;307;154;153
Joniškis d. mun.;2010;28;214;123;91
Joniškis d. mun.;2010;29;191;114;77
Joniškis d. mun.;2010;30;230;125;105
Joniškis d. mun.;2010;31;242;127;115
Joniškis d. mun.;2010;32;264;120;144
Joniškis d. mun.;2010;33;290;145;145
Joniškis d. mun.;2010;34;314;169;145
Joniškis d. mun.;2010;35;315;165;150
Joniškis d. mun.;2010;36;318;155;163
Joniškis d. mun.;2010;37;328;154;174
Joniškis d. mun.;2010;38;366;149;217
Joniškis d. mun.;2010;39;374;188;186
Joniškis d. mun.;2010;40;329;161;168
Joniškis d. mun.;2010;41;405;208;197
Joniškis d. mun.;2010;42;408;200;208
Joniškis d. mun.;2010;43;403;207;196
Joniškis d. mun.;2010;44;388;180;208
Joniškis d. mun.;2010;45;402;180;222
Joniškis d. mun.;2010;46;406;194;212
Joniškis d. mun.;2010;47;420;214;206
Joniškis d. mun.;2010;48;403;193;210
Joniškis d. mun.;2010;49;459;225;234
Joniškis d. mun.;2010;50;431;213;218
Joniškis d. mun.;2010;51;428;230;198
Joniškis d. mun.;2010;52;354;169;185
Joniškis d. mun.;2010;53;349;178;171
Joniškis d. mun.;2010;54;345;155;190
Joniškis d. mun.;2010;55;342;167;175
Joniškis d. mun.;2010;56;307;144;163
Joniškis d. mun.;2010;57;308;136;172
Joniškis d. mun.;2010;58;306;153;153
Joniškis d. mun.;2010;59;343;150;193
Joniškis d. mun.;2010;60;275;134;141
Joniškis d. mun.;2010;61;264;119;145
Joniškis d. mun.;2010;62;271;111;160
Joniškis d. mun.;2010;63;281;106;175
Joniškis d. mun.;2010;64;270;106;164
Joniškis d. mun.;2010;65;249;113;136
Joniškis d. mun.;2010;66;302;122;180
Joniškis d. mun.;2010;67;302;124;178
Joniškis d. mun.;2010;68;352;133;219
Joniškis d. mun.;2010;69;262;102;160
Joniškis d. mun.;2010;70;272;112;160
Joniškis d. mun.;2010;71;257;104;153
Joniškis d. mun.;2010;72;245;88;157
Joniškis d. mun.;2010;73;317;110;207
Joniškis d. mun.;2010;74;262;95;167
Joniškis d. mun.;2010;75;229;70;159
Joniškis d. mun.;2010;76;234;66;168
Joniškis d. mun.;2010;77;202;62;140
Joniškis d. mun.;2010;78;192;64;128
Joniškis d. mun.;2010;79;199;59;140
Joniškis d. mun.;2010;80;159;54;105
Joniškis d. mun.;2010;81;164;41;123
Joniškis d. mun.;2010;82;144;48;96
Joniškis d. mun.;2010;83;133;35;98
Joniškis d. mun.;2010;84;106;29;77
Joniškis d. mun.;2010;85;467;96;371
Joniškis d. mun.;2011;-1;26322;12241;14081
Joniškis d. mun.;2011;0;172;90;82
Joniškis d. mun.;2011;1;209;113;96
Joniškis d. mun.;2011;2;227;117;110
Joniškis d. mun.;2011;3;187;89;98
Joniškis d. mun.;2011;4;212;112;100
Joniškis d. mun.;2011;5;213;110;103
Joniškis d. mun.;2011;6;284;138;146
Joniškis d. mun.;2011;7;261;128;133
Joniškis d. mun.;2011;8;278;154;124
Joniškis d. mun.;2011;9;277;145;132
Joniškis d. mun.;2011;10;294;150;144
Joniškis d. mun.;2011;11;320;161;159
Joniškis d. mun.;2011;12;336;177;159
Joniškis d. mun.;2011;13;355;167;188
Joniškis d. mun.;2011;14;346;186;160
Joniškis d. mun.;2011;15;373;177;196
Joniškis d. mun.;2011;16;417;199;218
Joniškis d. mun.;2011;17;482;251;231
Joniškis d. mun.;2011;18;506;254;252
Joniškis d. mun.;2011;19;412;214;198
Joniškis d. mun.;2011;20;401;210;191
Joniškis d. mun.;2011;21;349;182;167
Joniškis d. mun.;2011;22;348;196;152
Joniškis d. mun.;2011;23;301;151;150
Joniškis d. mun.;2011;24;278;162;116
Joniškis d. mun.;2011;25;309;160;149
Joniškis d. mun.;2011;26;269;143;126
Joniškis d. mun.;2011;27;246;123;123
Joniškis d. mun.;2011;28;238;111;127
Joniškis d. mun.;2011;29;218;118;100
Joniškis d. mun.;2011;30;219;129;90
Joniškis d. mun.;2011;31;246;130;116
Joniškis d. mun.;2011;32;256;132;124
Joniškis d. mun.;2011;33;280;124;156
Joniškis d. mun.;2011;34;294;145;149
Joniškis d. mun.;2011;35;314;158;156
Joniškis d. mun.;2011;36;315;159;156
Joniškis d. mun.;2011;37;329;156;173
Joniškis d. mun.;2011;38;359;169;190
Joniškis d. mun.;2011;39;386;158;228
Joniškis d. mun.;2011;40;396;194;202
Joniškis d. mun.;2011;41;338;168;170
Joniškis d. mun.;2011;42;432;223;209
Joniškis d. mun.;2011;43;418;211;207
Joniškis d. mun.;2011;44;416;217;199
Joniškis d. mun.;2011;45;413;191;222
Joniškis d. mun.;2011;46;417;190;227
Joniškis d. mun.;2011;47;418;200;218
Joniškis d. mun.;2011;48;433;221;212
Joniškis d. mun.;2011;49;401;185;216
Joniškis d. mun.;2011;50;458;224;234
Joniškis d. mun.;2011;51;431;212;219
Joniškis d. mun.;2011;52;415;227;188
Joniškis d. mun.;2011;53;353;171;182
Joniškis d. mun.;2011;54;356;184;172
Joniškis d. mun.;2011;55;348;154;194
Joniškis d. mun.;2011;56;330;152;178
Joniškis d. mun.;2011;57;316;154;162
Joniškis d. mun.;2011;58;321;137;184
Joniškis d. mun.;2011;59;314;155;159
Joniškis d. mun.;2011;60;348;153;195
Joniškis d. mun.;2011;61;284;142;142
Joniškis d. mun.;2011;62;268;118;150
Joniškis d. mun.;2011;63;277;112;165
Joniškis d. mun.;2011;64;273;104;169
Joniškis d. mun.;2011;65;273;108;165
Joniškis d. mun.;2011;66;245;105;140
Joniškis d. mun.;2011;67;313;122;191
Joniškis d. mun.;2011;68;304;123;181
Joniškis d. mun.;2011;69;347;126;221
Joniškis d. mun.;2011;70;260;102;158
Joniškis d. mun.;2011;71;264;101;163
Joniškis d. mun.;2011;72;258;103;155
Joniškis d. mun.;2011;73;240;82;158
Joniškis d. mun.;2011;74;290;99;191
Joniškis d. mun.;2011;75;242;83;159
Joniškis d. mun.;2011;76;217;62;155
Joniškis d. mun.;2011;77;219;65;154
Joniškis d. mun.;2011;78;180;52;128
Joniškis d. mun.;2011;79;183;57;126
Joniškis d. mun.;2011;80;186;53;133
Joniškis d. mun.;2011;81;147;47;100
Joniškis d. mun.;2011;82;143;30;113
Joniškis d. mun.;2011;83;134;43;91
Joniškis d. mun.;2011;84;114;31;83
Joniškis d. mun.;2011;85;473;100;373
Joniškis d. mun.;2012;-1;25584;11874;13710
Joniškis d. mun.;2012;0;232;123;109
Joniškis d. mun.;2012;1;175;93;82
Joniškis d. mun.;2012;2;198;105;93
Joniškis d. mun.;2012;3;217;114;103
Joniškis d. mun.;2012;4;183;87;96
Joniškis d. mun.;2012;5;208;108;100
Joniškis d. mun.;2012;6;205;107;98
Joniškis d. mun.;2012;7;276;136;140
Joniškis d. mun.;2012;8;258;126;132
Joniškis d. mun.;2012;9;274;151;123
Joniškis d. mun.;2012;10;276;145;131
Joniškis d. mun.;2012;11;292;149;143
Joniškis d. mun.;2012;12;315;161;154
Joniškis d. mun.;2012;13;333;173;160
Joniškis d. mun.;2012;14;345;164;181
Joniškis d. mun.;2012;15;348;185;163
Joniškis d. mun.;2012;16;374;178;196
Joniškis d. mun.;2012;17;413;195;218
Joniškis d. mun.;2012;18;476;247;229
Joniškis d. mun.;2012;19;480;246;234
Joniškis d. mun.;2012;20;390;203;187
Joniškis d. mun.;2012;21;383;196;187
Joniškis d. mun.;2012;22;318;171;147
Joniškis d. mun.;2012;23;317;184;133
Joniškis d. mun.;2012;24;269;137;132
Joniškis d. mun.;2012;25;244;143;101
Joniškis d. mun.;2012;26;264;143;121
Joniškis d. mun.;2012;27;229;116;113
Joniškis d. mun.;2012;28;212;103;109
Joniškis d. mun.;2012;29;215;92;123
Joniškis d. mun.;2012;30;195;100;95
Joniškis d. mun.;2012;31;208;124;84
Joniškis d. mun.;2012;32;235;125;110
Joniškis d. mun.;2012;33;247;128;119
Joniškis d. mun.;2012;34;278;124;154
Joniškis d. mun.;2012;35;288;141;147
Joniškis d. mun.;2012;36;298;149;149
Joniškis d. mun.;2012;37;305;151;154
Joniškis d. mun.;2012;38;322;152;170
Joniškis d. mun.;2012;39;355;166;189
Joniškis d. mun.;2012;40;380;159;221
Joniškis d. mun.;2012;41;393;194;199
Joniškis d. mun.;2012;42;335;165;170
Joniškis d. mun.;2012;43;427;219;208
Joniškis d. mun.;2012;44;417;209;208
Joniškis d. mun.;2012;45;407;212;195
Joniškis d. mun.;2012;46;409;190;219
Joniškis d. mun.;2012;47;412;187;225
Joniškis d. mun.;2012;48;411;193;218
Joniškis d. mun.;2012;49;426;219;207
Joniškis d. mun.;2012;50;397;185;212
Joniškis d. mun.;2012;51;453;219;234
Joniškis d. mun.;2012;52;424;208;216
Joniškis d. mun.;2012;53;407;224;183
Joniškis d. mun.;2012;54;343;167;176
Joniškis d. mun.;2012;55;352;183;169
Joniškis d. mun.;2012;56;338;148;190
Joniškis d. mun.;2012;57;325;147;178
Joniškis d. mun.;2012;58;311;152;159
Joniškis d. mun.;2012;59;316;133;183
Joniškis d. mun.;2012;60;307;150;157
Joniškis d. mun.;2012;61;343;150;193
Joniškis d. mun.;2012;62;281;139;142
Joniškis d. mun.;2012;63;258;111;147
Joniškis d. mun.;2012;64;276;110;166
Joniškis d. mun.;2012;65;270;101;169
Joniškis d. mun.;2012;66;270;105;165
Joniškis d. mun.;2012;67;240;102;138
Joniškis d. mun.;2012;68;301;116;185
Joniškis d. mun.;2012;69;297;120;177
Joniškis d. mun.;2012;70;332;115;217
Joniškis d. mun.;2012;71;251;96;155
Joniškis d. mun.;2012;72;250;98;152
Joniškis d. mun.;2012;73;249;97;152
Joniškis d. mun.;2012;74;232;76;156
Joniškis d. mun.;2012;75;275;89;186
Joniškis d. mun.;2012;76;230;76;154
Joniškis d. mun.;2012;77;206;58;148
Joniškis d. mun.;2012;78;207;59;148
Joniškis d. mun.;2012;79;167;45;122
Joniškis d. mun.;2012;80;166;52;114
Joniškis d. mun.;2012;81;171;47;124
Joniškis d. mun.;2012;82;136;46;90
Joniškis d. mun.;2012;83;129;25;104
Joniškis d. mun.;2012;84;124;36;88
Joniškis d. mun.;2012;85;483;101;382
Joniškis d. mun.;2013;-1;24890;11592;13298
Joniškis d. mun.;2013;0;219;112;107
Joniškis d. mun.;2013;1;229;122;107
Joniškis d. mun.;2013;2;165;89;76
Joniškis d. mun.;2013;3;195;100;95
Joniškis d. mun.;2013;4;202;110;92
Joniškis d. mun.;2013;5;172;80;92
Joniškis d. mun.;2013;6;204;105;99
Joniškis d. mun.;2013;7;195;102;93
Joniškis d. mun.;2013;8;272;137;135
Joniškis d. mun.;2013;9;256;125;131
Joniškis d. mun.;2013;10;267;150;117
Joniškis d. mun.;2013;11;267;142;125
Joniškis d. mun.;2013;12;290;149;141
Joniškis d. mun.;2013;13;308;161;147
Joniškis d. mun.;2013;14;331;171;160
Joniškis d. mun.;2013;15;337;161;176
Joniškis d. mun.;2013;16;342;184;158
Joniškis d. mun.;2013;17;374;179;195
Joniškis d. mun.;2013;18;411;196;215
Joniškis d. mun.;2013;19;457;240;217
Joniškis d. mun.;2013;20;467;238;229
Joniškis d. mun.;2013;21;374;199;175
Joniškis d. mun.;2013;22;362;190;172
Joniškis d. mun.;2013;23;294;166;128
Joniškis d. mun.;2013;24;287;171;116
Joniškis d. mun.;2013;25;251;136;115
Joniškis d. mun.;2013;26;205;129;76
Joniškis d. mun.;2013;27;228;126;102
Joniškis d. mun.;2013;28;213;108;105
Joniškis d. mun.;2013;29;184;91;93
Joniškis d. mun.;2013;30;198;83;115
Joniškis d. mun.;2013;31;184;94;90
Joniškis d. mun.;2013;32;207;121;86
Joniškis d. mun.;2013;33;228;120;108
Joniškis d. mun.;2013;34;229;114;115
Joniškis d. mun.;2013;35;274;120;154
Joniškis d. mun.;2013;36;280;140;140
Joniškis d. mun.;2013;37;290;147;143
Joniškis d. mun.;2013;38;297;148;149
Joniškis d. mun.;2013;39;319;153;166
Joniškis d. mun.;2013;40;344;156;188
Joniškis d. mun.;2013;41;380;161;219
Joniškis d. mun.;2013;42;391;191;200
Joniškis d. mun.;2013;43;336;168;168
Joniškis d. mun.;2013;44;419;216;203
Joniškis d. mun.;2013;45;409;205;204
Joniškis d. mun.;2013;46;398;208;190
Joniškis d. mun.;2013;47;407;187;220
Joniškis d. mun.;2013;48;404;181;223
Joniškis d. mun.;2013;49;404;191;213
Joniškis d. mun.;2013;50;420;217;203
Joniškis d. mun.;2013;51;388;176;212
Joniškis d. mun.;2013;52;444;209;235
Joniškis d. mun.;2013;53;420;205;215
Joniškis d. mun.;2013;54;404;222;182
Joniškis d. mun.;2013;55;340;168;172
Joniškis d. mun.;2013;56;341;179;162
Joniškis d. mun.;2013;57;330;145;185
Joniškis d. mun.;2013;58;317;139;178
Joniškis d. mun.;2013;59;309;152;157
Joniškis d. mun.;2013;60;313;130;183
Joniškis d. mun.;2013;61;300;146;154
Joniškis d. mun.;2013;62;338;147;191
Joniškis d. mun.;2013;63;273;134;139
Joniškis d. mun.;2013;64;255;107;148
Joniškis d. mun.;2013;65;273;106;167
Joniškis d. mun.;2013;66;261;96;165
Joniškis d. mun.;2013;67;264;101;163
Joniškis d. mun.;2013;68;233;97;136
Joniškis d. mun.;2013;69;295;111;184
Joniškis d. mun.;2013;70;282;108;174
Joniškis d. mun.;2013;71;323;110;213
Joniškis d. mun.;2013;72;244;91;153
Joniškis d. mun.;2013;73;237;94;143
Joniškis d. mun.;2013;74;241;90;151
Joniškis d. mun.;2013;75;220;71;149
Joniškis d. mun.;2013;76;266;89;177
Joniškis d. mun.;2013;77;222;72;150
Joniškis d. mun.;2013;78;193;52;141
Joniškis d. mun.;2013;79;191;53;138
Joniškis d. mun.;2013;80;155;42;113
Joniškis d. mun.;2013;81;158;48;110
Joniškis d. mun.;2013;82;160;45;115
Joniškis d. mun.;2013;83;124;39;85
Joniškis d. mun.;2013;84;112;19;93
Joniškis d. mun.;2013;85;488;109;379
Joniškis d. mun.;2014;-1;24306;11326;12980
Joniškis d. mun.;2014;0;235;129;106
Joniškis d. mun.;2014;1;209;107;102
Joniškis d. mun.;2014;2;215;116;99
Joniškis d. mun.;2014;3;155;80;75
Joniškis d. mun.;2014;4;197;102;95
Joniškis d. mun.;2014;5;196;110;86
Joniškis d. mun.;2014;6;172;79;93
Joniškis d. mun.;2014;7;202;103;99
Joniškis d. mun.;2014;8;193;100;93
Joniškis d. mun.;2014;9;268;134;134
Joniškis d. mun.;2014;10;253;122;131
Joniškis d. mun.;2014;11;263;147;116
Joniškis d. mun.;2014;12;258;135;123
Joniškis d. mun.;2014;13;288;150;138
Joniškis d. mun.;2014;14;308;160;148
Joniškis d. mun.;2014;15;328;170;158
Joniškis d. mun.;2014;16;330;158;172
Joniškis d. mun.;2014;17;341;185;156
Joniškis d. mun.;2014;18;366;174;192
Joniškis d. mun.;2014;19;397;189;208
Joniškis d. mun.;2014;20;437;232;205
Joniškis d. mun.;2014;21;447;225;222
Joniškis d. mun.;2014;22;355;190;165
Joniškis d. mun.;2014;23;332;178;154
Joniškis d. mun.;2014;24;274;159;115
Joniškis d. mun.;2014;25;269;165;104
Joniškis d. mun.;2014;26;233;132;101
Joniškis d. mun.;2014;27;197;119;78
Joniškis d. mun.;2014;28;196;108;88
Joniškis d. mun.;2014;29;187;99;88
Joniškis d. mun.;2014;30;176;90;86
Joniškis d. mun.;2014;31;184;76;108
Joniškis d. mun.;2014;32;173;85;88
Joniškis d. mun.;2014;33;203;117;86
Joniškis d. mun.;2014;34;220;117;103
Joniškis d. mun.;2014;35;219;109;110
Joniškis d. mun.;2014;36;273;123;150
Joniškis d. mun.;2014;37;278;140;138
Joniškis d. mun.;2014;38;289;146;143
Joniškis d. mun.;2014;39;296;145;151
Joniškis d. mun.;2014;40;312;150;162
Joniškis d. mun.;2014;41;335;149;186
Joniškis d. mun.;2014;42;377;158;219
Joniškis d. mun.;2014;43;383;182;201
Joniškis d. mun.;2014;44;329;164;165
Joniškis d. mun.;2014;45;414;213;201
Joniškis d. mun.;2014;46;403;199;204
Joniškis d. mun.;2014;47;397;205;192
Joniškis d. mun.;2014;48;406;188;218
Joniškis d. mun.;2014;49;410;185;225
Joniškis d. mun.;2014;50;401;191;210
Joniškis d. mun.;2014;51;412;211;201
Joniškis d. mun.;2014;52;376;168;208
Joniškis d. mun.;2014;53;441;208;233
Joniškis d. mun.;2014;54;410;199;211
Joniškis d. mun.;2014;55;400;218;182
Joniškis d. mun.;2014;56;336;166;170
Joniškis d. mun.;2014;57;331;170;161
Joniškis d. mun.;2014;58;326;141;185
Joniškis d. mun.;2014;59;309;134;175
Joniškis d. mun.;2014;60;305;150;155
Joniškis d. mun.;2014;61;308;125;183
Joniškis d. mun.;2014;62;299;147;152
Joniškis d. mun.;2014;63;334;144;190
Joniškis d. mun.;2014;64;266;128;138
Joniškis d. mun.;2014;65;245;101;144
Joniškis d. mun.;2014;66;266;102;164
Joniškis d. mun.;2014;67;251;91;160
Joniškis d. mun.;2014;68;258;98;160
Joniškis d. mun.;2014;69;227;95;132
Joniškis d. mun.;2014;70;285;107;178
Joniškis d. mun.;2014;71;268;101;167
Joniškis d. mun.;2014;72;315;105;210
Joniškis d. mun.;2014;73;231;83;148
Joniškis d. mun.;2014;74;232;90;142
Joniškis d. mun.;2014;75;227;83;144
Joniškis d. mun.;2014;76;208;64;144
Joniškis d. mun.;2014;77;255;82;173
Joniškis d. mun.;2014;78;199;64;135
Joniškis d. mun.;2014;79;187;51;136
Joniškis d. mun.;2014;80;177;51;126
Joniškis d. mun.;2014;81;145;40;105
Joniškis d. mun.;2014;82;149;45;104
Joniškis d. mun.;2014;83;144;39;105
Joniškis d. mun.;2014;84;110;32;78
Joniškis d. mun.;2014;85;495;104;391
Joniškis d. mun.;2015;-1;23807;11131;12676
Joniškis d. mun.;2015;0;201;107;94
Joniškis d. mun.;2015;1;226;123;103
Joniškis d. mun.;2015;2;199;102;97
Joniškis d. mun.;2015;3;220;120;100
Joniškis d. mun.;2015;4;152;80;72
Joniškis d. mun.;2015;5;196;102;94
Joniškis d. mun.;2015;6;195;108;87
Joniškis d. mun.;2015;7;173;80;93
Joniškis d. mun.;2015;8;203;101;102
Joniškis d. mun.;2015;9;193;102;91
Joniškis d. mun.;2015;10;263;133;130
Joniškis d. mun.;2015;11;247;120;127
Joniškis d. mun.;2015;12;260;147;113
Joniškis d. mun.;2015;13;261;136;125
Joniškis d. mun.;2015;14;284;149;135
Joniškis d. mun.;2015;15;299;155;144
Joniškis d. mun.;2015;16;328;171;157
Joniškis d. mun.;2015;17;325;155;170
Joniškis d. mun.;2015;18;338;184;154
Joniškis d. mun.;2015;19;348;168;180
Joniškis d. mun.;2015;20;384;187;197
Joniškis d. mun.;2015;21;412;220;192
Joniškis d. mun.;2015;22;418;209;209
Joniškis d. mun.;2015;23;332;180;152
Joniškis d. mun.;2015;24;317;175;142
Joniškis d. mun.;2015;25;257;153;104
Joniškis d. mun.;2015;26;254;164;90
Joniškis d. mun.;2015;27;205;122;83
Joniškis d. mun.;2015;28;193;118;75
Joniškis d. mun.;2015;29;181;105;76
Joniškis d. mun.;2015;30;176;97;79
Joniškis d. mun.;2015;31;166;84;82
Joniškis d. mun.;2015;32;177;71;106
Joniškis d. mun.;2015;33;171;83;88
Joniškis d. mun.;2015;34;196;112;84
Joniškis d. mun.;2015;35;217;118;99
Joniškis d. mun.;2015;36;204;99;105
Joniškis d. mun.;2015;37;266;116;150
Joniškis d. mun.;2015;38;282;142;140
Joniškis d. mun.;2015;39;282;143;139
Joniškis d. mun.;2015;40;297;148;149
Joniškis d. mun.;2015;41;310;151;159
Joniškis d. mun.;2015;42;341;155;186
Joniškis d. mun.;2015;43;374;156;218
Joniškis d. mun.;2015;44;377;178;199
Joniškis d. mun.;2015;45;324;160;164
Joniškis d. mun.;2015;46;407;209;198
Joniškis d. mun.;2015;47;400;198;202
Joniškis d. mun.;2015;48;392;203;189
Joniškis d. mun.;2015;49;401;183;218
Joniškis d. mun.;2015;50;409;186;223
Joniškis d. mun.;2015;51;395;189;206
Joniškis d. mun.;2015;52;405;206;199
Joniškis d. mun.;2015;53;373;168;205
Joniškis d. mun.;2015;54;439;208;231
Joniškis d. mun.;2015;55;397;191;206
Joniškis d. mun.;2015;56;391;213;178
Joniškis d. mun.;2015;57;329;161;168
Joniškis d. mun.;2015;58;324;164;160
Joniškis d. mun.;2015;59;320;137;183
Joniškis d. mun.;2015;60;306;132;174
Joniškis d. mun.;2015;61;304;148;156
Joniškis d. mun.;2015;62;304;122;182
Joniškis d. mun.;2015;63;294;143;151
Joniškis d. mun.;2015;64;327;141;186
Joniškis d. mun.;2015;65;263;127;136
Joniškis d. mun.;2015;66;239;98;141
Joniškis d. mun.;2015;67;257;93;164
Joniškis d. mun.;2015;68;246;89;157
Joniškis d. mun.;2015;69;249;92;157
Joniškis d. mun.;2015;70;224;94;130
Joniškis d. mun.;2015;71;278;101;177
Joniškis d. mun.;2015;72;255;91;164
Joniškis d. mun.;2015;73;307;102;205
Joniškis d. mun.;2015;74;223;77;146
Joniškis d. mun.;2015;75;223;88;135
Joniškis d. mun.;2015;76;221;79;142
Joniškis d. mun.;2015;77;197;60;137
Joniškis d. mun.;2015;78;240;76;164
Joniškis d. mun.;2015;79;190;61;129
Joniškis d. mun.;2015;80;174;44;130
Joniškis d. mun.;2015;81;161;43;118
Joniškis d. mun.;2015;82;135;36;99
Joniškis d. mun.;2015;83;136;43;93
Joniškis d. mun.;2015;84;129;32;97
Joniškis d. mun.;2015;85;519;114;405
Joniškis d. mun.;2016;-1;23147;10816;12331
Joniškis d. mun.;2016;0;195;93;102
Joniškis d. mun.;2016;1;195;104;91
Joniškis d. mun.;2016;2;227;123;104
Joniškis d. mun.;2016;3;197;104;93
Joniškis d. mun.;2016;4;213;113;100
Joniškis d. mun.;2016;5;148;78;70
Joniškis d. mun.;2016;6;183;98;85
Joniškis d. mun.;2016;7;197;109;88
Joniškis d. mun.;2016;8;164;77;87
Joniškis d. mun.;2016;9;197;98;99
Joniškis d. mun.;2016;10;194;101;93
Joniškis d. mun.;2016;11;259;126;133
Joniškis d. mun.;2016;12;246;120;126
Joniškis d. mun.;2016;13;258;144;114
Joniškis d. mun.;2016;14;255;132;123
Joniškis d. mun.;2016;15;281;148;133
Joniškis d. mun.;2016;16;290;149;141
Joniškis d. mun.;2016;17;326;171;155
Joniškis d. mun.;2016;18;315;148;167
Joniškis d. mun.;2016;19;328;180;148
Joniškis d. mun.;2016;20;331;161;170
Joniškis d. mun.;2016;21;368;175;193
Joniškis d. mun.;2016;22;384;207;177
Joniškis d. mun.;2016;23;401;206;195
Joniškis d. mun.;2016;24;309;163;146
Joniškis d. mun.;2016;25;288;158;130
Joniškis d. mun.;2016;26;232;136;96
Joniškis d. mun.;2016;27;228;152;76
Joniškis d. mun.;2016;28;167;100;67
Joniškis d. mun.;2016;29;176;112;64
Joniškis d. mun.;2016;30;172;99;73
Joniškis d. mun.;2016;31;150;87;63
Joniškis d. mun.;2016;32;160;81;79
Joniškis d. mun.;2016;33;169;71;98
Joniškis d. mun.;2016;34;157;75;82
Joniškis d. mun.;2016;35;185;106;79
Joniškis d. mun.;2016;36;202;110;92
Joniškis d. mun.;2016;37;200;94;106
Joniškis d. mun.;2016;38;262;115;147
Joniškis d. mun.;2016;39;276;141;135
Joniškis d. mun.;2016;40;276;140;136
Joniškis d. mun.;2016;41;294;145;149
Joniškis d. mun.;2016;42;312;152;160
Joniškis d. mun.;2016;43;334;152;182
Joniškis d. mun.;2016;44;366;150;216
Joniškis d. mun.;2016;45;376;179;197
Joniškis d. mun.;2016;46;323;160;163
Joniškis d. mun.;2016;47;395;202;193
Joniškis d. mun.;2016;48;388;195;193
Joniškis d. mun.;2016;49;393;204;189
Joniškis d. mun.;2016;50;394;181;213
Joniškis d. mun.;2016;51;403;185;218
Joniškis d. mun.;2016;52;389;185;204
Joniškis d. mun.;2016;53;402;203;199
Joniškis d. mun.;2016;54;363;162;201
Joniškis d. mun.;2016;55;440;209;231
Joniškis d. mun.;2016;56;391;185;206
Joniškis d. mun.;2016;57;387;211;176
Joniškis d. mun.;2016;58;324;156;168
Joniškis d. mun.;2016;59;326;166;160
Joniškis d. mun.;2016;60;313;133;180
Joniškis d. mun.;2016;61;300;129;171
Joniškis d. mun.;2016;62;298;143;155
Joniškis d. mun.;2016;63;299;119;180
Joniškis d. mun.;2016;64;285;140;145
Joniškis d. mun.;2016;65;322;140;182
Joniškis d. mun.;2016;66;261;125;136
Joniškis d. mun.;2016;67;232;96;136
Joniškis d. mun.;2016;68;253;89;164
Joniškis d. mun.;2016;69;237;84;153
Joniškis d. mun.;2016;70;243;87;156
Joniškis d. mun.;2016;71;217;90;127
Joniškis d. mun.;2016;72;267;95;172
Joniškis d. mun.;2016;73;231;78;153
Joniškis d. mun.;2016;74;293;93;200
Joniškis d. mun.;2016;75;214;71;143
Joniškis d. mun.;2016;76;211;85;126
Joniškis d. mun.;2016;77;213;73;140
Joniškis d. mun.;2016;78;189;58;131
Joniškis d. mun.;2016;79;229;71;158
Joniškis d. mun.;2016;80;177;56;121
Joniškis d. mun.;2016;81;163;41;122
Joniškis d. mun.;2016;82;152;40;112
Joniškis d. mun.;2016;83;122;32;90
Joniškis d. mun.;2016;84;115;36;79
Joniškis d. mun.;2016;85;550;125;425
Joniškis d. mun.;2017;-1;22449;10500;11949
Joniškis d. mun.;2017;0;203;110;93
Joniškis d. mun.;2017;1;190;91;99
Joniškis d. mun.;2017;2;185;99;86
Joniškis d. mun.;2017;3;209;109;100
Joniškis d. mun.;2017;4;199;105;94
Joniškis d. mun.;2017;5;205;111;94
Joniškis d. mun.;2017;6;146;77;69
Joniškis d. mun.;2017;7;178;97;81
Joniškis d. mun.;2017;8;195;109;86
Joniškis d. mun.;2017;9;164;78;86
Joniškis d. mun.;2017;10;192;96;96
Joniškis d. mun.;2017;11;189;98;91
Joniškis d. mun.;2017;12;255;126;129
Joniškis d. mun.;2017;13;236;116;120
Joniškis d. mun.;2017;14;256;142;114
Joniškis d. mun.;2017;15;251;131;120
Joniškis d. mun.;2017;16;275;147;128
Joniškis d. mun.;2017;17;288;145;143
Joniškis d. mun.;2017;18;323;171;152
Joniškis d. mun.;2017;19;304;145;159
Joniškis d. mun.;2017;20;325;178;147
Joniškis d. mun.;2017;21;309;149;160
Joniškis d. mun.;2017;22;343;169;174
Joniškis d. mun.;2017;23;359;191;168
Joniškis d. mun.;2017;24;373;198;175
Joniškis d. mun.;2017;25;278;146;132
Joniškis d. mun.;2017;26;255;148;107
Joniškis d. mun.;2017;27;219;132;87
Joniškis d. mun.;2017;28;197;137;60
Joniškis d. mun.;2017;29;154;95;59
Joniškis d. mun.;2017;30;146;97;49
Joniškis d. mun.;2017;31;155;85;70
Joniškis d. mun.;2017;32;136;80;56
Joniškis d. mun.;2017;33;138;71;67
Joniškis d. mun.;2017;34;156;64;92
Joniškis d. mun.;2017;35;146;72;74
Joniškis d. mun.;2017;36;174;99;75
Joniškis d. mun.;2017;37;199;112;87
Joniškis d. mun.;2017;38;192;94;98
Joniškis d. mun.;2017;39;259;115;144
Joniškis d. mun.;2017;40;263;129;134
Joniškis d. mun.;2017;41;269;135;134
Joniškis d. mun.;2017;42;293;144;149
Joniškis d. mun.;2017;43;306;152;154
Joniškis d. mun.;2017;44;328;149;179
Joniškis d. mun.;2017;45;367;154;213
Joniškis d. mun.;2017;46;367;176;191
Joniškis d. mun.;2017;47;317;153;164
Joniškis d. mun.;2017;48;390;201;189
Joniškis d. mun.;2017;49;378;186;192
Joniškis d. mun.;2017;50;384;196;188
Joniškis d. mun.;2017;51;392;179;213
Joniškis d. mun.;2017;52;399;184;215
Joniškis d. mun.;2017;53;388;183;205
Joniškis d. mun.;2017;54;393;197;196
Joniškis d. mun.;2017;55;360;158;202
Joniškis d. mun.;2017;56;428;199;229
Joniškis d. mun.;2017;57;380;179;201
Joniškis d. mun.;2017;58;383;208;175
Joniškis d. mun.;2017;59;315;151;164
Joniškis d. mun.;2017;60;322;162;160
Joniškis d. mun.;2017;61;305;128;177
Joniškis d. mun.;2017;62;298;127;171
Joniškis d. mun.;2017;63;295;139;156
Joniškis d. mun.;2017;64;295;116;179
Joniškis d. mun.;2017;65;276;137;139
Joniškis d. mun.;2017;66;319;136;183
Joniškis d. mun.;2017;67;258;123;135
Joniškis d. mun.;2017;68;229;93;136
Joniškis d. mun.;2017;69;242;80;162
Joniškis d. mun.;2017;70;230;79;151
Joniškis d. mun.;2017;71;243;86;157
Joniškis d. mun.;2017;72;209;85;124
Joniškis d. mun.;2017;73;258;92;166
Joniškis d. mun.;2017;74;220;71;149
Joniškis d. mun.;2017;75;282;88;194
Joniškis d. mun.;2017;76;199;65;134
Joniškis d. mun.;2017;77;203;81;122
Joniškis d. mun.;2017;78;201;66;135
Joniškis d. mun.;2017;79;177;52;125
Joniškis d. mun.;2017;80;216;65;151
Joniškis d. mun.;2017;81;170;50;120
Joniškis d. mun.;2017;82;144;36;108
Joniškis d. mun.;2017;83;139;35;104
Joniškis d. mun.;2017;84;111;27;84
Joniškis d. mun.;2017;85;552;133;419
Joniškis d. mun.;2018;-1;21583;10070;11513
Joniškis d. mun.;2018;0;170;78;92
Joniškis d. mun.;2018;1;199;106;93
Joniškis d. mun.;2018;2;178;83;95
Joniškis d. mun.;2018;3;179;95;84
Joniškis d. mun.;2018;4;206;109;97
Joniškis d. mun.;2018;5;194;102;92
Joniškis d. mun.;2018;6;203;109;94
Joniškis d. mun.;2018;7;146;76;70
Joniškis d. mun.;2018;8;179;98;81
Joniškis d. mun.;2018;9;189;107;82
Joniškis d. mun.;2018;10;157;75;82
Joniškis d. mun.;2018;11;191;95;96
Joniškis d. mun.;2018;12;185;93;92
Joniškis d. mun.;2018;13;251;124;127
Joniškis d. mun.;2018;14;231;113;118
Joniškis d. mun.;2018;15;245;138;107
Joniškis d. mun.;2018;16;246;129;117
Joniškis d. mun.;2018;17;272;142;130
Joniškis d. mun.;2018;18;287;142;145
Joniškis d. mun.;2018;19;299;158;141
Joniškis d. mun.;2018;20;273;136;137
Joniškis d. mun.;2018;21;296;167;129
Joniškis d. mun.;2018;22;279;135;144
Joniškis d. mun.;2018;23;314;155;159
Joniškis d. mun.;2018;24;322;175;147
Joniškis d. mun.;2018;25;335;177;158
Joniškis d. mun.;2018;26;241;137;104
Joniškis d. mun.;2018;27;229;136;93
Joniškis d. mun.;2018;28;179;109;70
Joniškis d. mun.;2018;29;169;119;50
Joniškis d. mun.;2018;30;136;85;51
Joniškis d. mun.;2018;31;124;88;36
Joniškis d. mun.;2018;32;138;68;70
Joniškis d. mun.;2018;33;123;75;48
Joniškis d. mun.;2018;34;131;67;64
Joniškis d. mun.;2018;35;143;59;84
Joniškis d. mun.;2018;36;133;61;72
Joniškis d. mun.;2018;37;169;99;70
Joniškis d. mun.;2018;38;191;107;84
Joniškis d. mun.;2018;39;190;92;98
Joniškis d. mun.;2018;40;255;111;144
Joniškis d. mun.;2018;41;256;126;130
Joniškis d. mun.;2018;42;256;128;128
Joniškis d. mun.;2018;43;283;139;144
Joniškis d. mun.;2018;44;301;149;152
Joniškis d. mun.;2018;45;315;141;174
Joniškis d. mun.;2018;46;358;149;209
Joniškis d. mun.;2018;47;363;171;192
Joniškis d. mun.;2018;48;310;151;159
Joniškis d. mun.;2018;49;382;200;182
Joniškis d. mun.;2018;50;367;181;186
Joniškis d. mun.;2018;51;383;197;186
Joniškis d. mun.;2018;52;385;175;210
Joniškis d. mun.;2018;53;393;181;212
Joniškis d. mun.;2018;54;381;181;200
Joniškis d. mun.;2018;55;387;195;192
Joniškis d. mun.;2018;56;359;160;199
Joniškis d. mun.;2018;57;425;197;228
Joniškis d. mun.;2018;58;372;176;196
Joniškis d. mun.;2018;59;378;202;176
Joniškis d. mun.;2018;60;304;145;159
Joniškis d. mun.;2018;61;316;157;159
Joniškis d. mun.;2018;62;301;126;175
Joniškis d. mun.;2018;63;296;125;171
Joniškis d. mun.;2018;64;289;134;155
Joniškis d. mun.;2018;65;291;113;178
Joniškis d. mun.;2018;66;272;133;139
Joniškis d. mun.;2018;67;313;130;183
Joniškis d. mun.;2018;68;248;116;132
Joniškis d. mun.;2018;69;222;88;134
Joniškis d. mun.;2018;70;234;76;158
Joniškis d. mun.;2018;71;221;74;147
Joniškis d. mun.;2018;72;237;81;156
Joniškis d. mun.;2018;73;201;79;122
Joniškis d. mun.;2018;74;250;90;160
Joniškis d. mun.;2018;75;208;65;143
Joniškis d. mun.;2018;76;261;81;180
Joniškis d. mun.;2018;77;189;59;130
Joniškis d. mun.;2018;78;195;78;117
Joniškis d. mun.;2018;79;185;55;130
Joniškis d. mun.;2018;80;163;45;118
Joniškis d. mun.;2018;81;199;58;141
Joniškis d. mun.;2018;82;157;45;112
Joniškis d. mun.;2018;83;132;29;103
Joniškis d. mun.;2018;84;130;32;98
Joniškis d. mun.;2018;85;538;127;411
Jurbarkas d. mun.;2001;-1;37795;17883;19912
Jurbarkas d. mun.;2001;0;352;178;174
Jurbarkas d. mun.;2001;1;420;234;186
Jurbarkas d. mun.;2001;2;412;229;183
Jurbarkas d. mun.;2001;3;414;216;198
Jurbarkas d. mun.;2001;4;436;210;226
Jurbarkas d. mun.;2001;5;462;234;228
Jurbarkas d. mun.;2001;6;509;262;247
Jurbarkas d. mun.;2001;7;544;286;258
Jurbarkas d. mun.;2001;8;635;330;305
Jurbarkas d. mun.;2001;9;595;293;302
Jurbarkas d. mun.;2001;10;605;305;300
Jurbarkas d. mun.;2001;11;599;321;278
Jurbarkas d. mun.;2001;12;573;268;305
Jurbarkas d. mun.;2001;13;642;340;302
Jurbarkas d. mun.;2001;14;672;352;320
Jurbarkas d. mun.;2001;15;655;345;310
Jurbarkas d. mun.;2001;16;652;355;297
Jurbarkas d. mun.;2001;17;614;314;300
Jurbarkas d. mun.;2001;18;501;255;246
Jurbarkas d. mun.;2001;19;436;242;194
Jurbarkas d. mun.;2001;20;429;229;200
Jurbarkas d. mun.;2001;21;412;202;210
Jurbarkas d. mun.;2001;22;417;221;196
Jurbarkas d. mun.;2001;23;400;212;188
Jurbarkas d. mun.;2001;24;426;234;192
Jurbarkas d. mun.;2001;25;427;209;218
Jurbarkas d. mun.;2001;26;430;201;229
Jurbarkas d. mun.;2001;27;411;204;207
Jurbarkas d. mun.;2001;28;457;231;226
Jurbarkas d. mun.;2001;29;506;267;239
Jurbarkas d. mun.;2001;30;496;249;247
Jurbarkas d. mun.;2001;31;561;290;271
Jurbarkas d. mun.;2001;32;496;252;244
Jurbarkas d. mun.;2001;33;528;256;272
Jurbarkas d. mun.;2001;34;509;253;256
Jurbarkas d. mun.;2001;35;503;262;241
Jurbarkas d. mun.;2001;36;536;258;278
Jurbarkas d. mun.;2001;37;521;283;238
Jurbarkas d. mun.;2001;38;587;303;284
Jurbarkas d. mun.;2001;39;596;299;297
Jurbarkas d. mun.;2001;40;600;290;310
Jurbarkas d. mun.;2001;41;597;316;281
Jurbarkas d. mun.;2001;42;597;298;299
Jurbarkas d. mun.;2001;43;506;265;241
Jurbarkas d. mun.;2001;44;462;229;233
Jurbarkas d. mun.;2001;45;501;260;241
Jurbarkas d. mun.;2001;46;457;236;221
Jurbarkas d. mun.;2001;47;411;194;217
Jurbarkas d. mun.;2001;48;444;214;230
Jurbarkas d. mun.;2001;49;470;215;255
Jurbarkas d. mun.;2001;50;458;213;245
Jurbarkas d. mun.;2001;51;434;200;234
Jurbarkas d. mun.;2001;52;397;174;223
Jurbarkas d. mun.;2001;53;392;192;200
Jurbarkas d. mun.;2001;54;363;159;204
Jurbarkas d. mun.;2001;55;397;181;216
Jurbarkas d. mun.;2001;56;344;162;182
Jurbarkas d. mun.;2001;57;467;215;252
Jurbarkas d. mun.;2001;58;463;213;250
Jurbarkas d. mun.;2001;59;462;185;277
Jurbarkas d. mun.;2001;60;374;181;193
Jurbarkas d. mun.;2001;61;405;167;238
Jurbarkas d. mun.;2001;62;381;159;222
Jurbarkas d. mun.;2001;63;389;158;231
Jurbarkas d. mun.;2001;64;415;172;243
Jurbarkas d. mun.;2001;65;379;162;217
Jurbarkas d. mun.;2001;66;381;165;216
Jurbarkas d. mun.;2001;67;406;133;273
Jurbarkas d. mun.;2001;68;421;166;255
Jurbarkas d. mun.;2001;69;426;156;270
Jurbarkas d. mun.;2001;70;422;152;270
Jurbarkas d. mun.;2001;71;373;122;251
Jurbarkas d. mun.;2001;72;386;129;257
Jurbarkas d. mun.;2001;73;384;140;244
Jurbarkas d. mun.;2001;74;299;86;213
Jurbarkas d. mun.;2001;75;307;103;204
Jurbarkas d. mun.;2001;76;266;100;166
Jurbarkas d. mun.;2001;77;273;89;184
Jurbarkas d. mun.;2001;78;243;65;178
Jurbarkas d. mun.;2001;79;188;54;134
Jurbarkas d. mun.;2001;80;171;51;120
Jurbarkas d. mun.;2001;81;124;35;89
Jurbarkas d. mun.;2001;82;92;23;69
Jurbarkas d. mun.;2001;83;83;31;52
Jurbarkas d. mun.;2001;84;93;32;61
Jurbarkas d. mun.;2001;85;516;157;359
Jurbarkas d. mun.;2002;-1;37288;17527;19761
Jurbarkas d. mun.;2002;0;335;176;159
Jurbarkas d. mun.;2002;1;350;179;171
Jurbarkas d. mun.;2002;2;412;227;185
Jurbarkas d. mun.;2002;3;410;225;185
Jurbarkas d. mun.;2002;4;410;212;198
Jurbarkas d. mun.;2002;5;429;203;226
Jurbarkas d. mun.;2002;6;457;231;226
Jurbarkas d. mun.;2002;7;507;259;248
Jurbarkas d. mun.;2002;8;538;279;259
Jurbarkas d. mun.;2002;9;628;324;304
Jurbarkas d. mun.;2002;10;594;291;303
Jurbarkas d. mun.;2002;11;593;296;297
Jurbarkas d. mun.;2002;12;597;322;275
Jurbarkas d. mun.;2002;13;566;262;304
Jurbarkas d. mun.;2002;14;638;333;305
Jurbarkas d. mun.;2002;15;663;345;318
Jurbarkas d. mun.;2002;16;642;337;305
Jurbarkas d. mun.;2002;17;641;347;294
Jurbarkas d. mun.;2002;18;602;305;297
Jurbarkas d. mun.;2002;19;489;247;242
Jurbarkas d. mun.;2002;20;425;233;192
Jurbarkas d. mun.;2002;21;426;227;199
Jurbarkas d. mun.;2002;22;402;197;205
Jurbarkas d. mun.;2002;23;410;220;190
Jurbarkas d. mun.;2002;24;401;208;193
Jurbarkas d. mun.;2002;25;419;228;191
Jurbarkas d. mun.;2002;26;413;199;214
Jurbarkas d. mun.;2002;27;422;194;228
Jurbarkas d. mun.;2002;28;397;195;202
Jurbarkas d. mun.;2002;29;437;214;223
Jurbarkas d. mun.;2002;30;490;253;237
Jurbarkas d. mun.;2002;31;481;240;241
Jurbarkas d. mun.;2002;32;553;285;268
Jurbarkas d. mun.;2002;33;494;248;246
Jurbarkas d. mun.;2002;34;520;252;268
Jurbarkas d. mun.;2002;35;499;244;255
Jurbarkas d. mun.;2002;36;497;257;240
Jurbarkas d. mun.;2002;37;525;248;277
Jurbarkas d. mun.;2002;38;508;272;236
Jurbarkas d. mun.;2002;39;577;296;281
Jurbarkas d. mun.;2002;40;586;290;296
Jurbarkas d. mun.;2002;41;586;282;304
Jurbarkas d. mun.;2002;42;585;307;278
Jurbarkas d. mun.;2002;43;592;295;297
Jurbarkas d. mun.;2002;44;497;257;240
Jurbarkas d. mun.;2002;45;450;223;227
Jurbarkas d. mun.;2002;46;490;253;237
Jurbarkas d. mun.;2002;47;457;236;221
Jurbarkas d. mun.;2002;48;401;188;213
Jurbarkas d. mun.;2002;49;436;209;227
Jurbarkas d. mun.;2002;50;462;207;255
Jurbarkas d. mun.;2002;51;448;207;241
Jurbarkas d. mun.;2002;52;431;196;235
Jurbarkas d. mun.;2002;53;391;171;220
Jurbarkas d. mun.;2002;54;381;187;194
Jurbarkas d. mun.;2002;55;356;154;202
Jurbarkas d. mun.;2002;56;381;170;211
Jurbarkas d. mun.;2002;57;335;159;176
Jurbarkas d. mun.;2002;58;454;207;247
Jurbarkas d. mun.;2002;59;455;208;247
Jurbarkas d. mun.;2002;60;454;179;275
Jurbarkas d. mun.;2002;61;371;180;191
Jurbarkas d. mun.;2002;62;399;162;237
Jurbarkas d. mun.;2002;63;377;153;224
Jurbarkas d. mun.;2002;64;386;154;232
Jurbarkas d. mun.;2002;65;407;165;242
Jurbarkas d. mun.;2002;66;373;157;216
Jurbarkas d. mun.;2002;67;376;161;215
Jurbarkas d. mun.;2002;68;399;133;266
Jurbarkas d. mun.;2002;69;421;162;259
Jurbarkas d. mun.;2002;70;425;154;271
Jurbarkas d. mun.;2002;71;414;145;269
Jurbarkas d. mun.;2002;72;363;118;245
Jurbarkas d. mun.;2002;73;377;123;254
Jurbarkas d. mun.;2002;74;371;135;236
Jurbarkas d. mun.;2002;75;293;84;209
Jurbarkas d. mun.;2002;76;296;98;198
Jurbarkas d. mun.;2002;77;250;91;159
Jurbarkas d. mun.;2002;78;262;84;178
Jurbarkas d. mun.;2002;79;228;62;166
Jurbarkas d. mun.;2002;80;171;46;125
Jurbarkas d. mun.;2002;81;149;39;110
Jurbarkas d. mun.;2002;82;114;31;83
Jurbarkas d. mun.;2002;83;80;20;60
Jurbarkas d. mun.;2002;84;69;27;42
Jurbarkas d. mun.;2002;85;492;148;344
Jurbarkas d. mun.;2003;-1;36852;17329;19523
Jurbarkas d. mun.;2003;0;308;174;134
Jurbarkas d. mun.;2003;1;329;172;157
Jurbarkas d. mun.;2003;2;343;174;169
Jurbarkas d. mun.;2003;3;408;225;183
Jurbarkas d. mun.;2003;4;407;225;182
Jurbarkas d. mun.;2003;5;409;211;198
Jurbarkas d. mun.;2003;6;425;201;224
Jurbarkas d. mun.;2003;7;455;231;224
Jurbarkas d. mun.;2003;8;506;259;247
Jurbarkas d. mun.;2003;9;534;275;259
Jurbarkas d. mun.;2003;10;623;323;300
Jurbarkas d. mun.;2003;11;588;289;299
Jurbarkas d. mun.;2003;12;587;293;294
Jurbarkas d. mun.;2003;13;586;316;270
Jurbarkas d. mun.;2003;14;556;256;300
Jurbarkas d. mun.;2003;15;628;327;301
Jurbarkas d. mun.;2003;16;650;339;311
Jurbarkas d. mun.;2003;17;628;329;299
Jurbarkas d. mun.;2003;18;631;342;289
Jurbarkas d. mun.;2003;19;592;300;292
Jurbarkas d. mun.;2003;20;479;244;235
Jurbarkas d. mun.;2003;21;422;232;190
Jurbarkas d. mun.;2003;22;423;221;202
Jurbarkas d. mun.;2003;23;395;193;202
Jurbarkas d. mun.;2003;24;408;218;190
Jurbarkas d. mun.;2003;25;394;205;189
Jurbarkas d. mun.;2003;26;414;226;188
Jurbarkas d. mun.;2003;27;394;188;206
Jurbarkas d. mun.;2003;28;415;189;226
Jurbarkas d. mun.;2003;29;391;191;200
Jurbarkas d. mun.;2003;30;435;214;221
Jurbarkas d. mun.;2003;31;478;246;232
Jurbarkas d. mun.;2003;32;470;232;238
Jurbarkas d. mun.;2003;33;550;288;262
Jurbarkas d. mun.;2003;34;489;245;244
Jurbarkas d. mun.;2003;35;512;247;265
Jurbarkas d. mun.;2003;36;492;238;254
Jurbarkas d. mun.;2003;37;490;253;237
Jurbarkas d. mun.;2003;38;519;245;274
Jurbarkas d. mun.;2003;39;504;269;235
Jurbarkas d. mun.;2003;40;570;293;277
Jurbarkas d. mun.;2003;41;584;293;291
Jurbarkas d. mun.;2003;42;588;282;306
Jurbarkas d. mun.;2003;43;577;303;274
Jurbarkas d. mun.;2003;44;594;296;298
Jurbarkas d. mun.;2003;45;491;254;237
Jurbarkas d. mun.;2003;46;447;222;225
Jurbarkas d. mun.;2003;47;479;247;232
Jurbarkas d. mun.;2003;48;452;232;220
Jurbarkas d. mun.;2003;49;388;182;206
Jurbarkas d. mun.;2003;50;428;206;222
Jurbarkas d. mun.;2003;51;453;203;250
Jurbarkas d. mun.;2003;52;436;200;236
Jurbarkas d. mun.;2003;53;428;196;232
Jurbarkas d. mun.;2003;54;389;169;220
Jurbarkas d. mun.;2003;55;377;182;195
Jurbarkas d. mun.;2003;56;348;148;200
Jurbarkas d. mun.;2003;57;379;166;213
Jurbarkas d. mun.;2003;58;328;153;175
Jurbarkas d. mun.;2003;59;449;204;245
Jurbarkas d. mun.;2003;60;444;203;241
Jurbarkas d. mun.;2003;61;446;174;272
Jurbarkas d. mun.;2003;62;357;170;187
Jurbarkas d. mun.;2003;63;395;160;235
Jurbarkas d. mun.;2003;64;373;151;222
Jurbarkas d. mun.;2003;65;385;155;230
Jurbarkas d. mun.;2003;66;403;162;241
Jurbarkas d. mun.;2003;67;369;153;216
Jurbarkas d. mun.;2003;68;363;151;212
Jurbarkas d. mun.;2003;69;384;122;262
Jurbarkas d. mun.;2003;70;408;155;253
Jurbarkas d. mun.;2003;71;410;149;261
Jurbarkas d. mun.;2003;72;408;140;268
Jurbarkas d. mun.;2003;73;359;119;240
Jurbarkas d. mun.;2003;74;364;118;246
Jurbarkas d. mun.;2003;75;354;124;230
Jurbarkas d. mun.;2003;76;279;80;199
Jurbarkas d. mun.;2003;77;281;87;194
Jurbarkas d. mun.;2003;78;237;87;150
Jurbarkas d. mun.;2003;79;251;78;173
Jurbarkas d. mun.;2003;80;206;57;149
Jurbarkas d. mun.;2003;81;161;43;118
Jurbarkas d. mun.;2003;82;143;37;106
Jurbarkas d. mun.;2003;83;101;27;74
Jurbarkas d. mun.;2003;84;73;18;55
Jurbarkas d. mun.;2003;85;446;133;313
Jurbarkas d. mun.;2004;-1;36314;17075;19239
Jurbarkas d. mun.;2004;0;338;169;169
Jurbarkas d. mun.;2004;1;312;179;133
Jurbarkas d. mun.;2004;2;331;173;158
Jurbarkas d. mun.;2004;3;345;176;169
Jurbarkas d. mun.;2004;4;406;225;181
Jurbarkas d. mun.;2004;5;408;227;181
Jurbarkas d. mun.;2004;6;409;211;198
Jurbarkas d. mun.;2004;7;421;198;223
Jurbarkas d. mun.;2004;8;452;228;224
Jurbarkas d. mun.;2004;9;505;257;248
Jurbarkas d. mun.;2004;10;536;277;259
Jurbarkas d. mun.;2004;11;626;327;299
Jurbarkas d. mun.;2004;12;582;285;297
Jurbarkas d. mun.;2004;13;581;293;288
Jurbarkas d. mun.;2004;14;574;309;265
Jurbarkas d. mun.;2004;15;546;254;292
Jurbarkas d. mun.;2004;16;617;324;293
Jurbarkas d. mun.;2004;17;639;334;305
Jurbarkas d. mun.;2004;18;616;322;294
Jurbarkas d. mun.;2004;19;617;336;281
Jurbarkas d. mun.;2004;20;578;297;281
Jurbarkas d. mun.;2004;21;458;236;222
Jurbarkas d. mun.;2004;22;412;227;185
Jurbarkas d. mun.;2004;23;414;219;195
Jurbarkas d. mun.;2004;24;387;188;199
Jurbarkas d. mun.;2004;25;388;210;178
Jurbarkas d. mun.;2004;26;374;196;178
Jurbarkas d. mun.;2004;27;403;215;188
Jurbarkas d. mun.;2004;28;379;185;194
Jurbarkas d. mun.;2004;29;400;177;223
Jurbarkas d. mun.;2004;30;382;188;194
Jurbarkas d. mun.;2004;31;430;216;214
Jurbarkas d. mun.;2004;32;468;240;228
Jurbarkas d. mun.;2004;33;461;232;229
Jurbarkas d. mun.;2004;34;537;284;253
Jurbarkas d. mun.;2004;35;487;244;243
Jurbarkas d. mun.;2004;36;509;245;264
Jurbarkas d. mun.;2004;37;485;234;251
Jurbarkas d. mun.;2004;38;482;249;233
Jurbarkas d. mun.;2004;39;508;240;268
Jurbarkas d. mun.;2004;40;494;262;232
Jurbarkas d. mun.;2004;41;554;286;268
Jurbarkas d. mun.;2004;42;575;290;285
Jurbarkas d. mun.;2004;43;576;276;300
Jurbarkas d. mun.;2004;44;563;293;270
Jurbarkas d. mun.;2004;45;589;297;292
Jurbarkas d. mun.;2004;46;483;252;231
Jurbarkas d. mun.;2004;47;435;217;218
Jurbarkas d. mun.;2004;48;474;244;230
Jurbarkas d. mun.;2004;49;447;231;216
Jurbarkas d. mun.;2004;50;383;178;205
Jurbarkas d. mun.;2004;51;420;202;218
Jurbarkas d. mun.;2004;52;446;198;248
Jurbarkas d. mun.;2004;53;424;194;230
Jurbarkas d. mun.;2004;54;424;195;229
Jurbarkas d. mun.;2004;55;381;163;218
Jurbarkas d. mun.;2004;56;372;181;191
Jurbarkas d. mun.;2004;57;343;145;198
Jurbarkas d. mun.;2004;58;375;162;213
Jurbarkas d. mun.;2004;59;326;152;174
Jurbarkas d. mun.;2004;60;434;195;239
Jurbarkas d. mun.;2004;61;433;196;237
Jurbarkas d. mun.;2004;62;439;172;267
Jurbarkas d. mun.;2004;63;345;163;182
Jurbarkas d. mun.;2004;64;387;153;234
Jurbarkas d. mun.;2004;65;366;147;219
Jurbarkas d. mun.;2004;66;377;146;231
Jurbarkas d. mun.;2004;67;382;145;237
Jurbarkas d. mun.;2004;68;359;145;214
Jurbarkas d. mun.;2004;69;354;147;207
Jurbarkas d. mun.;2004;70;367;112;255
Jurbarkas d. mun.;2004;71;394;146;248
Jurbarkas d. mun.;2004;72;395;139;256
Jurbarkas d. mun.;2004;73;399;130;269
Jurbarkas d. mun.;2004;74;337;106;231
Jurbarkas d. mun.;2004;75;346;106;240
Jurbarkas d. mun.;2004;76;341;114;227
Jurbarkas d. mun.;2004;77;265;71;194
Jurbarkas d. mun.;2004;78;264;77;187
Jurbarkas d. mun.;2004;79;214;80;134
Jurbarkas d. mun.;2004;80;240;76;164
Jurbarkas d. mun.;2004;81;190;53;137
Jurbarkas d. mun.;2004;82;149;37;112
Jurbarkas d. mun.;2004;83;133;32;101
Jurbarkas d. mun.;2004;84;89;23;66
Jurbarkas d. mun.;2004;85;428;120;308
Jurbarkas d. mun.;2005;-1;35517;16674;18843
Jurbarkas d. mun.;2005;0;306;161;145
Jurbarkas d. mun.;2005;1;335;167;168
Jurbarkas d. mun.;2005;2;309;178;131
Jurbarkas d. mun.;2005;3;324;170;154
Jurbarkas d. mun.;2005;4;341;174;167
Jurbarkas d. mun.;2005;5;401;224;177
Jurbarkas d. mun.;2005;6;403;224;179
Jurbarkas d. mun.;2005;7;403;206;197
Jurbarkas d. mun.;2005;8;417;197;220
Jurbarkas d. mun.;2005;9;447;227;220
Jurbarkas d. mun.;2005;10;505;257;248
Jurbarkas d. mun.;2005;11;530;274;256
Jurbarkas d. mun.;2005;12;619;322;297
Jurbarkas d. mun.;2005;13;574;282;292
Jurbarkas d. mun.;2005;14;575;290;285
Jurbarkas d. mun.;2005;15;571;306;265
Jurbarkas d. mun.;2005;16;539;249;290
Jurbarkas d. mun.;2005;17;606;315;291
Jurbarkas d. mun.;2005;18;619;325;294
Jurbarkas d. mun.;2005;19;587;309;278
Jurbarkas d. mun.;2005;20;591;323;268
Jurbarkas d. mun.;2005;21;560;286;274
Jurbarkas d. mun.;2005;22;448;232;216
Jurbarkas d. mun.;2005;23;391;220;171
Jurbarkas d. mun.;2005;24;399;212;187
Jurbarkas d. mun.;2005;25;365;179;186
Jurbarkas d. mun.;2005;26;383;210;173
Jurbarkas d. mun.;2005;27;362;189;173
Jurbarkas d. mun.;2005;28;385;206;179
Jurbarkas d. mun.;2005;29;354;177;177
Jurbarkas d. mun.;2005;30;382;169;213
Jurbarkas d. mun.;2005;31;369;179;190
Jurbarkas d. mun.;2005;32;412;207;205
Jurbarkas d. mun.;2005;33;450;233;217
Jurbarkas d. mun.;2005;34;451;229;222
Jurbarkas d. mun.;2005;35;531;281;250
Jurbarkas d. mun.;2005;36;470;230;240
Jurbarkas d. mun.;2005;37;502;239;263
Jurbarkas d. mun.;2005;38;472;224;248
Jurbarkas d. mun.;2005;39;477;246;231
Jurbarkas d. mun.;2005;40;496;234;262
Jurbarkas d. mun.;2005;41;483;252;231
Jurbarkas d. mun.;2005;42;544;279;265
Jurbarkas d. mun.;2005;43;564;281;283
Jurbarkas d. mun.;2005;44;572;272;300
Jurbarkas d. mun.;2005;45;550;282;268
Jurbarkas d. mun.;2005;46;578;288;290
Jurbarkas d. mun.;2005;47;476;248;228
Jurbarkas d. mun.;2005;48;424;209;215
Jurbarkas d. mun.;2005;49;466;238;228
Jurbarkas d. mun.;2005;50;443;227;216
Jurbarkas d. mun.;2005;51;372;171;201
Jurbarkas d. mun.;2005;52;414;200;214
Jurbarkas d. mun.;2005;53;433;190;243
Jurbarkas d. mun.;2005;54;415;188;227
Jurbarkas d. mun.;2005;55;413;189;224
Jurbarkas d. mun.;2005;56;376;161;215
Jurbarkas d. mun.;2005;57;366;176;190
Jurbarkas d. mun.;2005;58;340;145;195
Jurbarkas d. mun.;2005;59;370;156;214
Jurbarkas d. mun.;2005;60;320;148;172
Jurbarkas d. mun.;2005;61;412;182;230
Jurbarkas d. mun.;2005;62;425;192;233
Jurbarkas d. mun.;2005;63;430;166;264
Jurbarkas d. mun.;2005;64;331;155;176
Jurbarkas d. mun.;2005;65;376;143;233
Jurbarkas d. mun.;2005;66;349;138;211
Jurbarkas d. mun.;2005;67;369;140;229
Jurbarkas d. mun.;2005;68;373;137;236
Jurbarkas d. mun.;2005;69;347;136;211
Jurbarkas d. mun.;2005;70;344;142;202
Jurbarkas d. mun.;2005;71;351;103;248
Jurbarkas d. mun.;2005;72;380;141;239
Jurbarkas d. mun.;2005;73;377;132;245
Jurbarkas d. mun.;2005;74;382;121;261
Jurbarkas d. mun.;2005;75;320;97;223
Jurbarkas d. mun.;2005;76;326;96;230
Jurbarkas d. mun.;2005;77;319;103;216
Jurbarkas d. mun.;2005;78;251;67;184
Jurbarkas d. mun.;2005;79;237;67;170
Jurbarkas d. mun.;2005;80;202;75;127
Jurbarkas d. mun.;2005;81;216;66;150
Jurbarkas d. mun.;2005;82;172;50;122
Jurbarkas d. mun.;2005;83;141;33;108
Jurbarkas d. mun.;2005;84;117;23;94
Jurbarkas d. mun.;2005;85;390;107;283
Jurbarkas d. mun.;2006;-1;34429;16182;18247
Jurbarkas d. mun.;2006;0;300;163;137
Jurbarkas d. mun.;2006;1;299;156;143
Jurbarkas d. mun.;2006;2;330;166;164
Jurbarkas d. mun.;2006;3;299;171;128
Jurbarkas d. mun.;2006;4;318;168;150
Jurbarkas d. mun.;2006;5;338;171;167
Jurbarkas d. mun.;2006;6;396;223;173
Jurbarkas d. mun.;2006;7;396;220;176
Jurbarkas d. mun.;2006;8;402;205;197
Jurbarkas d. mun.;2006;9;412;195;217
Jurbarkas d. mun.;2006;10;440;223;217
Jurbarkas d. mun.;2006;11;497;257;240
Jurbarkas d. mun.;2006;12;524;268;256
Jurbarkas d. mun.;2006;13;602;312;290
Jurbarkas d. mun.;2006;14;558;274;284
Jurbarkas d. mun.;2006;15;554;281;273
Jurbarkas d. mun.;2006;16;550;295;255
Jurbarkas d. mun.;2006;17;521;242;279
Jurbarkas d. mun.;2006;18;579;301;278
Jurbarkas d. mun.;2006;19;578;301;277
Jurbarkas d. mun.;2006;20;558;289;269
Jurbarkas d. mun.;2006;21;552;306;246
Jurbarkas d. mun.;2006;22;525;272;253
Jurbarkas d. mun.;2006;23;421;223;198
Jurbarkas d. mun.;2006;24;365;209;156
Jurbarkas d. mun.;2006;25;359;190;169
Jurbarkas d. mun.;2006;26;341;167;174
Jurbarkas d. mun.;2006;27;363;204;159
Jurbarkas d. mun.;2006;28;336;170;166
Jurbarkas d. mun.;2006;29;356;194;162
Jurbarkas d. mun.;2006;30;342;173;169
Jurbarkas d. mun.;2006;31;367;163;204
Jurbarkas d. mun.;2006;32;350;171;179
Jurbarkas d. mun.;2006;33;396;198;198
Jurbarkas d. mun.;2006;34;426;217;209
Jurbarkas d. mun.;2006;35;431;219;212
Jurbarkas d. mun.;2006;36;515;271;244
Jurbarkas d. mun.;2006;37;456;221;235
Jurbarkas d. mun.;2006;38;485;232;253
Jurbarkas d. mun.;2006;39;465;222;243
Jurbarkas d. mun.;2006;40;465;238;227
Jurbarkas d. mun.;2006;41;474;221;253
Jurbarkas d. mun.;2006;42;471;250;221
Jurbarkas d. mun.;2006;43;528;270;258
Jurbarkas d. mun.;2006;44;561;285;276
Jurbarkas d. mun.;2006;45;557;263;294
Jurbarkas d. mun.;2006;46;534;271;263
Jurbarkas d. mun.;2006;47;565;282;283
Jurbarkas d. mun.;2006;48;466;241;225
Jurbarkas d. mun.;2006;49;411;201;210
Jurbarkas d. mun.;2006;50;453;231;222
Jurbarkas d. mun.;2006;51;432;223;209
Jurbarkas d. mun.;2006;52;367;165;202
Jurbarkas d. mun.;2006;53;405;194;211
Jurbarkas d. mun.;2006;54;420;185;235
Jurbarkas d. mun.;2006;55;408;184;224
Jurbarkas d. mun.;2006;56;409;189;220
Jurbarkas d. mun.;2006;57;372;158;214
Jurbarkas d. mun.;2006;58;357;170;187
Jurbarkas d. mun.;2006;59;334;138;196
Jurbarkas d. mun.;2006;60;360;148;212
Jurbarkas d. mun.;2006;61;309;142;167
Jurbarkas d. mun.;2006;62;405;176;229
Jurbarkas d. mun.;2006;63;416;187;229
Jurbarkas d. mun.;2006;64;419;161;258
Jurbarkas d. mun.;2006;65;319;146;173
Jurbarkas d. mun.;2006;66;368;137;231
Jurbarkas d. mun.;2006;67;338;135;203
Jurbarkas d. mun.;2006;68;356;133;223
Jurbarkas d. mun.;2006;69;356;130;226
Jurbarkas d. mun.;2006;70;332;127;205
Jurbarkas d. mun.;2006;71;330;134;196
Jurbarkas d. mun.;2006;72;335;96;239
Jurbarkas d. mun.;2006;73;360;129;231
Jurbarkas d. mun.;2006;74;360;124;236
Jurbarkas d. mun.;2006;75;369;115;254
Jurbarkas d. mun.;2006;76;299;94;205
Jurbarkas d. mun.;2006;77;294;83;211
Jurbarkas d. mun.;2006;78;295;92;203
Jurbarkas d. mun.;2006;79;237;61;176
Jurbarkas d. mun.;2006;80;230;61;169
Jurbarkas d. mun.;2006;81;187;69;118
Jurbarkas d. mun.;2006;82;197;59;138
Jurbarkas d. mun.;2006;83;153;46;107
Jurbarkas d. mun.;2006;84;116;27;89
Jurbarkas d. mun.;2006;85;398;108;290
Jurbarkas d. mun.;2007;-1;33692;15817;17875
Jurbarkas d. mun.;2007;0;292;143;149
Jurbarkas d. mun.;2007;1;294;160;134
Jurbarkas d. mun.;2007;2;294;152;142
Jurbarkas d. mun.;2007;3;326;163;163
Jurbarkas d. mun.;2007;4;292;167;125
Jurbarkas d. mun.;2007;5;317;164;153
Jurbarkas d. mun.;2007;6;333;169;164
Jurbarkas d. mun.;2007;7;390;218;172
Jurbarkas d. mun.;2007;8;399;222;177
Jurbarkas d. mun.;2007;9;399;204;195
Jurbarkas d. mun.;2007;10;415;194;221
Jurbarkas d. mun.;2007;11;436;222;214
Jurbarkas d. mun.;2007;12;495;253;242
Jurbarkas d. mun.;2007;13;520;268;252
Jurbarkas d. mun.;2007;14;596;309;287
Jurbarkas d. mun.;2007;15;546;269;277
Jurbarkas d. mun.;2007;16;544;275;269
Jurbarkas d. mun.;2007;17;540;287;253
Jurbarkas d. mun.;2007;18;509;238;271
Jurbarkas d. mun.;2007;19;561;291;270
Jurbarkas d. mun.;2007;20;555;291;264
Jurbarkas d. mun.;2007;21;540;275;265
Jurbarkas d. mun.;2007;22;534;299;235
Jurbarkas d. mun.;2007;23;502;261;241
Jurbarkas d. mun.;2007;24;406;216;190
Jurbarkas d. mun.;2007;25;343;198;145
Jurbarkas d. mun.;2007;26;348;186;162
Jurbarkas d. mun.;2007;27;320;158;162
Jurbarkas d. mun.;2007;28;348;194;154
Jurbarkas d. mun.;2007;29;320;165;155
Jurbarkas d. mun.;2007;30;343;187;156
Jurbarkas d. mun.;2007;31;338;171;167
Jurbarkas d. mun.;2007;32;357;160;197
Jurbarkas d. mun.;2007;33;344;167;177
Jurbarkas d. mun.;2007;34;385;191;194
Jurbarkas d. mun.;2007;35;408;209;199
Jurbarkas d. mun.;2007;36;424;213;211
Jurbarkas d. mun.;2007;37;510;266;244
Jurbarkas d. mun.;2007;38;445;213;232
Jurbarkas d. mun.;2007;39;483;231;252
Jurbarkas d. mun.;2007;40;461;221;240
Jurbarkas d. mun.;2007;41;461;234;227
Jurbarkas d. mun.;2007;42;470;219;251
Jurbarkas d. mun.;2007;43;459;241;218
Jurbarkas d. mun.;2007;44;517;262;255
Jurbarkas d. mun.;2007;45;549;278;271
Jurbarkas d. mun.;2007;46;549;258;291
Jurbarkas d. mun.;2007;47;525;266;259
Jurbarkas d. mun.;2007;48;559;278;281
Jurbarkas d. mun.;2007;49;459;234;225
Jurbarkas d. mun.;2007;50;400;195;205
Jurbarkas d. mun.;2007;51;447;227;220
Jurbarkas d. mun.;2007;52;422;219;203
Jurbarkas d. mun.;2007;53;359;157;202
Jurbarkas d. mun.;2007;54;394;190;204
Jurbarkas d. mun.;2007;55;410;179;231
Jurbarkas d. mun.;2007;56;397;178;219
Jurbarkas d. mun.;2007;57;403;183;220
Jurbarkas d. mun.;2007;58;362;156;206
Jurbarkas d. mun.;2007;59;348;163;185
Jurbarkas d. mun.;2007;60;323;134;189
Jurbarkas d. mun.;2007;61;349;141;208
Jurbarkas d. mun.;2007;62;301;139;162
Jurbarkas d. mun.;2007;63;391;168;223
Jurbarkas d. mun.;2007;64;398;178;220
Jurbarkas d. mun.;2007;65;406;154;252
Jurbarkas d. mun.;2007;66;312;140;172
Jurbarkas d. mun.;2007;67;356;134;222
Jurbarkas d. mun.;2007;68;333;134;199
Jurbarkas d. mun.;2007;69;347;127;220
Jurbarkas d. mun.;2007;70;339;119;220
Jurbarkas d. mun.;2007;71;324;126;198
Jurbarkas d. mun.;2007;72;311;122;189
Jurbarkas d. mun.;2007;73;326;90;236
Jurbarkas d. mun.;2007;74;345;123;222
Jurbarkas d. mun.;2007;75;335;113;222
Jurbarkas d. mun.;2007;76;341;108;233
Jurbarkas d. mun.;2007;77;281;88;193
Jurbarkas d. mun.;2007;78;273;75;198
Jurbarkas d. mun.;2007;79;277;80;197
Jurbarkas d. mun.;2007;80;218;54;164
Jurbarkas d. mun.;2007;81;210;52;158
Jurbarkas d. mun.;2007;82;164;60;104
Jurbarkas d. mun.;2007;83;181;53;128
Jurbarkas d. mun.;2007;84;131;40;91
Jurbarkas d. mun.;2007;85;418;108;310
Jurbarkas d. mun.;2008;-1;32954;15405;17549
Jurbarkas d. mun.;2008;0;289;150;139
Jurbarkas d. mun.;2008;1;284;138;146
Jurbarkas d. mun.;2008;2;291;154;137
Jurbarkas d. mun.;2008;3;286;151;135
Jurbarkas d. mun.;2008;4;322;160;162
Jurbarkas d. mun.;2008;5;286;162;124
Jurbarkas d. mun.;2008;6;311;160;151
Jurbarkas d. mun.;2008;7;332;166;166
Jurbarkas d. mun.;2008;8;386;214;172
Jurbarkas d. mun.;2008;9;392;221;171
Jurbarkas d. mun.;2008;10;396;199;197
Jurbarkas d. mun.;2008;11;414;194;220
Jurbarkas d. mun.;2008;12;429;217;212
Jurbarkas d. mun.;2008;13;493;253;240
Jurbarkas d. mun.;2008;14;514;264;250
Jurbarkas d. mun.;2008;15;586;303;283
Jurbarkas d. mun.;2008;16;544;266;278
Jurbarkas d. mun.;2008;17;542;273;269
Jurbarkas d. mun.;2008;18;529;279;250
Jurbarkas d. mun.;2008;19;500;231;269
Jurbarkas d. mun.;2008;20;547;285;262
Jurbarkas d. mun.;2008;21;529;279;250
Jurbarkas d. mun.;2008;22;520;264;256
Jurbarkas d. mun.;2008;23;509;287;222
Jurbarkas d. mun.;2008;24;475;250;225
Jurbarkas d. mun.;2008;25;375;203;172
Jurbarkas d. mun.;2008;26;315;186;129
Jurbarkas d. mun.;2008;27;332;176;156
Jurbarkas d. mun.;2008;28;302;148;154
Jurbarkas d. mun.;2008;29;332;187;145
Jurbarkas d. mun.;2008;30;306;157;149
Jurbarkas d. mun.;2008;31;336;183;153
Jurbarkas d. mun.;2008;32;321;166;155
Jurbarkas d. mun.;2008;33;346;152;194
Jurbarkas d. mun.;2008;34;335;162;173
Jurbarkas d. mun.;2008;35;377;184;193
Jurbarkas d. mun.;2008;36;393;199;194
Jurbarkas d. mun.;2008;37;414;208;206
Jurbarkas d. mun.;2008;38;499;257;242
Jurbarkas d. mun.;2008;39;438;208;230
Jurbarkas d. mun.;2008;40;471;225;246
Jurbarkas d. mun.;2008;41;440;204;236
Jurbarkas d. mun.;2008;42;458;234;224
Jurbarkas d. mun.;2008;43;459;211;248
Jurbarkas d. mun.;2008;44;452;238;214
Jurbarkas d. mun.;2008;45;506;253;253
Jurbarkas d. mun.;2008;46;541;273;268
Jurbarkas d. mun.;2008;47;541;253;288
Jurbarkas d. mun.;2008;48;514;258;256
Jurbarkas d. mun.;2008;49;553;276;277
Jurbarkas d. mun.;2008;50;448;225;223
Jurbarkas d. mun.;2008;51;394;190;204
Jurbarkas d. mun.;2008;52;441;221;220
Jurbarkas d. mun.;2008;53;414;212;202
Jurbarkas d. mun.;2008;54;355;156;199
Jurbarkas d. mun.;2008;55;388;185;203
Jurbarkas d. mun.;2008;56;412;178;234
Jurbarkas d. mun.;2008;57;384;169;215
Jurbarkas d. mun.;2008;58;399;178;221
Jurbarkas d. mun.;2008;59;355;152;203
Jurbarkas d. mun.;2008;60;339;158;181
Jurbarkas d. mun.;2008;61;320;133;187
Jurbarkas d. mun.;2008;62;343;138;205
Jurbarkas d. mun.;2008;63;292;135;157
Jurbarkas d. mun.;2008;64;376;157;219
Jurbarkas d. mun.;2008;65;385;170;215
Jurbarkas d. mun.;2008;66;394;147;247
Jurbarkas d. mun.;2008;67;298;128;170
Jurbarkas d. mun.;2008;68;342;121;221
Jurbarkas d. mun.;2008;69;321;122;199
Jurbarkas d. mun.;2008;70;327;116;211
Jurbarkas d. mun.;2008;71;329;113;216
Jurbarkas d. mun.;2008;72;309;115;194
Jurbarkas d. mun.;2008;73;303;117;186
Jurbarkas d. mun.;2008;74;316;89;227
Jurbarkas d. mun.;2008;75;328;113;215
Jurbarkas d. mun.;2008;76;322;107;215
Jurbarkas d. mun.;2008;77;326;100;226
Jurbarkas d. mun.;2008;78;266;81;185
Jurbarkas d. mun.;2008;79;255;71;184
Jurbarkas d. mun.;2008;80;260;70;190
Jurbarkas d. mun.;2008;81;198;51;147
Jurbarkas d. mun.;2008;82;193;49;144
Jurbarkas d. mun.;2008;83;149;50;99
Jurbarkas d. mun.;2008;84;157;45;112
Jurbarkas d. mun.;2008;85;454;122;332
Jurbarkas d. mun.;2009;-1;32291;15096;17195
Jurbarkas d. mun.;2009;0;306;149;157
Jurbarkas d. mun.;2009;1;288;152;136
Jurbarkas d. mun.;2009;2;277;134;143
Jurbarkas d. mun.;2009;3;289;157;132
Jurbarkas d. mun.;2009;4;282;145;137
Jurbarkas d. mun.;2009;5;319;159;160
Jurbarkas d. mun.;2009;6;285;161;124
Jurbarkas d. mun.;2009;7;302;157;145
Jurbarkas d. mun.;2009;8;327;163;164
Jurbarkas d. mun.;2009;9;382;213;169
Jurbarkas d. mun.;2009;10;391;220;171
Jurbarkas d. mun.;2009;11;395;200;195
Jurbarkas d. mun.;2009;12;403;190;213
Jurbarkas d. mun.;2009;13;425;216;209
Jurbarkas d. mun.;2009;14;487;250;237
Jurbarkas d. mun.;2009;15;509;260;249
Jurbarkas d. mun.;2009;16;577;299;278
Jurbarkas d. mun.;2009;17;540;264;276
Jurbarkas d. mun.;2009;18;534;271;263
Jurbarkas d. mun.;2009;19;523;274;249
Jurbarkas d. mun.;2009;20;493;227;266
Jurbarkas d. mun.;2009;21;537;282;255
Jurbarkas d. mun.;2009;22;517;273;244
Jurbarkas d. mun.;2009;23;513;266;247
Jurbarkas d. mun.;2009;24;482;270;212
Jurbarkas d. mun.;2009;25;454;241;213
Jurbarkas d. mun.;2009;26;351;189;162
Jurbarkas d. mun.;2009;27;295;178;117
Jurbarkas d. mun.;2009;28;319;165;154
Jurbarkas d. mun.;2009;29;287;143;144
Jurbarkas d. mun.;2009;30;317;182;135
Jurbarkas d. mun.;2009;31;297;151;146
Jurbarkas d. mun.;2009;32;322;173;149
Jurbarkas d. mun.;2009;33;316;167;149
Jurbarkas d. mun.;2009;34;329;144;185
Jurbarkas d. mun.;2009;35;329;157;172
Jurbarkas d. mun.;2009;36;368;182;186
Jurbarkas d. mun.;2009;37;384;194;190
Jurbarkas d. mun.;2009;38;400;196;204
Jurbarkas d. mun.;2009;39;488;248;240
Jurbarkas d. mun.;2009;40;425;201;224
Jurbarkas d. mun.;2009;41;456;216;240
Jurbarkas d. mun.;2009;42;432;200;232
Jurbarkas d. mun.;2009;43;454;233;221
Jurbarkas d. mun.;2009;44;446;203;243
Jurbarkas d. mun.;2009;45;449;236;213
Jurbarkas d. mun.;2009;46;495;245;250
Jurbarkas d. mun.;2009;47;535;269;266
Jurbarkas d. mun.;2009;48;525;246;279
Jurbarkas d. mun.;2009;49;504;253;251
Jurbarkas d. mun.;2009;50;540;266;274
Jurbarkas d. mun.;2009;51;440;218;222
Jurbarkas d. mun.;2009;52;385;188;197
Jurbarkas d. mun.;2009;53;431;215;216
Jurbarkas d. mun.;2009;54;406;209;197
Jurbarkas d. mun.;2009;55;347;153;194
Jurbarkas d. mun.;2009;56;377;179;198
Jurbarkas d. mun.;2009;57;400;174;226
Jurbarkas d. mun.;2009;58;374;165;209
Jurbarkas d. mun.;2009;59;387;170;217
Jurbarkas d. mun.;2009;60;343;145;198
Jurbarkas d. mun.;2009;61;330;157;173
Jurbarkas d. mun.;2009;62;311;128;183
Jurbarkas d. mun.;2009;63;329;132;197
Jurbarkas d. mun.;2009;64;290;133;157
Jurbarkas d. mun.;2009;65;364;150;214
Jurbarkas d. mun.;2009;66;373;161;212
Jurbarkas d. mun.;2009;67;383;141;242
Jurbarkas d. mun.;2009;68;290;123;167
Jurbarkas d. mun.;2009;69;333;117;216
Jurbarkas d. mun.;2009;70;312;117;195
Jurbarkas d. mun.;2009;71;318;110;208
Jurbarkas d. mun.;2009;72;318;110;208
Jurbarkas d. mun.;2009;73;299;109;190
Jurbarkas d. mun.;2009;74;292;110;182
Jurbarkas d. mun.;2009;75;300;86;214
Jurbarkas d. mun.;2009;76;315;108;207
Jurbarkas d. mun.;2009;77;311;104;207
Jurbarkas d. mun.;2009;78;316;93;223
Jurbarkas d. mun.;2009;79;249;74;175
Jurbarkas d. mun.;2009;80;229;59;170
Jurbarkas d. mun.;2009;81;238;61;177
Jurbarkas d. mun.;2009;82;173;44;129
Jurbarkas d. mun.;2009;83;175;42;133
Jurbarkas d. mun.;2009;84;128;37;91
Jurbarkas d. mun.;2009;85;525;144;381
Jurbarkas d. mun.;2010;-1;31511;14722;16789
Jurbarkas d. mun.;2010;0;276;137;139
Jurbarkas d. mun.;2010;1;294;144;150
Jurbarkas d. mun.;2010;2;281;146;135
Jurbarkas d. mun.;2010;3;273;131;142
Jurbarkas d. mun.;2010;4;281;153;128
Jurbarkas d. mun.;2010;5;279;142;137
Jurbarkas d. mun.;2010;6;317;158;159
Jurbarkas d. mun.;2010;7;277;159;118
Jurbarkas d. mun.;2010;8;301;158;143
Jurbarkas d. mun.;2010;9;325;163;162
Jurbarkas d. mun.;2010;10;380;211;169
Jurbarkas d. mun.;2010;11;385;215;170
Jurbarkas d. mun.;2010;12;394;201;193
Jurbarkas d. mun.;2010;13;403;189;214
Jurbarkas d. mun.;2010;14;424;216;208
Jurbarkas d. mun.;2010;15;484;248;236
Jurbarkas d. mun.;2010;16;506;259;247
Jurbarkas d. mun.;2010;17;568;295;273
Jurbarkas d. mun.;2010;18;525;260;265
Jurbarkas d. mun.;2010;19;521;265;256
Jurbarkas d. mun.;2010;20;512;270;242
Jurbarkas d. mun.;2010;21;477;222;255
Jurbarkas d. mun.;2010;22;511;267;244
Jurbarkas d. mun.;2010;23;504;267;237
Jurbarkas d. mun.;2010;24;478;251;227
Jurbarkas d. mun.;2010;25;449;254;195
Jurbarkas d. mun.;2010;26;415;225;190
Jurbarkas d. mun.;2010;27;326;177;149
Jurbarkas d. mun.;2010;28;274;168;106
Jurbarkas d. mun.;2010;29;299;155;144
Jurbarkas d. mun.;2010;30;273;135;138
Jurbarkas d. mun.;2010;31;301;171;130
Jurbarkas d. mun.;2010;32;289;147;142
Jurbarkas d. mun.;2010;33;321;177;144
Jurbarkas d. mun.;2010;34;300;156;144
Jurbarkas d. mun.;2010;35;321;138;183
Jurbarkas d. mun.;2010;36;316;151;165
Jurbarkas d. mun.;2010;37;359;177;182
Jurbarkas d. mun.;2010;38;371;183;188
Jurbarkas d. mun.;2010;39;390;192;198
Jurbarkas d. mun.;2010;40;480;244;236
Jurbarkas d. mun.;2010;41;412;196;216
Jurbarkas d. mun.;2010;42;442;210;232
Jurbarkas d. mun.;2010;43;428;199;229
Jurbarkas d. mun.;2010;44;442;228;214
Jurbarkas d. mun.;2010;45;439;197;242
Jurbarkas d. mun.;2010;46;437;226;211
Jurbarkas d. mun.;2010;47;490;241;249
Jurbarkas d. mun.;2010;48;520;258;262
Jurbarkas d. mun.;2010;49;513;237;276
Jurbarkas d. mun.;2010;50;490;244;246
Jurbarkas d. mun.;2010;51;535;261;274
Jurbarkas d. mun.;2010;52;432;214;218
Jurbarkas d. mun.;2010;53;381;185;196
Jurbarkas d. mun.;2010;54;425;212;213
Jurbarkas d. mun.;2010;55;396;205;191
Jurbarkas d. mun.;2010;56;340;148;192
Jurbarkas d. mun.;2010;57;367;174;193
Jurbarkas d. mun.;2010;58;396;173;223
Jurbarkas d. mun.;2010;59;367;159;208
Jurbarkas d. mun.;2010;60;378;166;212
Jurbarkas d. mun.;2010;61;335;141;194
Jurbarkas d. mun.;2010;62;322;153;169
Jurbarkas d. mun.;2010;63;301;119;182
Jurbarkas d. mun.;2010;64;320;124;196
Jurbarkas d. mun.;2010;65;279;126;153
Jurbarkas d. mun.;2010;66;353;146;207
Jurbarkas d. mun.;2010;67;364;154;210
Jurbarkas d. mun.;2010;68;370;134;236
Jurbarkas d. mun.;2010;69;273;115;158
Jurbarkas d. mun.;2010;70;322;110;212
Jurbarkas d. mun.;2010;71;305;111;194
Jurbarkas d. mun.;2010;72;312;108;204
Jurbarkas d. mun.;2010;73;306;106;200
Jurbarkas d. mun.;2010;74;285;103;182
Jurbarkas d. mun.;2010;75;281;102;179
Jurbarkas d. mun.;2010;76;282;80;202
Jurbarkas d. mun.;2010;77;296;100;196
Jurbarkas d. mun.;2010;78;297;99;198
Jurbarkas d. mun.;2010;79;291;84;207
Jurbarkas d. mun.;2010;80;238;70;168
Jurbarkas d. mun.;2010;81;208;48;160
Jurbarkas d. mun.;2010;82;224;57;167
Jurbarkas d. mun.;2010;83;159;39;120
Jurbarkas d. mun.;2010;84;149;35;114
Jurbarkas d. mun.;2010;85;549;148;401
Jurbarkas d. mun.;2011;-1;30331;14192;16139
Jurbarkas d. mun.;2011;0;224;117;107
Jurbarkas d. mun.;2011;1;268;131;137
Jurbarkas d. mun.;2011;2;253;131;122
Jurbarkas d. mun.;2011;3;275;143;132
Jurbarkas d. mun.;2011;4;257;128;129
Jurbarkas d. mun.;2011;5;250;138;112
Jurbarkas d. mun.;2011;6;273;141;132
Jurbarkas d. mun.;2011;7;306;156;150
Jurbarkas d. mun.;2011;8;269;151;118
Jurbarkas d. mun.;2011;9;300;163;137
Jurbarkas d. mun.;2011;10;319;160;159
Jurbarkas d. mun.;2011;11;381;210;171
Jurbarkas d. mun.;2011;12;360;199;161
Jurbarkas d. mun.;2011;13;376;191;185
Jurbarkas d. mun.;2011;14;396;185;211
Jurbarkas d. mun.;2011;15;423;227;196
Jurbarkas d. mun.;2011;16;472;242;230
Jurbarkas d. mun.;2011;17;494;264;230
Jurbarkas d. mun.;2011;18;539;286;253
Jurbarkas d. mun.;2011;19;443;233;210
Jurbarkas d. mun.;2011;20;401;213;188
Jurbarkas d. mun.;2011;21;393;218;175
Jurbarkas d. mun.;2011;22;355;172;183
Jurbarkas d. mun.;2011;23;387;211;176
Jurbarkas d. mun.;2011;24;366;200;166
Jurbarkas d. mun.;2011;25;383;220;163
Jurbarkas d. mun.;2011;26;313;184;129
Jurbarkas d. mun.;2011;27;293;155;138
Jurbarkas d. mun.;2011;28;266;135;131
Jurbarkas d. mun.;2011;29;263;137;126
Jurbarkas d. mun.;2011;30;291;141;150
Jurbarkas d. mun.;2011;31;267;120;147
Jurbarkas d. mun.;2011;32;307;166;141
Jurbarkas d. mun.;2011;33;284;149;135
Jurbarkas d. mun.;2011;34;336;180;156
Jurbarkas d. mun.;2011;35;322;159;163
Jurbarkas d. mun.;2011;36;345;160;185
Jurbarkas d. mun.;2011;37;332;155;177
Jurbarkas d. mun.;2011;38;382;195;187
Jurbarkas d. mun.;2011;39;422;212;210
Jurbarkas d. mun.;2011;40;402;211;191
Jurbarkas d. mun.;2011;41;495;254;241
Jurbarkas d. mun.;2011;42;424;200;224
Jurbarkas d. mun.;2011;43;466;226;240
Jurbarkas d. mun.;2011;44;432;194;238
Jurbarkas d. mun.;2011;45;445;227;218
Jurbarkas d. mun.;2011;46;459;212;247
Jurbarkas d. mun.;2011;47;440;241;199
Jurbarkas d. mun.;2011;48;516;256;260
Jurbarkas d. mun.;2011;49;507;253;254
Jurbarkas d. mun.;2011;50;508;241;267
Jurbarkas d. mun.;2011;51;485;238;247
Jurbarkas d. mun.;2011;52;510;243;267
Jurbarkas d. mun.;2011;53;421;207;214
Jurbarkas d. mun.;2011;54;400;198;202
Jurbarkas d. mun.;2011;55;438;224;214
Jurbarkas d. mun.;2011;56;394;198;196
Jurbarkas d. mun.;2011;57;338;152;186
Jurbarkas d. mun.;2011;58;379;184;195
Jurbarkas d. mun.;2011;59;412;178;234
Jurbarkas d. mun.;2011;60;379;165;214
Jurbarkas d. mun.;2011;61;375;163;212
Jurbarkas d. mun.;2011;62;330;137;193
Jurbarkas d. mun.;2011;63;315;142;173
Jurbarkas d. mun.;2011;64;294;111;183
Jurbarkas d. mun.;2011;65;305;112;193
Jurbarkas d. mun.;2011;66;291;126;165
Jurbarkas d. mun.;2011;67;353;144;209
Jurbarkas d. mun.;2011;68;370;148;222
Jurbarkas d. mun.;2011;69;372;129;243
Jurbarkas d. mun.;2011;70;281;116;165
Jurbarkas d. mun.;2011;71;316;110;206
Jurbarkas d. mun.;2011;72;302;112;190
Jurbarkas d. mun.;2011;73;305;100;205
Jurbarkas d. mun.;2011;74;293;99;194
Jurbarkas d. mun.;2011;75;272;98;174
Jurbarkas d. mun.;2011;76;278;98;180
Jurbarkas d. mun.;2011;77;274;77;197
Jurbarkas d. mun.;2011;78;267;88;179
Jurbarkas d. mun.;2011;79;275;83;192
Jurbarkas d. mun.;2011;80;264;77;187
Jurbarkas d. mun.;2011;81;229;66;163
Jurbarkas d. mun.;2011;82;189;49;140
Jurbarkas d. mun.;2011;83;201;50;151
Jurbarkas d. mun.;2011;84;140;30;110
Jurbarkas d. mun.;2011;85;604;147;457
Jurbarkas d. mun.;2012;-1;29657;13887;15770
Jurbarkas d. mun.;2012;0;249;152;97
Jurbarkas d. mun.;2012;1;223;119;104
Jurbarkas d. mun.;2012;2;275;134;141
Jurbarkas d. mun.;2012;3;255;130;125
Jurbarkas d. mun.;2012;4;273;144;129
Jurbarkas d. mun.;2012;5;253;126;127
Jurbarkas d. mun.;2012;6;239;133;106
Jurbarkas d. mun.;2012;7;269;140;129
Jurbarkas d. mun.;2012;8;302;154;148
Jurbarkas d. mun.;2012;9;270;152;118
Jurbarkas d. mun.;2012;10;301;164;137
Jurbarkas d. mun.;2012;11;319;160;159
Jurbarkas d. mun.;2012;12;378;208;170
Jurbarkas d. mun.;2012;13;355;197;158
Jurbarkas d. mun.;2012;14;373;190;183
Jurbarkas d. mun.;2012;15;396;187;209
Jurbarkas d. mun.;2012;16;424;228;196
Jurbarkas d. mun.;2012;17;467;239;228
Jurbarkas d. mun.;2012;18;495;262;233
Jurbarkas d. mun.;2012;19;520;273;247
Jurbarkas d. mun.;2012;20;431;227;204
Jurbarkas d. mun.;2012;21;385;204;181
Jurbarkas d. mun.;2012;22;376;207;169
Jurbarkas d. mun.;2012;23;325;159;166
Jurbarkas d. mun.;2012;24;371;208;163
Jurbarkas d. mun.;2012;25;345;189;156
Jurbarkas d. mun.;2012;26;349;205;144
Jurbarkas d. mun.;2012;27;279;170;109
Jurbarkas d. mun.;2012;28;269;144;125
Jurbarkas d. mun.;2012;29;255;124;131
Jurbarkas d. mun.;2012;30;242;130;112
Jurbarkas d. mun.;2012;31;283;140;143
Jurbarkas d. mun.;2012;32;263;120;143
Jurbarkas d. mun.;2012;33;298;162;136
Jurbarkas d. mun.;2012;34;270;139;131
Jurbarkas d. mun.;2012;35;329;175;154
Jurbarkas d. mun.;2012;36;309;156;153
Jurbarkas d. mun.;2012;37;342;158;184
Jurbarkas d. mun.;2012;38;327;151;176
Jurbarkas d. mun.;2012;39;372;185;187
Jurbarkas d. mun.;2012;40;415;208;207
Jurbarkas d. mun.;2012;41;386;199;187
Jurbarkas d. mun.;2012;42;492;251;241
Jurbarkas d. mun.;2012;43;419;197;222
Jurbarkas d. mun.;2012;44;461;224;237
Jurbarkas d. mun.;2012;45;422;187;235
Jurbarkas d. mun.;2012;46;439;226;213
Jurbarkas d. mun.;2012;47;452;208;244
Jurbarkas d. mun.;2012;48;438;240;198
Jurbarkas d. mun.;2012;49;509;252;257
Jurbarkas d. mun.;2012;50;497;247;250
Jurbarkas d. mun.;2012;51;503;233;270
Jurbarkas d. mun.;2012;52;480;232;248
Jurbarkas d. mun.;2012;53;502;240;262
Jurbarkas d. mun.;2012;54;416;204;212
Jurbarkas d. mun.;2012;55;392;194;198
Jurbarkas d. mun.;2012;56;428;218;210
Jurbarkas d. mun.;2012;57;386;193;193
Jurbarkas d. mun.;2012;58;333;148;185
Jurbarkas d. mun.;2012;59;370;176;194
Jurbarkas d. mun.;2012;60;406;174;232
Jurbarkas d. mun.;2012;61;369;159;210
Jurbarkas d. mun.;2012;62;370;158;212
Jurbarkas d. mun.;2012;63;319;129;190
Jurbarkas d. mun.;2012;64;306;135;171
Jurbarkas d. mun.;2012;65;285;103;182
Jurbarkas d. mun.;2012;66;297;106;191
Jurbarkas d. mun.;2012;67;283;120;163
Jurbarkas d. mun.;2012;68;341;136;205
Jurbarkas d. mun.;2012;69;359;142;217
Jurbarkas d. mun.;2012;70;364;124;240
Jurbarkas d. mun.;2012;71;268;108;160
Jurbarkas d. mun.;2012;72;313;107;206
Jurbarkas d. mun.;2012;73;293;108;185
Jurbarkas d. mun.;2012;74;297;100;197
Jurbarkas d. mun.;2012;75;280;91;189
Jurbarkas d. mun.;2012;76;258;92;166
Jurbarkas d. mun.;2012;77;265;92;173
Jurbarkas d. mun.;2012;78;253;64;189
Jurbarkas d. mun.;2012;79;246;76;170
Jurbarkas d. mun.;2012;80;254;76;178
Jurbarkas d. mun.;2012;81;237;71;166
Jurbarkas d. mun.;2012;82;213;57;156
Jurbarkas d. mun.;2012;83;171;42;129
Jurbarkas d. mun.;2012;84;180;46;134
Jurbarkas d. mun.;2012;85;634;149;485
Jurbarkas d. mun.;2013;-1;29184;13651;15533
Jurbarkas d. mun.;2013;0;281;130;151
Jurbarkas d. mun.;2013;1;244;150;94
Jurbarkas d. mun.;2013;2;220;119;101
Jurbarkas d. mun.;2013;3;272;131;141
Jurbarkas d. mun.;2013;4;251;131;120
Jurbarkas d. mun.;2013;5;275;143;132
Jurbarkas d. mun.;2013;6;253;126;127
Jurbarkas d. mun.;2013;7;243;138;105
Jurbarkas d. mun.;2013;8;268;139;129
Jurbarkas d. mun.;2013;9;307;155;152
Jurbarkas d. mun.;2013;10;270;153;117
Jurbarkas d. mun.;2013;11;299;163;136
Jurbarkas d. mun.;2013;12;311;154;157
Jurbarkas d. mun.;2013;13;376;208;168
Jurbarkas d. mun.;2013;14;351;194;157
Jurbarkas d. mun.;2013;15;369;188;181
Jurbarkas d. mun.;2013;16;391;186;205
Jurbarkas d. mun.;2013;17;420;229;191
Jurbarkas d. mun.;2013;18;463;235;228
Jurbarkas d. mun.;2013;19;484;256;228
Jurbarkas d. mun.;2013;20;501;265;236
Jurbarkas d. mun.;2013;21;419;220;199
Jurbarkas d. mun.;2013;22;376;202;174
Jurbarkas d. mun.;2013;23;353;194;159
Jurbarkas d. mun.;2013;24;312;158;154
Jurbarkas d. mun.;2013;25;356;197;159
Jurbarkas d. mun.;2013;26;327;181;146
Jurbarkas d. mun.;2013;27;319;186;133
Jurbarkas d. mun.;2013;28;251;151;100
Jurbarkas d. mun.;2013;29;240;130;110
Jurbarkas d. mun.;2013;30;246;122;124
Jurbarkas d. mun.;2013;31;225;119;106
Jurbarkas d. mun.;2013;32;275;138;137
Jurbarkas d. mun.;2013;33;257;114;143
Jurbarkas d. mun.;2013;34;294;163;131
Jurbarkas d. mun.;2013;35;265;138;127
Jurbarkas d. mun.;2013;36;327;177;150
Jurbarkas d. mun.;2013;37;310;155;155
Jurbarkas d. mun.;2013;38;334;154;180
Jurbarkas d. mun.;2013;39;329;151;178
Jurbarkas d. mun.;2013;40;376;188;188
Jurbarkas d. mun.;2013;41;418;206;212
Jurbarkas d. mun.;2013;42;376;196;180
Jurbarkas d. mun.;2013;43;487;250;237
Jurbarkas d. mun.;2013;44;420;201;219
Jurbarkas d. mun.;2013;45;459;224;235
Jurbarkas d. mun.;2013;46;418;185;233
Jurbarkas d. mun.;2013;47;434;222;212
Jurbarkas d. mun.;2013;48;450;207;243
Jurbarkas d. mun.;2013;49;435;240;195
Jurbarkas d. mun.;2013;50;508;252;256
Jurbarkas d. mun.;2013;51;495;247;248
Jurbarkas d. mun.;2013;52;495;227;268
Jurbarkas d. mun.;2013;53;473;228;245
Jurbarkas d. mun.;2013;54;494;232;262
Jurbarkas d. mun.;2013;55;413;200;213
Jurbarkas d. mun.;2013;56;384;188;196
Jurbarkas d. mun.;2013;57;424;217;207
Jurbarkas d. mun.;2013;58;388;192;196
Jurbarkas d. mun.;2013;59;327;144;183
Jurbarkas d. mun.;2013;60;367;174;193
Jurbarkas d. mun.;2013;61;398;168;230
Jurbarkas d. mun.;2013;62;358;151;207
Jurbarkas d. mun.;2013;63;368;156;212
Jurbarkas d. mun.;2013;64;314;128;186
Jurbarkas d. mun.;2013;65;298;131;167
Jurbarkas d. mun.;2013;66;280;98;182
Jurbarkas d. mun.;2013;67;290;98;192
Jurbarkas d. mun.;2013;68;277;114;163
Jurbarkas d. mun.;2013;69;335;132;203
Jurbarkas d. mun.;2013;70;355;138;217
Jurbarkas d. mun.;2013;71;355;117;238
Jurbarkas d. mun.;2013;72;266;109;157
Jurbarkas d. mun.;2013;73;304;100;204
Jurbarkas d. mun.;2013;74;282;102;180
Jurbarkas d. mun.;2013;75;282;92;190
Jurbarkas d. mun.;2013;76;270;88;182
Jurbarkas d. mun.;2013;77;244;84;160
Jurbarkas d. mun.;2013;78;254;83;171
Jurbarkas d. mun.;2013;79;238;55;183
Jurbarkas d. mun.;2013;80;227;70;157
Jurbarkas d. mun.;2013;81;239;69;170
Jurbarkas d. mun.;2013;82;218;62;156
Jurbarkas d. mun.;2013;83;199;52;147
Jurbarkas d. mun.;2013;84;157;36;121
Jurbarkas d. mun.;2013;85;671;155;516
Jurbarkas d. mun.;2014;-1;28665;13445;15220
Jurbarkas d. mun.;2014;0;246;138;108
Jurbarkas d. mun.;2014;1;269;128;141
Jurbarkas d. mun.;2014;2;237;146;91
Jurbarkas d. mun.;2014;3;222;116;106
Jurbarkas d. mun.;2014;4;268;131;137
Jurbarkas d. mun.;2014;5;249;133;116
Jurbarkas d. mun.;2014;6;272;139;133
Jurbarkas d. mun.;2014;7;252;125;127
Jurbarkas d. mun.;2014;8;245;138;107
Jurbarkas d. mun.;2014;9;270;142;128
Jurbarkas d. mun.;2014;10;300;151;149
Jurbarkas d. mun.;2014;11;268;152;116
Jurbarkas d. mun.;2014;12;295;162;133
Jurbarkas d. mun.;2014;13;308;152;156
Jurbarkas d. mun.;2014;14;376;208;168
Jurbarkas d. mun.;2014;15;344;189;155
Jurbarkas d. mun.;2014;16;364;186;178
Jurbarkas d. mun.;2014;17;395;188;207
Jurbarkas d. mun.;2014;18;421;229;192
Jurbarkas d. mun.;2014;19;451;232;219
Jurbarkas d. mun.;2014;20;472;251;221
Jurbarkas d. mun.;2014;21;489;260;229
Jurbarkas d. mun.;2014;22;410;220;190
Jurbarkas d. mun.;2014;23;369;200;169
Jurbarkas d. mun.;2014;24;334;191;143
Jurbarkas d. mun.;2014;25;300;152;148
Jurbarkas d. mun.;2014;26;337;187;150
Jurbarkas d. mun.;2014;27;319;171;148
Jurbarkas d. mun.;2014;28;306;180;126
Jurbarkas d. mun.;2014;29;234;140;94
Jurbarkas d. mun.;2014;30;246;135;111
Jurbarkas d. mun.;2014;31;238;117;121
Jurbarkas d. mun.;2014;32;214;112;102
Jurbarkas d. mun.;2014;33;272;141;131
Jurbarkas d. mun.;2014;34;251;108;143
Jurbarkas d. mun.;2014;35;289;163;126
Jurbarkas d. mun.;2014;36;259;133;126
Jurbarkas d. mun.;2014;37;323;174;149
Jurbarkas d. mun.;2014;38;307;156;151
Jurbarkas d. mun.;2014;39;327;156;171
Jurbarkas d. mun.;2014;40;324;149;175
Jurbarkas d. mun.;2014;41;378;190;188
Jurbarkas d. mun.;2014;42;416;207;209
Jurbarkas d. mun.;2014;43;373;196;177
Jurbarkas d. mun.;2014;44;489;250;239
Jurbarkas d. mun.;2014;45;412;196;216
Jurbarkas d. mun.;2014;46;454;219;235
Jurbarkas d. mun.;2014;47;407;181;226
Jurbarkas d. mun.;2014;48;430;220;210
Jurbarkas d. mun.;2014;49;447;204;243
Jurbarkas d. mun.;2014;50;433;238;195
Jurbarkas d. mun.;2014;51;494;243;251
Jurbarkas d. mun.;2014;52;492;245;247
Jurbarkas d. mun.;2014;53;494;227;267
Jurbarkas d. mun.;2014;54;464;222;242
Jurbarkas d. mun.;2014;55;486;226;260
Jurbarkas d. mun.;2014;56;409;198;211
Jurbarkas d. mun.;2014;57;379;186;193
Jurbarkas d. mun.;2014;58;418;213;205
Jurbarkas d. mun.;2014;59;378;184;194
Jurbarkas d. mun.;2014;60;317;139;178
Jurbarkas d. mun.;2014;61;361;168;193
Jurbarkas d. mun.;2014;62;394;165;229
Jurbarkas d. mun.;2014;63;358;149;209
Jurbarkas d. mun.;2014;64;361;154;207
Jurbarkas d. mun.;2014;65;308;125;183
Jurbarkas d. mun.;2014;66;289;123;166
Jurbarkas d. mun.;2014;67;278;96;182
Jurbarkas d. mun.;2014;68;276;91;185
Jurbarkas d. mun.;2014;69;269;107;162
Jurbarkas d. mun.;2014;70;326;127;199
Jurbarkas d. mun.;2014;71;343;130;213
Jurbarkas d. mun.;2014;72;345;113;232
Jurbarkas d. mun.;2014;73;258;103;155
Jurbarkas d. mun.;2014;74;293;96;197
Jurbarkas d. mun.;2014;75;274;98;176
Jurbarkas d. mun.;2014;76;272;88;184
Jurbarkas d. mun.;2014;77;252;78;174
Jurbarkas d. mun.;2014;78;234;80;154
Jurbarkas d. mun.;2014;79;247;82;165
Jurbarkas d. mun.;2014;80;220;50;170
Jurbarkas d. mun.;2014;81;198;58;140
Jurbarkas d. mun.;2014;82;215;60;155
Jurbarkas d. mun.;2014;83;197;51;146
Jurbarkas d. mun.;2014;84;171;43;128
Jurbarkas d. mun.;2014;85;684;145;539
Jurbarkas d. mun.;2015;-1;28162;13242;14920
Jurbarkas d. mun.;2015;0;266;155;111
Jurbarkas d. mun.;2015;1;244;138;106
Jurbarkas d. mun.;2015;2;264;123;141
Jurbarkas d. mun.;2015;3;232;142;90
Jurbarkas d. mun.;2015;4;223;115;108
Jurbarkas d. mun.;2015;5;263;126;137
Jurbarkas d. mun.;2015;6;244;130;114
Jurbarkas d. mun.;2015;7;268;139;129
Jurbarkas d. mun.;2015;8;248;122;126
Jurbarkas d. mun.;2015;9;245;138;107
Jurbarkas d. mun.;2015;10;272;143;129
Jurbarkas d. mun.;2015;11;297;151;146
Jurbarkas d. mun.;2015;12;270;154;116
Jurbarkas d. mun.;2015;13;296;163;133
Jurbarkas d. mun.;2015;14;306;150;156
Jurbarkas d. mun.;2015;15;379;212;167
Jurbarkas d. mun.;2015;16;345;190;155
Jurbarkas d. mun.;2015;17;362;184;178
Jurbarkas d. mun.;2015;18;395;188;207
Jurbarkas d. mun.;2015;19;409;222;187
Jurbarkas d. mun.;2015;20;439;229;210
Jurbarkas d. mun.;2015;21;467;253;214
Jurbarkas d. mun.;2015;22;478;257;221
Jurbarkas d. mun.;2015;23;389;212;177
Jurbarkas d. mun.;2015;24;351;194;157
Jurbarkas d. mun.;2015;25;313;192;121
Jurbarkas d. mun.;2015;26;286;146;140
Jurbarkas d. mun.;2015;27;316;176;140
Jurbarkas d. mun.;2015;28;298;156;142
Jurbarkas d. mun.;2015;29;290;173;117
Jurbarkas d. mun.;2015;30;220;132;88
Jurbarkas d. mun.;2015;31;233;127;106
Jurbarkas d. mun.;2015;32;225;111;114
Jurbarkas d. mun.;2015;33;214;111;103
Jurbarkas d. mun.;2015;34;266;139;127
Jurbarkas d. mun.;2015;35;251;111;140
Jurbarkas d. mun.;2015;36;285;163;122
Jurbarkas d. mun.;2015;37;259;133;126
Jurbarkas d. mun.;2015;38;309;168;141
Jurbarkas d. mun.;2015;39;308;155;153
Jurbarkas d. mun.;2015;40;325;153;172
Jurbarkas d. mun.;2015;41;320;145;175
Jurbarkas d. mun.;2015;42;376;190;186
Jurbarkas d. mun.;2015;43;412;209;203
Jurbarkas d. mun.;2015;44;373;192;181
Jurbarkas d. mun.;2015;45;487;248;239
Jurbarkas d. mun.;2015;46;401;187;214
Jurbarkas d. mun.;2015;47;451;217;234
Jurbarkas d. mun.;2015;48;412;183;229
Jurbarkas d. mun.;2015;49;427;221;206
Jurbarkas d. mun.;2015;50;446;200;246
Jurbarkas d. mun.;2015;51;433;240;193
Jurbarkas d. mun.;2015;52;489;242;247
Jurbarkas d. mun.;2015;53;483;242;241
Jurbarkas d. mun.;2015;54;490;226;264
Jurbarkas d. mun.;2015;55;454;214;240
Jurbarkas d. mun.;2015;56;477;220;257
Jurbarkas d. mun.;2015;57;404;193;211
Jurbarkas d. mun.;2015;58;375;183;192
Jurbarkas d. mun.;2015;59;407;205;202
Jurbarkas d. mun.;2015;60;368;178;190
Jurbarkas d. mun.;2015;61;313;136;177
Jurbarkas d. mun.;2015;62;352;162;190
Jurbarkas d. mun.;2015;63;388;158;230
Jurbarkas d. mun.;2015;64;353;145;208
Jurbarkas d. mun.;2015;65;352;149;203
Jurbarkas d. mun.;2015;66;298;118;180
Jurbarkas d. mun.;2015;67;283;118;165
Jurbarkas d. mun.;2015;68;274;94;180
Jurbarkas d. mun.;2015;69;268;86;182
Jurbarkas d. mun.;2015;70;261;102;159
Jurbarkas d. mun.;2015;71;313;119;194
Jurbarkas d. mun.;2015;72;331;124;207
Jurbarkas d. mun.;2015;73;339;110;229
Jurbarkas d. mun.;2015;74;246;97;149
Jurbarkas d. mun.;2015;75;282;90;192
Jurbarkas d. mun.;2015;76;266;91;175
Jurbarkas d. mun.;2015;77;256;78;178
Jurbarkas d. mun.;2015;78;233;65;168
Jurbarkas d. mun.;2015;79;223;75;148
Jurbarkas d. mun.;2015;80;226;70;156
Jurbarkas d. mun.;2015;81;201;45;156
Jurbarkas d. mun.;2015;82;182;52;130
Jurbarkas d. mun.;2015;83;200;50;150
Jurbarkas d. mun.;2015;84;171;40;131
Jurbarkas d. mun.;2015;85;716;157;559
Jurbarkas d. mun.;2016;-1;27565;12957;14608
Jurbarkas d. mun.;2016;0;270;137;133
Jurbarkas d. mun.;2016;1;260;151;109
Jurbarkas d. mun.;2016;2;241;137;104
Jurbarkas d. mun.;2016;3;262;121;141
Jurbarkas d. mun.;2016;4;225;137;88
Jurbarkas d. mun.;2016;5;218;110;108
Jurbarkas d. mun.;2016;6;256;124;132
Jurbarkas d. mun.;2016;7;233;127;106
Jurbarkas d. mun.;2016;8;262;134;128
Jurbarkas d. mun.;2016;9;248;124;124
Jurbarkas d. mun.;2016;10;242;136;106
Jurbarkas d. mun.;2016;11;266;137;129
Jurbarkas d. mun.;2016;12;301;152;149
Jurbarkas d. mun.;2016;13;271;154;117
Jurbarkas d. mun.;2016;14;295;165;130
Jurbarkas d. mun.;2016;15;305;152;153
Jurbarkas d. mun.;2016;16;376;211;165
Jurbarkas d. mun.;2016;17;344;191;153
Jurbarkas d. mun.;2016;18;357;182;175
Jurbarkas d. mun.;2016;19;382;182;200
Jurbarkas d. mun.;2016;20;400;214;186
Jurbarkas d. mun.;2016;21;427;225;202
Jurbarkas d. mun.;2016;22;445;245;200
Jurbarkas d. mun.;2016;23;447;237;210
Jurbarkas d. mun.;2016;24;376;203;173
Jurbarkas d. mun.;2016;25;327;184;143
Jurbarkas d. mun.;2016;26;308;180;128
Jurbarkas d. mun.;2016;27;271;138;133
Jurbarkas d. mun.;2016;28;302;174;128
Jurbarkas d. mun.;2016;29;271;144;127
Jurbarkas d. mun.;2016;30;275;171;104
Jurbarkas d. mun.;2016;31;214;130;84
Jurbarkas d. mun.;2016;32;224;122;102
Jurbarkas d. mun.;2016;33;214;104;110
Jurbarkas d. mun.;2016;34;213;109;104
Jurbarkas d. mun.;2016;35;260;133;127
Jurbarkas d. mun.;2016;36;250;108;142
Jurbarkas d. mun.;2016;37;273;157;116
Jurbarkas d. mun.;2016;38;249;128;121
Jurbarkas d. mun.;2016;39;305;167;138
Jurbarkas d. mun.;2016;40;303;153;150
Jurbarkas d. mun.;2016;41;319;150;169
Jurbarkas d. mun.;2016;42;317;144;173
Jurbarkas d. mun.;2016;43;375;189;186
Jurbarkas d. mun.;2016;44;411;209;202
Jurbarkas d. mun.;2016;45;365;189;176
Jurbarkas d. mun.;2016;46;484;248;236
Jurbarkas d. mun.;2016;47;397;183;214
Jurbarkas d. mun.;2016;48;444;212;232
Jurbarkas d. mun.;2016;49;407;182;225
Jurbarkas d. mun.;2016;50;416;212;204
Jurbarkas d. mun.;2016;51;441;194;247
Jurbarkas d. mun.;2016;52;434;241;193
Jurbarkas d. mun.;2016;53;485;237;248
Jurbarkas d. mun.;2016;54;472;233;239
Jurbarkas d. mun.;2016;55;479;219;260
Jurbarkas d. mun.;2016;56;443;208;235
Jurbarkas d. mun.;2016;57;467;216;251
Jurbarkas d. mun.;2016;58;398;190;208
Jurbarkas d. mun.;2016;59;373;182;191
Jurbarkas d. mun.;2016;60;397;198;199
Jurbarkas d. mun.;2016;61;357;167;190
Jurbarkas d. mun.;2016;62;309;134;175
Jurbarkas d. mun.;2016;63;345;158;187
Jurbarkas d. mun.;2016;64;381;156;225
Jurbarkas d. mun.;2016;65;344;139;205
Jurbarkas d. mun.;2016;66;344;144;200
Jurbarkas d. mun.;2016;67;291;114;177
Jurbarkas d. mun.;2016;68;269;108;161
Jurbarkas d. mun.;2016;69;266;92;174
Jurbarkas d. mun.;2016;70;257;77;180
Jurbarkas d. mun.;2016;71;253;100;153
Jurbarkas d. mun.;2016;72;303;113;190
Jurbarkas d. mun.;2016;73;327;121;206
Jurbarkas d. mun.;2016;74;328;105;223
Jurbarkas d. mun.;2016;75;235;91;144
Jurbarkas d. mun.;2016;76;266;82;184
Jurbarkas d. mun.;2016;77;247;84;163
Jurbarkas d. mun.;2016;78;241;70;171
Jurbarkas d. mun.;2016;79;221;60;161
Jurbarkas d. mun.;2016;80;209;67;142
Jurbarkas d. mun.;2016;81;206;60;146
Jurbarkas d. mun.;2016;82;182;37;145
Jurbarkas d. mun.;2016;83;168;48;120
Jurbarkas d. mun.;2016;84;184;47;137
Jurbarkas d. mun.;2016;85;740;157;583
Jurbarkas d. mun.;2017;-1;26800;12619;14181
Jurbarkas d. mun.;2017;0;266;150;116
Jurbarkas d. mun.;2017;1;263;133;130
Jurbarkas d. mun.;2017;2;258;147;111
Jurbarkas d. mun.;2017;3;237;135;102
Jurbarkas d. mun.;2017;4;255;114;141
Jurbarkas d. mun.;2017;5;222;135;87
Jurbarkas d. mun.;2017;6;216;110;106
Jurbarkas d. mun.;2017;7;255;124;131
Jurbarkas d. mun.;2017;8;234;127;107
Jurbarkas d. mun.;2017;9;261;134;127
Jurbarkas d. mun.;2017;10;251;125;126
Jurbarkas d. mun.;2017;11;237;131;106
Jurbarkas d. mun.;2017;12;267;137;130
Jurbarkas d. mun.;2017;13;298;149;149
Jurbarkas d. mun.;2017;14;270;152;118
Jurbarkas d. mun.;2017;15;294;166;128
Jurbarkas d. mun.;2017;16;299;150;149
Jurbarkas d. mun.;2017;17;372;210;162
Jurbarkas d. mun.;2017;18;339;190;149
Jurbarkas d. mun.;2017;19;351;179;172
Jurbarkas d. mun.;2017;20;375;178;197
Jurbarkas d. mun.;2017;21;384;211;173
Jurbarkas d. mun.;2017;22;420;224;196
Jurbarkas d. mun.;2017;23;421;240;181
Jurbarkas d. mun.;2017;24;414;228;186
Jurbarkas d. mun.;2017;25;356;195;161
Jurbarkas d. mun.;2017;26;291;173;118
Jurbarkas d. mun.;2017;27;276;166;110
Jurbarkas d. mun.;2017;28;236;123;113
Jurbarkas d. mun.;2017;29;274;162;112
Jurbarkas d. mun.;2017;30;245;124;121
Jurbarkas d. mun.;2017;31;249;160;89
Jurbarkas d. mun.;2017;32;183;114;69
Jurbarkas d. mun.;2017;33;208;114;94
Jurbarkas d. mun.;2017;34;196;92;104
Jurbarkas d. mun.;2017;35;202;96;106
Jurbarkas d. mun.;2017;36;251;128;123
Jurbarkas d. mun.;2017;37;232;96;136
Jurbarkas d. mun.;2017;38;263;154;109
Jurbarkas d. mun.;2017;39;242;128;114
Jurbarkas d. mun.;2017;40;304;165;139
Jurbarkas d. mun.;2017;41;295;149;146
Jurbarkas d. mun.;2017;42;315;147;168
Jurbarkas d. mun.;2017;43;314;139;175
Jurbarkas d. mun.;2017;44;367;189;178
Jurbarkas d. mun.;2017;45;407;209;198
Jurbarkas d. mun.;2017;46;360;184;176
Jurbarkas d. mun.;2017;47;476;242;234
Jurbarkas d. mun.;2017;48;397;184;213
Jurbarkas d. mun.;2017;49;433;207;226
Jurbarkas d. mun.;2017;50;400;177;223
Jurbarkas d. mun.;2017;51;412;210;202
Jurbarkas d. mun.;2017;52;427;191;236
Jurbarkas d. mun.;2017;53;423;233;190
Jurbarkas d. mun.;2017;54;477;230;247
Jurbarkas d. mun.;2017;55;461;230;231
Jurbarkas d. mun.;2017;56;469;211;258
Jurbarkas d. mun.;2017;57;434;202;232
Jurbarkas d. mun.;2017;58;459;209;250
Jurbarkas d. mun.;2017;59;385;181;204
Jurbarkas d. mun.;2017;60;365;177;188
Jurbarkas d. mun.;2017;61;388;191;197
Jurbarkas d. mun.;2017;62;349;162;187
Jurbarkas d. mun.;2017;63;305;130;175
Jurbarkas d. mun.;2017;64;336;151;185
Jurbarkas d. mun.;2017;65;373;152;221
Jurbarkas d. mun.;2017;66;336;139;197
Jurbarkas d. mun.;2017;67;330;134;196
Jurbarkas d. mun.;2017;68;288;112;176
Jurbarkas d. mun.;2017;69;263;103;160
Jurbarkas d. mun.;2017;70;259;87;172
Jurbarkas d. mun.;2017;71;251;73;178
Jurbarkas d. mun.;2017;72;241;97;144
Jurbarkas d. mun.;2017;73;296;110;186
Jurbarkas d. mun.;2017;74;318;115;203
Jurbarkas d. mun.;2017;75;309;95;214
Jurbarkas d. mun.;2017;76;222;84;138
Jurbarkas d. mun.;2017;77;260;77;183
Jurbarkas d. mun.;2017;78;235;78;157
Jurbarkas d. mun.;2017;79;225;61;164
Jurbarkas d. mun.;2017;80;206;55;151
Jurbarkas d. mun.;2017;81;190;57;133
Jurbarkas d. mun.;2017;82;190;56;134
Jurbarkas d. mun.;2017;83;168;32;136
Jurbarkas d. mun.;2017;84;157;41;116
Jurbarkas d. mun.;2017;85;762;157;605
Jurbarkas d. mun.;2018;-1;26043;12250;13793
Jurbarkas d. mun.;2018;0;242;130;112
Jurbarkas d. mun.;2018;1;265;146;119
Jurbarkas d. mun.;2018;2;254;130;124
Jurbarkas d. mun.;2018;3;258;147;111
Jurbarkas d. mun.;2018;4;231;133;98
Jurbarkas d. mun.;2018;5;253;116;137
Jurbarkas d. mun.;2018;6;218;134;84
Jurbarkas d. mun.;2018;7;212;103;109
Jurbarkas d. mun.;2018;8;253;120;133
Jurbarkas d. mun.;2018;9;233;129;104
Jurbarkas d. mun.;2018;10;260;129;131
Jurbarkas d. mun.;2018;11;247;125;122
Jurbarkas d. mun.;2018;12;231;128;103
Jurbarkas d. mun.;2018;13;267;136;131
Jurbarkas d. mun.;2018;14;291;143;148
Jurbarkas d. mun.;2018;15;269;153;116
Jurbarkas d. mun.;2018;16;288;164;124
Jurbarkas d. mun.;2018;17;299;151;148
Jurbarkas d. mun.;2018;18;365;206;159
Jurbarkas d. mun.;2018;19;319;180;139
Jurbarkas d. mun.;2018;20;333;170;163
Jurbarkas d. mun.;2018;21;350;171;179
Jurbarkas d. mun.;2018;22;366;199;167
Jurbarkas d. mun.;2018;23;392;210;182
Jurbarkas d. mun.;2018;24;392;227;165
Jurbarkas d. mun.;2018;25;382;209;173
Jurbarkas d. mun.;2018;26;318;185;133
Jurbarkas d. mun.;2018;27;269;159;110
Jurbarkas d. mun.;2018;28;251;154;97
Jurbarkas d. mun.;2018;29;203;111;92
Jurbarkas d. mun.;2018;30;259;150;109
Jurbarkas d. mun.;2018;31;224;113;111
Jurbarkas d. mun.;2018;32;224;145;79
Jurbarkas d. mun.;2018;33;171;111;60
Jurbarkas d. mun.;2018;34;191;103;88
Jurbarkas d. mun.;2018;35;186;84;102
Jurbarkas d. mun.;2018;36;193;86;107
Jurbarkas d. mun.;2018;37;242;124;118
Jurbarkas d. mun.;2018;38;225;89;136
Jurbarkas d. mun.;2018;39;250;143;107
Jurbarkas d. mun.;2018;40;239;125;114
Jurbarkas d. mun.;2018;41;298;162;136
Jurbarkas d. mun.;2018;42;292;145;147
Jurbarkas d. mun.;2018;43;311;147;164
Jurbarkas d. mun.;2018;44;305;134;171
Jurbarkas d. mun.;2018;45;371;190;181
Jurbarkas d. mun.;2018;46;407;206;201
Jurbarkas d. mun.;2018;47;354;185;169
Jurbarkas d. mun.;2018;48;469;242;227
Jurbarkas d. mun.;2018;49;387;182;205
Jurbarkas d. mun.;2018;50;423;200;223
Jurbarkas d. mun.;2018;51;400;176;224
Jurbarkas d. mun.;2018;52;409;208;201
Jurbarkas d. mun.;2018;53;426;190;236
Jurbarkas d. mun.;2018;54;417;226;191
Jurbarkas d. mun.;2018;55;462;220;242
Jurbarkas d. mun.;2018;56;452;220;232
Jurbarkas d. mun.;2018;57;459;205;254
Jurbarkas d. mun.;2018;58;425;197;228
Jurbarkas d. mun.;2018;59;451;202;249
Jurbarkas d. mun.;2018;60;383;180;203
Jurbarkas d. mun.;2018;61;357;172;185
Jurbarkas d. mun.;2018;62;382;185;197
Jurbarkas d. mun.;2018;63;344;160;184
Jurbarkas d. mun.;2018;64;297;126;171
Jurbarkas d. mun.;2018;65;329;146;183
Jurbarkas d. mun.;2018;66;365;146;219
Jurbarkas d. mun.;2018;67;325;132;193
Jurbarkas d. mun.;2018;68;324;130;194
Jurbarkas d. mun.;2018;69;286;110;176
Jurbarkas d. mun.;2018;70;258;98;160
Jurbarkas d. mun.;2018;71;255;85;170
Jurbarkas d. mun.;2018;72;248;72;176
Jurbarkas d. mun.;2018;73;225;85;140
Jurbarkas d. mun.;2018;74;282;99;183
Jurbarkas d. mun.;2018;75;301;108;193
Jurbarkas d. mun.;2018;76;296;86;210
Jurbarkas d. mun.;2018;77;214;79;135
Jurbarkas d. mun.;2018;78;244;66;178
Jurbarkas d. mun.;2018;79;217;72;145
Jurbarkas d. mun.;2018;80;218;58;160
Jurbarkas d. mun.;2018;81;195;51;144
Jurbarkas d. mun.;2018;82;175;53;122
Jurbarkas d. mun.;2018;83;175;51;124
Jurbarkas d. mun.;2018;84;159;32;127
Jurbarkas d. mun.;2018;85;756;160;596
Kaišiadorys d. mun.;2001;-1;37632;18583;19049
Kaišiadorys d. mun.;2001;0;366;192;174
Kaišiadorys d. mun.;2001;1;393;179;214
Kaišiadorys d. mun.;2001;2;397;190;207
Kaišiadorys d. mun.;2001;3;441;226;215
Kaišiadorys d. mun.;2001;4;377;202;175
Kaišiadorys d. mun.;2001;5;466;228;238
Kaišiadorys d. mun.;2001;6;434;221;213
Kaišiadorys d. mun.;2001;7;502;247;255
Kaišiadorys d. mun.;2001;8;578;288;290
Kaišiadorys d. mun.;2001;9;543;251;292
Kaišiadorys d. mun.;2001;10;555;284;271
Kaišiadorys d. mun.;2001;11;533;271;262
Kaišiadorys d. mun.;2001;12;551;300;251
Kaišiadorys d. mun.;2001;13;569;273;296
Kaišiadorys d. mun.;2001;14;588;294;294
Kaišiadorys d. mun.;2001;15;565;325;240
Kaišiadorys d. mun.;2001;16;581;305;276
Kaišiadorys d. mun.;2001;17;548;270;278
Kaišiadorys d. mun.;2001;18;434;234;200
Kaišiadorys d. mun.;2001;19;420;271;149
Kaišiadorys d. mun.;2001;20;507;317;190
Kaišiadorys d. mun.;2001;21;509;340;169
Kaišiadorys d. mun.;2001;22;546;350;196
Kaišiadorys d. mun.;2001;23;518;331;187
Kaišiadorys d. mun.;2001;24;520;327;193
Kaišiadorys d. mun.;2001;25;514;316;198
Kaišiadorys d. mun.;2001;26;540;296;244
Kaišiadorys d. mun.;2001;27;467;266;201
Kaišiadorys d. mun.;2001;28;512;286;226
Kaišiadorys d. mun.;2001;29;561;309;252
Kaišiadorys d. mun.;2001;30;576;321;255
Kaišiadorys d. mun.;2001;31;507;282;225
Kaišiadorys d. mun.;2001;32;515;265;250
Kaišiadorys d. mun.;2001;33;551;300;251
Kaišiadorys d. mun.;2001;34;537;273;264
Kaišiadorys d. mun.;2001;35;506;281;225
Kaišiadorys d. mun.;2001;36;508;275;233
Kaišiadorys d. mun.;2001;37;530;297;233
Kaišiadorys d. mun.;2001;38;574;317;257
Kaišiadorys d. mun.;2001;39;625;337;288
Kaišiadorys d. mun.;2001;40;569;308;261
Kaišiadorys d. mun.;2001;41;557;283;274
Kaišiadorys d. mun.;2001;42;533;264;269
Kaišiadorys d. mun.;2001;43;511;251;260
Kaišiadorys d. mun.;2001;44;496;262;234
Kaišiadorys d. mun.;2001;45;528;269;259
Kaišiadorys d. mun.;2001;46;469;231;238
Kaišiadorys d. mun.;2001;47;398;190;208
Kaišiadorys d. mun.;2001;48;419;228;191
Kaišiadorys d. mun.;2001;49;446;231;215
Kaišiadorys d. mun.;2001;50;429;203;226
Kaišiadorys d. mun.;2001;51;508;239;269
Kaišiadorys d. mun.;2001;52;453;223;230
Kaišiadorys d. mun.;2001;53;349;158;191
Kaišiadorys d. mun.;2001;54;332;162;170
Kaišiadorys d. mun.;2001;55;440;205;235
Kaišiadorys d. mun.;2001;56;299;147;152
Kaišiadorys d. mun.;2001;57;455;203;252
Kaišiadorys d. mun.;2001;58;473;218;255
Kaišiadorys d. mun.;2001;59;401;196;205
Kaišiadorys d. mun.;2001;60;391;175;216
Kaišiadorys d. mun.;2001;61;407;184;223
Kaišiadorys d. mun.;2001;62;433;190;243
Kaišiadorys d. mun.;2001;63;391;158;233
Kaišiadorys d. mun.;2001;64;407;200;207
Kaišiadorys d. mun.;2001;65;378;160;218
Kaišiadorys d. mun.;2001;66;373;155;218
Kaišiadorys d. mun.;2001;67;403;152;251
Kaišiadorys d. mun.;2001;68;404;149;255
Kaišiadorys d. mun.;2001;69;399;152;247
Kaišiadorys d. mun.;2001;70;381;134;247
Kaišiadorys d. mun.;2001;71;340;111;229
Kaišiadorys d. mun.;2001;72;361;115;246
Kaišiadorys d. mun.;2001;73;370;129;241
Kaišiadorys d. mun.;2001;74;316;97;219
Kaišiadorys d. mun.;2001;75;304;99;205
Kaišiadorys d. mun.;2001;76;265;66;199
Kaišiadorys d. mun.;2001;77;263;84;179
Kaišiadorys d. mun.;2001;78;207;64;143
Kaišiadorys d. mun.;2001;79;224;67;157
Kaišiadorys d. mun.;2001;80;148;39;109
Kaišiadorys d. mun.;2001;81;150;37;113
Kaišiadorys d. mun.;2001;82;84;25;59
Kaišiadorys d. mun.;2001;83;92;32;60
Kaišiadorys d. mun.;2001;84;94;30;64
Kaišiadorys d. mun.;2001;85;518;171;347
Kaišiadorys d. mun.;2002;-1;37438;18559;18879
Kaišiadorys d. mun.;2002;0;342;177;165
Kaišiadorys d. mun.;2002;1;363;194;169
Kaišiadorys d. mun.;2002;2;398;183;215
Kaišiadorys d. mun.;2002;3;402;194;208
Kaišiadorys d. mun.;2002;4;444;229;215
Kaišiadorys d. mun.;2002;5;381;206;175
Kaišiadorys d. mun.;2002;6;464;227;237
Kaišiadorys d. mun.;2002;7;434;226;208
Kaišiadorys d. mun.;2002;8;500;248;252
Kaišiadorys d. mun.;2002;9;575;286;289
Kaišiadorys d. mun.;2002;10;545;254;291
Kaišiadorys d. mun.;2002;11;553;284;269
Kaišiadorys d. mun.;2002;12;527;269;258
Kaišiadorys d. mun.;2002;13;544;298;246
Kaišiadorys d. mun.;2002;14;567;275;292
Kaišiadorys d. mun.;2002;15;582;291;291
Kaišiadorys d. mun.;2002;16;564;327;237
Kaišiadorys d. mun.;2002;17;577;303;274
Kaišiadorys d. mun.;2002;18;544;270;274
Kaišiadorys d. mun.;2002;19;425;230;195
Kaišiadorys d. mun.;2002;20;407;263;144
Kaišiadorys d. mun.;2002;21;499;311;188
Kaišiadorys d. mun.;2002;22;504;338;166
Kaišiadorys d. mun.;2002;23;545;349;196
Kaišiadorys d. mun.;2002;24;505;323;182
Kaišiadorys d. mun.;2002;25;527;330;197
Kaišiadorys d. mun.;2002;26;508;312;196
Kaišiadorys d. mun.;2002;27;537;293;244
Kaišiadorys d. mun.;2002;28;464;261;203
Kaišiadorys d. mun.;2002;29;503;281;222
Kaišiadorys d. mun.;2002;30;556;306;250
Kaišiadorys d. mun.;2002;31;565;317;248
Kaišiadorys d. mun.;2002;32;503;279;224
Kaišiadorys d. mun.;2002;33;514;265;249
Kaišiadorys d. mun.;2002;34;544;294;250
Kaišiadorys d. mun.;2002;35;530;269;261
Kaišiadorys d. mun.;2002;36;501;279;222
Kaišiadorys d. mun.;2002;37;505;275;230
Kaišiadorys d. mun.;2002;38;523;296;227
Kaišiadorys d. mun.;2002;39;568;314;254
Kaišiadorys d. mun.;2002;40;614;329;285
Kaišiadorys d. mun.;2002;41;563;303;260
Kaišiadorys d. mun.;2002;42;553;283;270
Kaišiadorys d. mun.;2002;43;532;265;267
Kaišiadorys d. mun.;2002;44;508;251;257
Kaišiadorys d. mun.;2002;45;483;256;227
Kaišiadorys d. mun.;2002;46;530;271;259
Kaišiadorys d. mun.;2002;47;465;231;234
Kaišiadorys d. mun.;2002;48;393;190;203
Kaišiadorys d. mun.;2002;49;410;225;185
Kaišiadorys d. mun.;2002;50;442;226;216
Kaišiadorys d. mun.;2002;51;420;199;221
Kaišiadorys d. mun.;2002;52;505;238;267
Kaišiadorys d. mun.;2002;53;452;224;228
Kaišiadorys d. mun.;2002;54;346;156;190
Kaišiadorys d. mun.;2002;55;328;160;168
Kaišiadorys d. mun.;2002;56;432;200;232
Kaišiadorys d. mun.;2002;57;294;148;146
Kaišiadorys d. mun.;2002;58;448;200;248
Kaišiadorys d. mun.;2002;59;463;212;251
Kaišiadorys d. mun.;2002;60;396;193;203
Kaišiadorys d. mun.;2002;61;389;174;215
Kaišiadorys d. mun.;2002;62;411;190;221
Kaišiadorys d. mun.;2002;63;432;188;244
Kaišiadorys d. mun.;2002;64;390;161;229
Kaišiadorys d. mun.;2002;65;404;200;204
Kaišiadorys d. mun.;2002;66;368;156;212
Kaišiadorys d. mun.;2002;67;361;146;215
Kaišiadorys d. mun.;2002;68;399;151;248
Kaišiadorys d. mun.;2002;69;393;144;249
Kaišiadorys d. mun.;2002;70;395;152;243
Kaišiadorys d. mun.;2002;71;384;135;249
Kaišiadorys d. mun.;2002;72;334;106;228
Kaišiadorys d. mun.;2002;73;347;111;236
Kaišiadorys d. mun.;2002;74;366;123;243
Kaišiadorys d. mun.;2002;75;304;92;212
Kaišiadorys d. mun.;2002;76;290;95;195
Kaišiadorys d. mun.;2002;77;254;62;192
Kaišiadorys d. mun.;2002;78;247;74;173
Kaišiadorys d. mun.;2002;79;201;63;138
Kaišiadorys d. mun.;2002;80;210;61;149
Kaišiadorys d. mun.;2002;81;140;39;101
Kaišiadorys d. mun.;2002;82;141;34;107
Kaišiadorys d. mun.;2002;83;77;26;51
Kaišiadorys d. mun.;2002;84;85;31;54
Kaišiadorys d. mun.;2002;85;500;159;341
Kaišiadorys d. mun.;2003;-1;37394;18563;18831
Kaišiadorys d. mun.;2003;0;333;190;143
Kaišiadorys d. mun.;2003;1;346;182;164
Kaišiadorys d. mun.;2003;2;366;194;172
Kaišiadorys d. mun.;2003;3;400;182;218
Kaišiadorys d. mun.;2003;4;415;204;211
Kaišiadorys d. mun.;2003;5;448;229;219
Kaišiadorys d. mun.;2003;6;384;210;174
Kaišiadorys d. mun.;2003;7;466;229;237
Kaišiadorys d. mun.;2003;8;435;228;207
Kaišiadorys d. mun.;2003;9;499;248;251
Kaišiadorys d. mun.;2003;10;581;295;286
Kaišiadorys d. mun.;2003;11;540;253;287
Kaišiadorys d. mun.;2003;12;556;287;269
Kaišiadorys d. mun.;2003;13;523;266;257
Kaišiadorys d. mun.;2003;14;545;299;246
Kaišiadorys d. mun.;2003;15;561;273;288
Kaišiadorys d. mun.;2003;16;576;288;288
Kaišiadorys d. mun.;2003;17;558;325;233
Kaišiadorys d. mun.;2003;18;571;298;273
Kaišiadorys d. mun.;2003;19;540;267;273
Kaišiadorys d. mun.;2003;20;415;222;193
Kaišiadorys d. mun.;2003;21;417;268;149
Kaišiadorys d. mun.;2003;22;503;314;189
Kaišiadorys d. mun.;2003;23;506;333;173
Kaišiadorys d. mun.;2003;24;538;343;195
Kaišiadorys d. mun.;2003;25;507;322;185
Kaišiadorys d. mun.;2003;26;525;330;195
Kaišiadorys d. mun.;2003;27;505;307;198
Kaišiadorys d. mun.;2003;28;536;292;244
Kaišiadorys d. mun.;2003;29;451;256;195
Kaišiadorys d. mun.;2003;30;499;278;221
Kaišiadorys d. mun.;2003;31;563;310;253
Kaišiadorys d. mun.;2003;32;567;319;248
Kaišiadorys d. mun.;2003;33;501;277;224
Kaišiadorys d. mun.;2003;34;519;270;249
Kaišiadorys d. mun.;2003;35;541;292;249
Kaišiadorys d. mun.;2003;36;530;270;260
Kaišiadorys d. mun.;2003;37;500;278;222
Kaišiadorys d. mun.;2003;38;501;275;226
Kaišiadorys d. mun.;2003;39;519;296;223
Kaišiadorys d. mun.;2003;40;571;315;256
Kaišiadorys d. mun.;2003;41;611;329;282
Kaišiadorys d. mun.;2003;42;558;299;259
Kaišiadorys d. mun.;2003;43;548;278;270
Kaišiadorys d. mun.;2003;44;536;270;266
Kaišiadorys d. mun.;2003;45;511;252;259
Kaišiadorys d. mun.;2003;46;477;250;227
Kaišiadorys d. mun.;2003;47;532;272;260
Kaišiadorys d. mun.;2003;48;462;227;235
Kaišiadorys d. mun.;2003;49;395;192;203
Kaišiadorys d. mun.;2003;50;406;220;186
Kaišiadorys d. mun.;2003;51;441;227;214
Kaišiadorys d. mun.;2003;52;419;198;221
Kaišiadorys d. mun.;2003;53;502;236;266
Kaišiadorys d. mun.;2003;54;449;218;231
Kaišiadorys d. mun.;2003;55;339;152;187
Kaišiadorys d. mun.;2003;56;334;166;168
Kaišiadorys d. mun.;2003;57;429;197;232
Kaišiadorys d. mun.;2003;58;292;147;145
Kaišiadorys d. mun.;2003;59;447;200;247
Kaišiadorys d. mun.;2003;60;461;210;251
Kaišiadorys d. mun.;2003;61;395;195;200
Kaišiadorys d. mun.;2003;62;390;173;217
Kaišiadorys d. mun.;2003;63;415;192;223
Kaišiadorys d. mun.;2003;64;430;191;239
Kaišiadorys d. mun.;2003;65;394;161;233
Kaišiadorys d. mun.;2003;66;395;189;206
Kaišiadorys d. mun.;2003;67;359;149;210
Kaišiadorys d. mun.;2003;68;351;139;212
Kaišiadorys d. mun.;2003;69;387;146;241
Kaišiadorys d. mun.;2003;70;391;144;247
Kaišiadorys d. mun.;2003;71;385;146;239
Kaišiadorys d. mun.;2003;72;371;124;247
Kaišiadorys d. mun.;2003;73;324;102;222
Kaišiadorys d. mun.;2003;74;329;103;226
Kaišiadorys d. mun.;2003;75;357;118;239
Kaišiadorys d. mun.;2003;76;289;83;206
Kaišiadorys d. mun.;2003;77;279;92;187
Kaišiadorys d. mun.;2003;78;242;57;185
Kaišiadorys d. mun.;2003;79;230;64;166
Kaišiadorys d. mun.;2003;80;179;57;122
Kaišiadorys d. mun.;2003;81;194;51;143
Kaišiadorys d. mun.;2003;82;129;35;94
Kaišiadorys d. mun.;2003;83;134;31;103
Kaišiadorys d. mun.;2003;84;69;24;45
Kaišiadorys d. mun.;2003;85;470;143;327
Kaišiadorys d. mun.;2004;-1;37117;18463;18654
Kaišiadorys d. mun.;2004;0;323;151;172
Kaišiadorys d. mun.;2004;1;331;190;141
Kaišiadorys d. mun.;2004;2;347;180;167
Kaišiadorys d. mun.;2004;3;367;196;171
Kaišiadorys d. mun.;2004;4;401;185;216
Kaišiadorys d. mun.;2004;5;420;208;212
Kaišiadorys d. mun.;2004;6;450;231;219
Kaišiadorys d. mun.;2004;7;391;213;178
Kaišiadorys d. mun.;2004;8;466;229;237
Kaišiadorys d. mun.;2004;9;437;229;208
Kaišiadorys d. mun.;2004;10;498;250;248
Kaišiadorys d. mun.;2004;11;581;296;285
Kaišiadorys d. mun.;2004;12;544;257;287
Kaišiadorys d. mun.;2004;13;555;292;263
Kaišiadorys d. mun.;2004;14;512;264;248
Kaišiadorys d. mun.;2004;15;539;298;241
Kaišiadorys d. mun.;2004;16;552;269;283
Kaišiadorys d. mun.;2004;17;571;287;284
Kaišiadorys d. mun.;2004;18;545;321;224
Kaišiadorys d. mun.;2004;19;559;293;266
Kaišiadorys d. mun.;2004;20;530;264;266
Kaišiadorys d. mun.;2004;21;407;218;189
Kaišiadorys d. mun.;2004;22;413;267;146
Kaišiadorys d. mun.;2004;23;486;305;181
Kaišiadorys d. mun.;2004;24;490;328;162
Kaišiadorys d. mun.;2004;25;526;337;189
Kaišiadorys d. mun.;2004;26;498;315;183
Kaišiadorys d. mun.;2004;27;509;327;182
Kaišiadorys d. mun.;2004;28;496;301;195
Kaišiadorys d. mun.;2004;29;531;292;239
Kaišiadorys d. mun.;2004;30;439;248;191
Kaišiadorys d. mun.;2004;31;482;263;219
Kaišiadorys d. mun.;2004;32;550;299;251
Kaišiadorys d. mun.;2004;33;558;315;243
Kaišiadorys d. mun.;2004;34;500;277;223
Kaišiadorys d. mun.;2004;35;512;263;249
Kaišiadorys d. mun.;2004;36;543;299;244
Kaišiadorys d. mun.;2004;37;520;266;254
Kaišiadorys d. mun.;2004;38;492;273;219
Kaišiadorys d. mun.;2004;39;503;280;223
Kaišiadorys d. mun.;2004;40;516;295;221
Kaišiadorys d. mun.;2004;41;565;314;251
Kaišiadorys d. mun.;2004;42;604;324;280
Kaišiadorys d. mun.;2004;43;556;300;256
Kaišiadorys d. mun.;2004;44;547;277;270
Kaišiadorys d. mun.;2004;45;541;276;265
Kaišiadorys d. mun.;2004;46;510;252;258
Kaišiadorys d. mun.;2004;47;472;246;226
Kaišiadorys d. mun.;2004;48;520;264;256
Kaišiadorys d. mun.;2004;49;462;230;232
Kaišiadorys d. mun.;2004;50;392;193;199
Kaišiadorys d. mun.;2004;51;399;218;181
Kaišiadorys d. mun.;2004;52;434;223;211
Kaišiadorys d. mun.;2004;53;410;191;219
Kaišiadorys d. mun.;2004;54;494;235;259
Kaišiadorys d. mun.;2004;55;441;216;225
Kaišiadorys d. mun.;2004;56;330;145;185
Kaišiadorys d. mun.;2004;57;335;166;169
Kaišiadorys d. mun.;2004;58;429;195;234
Kaišiadorys d. mun.;2004;59;288;143;145
Kaišiadorys d. mun.;2004;60;443;198;245
Kaišiadorys d. mun.;2004;61;458;207;251
Kaišiadorys d. mun.;2004;62;396;196;200
Kaišiadorys d. mun.;2004;63;388;174;214
Kaišiadorys d. mun.;2004;64;414;192;222
Kaišiadorys d. mun.;2004;65;430;192;238
Kaišiadorys d. mun.;2004;66;376;150;226
Kaišiadorys d. mun.;2004;67;396;190;206
Kaišiadorys d. mun.;2004;68;357;147;210
Kaišiadorys d. mun.;2004;69;344;131;213
Kaišiadorys d. mun.;2004;70;383;143;240
Kaišiadorys d. mun.;2004;71;387;142;245
Kaišiadorys d. mun.;2004;72;378;141;237
Kaišiadorys d. mun.;2004;73;353;116;237
Kaišiadorys d. mun.;2004;74;317;95;222
Kaišiadorys d. mun.;2004;75;322;99;223
Kaišiadorys d. mun.;2004;76;337;103;234
Kaišiadorys d. mun.;2004;77;285;83;202
Kaišiadorys d. mun.;2004;78;264;80;184
Kaišiadorys d. mun.;2004;79;220;50;170
Kaišiadorys d. mun.;2004;80;212;57;155
Kaišiadorys d. mun.;2004;81;160;55;105
Kaišiadorys d. mun.;2004;82;188;50;138
Kaišiadorys d. mun.;2004;83;121;31;90
Kaišiadorys d. mun.;2004;84;128;28;100
Kaišiadorys d. mun.;2004;85;441;134;307
Kaišiadorys d. mun.;2005;-1;36732;18351;18381
Kaišiadorys d. mun.;2005;0;295;160;135
Kaišiadorys d. mun.;2005;1;324;154;170
Kaišiadorys d. mun.;2005;2;333;190;143
Kaišiadorys d. mun.;2005;3;345;182;163
Kaišiadorys d. mun.;2005;4;363;194;169
Kaišiadorys d. mun.;2005;5;396;185;211
Kaišiadorys d. mun.;2005;6;416;206;210
Kaišiadorys d. mun.;2005;7;447;231;216
Kaišiadorys d. mun.;2005;8;391;215;176
Kaišiadorys d. mun.;2005;9;466;230;236
Kaišiadorys d. mun.;2005;10;439;230;209
Kaišiadorys d. mun.;2005;11;496;250;246
Kaišiadorys d. mun.;2005;12;581;297;284
Kaišiadorys d. mun.;2005;13;539;256;283
Kaišiadorys d. mun.;2005;14;553;294;259
Kaišiadorys d. mun.;2005;15;507;261;246
Kaišiadorys d. mun.;2005;16;535;298;237
Kaišiadorys d. mun.;2005;17;549;268;281
Kaišiadorys d. mun.;2005;18;560;284;276
Kaišiadorys d. mun.;2005;19;535;316;219
Kaišiadorys d. mun.;2005;20;547;291;256
Kaišiadorys d. mun.;2005;21;519;264;255
Kaišiadorys d. mun.;2005;22;406;221;185
Kaišiadorys d. mun.;2005;23;414;269;145
Kaišiadorys d. mun.;2005;24;465;293;172
Kaišiadorys d. mun.;2005;25;486;320;166
Kaišiadorys d. mun.;2005;26;509;328;181
Kaišiadorys d. mun.;2005;27;475;305;170
Kaišiadorys d. mun.;2005;28;507;329;178
Kaišiadorys d. mun.;2005;29;490;298;192
Kaišiadorys d. mun.;2005;30;525;289;236
Kaišiadorys d. mun.;2005;31;422;238;184
Kaišiadorys d. mun.;2005;32;470;258;212
Kaišiadorys d. mun.;2005;33;541;296;245
Kaišiadorys d. mun.;2005;34;544;305;239
Kaišiadorys d. mun.;2005;35;498;279;219
Kaišiadorys d. mun.;2005;36;507;261;246
Kaišiadorys d. mun.;2005;37;549;302;247
Kaišiadorys d. mun.;2005;38;519;266;253
Kaišiadorys d. mun.;2005;39;490;272;218
Kaišiadorys d. mun.;2005;40;504;281;223
Kaišiadorys d. mun.;2005;41;510;288;222
Kaišiadorys d. mun.;2005;42;560;314;246
Kaišiadorys d. mun.;2005;43;590;314;276
Kaišiadorys d. mun.;2005;44;555;302;253
Kaišiadorys d. mun.;2005;45;548;279;269
Kaišiadorys d. mun.;2005;46;539;277;262
Kaišiadorys d. mun.;2005;47;509;251;258
Kaišiadorys d. mun.;2005;48;465;242;223
Kaišiadorys d. mun.;2005;49;523;265;258
Kaišiadorys d. mun.;2005;50;464;234;230
Kaišiadorys d. mun.;2005;51;386;190;196
Kaišiadorys d. mun.;2005;52;401;217;184
Kaišiadorys d. mun.;2005;53;429;221;208
Kaišiadorys d. mun.;2005;54;400;185;215
Kaišiadorys d. mun.;2005;55;487;229;258
Kaišiadorys d. mun.;2005;56;442;216;226
Kaišiadorys d. mun.;2005;57;324;143;181
Kaišiadorys d. mun.;2005;58;336;165;171
Kaišiadorys d. mun.;2005;59;431;194;237
Kaišiadorys d. mun.;2005;60;283;142;141
Kaišiadorys d. mun.;2005;61;442;199;243
Kaišiadorys d. mun.;2005;62;442;198;244
Kaišiadorys d. mun.;2005;63;384;185;199
Kaišiadorys d. mun.;2005;64;382;172;210
Kaišiadorys d. mun.;2005;65;405;185;220
Kaišiadorys d. mun.;2005;66;422;191;231
Kaišiadorys d. mun.;2005;67;366;145;221
Kaišiadorys d. mun.;2005;68;384;181;203
Kaišiadorys d. mun.;2005;69;347;142;205
Kaišiadorys d. mun.;2005;70;340;130;210
Kaišiadorys d. mun.;2005;71;369;133;236
Kaišiadorys d. mun.;2005;72;377;138;239
Kaišiadorys d. mun.;2005;73;370;136;234
Kaišiadorys d. mun.;2005;74;340;109;231
Kaišiadorys d. mun.;2005;75;308;92;216
Kaišiadorys d. mun.;2005;76;304;94;210
Kaišiadorys d. mun.;2005;77;322;97;225
Kaišiadorys d. mun.;2005;78;268;77;191
Kaišiadorys d. mun.;2005;79;244;72;172
Kaišiadorys d. mun.;2005;80;205;44;161
Kaišiadorys d. mun.;2005;81;191;50;141
Kaišiadorys d. mun.;2005;82;137;45;92
Kaišiadorys d. mun.;2005;83;171;43;128
Kaišiadorys d. mun.;2005;84;108;26;82
Kaišiadorys d. mun.;2005;85;465;133;332
Kaišiadorys d. mun.;2006;-1;36217;18219;17998
Kaišiadorys d. mun.;2006;0;330;169;161
Kaišiadorys d. mun.;2006;1;294;161;133
Kaišiadorys d. mun.;2006;2;314;151;163
Kaišiadorys d. mun.;2006;3;330;189;141
Kaišiadorys d. mun.;2006;4;343;182;161
Kaišiadorys d. mun.;2006;5;364;194;170
Kaišiadorys d. mun.;2006;6;396;188;208
Kaišiadorys d. mun.;2006;7;417;213;204
Kaišiadorys d. mun.;2006;8;452;236;216
Kaišiadorys d. mun.;2006;9;393;216;177
Kaišiadorys d. mun.;2006;10;467;232;235
Kaišiadorys d. mun.;2006;11;441;234;207
Kaišiadorys d. mun.;2006;12;502;255;247
Kaišiadorys d. mun.;2006;13;574;299;275
Kaišiadorys d. mun.;2006;14;535;254;281
Kaišiadorys d. mun.;2006;15;550;294;256
Kaišiadorys d. mun.;2006;16;502;262;240
Kaišiadorys d. mun.;2006;17;523;293;230
Kaišiadorys d. mun.;2006;18;534;263;271
Kaišiadorys d. mun.;2006;19;540;274;266
Kaišiadorys d. mun.;2006;20;511;304;207
Kaišiadorys d. mun.;2006;21;520;280;240
Kaišiadorys d. mun.;2006;22;486;253;233
Kaišiadorys d. mun.;2006;23;390;211;179
Kaišiadorys d. mun.;2006;24;396;260;136
Kaišiadorys d. mun.;2006;25;456;300;156
Kaišiadorys d. mun.;2006;26;461;312;149
Kaišiadorys d. mun.;2006;27;491;316;175
Kaišiadorys d. mun.;2006;28;463;303;160
Kaišiadorys d. mun.;2006;29;494;324;170
Kaišiadorys d. mun.;2006;30;489;299;190
Kaišiadorys d. mun.;2006;31;512;285;227
Kaišiadorys d. mun.;2006;32;416;234;182
Kaišiadorys d. mun.;2006;33;466;258;208
Kaišiadorys d. mun.;2006;34;531;291;240
Kaišiadorys d. mun.;2006;35;534;298;236
Kaišiadorys d. mun.;2006;36;477;264;213
Kaišiadorys d. mun.;2006;37;498;257;241
Kaišiadorys d. mun.;2006;38;539;297;242
Kaišiadorys d. mun.;2006;39;511;264;247
Kaišiadorys d. mun.;2006;40;482;264;218
Kaišiadorys d. mun.;2006;41;505;283;222
Kaišiadorys d. mun.;2006;42;504;286;218
Kaišiadorys d. mun.;2006;43;554;312;242
Kaišiadorys d. mun.;2006;44;592;318;274
Kaišiadorys d. mun.;2006;45;559;310;249
Kaišiadorys d. mun.;2006;46;547;278;269
Kaišiadorys d. mun.;2006;47;532;272;260
Kaišiadorys d. mun.;2006;48;509;255;254
Kaišiadorys d. mun.;2006;49;457;239;218
Kaišiadorys d. mun.;2006;50;520;266;254
Kaišiadorys d. mun.;2006;51;461;232;229
Kaišiadorys d. mun.;2006;52;379;185;194
Kaišiadorys d. mun.;2006;53;389;208;181
Kaišiadorys d. mun.;2006;54;425;221;204
Kaišiadorys d. mun.;2006;55;398;185;213
Kaišiadorys d. mun.;2006;56;488;230;258
Kaišiadorys d. mun.;2006;57;435;211;224
Kaišiadorys d. mun.;2006;58;318;137;181
Kaišiadorys d. mun.;2006;59;330;163;167
Kaišiadorys d. mun.;2006;60;425;192;233
Kaišiadorys d. mun.;2006;61;280;140;140
Kaišiadorys d. mun.;2006;62;435;195;240
Kaišiadorys d. mun.;2006;63;431;193;238
Kaišiadorys d. mun.;2006;64;377;184;193
Kaišiadorys d. mun.;2006;65;374;169;205
Kaišiadorys d. mun.;2006;66;396;179;217
Kaišiadorys d. mun.;2006;67;412;183;229
Kaišiadorys d. mun.;2006;68;359;145;214
Kaišiadorys d. mun.;2006;69;370;176;194
Kaišiadorys d. mun.;2006;70;332;132;200
Kaišiadorys d. mun.;2006;71;332;131;201
Kaišiadorys d. mun.;2006;72;356;124;232
Kaišiadorys d. mun.;2006;73;369;133;236
Kaišiadorys d. mun.;2006;74;360;133;227
Kaišiadorys d. mun.;2006;75;326;106;220
Kaišiadorys d. mun.;2006;76;292;81;211
Kaišiadorys d. mun.;2006;77;297;91;206
Kaišiadorys d. mun.;2006;78;298;87;211
Kaišiadorys d. mun.;2006;79;254;72;182
Kaišiadorys d. mun.;2006;80;227;67;160
Kaišiadorys d. mun.;2006;81;186;36;150
Kaišiadorys d. mun.;2006;82;178;47;131
Kaišiadorys d. mun.;2006;83;116;34;82
Kaišiadorys d. mun.;2006;84;159;40;119
Kaišiadorys d. mun.;2006;85;450;125;325
Kaišiadorys d. mun.;2007;-1;35970;18169;17801
Kaišiadorys d. mun.;2007;0;287;158;129
Kaišiadorys d. mun.;2007;1;332;170;162
Kaišiadorys d. mun.;2007;2;296;161;135
Kaišiadorys d. mun.;2007;3;317;152;165
Kaišiadorys d. mun.;2007;4;327;189;138
Kaišiadorys d. mun.;2007;5;347;186;161
Kaišiadorys d. mun.;2007;6;367;195;172
Kaišiadorys d. mun.;2007;7;401;191;210
Kaišiadorys d. mun.;2007;8;418;215;203
Kaišiadorys d. mun.;2007;9;463;243;220
Kaišiadorys d. mun.;2007;10;396;218;178
Kaišiadorys d. mun.;2007;11;470;234;236
Kaišiadorys d. mun.;2007;12;441;234;207
Kaišiadorys d. mun.;2007;13;507;259;248
Kaišiadorys d. mun.;2007;14;579;302;277
Kaišiadorys d. mun.;2007;15;538;260;278
Kaišiadorys d. mun.;2007;16;551;298;253
Kaišiadorys d. mun.;2007;17;496;262;234
Kaišiadorys d. mun.;2007;18;516;289;227
Kaišiadorys d. mun.;2007;19;526;260;266
Kaišiadorys d. mun.;2007;20;529;269;260
Kaišiadorys d. mun.;2007;21;504;303;201
Kaišiadorys d. mun.;2007;22;508;276;232
Kaišiadorys d. mun.;2007;23;474;245;229
Kaišiadorys d. mun.;2007;24;380;209;171
Kaišiadorys d. mun.;2007;25;386;253;133
Kaišiadorys d. mun.;2007;26;451;299;152
Kaišiadorys d. mun.;2007;27;457;309;148
Kaišiadorys d. mun.;2007;28;494;315;179
Kaišiadorys d. mun.;2007;29;456;302;154
Kaišiadorys d. mun.;2007;30;480;319;161
Kaišiadorys d. mun.;2007;31;493;299;194
Kaišiadorys d. mun.;2007;32;512;288;224
Kaišiadorys d. mun.;2007;33;422;243;179
Kaišiadorys d. mun.;2007;34;467;256;211
Kaišiadorys d. mun.;2007;35;529;289;240
Kaišiadorys d. mun.;2007;36;532;296;236
Kaišiadorys d. mun.;2007;37;482;271;211
Kaišiadorys d. mun.;2007;38;491;250;241
Kaišiadorys d. mun.;2007;39;536;296;240
Kaišiadorys d. mun.;2007;40;509;265;244
Kaišiadorys d. mun.;2007;41;484;269;215
Kaišiadorys d. mun.;2007;42;497;277;220
Kaišiadorys d. mun.;2007;43;496;284;212
Kaišiadorys d. mun.;2007;44;555;313;242
Kaišiadorys d. mun.;2007;45;595;319;276
Kaišiadorys d. mun.;2007;46;559;310;249
Kaišiadorys d. mun.;2007;47;539;272;267
Kaišiadorys d. mun.;2007;48;538;275;263
Kaišiadorys d. mun.;2007;49;504;253;251
Kaišiadorys d. mun.;2007;50;453;235;218
Kaišiadorys d. mun.;2007;51;515;264;251
Kaišiadorys d. mun.;2007;52;465;233;232
Kaišiadorys d. mun.;2007;53;375;180;195
Kaišiadorys d. mun.;2007;54;384;205;179
Kaišiadorys d. mun.;2007;55;413;213;200
Kaišiadorys d. mun.;2007;56;395;185;210
Kaišiadorys d. mun.;2007;57;493;234;259
Kaišiadorys d. mun.;2007;58;431;209;222
Kaišiadorys d. mun.;2007;59;312;132;180
Kaišiadorys d. mun.;2007;60;326;159;167
Kaišiadorys d. mun.;2007;61;419;191;228
Kaišiadorys d. mun.;2007;62;277;140;137
Kaišiadorys d. mun.;2007;63;423;187;236
Kaišiadorys d. mun.;2007;64;422;187;235
Kaišiadorys d. mun.;2007;65;373;180;193
Kaišiadorys d. mun.;2007;66;367;165;202
Kaišiadorys d. mun.;2007;67;385;174;211
Kaišiadorys d. mun.;2007;68;400;174;226
Kaišiadorys d. mun.;2007;69;347;137;210
Kaišiadorys d. mun.;2007;70;360;170;190
Kaišiadorys d. mun.;2007;71;318;124;194
Kaišiadorys d. mun.;2007;72;319;123;196
Kaišiadorys d. mun.;2007;73;352;124;228
Kaišiadorys d. mun.;2007;74;364;129;235
Kaišiadorys d. mun.;2007;75;343;122;221
Kaišiadorys d. mun.;2007;76;313;104;209
Kaišiadorys d. mun.;2007;77;274;75;199
Kaišiadorys d. mun.;2007;78;280;82;198
Kaišiadorys d. mun.;2007;79;270;76;194
Kaišiadorys d. mun.;2007;80;233;62;171
Kaišiadorys d. mun.;2007;81;212;63;149
Kaišiadorys d. mun.;2007;82;172;34;138
Kaišiadorys d. mun.;2007;83;157;39;118
Kaišiadorys d. mun.;2007;84;109;31;78
Kaišiadorys d. mun.;2007;85;485;127;358
Kaišiadorys d. mun.;2008;-1;35571;18011;17560
Kaišiadorys d. mun.;2008;0;324;184;140
Kaišiadorys d. mun.;2008;1;282;155;127
Kaišiadorys d. mun.;2008;2;330;171;159
Kaišiadorys d. mun.;2008;3;289;155;134
Kaišiadorys d. mun.;2008;4;316;151;165
Kaišiadorys d. mun.;2008;5;329;189;140
Kaišiadorys d. mun.;2008;6;349;187;162
Kaišiadorys d. mun.;2008;7;365;193;172
Kaišiadorys d. mun.;2008;8;406;193;213
Kaišiadorys d. mun.;2008;9;419;219;200
Kaišiadorys d. mun.;2008;10;456;241;215
Kaišiadorys d. mun.;2008;11;400;222;178
Kaišiadorys d. mun.;2008;12;473;239;234
Kaišiadorys d. mun.;2008;13;444;238;206
Kaišiadorys d. mun.;2008;14;506;257;249
Kaišiadorys d. mun.;2008;15;576;302;274
Kaišiadorys d. mun.;2008;16;535;259;276
Kaišiadorys d. mun.;2008;17;550;296;254
Kaišiadorys d. mun.;2008;18;496;263;233
Kaišiadorys d. mun.;2008;19;511;289;222
Kaišiadorys d. mun.;2008;20;516;258;258
Kaišiadorys d. mun.;2008;21;531;270;261
Kaišiadorys d. mun.;2008;22;495;295;200
Kaišiadorys d. mun.;2008;23;507;274;233
Kaišiadorys d. mun.;2008;24;474;246;228
Kaišiadorys d. mun.;2008;25;369;207;162
Kaišiadorys d. mun.;2008;26;371;249;122
Kaišiadorys d. mun.;2008;27;430;290;140
Kaišiadorys d. mun.;2008;28;436;298;138
Kaišiadorys d. mun.;2008;29;492;310;182
Kaišiadorys d. mun.;2008;30;444;294;150
Kaišiadorys d. mun.;2008;31;472;316;156
Kaišiadorys d. mun.;2008;32;494;298;196
Kaišiadorys d. mun.;2008;33;501;280;221
Kaišiadorys d. mun.;2008;34;419;242;177
Kaišiadorys d. mun.;2008;35;461;252;209
Kaišiadorys d. mun.;2008;36;511;274;237
Kaišiadorys d. mun.;2008;37;527;297;230
Kaišiadorys d. mun.;2008;38;474;264;210
Kaišiadorys d. mun.;2008;39;484;247;237
Kaišiadorys d. mun.;2008;40;526;290;236
Kaišiadorys d. mun.;2008;41;508;267;241
Kaišiadorys d. mun.;2008;42;473;261;212
Kaišiadorys d. mun.;2008;43;500;280;220
Kaišiadorys d. mun.;2008;44;499;284;215
Kaišiadorys d. mun.;2008;45;553;311;242
Kaišiadorys d. mun.;2008;46;580;311;269
Kaišiadorys d. mun.;2008;47;561;308;253
Kaišiadorys d. mun.;2008;48;537;269;268
Kaišiadorys d. mun.;2008;49;528;269;259
Kaišiadorys d. mun.;2008;50;504;253;251
Kaišiadorys d. mun.;2008;51;446;229;217
Kaišiadorys d. mun.;2008;52;513;262;251
Kaišiadorys d. mun.;2008;53;467;235;232
Kaišiadorys d. mun.;2008;54;370;175;195
Kaišiadorys d. mun.;2008;55;381;202;179
Kaišiadorys d. mun.;2008;56;406;209;197
Kaišiadorys d. mun.;2008;57;386;178;208
Kaišiadorys d. mun.;2008;58;482;224;258
Kaišiadorys d. mun.;2008;59;427;206;221
Kaišiadorys d. mun.;2008;60;306;128;178
Kaišiadorys d. mun.;2008;61;326;159;167
Kaišiadorys d. mun.;2008;62;413;189;224
Kaišiadorys d. mun.;2008;63;276;139;137
Kaišiadorys d. mun.;2008;64;409;175;234
Kaišiadorys d. mun.;2008;65;408;180;228
Kaišiadorys d. mun.;2008;66;360;168;192
Kaišiadorys d. mun.;2008;67;354;158;196
Kaišiadorys d. mun.;2008;68;380;170;210
Kaišiadorys d. mun.;2008;69;391;170;221
Kaišiadorys d. mun.;2008;70;341;134;207
Kaišiadorys d. mun.;2008;71;354;165;189
Kaišiadorys d. mun.;2008;72;300;114;186
Kaišiadorys d. mun.;2008;73;303;115;188
Kaišiadorys d. mun.;2008;74;335;114;221
Kaišiadorys d. mun.;2008;75;357;127;230
Kaišiadorys d. mun.;2008;76;326;111;215
Kaišiadorys d. mun.;2008;77;290;92;198
Kaišiadorys d. mun.;2008;78;252;68;184
Kaišiadorys d. mun.;2008;79;262;73;189
Kaišiadorys d. mun.;2008;80;251;69;182
Kaišiadorys d. mun.;2008;81;213;58;155
Kaišiadorys d. mun.;2008;82;192;57;135
Kaišiadorys d. mun.;2008;83;152;29;123
Kaišiadorys d. mun.;2008;84;137;32;105
Kaišiadorys d. mun.;2008;85;472;130;342
Kaišiadorys d. mun.;2009;-1;35174;17815;17359
Kaišiadorys d. mun.;2009;0;330;169;161
Kaišiadorys d. mun.;2009;1;319;179;140
Kaišiadorys d. mun.;2009;2;289;159;130
Kaišiadorys d. mun.;2009;3;326;169;157
Kaišiadorys d. mun.;2009;4;286;153;133
Kaišiadorys d. mun.;2009;5;316;153;163
Kaišiadorys d. mun.;2009;6;327;188;139
Kaišiadorys d. mun.;2009;7;347;185;162
Kaišiadorys d. mun.;2009;8;369;195;174
Kaišiadorys d. mun.;2009;9;401;192;209
Kaišiadorys d. mun.;2009;10;415;220;195
Kaišiadorys d. mun.;2009;11;455;241;214
Kaišiadorys d. mun.;2009;12;399;218;181
Kaišiadorys d. mun.;2009;13;471;238;233
Kaišiadorys d. mun.;2009;14;450;241;209
Kaišiadorys d. mun.;2009;15;508;260;248
Kaišiadorys d. mun.;2009;16;572;304;268
Kaišiadorys d. mun.;2009;17;542;264;278
Kaišiadorys d. mun.;2009;18;545;294;251
Kaišiadorys d. mun.;2009;19;494;263;231
Kaišiadorys d. mun.;2009;20;506;287;219
Kaišiadorys d. mun.;2009;21;508;254;254
Kaišiadorys d. mun.;2009;22;526;268;258
Kaišiadorys d. mun.;2009;23;487;288;199
Kaišiadorys d. mun.;2009;24;497;272;225
Kaišiadorys d. mun.;2009;25;467;245;222
Kaišiadorys d. mun.;2009;26;373;208;165
Kaišiadorys d. mun.;2009;27;357;247;110
Kaišiadorys d. mun.;2009;28;412;279;133
Kaišiadorys d. mun.;2009;29;425;297;128
Kaišiadorys d. mun.;2009;30;486;305;181
Kaišiadorys d. mun.;2009;31;423;278;145
Kaišiadorys d. mun.;2009;32;462;313;149
Kaišiadorys d. mun.;2009;33;489;294;195
Kaišiadorys d. mun.;2009;34;500;278;222
Kaišiadorys d. mun.;2009;35;408;237;171
Kaišiadorys d. mun.;2009;36;447;241;206
Kaišiadorys d. mun.;2009;37;509;273;236
Kaišiadorys d. mun.;2009;38;516;287;229
Kaišiadorys d. mun.;2009;39;469;262;207
Kaišiadorys d. mun.;2009;40;484;247;237
Kaišiadorys d. mun.;2009;41;522;287;235
Kaišiadorys d. mun.;2009;42;506;266;240
Kaišiadorys d. mun.;2009;43;468;255;213
Kaišiadorys d. mun.;2009;44;493;275;218
Kaišiadorys d. mun.;2009;45;497;285;212
Kaišiadorys d. mun.;2009;46;545;307;238
Kaišiadorys d. mun.;2009;47;577;309;268
Kaišiadorys d. mun.;2009;48;549;297;252
Kaišiadorys d. mun.;2009;49;540;269;271
Kaišiadorys d. mun.;2009;50;520;260;260
Kaišiadorys d. mun.;2009;51;504;249;255
Kaišiadorys d. mun.;2009;52;438;224;214
Kaišiadorys d. mun.;2009;53;506;258;248
Kaišiadorys d. mun.;2009;54;459;231;228
Kaišiadorys d. mun.;2009;55;365;169;196
Kaišiadorys d. mun.;2009;56;378;202;176
Kaišiadorys d. mun.;2009;57;401;206;195
Kaišiadorys d. mun.;2009;58;376;169;207
Kaišiadorys d. mun.;2009;59;468;213;255
Kaišiadorys d. mun.;2009;60;419;204;215
Kaišiadorys d. mun.;2009;61;308;127;181
Kaišiadorys d. mun.;2009;62;326;156;170
Kaišiadorys d. mun.;2009;63;408;188;220
Kaišiadorys d. mun.;2009;64;267;132;135
Kaišiadorys d. mun.;2009;65;402;168;234
Kaišiadorys d. mun.;2009;66;394;173;221
Kaišiadorys d. mun.;2009;67;347;158;189
Kaišiadorys d. mun.;2009;68;342;150;192
Kaišiadorys d. mun.;2009;69;362;158;204
Kaišiadorys d. mun.;2009;70;382;165;217
Kaišiadorys d. mun.;2009;71;336;133;203
Kaišiadorys d. mun.;2009;72;345;154;191
Kaišiadorys d. mun.;2009;73;291;109;182
Kaišiadorys d. mun.;2009;74;289;112;177
Kaišiadorys d. mun.;2009;75;328;110;218
Kaišiadorys d. mun.;2009;76;327;116;211
Kaišiadorys d. mun.;2009;77;312;105;207
Kaišiadorys d. mun.;2009;78;278;85;193
Kaišiadorys d. mun.;2009;79;238;65;173
Kaišiadorys d. mun.;2009;80;243;66;177
Kaišiadorys d. mun.;2009;81;236;65;171
Kaišiadorys d. mun.;2009;82;186;50;136
Kaišiadorys d. mun.;2009;83;167;45;122
Kaišiadorys d. mun.;2009;84;138;27;111
Kaišiadorys d. mun.;2009;85;479;118;361
Kaišiadorys d. mun.;2010;-1;34795;17638;17157
Kaišiadorys d. mun.;2010;0;322;167;155
Kaišiadorys d. mun.;2010;1;328;169;159
Kaišiadorys d. mun.;2010;2;322;180;142
Kaišiadorys d. mun.;2010;3;286;158;128
Kaišiadorys d. mun.;2010;4;325;166;159
Kaišiadorys d. mun.;2010;5;293;161;132
Kaišiadorys d. mun.;2010;6;316;154;162
Kaišiadorys d. mun.;2010;7;324;186;138
Kaišiadorys d. mun.;2010;8;347;185;162
Kaišiadorys d. mun.;2010;9;368;193;175
Kaišiadorys d. mun.;2010;10;400;193;207
Kaišiadorys d. mun.;2010;11;417;219;198
Kaišiadorys d. mun.;2010;12;455;243;212
Kaišiadorys d. mun.;2010;13;396;216;180
Kaišiadorys d. mun.;2010;14;468;237;231
Kaišiadorys d. mun.;2010;15;446;239;207
Kaišiadorys d. mun.;2010;16;502;258;244
Kaišiadorys d. mun.;2010;17;571;302;269
Kaišiadorys d. mun.;2010;18;541;263;278
Kaišiadorys d. mun.;2010;19;540;294;246
Kaišiadorys d. mun.;2010;20;490;260;230
Kaišiadorys d. mun.;2010;21;502;286;216
Kaišiadorys d. mun.;2010;22;499;248;251
Kaišiadorys d. mun.;2010;23;507;256;251
Kaišiadorys d. mun.;2010;24;472;278;194
Kaišiadorys d. mun.;2010;25;476;254;222
Kaišiadorys d. mun.;2010;26;455;242;213
Kaišiadorys d. mun.;2010;27;356;202;154
Kaišiadorys d. mun.;2010;28;356;246;110
Kaišiadorys d. mun.;2010;29;401;270;131
Kaišiadorys d. mun.;2010;30;421;295;126
Kaišiadorys d. mun.;2010;31;470;297;173
Kaišiadorys d. mun.;2010;32;421;279;142
Kaišiadorys d. mun.;2010;33;454;311;143
Kaišiadorys d. mun.;2010;34;487;291;196
Kaišiadorys d. mun.;2010;35;495;279;216
Kaišiadorys d. mun.;2010;36;393;226;167
Kaišiadorys d. mun.;2010;37;438;233;205
Kaišiadorys d. mun.;2010;38;507;274;233
Kaišiadorys d. mun.;2010;39;516;288;228
Kaišiadorys d. mun.;2010;40;460;254;206
Kaišiadorys d. mun.;2010;41;480;247;233
Kaišiadorys d. mun.;2010;42;513;279;234
Kaišiadorys d. mun.;2010;43;500;262;238
Kaišiadorys d. mun.;2010;44;464;251;213
Kaišiadorys d. mun.;2010;45;486;274;212
Kaišiadorys d. mun.;2010;46;491;282;209
Kaišiadorys d. mun.;2010;47;542;306;236
Kaišiadorys d. mun.;2010;48;574;309;265
Kaišiadorys d. mun.;2010;49;547;293;254
Kaišiadorys d. mun.;2010;50;541;269;272
Kaišiadorys d. mun.;2010;51;516;258;258
Kaišiadorys d. mun.;2010;52;505;251;254
Kaišiadorys d. mun.;2010;53;434;218;216
Kaišiadorys d. mun.;2010;54;505;260;245
Kaišiadorys d. mun.;2010;55;450;225;225
Kaišiadorys d. mun.;2010;56;366;170;196
Kaišiadorys d. mun.;2010;57;378;202;176
Kaišiadorys d. mun.;2010;58;395;199;196
Kaišiadorys d. mun.;2010;59;368;161;207
Kaišiadorys d. mun.;2010;60;459;210;249
Kaišiadorys d. mun.;2010;61;410;200;210
Kaišiadorys d. mun.;2010;62;303;124;179
Kaišiadorys d. mun.;2010;63;325;155;170
Kaišiadorys d. mun.;2010;64;390;177;213
Kaišiadorys d. mun.;2010;65;262;128;134
Kaišiadorys d. mun.;2010;66;390;159;231
Kaišiadorys d. mun.;2010;67;384;165;219
Kaišiadorys d. mun.;2010;68;340;156;184
Kaišiadorys d. mun.;2010;69;341;148;193
Kaišiadorys d. mun.;2010;70;352;155;197
Kaišiadorys d. mun.;2010;71;371;160;211
Kaišiadorys d. mun.;2010;72;320;123;197
Kaišiadorys d. mun.;2010;73;323;140;183
Kaišiadorys d. mun.;2010;74;277;100;177
Kaišiadorys d. mun.;2010;75;284;108;176
Kaišiadorys d. mun.;2010;76;317;105;212
Kaišiadorys d. mun.;2010;77;307;105;202
Kaišiadorys d. mun.;2010;78;294;98;196
Kaišiadorys d. mun.;2010;79;252;79;173
Kaišiadorys d. mun.;2010;80;219;57;162
Kaišiadorys d. mun.;2010;81;232;64;168
Kaišiadorys d. mun.;2010;82;222;61;161
Kaišiadorys d. mun.;2010;83;172;45;127
Kaišiadorys d. mun.;2010;84;151;39;112
Kaišiadorys d. mun.;2010;85;500;109;391
Kaišiadorys d. mun.;2011;-1;33920;17197;16723
Kaišiadorys d. mun.;2011;0;288;153;135
Kaišiadorys d. mun.;2011;1;300;157;143
Kaišiadorys d. mun.;2011;2;285;149;136
Kaišiadorys d. mun.;2011;3;304;180;124
Kaišiadorys d. mun.;2011;4;257;130;127
Kaišiadorys d. mun.;2011;5;320;156;164
Kaišiadorys d. mun.;2011;6;271;138;133
Kaišiadorys d. mun.;2011;7;280;132;148
Kaišiadorys d. mun.;2011;8;288;156;132
Kaišiadorys d. mun.;2011;9;311;164;147
Kaišiadorys d. mun.;2011;10;361;190;171
Kaišiadorys d. mun.;2011;11;381;180;201
Kaišiadorys d. mun.;2011;12;400;196;204
Kaišiadorys d. mun.;2011;13;441;225;216
Kaišiadorys d. mun.;2011;14;369;194;175
Kaišiadorys d. mun.;2011;15;440;205;235
Kaišiadorys d. mun.;2011;16;399;207;192
Kaišiadorys d. mun.;2011;17;478;226;252
Kaišiadorys d. mun.;2011;18;565;307;258
Kaišiadorys d. mun.;2011;19;542;327;215
Kaišiadorys d. mun.;2011;20;589;396;193
Kaišiadorys d. mun.;2011;21;584;395;189
Kaišiadorys d. mun.;2011;22;563;391;172
Kaišiadorys d. mun.;2011;23;603;393;210
Kaišiadorys d. mun.;2011;24;549;367;182
Kaišiadorys d. mun.;2011;25;494;334;160
Kaišiadorys d. mun.;2011;26;483;314;169
Kaišiadorys d. mun.;2011;27;443;297;146
Kaišiadorys d. mun.;2011;28;380;236;144
Kaišiadorys d. mun.;2011;29;396;260;136
Kaišiadorys d. mun.;2011;30;385;228;157
Kaišiadorys d. mun.;2011;31;403;252;151
Kaišiadorys d. mun.;2011;32;432;242;190
Kaišiadorys d. mun.;2011;33;402;227;175
Kaišiadorys d. mun.;2011;34;432;257;175
Kaišiadorys d. mun.;2011;35;460;248;212
Kaišiadorys d. mun.;2011;36;460;229;231
Kaišiadorys d. mun.;2011;37;405;227;178
Kaišiadorys d. mun.;2011;38;465;232;233
Kaišiadorys d. mun.;2011;39;499;252;247
Kaišiadorys d. mun.;2011;40;512;283;229
Kaišiadorys d. mun.;2011;41;484;263;221
Kaišiadorys d. mun.;2011;42;491;259;232
Kaišiadorys d. mun.;2011;43;505;259;246
Kaišiadorys d. mun.;2011;44;502;259;243
Kaišiadorys d. mun.;2011;45;462;250;212
Kaišiadorys d. mun.;2011;46;472;263;209
Kaišiadorys d. mun.;2011;47;495;272;223
Kaišiadorys d. mun.;2011;48;509;279;230
Kaišiadorys d. mun.;2011;49;542;275;267
Kaišiadorys d. mun.;2011;50;489;248;241
Kaišiadorys d. mun.;2011;51;517;260;257
Kaišiadorys d. mun.;2011;52;480;225;255
Kaišiadorys d. mun.;2011;53;471;221;250
Kaišiadorys d. mun.;2011;54;428;215;213
Kaišiadorys d. mun.;2011;55;455;227;228
Kaišiadorys d. mun.;2011;56;406;189;217
Kaišiadorys d. mun.;2011;57;369;173;196
Kaišiadorys d. mun.;2011;58;367;179;188
Kaišiadorys d. mun.;2011;59;383;188;195
Kaišiadorys d. mun.;2011;60;391;180;211
Kaišiadorys d. mun.;2011;61;413;179;234
Kaišiadorys d. mun.;2011;62;383;181;202
Kaišiadorys d. mun.;2011;63;308;131;177
Kaišiadorys d. mun.;2011;64;301;132;169
Kaišiadorys d. mun.;2011;65;358;152;206
Kaišiadorys d. mun.;2011;66;267;124;143
Kaišiadorys d. mun.;2011;67;335;124;211
Kaišiadorys d. mun.;2011;68;340;140;200
Kaišiadorys d. mun.;2011;69;297;126;171
Kaišiadorys d. mun.;2011;70;329;134;195
Kaišiadorys d. mun.;2011;71;320;132;188
Kaišiadorys d. mun.;2011;72;334;133;201
Kaišiadorys d. mun.;2011;73;311;114;197
Kaišiadorys d. mun.;2011;74;294;112;182
Kaišiadorys d. mun.;2011;75;253;83;170
Kaišiadorys d. mun.;2011;76;260;88;172
Kaišiadorys d. mun.;2011;77;283;87;196
Kaišiadorys d. mun.;2011;78;268;73;195
Kaišiadorys d. mun.;2011;79;266;81;185
Kaišiadorys d. mun.;2011;80;226;58;168
Kaišiadorys d. mun.;2011;81;191;43;148
Kaišiadorys d. mun.;2011;82;198;50;148
Kaišiadorys d. mun.;2011;83;208;55;153
Kaišiadorys d. mun.;2011;84;144;30;114
Kaišiadorys d. mun.;2011;85;596;119;477
Kaišiadorys d. mun.;2012;-1;33389;16880;16509
Kaišiadorys d. mun.;2012;0;283;134;149
Kaišiadorys d. mun.;2012;1;286;152;134
Kaišiadorys d. mun.;2012;2;296;154;142
Kaišiadorys d. mun.;2012;3;277;143;134
Kaišiadorys d. mun.;2012;4;305;179;126
Kaišiadorys d. mun.;2012;5;254;130;124
Kaišiadorys d. mun.;2012;6;324;160;164
Kaišiadorys d. mun.;2012;7;272;138;134
Kaišiadorys d. mun.;2012;8;285;136;149
Kaišiadorys d. mun.;2012;9;282;149;133
Kaišiadorys d. mun.;2012;10;311;164;147
Kaišiadorys d. mun.;2012;11;355;186;169
Kaišiadorys d. mun.;2012;12;380;179;201
Kaišiadorys d. mun.;2012;13;398;196;202
Kaišiadorys d. mun.;2012;14;440;225;215
Kaišiadorys d. mun.;2012;15;374;199;175
Kaišiadorys d. mun.;2012;16;443;206;237
Kaišiadorys d. mun.;2012;17;398;204;194
Kaišiadorys d. mun.;2012;18;471;224;247
Kaišiadorys d. mun.;2012;19;552;302;250
Kaišiadorys d. mun.;2012;20;528;322;206
Kaišiadorys d. mun.;2012;21;573;384;189
Kaišiadorys d. mun.;2012;22;565;386;179
Kaišiadorys d. mun.;2012;23;539;381;158
Kaišiadorys d. mun.;2012;24;589;383;206
Kaišiadorys d. mun.;2012;25;536;363;173
Kaišiadorys d. mun.;2012;26;460;313;147
Kaišiadorys d. mun.;2012;27;460;304;156
Kaišiadorys d. mun.;2012;28;432;288;144
Kaišiadorys d. mun.;2012;29;366;234;132
Kaišiadorys d. mun.;2012;30;375;247;128
Kaišiadorys d. mun.;2012;31;370;221;149
Kaišiadorys d. mun.;2012;32;380;236;144
Kaišiadorys d. mun.;2012;33;415;229;186
Kaišiadorys d. mun.;2012;34;393;216;177
Kaišiadorys d. mun.;2012;35;428;257;171
Kaišiadorys d. mun.;2012;36;454;243;211
Kaišiadorys d. mun.;2012;37;452;224;228
Kaišiadorys d. mun.;2012;38;395;222;173
Kaišiadorys d. mun.;2012;39;459;223;236
Kaišiadorys d. mun.;2012;40;488;244;244
Kaišiadorys d. mun.;2012;41;504;277;227
Kaišiadorys d. mun.;2012;42;475;257;218
Kaišiadorys d. mun.;2012;43;485;256;229
Kaišiadorys d. mun.;2012;44;500;258;242
Kaišiadorys d. mun.;2012;45;491;253;238
Kaišiadorys d. mun.;2012;46;458;246;212
Kaišiadorys d. mun.;2012;47;463;257;206
Kaišiadorys d. mun.;2012;48;488;266;222
Kaišiadorys d. mun.;2012;49;506;276;230
Kaišiadorys d. mun.;2012;50;541;272;269
Kaišiadorys d. mun.;2012;51;484;243;241
Kaišiadorys d. mun.;2012;52;512;255;257
Kaišiadorys d. mun.;2012;53;482;223;259
Kaišiadorys d. mun.;2012;54;472;220;252
Kaišiadorys d. mun.;2012;55;420;213;207
Kaišiadorys d. mun.;2012;56;456;224;232
Kaišiadorys d. mun.;2012;57;400;187;213
Kaišiadorys d. mun.;2012;58;366;171;195
Kaišiadorys d. mun.;2012;59;366;179;187
Kaišiadorys d. mun.;2012;60;382;187;195
Kaišiadorys d. mun.;2012;61;380;171;209
Kaišiadorys d. mun.;2012;62;412;176;236
Kaišiadorys d. mun.;2012;63;370;170;200
Kaišiadorys d. mun.;2012;64;299;123;176
Kaišiadorys d. mun.;2012;65;294;128;166
Kaišiadorys d. mun.;2012;66;347;145;202
Kaišiadorys d. mun.;2012;67;262;121;141
Kaišiadorys d. mun.;2012;68;327;116;211
Kaišiadorys d. mun.;2012;69;333;135;198
Kaišiadorys d. mun.;2012;70;287;118;169
Kaišiadorys d. mun.;2012;71;318;127;191
Kaišiadorys d. mun.;2012;72;309;123;186
Kaišiadorys d. mun.;2012;73;322;125;197
Kaišiadorys d. mun.;2012;74;302;108;194
Kaišiadorys d. mun.;2012;75;284;106;178
Kaišiadorys d. mun.;2012;76;242;75;167
Kaišiadorys d. mun.;2012;77;247;84;163
Kaišiadorys d. mun.;2012;78;273;82;191
Kaišiadorys d. mun.;2012;79;255;70;185
Kaišiadorys d. mun.;2012;80;251;75;176
Kaišiadorys d. mun.;2012;81;211;53;158
Kaišiadorys d. mun.;2012;82;177;36;141
Kaišiadorys d. mun.;2012;83;185;45;140
Kaišiadorys d. mun.;2012;84;184;48;136
Kaišiadorys d. mun.;2012;85;624;120;504
Kaišiadorys d. mun.;2013;-1;32922;16649;16273
Kaišiadorys d. mun.;2013;0;272;135;137
Kaišiadorys d. mun.;2013;1;287;136;151
Kaišiadorys d. mun.;2013;2;287;150;137
Kaišiadorys d. mun.;2013;3;291;151;140
Kaišiadorys d. mun.;2013;4;276;140;136
Kaišiadorys d. mun.;2013;5;304;177;127
Kaišiadorys d. mun.;2013;6;249;127;122
Kaišiadorys d. mun.;2013;7;325;162;163
Kaišiadorys d. mun.;2013;8;270;135;135
Kaišiadorys d. mun.;2013;9;282;132;150
Kaišiadorys d. mun.;2013;10;280;147;133
Kaišiadorys d. mun.;2013;11;308;162;146
Kaišiadorys d. mun.;2013;12;351;184;167
Kaišiadorys d. mun.;2013;13;376;178;198
Kaišiadorys d. mun.;2013;14;398;198;200
Kaišiadorys d. mun.;2013;15;433;219;214
Kaišiadorys d. mun.;2013;16;373;197;176
Kaišiadorys d. mun.;2013;17;446;207;239
Kaišiadorys d. mun.;2013;18;389;198;191
Kaišiadorys d. mun.;2013;19;465;226;239
Kaišiadorys d. mun.;2013;20;545;302;243
Kaišiadorys d. mun.;2013;21;511;315;196
Kaišiadorys d. mun.;2013;22;561;378;183
Kaišiadorys d. mun.;2013;23;558;382;176
Kaišiadorys d. mun.;2013;24;534;377;157
Kaišiadorys d. mun.;2013;25;573;375;198
Kaišiadorys d. mun.;2013;26;507;352;155
Kaišiadorys d. mun.;2013;27;444;311;133
Kaišiadorys d. mun.;2013;28;443;289;154
Kaišiadorys d. mun.;2013;29;421;283;138
Kaišiadorys d. mun.;2013;30;357;230;127
Kaišiadorys d. mun.;2013;31;369;246;123
Kaišiadorys d. mun.;2013;32;373;227;146
Kaišiadorys d. mun.;2013;33;368;233;135
Kaišiadorys d. mun.;2013;34;401;226;175
Kaišiadorys d. mun.;2013;35;388;215;173
Kaišiadorys d. mun.;2013;36;428;255;173
Kaišiadorys d. mun.;2013;37;452;239;213
Kaišiadorys d. mun.;2013;38;449;223;226
Kaišiadorys d. mun.;2013;39;394;219;175
Kaišiadorys d. mun.;2013;40;449;218;231
Kaišiadorys d. mun.;2013;41;483;243;240
Kaišiadorys d. mun.;2013;42;498;276;222
Kaišiadorys d. mun.;2013;43;473;260;213
Kaišiadorys d. mun.;2013;44;487;257;230
Kaišiadorys d. mun.;2013;45;495;255;240
Kaišiadorys d. mun.;2013;46;480;247;233
Kaišiadorys d. mun.;2013;47;448;238;210
Kaišiadorys d. mun.;2013;48;458;253;205
Kaišiadorys d. mun.;2013;49;487;261;226
Kaišiadorys d. mun.;2013;50;496;267;229
Kaišiadorys d. mun.;2013;51;536;268;268
Kaišiadorys d. mun.;2013;52;480;238;242
Kaišiadorys d. mun.;2013;53;510;251;259
Kaišiadorys d. mun.;2013;54;480;224;256
Kaišiadorys d. mun.;2013;55;470;218;252
Kaišiadorys d. mun.;2013;56;410;205;205
Kaišiadorys d. mun.;2013;57;450;215;235
Kaišiadorys d. mun.;2013;58;392;182;210
Kaišiadorys d. mun.;2013;59;358;164;194
Kaišiadorys d. mun.;2013;60;359;173;186
Kaišiadorys d. mun.;2013;61;369;179;190
Kaišiadorys d. mun.;2013;62;372;163;209
Kaišiadorys d. mun.;2013;63;408;173;235
Kaišiadorys d. mun.;2013;64;361;165;196
Kaišiadorys d. mun.;2013;65;293;120;173
Kaišiadorys d. mun.;2013;66;286;125;161
Kaišiadorys d. mun.;2013;67;332;139;193
Kaišiadorys d. mun.;2013;68;252;114;138
Kaišiadorys d. mun.;2013;69;319;112;207
Kaišiadorys d. mun.;2013;70;323;130;193
Kaišiadorys d. mun.;2013;71;278;113;165
Kaišiadorys d. mun.;2013;72;305;122;183
Kaišiadorys d. mun.;2013;73;301;114;187
Kaišiadorys d. mun.;2013;74;305;118;187
Kaišiadorys d. mun.;2013;75;289;99;190
Kaišiadorys d. mun.;2013;76;262;96;166
Kaišiadorys d. mun.;2013;77;238;74;164
Kaišiadorys d. mun.;2013;78;231;76;155
Kaišiadorys d. mun.;2013;79;259;73;186
Kaišiadorys d. mun.;2013;80;246;64;182
Kaišiadorys d. mun.;2013;81;230;66;164
Kaišiadorys d. mun.;2013;82;196;48;148
Kaišiadorys d. mun.;2013;83;159;32;127
Kaišiadorys d. mun.;2013;84;167;41;126
Kaišiadorys d. mun.;2013;85;704;142;562
Kaišiadorys d. mun.;2014;-1;32358;16427;15931
Kaišiadorys d. mun.;2014;0;279;159;120
Kaišiadorys d. mun.;2014;1;273;135;138
Kaišiadorys d. mun.;2014;2;269;127;142
Kaišiadorys d. mun.;2014;3;280;145;135
Kaišiadorys d. mun.;2014;4;284;146;138
Kaišiadorys d. mun.;2014;5;271;135;136
Kaišiadorys d. mun.;2014;6;300;179;121
Kaišiadorys d. mun.;2014;7;252;128;124
Kaišiadorys d. mun.;2014;8;324;161;163
Kaišiadorys d. mun.;2014;9;261;132;129
Kaišiadorys d. mun.;2014;10;273;124;149
Kaišiadorys d. mun.;2014;11;274;143;131
Kaišiadorys d. mun.;2014;12;307;164;143
Kaišiadorys d. mun.;2014;13;347;181;166
Kaišiadorys d. mun.;2014;14;369;177;192
Kaišiadorys d. mun.;2014;15;396;195;201
Kaišiadorys d. mun.;2014;16;430;219;211
Kaišiadorys d. mun.;2014;17;366;194;172
Kaišiadorys d. mun.;2014;18;439;204;235
Kaišiadorys d. mun.;2014;19;376;193;183
Kaišiadorys d. mun.;2014;20;458;224;234
Kaišiadorys d. mun.;2014;21;536;299;237
Kaišiadorys d. mun.;2014;22;496;307;189
Kaišiadorys d. mun.;2014;23;529;365;164
Kaišiadorys d. mun.;2014;24;541;373;168
Kaišiadorys d. mun.;2014;25;523;370;153
Kaišiadorys d. mun.;2014;26;547;366;181
Kaišiadorys d. mun.;2014;27;492;349;143
Kaišiadorys d. mun.;2014;28;435;309;126
Kaišiadorys d. mun.;2014;29;425;278;147
Kaišiadorys d. mun.;2014;30;411;284;127
Kaišiadorys d. mun.;2014;31;345;224;121
Kaišiadorys d. mun.;2014;32;357;241;116
Kaišiadorys d. mun.;2014;33;378;234;144
Kaišiadorys d. mun.;2014;34;360;229;131
Kaišiadorys d. mun.;2014;35;394;221;173
Kaišiadorys d. mun.;2014;36;380;207;173
Kaišiadorys d. mun.;2014;37;422;252;170
Kaišiadorys d. mun.;2014;38;440;233;207
Kaišiadorys d. mun.;2014;39;434;215;219
Kaišiadorys d. mun.;2014;40;391;219;172
Kaišiadorys d. mun.;2014;41;449;221;228
Kaišiadorys d. mun.;2014;42;485;247;238
Kaišiadorys d. mun.;2014;43;498;278;220
Kaišiadorys d. mun.;2014;44;465;254;211
Kaišiadorys d. mun.;2014;45;476;251;225
Kaišiadorys d. mun.;2014;46;487;246;241
Kaišiadorys d. mun.;2014;47;483;249;234
Kaišiadorys d. mun.;2014;48;446;238;208
Kaišiadorys d. mun.;2014;49;458;256;202
Kaišiadorys d. mun.;2014;50;483;261;222
Kaišiadorys d. mun.;2014;51;496;266;230
Kaišiadorys d. mun.;2014;52;529;262;267
Kaišiadorys d. mun.;2014;53;469;232;237
Kaišiadorys d. mun.;2014;54;505;248;257
Kaišiadorys d. mun.;2014;55;466;213;253
Kaišiadorys d. mun.;2014;56;465;212;253
Kaišiadorys d. mun.;2014;57;405;201;204
Kaišiadorys d. mun.;2014;58;443;212;231
Kaišiadorys d. mun.;2014;59;379;174;205
Kaišiadorys d. mun.;2014;60;357;160;197
Kaišiadorys d. mun.;2014;61;358;173;185
Kaišiadorys d. mun.;2014;62;365;178;187
Kaišiadorys d. mun.;2014;63;361;155;206
Kaišiadorys d. mun.;2014;64;404;169;235
Kaišiadorys d. mun.;2014;65;353;159;194
Kaišiadorys d. mun.;2014;66;280;115;165
Kaišiadorys d. mun.;2014;67;286;126;160
Kaišiadorys d. mun.;2014;68;327;136;191
Kaišiadorys d. mun.;2014;69;244;106;138
Kaišiadorys d. mun.;2014;70;304;106;198
Kaišiadorys d. mun.;2014;71;316;124;192
Kaišiadorys d. mun.;2014;72;263;103;160
Kaišiadorys d. mun.;2014;73;298;118;180
Kaišiadorys d. mun.;2014;74;287;108;179
Kaišiadorys d. mun.;2014;75;289;109;180
Kaišiadorys d. mun.;2014;76;278;91;187
Kaišiadorys d. mun.;2014;77;251;90;161
Kaišiadorys d. mun.;2014;78;227;68;159
Kaišiadorys d. mun.;2014;79;215;64;151
Kaišiadorys d. mun.;2014;80;246;66;180
Kaišiadorys d. mun.;2014;81;231;61;170
Kaišiadorys d. mun.;2014;82;209;57;152
Kaišiadorys d. mun.;2014;83;182;44;138
Kaišiadorys d. mun.;2014;84;143;29;114
Kaišiadorys d. mun.;2014;85;733;151;582
Kaišiadorys d. mun.;2015;-1;31915;16245;15670
Kaišiadorys d. mun.;2015;0;284;156;128
Kaišiadorys d. mun.;2015;1;275;155;120
Kaišiadorys d. mun.;2015;2;276;138;138
Kaišiadorys d. mun.;2015;3;261;123;138
Kaišiadorys d. mun.;2015;4;278;142;136
Kaišiadorys d. mun.;2015;5;282;147;135
Kaišiadorys d. mun.;2015;6;264;130;134
Kaišiadorys d. mun.;2015;7;289;173;116
Kaišiadorys d. mun.;2015;8;252;127;125
Kaišiadorys d. mun.;2015;9;319;159;160
Kaišiadorys d. mun.;2015;10;261;131;130
Kaišiadorys d. mun.;2015;11;273;123;150
Kaišiadorys d. mun.;2015;12;271;142;129
Kaišiadorys d. mun.;2015;13;305;165;140
Kaišiadorys d. mun.;2015;14;340;180;160
Kaišiadorys d. mun.;2015;15;360;170;190
Kaišiadorys d. mun.;2015;16;395;193;202
Kaišiadorys d. mun.;2015;17;429;222;207
Kaišiadorys d. mun.;2015;18;366;195;171
Kaišiadorys d. mun.;2015;19;429;198;231
Kaišiadorys d. mun.;2015;20;373;188;185
Kaišiadorys d. mun.;2015;21;450;217;233
Kaišiadorys d. mun.;2015;22;523;300;223
Kaišiadorys d. mun.;2015;23;488;306;182
Kaišiadorys d. mun.;2015;24;525;363;162
Kaišiadorys d. mun.;2015;25;528;364;164
Kaišiadorys d. mun.;2015;26;514;364;150
Kaišiadorys d. mun.;2015;27;525;361;164
Kaišiadorys d. mun.;2015;28;490;350;140
Kaišiadorys d. mun.;2015;29;423;302;121
Kaišiadorys d. mun.;2015;30;423;270;153
Kaišiadorys d. mun.;2015;31;399;280;119
Kaišiadorys d. mun.;2015;32;334;219;115
Kaišiadorys d. mun.;2015;33;360;241;119
Kaišiadorys d. mun.;2015;34;372;233;139
Kaišiadorys d. mun.;2015;35;361;234;127
Kaišiadorys d. mun.;2015;36;399;225;174
Kaišiadorys d. mun.;2015;37;369;204;165
Kaišiadorys d. mun.;2015;38;414;248;166
Kaišiadorys d. mun.;2015;39;434;231;203
Kaišiadorys d. mun.;2015;40;424;206;218
Kaišiadorys d. mun.;2015;41;385;215;170
Kaišiadorys d. mun.;2015;42;448;219;229
Kaišiadorys d. mun.;2015;43;482;244;238
Kaišiadorys d. mun.;2015;44;488;273;215
Kaišiadorys d. mun.;2015;45;457;250;207
Kaišiadorys d. mun.;2015;46;473;251;222
Kaišiadorys d. mun.;2015;47;486;247;239
Kaišiadorys d. mun.;2015;48;480;248;232
Kaišiadorys d. mun.;2015;49;445;235;210
Kaišiadorys d. mun.;2015;50;460;257;203
Kaišiadorys d. mun.;2015;51;484;261;223
Kaišiadorys d. mun.;2015;52;486;260;226
Kaišiadorys d. mun.;2015;53;527;263;264
Kaišiadorys d. mun.;2015;54;469;232;237
Kaišiadorys d. mun.;2015;55;498;244;254
Kaišiadorys d. mun.;2015;56;461;210;251
Kaišiadorys d. mun.;2015;57;457;204;253
Kaišiadorys d. mun.;2015;58;400;198;202
Kaišiadorys d. mun.;2015;59;435;207;228
Kaišiadorys d. mun.;2015;60;371;166;205
Kaišiadorys d. mun.;2015;61;354;157;197
Kaišiadorys d. mun.;2015;62;351;166;185
Kaišiadorys d. mun.;2015;63;360;173;187
Kaišiadorys d. mun.;2015;64;353;147;206
Kaišiadorys d. mun.;2015;65;397;163;234
Kaišiadorys d. mun.;2015;66;344;151;193
Kaišiadorys d. mun.;2015;67;274;114;160
Kaišiadorys d. mun.;2015;68;277;119;158
Kaišiadorys d. mun.;2015;69;315;129;186
Kaišiadorys d. mun.;2015;70;236;100;136
Kaišiadorys d. mun.;2015;71;296;103;193
Kaišiadorys d. mun.;2015;72;311;122;189
Kaišiadorys d. mun.;2015;73;254;98;156
Kaišiadorys d. mun.;2015;74;289;112;177
Kaišiadorys d. mun.;2015;75;277;101;176
Kaišiadorys d. mun.;2015;76;276;104;172
Kaišiadorys d. mun.;2015;77;264;83;181
Kaišiadorys d. mun.;2015;78;235;84;151
Kaišiadorys d. mun.;2015;79;214;64;150
Kaišiadorys d. mun.;2015;80;200;58;142
Kaišiadorys d. mun.;2015;81;230;59;171
Kaišiadorys d. mun.;2015;82;211;54;157
Kaišiadorys d. mun.;2015;83;190;47;143
Kaišiadorys d. mun.;2015;84;159;34;125
Kaišiadorys d. mun.;2015;85;719;144;575
Kaišiadorys d. mun.;2016;-1;31447;16009;15438
Kaišiadorys d. mun.;2016;0;278;133;145
Kaišiadorys d. mun.;2016;1;281;156;125
Kaišiadorys d. mun.;2016;2;275;155;120
Kaišiadorys d. mun.;2016;3;268;133;135
Kaišiadorys d. mun.;2016;4;263;127;136
Kaišiadorys d. mun.;2016;5;277;141;136
Kaišiadorys d. mun.;2016;6;282;148;134
Kaišiadorys d. mun.;2016;7;268;133;135
Kaišiadorys d. mun.;2016;8;291;174;117
Kaišiadorys d. mun.;2016;9;252;129;123
Kaišiadorys d. mun.;2016;10;318;158;160
Kaišiadorys d. mun.;2016;11;258;136;122
Kaišiadorys d. mun.;2016;12;272;123;149
Kaišiadorys d. mun.;2016;13;267;141;126
Kaišiadorys d. mun.;2016;14;304;164;140
Kaišiadorys d. mun.;2016;15;340;178;162
Kaišiadorys d. mun.;2016;16;359;169;190
Kaišiadorys d. mun.;2016;17;388;188;200
Kaišiadorys d. mun.;2016;18;422;220;202
Kaišiadorys d. mun.;2016;19;357;189;168
Kaišiadorys d. mun.;2016;20;423;197;226
Kaišiadorys d. mun.;2016;21;371;187;184
Kaišiadorys d. mun.;2016;22;427;208;219
Kaišiadorys d. mun.;2016;23;502;287;215
Kaišiadorys d. mun.;2016;24;472;300;172
Kaišiadorys d. mun.;2016;25;510;353;157
Kaišiadorys d. mun.;2016;26;514;353;161
Kaišiadorys d. mun.;2016;27;495;362;133
Kaišiadorys d. mun.;2016;28;524;365;159
Kaišiadorys d. mun.;2016;29;480;341;139
Kaišiadorys d. mun.;2016;30;407;292;115
Kaišiadorys d. mun.;2016;31;418;263;155
Kaišiadorys d. mun.;2016;32;388;273;115
Kaišiadorys d. mun.;2016;33;323;211;112
Kaišiadorys d. mun.;2016;34;349;231;118
Kaišiadorys d. mun.;2016;35;355;221;134
Kaišiadorys d. mun.;2016;36;355;228;127
Kaišiadorys d. mun.;2016;37;395;224;171
Kaišiadorys d. mun.;2016;38;370;205;165
Kaišiadorys d. mun.;2016;39;412;253;159
Kaišiadorys d. mun.;2016;40;427;226;201
Kaišiadorys d. mun.;2016;41;419;203;216
Kaišiadorys d. mun.;2016;42;382;213;169
Kaišiadorys d. mun.;2016;43;445;217;228
Kaišiadorys d. mun.;2016;44;471;242;229
Kaišiadorys d. mun.;2016;45;474;263;211
Kaišiadorys d. mun.;2016;46;445;241;204
Kaišiadorys d. mun.;2016;47;474;251;223
Kaišiadorys d. mun.;2016;48;490;249;241
Kaišiadorys d. mun.;2016;49;480;247;233
Kaišiadorys d. mun.;2016;50;440;230;210
Kaišiadorys d. mun.;2016;51;456;252;204
Kaišiadorys d. mun.;2016;52;481;257;224
Kaišiadorys d. mun.;2016;53;485;260;225
Kaišiadorys d. mun.;2016;54;514;255;259
Kaišiadorys d. mun.;2016;55;470;232;238
Kaišiadorys d. mun.;2016;56;491;234;257
Kaišiadorys d. mun.;2016;57;464;211;253
Kaišiadorys d. mun.;2016;58;451;197;254
Kaišiadorys d. mun.;2016;59;395;193;202
Kaišiadorys d. mun.;2016;60;433;206;227
Kaišiadorys d. mun.;2016;61;368;163;205
Kaišiadorys d. mun.;2016;62;352;155;197
Kaišiadorys d. mun.;2016;63;338;158;180
Kaišiadorys d. mun.;2016;64;353;167;186
Kaišiadorys d. mun.;2016;65;345;141;204
Kaišiadorys d. mun.;2016;66;391;157;234
Kaišiadorys d. mun.;2016;67;333;145;188
Kaišiadorys d. mun.;2016;68;268;109;159
Kaišiadorys d. mun.;2016;69;270;115;155
Kaišiadorys d. mun.;2016;70;311;126;185
Kaišiadorys d. mun.;2016;71;228;93;135
Kaišiadorys d. mun.;2016;72;287;97;190
Kaišiadorys d. mun.;2016;73;300;113;187
Kaišiadorys d. mun.;2016;74;246;93;153
Kaišiadorys d. mun.;2016;75;274;105;169
Kaišiadorys d. mun.;2016;76;264;93;171
Kaišiadorys d. mun.;2016;77;257;93;164
Kaišiadorys d. mun.;2016;78;243;72;171
Kaišiadorys d. mun.;2016;79;226;79;147
Kaišiadorys d. mun.;2016;80;204;60;144
Kaišiadorys d. mun.;2016;81;190;53;137
Kaišiadorys d. mun.;2016;82;212;55;157
Kaišiadorys d. mun.;2016;83;194;51;143
Kaišiadorys d. mun.;2016;84;170;44;126
Kaišiadorys d. mun.;2016;85;726;144;582
Kaišiadorys d. mun.;2017;-1;30836;15736;15100
Kaišiadorys d. mun.;2017;0;283;151;132
Kaišiadorys d. mun.;2017;1;271;130;141
Kaišiadorys d. mun.;2017;2;273;150;123
Kaišiadorys d. mun.;2017;3;272;158;114
Kaišiadorys d. mun.;2017;4;268;129;139
Kaišiadorys d. mun.;2017;5;263;127;136
Kaišiadorys d. mun.;2017;6;276;139;137
Kaišiadorys d. mun.;2017;7;283;150;133
Kaišiadorys d. mun.;2017;8;260;128;132
Kaišiadorys d. mun.;2017;9;295;172;123
Kaišiadorys d. mun.;2017;10;252;129;123
Kaišiadorys d. mun.;2017;11;320;160;160
Kaišiadorys d. mun.;2017;12;260;137;123
Kaišiadorys d. mun.;2017;13;268;119;149
Kaišiadorys d. mun.;2017;14;270;145;125
Kaišiadorys d. mun.;2017;15;299;162;137
Kaišiadorys d. mun.;2017;16;339;180;159
Kaišiadorys d. mun.;2017;17;363;173;190
Kaišiadorys d. mun.;2017;18;383;185;198
Kaišiadorys d. mun.;2017;19;413;212;201
Kaišiadorys d. mun.;2017;20;351;186;165
Kaišiadorys d. mun.;2017;21;414;198;216
Kaišiadorys d. mun.;2017;22;352;177;175
Kaišiadorys d. mun.;2017;23;412;202;210
Kaišiadorys d. mun.;2017;24;487;282;205
Kaišiadorys d. mun.;2017;25;447;290;157
Kaišiadorys d. mun.;2017;26;474;341;133
Kaišiadorys d. mun.;2017;27;496;339;157
Kaišiadorys d. mun.;2017;28;466;351;115
Kaišiadorys d. mun.;2017;29;503;355;148
Kaišiadorys d. mun.;2017;30;474;342;132
Kaišiadorys d. mun.;2017;31;393;282;111
Kaišiadorys d. mun.;2017;32;386;249;137
Kaišiadorys d. mun.;2017;33;370;267;103
Kaišiadorys d. mun.;2017;34;309;210;99
Kaišiadorys d. mun.;2017;35;337;227;110
Kaišiadorys d. mun.;2017;36;342;210;132
Kaišiadorys d. mun.;2017;37;350;222;128
Kaišiadorys d. mun.;2017;38;383;216;167
Kaišiadorys d. mun.;2017;39;367;199;168
Kaišiadorys d. mun.;2017;40;405;246;159
Kaišiadorys d. mun.;2017;41;428;231;197
Kaišiadorys d. mun.;2017;42;412;200;212
Kaišiadorys d. mun.;2017;43;376;211;165
Kaišiadorys d. mun.;2017;44;436;209;227
Kaišiadorys d. mun.;2017;45;474;246;228
Kaišiadorys d. mun.;2017;46;474;262;212
Kaišiadorys d. mun.;2017;47;444;241;203
Kaišiadorys d. mun.;2017;48;470;249;221
Kaišiadorys d. mun.;2017;49;479;244;235
Kaišiadorys d. mun.;2017;50;476;242;234
Kaišiadorys d. mun.;2017;51;436;227;209
Kaišiadorys d. mun.;2017;52;444;241;203
Kaišiadorys d. mun.;2017;53;474;253;221
Kaišiadorys d. mun.;2017;54;468;250;218
Kaišiadorys d. mun.;2017;55;509;252;257
Kaišiadorys d. mun.;2017;56;467;227;240
Kaišiadorys d. mun.;2017;57;481;229;252
Kaišiadorys d. mun.;2017;58;458;207;251
Kaišiadorys d. mun.;2017;59;446;191;255
Kaišiadorys d. mun.;2017;60;390;188;202
Kaišiadorys d. mun.;2017;61;423;202;221
Kaišiadorys d. mun.;2017;62;363;162;201
Kaišiadorys d. mun.;2017;63;353;156;197
Kaišiadorys d. mun.;2017;64;329;148;181
Kaišiadorys d. mun.;2017;65;348;162;186
Kaišiadorys d. mun.;2017;66;339;135;204
Kaišiadorys d. mun.;2017;67;382;152;230
Kaišiadorys d. mun.;2017;68;322;139;183
Kaišiadorys d. mun.;2017;69;266;108;158
Kaišiadorys d. mun.;2017;70;263;112;151
Kaišiadorys d. mun.;2017;71;300;118;182
Kaišiadorys d. mun.;2017;72;221;89;132
Kaišiadorys d. mun.;2017;73;275;91;184
Kaišiadorys d. mun.;2017;74;287;107;180
Kaišiadorys d. mun.;2017;75;238;88;150
Kaišiadorys d. mun.;2017;76;261;96;165
Kaišiadorys d. mun.;2017;77;251;88;163
Kaišiadorys d. mun.;2017;78;234;79;155
Kaišiadorys d. mun.;2017;79;229;69;160
Kaišiadorys d. mun.;2017;80;206;68;138
Kaišiadorys d. mun.;2017;81;197;54;143
Kaišiadorys d. mun.;2017;82;177;49;128
Kaišiadorys d. mun.;2017;83;191;49;142
Kaišiadorys d. mun.;2017;84;176;44;132
Kaišiadorys d. mun.;2017;85;734;144;590
Kaišiadorys d. mun.;2018;-1;30257;15477;14780
Kaišiadorys d. mun.;2018;0;260;127;133
Kaišiadorys d. mun.;2018;1;277;150;127
Kaišiadorys d. mun.;2018;2;265;127;138
Kaišiadorys d. mun.;2018;3;264;143;121
Kaišiadorys d. mun.;2018;4;271;154;117
Kaišiadorys d. mun.;2018;5;264;127;137
Kaišiadorys d. mun.;2018;6;262;126;136
Kaišiadorys d. mun.;2018;7;273;138;135
Kaišiadorys d. mun.;2018;8;282;148;134
Kaišiadorys d. mun.;2018;9;256;130;126
Kaišiadorys d. mun.;2018;10;293;168;125
Kaišiadorys d. mun.;2018;11;255;130;125
Kaišiadorys d. mun.;2018;12;319;159;160
Kaišiadorys d. mun.;2018;13;255;133;122
Kaišiadorys d. mun.;2018;14;268;118;150
Kaišiadorys d. mun.;2018;15;263;139;124
Kaišiadorys d. mun.;2018;16;301;162;139
Kaišiadorys d. mun.;2018;17;340;179;161
Kaišiadorys d. mun.;2018;18;346;167;179
Kaišiadorys d. mun.;2018;19;373;185;188
Kaišiadorys d. mun.;2018;20;407;210;197
Kaišiadorys d. mun.;2018;21;340;178;162
Kaišiadorys d. mun.;2018;22;398;191;207
Kaišiadorys d. mun.;2018;23;340;175;165
Kaišiadorys d. mun.;2018;24;393;193;200
Kaišiadorys d. mun.;2018;25;453;266;187
Kaišiadorys d. mun.;2018;26;422;282;140
Kaišiadorys d. mun.;2018;27;445;328;117
Kaišiadorys d. mun.;2018;28;475;330;145
Kaišiadorys d. mun.;2018;29;451;340;111
Kaišiadorys d. mun.;2018;30;486;353;133
Kaišiadorys d. mun.;2018;31;471;340;131
Kaišiadorys d. mun.;2018;32;388;283;105
Kaišiadorys d. mun.;2018;33;370;240;130
Kaišiadorys d. mun.;2018;34;366;263;103
Kaišiadorys d. mun.;2018;35;305;205;100
Kaišiadorys d. mun.;2018;36;332;222;110
Kaišiadorys d. mun.;2018;37;338;205;133
Kaišiadorys d. mun.;2018;38;344;222;122
Kaišiadorys d. mun.;2018;39;380;214;166
Kaišiadorys d. mun.;2018;40;366;205;161
Kaišiadorys d. mun.;2018;41;393;241;152
Kaišiadorys d. mun.;2018;42;421;224;197
Kaišiadorys d. mun.;2018;43;403;195;208
Kaišiadorys d. mun.;2018;44;373;209;164
Kaišiadorys d. mun.;2018;45;432;207;225
Kaišiadorys d. mun.;2018;46;474;245;229
Kaišiadorys d. mun.;2018;47;471;259;212
Kaišiadorys d. mun.;2018;48;443;240;203
Kaišiadorys d. mun.;2018;49;468;252;216
Kaišiadorys d. mun.;2018;50;471;244;227
Kaišiadorys d. mun.;2018;51;473;239;234
Kaišiadorys d. mun.;2018;52;438;229;209
Kaišiadorys d. mun.;2018;53;434;234;200
Kaišiadorys d. mun.;2018;54;472;252;220
Kaišiadorys d. mun.;2018;55;465;246;219
Kaišiadorys d. mun.;2018;56;503;247;256
Kaišiadorys d. mun.;2018;57;462;224;238
Kaišiadorys d. mun.;2018;58;472;223;249
Kaišiadorys d. mun.;2018;59;451;201;250
Kaišiadorys d. mun.;2018;60;439;187;252
Kaišiadorys d. mun.;2018;61;388;188;200
Kaišiadorys d. mun.;2018;62;413;191;222
Kaišiadorys d. mun.;2018;63;350;153;197
Kaišiadorys d. mun.;2018;64;346;150;196
Kaišiadorys d. mun.;2018;65;324;145;179
Kaišiadorys d. mun.;2018;66;336;154;182
Kaišiadorys d. mun.;2018;67;330;130;200
Kaišiadorys d. mun.;2018;68;370;148;222
Kaišiadorys d. mun.;2018;69;310;129;181
Kaišiadorys d. mun.;2018;70;256;101;155
Kaišiadorys d. mun.;2018;71;258;108;150
Kaišiadorys d. mun.;2018;72;288;112;176
Kaišiadorys d. mun.;2018;73;211;83;128
Kaišiadorys d. mun.;2018;74;264;87;177
Kaišiadorys d. mun.;2018;75;275;101;174
Kaišiadorys d. mun.;2018;76;231;85;146
Kaišiadorys d. mun.;2018;77;245;88;157
Kaišiadorys d. mun.;2018;78;237;81;156
Kaišiadorys d. mun.;2018;79;228;74;154
Kaišiadorys d. mun.;2018;80;217;66;151
Kaišiadorys d. mun.;2018;81;198;64;134
Kaišiadorys d. mun.;2018;82;185;48;137
Kaišiadorys d. mun.;2018;83;160;44;116
Kaišiadorys d. mun.;2018;84;173;41;132
Kaišiadorys d. mun.;2018;85;749;153;596
Kalvarija mun.;2001;-1;13907;6659;7248
Kalvarija mun.;2001;0;162;87;75
Kalvarija mun.;2001;1;153;74;79
Kalvarija mun.;2001;2;181;103;78
Kalvarija mun.;2001;3;180;87;93
Kalvarija mun.;2001;4;165;83;82
Kalvarija mun.;2001;5;219;114;105
Kalvarija mun.;2001;6;205;113;92
Kalvarija mun.;2001;7;238;131;107
Kalvarija mun.;2001;8;242;122;120
Kalvarija mun.;2001;9;240;123;117
Kalvarija mun.;2001;10;253;131;122
Kalvarija mun.;2001;11;225;116;109
Kalvarija mun.;2001;12;215;105;110
Kalvarija mun.;2001;13;245;119;126
Kalvarija mun.;2001;14;255;116;139
Kalvarija mun.;2001;15;212;112;100
Kalvarija mun.;2001;16;229;128;101
Kalvarija mun.;2001;17;248;130;118
Kalvarija mun.;2001;18;189;100;89
Kalvarija mun.;2001;19;169;91;78
Kalvarija mun.;2001;20;169;92;77
Kalvarija mun.;2001;21;162;98;64
Kalvarija mun.;2001;22;155;85;70
Kalvarija mun.;2001;23;171;98;73
Kalvarija mun.;2001;24;154;74;80
Kalvarija mun.;2001;25;148;81;67
Kalvarija mun.;2001;26;159;80;79
Kalvarija mun.;2001;27;175;101;74
Kalvarija mun.;2001;28;200;114;86
Kalvarija mun.;2001;29;184;86;98
Kalvarija mun.;2001;30;179;89;90
Kalvarija mun.;2001;31;171;79;92
Kalvarija mun.;2001;32;200;99;101
Kalvarija mun.;2001;33;174;88;86
Kalvarija mun.;2001;34;175;88;87
Kalvarija mun.;2001;35;189;97;92
Kalvarija mun.;2001;36;179;94;85
Kalvarija mun.;2001;37;206;115;91
Kalvarija mun.;2001;38;195;92;103
Kalvarija mun.;2001;39;180;92;88
Kalvarija mun.;2001;40;178;93;85
Kalvarija mun.;2001;41;224;122;102
Kalvarija mun.;2001;42;177;96;81
Kalvarija mun.;2001;43;174;87;87
Kalvarija mun.;2001;44;152;81;71
Kalvarija mun.;2001;45;173;86;87
Kalvarija mun.;2001;46;157;70;87
Kalvarija mun.;2001;47;124;68;56
Kalvarija mun.;2001;48;148;82;66
Kalvarija mun.;2001;49;120;55;65
Kalvarija mun.;2001;50;142;79;63
Kalvarija mun.;2001;51;125;63;62
Kalvarija mun.;2001;52;105;48;57
Kalvarija mun.;2001;53;113;53;60
Kalvarija mun.;2001;54;92;48;44
Kalvarija mun.;2001;55;126;69;57
Kalvarija mun.;2001;56;102;49;53
Kalvarija mun.;2001;57;148;56;92
Kalvarija mun.;2001;58;131;63;68
Kalvarija mun.;2001;59;157;61;96
Kalvarija mun.;2001;60;140;57;83
Kalvarija mun.;2001;61;149;60;89
Kalvarija mun.;2001;62;141;59;82
Kalvarija mun.;2001;63;144;70;74
Kalvarija mun.;2001;64;148;67;81
Kalvarija mun.;2001;65;167;56;111
Kalvarija mun.;2001;66;157;60;97
Kalvarija mun.;2001;67;192;68;124
Kalvarija mun.;2001;68;195;71;124
Kalvarija mun.;2001;69;161;63;98
Kalvarija mun.;2001;70;169;70;99
Kalvarija mun.;2001;71;183;72;111
Kalvarija mun.;2001;72;173;60;113
Kalvarija mun.;2001;73;138;55;83
Kalvarija mun.;2001;74;131;41;90
Kalvarija mun.;2001;75;119;43;76
Kalvarija mun.;2001;76;103;35;68
Kalvarija mun.;2001;77;89;27;62
Kalvarija mun.;2001;78;81;25;56
Kalvarija mun.;2001;79;65;21;44
Kalvarija mun.;2001;80;54;18;36
Kalvarija mun.;2001;81;61;19;42
Kalvarija mun.;2001;82;44;13;31
Kalvarija mun.;2001;83;34;7;27
Kalvarija mun.;2001;84;48;12;36
Kalvarija mun.;2001;85;203;54;149
Kalvarija mun.;2002;-1;13724;6550;7174
Kalvarija mun.;2002;0;142;68;74
Kalvarija mun.;2002;1;160;86;74
Kalvarija mun.;2002;2;150;71;79
Kalvarija mun.;2002;3;181;103;78
Kalvarija mun.;2002;4;176;84;92
Kalvarija mun.;2002;5;163;81;82
Kalvarija mun.;2002;6;216;111;105
Kalvarija mun.;2002;7;207;115;92
Kalvarija mun.;2002;8;234;129;105
Kalvarija mun.;2002;9;239;119;120
Kalvarija mun.;2002;10;237;121;116
Kalvarija mun.;2002;11;251;130;121
Kalvarija mun.;2002;12;220;114;106
Kalvarija mun.;2002;13;209;104;105
Kalvarija mun.;2002;14;241;117;124
Kalvarija mun.;2002;15;252;114;138
Kalvarija mun.;2002;16;209;111;98
Kalvarija mun.;2002;17;224;124;100
Kalvarija mun.;2002;18;242;126;116
Kalvarija mun.;2002;19;180;96;84
Kalvarija mun.;2002;20;167;90;77
Kalvarija mun.;2002;21;165;88;77
Kalvarija mun.;2002;22;161;97;64
Kalvarija mun.;2002;23;153;83;70
Kalvarija mun.;2002;24;165;94;71
Kalvarija mun.;2002;25;151;74;77
Kalvarija mun.;2002;26;145;79;66
Kalvarija mun.;2002;27;158;78;80
Kalvarija mun.;2002;28;171;97;74
Kalvarija mun.;2002;29;196;111;85
Kalvarija mun.;2002;30;181;84;97
Kalvarija mun.;2002;31;176;88;88
Kalvarija mun.;2002;32;167;77;90
Kalvarija mun.;2002;33;199;97;102
Kalvarija mun.;2002;34;171;85;86
Kalvarija mun.;2002;35;173;87;86
Kalvarija mun.;2002;36;185;95;90
Kalvarija mun.;2002;37;178;94;84
Kalvarija mun.;2002;38;201;110;91
Kalvarija mun.;2002;39;190;88;102
Kalvarija mun.;2002;40;179;90;89
Kalvarija mun.;2002;41;177;92;85
Kalvarija mun.;2002;42;221;120;101
Kalvarija mun.;2002;43;174;94;80
Kalvarija mun.;2002;44;171;86;85
Kalvarija mun.;2002;45;149;79;70
Kalvarija mun.;2002;46;171;87;84
Kalvarija mun.;2002;47;156;68;88
Kalvarija mun.;2002;48;122;66;56
Kalvarija mun.;2002;49;146;81;65
Kalvarija mun.;2002;50;115;51;64
Kalvarija mun.;2002;51;129;76;53
Kalvarija mun.;2002;52;120;60;60
Kalvarija mun.;2002;53;98;43;55
Kalvarija mun.;2002;54;108;49;59
Kalvarija mun.;2002;55;90;47;43
Kalvarija mun.;2002;56;124;67;57
Kalvarija mun.;2002;57;100;48;52
Kalvarija mun.;2002;58;145;54;91
Kalvarija mun.;2002;59;128;62;66
Kalvarija mun.;2002;60;154;60;94
Kalvarija mun.;2002;61;136;56;80
Kalvarija mun.;2002;62;147;58;89
Kalvarija mun.;2002;63;140;57;83
Kalvarija mun.;2002;64;143;69;74
Kalvarija mun.;2002;65;145;67;78
Kalvarija mun.;2002;66;165;55;110
Kalvarija mun.;2002;67;156;60;96
Kalvarija mun.;2002;68;188;67;121
Kalvarija mun.;2002;69;196;71;125
Kalvarija mun.;2002;70;155;59;96
Kalvarija mun.;2002;71;163;65;98
Kalvarija mun.;2002;72;175;67;108
Kalvarija mun.;2002;73;167;58;109
Kalvarija mun.;2002;74;134;51;83
Kalvarija mun.;2002;75;124;38;86
Kalvarija mun.;2002;76;113;40;73
Kalvarija mun.;2002;77;95;30;65
Kalvarija mun.;2002;78;83;25;58
Kalvarija mun.;2002;79;71;22;49
Kalvarija mun.;2002;80;63;21;42
Kalvarija mun.;2002;81;50;15;35
Kalvarija mun.;2002;82;54;17;37
Kalvarija mun.;2002;83;42;14;28
Kalvarija mun.;2002;84;31;7;24
Kalvarija mun.;2002;85;225;61;164
Kalvarija mun.;2003;-1;13618;6491;7127
Kalvarija mun.;2003;0;156;77;79
Kalvarija mun.;2003;1;138;67;71
Kalvarija mun.;2003;2;157;83;74
Kalvarija mun.;2003;3;149;72;77
Kalvarija mun.;2003;4;180;102;78
Kalvarija mun.;2003;5;176;83;93
Kalvarija mun.;2003;6;161;80;81
Kalvarija mun.;2003;7;215;109;106
Kalvarija mun.;2003;8;206;114;92
Kalvarija mun.;2003;9;230;129;101
Kalvarija mun.;2003;10;237;119;118
Kalvarija mun.;2003;11;237;122;115
Kalvarija mun.;2003;12;248;128;120
Kalvarija mun.;2003;13;217;112;105
Kalvarija mun.;2003;14;208;103;105
Kalvarija mun.;2003;15;237;114;123
Kalvarija mun.;2003;16;249;114;135
Kalvarija mun.;2003;17;207;109;98
Kalvarija mun.;2003;18;222;124;98
Kalvarija mun.;2003;19;238;125;113
Kalvarija mun.;2003;20;181;95;86
Kalvarija mun.;2003;21;162;88;74
Kalvarija mun.;2003;22;164;90;74
Kalvarija mun.;2003;23;161;94;67
Kalvarija mun.;2003;24;153;81;72
Kalvarija mun.;2003;25;160;93;67
Kalvarija mun.;2003;26;150;73;77
Kalvarija mun.;2003;27;137;77;60
Kalvarija mun.;2003;28;152;77;75
Kalvarija mun.;2003;29;171;98;73
Kalvarija mun.;2003;30;193;110;83
Kalvarija mun.;2003;31;181;83;98
Kalvarija mun.;2003;32;175;87;88
Kalvarija mun.;2003;33;159;72;87
Kalvarija mun.;2003;34;194;95;99
Kalvarija mun.;2003;35;166;83;83
Kalvarija mun.;2003;36;163;84;79
Kalvarija mun.;2003;37;183;94;89
Kalvarija mun.;2003;38;176;92;84
Kalvarija mun.;2003;39;199;110;89
Kalvarija mun.;2003;40;189;86;103
Kalvarija mun.;2003;41;179;92;87
Kalvarija mun.;2003;42;175;91;84
Kalvarija mun.;2003;43;223;123;100
Kalvarija mun.;2003;44;175;93;82
Kalvarija mun.;2003;45;168;83;85
Kalvarija mun.;2003;46;148;77;71
Kalvarija mun.;2003;47;171;87;84
Kalvarija mun.;2003;48;155;67;88
Kalvarija mun.;2003;49;123;68;55
Kalvarija mun.;2003;50;144;79;65
Kalvarija mun.;2003;51;112;49;63
Kalvarija mun.;2003;52;134;74;60
Kalvarija mun.;2003;53;118;59;59
Kalvarija mun.;2003;54;99;40;59
Kalvarija mun.;2003;55;107;47;60
Kalvarija mun.;2003;56;90;47;43
Kalvarija mun.;2003;57;125;68;57
Kalvarija mun.;2003;58;94;43;51
Kalvarija mun.;2003;59;143;53;90
Kalvarija mun.;2003;60;127;60;67
Kalvarija mun.;2003;61;151;59;92
Kalvarija mun.;2003;62;134;55;79
Kalvarija mun.;2003;63;150;59;91
Kalvarija mun.;2003;64;142;59;83
Kalvarija mun.;2003;65;142;68;74
Kalvarija mun.;2003;66;151;70;81
Kalvarija mun.;2003;67;168;55;113
Kalvarija mun.;2003;68;148;57;91
Kalvarija mun.;2003;69;182;62;120
Kalvarija mun.;2003;70;192;69;123
Kalvarija mun.;2003;71;152;57;95
Kalvarija mun.;2003;72;157;60;97
Kalvarija mun.;2003;73;168;65;103
Kalvarija mun.;2003;74;164;57;107
Kalvarija mun.;2003;75;126;47;79
Kalvarija mun.;2003;76;120;38;82
Kalvarija mun.;2003;77;107;35;72
Kalvarija mun.;2003;78;88;26;62
Kalvarija mun.;2003;79;74;21;53
Kalvarija mun.;2003;80;62;19;43
Kalvarija mun.;2003;81;55;14;41
Kalvarija mun.;2003;82;47;13;34
Kalvarija mun.;2003;83;50;15;35
Kalvarija mun.;2003;84;35;10;25
Kalvarija mun.;2003;85;206;53;153
Kalvarija mun.;2004;-1;13477;6412;7065
Kalvarija mun.;2004;0;133;70;63
Kalvarija mun.;2004;1;155;76;79
Kalvarija mun.;2004;2;134;66;68
Kalvarija mun.;2004;3;158;84;74
Kalvarija mun.;2004;4;145;71;74
Kalvarija mun.;2004;5;181;103;78
Kalvarija mun.;2004;6;174;81;93
Kalvarija mun.;2004;7;161;80;81
Kalvarija mun.;2004;8;214;109;105
Kalvarija mun.;2004;9;206;114;92
Kalvarija mun.;2004;10;232;130;102
Kalvarija mun.;2004;11;235;118;117
Kalvarija mun.;2004;12;237;121;116
Kalvarija mun.;2004;13;244;127;117
Kalvarija mun.;2004;14;214;112;102
Kalvarija mun.;2004;15;207;102;105
Kalvarija mun.;2004;16;234;113;121
Kalvarija mun.;2004;17;247;112;135
Kalvarija mun.;2004;18;201;107;94
Kalvarija mun.;2004;19;216;120;96
Kalvarija mun.;2004;20;235;123;112
Kalvarija mun.;2004;21;178;93;85
Kalvarija mun.;2004;22;163;87;76
Kalvarija mun.;2004;23;159;88;71
Kalvarija mun.;2004;24;159;89;70
Kalvarija mun.;2004;25;157;81;76
Kalvarija mun.;2004;26;160;93;67
Kalvarija mun.;2004;27;147;72;75
Kalvarija mun.;2004;28;136;75;61
Kalvarija mun.;2004;29;149;77;72
Kalvarija mun.;2004;30;162;90;72
Kalvarija mun.;2004;31;191;107;84
Kalvarija mun.;2004;32;178;82;96
Kalvarija mun.;2004;33;176;85;91
Kalvarija mun.;2004;34;161;72;89
Kalvarija mun.;2004;35;192;94;98
Kalvarija mun.;2004;36;168;85;83
Kalvarija mun.;2004;37;163;81;82
Kalvarija mun.;2004;38;182;92;90
Kalvarija mun.;2004;39;171;88;83
Kalvarija mun.;2004;40;199;112;87
Kalvarija mun.;2004;41;190;87;103
Kalvarija mun.;2004;42;177;91;86
Kalvarija mun.;2004;43;175;92;83
Kalvarija mun.;2004;44;219;120;99
Kalvarija mun.;2004;45;175;93;82
Kalvarija mun.;2004;46;166;82;84
Kalvarija mun.;2004;47;148;79;69
Kalvarija mun.;2004;48;168;84;84
Kalvarija mun.;2004;49;153;66;87
Kalvarija mun.;2004;50;123;68;55
Kalvarija mun.;2004;51;143;76;67
Kalvarija mun.;2004;52;112;51;61
Kalvarija mun.;2004;53;134;75;59
Kalvarija mun.;2004;54;119;60;59
Kalvarija mun.;2004;55;99;42;57
Kalvarija mun.;2004;56;103;45;58
Kalvarija mun.;2004;57;88;47;41
Kalvarija mun.;2004;58;119;64;55
Kalvarija mun.;2004;59;92;42;50
Kalvarija mun.;2004;60;142;50;92
Kalvarija mun.;2004;61;121;56;65
Kalvarija mun.;2004;62;147;57;90
Kalvarija mun.;2004;63;131;54;77
Kalvarija mun.;2004;64;142;52;90
Kalvarija mun.;2004;65;137;54;83
Kalvarija mun.;2004;66;141;66;75
Kalvarija mun.;2004;67;145;67;78
Kalvarija mun.;2004;68;162;50;112
Kalvarija mun.;2004;69;147;56;91
Kalvarija mun.;2004;70;177;58;119
Kalvarija mun.;2004;71;186;66;120
Kalvarija mun.;2004;72;143;53;90
Kalvarija mun.;2004;73;146;55;91
Kalvarija mun.;2004;74;166;61;105
Kalvarija mun.;2004;75;156;51;105
Kalvarija mun.;2004;76;121;44;77
Kalvarija mun.;2004;77;114;35;79
Kalvarija mun.;2004;78;103;32;71
Kalvarija mun.;2004;79;84;23;61
Kalvarija mun.;2004;80;61;17;44
Kalvarija mun.;2004;81;54;15;39
Kalvarija mun.;2004;82;50;13;37
Kalvarija mun.;2004;83;41;10;31
Kalvarija mun.;2004;84;45;15;30
Kalvarija mun.;2004;85;198;56;142
Kalvarija mun.;2005;-1;13323;6320;7003
Kalvarija mun.;2005;0;135;69;66
Kalvarija mun.;2005;1;131;68;63
Kalvarija mun.;2005;2;156;76;80
Kalvarija mun.;2005;3;131;65;66
Kalvarija mun.;2005;4;152;81;71
Kalvarija mun.;2005;5;143;71;72
Kalvarija mun.;2005;6;180;103;77
Kalvarija mun.;2005;7;175;81;94
Kalvarija mun.;2005;8;160;79;81
Kalvarija mun.;2005;9;208;106;102
Kalvarija mun.;2005;10;205;113;92
Kalvarija mun.;2005;11;227;127;100
Kalvarija mun.;2005;12;236;118;118
Kalvarija mun.;2005;13;234;120;114
Kalvarija mun.;2005;14;240;125;115
Kalvarija mun.;2005;15;210;111;99
Kalvarija mun.;2005;16;202;99;103
Kalvarija mun.;2005;17;229;112;117
Kalvarija mun.;2005;18;237;107;130
Kalvarija mun.;2005;19;198;104;94
Kalvarija mun.;2005;20;213;117;96
Kalvarija mun.;2005;21;234;122;112
Kalvarija mun.;2005;22;176;91;85
Kalvarija mun.;2005;23;160;85;75
Kalvarija mun.;2005;24;157;88;69
Kalvarija mun.;2005;25;160;92;68
Kalvarija mun.;2005;26;147;73;74
Kalvarija mun.;2005;27;155;90;65
Kalvarija mun.;2005;28;137;66;71
Kalvarija mun.;2005;29;128;73;55
Kalvarija mun.;2005;30;144;74;70
Kalvarija mun.;2005;31;157;88;69
Kalvarija mun.;2005;32;186;104;82
Kalvarija mun.;2005;33;175;80;95
Kalvarija mun.;2005;34;169;80;89
Kalvarija mun.;2005;35;162;72;90
Kalvarija mun.;2005;36;190;95;95
Kalvarija mun.;2005;37;167;84;83
Kalvarija mun.;2005;38;159;77;82
Kalvarija mun.;2005;39;181;91;90
Kalvarija mun.;2005;40;172;89;83
Kalvarija mun.;2005;41;192;107;85
Kalvarija mun.;2005;42;187;87;100
Kalvarija mun.;2005;43;176;88;88
Kalvarija mun.;2005;44;174;89;85
Kalvarija mun.;2005;45;223;122;101
Kalvarija mun.;2005;46;173;92;81
Kalvarija mun.;2005;47;168;84;84
Kalvarija mun.;2005;48;152;81;71
Kalvarija mun.;2005;49;170;83;87
Kalvarija mun.;2005;50;152;65;87
Kalvarija mun.;2005;51;121;66;55
Kalvarija mun.;2005;52;143;76;67
Kalvarija mun.;2005;53;112;51;61
Kalvarija mun.;2005;54;132;73;59
Kalvarija mun.;2005;55;124;60;64
Kalvarija mun.;2005;56;98;41;57
Kalvarija mun.;2005;57;102;45;57
Kalvarija mun.;2005;58;86;45;41
Kalvarija mun.;2005;59;116;62;54
Kalvarija mun.;2005;60;93;44;49
Kalvarija mun.;2005;61;142;48;94
Kalvarija mun.;2005;62;118;53;65
Kalvarija mun.;2005;63;148;59;89
Kalvarija mun.;2005;64;127;52;75
Kalvarija mun.;2005;65;139;49;90
Kalvarija mun.;2005;66;135;52;83
Kalvarija mun.;2005;67;142;65;77
Kalvarija mun.;2005;68;140;63;77
Kalvarija mun.;2005;69;159;47;112
Kalvarija mun.;2005;70;145;54;91
Kalvarija mun.;2005;71;163;52;111
Kalvarija mun.;2005;72;178;60;118
Kalvarija mun.;2005;73;139;52;87
Kalvarija mun.;2005;74;142;53;89
Kalvarija mun.;2005;75;159;56;103
Kalvarija mun.;2005;76;152;49;103
Kalvarija mun.;2005;77;115;41;74
Kalvarija mun.;2005;78;110;34;76
Kalvarija mun.;2005;79;98;30;68
Kalvarija mun.;2005;80;76;20;56
Kalvarija mun.;2005;81;56;14;42
Kalvarija mun.;2005;82;47;11;36
Kalvarija mun.;2005;83;43;12;31
Kalvarija mun.;2005;84;37;7;30
Kalvarija mun.;2005;85;201;60;141
Kalvarija mun.;2006;-1;13077;6219;6858
Kalvarija mun.;2006;0;115;62;53
Kalvarija mun.;2006;1;135;71;64
Kalvarija mun.;2006;2;130;69;61
Kalvarija mun.;2006;3;149;74;75
Kalvarija mun.;2006;4;126;64;62
Kalvarija mun.;2006;5;153;81;72
Kalvarija mun.;2006;6;140;71;69
Kalvarija mun.;2006;7;175;99;76
Kalvarija mun.;2006;8;172;79;93
Kalvarija mun.;2006;9;159;80;79
Kalvarija mun.;2006;10;204;104;100
Kalvarija mun.;2006;11;204;113;91
Kalvarija mun.;2006;12;228;128;100
Kalvarija mun.;2006;13;231;115;116
Kalvarija mun.;2006;14;232;119;113
Kalvarija mun.;2006;15;235;122;113
Kalvarija mun.;2006;16;208;108;100
Kalvarija mun.;2006;17;201;99;102
Kalvarija mun.;2006;18;219;107;112
Kalvarija mun.;2006;19;224;102;122
Kalvarija mun.;2006;20;187;99;88
Kalvarija mun.;2006;21;203;111;92
Kalvarija mun.;2006;22;224;120;104
Kalvarija mun.;2006;23;170;88;82
Kalvarija mun.;2006;24;152;80;72
Kalvarija mun.;2006;25;144;82;62
Kalvarija mun.;2006;26;152;89;63
Kalvarija mun.;2006;27;146;72;74
Kalvarija mun.;2006;28;153;90;63
Kalvarija mun.;2006;29;135;66;69
Kalvarija mun.;2006;30;124;72;52
Kalvarija mun.;2006;31;137;70;67
Kalvarija mun.;2006;32;152;87;65
Kalvarija mun.;2006;33;182;101;81
Kalvarija mun.;2006;34;169;77;92
Kalvarija mun.;2006;35;168;79;89
Kalvarija mun.;2006;36;160;71;89
Kalvarija mun.;2006;37;185;93;92
Kalvarija mun.;2006;38;163;82;81
Kalvarija mun.;2006;39;159;77;82
Kalvarija mun.;2006;40;181;90;91
Kalvarija mun.;2006;41;170;88;82
Kalvarija mun.;2006;42;191;107;84
Kalvarija mun.;2006;43;181;85;96
Kalvarija mun.;2006;44;178;90;88
Kalvarija mun.;2006;45;174;89;85
Kalvarija mun.;2006;46;217;117;100
Kalvarija mun.;2006;47;171;91;80
Kalvarija mun.;2006;48;163;80;83
Kalvarija mun.;2006;49;149;80;69
Kalvarija mun.;2006;50;170;82;88
Kalvarija mun.;2006;51;149;64;85
Kalvarija mun.;2006;52;120;66;54
Kalvarija mun.;2006;53;137;72;65
Kalvarija mun.;2006;54;110;48;62
Kalvarija mun.;2006;55;136;76;60
Kalvarija mun.;2006;56;121;58;63
Kalvarija mun.;2006;57;100;43;57
Kalvarija mun.;2006;58;101;45;56
Kalvarija mun.;2006;59;85;44;41
Kalvarija mun.;2006;60;114;60;54
Kalvarija mun.;2006;61;92;43;49
Kalvarija mun.;2006;62;140;47;93
Kalvarija mun.;2006;63;118;55;63
Kalvarija mun.;2006;64;146;57;89
Kalvarija mun.;2006;65;125;51;74
Kalvarija mun.;2006;66;137;46;91
Kalvarija mun.;2006;67;133;51;82
Kalvarija mun.;2006;68;138;62;76
Kalvarija mun.;2006;69;138;61;77
Kalvarija mun.;2006;70;155;44;111
Kalvarija mun.;2006;71;134;46;88
Kalvarija mun.;2006;72;156;47;109
Kalvarija mun.;2006;73;174;58;116
Kalvarija mun.;2006;74;134;49;85
Kalvarija mun.;2006;75;138;52;86
Kalvarija mun.;2006;76;157;54;103
Kalvarija mun.;2006;77;144;44;100
Kalvarija mun.;2006;78;107;36;71
Kalvarija mun.;2006;79;100;31;69
Kalvarija mun.;2006;80;95;28;67
Kalvarija mun.;2006;81;70;18;52
Kalvarija mun.;2006;82;50;13;37
Kalvarija mun.;2006;83;42;9;33
Kalvarija mun.;2006;84;40;11;29
Kalvarija mun.;2006;85;191;58;133
Kalvarija mun.;2007;-1;12909;6123;6786
Kalvarija mun.;2007;0;132;64;68
Kalvarija mun.;2007;1;114;61;53
Kalvarija mun.;2007;2;134;69;65
Kalvarija mun.;2007;3;135;73;62
Kalvarija mun.;2007;4;146;72;74
Kalvarija mun.;2007;5;127;64;63
Kalvarija mun.;2007;6;151;79;72
Kalvarija mun.;2007;7;142;72;70
Kalvarija mun.;2007;8;175;98;77
Kalvarija mun.;2007;9;171;80;91
Kalvarija mun.;2007;10;156;77;79
Kalvarija mun.;2007;11;206;106;100
Kalvarija mun.;2007;12;202;112;90
Kalvarija mun.;2007;13;227;126;101
Kalvarija mun.;2007;14;229;114;115
Kalvarija mun.;2007;15;233;121;112
Kalvarija mun.;2007;16;235;123;112
Kalvarija mun.;2007;17;210;110;100
Kalvarija mun.;2007;18;197;97;100
Kalvarija mun.;2007;19;215;105;110
Kalvarija mun.;2007;20;216;98;118
Kalvarija mun.;2007;21;182;95;87
Kalvarija mun.;2007;22;201;109;92
Kalvarija mun.;2007;23;215;115;100
Kalvarija mun.;2007;24;163;86;77
Kalvarija mun.;2007;25;148;78;70
Kalvarija mun.;2007;26;138;80;58
Kalvarija mun.;2007;27;148;85;63
Kalvarija mun.;2007;28;144;69;75
Kalvarija mun.;2007;29;146;87;59
Kalvarija mun.;2007;30;131;66;65
Kalvarija mun.;2007;31;120;68;52
Kalvarija mun.;2007;32;136;71;65
Kalvarija mun.;2007;33;151;86;65
Kalvarija mun.;2007;34;178;101;77
Kalvarija mun.;2007;35;171;78;93
Kalvarija mun.;2007;36;168;79;89
Kalvarija mun.;2007;37;165;72;93
Kalvarija mun.;2007;38;182;92;90
Kalvarija mun.;2007;39;158;80;78
Kalvarija mun.;2007;40;161;81;80
Kalvarija mun.;2007;41;174;86;88
Kalvarija mun.;2007;42;167;88;79
Kalvarija mun.;2007;43;187;104;83
Kalvarija mun.;2007;44;179;83;96
Kalvarija mun.;2007;45;182;94;88
Kalvarija mun.;2007;46;172;87;85
Kalvarija mun.;2007;47;216;117;99
Kalvarija mun.;2007;48;171;92;79
Kalvarija mun.;2007;49;164;80;84
Kalvarija mun.;2007;50;147;78;69
Kalvarija mun.;2007;51;170;82;88
Kalvarija mun.;2007;52;147;61;86
Kalvarija mun.;2007;53;118;66;52
Kalvarija mun.;2007;54;135;70;65
Kalvarija mun.;2007;55;109;47;62
Kalvarija mun.;2007;56;134;72;62
Kalvarija mun.;2007;57;119;58;61
Kalvarija mun.;2007;58;97;41;56
Kalvarija mun.;2007;59;102;45;57
Kalvarija mun.;2007;60;82;42;40
Kalvarija mun.;2007;61;112;60;52
Kalvarija mun.;2007;62;87;40;47
Kalvarija mun.;2007;63;138;46;92
Kalvarija mun.;2007;64;113;51;62
Kalvarija mun.;2007;65;140;54;86
Kalvarija mun.;2007;66;125;49;76
Kalvarija mun.;2007;67;133;44;89
Kalvarija mun.;2007;68;134;50;84
Kalvarija mun.;2007;69;135;62;73
Kalvarija mun.;2007;70;130;57;73
Kalvarija mun.;2007;71;154;43;111
Kalvarija mun.;2007;72;125;39;86
Kalvarija mun.;2007;73;148;43;105
Kalvarija mun.;2007;74;164;50;114
Kalvarija mun.;2007;75;129;47;82
Kalvarija mun.;2007;76;131;48;83
Kalvarija mun.;2007;77;145;47;98
Kalvarija mun.;2007;78;138;40;98
Kalvarija mun.;2007;79;97;30;67
Kalvarija mun.;2007;80;96;29;67
Kalvarija mun.;2007;81;85;24;61
Kalvarija mun.;2007;82;62;14;48
Kalvarija mun.;2007;83;42;9;33
Kalvarija mun.;2007;84;37;6;31
Kalvarija mun.;2007;85;178;49;129
Kalvarija mun.;2008;-1;12738;6043;6695
Kalvarija mun.;2008;0;121;61;60
Kalvarija mun.;2008;1;128;62;66
Kalvarija mun.;2008;2;110;59;51
Kalvarija mun.;2008;3;141;72;69
Kalvarija mun.;2008;4;140;77;63
Kalvarija mun.;2008;5;143;71;72
Kalvarija mun.;2008;6;127;66;61
Kalvarija mun.;2008;7;152;80;72
Kalvarija mun.;2008;8;143;73;70
Kalvarija mun.;2008;9;175;97;78
Kalvarija mun.;2008;10;166;78;88
Kalvarija mun.;2008;11;159;78;81
Kalvarija mun.;2008;12;207;108;99
Kalvarija mun.;2008;13;203;112;91
Kalvarija mun.;2008;14;230;127;103
Kalvarija mun.;2008;15;224;113;111
Kalvarija mun.;2008;16;235;120;115
Kalvarija mun.;2008;17;233;120;113
Kalvarija mun.;2008;18;205;106;99
Kalvarija mun.;2008;19;191;92;99
Kalvarija mun.;2008;20;207;104;103
Kalvarija mun.;2008;21;211;96;115
Kalvarija mun.;2008;22;175;91;84
Kalvarija mun.;2008;23;195;106;89
Kalvarija mun.;2008;24;208;110;98
Kalvarija mun.;2008;25;155;83;72
Kalvarija mun.;2008;26;143;75;68
Kalvarija mun.;2008;27;135;78;57
Kalvarija mun.;2008;28;146;84;62
Kalvarija mun.;2008;29;139;69;70
Kalvarija mun.;2008;30;146;87;59
Kalvarija mun.;2008;31;127;66;61
Kalvarija mun.;2008;32;115;62;53
Kalvarija mun.;2008;33;130;65;65
Kalvarija mun.;2008;34;153;87;66
Kalvarija mun.;2008;35;178;102;76
Kalvarija mun.;2008;36;172;76;96
Kalvarija mun.;2008;37;170;81;89
Kalvarija mun.;2008;38;165;73;92
Kalvarija mun.;2008;39;185;94;91
Kalvarija mun.;2008;40;158;80;78
Kalvarija mun.;2008;41;161;81;80
Kalvarija mun.;2008;42;172;84;88
Kalvarija mun.;2008;43;168;87;81
Kalvarija mun.;2008;44;186;104;82
Kalvarija mun.;2008;45;175;82;93
Kalvarija mun.;2008;46;181;92;89
Kalvarija mun.;2008;47;172;88;84
Kalvarija mun.;2008;48;210;112;98
Kalvarija mun.;2008;49;169;90;79
Kalvarija mun.;2008;50;163;80;83
Kalvarija mun.;2008;51;149;78;71
Kalvarija mun.;2008;52;170;81;89
Kalvarija mun.;2008;53;145;59;86
Kalvarija mun.;2008;54;119;67;52
Kalvarija mun.;2008;55;132;68;64
Kalvarija mun.;2008;56;110;47;63
Kalvarija mun.;2008;57;135;74;61
Kalvarija mun.;2008;58;119;57;62
Kalvarija mun.;2008;59;93;39;54
Kalvarija mun.;2008;60;104;45;59
Kalvarija mun.;2008;61;78;40;38
Kalvarija mun.;2008;62;110;58;52
Kalvarija mun.;2008;63;81;37;44
Kalvarija mun.;2008;64;130;42;88
Kalvarija mun.;2008;65;105;46;59
Kalvarija mun.;2008;66;137;53;84
Kalvarija mun.;2008;67;112;41;71
Kalvarija mun.;2008;68;129;43;86
Kalvarija mun.;2008;69;132;48;84
Kalvarija mun.;2008;70;135;63;72
Kalvarija mun.;2008;71;126;56;70
Kalvarija mun.;2008;72;148;40;108
Kalvarija mun.;2008;73;120;35;85
Kalvarija mun.;2008;74;140;41;99
Kalvarija mun.;2008;75;156;47;109
Kalvarija mun.;2008;76;120;42;78
Kalvarija mun.;2008;77;123;43;80
Kalvarija mun.;2008;78;130;40;90
Kalvarija mun.;2008;79;133;37;96
Kalvarija mun.;2008;80;86;27;59
Kalvarija mun.;2008;81;88;25;63
Kalvarija mun.;2008;82;76;24;52
Kalvarija mun.;2008;83;56;13;43
Kalvarija mun.;2008;84;39;7;32
Kalvarija mun.;2008;85;169;39;130
Kalvarija mun.;2009;-1;12562;5964;6598
Kalvarija mun.;2009;0;121;62;59
Kalvarija mun.;2009;1;115;57;58
Kalvarija mun.;2009;2;126;63;63
Kalvarija mun.;2009;3;110;58;52
Kalvarija mun.;2009;4;136;71;65
Kalvarija mun.;2009;5;144;79;65
Kalvarija mun.;2009;6;145;73;72
Kalvarija mun.;2009;7;126;66;60
Kalvarija mun.;2009;8;152;80;72
Kalvarija mun.;2009;9;142;72;70
Kalvarija mun.;2009;10;177;97;80
Kalvarija mun.;2009;11;162;74;88
Kalvarija mun.;2009;12;158;78;80
Kalvarija mun.;2009;13;204;108;96
Kalvarija mun.;2009;14;204;113;91
Kalvarija mun.;2009;15;231;127;104
Kalvarija mun.;2009;16;223;112;111
Kalvarija mun.;2009;17;234;118;116
Kalvarija mun.;2009;18;230;119;111
Kalvarija mun.;2009;19;202;105;97
Kalvarija mun.;2009;20;187;93;94
Kalvarija mun.;2009;21;205;103;102
Kalvarija mun.;2009;22;209;95;114
Kalvarija mun.;2009;23;175;91;84
Kalvarija mun.;2009;24;187;103;84
Kalvarija mun.;2009;25;199;104;95
Kalvarija mun.;2009;26;152;83;69
Kalvarija mun.;2009;27;142;73;69
Kalvarija mun.;2009;28;128;76;52
Kalvarija mun.;2009;29;144;83;61
Kalvarija mun.;2009;30;134;65;69
Kalvarija mun.;2009;31;138;82;56
Kalvarija mun.;2009;32;127;67;60
Kalvarija mun.;2009;33;114;62;52
Kalvarija mun.;2009;34;130;66;64
Kalvarija mun.;2009;35;152;86;66
Kalvarija mun.;2009;36;177;103;74
Kalvarija mun.;2009;37;169;72;97
Kalvarija mun.;2009;38;168;80;88
Kalvarija mun.;2009;39;165;70;95
Kalvarija mun.;2009;40;185;93;92
Kalvarija mun.;2009;41;159;81;78
Kalvarija mun.;2009;42;162;83;79
Kalvarija mun.;2009;43;171;81;90
Kalvarija mun.;2009;44;171;89;82
Kalvarija mun.;2009;45;183;102;81
Kalvarija mun.;2009;46;175;83;92
Kalvarija mun.;2009;47;178;90;88
Kalvarija mun.;2009;48;175;91;84
Kalvarija mun.;2009;49;206;112;94
Kalvarija mun.;2009;50;165;88;77
Kalvarija mun.;2009;51;160;79;81
Kalvarija mun.;2009;52;148;77;71
Kalvarija mun.;2009;53;168;83;85
Kalvarija mun.;2009;54;146;59;87
Kalvarija mun.;2009;55;115;65;50
Kalvarija mun.;2009;56;132;67;65
Kalvarija mun.;2009;57;106;43;63
Kalvarija mun.;2009;58;132;71;61
Kalvarija mun.;2009;59;117;56;61
Kalvarija mun.;2009;60;90;37;53
Kalvarija mun.;2009;61;103;44;59
Kalvarija mun.;2009;62;75;37;38
Kalvarija mun.;2009;63;110;58;52
Kalvarija mun.;2009;64;78;34;44
Kalvarija mun.;2009;65;126;40;86
Kalvarija mun.;2009;66;105;45;60
Kalvarija mun.;2009;67;135;50;85
Kalvarija mun.;2009;68;109;40;69
Kalvarija mun.;2009;69;122;37;85
Kalvarija mun.;2009;70;127;45;82
Kalvarija mun.;2009;71;126;57;69
Kalvarija mun.;2009;72;121;53;68
Kalvarija mun.;2009;73;143;38;105
Kalvarija mun.;2009;74;108;32;76
Kalvarija mun.;2009;75;136;38;98
Kalvarija mun.;2009;76;148;41;107
Kalvarija mun.;2009;77;114;40;74
Kalvarija mun.;2009;78;117;39;78
Kalvarija mun.;2009;79;119;35;84
Kalvarija mun.;2009;80;124;34;90
Kalvarija mun.;2009;81;76;24;52
Kalvarija mun.;2009;82;83;22;61
Kalvarija mun.;2009;83;63;20;43
Kalvarija mun.;2009;84;50;11;39
Kalvarija mun.;2009;85;156;31;125
Kalvarija mun.;2010;-1;12378;5889;6489
Kalvarija mun.;2010;0;107;60;47
Kalvarija mun.;2010;1;117;59;58
Kalvarija mun.;2010;2;114;59;55
Kalvarija mun.;2010;3;125;63;62
Kalvarija mun.;2010;4;112;62;50
Kalvarija mun.;2010;5;135;71;64
Kalvarija mun.;2010;6;146;79;67
Kalvarija mun.;2010;7;144;71;73
Kalvarija mun.;2010;8;128;67;61
Kalvarija mun.;2010;9;154;81;73
Kalvarija mun.;2010;10;141;71;70
Kalvarija mun.;2010;11;178;99;79
Kalvarija mun.;2010;12;162;75;87
Kalvarija mun.;2010;13;158;78;80
Kalvarija mun.;2010;14;203;108;95
Kalvarija mun.;2010;15;203;112;91
Kalvarija mun.;2010;16;233;127;106
Kalvarija mun.;2010;17;225;114;111
Kalvarija mun.;2010;18;234;119;115
Kalvarija mun.;2010;19;227;118;109
Kalvarija mun.;2010;20;202;107;95
Kalvarija mun.;2010;21;192;93;99
Kalvarija mun.;2010;22;199;101;98
Kalvarija mun.;2010;23;199;94;105
Kalvarija mun.;2010;24;170;88;82
Kalvarija mun.;2010;25;182;98;84
Kalvarija mun.;2010;26;191;101;90
Kalvarija mun.;2010;27;141;77;64
Kalvarija mun.;2010;28;134;68;66
Kalvarija mun.;2010;29;124;73;51
Kalvarija mun.;2010;30;141;83;58
Kalvarija mun.;2010;31;129;63;66
Kalvarija mun.;2010;32;139;82;57
Kalvarija mun.;2010;33;125;65;60
Kalvarija mun.;2010;34;113;61;52
Kalvarija mun.;2010;35;129;63;66
Kalvarija mun.;2010;36;147;84;63
Kalvarija mun.;2010;37;168;96;72
Kalvarija mun.;2010;38;167;70;97
Kalvarija mun.;2010;39;166;79;87
Kalvarija mun.;2010;40;162;68;94
Kalvarija mun.;2010;41;184;92;92
Kalvarija mun.;2010;42;159;80;79
Kalvarija mun.;2010;43;160;81;79
Kalvarija mun.;2010;44;170;81;89
Kalvarija mun.;2010;45;169;89;80
Kalvarija mun.;2010;46;177;96;81
Kalvarija mun.;2010;47;172;82;90
Kalvarija mun.;2010;48;175;90;85
Kalvarija mun.;2010;49;174;92;82
Kalvarija mun.;2010;50;203;110;93
Kalvarija mun.;2010;51;165;89;76
Kalvarija mun.;2010;52;156;76;80
Kalvarija mun.;2010;53;147;75;72
Kalvarija mun.;2010;54;168;83;85
Kalvarija mun.;2010;55;144;58;86
Kalvarija mun.;2010;56;113;65;48
Kalvarija mun.;2010;57;131;66;65
Kalvarija mun.;2010;58;103;41;62
Kalvarija mun.;2010;59;129;69;60
Kalvarija mun.;2010;60;113;52;61
Kalvarija mun.;2010;61;84;34;50
Kalvarija mun.;2010;62;96;40;56
Kalvarija mun.;2010;63;74;36;38
Kalvarija mun.;2010;64;106;56;50
Kalvarija mun.;2010;65;74;31;43
Kalvarija mun.;2010;66;121;38;83
Kalvarija mun.;2010;67;99;41;58
Kalvarija mun.;2010;68;133;49;84
Kalvarija mun.;2010;69;106;38;68
Kalvarija mun.;2010;70;119;36;83
Kalvarija mun.;2010;71;123;43;80
Kalvarija mun.;2010;72;120;53;67
Kalvarija mun.;2010;73;117;50;67
Kalvarija mun.;2010;74;136;34;102
Kalvarija mun.;2010;75;104;29;75
Kalvarija mun.;2010;76;131;39;92
Kalvarija mun.;2010;77;142;38;104
Kalvarija mun.;2010;78;103;35;68
Kalvarija mun.;2010;79;110;37;73
Kalvarija mun.;2010;80;112;32;80
Kalvarija mun.;2010;81;117;33;84
Kalvarija mun.;2010;82;71;20;51
Kalvarija mun.;2010;83;79;21;58
Kalvarija mun.;2010;84;57;17;40
Kalvarija mun.;2010;85;166;35;131
Kalvarija mun.;2011;-1;12105;5727;6378
Kalvarija mun.;2011;0;116;63;53
Kalvarija mun.;2011;1;95;52;43
Kalvarija mun.;2011;2;135;67;68
Kalvarija mun.;2011;3;114;60;54
Kalvarija mun.;2011;4;129;64;65
Kalvarija mun.;2011;5;128;67;61
Kalvarija mun.;2011;6;142;81;61
Kalvarija mun.;2011;7;142;72;70
Kalvarija mun.;2011;8;144;71;73
Kalvarija mun.;2011;9;127;57;70
Kalvarija mun.;2011;10;157;82;75
Kalvarija mun.;2011;11;161;77;84
Kalvarija mun.;2011;12;174;89;85
Kalvarija mun.;2011;13;175;86;89
Kalvarija mun.;2011;14;170;85;85
Kalvarija mun.;2011;15;204;116;88
Kalvarija mun.;2011;16;190;100;90
Kalvarija mun.;2011;17;232;123;109
Kalvarija mun.;2011;18;211;111;100
Kalvarija mun.;2011;19;206;106;100
Kalvarija mun.;2011;20;181;100;81
Kalvarija mun.;2011;21;164;97;67
Kalvarija mun.;2011;22;155;70;85
Kalvarija mun.;2011;23;150;79;71
Kalvarija mun.;2011;24;137;67;70
Kalvarija mun.;2011;25;135;64;71
Kalvarija mun.;2011;26;147;78;69
Kalvarija mun.;2011;27;160;81;79
Kalvarija mun.;2011;28;125;62;63
Kalvarija mun.;2011;29;135;64;71
Kalvarija mun.;2011;30;129;62;67
Kalvarija mun.;2011;31;118;73;45
Kalvarija mun.;2011;32;138;71;67
Kalvarija mun.;2011;33;125;66;59
Kalvarija mun.;2011;34;122;59;63
Kalvarija mun.;2011;35;126;67;59
Kalvarija mun.;2011;36;134;65;69
Kalvarija mun.;2011;37;157;91;66
Kalvarija mun.;2011;38;184;100;84
Kalvarija mun.;2011;39;188;89;99
Kalvarija mun.;2011;40;178;84;94
Kalvarija mun.;2011;41;165;71;94
Kalvarija mun.;2011;42;180;89;91
Kalvarija mun.;2011;43;168;88;80
Kalvarija mun.;2011;44;174;88;86
Kalvarija mun.;2011;45;179;91;88
Kalvarija mun.;2011;46;172;91;81
Kalvarija mun.;2011;47;189;102;87
Kalvarija mun.;2011;48;179;84;95
Kalvarija mun.;2011;49;175;92;83
Kalvarija mun.;2011;50;177;93;84
Kalvarija mun.;2011;51;206;110;96
Kalvarija mun.;2011;52;159;79;80
Kalvarija mun.;2011;53;153;77;76
Kalvarija mun.;2011;54;154;82;72
Kalvarija mun.;2011;55;158;83;75
Kalvarija mun.;2011;56;135;55;80
Kalvarija mun.;2011;57;114;60;54
Kalvarija mun.;2011;58;139;71;68
Kalvarija mun.;2011;59;113;45;68
Kalvarija mun.;2011;60;127;67;60
Kalvarija mun.;2011;61;101;47;54
Kalvarija mun.;2011;62;84;34;50
Kalvarija mun.;2011;63;90;38;52
Kalvarija mun.;2011;64;81;38;43
Kalvarija mun.;2011;65;96;46;50
Kalvarija mun.;2011;66;77;29;48
Kalvarija mun.;2011;67;119;36;83
Kalvarija mun.;2011;68;100;40;60
Kalvarija mun.;2011;69;137;50;87
Kalvarija mun.;2011;70;103;37;66
Kalvarija mun.;2011;71;108;33;75
Kalvarija mun.;2011;72;122;43;79
Kalvarija mun.;2011;73;113;43;70
Kalvarija mun.;2011;74;103;40;63
Kalvarija mun.;2011;75;131;30;101
Kalvarija mun.;2011;76;105;31;74
Kalvarija mun.;2011;77;122;39;83
Kalvarija mun.;2011;78;135;34;101
Kalvarija mun.;2011;79;95;30;65
Kalvarija mun.;2011;80;100;33;67
Kalvarija mun.;2011;81;95;27;68
Kalvarija mun.;2011;82;98;26;72
Kalvarija mun.;2011;83;68;25;43
Kalvarija mun.;2011;84;70;20;50
Kalvarija mun.;2011;85;196;42;154
Kalvarija mun.;2012;-1;11921;5655;6266
Kalvarija mun.;2012;0;140;85;55
Kalvarija mun.;2012;1;116;62;54
Kalvarija mun.;2012;2;96;51;45
Kalvarija mun.;2012;3;135;68;67
Kalvarija mun.;2012;4;113;59;54
Kalvarija mun.;2012;5;129;63;66
Kalvarija mun.;2012;6;127;64;63
Kalvarija mun.;2012;7;141;80;61
Kalvarija mun.;2012;8;141;69;72
Kalvarija mun.;2012;9;144;70;74
Kalvarija mun.;2012;10;124;55;69
Kalvarija mun.;2012;11;156;83;73
Kalvarija mun.;2012;12;159;76;83
Kalvarija mun.;2012;13;172;88;84
Kalvarija mun.;2012;14;174;85;89
Kalvarija mun.;2012;15;169;85;84
Kalvarija mun.;2012;16;203;114;89
Kalvarija mun.;2012;17;184;97;87
Kalvarija mun.;2012;18;228;122;106
Kalvarija mun.;2012;19;205;110;95
Kalvarija mun.;2012;20;197;105;92
Kalvarija mun.;2012;21;179;101;78
Kalvarija mun.;2012;22;163;96;67
Kalvarija mun.;2012;23;149;64;85
Kalvarija mun.;2012;24;141;79;62
Kalvarija mun.;2012;25;122;61;61
Kalvarija mun.;2012;26;129;60;69
Kalvarija mun.;2012;27;134;70;64
Kalvarija mun.;2012;28;150;78;72
Kalvarija mun.;2012;29;126;61;65
Kalvarija mun.;2012;30;127;62;65
Kalvarija mun.;2012;31;122;56;66
Kalvarija mun.;2012;32;114;69;45
Kalvarija mun.;2012;33;132;69;63
Kalvarija mun.;2012;34;122;62;60
Kalvarija mun.;2012;35;115;55;60
Kalvarija mun.;2012;36;126;68;58
Kalvarija mun.;2012;37;136;68;68
Kalvarija mun.;2012;38;153;87;66
Kalvarija mun.;2012;39;184;99;85
Kalvarija mun.;2012;40;190;89;101
Kalvarija mun.;2012;41;177;83;94
Kalvarija mun.;2012;42;161;69;92
Kalvarija mun.;2012;43;178;90;88
Kalvarija mun.;2012;44;167;88;79
Kalvarija mun.;2012;45;170;83;87
Kalvarija mun.;2012;46;176;91;85
Kalvarija mun.;2012;47;171;90;81
Kalvarija mun.;2012;48;184;98;86
Kalvarija mun.;2012;49;175;83;92
Kalvarija mun.;2012;50;174;91;83
Kalvarija mun.;2012;51;175;91;84
Kalvarija mun.;2012;52;205;107;98
Kalvarija mun.;2012;53;156;79;77
Kalvarija mun.;2012;54;155;79;76
Kalvarija mun.;2012;55;151;82;69
Kalvarija mun.;2012;56;156;79;77
Kalvarija mun.;2012;57;133;55;78
Kalvarija mun.;2012;58;109;57;52
Kalvarija mun.;2012;59;144;73;71
Kalvarija mun.;2012;60;111;43;68
Kalvarija mun.;2012;61;127;67;60
Kalvarija mun.;2012;62;101;46;55
Kalvarija mun.;2012;63;82;32;50
Kalvarija mun.;2012;64;91;39;52
Kalvarija mun.;2012;65;79;37;42
Kalvarija mun.;2012;66;94;44;50
Kalvarija mun.;2012;67;75;27;48
Kalvarija mun.;2012;68;118;36;82
Kalvarija mun.;2012;69;91;33;58
Kalvarija mun.;2012;70;134;50;84
Kalvarija mun.;2012;71;100;37;63
Kalvarija mun.;2012;72;105;31;74
Kalvarija mun.;2012;73;117;41;76
Kalvarija mun.;2012;74;111;43;68
Kalvarija mun.;2012;75;92;33;59
Kalvarija mun.;2012;76;128;29;99
Kalvarija mun.;2012;77;100;29;71
Kalvarija mun.;2012;78;112;34;78
Kalvarija mun.;2012;79;126;32;94
Kalvarija mun.;2012;80;88;26;62
Kalvarija mun.;2012;81;92;28;64
Kalvarija mun.;2012;82;85;25;60
Kalvarija mun.;2012;83;88;26;62
Kalvarija mun.;2012;84;57;19;38
Kalvarija mun.;2012;85;233;55;178
Kalvarija mun.;2013;-1;11777;5597;6180
Kalvarija mun.;2013;0;143;79;64
Kalvarija mun.;2013;1;141;85;56
Kalvarija mun.;2013;2;118;67;51
Kalvarija mun.;2013;3;92;46;46
Kalvarija mun.;2013;4;132;63;69
Kalvarija mun.;2013;5;113;62;51
Kalvarija mun.;2013;6;127;63;64
Kalvarija mun.;2013;7;126;63;63
Kalvarija mun.;2013;8;143;83;60
Kalvarija mun.;2013;9;137;66;71
Kalvarija mun.;2013;10;144;70;74
Kalvarija mun.;2013;11;121;52;69
Kalvarija mun.;2013;12;154;85;69
Kalvarija mun.;2013;13;162;75;87
Kalvarija mun.;2013;14;172;88;84
Kalvarija mun.;2013;15;174;85;89
Kalvarija mun.;2013;16;169;85;84
Kalvarija mun.;2013;17;200;114;86
Kalvarija mun.;2013;18;184;95;89
Kalvarija mun.;2013;19;224;118;106
Kalvarija mun.;2013;20;201;110;91
Kalvarija mun.;2013;21;188;102;86
Kalvarija mun.;2013;22;175;100;75
Kalvarija mun.;2013;23;157;92;65
Kalvarija mun.;2013;24;148;67;81
Kalvarija mun.;2013;25;131;68;63
Kalvarija mun.;2013;26;116;58;58
Kalvarija mun.;2013;27;120;54;66
Kalvarija mun.;2013;28;126;68;58
Kalvarija mun.;2013;29;139;75;64
Kalvarija mun.;2013;30;122;58;64
Kalvarija mun.;2013;31;121;60;61
Kalvarija mun.;2013;32;121;55;66
Kalvarija mun.;2013;33;107;65;42
Kalvarija mun.;2013;34;131;67;64
Kalvarija mun.;2013;35;113;57;56
Kalvarija mun.;2013;36;113;54;59
Kalvarija mun.;2013;37;128;71;57
Kalvarija mun.;2013;38;133;67;66
Kalvarija mun.;2013;39;153;87;66
Kalvarija mun.;2013;40;182;97;85
Kalvarija mun.;2013;41;192;90;102
Kalvarija mun.;2013;42;174;81;93
Kalvarija mun.;2013;43;161;68;93
Kalvarija mun.;2013;44;173;87;86
Kalvarija mun.;2013;45;170;89;81
Kalvarija mun.;2013;46;168;82;86
Kalvarija mun.;2013;47;175;89;86
Kalvarija mun.;2013;48;170;89;81
Kalvarija mun.;2013;49;181;96;85
Kalvarija mun.;2013;50;179;84;95
Kalvarija mun.;2013;51;168;87;81
Kalvarija mun.;2013;52;174;90;84
Kalvarija mun.;2013;53;200;107;93
Kalvarija mun.;2013;54;152;77;75
Kalvarija mun.;2013;55;154;80;74
Kalvarija mun.;2013;56;147;78;69
Kalvarija mun.;2013;57;152;76;76
Kalvarija mun.;2013;58;131;54;77
Kalvarija mun.;2013;59;111;58;53
Kalvarija mun.;2013;60;141;71;70
Kalvarija mun.;2013;61;112;44;68
Kalvarija mun.;2013;62;126;67;59
Kalvarija mun.;2013;63;99;45;54
Kalvarija mun.;2013;64;80;30;50
Kalvarija mun.;2013;65;92;39;53
Kalvarija mun.;2013;66;77;34;43
Kalvarija mun.;2013;67;92;42;50
Kalvarija mun.;2013;68;72;24;48
Kalvarija mun.;2013;69;118;36;82
Kalvarija mun.;2013;70;89;31;58
Kalvarija mun.;2013;71;129;46;83
Kalvarija mun.;2013;72;95;32;63
Kalvarija mun.;2013;73;100;30;70
Kalvarija mun.;2013;74;104;35;69
Kalvarija mun.;2013;75;111;42;69
Kalvarija mun.;2013;76;90;33;57
Kalvarija mun.;2013;77;128;28;100
Kalvarija mun.;2013;78;98;30;68
Kalvarija mun.;2013;79;103;30;73
Kalvarija mun.;2013;80;123;31;92
Kalvarija mun.;2013;81;83;22;61
Kalvarija mun.;2013;82;82;24;58
Kalvarija mun.;2013;83;78;24;54
Kalvarija mun.;2013;84;78;20;58
Kalvarija mun.;2013;85;244;69;175
Kalvarija mun.;2014;-1;11636;5542;6094
Kalvarija mun.;2014;0;111;64;47
Kalvarija mun.;2014;1;140;76;64
Kalvarija mun.;2014;2;134;81;53
Kalvarija mun.;2014;3;114;65;49
Kalvarija mun.;2014;4;93;47;46
Kalvarija mun.;2014;5;134;65;69
Kalvarija mun.;2014;6;113;64;49
Kalvarija mun.;2014;7;125;61;64
Kalvarija mun.;2014;8;129;62;67
Kalvarija mun.;2014;9;144;84;60
Kalvarija mun.;2014;10;134;64;70
Kalvarija mun.;2014;11;144;71;73
Kalvarija mun.;2014;12;118;49;69
Kalvarija mun.;2014;13;152;84;68
Kalvarija mun.;2014;14;158;74;84
Kalvarija mun.;2014;15;169;87;82
Kalvarija mun.;2014;16;174;83;91
Kalvarija mun.;2014;17;166;82;84
Kalvarija mun.;2014;18;199;112;87
Kalvarija mun.;2014;19;173;91;82
Kalvarija mun.;2014;20;223;119;104
Kalvarija mun.;2014;21;201;108;93
Kalvarija mun.;2014;22;192;106;86
Kalvarija mun.;2014;23;168;102;66
Kalvarija mun.;2014;24;153;91;62
Kalvarija mun.;2014;25;140;67;73
Kalvarija mun.;2014;26;122;62;60
Kalvarija mun.;2014;27;109;57;52
Kalvarija mun.;2014;28;119;53;66
Kalvarija mun.;2014;29;126;65;61
Kalvarija mun.;2014;30;127;69;58
Kalvarija mun.;2014;31;121;56;65
Kalvarija mun.;2014;32;123;60;63
Kalvarija mun.;2014;33;110;50;60
Kalvarija mun.;2014;34;111;68;43
Kalvarija mun.;2014;35;136;71;65
Kalvarija mun.;2014;36;115;55;60
Kalvarija mun.;2014;37;111;54;57
Kalvarija mun.;2014;38;128;71;57
Kalvarija mun.;2014;39;131;65;66
Kalvarija mun.;2014;40;148;83;65
Kalvarija mun.;2014;41;176;94;82
Kalvarija mun.;2014;42;192;91;101
Kalvarija mun.;2014;43;173;80;93
Kalvarija mun.;2014;44;163;69;94
Kalvarija mun.;2014;45;170;86;84
Kalvarija mun.;2014;46;172;92;80
Kalvarija mun.;2014;47;167;81;86
Kalvarija mun.;2014;48;173;88;85
Kalvarija mun.;2014;49;172;91;81
Kalvarija mun.;2014;50;183;94;89
Kalvarija mun.;2014;51;179;82;97
Kalvarija mun.;2014;52;165;85;80
Kalvarija mun.;2014;53;170;87;83
Kalvarija mun.;2014;54;200;108;92
Kalvarija mun.;2014;55;151;77;74
Kalvarija mun.;2014;56;147;76;71
Kalvarija mun.;2014;57;145;75;70
Kalvarija mun.;2014;58;145;73;72
Kalvarija mun.;2014;59;131;54;77
Kalvarija mun.;2014;60;110;57;53
Kalvarija mun.;2014;61;140;70;70
Kalvarija mun.;2014;62;114;44;70
Kalvarija mun.;2014;63;127;68;59
Kalvarija mun.;2014;64;98;44;54
Kalvarija mun.;2014;65;79;31;48
Kalvarija mun.;2014;66;88;35;53
Kalvarija mun.;2014;67;78;34;44
Kalvarija mun.;2014;68;90;42;48
Kalvarija mun.;2014;69;71;22;49
Kalvarija mun.;2014;70;114;33;81
Kalvarija mun.;2014;71;88;30;58
Kalvarija mun.;2014;72;126;45;81
Kalvarija mun.;2014;73;90;31;59
Kalvarija mun.;2014;74;96;27;69
Kalvarija mun.;2014;75;97;30;67
Kalvarija mun.;2014;76;102;35;67
Kalvarija mun.;2014;77;91;33;58
Kalvarija mun.;2014;78;123;26;97
Kalvarija mun.;2014;79;94;27;67
Kalvarija mun.;2014;80;96;28;68
Kalvarija mun.;2014;81;120;32;88
Kalvarija mun.;2014;82;80;21;59
Kalvarija mun.;2014;83;73;22;51
Kalvarija mun.;2014;84;68;21;47
Kalvarija mun.;2014;85;271;73;198
Kalvarija mun.;2015;-1;11486;5456;6030
Kalvarija mun.;2015;0;122;57;65
Kalvarija mun.;2015;1;115;67;48
Kalvarija mun.;2015;2;139;78;61
Kalvarija mun.;2015;3;139;83;56
Kalvarija mun.;2015;4;112;63;49
Kalvarija mun.;2015;5;94;47;47
Kalvarija mun.;2015;6;132;59;73
Kalvarija mun.;2015;7;110;62;48
Kalvarija mun.;2015;8;127;61;66
Kalvarija mun.;2015;9;126;61;65
Kalvarija mun.;2015;10;143;83;60
Kalvarija mun.;2015;11;136;65;71
Kalvarija mun.;2015;12;144;73;71
Kalvarija mun.;2015;13;117;49;68
Kalvarija mun.;2015;14;154;84;70
Kalvarija mun.;2015;15;156;73;83
Kalvarija mun.;2015;16;167;86;81
Kalvarija mun.;2015;17;173;85;88
Kalvarija mun.;2015;18;164;80;84
Kalvarija mun.;2015;19;195;112;83
Kalvarija mun.;2015;20;177;94;83
Kalvarija mun.;2015;21;216;117;99
Kalvarija mun.;2015;22;198;107;91
Kalvarija mun.;2015;23;190;102;88
Kalvarija mun.;2015;24;161;95;66
Kalvarija mun.;2015;25;145;83;62
Kalvarija mun.;2015;26;136;65;71
Kalvarija mun.;2015;27;116;61;55
Kalvarija mun.;2015;28;111;60;51
Kalvarija mun.;2015;29;119;52;67
Kalvarija mun.;2015;30;119;63;56
Kalvarija mun.;2015;31;129;70;59
Kalvarija mun.;2015;32;116;57;59
Kalvarija mun.;2015;33;119;56;63
Kalvarija mun.;2015;34;107;48;59
Kalvarija mun.;2015;35;109;64;45
Kalvarija mun.;2015;36;135;72;63
Kalvarija mun.;2015;37;110;50;60
Kalvarija mun.;2015;38;109;53;56
Kalvarija mun.;2015;39;124;68;56
Kalvarija mun.;2015;40;128;65;63
Kalvarija mun.;2015;41;148;82;66
Kalvarija mun.;2015;42;174;92;82
Kalvarija mun.;2015;43;187;90;97
Kalvarija mun.;2015;44;169;75;94
Kalvarija mun.;2015;45;163;72;91
Kalvarija mun.;2015;46;166;84;82
Kalvarija mun.;2015;47;169;89;80
Kalvarija mun.;2015;48;166;81;85
Kalvarija mun.;2015;49;171;86;85
Kalvarija mun.;2015;50;171;91;80
Kalvarija mun.;2015;51;182;95;87
Kalvarija mun.;2015;52;177;81;96
Kalvarija mun.;2015;53;160;81;79
Kalvarija mun.;2015;54;168;86;82
Kalvarija mun.;2015;55;198;106;92
Kalvarija mun.;2015;56;152;79;73
Kalvarija mun.;2015;57;146;75;71
Kalvarija mun.;2015;58;144;72;72
Kalvarija mun.;2015;59;141;70;71
Kalvarija mun.;2015;60;124;51;73
Kalvarija mun.;2015;61;112;56;56
Kalvarija mun.;2015;62;135;66;69
Kalvarija mun.;2015;63;107;40;67
Kalvarija mun.;2015;64;119;60;59
Kalvarija mun.;2015;65;94;42;52
Kalvarija mun.;2015;66;75;28;47
Kalvarija mun.;2015;67;86;34;52
Kalvarija mun.;2015;68;81;34;47
Kalvarija mun.;2015;69;87;38;49
Kalvarija mun.;2015;70;71;22;49
Kalvarija mun.;2015;71;112;32;80
Kalvarija mun.;2015;72;87;29;58
Kalvarija mun.;2015;73;119;42;77
Kalvarija mun.;2015;74;88;29;59
Kalvarija mun.;2015;75;90;24;66
Kalvarija mun.;2015;76;94;28;66
Kalvarija mun.;2015;77;95;32;63
Kalvarija mun.;2015;78;82;27;55
Kalvarija mun.;2015;79;119;25;94
Kalvarija mun.;2015;80;89;27;62
Kalvarija mun.;2015;81;86;25;61
Kalvarija mun.;2015;82;110;29;81
Kalvarija mun.;2015;83;78;18;60
Kalvarija mun.;2015;84;65;19;46
Kalvarija mun.;2015;85;290;82;208
Kalvarija mun.;2016;-1;11307;5383;5924
Kalvarija mun.;2016;0;134;66;68
Kalvarija mun.;2016;1;118;57;61
Kalvarija mun.;2016;2;116;68;48
Kalvarija mun.;2016;3;132;74;58
Kalvarija mun.;2016;4;138;84;54
Kalvarija mun.;2016;5;113;66;47
Kalvarija mun.;2016;6;96;49;47
Kalvarija mun.;2016;7;130;58;72
Kalvarija mun.;2016;8;110;62;48
Kalvarija mun.;2016;9;128;62;66
Kalvarija mun.;2016;10;126;61;65
Kalvarija mun.;2016;11;143;84;59
Kalvarija mun.;2016;12;137;67;70
Kalvarija mun.;2016;13;144;73;71
Kalvarija mun.;2016;14;117;49;68
Kalvarija mun.;2016;15;155;84;71
Kalvarija mun.;2016;16;158;73;85
Kalvarija mun.;2016;17;169;87;82
Kalvarija mun.;2016;18;173;85;88
Kalvarija mun.;2016;19;163;80;83
Kalvarija mun.;2016;20;188;110;78
Kalvarija mun.;2016;21;166;89;77
Kalvarija mun.;2016;22;216;118;98
Kalvarija mun.;2016;23;187;101;86
Kalvarija mun.;2016;24;186;100;86
Kalvarija mun.;2016;25;161;97;64
Kalvarija mun.;2016;26;139;77;62
Kalvarija mun.;2016;27;125;56;69
Kalvarija mun.;2016;28;108;61;47
Kalvarija mun.;2016;29;108;59;49
Kalvarija mun.;2016;30;108;45;63
Kalvarija mun.;2016;31;113;62;51
Kalvarija mun.;2016;32;126;67;59
Kalvarija mun.;2016;33;109;54;55
Kalvarija mun.;2016;34;113;52;61
Kalvarija mun.;2016;35;110;49;61
Kalvarija mun.;2016;36;104;63;41
Kalvarija mun.;2016;37;131;72;59
Kalvarija mun.;2016;38;111;49;62
Kalvarija mun.;2016;39;108;49;59
Kalvarija mun.;2016;40;119;64;55
Kalvarija mun.;2016;41;125;64;61
Kalvarija mun.;2016;42;144;82;62
Kalvarija mun.;2016;43;172;91;81
Kalvarija mun.;2016;44;185;88;97
Kalvarija mun.;2016;45;167;73;94
Kalvarija mun.;2016;46;162;72;90
Kalvarija mun.;2016;47;164;82;82
Kalvarija mun.;2016;48;169;89;80
Kalvarija mun.;2016;49;164;81;83
Kalvarija mun.;2016;50;169;84;85
Kalvarija mun.;2016;51;173;91;82
Kalvarija mun.;2016;52;181;95;86
Kalvarija mun.;2016;53;177;81;96
Kalvarija mun.;2016;54;158;80;78
Kalvarija mun.;2016;55;168;85;83
Kalvarija mun.;2016;56;194;104;90
Kalvarija mun.;2016;57;149;76;73
Kalvarija mun.;2016;58;144;73;71
Kalvarija mun.;2016;59;136;67;69
Kalvarija mun.;2016;60;138;69;69
Kalvarija mun.;2016;61;124;51;73
Kalvarija mun.;2016;62;108;52;56
Kalvarija mun.;2016;63;133;66;67
Kalvarija mun.;2016;64;102;38;64
Kalvarija mun.;2016;65;115;58;57
Kalvarija mun.;2016;66;88;37;51
Kalvarija mun.;2016;67;72;26;46
Kalvarija mun.;2016;68;80;30;50
Kalvarija mun.;2016;69;75;32;43
Kalvarija mun.;2016;70;81;34;47
Kalvarija mun.;2016;71;70;21;49
Kalvarija mun.;2016;72;109;31;78
Kalvarija mun.;2016;73;83;26;57
Kalvarija mun.;2016;74;112;39;73
Kalvarija mun.;2016;75;84;26;58
Kalvarija mun.;2016;76;84;23;61
Kalvarija mun.;2016;77;88;23;65
Kalvarija mun.;2016;78;87;27;60
Kalvarija mun.;2016;79;79;27;52
Kalvarija mun.;2016;80;116;25;91
Kalvarija mun.;2016;81;82;26;56
Kalvarija mun.;2016;82;81;23;58
Kalvarija mun.;2016;83;101;28;73
Kalvarija mun.;2016;84;75;18;57
Kalvarija mun.;2016;85;303;86;217
Kalvarija mun.;2017;-1;11067;5301;5766
Kalvarija mun.;2017;0;136;79;57
Kalvarija mun.;2017;1;134;67;67
Kalvarija mun.;2017;2;111;55;56
Kalvarija mun.;2017;3;106;61;45
Kalvarija mun.;2017;4;130;73;57
Kalvarija mun.;2017;5;136;84;52
Kalvarija mun.;2017;6;107;63;44
Kalvarija mun.;2017;7;95;49;46
Kalvarija mun.;2017;8;130;59;71
Kalvarija mun.;2017;9;105;59;46
Kalvarija mun.;2017;10;125;60;65
Kalvarija mun.;2017;11;123;62;61
Kalvarija mun.;2017;12;140;83;57
Kalvarija mun.;2017;13;134;66;68
Kalvarija mun.;2017;14;142;73;69
Kalvarija mun.;2017;15;113;49;64
Kalvarija mun.;2017;16;153;83;70
Kalvarija mun.;2017;17;159;73;86
Kalvarija mun.;2017;18;168;87;81
Kalvarija mun.;2017;19;164;83;81
Kalvarija mun.;2017;20;156;76;80
Kalvarija mun.;2017;21;178;104;74
Kalvarija mun.;2017;22;158;85;73
Kalvarija mun.;2017;23;209;116;93
Kalvarija mun.;2017;24;183;101;82
Kalvarija mun.;2017;25;179;98;81
Kalvarija mun.;2017;26;151;98;53
Kalvarija mun.;2017;27;135;78;57
Kalvarija mun.;2017;28;117;50;67
Kalvarija mun.;2017;29;107;65;42
Kalvarija mun.;2017;30;98;56;42
Kalvarija mun.;2017;31;93;38;55
Kalvarija mun.;2017;32;101;52;49
Kalvarija mun.;2017;33;124;65;59
Kalvarija mun.;2017;34;100;50;50
Kalvarija mun.;2017;35;105;50;55
Kalvarija mun.;2017;36;107;48;59
Kalvarija mun.;2017;37;96;59;37
Kalvarija mun.;2017;38;130;73;57
Kalvarija mun.;2017;39;106;45;61
Kalvarija mun.;2017;40;107;47;60
Kalvarija mun.;2017;41;118;63;55
Kalvarija mun.;2017;42;124;62;62
Kalvarija mun.;2017;43;144;82;62
Kalvarija mun.;2017;44;166;86;80
Kalvarija mun.;2017;45;183;88;95
Kalvarija mun.;2017;46;161;69;92
Kalvarija mun.;2017;47;160;72;88
Kalvarija mun.;2017;48;161;80;81
Kalvarija mun.;2017;49;171;91;80
Kalvarija mun.;2017;50;161;78;83
Kalvarija mun.;2017;51;167;82;85
Kalvarija mun.;2017;52;169;89;80
Kalvarija mun.;2017;53;179;94;85
Kalvarija mun.;2017;54;176;82;94
Kalvarija mun.;2017;55;150;73;77
Kalvarija mun.;2017;56;170;86;84
Kalvarija mun.;2017;57;194;102;92
Kalvarija mun.;2017;58;146;73;73
Kalvarija mun.;2017;59;141;69;72
Kalvarija mun.;2017;60;138;67;71
Kalvarija mun.;2017;61;141;72;69
Kalvarija mun.;2017;62;122;50;72
Kalvarija mun.;2017;63;108;54;54
Kalvarija mun.;2017;64;132;66;66
Kalvarija mun.;2017;65;101;39;62
Kalvarija mun.;2017;66;108;54;54
Kalvarija mun.;2017;67;89;37;52
Kalvarija mun.;2017;68;72;26;46
Kalvarija mun.;2017;69;74;26;48
Kalvarija mun.;2017;70;72;30;42
Kalvarija mun.;2017;71;80;34;46
Kalvarija mun.;2017;72;66;19;47
Kalvarija mun.;2017;73;109;32;77
Kalvarija mun.;2017;74;81;25;56
Kalvarija mun.;2017;75;109;37;72
Kalvarija mun.;2017;76;79;24;55
Kalvarija mun.;2017;77;80;20;60
Kalvarija mun.;2017;78;85;22;63
Kalvarija mun.;2017;79;83;24;59
Kalvarija mun.;2017;80;75;24;51
Kalvarija mun.;2017;81;113;24;89
Kalvarija mun.;2017;82;74;19;55
Kalvarija mun.;2017;83;74;20;54
Kalvarija mun.;2017;84;92;24;68
Kalvarija mun.;2017;85;318;89;229
Kalvarija mun.;2018;-1;10776;5177;5599
Kalvarija mun.;2018;0;128;62;66
Kalvarija mun.;2018;1;134;78;56
Kalvarija mun.;2018;2;132;66;66
Kalvarija mun.;2018;3;113;57;56
Kalvarija mun.;2018;4;107;63;44
Kalvarija mun.;2018;5;131;77;54
Kalvarija mun.;2018;6;135;81;54
Kalvarija mun.;2018;7;102;60;42
Kalvarija mun.;2018;8;95;49;46
Kalvarija mun.;2018;9;130;61;69
Kalvarija mun.;2018;10;104;60;44
Kalvarija mun.;2018;11;118;58;60
Kalvarija mun.;2018;12;124;62;62
Kalvarija mun.;2018;13;134;80;54
Kalvarija mun.;2018;14;130;64;66
Kalvarija mun.;2018;15;141;72;69
Kalvarija mun.;2018;16;113;49;64
Kalvarija mun.;2018;17;153;85;68
Kalvarija mun.;2018;18;158;73;85
Kalvarija mun.;2018;19;157;80;77
Kalvarija mun.;2018;20;164;83;81
Kalvarija mun.;2018;21;150;70;80
Kalvarija mun.;2018;22;164;95;69
Kalvarija mun.;2018;23;139;75;64
Kalvarija mun.;2018;24;198;111;87
Kalvarija mun.;2018;25;161;87;74
Kalvarija mun.;2018;26;159;91;68
Kalvarija mun.;2018;27;134;92;42
Kalvarija mun.;2018;28;126;75;51
Kalvarija mun.;2018;29;103;46;57
Kalvarija mun.;2018;30;91;55;36
Kalvarija mun.;2018;31;98;55;43
Kalvarija mun.;2018;32;89;35;54
Kalvarija mun.;2018;33;104;55;49
Kalvarija mun.;2018;34;117;58;59
Kalvarija mun.;2018;35;93;43;50
Kalvarija mun.;2018;36;101;47;54
Kalvarija mun.;2018;37;100;44;56
Kalvarija mun.;2018;38;91;55;36
Kalvarija mun.;2018;39;131;73;58
Kalvarija mun.;2018;40;99;42;57
Kalvarija mun.;2018;41;103;46;57
Kalvarija mun.;2018;42;121;63;58
Kalvarija mun.;2018;43;123;59;64
Kalvarija mun.;2018;44;141;82;59
Kalvarija mun.;2018;45;164;85;79
Kalvarija mun.;2018;46;179;87;92
Kalvarija mun.;2018;47;161;69;92
Kalvarija mun.;2018;48;160;73;87
Kalvarija mun.;2018;49;158;78;80
Kalvarija mun.;2018;50;169;88;81
Kalvarija mun.;2018;51;162;78;84
Kalvarija mun.;2018;52;165;82;83
Kalvarija mun.;2018;53;168;90;78
Kalvarija mun.;2018;54;174;92;82
Kalvarija mun.;2018;55;178;83;95
Kalvarija mun.;2018;56;149;74;75
Kalvarija mun.;2018;57;164;82;82
Kalvarija mun.;2018;58;196;103;93
Kalvarija mun.;2018;59;139;70;69
Kalvarija mun.;2018;60;140;67;73
Kalvarija mun.;2018;61;137;66;71
Kalvarija mun.;2018;62;141;71;70
Kalvarija mun.;2018;63;123;51;72
Kalvarija mun.;2018;64;108;54;54
Kalvarija mun.;2018;65;127;62;65
Kalvarija mun.;2018;66;95;38;57
Kalvarija mun.;2018;67;107;53;54
Kalvarija mun.;2018;68;87;35;52
Kalvarija mun.;2018;69;70;26;44
Kalvarija mun.;2018;70;72;26;46
Kalvarija mun.;2018;71;69;28;41
Kalvarija mun.;2018;72;76;32;44
Kalvarija mun.;2018;73;65;19;46
Kalvarija mun.;2018;74;104;30;74
Kalvarija mun.;2018;75;78;23;55
Kalvarija mun.;2018;76;101;35;66
Kalvarija mun.;2018;77;76;23;53
Kalvarija mun.;2018;78;72;16;56
Kalvarija mun.;2018;79;81;19;62
Kalvarija mun.;2018;80;76;21;55
Kalvarija mun.;2018;81;70;21;49
Kalvarija mun.;2018;82;105;23;82
Kalvarija mun.;2018;83;66;14;52
Kalvarija mun.;2018;84;66;17;49
Kalvarija mun.;2018;85;339;99;240
Kaunas c. mun.;2001;-1;379706;171498;208208
Kaunas c. mun.;2001;0;3320;1730;1590
Kaunas c. mun.;2001;1;3736;1921;1815
Kaunas c. mun.;2001;2;3804;2029;1775
Kaunas c. mun.;2001;3;3854;1965;1889
Kaunas c. mun.;2001;4;4144;2086;2058
Kaunas c. mun.;2001;5;4253;2234;2019
Kaunas c. mun.;2001;6;4038;2072;1966
Kaunas c. mun.;2001;7;4641;2380;2261
Kaunas c. mun.;2001;8;4973;2603;2370
Kaunas c. mun.;2001;9;4929;2518;2411
Kaunas c. mun.;2001;10;4895;2483;2412
Kaunas c. mun.;2001;11;4717;2402;2315
Kaunas c. mun.;2001;12;4907;2467;2440
Kaunas c. mun.;2001;13;5144;2621;2523
Kaunas c. mun.;2001;14;5408;2800;2608
Kaunas c. mun.;2001;15;5338;2699;2639
Kaunas c. mun.;2001;16;5354;2688;2666
Kaunas c. mun.;2001;17;5197;2602;2595
Kaunas c. mun.;2001;18;6176;2937;3239
Kaunas c. mun.;2001;19;7200;3326;3874
Kaunas c. mun.;2001;20;7020;3300;3720
Kaunas c. mun.;2001;21;6508;3143;3365
Kaunas c. mun.;2001;22;6134;2943;3191
Kaunas c. mun.;2001;23;5845;2836;3009
Kaunas c. mun.;2001;24;5645;2697;2948
Kaunas c. mun.;2001;25;5619;2759;2860
Kaunas c. mun.;2001;26;5848;2886;2962
Kaunas c. mun.;2001;27;5779;2831;2948
Kaunas c. mun.;2001;28;6018;2893;3125
Kaunas c. mun.;2001;29;6066;2916;3150
Kaunas c. mun.;2001;30;5859;2701;3158
Kaunas c. mun.;2001;31;5803;2808;2995
Kaunas c. mun.;2001;32;5774;2817;2957
Kaunas c. mun.;2001;33;5661;2685;2976
Kaunas c. mun.;2001;34;5571;2626;2945
Kaunas c. mun.;2001;35;5619;2696;2923
Kaunas c. mun.;2001;36;5867;2783;3084
Kaunas c. mun.;2001;37;5806;2684;3122
Kaunas c. mun.;2001;38;6297;2913;3384
Kaunas c. mun.;2001;39;6158;2817;3341
Kaunas c. mun.;2001;40;5889;2685;3204
Kaunas c. mun.;2001;41;6205;2826;3379
Kaunas c. mun.;2001;42;5700;2566;3134
Kaunas c. mun.;2001;43;5442;2500;2942
Kaunas c. mun.;2001;44;5381;2330;3051
Kaunas c. mun.;2001;45;5029;2266;2763
Kaunas c. mun.;2001;46;4605;1992;2613
Kaunas c. mun.;2001;47;4697;2131;2566
Kaunas c. mun.;2001;48;4878;2113;2765
Kaunas c. mun.;2001;49;4851;2082;2769
Kaunas c. mun.;2001;50;4874;2054;2820
Kaunas c. mun.;2001;51;4606;1942;2664
Kaunas c. mun.;2001;52;4195;1795;2400
Kaunas c. mun.;2001;53;4229;1842;2387
Kaunas c. mun.;2001;54;4076;1757;2319
Kaunas c. mun.;2001;55;4425;1877;2548
Kaunas c. mun.;2001;56;3986;1721;2265
Kaunas c. mun.;2001;57;4570;1854;2716
Kaunas c. mun.;2001;58;4803;2005;2798
Kaunas c. mun.;2001;59;4389;1800;2589
Kaunas c. mun.;2001;60;4118;1697;2421
Kaunas c. mun.;2001;61;3925;1623;2302
Kaunas c. mun.;2001;62;3860;1529;2331
Kaunas c. mun.;2001;63;3717;1455;2262
Kaunas c. mun.;2001;64;3547;1406;2141
Kaunas c. mun.;2001;65;3383;1311;2072
Kaunas c. mun.;2001;66;3285;1246;2039
Kaunas c. mun.;2001;67;3393;1330;2063
Kaunas c. mun.;2001;68;3345;1288;2057
Kaunas c. mun.;2001;69;3098;1142;1956
Kaunas c. mun.;2001;70;3114;1197;1917
Kaunas c. mun.;2001;71;2976;1158;1818
Kaunas c. mun.;2001;72;3004;1145;1859
Kaunas c. mun.;2001;73;2697;1000;1697
Kaunas c. mun.;2001;74;2455;684;1771
Kaunas c. mun.;2001;75;2250;631;1619
Kaunas c. mun.;2001;76;2057;590;1467
Kaunas c. mun.;2001;77;1888;559;1329
Kaunas c. mun.;2001;78;1797;477;1320
Kaunas c. mun.;2001;79;1438;398;1040
Kaunas c. mun.;2001;80;1225;327;898
Kaunas c. mun.;2001;81;1037;274;763
Kaunas c. mun.;2001;82;827;203;624
Kaunas c. mun.;2001;83;621;164;457
Kaunas c. mun.;2001;84;729;197;532
Kaunas c. mun.;2001;85;4165;1032;3133
Kaunas c. mun.;2002;-1;374176;168782;205394
Kaunas c. mun.;2002;0;3022;1571;1451
Kaunas c. mun.;2002;1;3266;1701;1565
Kaunas c. mun.;2002;2;3677;1879;1798
Kaunas c. mun.;2002;3;3746;2007;1739
Kaunas c. mun.;2002;4;3798;1935;1863
Kaunas c. mun.;2002;5;4104;2059;2045
Kaunas c. mun.;2002;6;4216;2214;2002
Kaunas c. mun.;2002;7;4023;2062;1961
Kaunas c. mun.;2002;8;4593;2357;2236
Kaunas c. mun.;2002;9;4896;2556;2340
Kaunas c. mun.;2002;10;4883;2494;2389
Kaunas c. mun.;2002;11;4807;2438;2369
Kaunas c. mun.;2002;12;4647;2365;2282
Kaunas c. mun.;2002;13;4797;2409;2388
Kaunas c. mun.;2002;14;5052;2570;2482
Kaunas c. mun.;2002;15;5311;2740;2571
Kaunas c. mun.;2002;16;5264;2662;2602
Kaunas c. mun.;2002;17;5248;2623;2625
Kaunas c. mun.;2002;18;5234;2602;2632
Kaunas c. mun.;2002;19;6123;2892;3231
Kaunas c. mun.;2002;20;7024;3213;3811
Kaunas c. mun.;2002;21;6776;3161;3615
Kaunas c. mun.;2002;22;6249;2998;3251
Kaunas c. mun.;2002;23;5890;2809;3081
Kaunas c. mun.;2002;24;5632;2709;2923
Kaunas c. mun.;2002;25;5443;2586;2857
Kaunas c. mun.;2002;26;5492;2685;2807
Kaunas c. mun.;2002;27;5733;2800;2933
Kaunas c. mun.;2002;28;5664;2743;2921
Kaunas c. mun.;2002;29;5859;2807;3052
Kaunas c. mun.;2002;30;5931;2854;3077
Kaunas c. mun.;2002;31;5730;2648;3082
Kaunas c. mun.;2002;32;5678;2737;2941
Kaunas c. mun.;2002;33;5655;2744;2911
Kaunas c. mun.;2002;34;5570;2638;2932
Kaunas c. mun.;2002;35;5465;2565;2900
Kaunas c. mun.;2002;36;5523;2639;2884
Kaunas c. mun.;2002;37;5724;2707;3017
Kaunas c. mun.;2002;38;5691;2617;3074
Kaunas c. mun.;2002;39;6129;2820;3309
Kaunas c. mun.;2002;40;6019;2729;3290
Kaunas c. mun.;2002;41;5781;2631;3150
Kaunas c. mun.;2002;42;6122;2787;3335
Kaunas c. mun.;2002;43;5641;2548;3093
Kaunas c. mun.;2002;44;5364;2461;2903
Kaunas c. mun.;2002;45;5249;2271;2978
Kaunas c. mun.;2002;46;4914;2202;2712
Kaunas c. mun.;2002;47;4572;1983;2589
Kaunas c. mun.;2002;48;4577;2074;2503
Kaunas c. mun.;2002;49;4757;2058;2699
Kaunas c. mun.;2002;50;4769;2014;2755
Kaunas c. mun.;2002;51;4758;2000;2758
Kaunas c. mun.;2002;52;4541;1914;2627
Kaunas c. mun.;2002;53;4148;1781;2367
Kaunas c. mun.;2002;54;4130;1800;2330
Kaunas c. mun.;2002;55;3971;1715;2256
Kaunas c. mun.;2002;56;4303;1823;2480
Kaunas c. mun.;2002;57;3885;1679;2206
Kaunas c. mun.;2002;58;4439;1795;2644
Kaunas c. mun.;2002;59;4667;1933;2734
Kaunas c. mun.;2002;60;4320;1771;2549
Kaunas c. mun.;2002;61;4064;1662;2402
Kaunas c. mun.;2002;62;3896;1599;2297
Kaunas c. mun.;2002;63;3806;1497;2309
Kaunas c. mun.;2002;64;3665;1426;2239
Kaunas c. mun.;2002;65;3501;1380;2121
Kaunas c. mun.;2002;66;3306;1266;2040
Kaunas c. mun.;2002;67;3227;1219;2008
Kaunas c. mun.;2002;68;3338;1304;2034
Kaunas c. mun.;2002;69;3267;1244;2023
Kaunas c. mun.;2002;70;3051;1123;1928
Kaunas c. mun.;2002;71;3040;1159;1881
Kaunas c. mun.;2002;72;2908;1117;1791
Kaunas c. mun.;2002;73;2912;1100;1812
Kaunas c. mun.;2002;74;2619;964;1655
Kaunas c. mun.;2002;75;2384;649;1735
Kaunas c. mun.;2002;76;2172;600;1572
Kaunas c. mun.;2002;77;1978;556;1422
Kaunas c. mun.;2002;78;1815;539;1276
Kaunas c. mun.;2002;79;1720;445;1275
Kaunas c. mun.;2002;80;1349;367;982
Kaunas c. mun.;2002;81;1153;307;846
Kaunas c. mun.;2002;82;968;251;717
Kaunas c. mun.;2002;83;775;188;587
Kaunas c. mun.;2002;84;592;153;439
Kaunas c. mun.;2002;85;4178;1082;3096
Kaunas c. mun.;2003;-1;370242;166796;203446
Kaunas c. mun.;2003;0;2969;1533;1436
Kaunas c. mun.;2003;1;2984;1548;1436
Kaunas c. mun.;2003;2;3240;1693;1547
Kaunas c. mun.;2003;3;3634;1859;1775
Kaunas c. mun.;2003;4;3692;1975;1717
Kaunas c. mun.;2003;5;3758;1910;1848
Kaunas c. mun.;2003;6;4075;2042;2033
Kaunas c. mun.;2003;7;4178;2194;1984
Kaunas c. mun.;2003;8;3988;2050;1938
Kaunas c. mun.;2003;9;4551;2332;2219
Kaunas c. mun.;2003;10;4832;2523;2309
Kaunas c. mun.;2003;11;4817;2464;2353
Kaunas c. mun.;2003;12;4717;2387;2330
Kaunas c. mun.;2003;13;4541;2305;2236
Kaunas c. mun.;2003;14;4707;2349;2358
Kaunas c. mun.;2003;15;4949;2505;2444
Kaunas c. mun.;2003;16;5221;2691;2530
Kaunas c. mun.;2003;17;5166;2607;2559
Kaunas c. mun.;2003;18;5177;2576;2601
Kaunas c. mun.;2003;19;5183;2573;2610
Kaunas c. mun.;2003;20;6032;2849;3183
Kaunas c. mun.;2003;21;6894;3157;3737
Kaunas c. mun.;2003;22;6601;3074;3527
Kaunas c. mun.;2003;23;6128;2924;3204
Kaunas c. mun.;2003;24;5753;2738;3015
Kaunas c. mun.;2003;25;5504;2642;2862
Kaunas c. mun.;2003;26;5419;2565;2854
Kaunas c. mun.;2003;27;5444;2651;2793
Kaunas c. mun.;2003;28;5673;2758;2915
Kaunas c. mun.;2003;29;5611;2724;2887
Kaunas c. mun.;2003;30;5793;2794;2999
Kaunas c. mun.;2003;31;5893;2839;3054
Kaunas c. mun.;2003;32;5684;2636;3048
Kaunas c. mun.;2003;33;5614;2715;2899
Kaunas c. mun.;2003;34;5584;2723;2861
Kaunas c. mun.;2003;35;5488;2592;2896
Kaunas c. mun.;2003;36;5383;2537;2846
Kaunas c. mun.;2003;37;5454;2609;2845
Kaunas c. mun.;2003;38;5661;2679;2982
Kaunas c. mun.;2003;39;5614;2577;3037
Kaunas c. mun.;2003;40;6039;2782;3257
Kaunas c. mun.;2003;41;5951;2695;3256
Kaunas c. mun.;2003;42;5708;2593;3115
Kaunas c. mun.;2003;43;6046;2752;3294
Kaunas c. mun.;2003;44;5611;2539;3072
Kaunas c. mun.;2003;45;5273;2410;2863
Kaunas c. mun.;2003;46;5175;2231;2944
Kaunas c. mun.;2003;47;4851;2167;2684
Kaunas c. mun.;2003;48;4514;1939;2575
Kaunas c. mun.;2003;49;4517;2032;2485
Kaunas c. mun.;2003;50;4702;2028;2674
Kaunas c. mun.;2003;51;4674;1977;2697
Kaunas c. mun.;2003;52;4677;1956;2721
Kaunas c. mun.;2003;53;4504;1902;2602
Kaunas c. mun.;2003;54;4081;1739;2342
Kaunas c. mun.;2003;55;4058;1756;2302
Kaunas c. mun.;2003;56;3902;1671;2231
Kaunas c. mun.;2003;57;4225;1770;2455
Kaunas c. mun.;2003;58;3799;1619;2180
Kaunas c. mun.;2003;59;4349;1748;2601
Kaunas c. mun.;2003;60;4578;1880;2698
Kaunas c. mun.;2003;61;4235;1713;2522
Kaunas c. mun.;2003;62;4013;1629;2384
Kaunas c. mun.;2003;63;3842;1561;2281
Kaunas c. mun.;2003;64;3758;1451;2307
Kaunas c. mun.;2003;65;3597;1381;2216
Kaunas c. mun.;2003;66;3456;1351;2105
Kaunas c. mun.;2003;67;3243;1226;2017
Kaunas c. mun.;2003;68;3172;1182;1990
Kaunas c. mun.;2003;69;3264;1247;2017
Kaunas c. mun.;2003;70;3202;1208;1994
Kaunas c. mun.;2003;71;2952;1061;1891
Kaunas c. mun.;2003;72;2964;1113;1851
Kaunas c. mun.;2003;73;2809;1057;1752
Kaunas c. mun.;2003;74;2823;1040;1783
Kaunas c. mun.;2003;75;2491;892;1599
Kaunas c. mun.;2003;76;2275;603;1672
Kaunas c. mun.;2003;77;2099;558;1541
Kaunas c. mun.;2003;78;1901;521;1380
Kaunas c. mun.;2003;79;1715;489;1226
Kaunas c. mun.;2003;80;1614;410;1204
Kaunas c. mun.;2003;81;1265;339;926
Kaunas c. mun.;2003;82;1080;271;809
Kaunas c. mun.;2003;83;896;222;674
Kaunas c. mun.;2003;84;699;155;544
Kaunas c. mun.;2003;85;4037;1031;3006
Kaunas c. mun.;2004;-1;363952;163690;200262
Kaunas c. mun.;2004;0;2925;1483;1442
Kaunas c. mun.;2004;1;2897;1497;1400
Kaunas c. mun.;2004;2;2917;1509;1408
Kaunas c. mun.;2004;3;3161;1647;1514
Kaunas c. mun.;2004;4;3567;1827;1740
Kaunas c. mun.;2004;5;3623;1943;1680
Kaunas c. mun.;2004;6;3688;1874;1814
Kaunas c. mun.;2004;7;4016;2007;2009
Kaunas c. mun.;2004;8;4109;2164;1945
Kaunas c. mun.;2004;9;3924;2008;1916
Kaunas c. mun.;2004;10;4496;2303;2193
Kaunas c. mun.;2004;11;4732;2480;2252
Kaunas c. mun.;2004;12;4707;2418;2289
Kaunas c. mun.;2004;13;4578;2309;2269
Kaunas c. mun.;2004;14;4415;2238;2177
Kaunas c. mun.;2004;15;4590;2300;2290
Kaunas c. mun.;2004;16;4853;2466;2387
Kaunas c. mun.;2004;17;5132;2648;2484
Kaunas c. mun.;2004;18;5076;2564;2512
Kaunas c. mun.;2004;19;5087;2535;2552
Kaunas c. mun.;2004;20;5116;2533;2583
Kaunas c. mun.;2004;21;5898;2791;3107
Kaunas c. mun.;2004;22;6723;3072;3651
Kaunas c. mun.;2004;23;6357;2945;3412
Kaunas c. mun.;2004;24;5884;2803;3081
Kaunas c. mun.;2004;25;5480;2609;2871
Kaunas c. mun.;2004;26;5349;2552;2797
Kaunas c. mun.;2004;27;5375;2528;2847
Kaunas c. mun.;2004;28;5378;2617;2761
Kaunas c. mun.;2004;29;5566;2695;2871
Kaunas c. mun.;2004;30;5513;2672;2841
Kaunas c. mun.;2004;31;5686;2749;2937
Kaunas c. mun.;2004;32;5780;2780;3000
Kaunas c. mun.;2004;33;5560;2574;2986
Kaunas c. mun.;2004;34;5499;2671;2828
Kaunas c. mun.;2004;35;5450;2663;2787
Kaunas c. mun.;2004;36;5364;2540;2824
Kaunas c. mun.;2004;37;5272;2492;2780
Kaunas c. mun.;2004;38;5317;2537;2780
Kaunas c. mun.;2004;39;5526;2620;2906
Kaunas c. mun.;2004;40;5480;2523;2957
Kaunas c. mun.;2004;41;5905;2717;3188
Kaunas c. mun.;2004;42;5810;2634;3176
Kaunas c. mun.;2004;43;5608;2552;3056
Kaunas c. mun.;2004;44;5933;2681;3252
Kaunas c. mun.;2004;45;5503;2493;3010
Kaunas c. mun.;2004;46;5180;2364;2816
Kaunas c. mun.;2004;47;5071;2173;2898
Kaunas c. mun.;2004;48;4754;2107;2647
Kaunas c. mun.;2004;49;4418;1876;2542
Kaunas c. mun.;2004;50;4424;1984;2440
Kaunas c. mun.;2004;51;4598;1977;2621
Kaunas c. mun.;2004;52;4576;1934;2642
Kaunas c. mun.;2004;53;4581;1906;2675
Kaunas c. mun.;2004;54;4434;1877;2557
Kaunas c. mun.;2004;55;4011;1705;2306
Kaunas c. mun.;2004;56;3975;1705;2270
Kaunas c. mun.;2004;57;3818;1631;2187
Kaunas c. mun.;2004;58;4114;1707;2407
Kaunas c. mun.;2004;59;3724;1579;2145
Kaunas c. mun.;2004;60;4228;1683;2545
Kaunas c. mun.;2004;61;4454;1807;2647
Kaunas c. mun.;2004;62;4136;1663;2473
Kaunas c. mun.;2004;63;3935;1583;2352
Kaunas c. mun.;2004;64;3756;1504;2252
Kaunas c. mun.;2004;65;3684;1394;2290
Kaunas c. mun.;2004;66;3521;1326;2195
Kaunas c. mun.;2004;67;3384;1290;2094
Kaunas c. mun.;2004;68;3162;1161;2001
Kaunas c. mun.;2004;69;3098;1135;1963
Kaunas c. mun.;2004;70;3186;1202;1984
Kaunas c. mun.;2004;71;3122;1152;1970
Kaunas c. mun.;2004;72;2855;1003;1852
Kaunas c. mun.;2004;73;2887;1067;1820
Kaunas c. mun.;2004;74;2714;994;1720
Kaunas c. mun.;2004;75;2723;977;1746
Kaunas c. mun.;2004;76;2409;845;1564
Kaunas c. mun.;2004;77;2168;553;1615
Kaunas c. mun.;2004;78;2005;501;1504
Kaunas c. mun.;2004;79;1798;467;1331
Kaunas c. mun.;2004;80;1625;454;1171
Kaunas c. mun.;2004;81;1523;384;1139
Kaunas c. mun.;2004;82;1188;310;878
Kaunas c. mun.;2004;83;1021;257;764
Kaunas c. mun.;2004;84;833;198;635
Kaunas c. mun.;2004;85;4034;992;3042
Kaunas c. mun.;2005;-1;356954;160453;196501
Kaunas c. mun.;2005;0;3016;1534;1482
Kaunas c. mun.;2005;1;2885;1462;1423
Kaunas c. mun.;2005;2;2871;1486;1385
Kaunas c. mun.;2005;3;2886;1502;1384
Kaunas c. mun.;2005;4;3122;1627;1495
Kaunas c. mun.;2005;5;3520;1806;1714
Kaunas c. mun.;2005;6;3579;1924;1655
Kaunas c. mun.;2005;7;3628;1842;1786
Kaunas c. mun.;2005;8;3980;1989;1991
Kaunas c. mun.;2005;9;4060;2145;1915
Kaunas c. mun.;2005;10;3876;1990;1886
Kaunas c. mun.;2005;11;4447;2280;2167
Kaunas c. mun.;2005;12;4647;2437;2210
Kaunas c. mun.;2005;13;4637;2381;2256
Kaunas c. mun.;2005;14;4486;2266;2220
Kaunas c. mun.;2005;15;4318;2193;2125
Kaunas c. mun.;2005;16;4481;2246;2235
Kaunas c. mun.;2005;17;4744;2402;2342
Kaunas c. mun.;2005;18;5005;2584;2421
Kaunas c. mun.;2005;19;4929;2491;2438
Kaunas c. mun.;2005;20;4975;2476;2499
Kaunas c. mun.;2005;21;4996;2459;2537
Kaunas c. mun.;2005;22;5751;2723;3028
Kaunas c. mun.;2005;23;6505;2986;3519
Kaunas c. mun.;2005;24;6172;2840;3332
Kaunas c. mun.;2005;25;5564;2686;2878
Kaunas c. mun.;2005;26;5336;2526;2810
Kaunas c. mun.;2005;27;5274;2504;2770
Kaunas c. mun.;2005;28;5311;2500;2811
Kaunas c. mun.;2005;29;5244;2547;2697
Kaunas c. mun.;2005;30;5455;2660;2795
Kaunas c. mun.;2005;31;5370;2592;2778
Kaunas c. mun.;2005;32;5528;2666;2862
Kaunas c. mun.;2005;33;5631;2709;2922
Kaunas c. mun.;2005;34;5362;2467;2895
Kaunas c. mun.;2005;35;5344;2594;2750
Kaunas c. mun.;2005;36;5285;2579;2706
Kaunas c. mun.;2005;37;5189;2447;2742
Kaunas c. mun.;2005;38;5123;2413;2710
Kaunas c. mun.;2005;39;5142;2445;2697
Kaunas c. mun.;2005;40;5373;2529;2844
Kaunas c. mun.;2005;41;5317;2446;2871
Kaunas c. mun.;2005;42;5776;2643;3133
Kaunas c. mun.;2005;43;5681;2574;3107
Kaunas c. mun.;2005;44;5500;2504;2996
Kaunas c. mun.;2005;45;5753;2596;3157
Kaunas c. mun.;2005;46;5391;2439;2952
Kaunas c. mun.;2005;47;5088;2309;2779
Kaunas c. mun.;2005;48;4963;2124;2839
Kaunas c. mun.;2005;49;4670;2063;2607
Kaunas c. mun.;2005;50;4323;1823;2500
Kaunas c. mun.;2005;51;4330;1932;2398
Kaunas c. mun.;2005;52;4474;1921;2553
Kaunas c. mun.;2005;53;4467;1874;2593
Kaunas c. mun.;2005;54;4496;1877;2619
Kaunas c. mun.;2005;55;4307;1805;2502
Kaunas c. mun.;2005;56;3925;1654;2271
Kaunas c. mun.;2005;57;3909;1662;2247
Kaunas c. mun.;2005;58;3721;1581;2140
Kaunas c. mun.;2005;59;3999;1651;2348
Kaunas c. mun.;2005;60;3650;1531;2119
Kaunas c. mun.;2005;61;4141;1637;2504
Kaunas c. mun.;2005;62;4343;1750;2593
Kaunas c. mun.;2005;63;4026;1602;2424
Kaunas c. mun.;2005;64;3824;1522;2302
Kaunas c. mun.;2005;65;3677;1457;2220
Kaunas c. mun.;2005;66;3598;1345;2253
Kaunas c. mun.;2005;67;3442;1280;2162
Kaunas c. mun.;2005;68;3294;1238;2056
Kaunas c. mun.;2005;69;3069;1111;1958
Kaunas c. mun.;2005;70;3007;1080;1927
Kaunas c. mun.;2005;71;3085;1145;1940
Kaunas c. mun.;2005;72;2998;1085;1913
Kaunas c. mun.;2005;73;2749;949;1800
Kaunas c. mun.;2005;74;2777;1011;1766
Kaunas c. mun.;2005;75;2600;933;1667
Kaunas c. mun.;2005;76;2585;918;1667
Kaunas c. mun.;2005;77;2302;792;1510
Kaunas c. mun.;2005;78;2043;515;1528
Kaunas c. mun.;2005;79;1899;467;1432
Kaunas c. mun.;2005;80;1686;433;1253
Kaunas c. mun.;2005;81;1490;412;1078
Kaunas c. mun.;2005;82;1396;338;1058
Kaunas c. mun.;2005;83;1085;282;803
Kaunas c. mun.;2005;84;927;228;699
Kaunas c. mun.;2005;85;4124;979;3145
Kaunas c. mun.;2006;-1;348506;156414;192092
Kaunas c. mun.;2006;0;3029;1527;1502
Kaunas c. mun.;2006;1;2977;1514;1463
Kaunas c. mun.;2006;2;2827;1438;1389
Kaunas c. mun.;2006;3;2806;1460;1346
Kaunas c. mun.;2006;4;2833;1479;1354
Kaunas c. mun.;2006;5;3072;1599;1473
Kaunas c. mun.;2006;6;3454;1775;1679
Kaunas c. mun.;2006;7;3520;1881;1639
Kaunas c. mun.;2006;8;3569;1821;1748
Kaunas c. mun.;2006;9;3926;1964;1962
Kaunas c. mun.;2006;10;3994;2118;1876
Kaunas c. mun.;2006;11;3822;1957;1865
Kaunas c. mun.;2006;12;4374;2243;2131
Kaunas c. mun.;2006;13;4529;2370;2159
Kaunas c. mun.;2006;14;4545;2335;2210
Kaunas c. mun.;2006;15;4317;2184;2133
Kaunas c. mun.;2006;16;4162;2101;2061
Kaunas c. mun.;2006;17;4336;2160;2176
Kaunas c. mun.;2006;18;4567;2309;2258
Kaunas c. mun.;2006;19;4782;2458;2324
Kaunas c. mun.;2006;20;4731;2392;2339
Kaunas c. mun.;2006;21;4715;2347;2368
Kaunas c. mun.;2006;22;4760;2341;2419
Kaunas c. mun.;2006;23;5540;2600;2940
Kaunas c. mun.;2006;24;6199;2845;3354
Kaunas c. mun.;2006;25;5738;2622;3116
Kaunas c. mun.;2006;26;5319;2549;2770
Kaunas c. mun.;2006;27;5160;2454;2706
Kaunas c. mun.;2006;28;5163;2453;2710
Kaunas c. mun.;2006;29;5200;2457;2743
Kaunas c. mun.;2006;30;5119;2484;2635
Kaunas c. mun.;2006;31;5318;2595;2723
Kaunas c. mun.;2006;32;5207;2518;2689
Kaunas c. mun.;2006;33;5332;2572;2760
Kaunas c. mun.;2006;34;5461;2632;2829
Kaunas c. mun.;2006;35;5203;2385;2818
Kaunas c. mun.;2006;36;5194;2512;2682
Kaunas c. mun.;2006;37;5093;2476;2617
Kaunas c. mun.;2006;38;5012;2361;2651
Kaunas c. mun.;2006;39;4969;2332;2637
Kaunas c. mun.;2006;40;4996;2361;2635
Kaunas c. mun.;2006;41;5217;2438;2779
Kaunas c. mun.;2006;42;5164;2360;2804
Kaunas c. mun.;2006;43;5636;2567;3069
Kaunas c. mun.;2006;44;5545;2507;3038
Kaunas c. mun.;2006;45;5349;2429;2920
Kaunas c. mun.;2006;46;5604;2532;3072
Kaunas c. mun.;2006;47;5314;2393;2921
Kaunas c. mun.;2006;48;4984;2255;2729
Kaunas c. mun.;2006;49;4849;2067;2782
Kaunas c. mun.;2006;50;4570;2016;2554
Kaunas c. mun.;2006;51;4224;1765;2459
Kaunas c. mun.;2006;52;4246;1897;2349
Kaunas c. mun.;2006;53;4357;1860;2497
Kaunas c. mun.;2006;54;4349;1823;2526
Kaunas c. mun.;2006;55;4383;1817;2566
Kaunas c. mun.;2006;56;4210;1749;2461
Kaunas c. mun.;2006;57;3857;1613;2244
Kaunas c. mun.;2006;58;3829;1619;2210
Kaunas c. mun.;2006;59;3648;1550;2098
Kaunas c. mun.;2006;60;3908;1601;2307
Kaunas c. mun.;2006;61;3557;1477;2080
Kaunas c. mun.;2006;62;4028;1569;2459
Kaunas c. mun.;2006;63;4213;1679;2534
Kaunas c. mun.;2006;64;3914;1529;2385
Kaunas c. mun.;2006;65;3736;1473;2263
Kaunas c. mun.;2006;66;3574;1406;2168
Kaunas c. mun.;2006;67;3500;1288;2212
Kaunas c. mun.;2006;68;3348;1229;2119
Kaunas c. mun.;2006;69;3193;1184;2009
Kaunas c. mun.;2006;70;2960;1059;1901
Kaunas c. mun.;2006;71;2911;1033;1878
Kaunas c. mun.;2006;72;2958;1084;1874
Kaunas c. mun.;2006;73;2873;1021;1852
Kaunas c. mun.;2006;74;2652;895;1757
Kaunas c. mun.;2006;75;2653;949;1704
Kaunas c. mun.;2006;76;2495;882;1613
Kaunas c. mun.;2006;77;2447;858;1589
Kaunas c. mun.;2006;78;2182;743;1439
Kaunas c. mun.;2006;79;1935;484;1451
Kaunas c. mun.;2006;80;1774;432;1342
Kaunas c. mun.;2006;81;1562;396;1166
Kaunas c. mun.;2006;82;1368;365;1003
Kaunas c. mun.;2006;83;1282;299;983
Kaunas c. mun.;2006;84;1002;251;751
Kaunas c. mun.;2006;85;4276;990;3286
Kaunas c. mun.;2007;-1;343932;154026;189906
Kaunas c. mun.;2007;0;2991;1550;1441
Kaunas c. mun.;2007;1;3008;1520;1488
Kaunas c. mun.;2007;2;2920;1492;1428
Kaunas c. mun.;2007;3;2789;1409;1380
Kaunas c. mun.;2007;4;2784;1444;1340
Kaunas c. mun.;2007;5;2807;1471;1336
Kaunas c. mun.;2007;6;3050;1584;1466
Kaunas c. mun.;2007;7;3410;1748;1662
Kaunas c. mun.;2007;8;3505;1874;1631
Kaunas c. mun.;2007;9;3546;1817;1729
Kaunas c. mun.;2007;10;3882;1944;1938
Kaunas c. mun.;2007;11;3954;2102;1852
Kaunas c. mun.;2007;12;3788;1944;1844
Kaunas c. mun.;2007;13;4360;2232;2128
Kaunas c. mun.;2007;14;4494;2357;2137
Kaunas c. mun.;2007;15;4482;2303;2179
Kaunas c. mun.;2007;16;4237;2143;2094
Kaunas c. mun.;2007;17;4086;2063;2023
Kaunas c. mun.;2007;18;4277;2127;2150
Kaunas c. mun.;2007;19;4492;2269;2223
Kaunas c. mun.;2007;20;4691;2405;2286
Kaunas c. mun.;2007;21;4637;2333;2304
Kaunas c. mun.;2007;22;4635;2285;2350
Kaunas c. mun.;2007;23;4675;2281;2394
Kaunas c. mun.;2007;24;5449;2520;2929
Kaunas c. mun.;2007;25;5998;2732;3266
Kaunas c. mun.;2007;26;5614;2561;3053
Kaunas c. mun.;2007;27;5242;2480;2762
Kaunas c. mun.;2007;28;5119;2430;2689
Kaunas c. mun.;2007;29;5100;2414;2686
Kaunas c. mun.;2007;30;5148;2433;2715
Kaunas c. mun.;2007;31;5066;2459;2607
Kaunas c. mun.;2007;32;5243;2537;2706
Kaunas c. mun.;2007;33;5150;2489;2661
Kaunas c. mun.;2007;34;5266;2531;2735
Kaunas c. mun.;2007;35;5409;2599;2810
Kaunas c. mun.;2007;36;5133;2357;2776
Kaunas c. mun.;2007;37;5094;2462;2632
Kaunas c. mun.;2007;38;5003;2432;2571
Kaunas c. mun.;2007;39;4938;2322;2616
Kaunas c. mun.;2007;40;4848;2273;2575
Kaunas c. mun.;2007;41;4904;2314;2590
Kaunas c. mun.;2007;42;5111;2383;2728
Kaunas c. mun.;2007;43;5092;2324;2768
Kaunas c. mun.;2007;44;5537;2512;3025
Kaunas c. mun.;2007;45;5425;2439;2986
Kaunas c. mun.;2007;46;5241;2354;2887
Kaunas c. mun.;2007;47;5498;2481;3017
Kaunas c. mun.;2007;48;5246;2359;2887
Kaunas c. mun.;2007;49;4936;2218;2718
Kaunas c. mun.;2007;50;4768;2022;2746
Kaunas c. mun.;2007;51;4475;1953;2522
Kaunas c. mun.;2007;52;4153;1719;2434
Kaunas c. mun.;2007;53;4165;1856;2309
Kaunas c. mun.;2007;54;4288;1818;2470
Kaunas c. mun.;2007;55;4279;1782;2497
Kaunas c. mun.;2007;56;4314;1775;2539
Kaunas c. mun.;2007;57;4124;1694;2430
Kaunas c. mun.;2007;58;3788;1572;2216
Kaunas c. mun.;2007;59;3758;1569;2189
Kaunas c. mun.;2007;60;3562;1493;2069
Kaunas c. mun.;2007;61;3819;1545;2274
Kaunas c. mun.;2007;62;3473;1421;2052
Kaunas c. mun.;2007;63;3950;1518;2432
Kaunas c. mun.;2007;64;4083;1597;2486
Kaunas c. mun.;2007;65;3814;1469;2345
Kaunas c. mun.;2007;66;3645;1417;2228
Kaunas c. mun.;2007;67;3493;1350;2143
Kaunas c. mun.;2007;68;3392;1213;2179
Kaunas c. mun.;2007;69;3281;1181;2100
Kaunas c. mun.;2007;70;3101;1130;1971
Kaunas c. mun.;2007;71;2878;1006;1872
Kaunas c. mun.;2007;72;2813;968;1845
Kaunas c. mun.;2007;73;2867;1035;1832
Kaunas c. mun.;2007;74;2741;955;1786
Kaunas c. mun.;2007;75;2539;830;1709
Kaunas c. mun.;2007;76;2531;894;1637
Kaunas c. mun.;2007;77;2383;829;1554
Kaunas c. mun.;2007;78;2302;788;1514
Kaunas c. mun.;2007;79;2052;689;1363
Kaunas c. mun.;2007;80;1825;449;1376
Kaunas c. mun.;2007;81;1637;389;1248
Kaunas c. mun.;2007;82;1445;358;1087
Kaunas c. mun.;2007;83;1254;333;921
Kaunas c. mun.;2007;84;1161;261;900
Kaunas c. mun.;2007;85;4469;1036;3433
Kaunas c. mun.;2008;-1;339535;151817;187718
Kaunas c. mun.;2008;0;3157;1634;1523
Kaunas c. mun.;2008;1;2964;1541;1423
Kaunas c. mun.;2008;2;2966;1493;1473
Kaunas c. mun.;2008;3;2859;1461;1398
Kaunas c. mun.;2008;4;2765;1399;1366
Kaunas c. mun.;2008;5;2752;1427;1325
Kaunas c. mun.;2008;6;2767;1443;1324
Kaunas c. mun.;2008;7;3008;1555;1453
Kaunas c. mun.;2008;8;3377;1733;1644
Kaunas c. mun.;2008;9;3482;1857;1625
Kaunas c. mun.;2008;10;3517;1806;1711
Kaunas c. mun.;2008;11;3855;1929;1926
Kaunas c. mun.;2008;12;3911;2076;1835
Kaunas c. mun.;2008;13;3738;1909;1829
Kaunas c. mun.;2008;14;4294;2196;2098
Kaunas c. mun.;2008;15;4456;2338;2118
Kaunas c. mun.;2008;16;4422;2271;2151
Kaunas c. mun.;2008;17;4161;2107;2054
Kaunas c. mun.;2008;18;4017;2026;1991
Kaunas c. mun.;2008;19;4203;2085;2118
Kaunas c. mun.;2008;20;4435;2236;2199
Kaunas c. mun.;2008;21;4629;2368;2261
Kaunas c. mun.;2008;22;4548;2282;2266
Kaunas c. mun.;2008;23;4556;2234;2322
Kaunas c. mun.;2008;24;4623;2226;2397
Kaunas c. mun.;2008;25;5393;2472;2921
Kaunas c. mun.;2008;26;5919;2691;3228
Kaunas c. mun.;2008;27;5523;2507;3016
Kaunas c. mun.;2008;28;5167;2454;2713
Kaunas c. mun.;2008;29;5041;2402;2639
Kaunas c. mun.;2008;30;5035;2369;2666
Kaunas c. mun.;2008;31;5048;2389;2659
Kaunas c. mun.;2008;32;5012;2430;2582
Kaunas c. mun.;2008;33;5165;2501;2664
Kaunas c. mun.;2008;34;5046;2443;2603
Kaunas c. mun.;2008;35;5164;2476;2688
Kaunas c. mun.;2008;36;5315;2558;2757
Kaunas c. mun.;2008;37;5014;2302;2712
Kaunas c. mun.;2008;38;4990;2405;2585
Kaunas c. mun.;2008;39;4907;2388;2519
Kaunas c. mun.;2008;40;4816;2246;2570
Kaunas c. mun.;2008;41;4745;2210;2535
Kaunas c. mun.;2008;42;4821;2270;2551
Kaunas c. mun.;2008;43;5020;2329;2691
Kaunas c. mun.;2008;44;4983;2270;2713
Kaunas c. mun.;2008;45;5410;2450;2960
Kaunas c. mun.;2008;46;5332;2391;2941
Kaunas c. mun.;2008;47;5156;2306;2850
Kaunas c. mun.;2008;48;5428;2446;2982
Kaunas c. mun.;2008;49;5169;2313;2856
Kaunas c. mun.;2008;50;4847;2168;2679
Kaunas c. mun.;2008;51;4699;1981;2718
Kaunas c. mun.;2008;52;4394;1903;2491
Kaunas c. mun.;2008;53;4075;1676;2399
Kaunas c. mun.;2008;54;4078;1808;2270
Kaunas c. mun.;2008;55;4216;1778;2438
Kaunas c. mun.;2008;56;4201;1741;2460
Kaunas c. mun.;2008;57;4226;1730;2496
Kaunas c. mun.;2008;58;4038;1639;2399
Kaunas c. mun.;2008;59;3715;1533;2182
Kaunas c. mun.;2008;60;3662;1517;2145
Kaunas c. mun.;2008;61;3485;1440;2045
Kaunas c. mun.;2008;62;3717;1481;2236
Kaunas c. mun.;2008;63;3414;1378;2036
Kaunas c. mun.;2008;64;3834;1453;2381
Kaunas c. mun.;2008;65;3980;1535;2445
Kaunas c. mun.;2008;66;3709;1400;2309
Kaunas c. mun.;2008;67;3544;1357;2187
Kaunas c. mun.;2008;68;3389;1292;2097
Kaunas c. mun.;2008;69;3295;1168;2127
Kaunas c. mun.;2008;70;3193;1122;2071
Kaunas c. mun.;2008;71;3006;1078;1928
Kaunas c. mun.;2008;72;2797;956;1841
Kaunas c. mun.;2008;73;2725;922;1803
Kaunas c. mun.;2008;74;2789;989;1800
Kaunas c. mun.;2008;75;2638;898;1740
Kaunas c. mun.;2008;76;2448;785;1663
Kaunas c. mun.;2008;77;2413;831;1582
Kaunas c. mun.;2008;78;2247;768;1479
Kaunas c. mun.;2008;79;2154;715;1439
Kaunas c. mun.;2008;80;1922;633;1289
Kaunas c. mun.;2008;81;1724;403;1321
Kaunas c. mun.;2008;82;1512;359;1153
Kaunas c. mun.;2008;83;1325;329;996
Kaunas c. mun.;2008;84;1155;303;852
Kaunas c. mun.;2008;85;4888;1098;3790
Kaunas c. mun.;2009;-1;335393;149678;185715
Kaunas c. mun.;2009;0;3393;1761;1632
Kaunas c. mun.;2009;1;3110;1616;1494
Kaunas c. mun.;2009;2;2894;1505;1389
Kaunas c. mun.;2009;3;2913;1471;1442
Kaunas c. mun.;2009;4;2812;1442;1370
Kaunas c. mun.;2009;5;2722;1370;1352
Kaunas c. mun.;2009;6;2693;1400;1293
Kaunas c. mun.;2009;7;2717;1419;1298
Kaunas c. mun.;2009;8;2969;1536;1433
Kaunas c. mun.;2009;9;3320;1712;1608
Kaunas c. mun.;2009;10;3423;1819;1604
Kaunas c. mun.;2009;11;3480;1783;1697
Kaunas c. mun.;2009;12;3779;1895;1884
Kaunas c. mun.;2009;13;3850;2043;1807
Kaunas c. mun.;2009;14;3691;1889;1802
Kaunas c. mun.;2009;15;4246;2176;2070
Kaunas c. mun.;2009;16;4405;2302;2103
Kaunas c. mun.;2009;17;4371;2241;2130
Kaunas c. mun.;2009;18;4124;2072;2052
Kaunas c. mun.;2009;19;3973;1997;1976
Kaunas c. mun.;2009;20;4128;2040;2088
Kaunas c. mun.;2009;21;4352;2188;2164
Kaunas c. mun.;2009;22;4558;2311;2247
Kaunas c. mun.;2009;23;4479;2226;2253
Kaunas c. mun.;2009;24;4505;2196;2309
Kaunas c. mun.;2009;25;4587;2180;2407
Kaunas c. mun.;2009;26;5312;2424;2888
Kaunas c. mun.;2009;27;5825;2629;3196
Kaunas c. mun.;2009;28;5438;2471;2967
Kaunas c. mun.;2009;29;5064;2397;2667
Kaunas c. mun.;2009;30;4965;2354;2611
Kaunas c. mun.;2009;31;4998;2349;2649
Kaunas c. mun.;2009;32;4951;2348;2603
Kaunas c. mun.;2009;33;4880;2373;2507
Kaunas c. mun.;2009;34;5067;2462;2605
Kaunas c. mun.;2009;35;4911;2408;2503
Kaunas c. mun.;2009;36;5041;2440;2601
Kaunas c. mun.;2009;37;5230;2509;2721
Kaunas c. mun.;2009;38;4945;2256;2689
Kaunas c. mun.;2009;39;4905;2361;2544
Kaunas c. mun.;2009;40;4811;2340;2471
Kaunas c. mun.;2009;41;4751;2205;2546
Kaunas c. mun.;2009;42;4673;2173;2500
Kaunas c. mun.;2009;43;4740;2227;2513
Kaunas c. mun.;2009;44;4937;2281;2656
Kaunas c. mun.;2009;45;4889;2215;2674
Kaunas c. mun.;2009;46;5335;2410;2925
Kaunas c. mun.;2009;47;5245;2337;2908
Kaunas c. mun.;2009;48;5054;2247;2807
Kaunas c. mun.;2009;49;5369;2407;2962
Kaunas c. mun.;2009;50;5068;2258;2810
Kaunas c. mun.;2009;51;4784;2128;2656
Kaunas c. mun.;2009;52;4635;1945;2690
Kaunas c. mun.;2009;53;4331;1857;2474
Kaunas c. mun.;2009;54;3991;1614;2377
Kaunas c. mun.;2009;55;3983;1753;2230
Kaunas c. mun.;2009;56;4146;1738;2408
Kaunas c. mun.;2009;57;4147;1705;2442
Kaunas c. mun.;2009;58;4142;1675;2467
Kaunas c. mun.;2009;59;3951;1588;2363
Kaunas c. mun.;2009;60;3646;1487;2159
Kaunas c. mun.;2009;61;3588;1464;2124
Kaunas c. mun.;2009;62;3400;1387;2013
Kaunas c. mun.;2009;63;3639;1431;2208
Kaunas c. mun.;2009;64;3335;1322;2013
Kaunas c. mun.;2009;65;3749;1405;2344
Kaunas c. mun.;2009;66;3889;1483;2406
Kaunas c. mun.;2009;67;3619;1348;2271
Kaunas c. mun.;2009;68;3470;1316;2154
Kaunas c. mun.;2009;69;3321;1239;2082
Kaunas c. mun.;2009;70;3193;1112;2081
Kaunas c. mun.;2009;71;3104;1068;2036
Kaunas c. mun.;2009;72;2924;1031;1893
Kaunas c. mun.;2009;73;2713;898;1815
Kaunas c. mun.;2009;74;2618;856;1762
Kaunas c. mun.;2009;75;2710;936;1774
Kaunas c. mun.;2009;76;2522;836;1686
Kaunas c. mun.;2009;77;2322;725;1597
Kaunas c. mun.;2009;78;2308;789;1519
Kaunas c. mun.;2009;79;2127;720;1407
Kaunas c. mun.;2009;80;2034;654;1380
Kaunas c. mun.;2009;81;1786;579;1207
Kaunas c. mun.;2009;82;1609;364;1245
Kaunas c. mun.;2009;83;1383;317;1066
Kaunas c. mun.;2009;84;1216;293;923
Kaunas c. mun.;2009;85;5160;1144;4016
Kaunas c. mun.;2010;-1;329542;146395;183147
Kaunas c. mun.;2010;0;3442;1786;1656
Kaunas c. mun.;2010;1;3291;1706;1585
Kaunas c. mun.;2010;2;3028;1569;1459
Kaunas c. mun.;2010;3;2816;1471;1345
Kaunas c. mun.;2010;4;2834;1435;1399
Kaunas c. mun.;2010;5;2720;1384;1336
Kaunas c. mun.;2010;6;2656;1330;1326
Kaunas c. mun.;2010;7;2620;1352;1268
Kaunas c. mun.;2010;8;2698;1403;1295
Kaunas c. mun.;2010;9;2925;1527;1398
Kaunas c. mun.;2010;10;3254;1676;1578
Kaunas c. mun.;2010;11;3362;1786;1576
Kaunas c. mun.;2010;12;3438;1757;1681
Kaunas c. mun.;2010;13;3703;1848;1855
Kaunas c. mun.;2010;14;3812;2013;1799
Kaunas c. mun.;2010;15;3648;1868;1780
Kaunas c. mun.;2010;16;4193;2145;2048
Kaunas c. mun.;2010;17;4344;2260;2084
Kaunas c. mun.;2010;18;4315;2212;2103
Kaunas c. mun.;2010;19;4044;2027;2017
Kaunas c. mun.;2010;20;3880;1941;1939
Kaunas c. mun.;2010;21;4011;1969;2042
Kaunas c. mun.;2010;22;4206;2093;2113
Kaunas c. mun.;2010;23;4395;2213;2182
Kaunas c. mun.;2010;24;4351;2143;2208
Kaunas c. mun.;2010;25;4393;2129;2264
Kaunas c. mun.;2010;26;4432;2091;2341
Kaunas c. mun.;2010;27;5150;2320;2830
Kaunas c. mun.;2010;28;5652;2523;3129
Kaunas c. mun.;2010;29;5282;2390;2892
Kaunas c. mun.;2010;30;4934;2328;2606
Kaunas c. mun.;2010;31;4829;2290;2539
Kaunas c. mun.;2010;32;4868;2274;2594
Kaunas c. mun.;2010;33;4802;2261;2541
Kaunas c. mun.;2010;34;4715;2299;2416
Kaunas c. mun.;2010;35;4904;2363;2541
Kaunas c. mun.;2010;36;4758;2322;2436
Kaunas c. mun.;2010;37;4880;2335;2545
Kaunas c. mun.;2010;38;5083;2422;2661
Kaunas c. mun.;2010;39;4832;2190;2642
Kaunas c. mun.;2010;40;4811;2294;2517
Kaunas c. mun.;2010;41;4702;2271;2431
Kaunas c. mun.;2010;42;4670;2146;2524
Kaunas c. mun.;2010;43;4566;2108;2458
Kaunas c. mun.;2010;44;4629;2153;2476
Kaunas c. mun.;2010;45;4812;2206;2606
Kaunas c. mun.;2010;46;4809;2159;2650
Kaunas c. mun.;2010;47;5226;2343;2883
Kaunas c. mun.;2010;48;5164;2286;2878
Kaunas c. mun.;2010;49;4965;2193;2772
Kaunas c. mun.;2010;50;5272;2355;2917
Kaunas c. mun.;2010;51;4983;2195;2788
Kaunas c. mun.;2010;52;4702;2067;2635
Kaunas c. mun.;2010;53;4552;1894;2658
Kaunas c. mun.;2010;54;4265;1815;2450
Kaunas c. mun.;2010;55;3907;1570;2337
Kaunas c. mun.;2010;56;3884;1688;2196
Kaunas c. mun.;2010;57;4083;1690;2393
Kaunas c. mun.;2010;58;4067;1657;2410
Kaunas c. mun.;2010;59;4068;1629;2439
Kaunas c. mun.;2010;60;3873;1538;2335
Kaunas c. mun.;2010;61;3556;1431;2125
Kaunas c. mun.;2010;62;3496;1403;2093
Kaunas c. mun.;2010;63;3321;1337;1984
Kaunas c. mun.;2010;64;3569;1391;2178
Kaunas c. mun.;2010;65;3259;1266;1993
Kaunas c. mun.;2010;66;3672;1357;2315
Kaunas c. mun.;2010;67;3810;1437;2373
Kaunas c. mun.;2010;68;3511;1281;2230
Kaunas c. mun.;2010;69;3373;1261;2112
Kaunas c. mun.;2010;70;3224;1181;2043
Kaunas c. mun.;2010;71;3103;1066;2037
Kaunas c. mun.;2010;72;3016;1022;1994
Kaunas c. mun.;2010;73;2841;984;1857
Kaunas c. mun.;2010;74;2613;847;1766
Kaunas c. mun.;2010;75;2528;799;1729
Kaunas c. mun.;2010;76;2590;868;1722
Kaunas c. mun.;2010;77;2398;787;1611
Kaunas c. mun.;2010;78;2216;684;1532
Kaunas c. mun.;2010;79;2171;711;1460
Kaunas c. mun.;2010;80;2013;661;1352
Kaunas c. mun.;2010;81;1911;602;1309
Kaunas c. mun.;2010;82;1655;528;1127
Kaunas c. mun.;2010;83;1479;315;1164
Kaunas c. mun.;2010;84;1262;280;982
Kaunas c. mun.;2010;85;5445;1188;4257
Kaunas c. mun.;2011;-1;317319;140490;176829
Kaunas c. mun.;2011;0;3522;1807;1715
Kaunas c. mun.;2011;1;3473;1751;1722
Kaunas c. mun.;2011;2;3115;1607;1508
Kaunas c. mun.;2011;3;2911;1486;1425
Kaunas c. mun.;2011;4;2739;1447;1292
Kaunas c. mun.;2011;5;2708;1387;1321
Kaunas c. mun.;2011;6;2628;1343;1285
Kaunas c. mun.;2011;7;2527;1287;1240
Kaunas c. mun.;2011;8;2548;1294;1254
Kaunas c. mun.;2011;9;2593;1325;1268
Kaunas c. mun.;2011;10;2806;1436;1370
Kaunas c. mun.;2011;11;3113;1605;1508
Kaunas c. mun.;2011;12;3220;1717;1503
Kaunas c. mun.;2011;13;3215;1619;1596
Kaunas c. mun.;2011;14;3468;1753;1715
Kaunas c. mun.;2011;15;3643;1904;1739
Kaunas c. mun.;2011;16;3557;1809;1748
Kaunas c. mun.;2011;17;4031;2085;1946
Kaunas c. mun.;2011;18;4363;2257;2106
Kaunas c. mun.;2011;19;5074;2483;2591
Kaunas c. mun.;2011;20;5094;2423;2671
Kaunas c. mun.;2011;21;4741;2227;2514
Kaunas c. mun.;2011;22;4796;2221;2575
Kaunas c. mun.;2011;23;4958;2369;2589
Kaunas c. mun.;2011;24;5008;2499;2509
Kaunas c. mun.;2011;25;4825;2319;2506
Kaunas c. mun.;2011;26;4831;2322;2509
Kaunas c. mun.;2011;27;4770;2302;2468
Kaunas c. mun.;2011;28;4397;2122;2275
Kaunas c. mun.;2011;29;4161;2070;2091
Kaunas c. mun.;2011;30;4118;2022;2096
Kaunas c. mun.;2011;31;4035;1996;2039
Kaunas c. mun.;2011;32;4105;2044;2061
Kaunas c. mun.;2011;33;4159;2014;2145
Kaunas c. mun.;2011;34;4051;1982;2069
Kaunas c. mun.;2011;35;4057;1918;2139
Kaunas c. mun.;2011;36;4065;1906;2159
Kaunas c. mun.;2011;37;3918;1886;2032
Kaunas c. mun.;2011;38;4059;1892;2167
Kaunas c. mun.;2011;39;4476;2152;2324
Kaunas c. mun.;2011;40;4366;2016;2350
Kaunas c. mun.;2011;41;4268;2044;2224
Kaunas c. mun.;2011;42;4214;1969;2245
Kaunas c. mun.;2011;43;4214;1887;2327
Kaunas c. mun.;2011;44;4153;1871;2282
Kaunas c. mun.;2011;45;4162;1901;2261
Kaunas c. mun.;2011;46;4370;1960;2410
Kaunas c. mun.;2011;47;4401;1932;2469
Kaunas c. mun.;2011;48;4835;2130;2705
Kaunas c. mun.;2011;49;4897;2162;2735
Kaunas c. mun.;2011;50;4893;2178;2715
Kaunas c. mun.;2011;51;4950;2150;2800
Kaunas c. mun.;2011;52;4907;2136;2771
Kaunas c. mun.;2011;53;4532;1976;2556
Kaunas c. mun.;2011;54;4176;1717;2459
Kaunas c. mun.;2011;55;4051;1748;2303
Kaunas c. mun.;2011;56;3766;1534;2232
Kaunas c. mun.;2011;57;3638;1550;2088
Kaunas c. mun.;2011;58;3771;1519;2252
Kaunas c. mun.;2011;59;3805;1498;2307
Kaunas c. mun.;2011;60;3843;1488;2355
Kaunas c. mun.;2011;61;3960;1585;2375
Kaunas c. mun.;2011;62;3464;1365;2099
Kaunas c. mun.;2011;63;3265;1239;2026
Kaunas c. mun.;2011;64;3157;1251;1906
Kaunas c. mun.;2011;65;3411;1314;2097
Kaunas c. mun.;2011;66;3053;1155;1898
Kaunas c. mun.;2011;67;3499;1245;2254
Kaunas c. mun.;2011;68;3723;1381;2342
Kaunas c. mun.;2011;69;3502;1264;2238
Kaunas c. mun.;2011;70;3291;1199;2092
Kaunas c. mun.;2011;71;3180;1172;2008
Kaunas c. mun.;2011;72;3107;1078;2029
Kaunas c. mun.;2011;73;2951;964;1987
Kaunas c. mun.;2011;74;2825;963;1862
Kaunas c. mun.;2011;75;2618;839;1779
Kaunas c. mun.;2011;76;2406;743;1663
Kaunas c. mun.;2011;77;2531;835;1696
Kaunas c. mun.;2011;78;2424;805;1619
Kaunas c. mun.;2011;79;2225;697;1528
Kaunas c. mun.;2011;80;2138;699;1439
Kaunas c. mun.;2011;81;1950;622;1328
Kaunas c. mun.;2011;82;1819;563;1256
Kaunas c. mun.;2011;83;1583;480;1103
Kaunas c. mun.;2011;84;1412;313;1099
Kaunas c. mun.;2011;85;5735;1265;4470
Kaunas c. mun.;2012;-1;310773;137178;173595
Kaunas c. mun.;2012;0;3192;1627;1565
Kaunas c. mun.;2012;1;3536;1811;1725
Kaunas c. mun.;2012;2;3439;1733;1706
Kaunas c. mun.;2012;3;3009;1536;1473
Kaunas c. mun.;2012;4;2866;1480;1386
Kaunas c. mun.;2012;5;2660;1401;1259
Kaunas c. mun.;2012;6;2650;1354;1296
Kaunas c. mun.;2012;7;2565;1319;1246
Kaunas c. mun.;2012;8;2467;1263;1204
Kaunas c. mun.;2012;9;2499;1283;1216
Kaunas c. mun.;2012;10;2538;1301;1237
Kaunas c. mun.;2012;11;2739;1399;1340
Kaunas c. mun.;2012;12;3051;1567;1484
Kaunas c. mun.;2012;13;3154;1681;1473
Kaunas c. mun.;2012;14;3158;1592;1566
Kaunas c. mun.;2012;15;3393;1712;1681
Kaunas c. mun.;2012;16;3610;1883;1727
Kaunas c. mun.;2012;17;3506;1780;1726
Kaunas c. mun.;2012;18;3971;2045;1926
Kaunas c. mun.;2012;19;4208;2197;2011
Kaunas c. mun.;2012;20;4997;2446;2551
Kaunas c. mun.;2012;21;5010;2375;2635
Kaunas c. mun.;2012;22;4617;2164;2453
Kaunas c. mun.;2012;23;4571;2114;2457
Kaunas c. mun.;2012;24;4761;2278;2483
Kaunas c. mun.;2012;25;4823;2400;2423
Kaunas c. mun.;2012;26;4638;2198;2440
Kaunas c. mun.;2012;27;4696;2227;2469
Kaunas c. mun.;2012;28;4658;2226;2432
Kaunas c. mun.;2012;29;4243;2027;2216
Kaunas c. mun.;2012;30;3985;1971;2014
Kaunas c. mun.;2012;31;3985;1942;2043
Kaunas c. mun.;2012;32;3902;1931;1971
Kaunas c. mun.;2012;33;3945;1964;1981
Kaunas c. mun.;2012;34;3973;1923;2050
Kaunas c. mun.;2012;35;3846;1872;1974
Kaunas c. mun.;2012;36;3894;1830;2064
Kaunas c. mun.;2012;37;3913;1830;2083
Kaunas c. mun.;2012;38;3783;1815;1968
Kaunas c. mun.;2012;39;3929;1819;2110
Kaunas c. mun.;2012;40;4348;2070;2278
Kaunas c. mun.;2012;41;4231;1930;2301
Kaunas c. mun.;2012;42;4136;1967;2169
Kaunas c. mun.;2012;43;4106;1911;2195
Kaunas c. mun.;2012;44;4098;1827;2271
Kaunas c. mun.;2012;45;4035;1816;2219
Kaunas c. mun.;2012;46;4072;1847;2225
Kaunas c. mun.;2012;47;4279;1914;2365
Kaunas c. mun.;2012;48;4295;1865;2430
Kaunas c. mun.;2012;49;4722;2074;2648
Kaunas c. mun.;2012;50;4797;2101;2696
Kaunas c. mun.;2012;51;4772;2103;2669
Kaunas c. mun.;2012;52;4860;2100;2760
Kaunas c. mun.;2012;53;4824;2088;2736
Kaunas c. mun.;2012;54;4440;1931;2509
Kaunas c. mun.;2012;55;4074;1677;2397
Kaunas c. mun.;2012;56;3966;1692;2274
Kaunas c. mun.;2012;57;3702;1495;2207
Kaunas c. mun.;2012;58;3566;1512;2054
Kaunas c. mun.;2012;59;3707;1479;2228
Kaunas c. mun.;2012;60;3712;1449;2263
Kaunas c. mun.;2012;61;3767;1442;2325
Kaunas c. mun.;2012;62;3874;1524;2350
Kaunas c. mun.;2012;63;3381;1328;2053
Kaunas c. mun.;2012;64;3179;1186;1993
Kaunas c. mun.;2012;65;3081;1212;1869
Kaunas c. mun.;2012;66;3324;1257;2067
Kaunas c. mun.;2012;67;2985;1110;1875
Kaunas c. mun.;2012;68;3412;1195;2217
Kaunas c. mun.;2012;69;3634;1320;2314
Kaunas c. mun.;2012;70;3412;1208;2204
Kaunas c. mun.;2012;71;3209;1153;2056
Kaunas c. mun.;2012;72;3083;1121;1962
Kaunas c. mun.;2012;73;3003;1019;1984
Kaunas c. mun.;2012;74;2884;926;1958
Kaunas c. mun.;2012;75;2707;895;1812
Kaunas c. mun.;2012;76;2527;800;1727
Kaunas c. mun.;2012;77;2297;690;1607
Kaunas c. mun.;2012;78;2417;779;1638
Kaunas c. mun.;2012;79;2289;741;1548
Kaunas c. mun.;2012;80;2095;628;1467
Kaunas c. mun.;2012;81;1995;638;1357
Kaunas c. mun.;2012;82;1820;575;1245
Kaunas c. mun.;2012;83;1673;505;1168
Kaunas c. mun.;2012;84;1430;421;1009
Kaunas c. mun.;2012;85;6173;1341;4832
Kaunas c. mun.;2013;-1;306888;135230;171658
Kaunas c. mun.;2013;0;3222;1646;1576
Kaunas c. mun.;2013;1;3266;1653;1613
Kaunas c. mun.;2013;2;3598;1855;1743
Kaunas c. mun.;2013;3;3421;1722;1699
Kaunas c. mun.;2013;4;2952;1517;1435
Kaunas c. mun.;2013;5;2817;1456;1361
Kaunas c. mun.;2013;6;2598;1365;1233
Kaunas c. mun.;2013;7;2613;1330;1283
Kaunas c. mun.;2013;8;2523;1298;1225
Kaunas c. mun.;2013;9;2421;1234;1187
Kaunas c. mun.;2013;10;2466;1261;1205
Kaunas c. mun.;2013;11;2470;1272;1198
Kaunas c. mun.;2013;12;2694;1372;1322
Kaunas c. mun.;2013;13;3022;1555;1467
Kaunas c. mun.;2013;14;3103;1650;1453
Kaunas c. mun.;2013;15;3123;1576;1547
Kaunas c. mun.;2013;16;3343;1686;1657
Kaunas c. mun.;2013;17;3576;1867;1709
Kaunas c. mun.;2013;18;3477;1758;1719
Kaunas c. mun.;2013;19;3836;1977;1859
Kaunas c. mun.;2013;20;4150;2160;1990
Kaunas c. mun.;2013;21;4956;2420;2536
Kaunas c. mun.;2013;22;4942;2333;2609
Kaunas c. mun.;2013;23;4585;2144;2441
Kaunas c. mun.;2013;24;4515;2072;2443
Kaunas c. mun.;2013;25;4692;2241;2451
Kaunas c. mun.;2013;26;4787;2353;2434
Kaunas c. mun.;2013;27;4643;2185;2458
Kaunas c. mun.;2013;28;4724;2247;2477
Kaunas c. mun.;2013;29;4649;2199;2450
Kaunas c. mun.;2013;30;4197;1995;2202
Kaunas c. mun.;2013;31;3919;1941;1978
Kaunas c. mun.;2013;32;3888;1886;2002
Kaunas c. mun.;2013;33;3816;1897;1919
Kaunas c. mun.;2013;34;3836;1910;1926
Kaunas c. mun.;2013;35;3852;1848;2004
Kaunas c. mun.;2013;36;3762;1823;1939
Kaunas c. mun.;2013;37;3779;1768;2011
Kaunas c. mun.;2013;38;3816;1781;2035
Kaunas c. mun.;2013;39;3715;1785;1930
Kaunas c. mun.;2013;40;3836;1760;2076
Kaunas c. mun.;2013;41;4265;2029;2236
Kaunas c. mun.;2013;42;4134;1880;2254
Kaunas c. mun.;2013;43;4051;1910;2141
Kaunas c. mun.;2013;44;4017;1863;2154
Kaunas c. mun.;2013;45;3995;1779;2216
Kaunas c. mun.;2013;46;3986;1793;2193
Kaunas c. mun.;2013;47;3988;1808;2180
Kaunas c. mun.;2013;48;4204;1868;2336
Kaunas c. mun.;2013;49;4183;1802;2381
Kaunas c. mun.;2013;50;4658;2038;2620
Kaunas c. mun.;2013;51;4698;2039;2659
Kaunas c. mun.;2013;52;4689;2058;2631
Kaunas c. mun.;2013;53;4794;2068;2726
Kaunas c. mun.;2013;54;4763;2051;2712
Kaunas c. mun.;2013;55;4350;1869;2481
Kaunas c. mun.;2013;56;4019;1646;2373
Kaunas c. mun.;2013;57;3891;1642;2249
Kaunas c. mun.;2013;58;3624;1453;2171
Kaunas c. mun.;2013;59;3516;1474;2042
Kaunas c. mun.;2013;60;3651;1431;2220
Kaunas c. mun.;2013;61;3644;1402;2242
Kaunas c. mun.;2013;62;3698;1398;2300
Kaunas c. mun.;2013;63;3798;1468;2330
Kaunas c. mun.;2013;64;3302;1271;2031
Kaunas c. mun.;2013;65;3104;1134;1970
Kaunas c. mun.;2013;66;3008;1167;1841
Kaunas c. mun.;2013;67;3216;1189;2027
Kaunas c. mun.;2013;68;2913;1076;1837
Kaunas c. mun.;2013;69;3314;1138;2176
Kaunas c. mun.;2013;70;3547;1268;2279
Kaunas c. mun.;2013;71;3309;1134;2175
Kaunas c. mun.;2013;72;3110;1100;2010
Kaunas c. mun.;2013;73;2988;1071;1917
Kaunas c. mun.;2013;74;2904;975;1929
Kaunas c. mun.;2013;75;2782;879;1903
Kaunas c. mun.;2013;76;2609;853;1756
Kaunas c. mun.;2013;77;2413;749;1664
Kaunas c. mun.;2013;78;2195;646;1549
Kaunas c. mun.;2013;79;2298;733;1565
Kaunas c. mun.;2013;80;2147;681;1466
Kaunas c. mun.;2013;81;1961;576;1385
Kaunas c. mun.;2013;82;1846;572;1274
Kaunas c. mun.;2013;83;1667;512;1155
Kaunas c. mun.;2013;84;1528;457;1071
Kaunas c. mun.;2013;85;6511;1482;5029
Kaunas c. mun.;2014;-1;304012;133711;170301
Kaunas c. mun.;2014;0;3054;1538;1516
Kaunas c. mun.;2014;1;3307;1681;1626
Kaunas c. mun.;2014;2;3372;1699;1673
Kaunas c. mun.;2014;3;3595;1867;1728
Kaunas c. mun.;2014;4;3409;1716;1693
Kaunas c. mun.;2014;5;2901;1483;1418
Kaunas c. mun.;2014;6;2761;1419;1342
Kaunas c. mun.;2014;7;2555;1330;1225
Kaunas c. mun.;2014;8;2551;1303;1248
Kaunas c. mun.;2014;9;2497;1283;1214
Kaunas c. mun.;2014;10;2381;1202;1179
Kaunas c. mun.;2014;11;2411;1230;1181
Kaunas c. mun.;2014;12;2414;1234;1180
Kaunas c. mun.;2014;13;2658;1356;1302
Kaunas c. mun.;2014;14;2982;1531;1451
Kaunas c. mun.;2014;15;3085;1644;1441
Kaunas c. mun.;2014;16;3080;1555;1525
Kaunas c. mun.;2014;17;3307;1673;1634
Kaunas c. mun.;2014;18;3560;1859;1701
Kaunas c. mun.;2014;19;3406;1725;1681
Kaunas c. mun.;2014;20;3769;1935;1834
Kaunas c. mun.;2014;21;4124;2124;2000
Kaunas c. mun.;2014;22;4936;2404;2532
Kaunas c. mun.;2014;23;4886;2307;2579
Kaunas c. mun.;2014;24;4562;2104;2458
Kaunas c. mun.;2014;25;4522;2064;2458
Kaunas c. mun.;2014;26;4732;2231;2501
Kaunas c. mun.;2014;27;4832;2349;2483
Kaunas c. mun.;2014;28;4725;2207;2518
Kaunas c. mun.;2014;29;4741;2246;2495
Kaunas c. mun.;2014;30;4687;2200;2487
Kaunas c. mun.;2014;31;4188;1991;2197
Kaunas c. mun.;2014;32;3875;1907;1968
Kaunas c. mun.;2014;33;3809;1849;1960
Kaunas c. mun.;2014;34;3719;1837;1882
Kaunas c. mun.;2014;35;3735;1864;1871
Kaunas c. mun.;2014;36;3771;1816;1955
Kaunas c. mun.;2014;37;3702;1793;1909
Kaunas c. mun.;2014;38;3711;1739;1972
Kaunas c. mun.;2014;39;3752;1742;2010
Kaunas c. mun.;2014;40;3669;1763;1906
Kaunas c. mun.;2014;41;3785;1731;2054
Kaunas c. mun.;2014;42;4181;1994;2187
Kaunas c. mun.;2014;43;4064;1839;2225
Kaunas c. mun.;2014;44;3976;1874;2102
Kaunas c. mun.;2014;45;3913;1815;2098
Kaunas c. mun.;2014;46;3923;1738;2185
Kaunas c. mun.;2014;47;3930;1761;2169
Kaunas c. mun.;2014;48;3920;1763;2157
Kaunas c. mun.;2014;49;4145;1840;2305
Kaunas c. mun.;2014;50;4116;1765;2351
Kaunas c. mun.;2014;51;4592;1995;2597
Kaunas c. mun.;2014;52;4629;1997;2632
Kaunas c. mun.;2014;53;4608;2008;2600
Kaunas c. mun.;2014;54;4720;2024;2696
Kaunas c. mun.;2014;55;4671;2004;2667
Kaunas c. mun.;2014;56;4298;1835;2463
Kaunas c. mun.;2014;57;3940;1603;2337
Kaunas c. mun.;2014;58;3817;1607;2210
Kaunas c. mun.;2014;59;3554;1416;2138
Kaunas c. mun.;2014;60;3471;1442;2029
Kaunas c. mun.;2014;61;3595;1383;2212
Kaunas c. mun.;2014;62;3592;1367;2225
Kaunas c. mun.;2014;63;3641;1363;2278
Kaunas c. mun.;2014;64;3714;1417;2297
Kaunas c. mun.;2014;65;3206;1213;1993
Kaunas c. mun.;2014;66;3036;1090;1946
Kaunas c. mun.;2014;67;2939;1125;1814
Kaunas c. mun.;2014;68;3142;1138;2004
Kaunas c. mun.;2014;69;2827;1026;1801
Kaunas c. mun.;2014;70;3235;1093;2142
Kaunas c. mun.;2014;71;3446;1220;2226
Kaunas c. mun.;2014;72;3217;1085;2132
Kaunas c. mun.;2014;73;3011;1041;1970
Kaunas c. mun.;2014;74;2901;1024;1877
Kaunas c. mun.;2014;75;2799;928;1871
Kaunas c. mun.;2014;76;2682;829;1853
Kaunas c. mun.;2014;77;2488;794;1694
Kaunas c. mun.;2014;78;2306;688;1618
Kaunas c. mun.;2014;79;2102;610;1492
Kaunas c. mun.;2014;80;2159;669;1490
Kaunas c. mun.;2014;81;2020;629;1391
Kaunas c. mun.;2014;82;1818;516;1302
Kaunas c. mun.;2014;83;1701;516;1185
Kaunas c. mun.;2014;84;1524;450;1074
Kaunas c. mun.;2014;85;6925;1646;5279
Kaunas c. mun.;2015;-1;301357;132380;168977
Kaunas c. mun.;2015;0;3174;1640;1534
Kaunas c. mun.;2015;1;3134;1571;1563
Kaunas c. mun.;2015;2;3356;1709;1647
Kaunas c. mun.;2015;3;3335;1688;1647
Kaunas c. mun.;2015;4;3535;1837;1698
Kaunas c. mun.;2015;5;3381;1693;1688
Kaunas c. mun.;2015;6;2839;1451;1388
Kaunas c. mun.;2015;7;2695;1392;1303
Kaunas c. mun.;2015;8;2494;1302;1192
Kaunas c. mun.;2015;9;2522;1281;1241
Kaunas c. mun.;2015;10;2454;1261;1193
Kaunas c. mun.;2015;11;2335;1174;1161
Kaunas c. mun.;2015;12;2359;1200;1159
Kaunas c. mun.;2015;13;2382;1224;1158
Kaunas c. mun.;2015;14;2637;1331;1306
Kaunas c. mun.;2015;15;2943;1497;1446
Kaunas c. mun.;2015;16;3043;1618;1425
Kaunas c. mun.;2015;17;3051;1539;1512
Kaunas c. mun.;2015;18;3274;1663;1611
Kaunas c. mun.;2015;19;3505;1834;1671
Kaunas c. mun.;2015;20;3360;1694;1666
Kaunas c. mun.;2015;21;3723;1902;1821
Kaunas c. mun.;2015;22;4120;2118;2002
Kaunas c. mun.;2015;23;4887;2375;2512
Kaunas c. mun.;2015;24;4921;2295;2626
Kaunas c. mun.;2015;25;4596;2113;2483
Kaunas c. mun.;2015;26;4575;2064;2511
Kaunas c. mun.;2015;27;4787;2224;2563
Kaunas c. mun.;2015;28;4901;2377;2524
Kaunas c. mun.;2015;29;4750;2207;2543
Kaunas c. mun.;2015;30;4749;2246;2503
Kaunas c. mun.;2015;31;4667;2181;2486
Kaunas c. mun.;2015;32;4160;1975;2185
Kaunas c. mun.;2015;33;3825;1870;1955
Kaunas c. mun.;2015;34;3717;1803;1914
Kaunas c. mun.;2015;35;3608;1773;1835
Kaunas c. mun.;2015;36;3674;1815;1859
Kaunas c. mun.;2015;37;3717;1784;1933
Kaunas c. mun.;2015;38;3644;1765;1879
Kaunas c. mun.;2015;39;3646;1702;1944
Kaunas c. mun.;2015;40;3691;1707;1984
Kaunas c. mun.;2015;41;3604;1725;1879
Kaunas c. mun.;2015;42;3694;1689;2005
Kaunas c. mun.;2015;43;4115;1954;2161
Kaunas c. mun.;2015;44;3980;1795;2185
Kaunas c. mun.;2015;45;3877;1815;2062
Kaunas c. mun.;2015;46;3858;1774;2084
Kaunas c. mun.;2015;47;3889;1715;2174
Kaunas c. mun.;2015;48;3862;1723;2139
Kaunas c. mun.;2015;49;3880;1747;2133
Kaunas c. mun.;2015;50;4093;1814;2279
Kaunas c. mun.;2015;51;4056;1738;2318
Kaunas c. mun.;2015;52;4528;1954;2574
Kaunas c. mun.;2015;53;4547;1947;2600
Kaunas c. mun.;2015;54;4557;1985;2572
Kaunas c. mun.;2015;55;4641;1970;2671
Kaunas c. mun.;2015;56;4578;1951;2627
Kaunas c. mun.;2015;57;4241;1815;2426
Kaunas c. mun.;2015;58;3859;1564;2295
Kaunas c. mun.;2015;59;3767;1574;2193
Kaunas c. mun.;2015;60;3477;1368;2109
Kaunas c. mun.;2015;61;3427;1420;2007
Kaunas c. mun.;2015;62;3511;1335;2176
Kaunas c. mun.;2015;63;3521;1323;2198
Kaunas c. mun.;2015;64;3548;1303;2245
Kaunas c. mun.;2015;65;3628;1368;2260
Kaunas c. mun.;2015;66;3140;1175;1965
Kaunas c. mun.;2015;67;2974;1057;1917
Kaunas c. mun.;2015;68;2885;1097;1788
Kaunas c. mun.;2015;69;3064;1094;1970
Kaunas c. mun.;2015;70;2718;960;1758
Kaunas c. mun.;2015;71;3151;1053;2098
Kaunas c. mun.;2015;72;3358;1172;2186
Kaunas c. mun.;2015;73;3110;1040;2070
Kaunas c. mun.;2015;74;2934;999;1935
Kaunas c. mun.;2015;75;2808;972;1836
Kaunas c. mun.;2015;76;2719;892;1827
Kaunas c. mun.;2015;77;2593;787;1806
Kaunas c. mun.;2015;78;2364;745;1619
Kaunas c. mun.;2015;79;2183;638;1545
Kaunas c. mun.;2015;80;2007;567;1440
Kaunas c. mun.;2015;81;2012;587;1425
Kaunas c. mun.;2015;82;1912;581;1331
Kaunas c. mun.;2015;83;1682;464;1218
Kaunas c. mun.;2015;84;1575;468;1107
Kaunas c. mun.;2015;85;7264;1771;5493
Kaunas c. mun.;2016;-1;297846;130501;167345
Kaunas c. mun.;2016;0;3201;1676;1525
Kaunas c. mun.;2016;1;3228;1665;1563
Kaunas c. mun.;2016;2;3155;1588;1567
Kaunas c. mun.;2016;3;3316;1683;1633
Kaunas c. mun.;2016;4;3296;1681;1615
Kaunas c. mun.;2016;5;3464;1784;1680
Kaunas c. mun.;2016;6;3314;1650;1664
Kaunas c. mun.;2016;7;2794;1422;1372
Kaunas c. mun.;2016;8;2637;1365;1272
Kaunas c. mun.;2016;9;2458;1283;1175
Kaunas c. mun.;2016;10;2464;1264;1200
Kaunas c. mun.;2016;11;2402;1231;1171
Kaunas c. mun.;2016;12;2284;1151;1133
Kaunas c. mun.;2016;13;2319;1174;1145
Kaunas c. mun.;2016;14;2349;1206;1143
Kaunas c. mun.;2016;15;2599;1308;1291
Kaunas c. mun.;2016;16;2909;1478;1431
Kaunas c. mun.;2016;17;3003;1590;1413
Kaunas c. mun.;2016;18;3019;1528;1491
Kaunas c. mun.;2016;19;3203;1627;1576
Kaunas c. mun.;2016;20;3407;1756;1651
Kaunas c. mun.;2016;21;3276;1628;1648
Kaunas c. mun.;2016;22;3632;1817;1815
Kaunas c. mun.;2016;23;3997;2031;1966
Kaunas c. mun.;2016;24;4796;2298;2498
Kaunas c. mun.;2016;25;4953;2287;2666
Kaunas c. mun.;2016;26;4600;2080;2520
Kaunas c. mun.;2016;27;4553;2038;2515
Kaunas c. mun.;2016;28;4882;2255;2627
Kaunas c. mun.;2016;29;4954;2391;2563
Kaunas c. mun.;2016;30;4750;2170;2580
Kaunas c. mun.;2016;31;4750;2227;2523
Kaunas c. mun.;2016;32;4662;2179;2483
Kaunas c. mun.;2016;33;4131;1958;2173
Kaunas c. mun.;2016;34;3756;1848;1908
Kaunas c. mun.;2016;35;3626;1769;1857
Kaunas c. mun.;2016;36;3505;1704;1801
Kaunas c. mun.;2016;37;3594;1768;1826
Kaunas c. mun.;2016;38;3664;1771;1893
Kaunas c. mun.;2016;39;3588;1737;1851
Kaunas c. mun.;2016;40;3567;1672;1895
Kaunas c. mun.;2016;41;3630;1677;1953
Kaunas c. mun.;2016;42;3523;1689;1834
Kaunas c. mun.;2016;43;3625;1650;1975
Kaunas c. mun.;2016;44;4051;1936;2115
Kaunas c. mun.;2016;45;3916;1756;2160
Kaunas c. mun.;2016;46;3791;1767;2024
Kaunas c. mun.;2016;47;3780;1726;2054
Kaunas c. mun.;2016;48;3827;1676;2151
Kaunas c. mun.;2016;49;3832;1712;2120
Kaunas c. mun.;2016;50;3806;1704;2102
Kaunas c. mun.;2016;51;4029;1779;2250
Kaunas c. mun.;2016;52;4012;1711;2301
Kaunas c. mun.;2016;53;4475;1924;2551
Kaunas c. mun.;2016;54;4490;1915;2575
Kaunas c. mun.;2016;55;4453;1911;2542
Kaunas c. mun.;2016;56;4579;1924;2655
Kaunas c. mun.;2016;57;4493;1906;2587
Kaunas c. mun.;2016;58;4168;1770;2398
Kaunas c. mun.;2016;59;3771;1503;2268
Kaunas c. mun.;2016;60;3689;1526;2163
Kaunas c. mun.;2016;61;3435;1336;2099
Kaunas c. mun.;2016;62;3361;1374;1987
Kaunas c. mun.;2016;63;3433;1285;2148
Kaunas c. mun.;2016;64;3461;1286;2175
Kaunas c. mun.;2016;65;3441;1235;2206
Kaunas c. mun.;2016;66;3522;1305;2217
Kaunas c. mun.;2016;67;3062;1129;1933
Kaunas c. mun.;2016;68;2896;1001;1895
Kaunas c. mun.;2016;69;2810;1039;1771
Kaunas c. mun.;2016;70;2974;1049;1925
Kaunas c. mun.;2016;71;2634;917;1717
Kaunas c. mun.;2016;72;3049;990;2059
Kaunas c. mun.;2016;73;3255;1124;2131
Kaunas c. mun.;2016;74;3000;978;2022
Kaunas c. mun.;2016;75;2829;942;1887
Kaunas c. mun.;2016;76;2717;928;1789
Kaunas c. mun.;2016;77;2620;841;1779
Kaunas c. mun.;2016;78;2491;738;1753
Kaunas c. mun.;2016;79;2234;680;1554
Kaunas c. mun.;2016;80;2068;586;1482
Kaunas c. mun.;2016;81;1856;507;1349
Kaunas c. mun.;2016;82;1869;532;1337
Kaunas c. mun.;2016;83;1776;522;1254
Kaunas c. mun.;2016;84;1539;416;1123
Kaunas c. mun.;2016;85;7517;1861;5656
Kaunas c. mun.;2017;-1;292691;128121;164570
Kaunas c. mun.;2017;0;3217;1680;1537
Kaunas c. mun.;2017;1;3209;1675;1534
Kaunas c. mun.;2017;2;3131;1604;1527
Kaunas c. mun.;2017;3;3047;1521;1526
Kaunas c. mun.;2017;4;3195;1625;1570
Kaunas c. mun.;2017;5;3215;1629;1586
Kaunas c. mun.;2017;6;3360;1735;1625
Kaunas c. mun.;2017;7;3201;1599;1602
Kaunas c. mun.;2017;8;2715;1383;1332
Kaunas c. mun.;2017;9;2576;1339;1237
Kaunas c. mun.;2017;10;2417;1254;1163
Kaunas c. mun.;2017;11;2402;1237;1165
Kaunas c. mun.;2017;12;2359;1208;1151
Kaunas c. mun.;2017;13;2242;1133;1109
Kaunas c. mun.;2017;14;2296;1157;1139
Kaunas c. mun.;2017;15;2306;1186;1120
Kaunas c. mun.;2017;16;2551;1278;1273
Kaunas c. mun.;2017;17;2851;1454;1397
Kaunas c. mun.;2017;18;2977;1575;1402
Kaunas c. mun.;2017;19;2970;1501;1469
Kaunas c. mun.;2017;20;3162;1601;1561
Kaunas c. mun.;2017;21;3356;1721;1635
Kaunas c. mun.;2017;22;3239;1614;1625
Kaunas c. mun.;2017;23;3584;1799;1785
Kaunas c. mun.;2017;24;3951;1994;1957
Kaunas c. mun.;2017;25;4735;2246;2489
Kaunas c. mun.;2017;26;4922;2264;2658
Kaunas c. mun.;2017;27;4552;2056;2496
Kaunas c. mun.;2017;28;4549;2029;2520
Kaunas c. mun.;2017;29;4866;2254;2612
Kaunas c. mun.;2017;30;4879;2354;2525
Kaunas c. mun.;2017;31;4661;2132;2529
Kaunas c. mun.;2017;32;4628;2160;2468
Kaunas c. mun.;2017;33;4544;2144;2400
Kaunas c. mun.;2017;34;3987;1902;2085
Kaunas c. mun.;2017;35;3597;1771;1826
Kaunas c. mun.;2017;36;3496;1696;1800
Kaunas c. mun.;2017;37;3415;1660;1755
Kaunas c. mun.;2017;38;3468;1720;1748
Kaunas c. mun.;2017;39;3543;1690;1853
Kaunas c. mun.;2017;40;3491;1686;1805
Kaunas c. mun.;2017;41;3460;1618;1842
Kaunas c. mun.;2017;42;3501;1605;1896
Kaunas c. mun.;2017;43;3413;1631;1782
Kaunas c. mun.;2017;44;3524;1599;1925
Kaunas c. mun.;2017;45;3957;1884;2073
Kaunas c. mun.;2017;46;3824;1696;2128
Kaunas c. mun.;2017;47;3708;1735;1973
Kaunas c. mun.;2017;48;3688;1674;2014
Kaunas c. mun.;2017;49;3748;1639;2109
Kaunas c. mun.;2017;50;3742;1666;2076
Kaunas c. mun.;2017;51;3730;1667;2063
Kaunas c. mun.;2017;52;3923;1731;2192
Kaunas c. mun.;2017;53;3915;1668;2247
Kaunas c. mun.;2017;54;4389;1864;2525
Kaunas c. mun.;2017;55;4384;1871;2513
Kaunas c. mun.;2017;56;4368;1880;2488
Kaunas c. mun.;2017;57;4490;1870;2620
Kaunas c. mun.;2017;58;4399;1852;2547
Kaunas c. mun.;2017;59;4074;1715;2359
Kaunas c. mun.;2017;60;3711;1470;2241
Kaunas c. mun.;2017;61;3623;1486;2137
Kaunas c. mun.;2017;62;3363;1289;2074
Kaunas c. mun.;2017;63;3310;1345;1965
Kaunas c. mun.;2017;64;3367;1246;2121
Kaunas c. mun.;2017;65;3388;1237;2151
Kaunas c. mun.;2017;66;3343;1170;2173
Kaunas c. mun.;2017;67;3434;1251;2183
Kaunas c. mun.;2017;68;2981;1083;1898
Kaunas c. mun.;2017;69;2830;959;1871
Kaunas c. mun.;2017;70;2731;994;1737
Kaunas c. mun.;2017;71;2876;994;1882
Kaunas c. mun.;2017;72;2537;870;1667
Kaunas c. mun.;2017;73;2945;940;2005
Kaunas c. mun.;2017;74;3159;1069;2090
Kaunas c. mun.;2017;75;2885;926;1959
Kaunas c. mun.;2017;76;2745;898;1847
Kaunas c. mun.;2017;77;2594;860;1734
Kaunas c. mun.;2017;78;2507;781;1726
Kaunas c. mun.;2017;79;2363;684;1679
Kaunas c. mun.;2017;80;2119;627;1492
Kaunas c. mun.;2017;81;1963;543;1420
Kaunas c. mun.;2017;82;1701;453;1248
Kaunas c. mun.;2017;83;1748;481;1267
Kaunas c. mun.;2017;84;1605;459;1146
Kaunas c. mun.;2017;85;7764;1875;5889
Kaunas c. mun.;2018;-1;288363;126411;161952
Kaunas c. mun.;2018;0;3017;1569;1448
Kaunas c. mun.;2018;1;3256;1701;1555
Kaunas c. mun.;2018;2;3224;1675;1549
Kaunas c. mun.;2018;3;3061;1579;1482
Kaunas c. mun.;2018;4;2956;1488;1468
Kaunas c. mun.;2018;5;3124;1578;1546
Kaunas c. mun.;2018;6;3118;1577;1541
Kaunas c. mun.;2018;7;3283;1695;1588
Kaunas c. mun.;2018;8;3095;1555;1540
Kaunas c. mun.;2018;9;2662;1345;1317
Kaunas c. mun.;2018;10;2512;1310;1202
Kaunas c. mun.;2018;11;2360;1219;1141
Kaunas c. mun.;2018;12;2358;1208;1150
Kaunas c. mun.;2018;13;2329;1192;1137
Kaunas c. mun.;2018;14;2204;1111;1093
Kaunas c. mun.;2018;15;2280;1150;1130
Kaunas c. mun.;2018;16;2283;1175;1108
Kaunas c. mun.;2018;17;2510;1258;1252
Kaunas c. mun.;2018;18;2804;1428;1376
Kaunas c. mun.;2018;19;2911;1548;1363
Kaunas c. mun.;2018;20;2877;1469;1408
Kaunas c. mun.;2018;21;3079;1554;1525
Kaunas c. mun.;2018;22;3273;1683;1590
Kaunas c. mun.;2018;23;3146;1591;1555
Kaunas c. mun.;2018;24;3470;1738;1732
Kaunas c. mun.;2018;25;3899;1943;1956
Kaunas c. mun.;2018;26;4711;2245;2466
Kaunas c. mun.;2018;27;4898;2266;2632
Kaunas c. mun.;2018;28;4522;2022;2500
Kaunas c. mun.;2018;29;4521;2002;2519
Kaunas c. mun.;2018;30;4807;2238;2569
Kaunas c. mun.;2018;31;4751;2269;2482
Kaunas c. mun.;2018;32;4592;2105;2487
Kaunas c. mun.;2018;33;4569;2144;2425
Kaunas c. mun.;2018;34;4463;2124;2339
Kaunas c. mun.;2018;35;3922;1893;2029
Kaunas c. mun.;2018;36;3495;1736;1759
Kaunas c. mun.;2018;37;3396;1654;1742
Kaunas c. mun.;2018;38;3344;1641;1703
Kaunas c. mun.;2018;39;3409;1694;1715
Kaunas c. mun.;2018;40;3489;1684;1805
Kaunas c. mun.;2018;41;3424;1674;1750
Kaunas c. mun.;2018;42;3410;1598;1812
Kaunas c. mun.;2018;43;3462;1585;1877
Kaunas c. mun.;2018;44;3378;1613;1765
Kaunas c. mun.;2018;45;3451;1566;1885
Kaunas c. mun.;2018;46;3891;1858;2033
Kaunas c. mun.;2018;47;3768;1671;2097
Kaunas c. mun.;2018;48;3647;1699;1948
Kaunas c. mun.;2018;49;3625;1637;1988
Kaunas c. mun.;2018;50;3696;1611;2085
Kaunas c. mun.;2018;51;3686;1636;2050
Kaunas c. mun.;2018;52;3673;1635;2038
Kaunas c. mun.;2018;53;3854;1697;2157
Kaunas c. mun.;2018;54;3824;1633;2191
Kaunas c. mun.;2018;55;4323;1826;2497
Kaunas c. mun.;2018;56;4327;1830;2497
Kaunas c. mun.;2018;57;4307;1848;2459
Kaunas c. mun.;2018;58;4409;1816;2593
Kaunas c. mun.;2018;59;4324;1805;2519
Kaunas c. mun.;2018;60;4000;1677;2323
Kaunas c. mun.;2018;61;3648;1433;2215
Kaunas c. mun.;2018;62;3568;1447;2121
Kaunas c. mun.;2018;63;3299;1240;2059
Kaunas c. mun.;2018;64;3255;1316;1939
Kaunas c. mun.;2018;65;3312;1221;2091
Kaunas c. mun.;2018;66;3299;1185;2114
Kaunas c. mun.;2018;67;3263;1125;2138
Kaunas c. mun.;2018;68;3348;1196;2152
Kaunas c. mun.;2018;69;2908;1047;1861
Kaunas c. mun.;2018;70;2764;930;1834
Kaunas c. mun.;2018;71;2647;949;1698
Kaunas c. mun.;2018;72;2766;929;1837
Kaunas c. mun.;2018;73;2460;824;1636
Kaunas c. mun.;2018;74;2865;899;1966
Kaunas c. mun.;2018;75;3058;1024;2034
Kaunas c. mun.;2018;76;2773;863;1910
Kaunas c. mun.;2018;77;2631;832;1799
Kaunas c. mun.;2018;78;2498;810;1688
Kaunas c. mun.;2018;79;2386;730;1656
Kaunas c. mun.;2018;80;2239;624;1615
Kaunas c. mun.;2018;81;1976;568;1408
Kaunas c. mun.;2018;82;1856;506;1350
Kaunas c. mun.;2018;83;1583;409;1174
Kaunas c. mun.;2018;84;1594;426;1168
Kaunas c. mun.;2018;85;7908;1907;6001
Kaunas county;2001;-1;702090;324368;377722
Kaunas county;2001;0;6637;3434;3203
Kaunas county;2001;1;7176;3654;3522
Kaunas county;2001;2;7385;3870;3515
Kaunas county;2001;3;7601;3870;3731
Kaunas county;2001;4;7943;4038;3905
Kaunas county;2001;5;8230;4271;3959
Kaunas county;2001;6;8007;4064;3943
Kaunas county;2001;7;9151;4676;4475
Kaunas county;2001;8;10197;5252;4945
Kaunas county;2001;9;10006;5137;4869
Kaunas county;2001;10;9966;5088;4878
Kaunas county;2001;11;9622;4957;4665
Kaunas county;2001;12;9853;5024;4829
Kaunas county;2001;13;10461;5285;5176
Kaunas county;2001;14;11028;5663;5365
Kaunas county;2001;15;10627;5341;5286
Kaunas county;2001;16;10497;5348;5149
Kaunas county;2001;17;10131;5161;4970
Kaunas county;2001;18;10624;5243;5381
Kaunas county;2001;19;11287;5545;5742
Kaunas county;2001;20;11216;5553;5663
Kaunas county;2001;21;10668;5414;5254
Kaunas county;2001;22;10197;5048;5149
Kaunas county;2001;23;9939;4983;4956
Kaunas county;2001;24;9696;4801;4895
Kaunas county;2001;25;9663;4861;4802
Kaunas county;2001;26;9941;4955;4986
Kaunas county;2001;27;9879;4944;4935
Kaunas county;2001;28;10495;5173;5322
Kaunas county;2001;29;10621;5213;5408
Kaunas county;2001;30;10474;5074;5400
Kaunas county;2001;31;10233;5040;5193
Kaunas county;2001;32;10362;5042;5320
Kaunas county;2001;33;10315;5011;5304
Kaunas county;2001;34;10250;4972;5278
Kaunas county;2001;35;10214;5014;5200
Kaunas county;2001;36;10507;5118;5389
Kaunas county;2001;37;10453;5056;5397
Kaunas county;2001;38;11265;5379;5886
Kaunas county;2001;39;11440;5420;6020
Kaunas county;2001;40;10986;5170;5816
Kaunas county;2001;41;11199;5312;5887
Kaunas county;2001;42;10427;4891;5536
Kaunas county;2001;43;10018;4781;5237
Kaunas county;2001;44;9584;4416;5168
Kaunas county;2001;45;9299;4359;4940
Kaunas county;2001;46;8570;3905;4665
Kaunas county;2001;47;8415;3950;4465
Kaunas county;2001;48;8788;4000;4788
Kaunas county;2001;49;8720;3954;4766
Kaunas county;2001;50;8674;3895;4779
Kaunas county;2001;51;8438;3733;4705
Kaunas county;2001;52;7727;3478;4249
Kaunas county;2001;53;7400;3315;4085
Kaunas county;2001;54;7163;3207;3956
Kaunas county;2001;55;7981;3527;4454
Kaunas county;2001;56;6968;3079;3889
Kaunas county;2001;57;8207;3501;4706
Kaunas county;2001;58;8839;3767;5072
Kaunas county;2001;59;8127;3450;4677
Kaunas county;2001;60;7511;3217;4294
Kaunas county;2001;61;7353;3117;4236
Kaunas county;2001;62;7317;3007;4310
Kaunas county;2001;63;7018;2818;4200
Kaunas county;2001;64;6902;2841;4061
Kaunas county;2001;65;6710;2683;4027
Kaunas county;2001;66;6479;2533;3946
Kaunas county;2001;67;6652;2594;4058
Kaunas county;2001;68;6613;2547;4066
Kaunas county;2001;69;6262;2340;3922
Kaunas county;2001;70;6213;2380;3833
Kaunas county;2001;71;5729;2158;3571
Kaunas county;2001;72;5771;2122;3649
Kaunas county;2001;73;5295;1918;3377
Kaunas county;2001;74;4757;1364;3393
Kaunas county;2001;75;4415;1277;3138
Kaunas county;2001;76;4079;1194;2885
Kaunas county;2001;77;3764;1149;2615
Kaunas county;2001;78;3482;972;2510
Kaunas county;2001;79;3013;904;2109
Kaunas county;2001;80;2520;707;1813
Kaunas county;2001;81;2103;576;1527
Kaunas county;2001;82;1566;388;1178
Kaunas county;2001;83;1255;336;919
Kaunas county;2001;84;1394;365;1029
Kaunas county;2001;85;8130;2179;5951
Kaunas county;2002;-1;695033;321124;373909
Kaunas county;2002;0;6160;3225;2935
Kaunas county;2002;1;6573;3403;3170
Kaunas county;2002;2;7134;3628;3506
Kaunas county;2002;3;7346;3867;3479
Kaunas county;2002;4;7541;3844;3697
Kaunas county;2002;5;7903;4019;3884
Kaunas county;2002;6;8188;4246;3942
Kaunas county;2002;7;7989;4061;3928
Kaunas county;2002;8;9098;4650;4448
Kaunas county;2002;9;10100;5188;4912
Kaunas county;2002;10;9980;5130;4850
Kaunas county;2002;11;9860;5038;4822
Kaunas county;2002;12;9512;4900;4612
Kaunas county;2002;13;9713;4954;4759
Kaunas county;2002;14;10344;5219;5125
Kaunas county;2002;15;10887;5571;5316
Kaunas county;2002;16;10519;5290;5229
Kaunas county;2002;17;10337;5249;5088
Kaunas county;2002;18;10097;5138;4959
Kaunas county;2002;19;10487;5159;5328
Kaunas county;2002;20;11083;5411;5672
Kaunas county;2002;21;10925;5383;5542
Kaunas county;2002;22;10364;5229;5135
Kaunas county;2002;23;9894;4889;5005
Kaunas county;2002;24;9647;4815;4832
Kaunas county;2002;25;9442;4671;4771
Kaunas county;2002;26;9470;4746;4724
Kaunas county;2002;27;9773;4842;4931
Kaunas county;2002;28;9709;4811;4898
Kaunas county;2002;29;10257;5041;5216
Kaunas county;2002;30;10431;5127;5304
Kaunas county;2002;31;10268;4988;5280
Kaunas county;2002;32;10058;4942;5116
Kaunas county;2002;33;10178;4929;5249
Kaunas county;2002;34;10165;4925;5240
Kaunas county;2002;35;10079;4866;5213
Kaunas county;2002;36;10073;4940;5133
Kaunas county;2002;37;10326;5017;5309
Kaunas county;2002;38;10286;4956;5330
Kaunas county;2002;39;11032;5248;5784
Kaunas county;2002;40;11233;5285;5948
Kaunas county;2002;41;10845;5099;5746
Kaunas county;2002;42;11089;5260;5829
Kaunas county;2002;43;10358;4881;5477
Kaunas county;2002;44;9911;4726;5185
Kaunas county;2002;45;9377;4318;5059
Kaunas county;2002;46;9144;4277;4867
Kaunas county;2002;47;8527;3901;4626
Kaunas county;2002;48;8228;3851;4377
Kaunas county;2002;49;8610;3915;4695
Kaunas county;2002;50;8592;3847;4745
Kaunas county;2002;51;8497;3811;4686
Kaunas county;2002;52;8348;3698;4650
Kaunas county;2002;53;7663;3463;4200
Kaunas county;2002;54;7263;3265;3998
Kaunas county;2002;55;6991;3126;3865
Kaunas county;2002;56;7799;3439;4360
Kaunas county;2002;57;6826;3026;3800
Kaunas county;2002;58;8003;3401;4602
Kaunas county;2002;59;8622;3664;4958
Kaunas county;2002;60;8020;3399;4621
Kaunas county;2002;61;7443;3169;4274
Kaunas county;2002;62;7315;3085;4230
Kaunas county;2002;63;7237;2942;4295
Kaunas county;2002;64;6958;2785;4173
Kaunas county;2002;65;6829;2805;4024
Kaunas county;2002;66;6592;2615;3977
Kaunas county;2002;67;6370;2478;3892
Kaunas county;2002;68;6559;2551;4008
Kaunas county;2002;69;6465;2460;4005
Kaunas county;2002;70;6155;2291;3864
Kaunas county;2002;71;6078;2307;3771
Kaunas county;2002;72;5604;2089;3515
Kaunas county;2002;73;5614;2056;3558
Kaunas county;2002;74;5164;1859;3305
Kaunas county;2002;75;4603;1299;3304
Kaunas county;2002;76;4250;1213;3037
Kaunas county;2002;77;3925;1133;2792
Kaunas county;2002;78;3599;1079;2520
Kaunas county;2002;79;3327;908;2419
Kaunas county;2002;80;2834;827;2007
Kaunas county;2002;81;2354;640;1714
Kaunas county;2002;82;1936;515;1421
Kaunas county;2002;83;1452;358;1094
Kaunas county;2002;84;1172;310;862
Kaunas county;2002;85;8024;2143;5881
Kaunas county;2003;-1;689787;318418;371369
Kaunas county;2003;0;5855;3041;2814
Kaunas county;2003;1;6142;3215;2927
Kaunas county;2003;2;6546;3396;3150
Kaunas county;2003;3;7106;3604;3502
Kaunas county;2003;4;7315;3852;3463
Kaunas county;2003;5;7513;3826;3687
Kaunas county;2003;6;7889;4011;3878
Kaunas county;2003;7;8179;4245;3934
Kaunas county;2003;8;7957;4050;3907
Kaunas county;2003;9;9065;4638;4427
Kaunas county;2003;10;10030;5163;4867
Kaunas county;2003;11;9904;5101;4803
Kaunas county;2003;12;9738;4976;4762
Kaunas county;2003;13;9368;4821;4547
Kaunas county;2003;14;9584;4860;4724
Kaunas county;2003;15;10176;5120;5056
Kaunas county;2003;16;10729;5494;5235
Kaunas county;2003;17;10341;5187;5154
Kaunas county;2003;18;10202;5174;5028
Kaunas county;2003;19;10021;5093;4928
Kaunas county;2003;20;10331;5077;5254
Kaunas county;2003;21;10912;5339;5573
Kaunas county;2003;22;10732;5285;5447
Kaunas county;2003;23;10235;5132;5103
Kaunas county;2003;24;9698;4790;4908
Kaunas county;2003;25;9492;4740;4752
Kaunas county;2003;26;9377;4643;4734
Kaunas county;2003;27;9367;4676;4691
Kaunas county;2003;28;9703;4782;4921
Kaunas county;2003;29;9585;4751;4834
Kaunas county;2003;30;10158;5002;5156
Kaunas county;2003;31;10356;5092;5264
Kaunas county;2003;32;10208;4971;5237
Kaunas county;2003;33;9964;4905;5059
Kaunas county;2003;34;10074;4894;5180
Kaunas county;2003;35;10017;4840;5177
Kaunas county;2003;36;9955;4813;5142
Kaunas county;2003;37;9976;4893;5083
Kaunas county;2003;38;10234;4977;5257
Kaunas county;2003;39;10193;4910;5283
Kaunas county;2003;40;10913;5194;5719
Kaunas county;2003;41;11130;5226;5904
Kaunas county;2003;42;10743;5043;5700
Kaunas county;2003;43;10986;5202;5784
Kaunas county;2003;44;10324;4875;5449
Kaunas county;2003;45;9787;4648;5139
Kaunas county;2003;46;9275;4256;5019
Kaunas county;2003;47;9059;4220;4839
Kaunas county;2003;48;8437;3840;4597
Kaunas county;2003;49;8158;3800;4358
Kaunas county;2003;50;8503;3851;4652
Kaunas county;2003;51;8454;3778;4676
Kaunas county;2003;52;8392;3741;4651
Kaunas county;2003;53;8321;3693;4628
Kaunas county;2003;54;7573;3394;4179
Kaunas county;2003;55;7163;3194;3969
Kaunas county;2003;56;6898;3068;3830
Kaunas county;2003;57;7674;3349;4325
Kaunas county;2003;58;6717;2939;3778
Kaunas county;2003;59;7877;3332;4545
Kaunas county;2003;60;8470;3562;4908
Kaunas county;2003;61;7882;3311;4571
Kaunas county;2003;62;7368;3128;4240
Kaunas county;2003;63;7213;3019;4194
Kaunas county;2003;64;7139;2866;4273
Kaunas county;2003;65;6861;2707;4154
Kaunas county;2003;66;6736;2741;3995
Kaunas county;2003;67;6510;2555;3955
Kaunas county;2003;68;6254;2395;3859
Kaunas county;2003;69;6403;2445;3958
Kaunas county;2003;70;6327;2384;3943
Kaunas county;2003;71;5967;2176;3791
Kaunas county;2003;72;5911;2205;3706
Kaunas county;2003;73;5409;1975;3434
Kaunas county;2003;74;5423;1938;3485
Kaunas county;2003;75;4953;1734;3219
Kaunas county;2003;76;4408;1217;3191
Kaunas county;2003;77;4080;1130;2950
Kaunas county;2003;78;3768;1052;2716
Kaunas county;2003;79;3396;982;2414
Kaunas county;2003;80;3092;821;2271
Kaunas county;2003;81;2638;752;1886
Kaunas county;2003;82;2201;573;1628
Kaunas county;2003;83;1783;455;1328
Kaunas county;2003;84;1324;306;1018
Kaunas county;2003;85;7660;1967;5693
Kaunas county;2004;-1;682074;314618;367456
Kaunas county;2004;0;5908;2990;2918
Kaunas county;2004;1;5815;3017;2798
Kaunas county;2004;2;6109;3190;2919
Kaunas county;2004;3;6495;3366;3129
Kaunas county;2004;4;7072;3592;3480
Kaunas county;2004;5;7283;3832;3451
Kaunas county;2004;6;7473;3804;3669
Kaunas county;2004;7;7855;3990;3865
Kaunas county;2004;8;8132;4227;3905
Kaunas county;2004;9;7926;4029;3897
Kaunas county;2004;10;9024;4620;4404
Kaunas county;2004;11;9953;5150;4803
Kaunas county;2004;12;9792;5042;4750
Kaunas county;2004;13;9592;4908;4684
Kaunas county;2004;14;9199;4737;4462
Kaunas county;2004;15;9441;4804;4637
Kaunas county;2004;16;10011;5053;4958
Kaunas county;2004;17;10546;5411;5135
Kaunas county;2004;18;10149;5103;5046
Kaunas county;2004;19;10023;5092;4931
Kaunas county;2004;20;9870;5014;4856
Kaunas county;2004;21;10124;4986;5138
Kaunas county;2004;22;10725;5238;5487
Kaunas county;2004;23;10417;5123;5294
Kaunas county;2004;24;9930;4984;4946
Kaunas county;2004;25;9341;4630;4711
Kaunas county;2004;26;9268;4606;4662
Kaunas county;2004;27;9219;4557;4662
Kaunas county;2004;28;9260;4620;4640
Kaunas county;2004;29;9578;4715;4863
Kaunas county;2004;30;9403;4654;4749
Kaunas county;2004;31;9994;4925;5069
Kaunas county;2004;32;10182;4996;5186
Kaunas county;2004;33;10033;4876;5157
Kaunas county;2004;34;9824;4848;4976
Kaunas county;2004;35;9911;4817;5094
Kaunas county;2004;36;9867;4777;5090
Kaunas county;2004;37;9785;4738;5047
Kaunas county;2004;38;9780;4799;4981
Kaunas county;2004;39;10064;4911;5153
Kaunas county;2004;40;10023;4833;5190
Kaunas county;2004;41;10746;5125;5621
Kaunas county;2004;42;10943;5131;5812
Kaunas county;2004;43;10638;5003;5635
Kaunas county;2004;44;10819;5100;5719
Kaunas county;2004;45;10213;4828;5385
Kaunas county;2004;46;9672;4583;5089
Kaunas county;2004;47;9143;4182;4961
Kaunas county;2004;48;8936;4153;4783
Kaunas county;2004;49;8337;3774;4563
Kaunas county;2004;50;8025;3732;4293
Kaunas county;2004;51;8353;3775;4578
Kaunas county;2004;52;8295;3696;4599
Kaunas county;2004;53;8243;3655;4588
Kaunas county;2004;54;8225;3650;4575
Kaunas county;2004;55;7464;3335;4129
Kaunas county;2004;56;7035;3105;3930
Kaunas county;2004;57;6785;3000;3785
Kaunas county;2004;58;7548;3267;4281
Kaunas county;2004;59;6585;2858;3727
Kaunas county;2004;60;7704;3230;4474
Kaunas county;2004;61;8313;3453;4860
Kaunas county;2004;62;7738;3219;4519
Kaunas county;2004;63;7271;3061;4210
Kaunas county;2004;64;7071;2917;4154
Kaunas county;2004;65;7053;2797;4256
Kaunas county;2004;66;6726;2607;4119
Kaunas county;2004;67;6601;2628;3973
Kaunas county;2004;68;6386;2454;3932
Kaunas county;2004;69;6141;2321;3820
Kaunas county;2004;70;6248;2354;3894
Kaunas county;2004;71;6211;2305;3906
Kaunas county;2004;72;5802;2073;3729
Kaunas county;2004;73;5747;2110;3637
Kaunas county;2004;74;5223;1855;3368
Kaunas county;2004;75;5215;1808;3407
Kaunas county;2004;76;4758;1628;3130
Kaunas county;2004;77;4208;1125;3083
Kaunas county;2004;78;3897;1038;2859
Kaunas county;2004;79;3563;955;2608
Kaunas county;2004;80;3179;898;2281
Kaunas county;2004;81;2907;749;2158
Kaunas county;2004;82;2451;677;1774
Kaunas county;2004;83;2037;518;1519
Kaunas county;2004;84;1639;404;1235
Kaunas county;2004;85;7584;1878;5706
Kaunas county;2005;-1;671923;309962;361961
Kaunas county;2005;0;5834;2993;2841
Kaunas county;2005;1;5860;2966;2894
Kaunas county;2005;2;5779;3000;2779
Kaunas county;2005;3;6042;3165;2877
Kaunas county;2005;4;6430;3337;3093
Kaunas county;2005;5;7005;3560;3445
Kaunas county;2005;6;7211;3801;3410
Kaunas county;2005;7;7398;3768;3630
Kaunas county;2005;8;7800;3967;3833
Kaunas county;2005;9;8065;4199;3866
Kaunas county;2005;10;7894;4013;3881
Kaunas county;2005;11;8937;4570;4367
Kaunas county;2005;12;9842;5103;4739
Kaunas county;2005;13;9695;5002;4693
Kaunas county;2005;14;9455;4837;4618
Kaunas county;2005;15;9053;4663;4390
Kaunas county;2005;16;9248;4710;4538
Kaunas county;2005;17;9821;4957;4864
Kaunas county;2005;18;10298;5284;5014
Kaunas county;2005;19;9902;4981;4921
Kaunas county;2005;20;9814;4984;4830
Kaunas county;2005;21;9616;4883;4733
Kaunas county;2005;22;9869;4870;4999
Kaunas county;2005;23;10436;5120;5316
Kaunas county;2005;24;10100;4970;5130
Kaunas county;2005;25;9445;4798;4647
Kaunas county;2005;26;9104;4506;4598
Kaunas county;2005;27;9078;4493;4585
Kaunas county;2005;28;9103;4503;4600
Kaunas county;2005;29;9123;4550;4573
Kaunas county;2005;30;9402;4654;4748
Kaunas county;2005;31;9178;4538;4640
Kaunas county;2005;32;9751;4785;4966
Kaunas county;2005;33;10023;4912;5111
Kaunas county;2005;34;9827;4761;5066
Kaunas county;2005;35;9624;4749;4875
Kaunas county;2005;36;9711;4716;4995
Kaunas county;2005;37;9689;4685;5004
Kaunas county;2005;38;9606;4638;4968
Kaunas county;2005;39;9588;4708;4880
Kaunas county;2005;40;9871;4812;5059
Kaunas county;2005;41;9830;4727;5103
Kaunas county;2005;42;10556;5013;5543
Kaunas county;2005;43;10772;5045;5727
Kaunas county;2005;44;10494;4940;5554
Kaunas county;2005;45;10593;4983;5610
Kaunas county;2005;46;10073;4756;5317
Kaunas county;2005;47;9536;4495;5041
Kaunas county;2005;48;8953;4081;4872
Kaunas county;2005;49;8805;4071;4734
Kaunas county;2005;50;8220;3720;4500
Kaunas county;2005;51;7878;3650;4228
Kaunas county;2005;52;8199;3698;4501
Kaunas county;2005;53;8148;3618;4530
Kaunas county;2005;54;8113;3591;4522
Kaunas county;2005;55;8074;3561;4513
Kaunas county;2005;56;7337;3251;4086
Kaunas county;2005;57;6935;3045;3890
Kaunas county;2005;58;6645;2926;3719
Kaunas county;2005;59;7424;3198;4226
Kaunas county;2005;60;6482;2792;3690
Kaunas county;2005;61;7551;3131;4420
Kaunas county;2005;62;8114;3335;4779
Kaunas county;2005;63;7545;3100;4445
Kaunas county;2005;64;7122;2966;4156
Kaunas county;2005;65;6935;2837;4098
Kaunas county;2005;66;6907;2713;4194
Kaunas county;2005;67;6566;2515;4051
Kaunas county;2005;68;6436;2537;3899
Kaunas county;2005;69;6197;2344;3853
Kaunas county;2005;70;5964;2217;3747
Kaunas county;2005;71;6061;2233;3828
Kaunas county;2005;72;5985;2183;3802
Kaunas county;2005;73;5580;1947;3633
Kaunas county;2005;74;5510;1982;3528
Kaunas county;2005;75;5023;1753;3270
Kaunas county;2005;76;4972;1702;3270
Kaunas county;2005;77;4541;1512;3029
Kaunas county;2005;78;3991;1044;2947
Kaunas county;2005;79;3688;962;2726
Kaunas county;2005;80;3347;888;2459
Kaunas county;2005;81;2916;800;2116
Kaunas county;2005;82;2636;654;1982
Kaunas county;2005;83;2232;609;1623
Kaunas county;2005;84;1826;455;1371
Kaunas county;2005;85;7684;1871;5813
Kaunas county;2006;-1;658100;303285;354815
Kaunas county;2006;0;5823;2984;2839
Kaunas county;2006;1;5752;2957;2795
Kaunas county;2006;2;5760;2922;2838
Kaunas county;2006;3;5679;2954;2725
Kaunas county;2006;4;5937;3117;2820
Kaunas county;2006;5;6340;3277;3063
Kaunas county;2006;6;6895;3514;3381
Kaunas county;2006;7;7142;3757;3385
Kaunas county;2006;8;7319;3736;3583
Kaunas county;2006;9;7727;3939;3788
Kaunas county;2006;10;7978;4163;3815
Kaunas county;2006;11;7813;3977;3836
Kaunas county;2006;12;8849;4531;4318
Kaunas county;2006;13;9629;4989;4640
Kaunas county;2006;14;9538;4928;4610
Kaunas county;2006;15;9181;4705;4476
Kaunas county;2006;16;8762;4503;4259
Kaunas county;2006;17;8984;4554;4430
Kaunas county;2006;18;9477;4776;4701
Kaunas county;2006;19;9827;5026;4801
Kaunas county;2006;20;9453;4742;4711
Kaunas county;2006;21;9302;4730;4572
Kaunas county;2006;22;9159;4678;4481
Kaunas county;2006;23;9492;4667;4825
Kaunas county;2006;24;9981;4901;5080
Kaunas county;2006;25;9472;4664;4808
Kaunas county;2006;26;9048;4584;4464
Kaunas county;2006;27;8803;4366;4437
Kaunas county;2006;28;8859;4387;4472
Kaunas county;2006;29;8909;4420;4489
Kaunas county;2006;30;8938;4458;4480
Kaunas county;2006;31;9189;4551;4638
Kaunas county;2006;32;8936;4409;4527
Kaunas county;2006;33;9476;4651;4825
Kaunas county;2006;34;9742;4769;4973
Kaunas county;2006;35;9563;4624;4939
Kaunas county;2006;36;9391;4616;4775
Kaunas county;2006;37;9440;4573;4867
Kaunas county;2006;38;9442;4546;4896
Kaunas county;2006;39;9365;4503;4862
Kaunas county;2006;40;9355;4568;4787
Kaunas county;2006;41;9640;4678;4962
Kaunas county;2006;42;9608;4599;5009
Kaunas county;2006;43;10326;4886;5440
Kaunas county;2006;44;10584;4949;5635
Kaunas county;2006;45;10324;4861;5463
Kaunas county;2006;46;10377;4883;5494
Kaunas county;2006;47;9947;4666;5281
Kaunas county;2006;48;9380;4407;4973
Kaunas county;2006;49;8774;3993;4781
Kaunas county;2006;50;8651;3989;4662
Kaunas county;2006;51;8088;3649;4439
Kaunas county;2006;52;7731;3563;4168
Kaunas county;2006;53;8006;3592;4414
Kaunas county;2006;54;7987;3534;4453
Kaunas county;2006;55;7956;3513;4443
Kaunas county;2006;56;7942;3474;4468
Kaunas county;2006;57;7214;3164;4050
Kaunas county;2006;58;6810;2962;3848
Kaunas county;2006;59;6528;2869;3659
Kaunas county;2006;60;7266;3106;4160
Kaunas county;2006;61;6330;2700;3630
Kaunas county;2006;62;7372;3025;4347
Kaunas county;2006;63;7915;3220;4695
Kaunas county;2006;64;7345;2973;4372
Kaunas county;2006;65;6960;2871;4089
Kaunas county;2006;66;6759;2737;4022
Kaunas county;2006;67;6729;2608;4121
Kaunas county;2006;68;6385;2409;3976
Kaunas county;2006;69;6251;2430;3821
Kaunas county;2006;70;5990;2243;3747
Kaunas county;2006;71;5766;2115;3651
Kaunas county;2006;72;5820;2098;3722
Kaunas county;2006;73;5754;2060;3694
Kaunas county;2006;74;5387;1854;3533
Kaunas county;2006;75;5271;1865;3406
Kaunas county;2006;76;4823;1653;3170
Kaunas county;2006;77;4719;1598;3121
Kaunas county;2006;78;4297;1407;2890
Kaunas county;2006;79;3774;969;2805
Kaunas county;2006;80;3429;873;2556
Kaunas county;2006;81;3090;802;2288
Kaunas county;2006;82;2690;720;1970
Kaunas county;2006;83;2406;580;1826
Kaunas county;2006;84;2033;542;1491
Kaunas county;2006;85;7939;1880;6059
Kaunas county;2007;-1;650408;299244;351164
Kaunas county;2007;0;5670;2918;2752
Kaunas county;2007;1;5793;2969;2824
Kaunas county;2007;2;5672;2913;2759
Kaunas county;2007;3;5711;2895;2816
Kaunas county;2007;4;5636;2933;2703
Kaunas county;2007;5;5892;3099;2793
Kaunas county;2007;6;6318;3266;3052
Kaunas county;2007;7;6871;3500;3371
Kaunas county;2007;8;7110;3747;3363
Kaunas county;2007;9;7304;3731;3573
Kaunas county;2007;10;7693;3919;3774
Kaunas county;2007;11;7947;4152;3795
Kaunas county;2007;12;7778;3957;3821
Kaunas county;2007;13;8834;4516;4318
Kaunas county;2007;14;9572;4974;4598
Kaunas county;2007;15;9459;4895;4564
Kaunas county;2007;16;9063;4646;4417
Kaunas county;2007;17;8621;4436;4185
Kaunas county;2007;18;8850;4489;4361
Kaunas county;2007;19;9304;4685;4619
Kaunas county;2007;20;9615;4904;4711
Kaunas county;2007;21;9226;4616;4610
Kaunas county;2007;22;9082;4586;4496
Kaunas county;2007;23;8944;4529;4415
Kaunas county;2007;24;9286;4516;4770
Kaunas county;2007;25;9672;4730;4942
Kaunas county;2007;26;9259;4557;4702
Kaunas county;2007;27;8911;4478;4433
Kaunas county;2007;28;8717;4311;4406
Kaunas county;2007;29;8741;4308;4433
Kaunas county;2007;30;8794;4356;4438
Kaunas county;2007;31;8856;4417;4439
Kaunas county;2007;32;9079;4482;4597
Kaunas county;2007;33;8867;4368;4499
Kaunas county;2007;34;9359;4581;4778
Kaunas county;2007;35;9643;4705;4938
Kaunas county;2007;36;9454;4576;4878
Kaunas county;2007;37;9267;4548;4719
Kaunas county;2007;38;9309;4497;4812
Kaunas county;2007;39;9330;4485;4845
Kaunas county;2007;40;9206;4428;4778
Kaunas county;2007;41;9230;4506;4724
Kaunas county;2007;42;9487;4590;4897
Kaunas county;2007;43;9477;4523;4954
Kaunas county;2007;44;10164;4789;5375
Kaunas county;2007;45;10415;4865;5550
Kaunas county;2007;46;10176;4759;5417
Kaunas county;2007;47;10209;4797;5412
Kaunas county;2007;48;9872;4624;5248
Kaunas county;2007;49;9299;4349;4950
Kaunas county;2007;50;8655;3920;4735
Kaunas county;2007;51;8508;3893;4615
Kaunas county;2007;52;7999;3597;4402
Kaunas county;2007;53;7591;3482;4109
Kaunas county;2007;54;7892;3519;4373
Kaunas county;2007;55;7857;3453;4404
Kaunas county;2007;56;7840;3438;4402
Kaunas county;2007;57;7814;3397;4417
Kaunas county;2007;58;7094;3081;4013
Kaunas county;2007;59;6694;2882;3812
Kaunas county;2007;60;6388;2774;3614
Kaunas county;2007;61;7114;3008;4106
Kaunas county;2007;62;6195;2613;3582
Kaunas county;2007;63;7206;2907;4299
Kaunas county;2007;64;7712;3095;4617
Kaunas county;2007;65;7164;2857;4307
Kaunas county;2007;66;6799;2773;4026
Kaunas county;2007;67;6579;2609;3970
Kaunas county;2007;68;6538;2486;4052
Kaunas county;2007;69;6232;2310;3922
Kaunas county;2007;70;6071;2330;3741
Kaunas county;2007;71;5806;2130;3676
Kaunas county;2007;72;5568;1992;3576
Kaunas county;2007;73;5626;1988;3638
Kaunas county;2007;74;5539;1940;3599
Kaunas county;2007;75;5170;1734;3436
Kaunas county;2007;76;5036;1751;3285
Kaunas county;2007;77;4615;1548;3067
Kaunas county;2007;78;4459;1478;2981
Kaunas county;2007;79;4005;1284;2721
Kaunas county;2007;80;3551;881;2670
Kaunas county;2007;81;3188;793;2395
Kaunas county;2007;82;2854;725;2129
Kaunas county;2007;83;2454;644;1810
Kaunas county;2007;84;2182;512;1670
Kaunas county;2007;85;8369;2000;6369
Kaunas county;2008;-1;643358;295754;347604
Kaunas county;2008;0;5914;3071;2843
Kaunas county;2008;1;5617;2890;2727
Kaunas county;2008;2;5741;2940;2801
Kaunas county;2008;3;5607;2879;2728
Kaunas county;2008;4;5685;2883;2802
Kaunas county;2008;5;5612;2919;2693
Kaunas county;2008;6;5853;3077;2776
Kaunas county;2008;7;6270;3235;3035
Kaunas county;2008;8;6832;3486;3346
Kaunas county;2008;9;7091;3741;3350
Kaunas county;2008;10;7274;3723;3551
Kaunas county;2008;11;7666;3906;3760
Kaunas county;2008;12;7899;4131;3768
Kaunas county;2008;13;7745;3942;3803
Kaunas county;2008;14;8760;4480;4280
Kaunas county;2008;15;9507;4945;4562
Kaunas county;2008;16;9388;4863;4525
Kaunas county;2008;17;8959;4607;4352
Kaunas county;2008;18;8505;4377;4128
Kaunas county;2008;19;8701;4416;4285
Kaunas county;2008;20;9165;4622;4543
Kaunas county;2008;21;9465;4820;4645
Kaunas county;2008;22;9040;4523;4517
Kaunas county;2008;23;8929;4499;4430
Kaunas county;2008;24;8814;4427;4387
Kaunas county;2008;25;9131;4421;4710
Kaunas county;2008;26;9512;4637;4875
Kaunas county;2008;27;9092;4461;4631
Kaunas county;2008;28;8761;4405;4356
Kaunas county;2008;29;8592;4263;4329
Kaunas county;2008;30;8669;4269;4400
Kaunas county;2008;31;8668;4285;4383
Kaunas county;2008;32;8792;4377;4415
Kaunas county;2008;33;8974;4419;4555
Kaunas county;2008;34;8775;4327;4448
Kaunas county;2008;35;9240;4509;4731
Kaunas county;2008;36;9516;4634;4882
Kaunas county;2008;37;9295;4496;4799
Kaunas county;2008;38;9146;4498;4648
Kaunas county;2008;39;9169;4422;4747
Kaunas county;2008;40;9176;4394;4782
Kaunas county;2008;41;9072;4345;4727
Kaunas county;2008;42;9114;4444;4670
Kaunas county;2008;43;9375;4527;4848
Kaunas county;2008;44;9313;4433;4880
Kaunas county;2008;45;9968;4688;5280
Kaunas county;2008;46;10254;4782;5472
Kaunas county;2008;47;10058;4683;5375
Kaunas county;2008;48;10097;4731;5366
Kaunas county;2008;49;9772;4559;5213
Kaunas county;2008;50;9164;4265;4899
Kaunas county;2008;51;8528;3839;4689
Kaunas county;2008;52;8395;3825;4570
Kaunas county;2008;53;7874;3517;4357
Kaunas county;2008;54;7452;3394;4058
Kaunas county;2008;55;7762;3436;4326
Kaunas county;2008;56;7709;3368;4341
Kaunas county;2008;57;7693;3348;4345
Kaunas county;2008;58;7661;3290;4371
Kaunas county;2008;59;6972;3003;3969
Kaunas county;2008;60;6559;2799;3760
Kaunas county;2008;61;6268;2695;3573
Kaunas county;2008;62;6970;2915;4055
Kaunas county;2008;63;6075;2525;3550
Kaunas county;2008;64;7018;2784;4234
Kaunas county;2008;65;7531;2984;4547
Kaunas county;2008;66;6964;2713;4251
Kaunas county;2008;67;6608;2647;3961
Kaunas county;2008;68;6405;2499;3906
Kaunas county;2008;69;6376;2400;3976
Kaunas county;2008;70;6070;2199;3871
Kaunas county;2008;71;5887;2234;3653
Kaunas county;2008;72;5623;2024;3599
Kaunas county;2008;73;5385;1893;3492
Kaunas county;2008;74;5426;1873;3553
Kaunas county;2008;75;5321;1832;3489
Kaunas county;2008;76;4951;1625;3326
Kaunas county;2008;77;4790;1623;3167
Kaunas county;2008;78;4353;1429;2924
Kaunas county;2008;79;4196;1346;2850
Kaunas county;2008;80;3746;1176;2570
Kaunas county;2008;81;3340;802;2538
Kaunas county;2008;82;2933;716;2217
Kaunas county;2008;83;2589;653;1936
Kaunas county;2008;84;2239;568;1671
Kaunas county;2008;85;8955;2104;6851
Kaunas county;2009;-1;638385;293189;345196
Kaunas county;2009;0;6304;3235;3069
Kaunas county;2009;1;5862;3042;2820
Kaunas county;2009;2;5574;2872;2702
Kaunas county;2009;3;5703;2924;2779
Kaunas county;2009;4;5582;2868;2714
Kaunas county;2009;5;5652;2864;2788
Kaunas county;2009;6;5584;2904;2680
Kaunas county;2009;7;5814;3055;2759
Kaunas county;2009;8;6253;3222;3031
Kaunas county;2009;9;6796;3461;3335
Kaunas county;2009;10;7065;3727;3338
Kaunas county;2009;11;7258;3718;3540
Kaunas county;2009;12;7629;3887;3742
Kaunas county;2009;13;7858;4117;3741
Kaunas county;2009;14;7725;3927;3798
Kaunas county;2009;15;8722;4469;4253
Kaunas county;2009;16;9453;4912;4541
Kaunas county;2009;17;9340;4836;4504
Kaunas county;2009;18;8907;4569;4338
Kaunas county;2009;19;8427;4319;4108
Kaunas county;2009;20;8584;4345;4239
Kaunas county;2009;21;9031;4544;4487
Kaunas county;2009;22;9325;4735;4590
Kaunas county;2009;23;8913;4443;4470
Kaunas county;2009;24;8835;4457;4378
Kaunas county;2009;25;8713;4352;4361
Kaunas county;2009;26;9016;4360;4656
Kaunas county;2009;27;9358;4557;4801
Kaunas county;2009;28;8971;4397;4574
Kaunas county;2009;29;8646;4341;4305
Kaunas county;2009;30;8538;4231;4307
Kaunas county;2009;31;8600;4225;4375
Kaunas county;2009;32;8557;4247;4310
Kaunas county;2009;33;8671;4317;4354
Kaunas county;2009;34;8906;4380;4526
Kaunas county;2009;35;8635;4281;4354
Kaunas county;2009;36;9123;4468;4655
Kaunas county;2009;37;9446;4600;4846
Kaunas county;2009;38;9234;4467;4767
Kaunas county;2009;39;9061;4450;4611
Kaunas county;2009;40;9086;4374;4712
Kaunas county;2009;41;9096;4353;4743
Kaunas county;2009;42;8993;4308;4685
Kaunas county;2009;43;9022;4381;4641
Kaunas county;2009;44;9283;4474;4809
Kaunas county;2009;45;9207;4378;4829
Kaunas county;2009;46;9880;4634;5246
Kaunas county;2009;47;10147;4710;5437
Kaunas county;2009;48;9927;4604;5323
Kaunas county;2009;49;10024;4678;5346
Kaunas county;2009;50;9659;4479;5180
Kaunas county;2009;51;9063;4194;4869
Kaunas county;2009;52;8444;3785;4659
Kaunas county;2009;53;8295;3754;4541
Kaunas county;2009;54;7741;3425;4316
Kaunas county;2009;55;7330;3312;4018
Kaunas county;2009;56;7645;3365;4280
Kaunas county;2009;57;7616;3301;4315
Kaunas county;2009;58;7557;3247;4310
Kaunas county;2009;59;7528;3200;4328
Kaunas county;2009;60;6853;2922;3931
Kaunas county;2009;61;6446;2708;3738
Kaunas county;2009;62;6159;2625;3534
Kaunas county;2009;63;6833;2828;4005
Kaunas county;2009;64;5926;2418;3508
Kaunas county;2009;65;6888;2699;4189
Kaunas county;2009;66;7366;2873;4493
Kaunas county;2009;67;6800;2612;4188
Kaunas county;2009;68;6459;2555;3904
Kaunas county;2009;69;6254;2407;3847
Kaunas county;2009;70;6205;2308;3897
Kaunas county;2009;71;5914;2103;3811
Kaunas county;2009;72;5722;2132;3590
Kaunas county;2009;73;5445;1901;3544
Kaunas county;2009;74;5175;1777;3398
Kaunas county;2009;75;5249;1766;3483
Kaunas county;2009;76;5078;1701;3377
Kaunas county;2009;77;4685;1500;3185
Kaunas county;2009;78;4561;1517;3044
Kaunas county;2009;79;4134;1344;2790
Kaunas county;2009;80;3947;1237;2710
Kaunas county;2009;81;3490;1076;2414
Kaunas county;2009;82;3091;728;2363
Kaunas county;2009;83;2666;631;2035
Kaunas county;2009;84;2353;575;1778
Kaunas county;2009;85;9472;2165;7307
Kaunas county;2010;-1;629896;288338;341558
Kaunas county;2010;0;6393;3281;3112
Kaunas county;2010;1;6206;3181;3025
Kaunas county;2010;2;5784;2990;2794
Kaunas county;2010;3;5497;2835;2662
Kaunas county;2010;4;5608;2871;2737
Kaunas county;2010;5;5500;2813;2687
Kaunas county;2010;6;5595;2827;2768
Kaunas county;2010;7;5538;2871;2667
Kaunas county;2010;8;5795;3047;2748
Kaunas county;2010;9;6200;3200;3000
Kaunas county;2010;10;6740;3431;3309
Kaunas county;2010;11;7016;3690;3326
Kaunas county;2010;12;7211;3692;3519
Kaunas county;2010;13;7553;3839;3714
Kaunas county;2010;14;7808;4083;3725
Kaunas county;2010;15;7666;3896;3770
Kaunas county;2010;16;8634;4420;4214
Kaunas county;2010;17;9389;4868;4521
Kaunas county;2010;18;9242;4773;4469
Kaunas county;2010;19;8764;4482;4282
Kaunas county;2010;20;8264;4217;4047
Kaunas county;2010;21;8375;4226;4149
Kaunas county;2010;22;8746;4374;4372
Kaunas county;2010;23;9017;4557;4460
Kaunas county;2010;24;8655;4282;4373
Kaunas county;2010;25;8587;4299;4288
Kaunas county;2010;26;8419;4176;4243
Kaunas county;2010;27;8761;4208;4553
Kaunas county;2010;28;9126;4427;4699
Kaunas county;2010;29;8756;4282;4474
Kaunas county;2010;30;8484;4258;4226
Kaunas county;2010;31;8370;4135;4235
Kaunas county;2010;32;8434;4131;4303
Kaunas county;2010;33;8382;4149;4233
Kaunas county;2010;34;8496;4237;4259
Kaunas county;2010;35;8703;4261;4442
Kaunas county;2010;36;8431;4162;4269
Kaunas county;2010;37;8891;4320;4571
Kaunas county;2010;38;9290;4502;4788
Kaunas county;2010;39;9096;4372;4724
Kaunas county;2010;40;8921;4344;4577
Kaunas county;2010;41;8945;4290;4655
Kaunas county;2010;42;8960;4248;4712
Kaunas county;2010;43;8847;4216;4631
Kaunas county;2010;44;8865;4273;4592
Kaunas county;2010;45;9101;4363;4738
Kaunas county;2010;46;9074;4291;4783
Kaunas county;2010;47;9735;4537;5198
Kaunas county;2010;48;10006;4625;5381
Kaunas county;2010;49;9787;4518;5269
Kaunas county;2010;50;9879;4581;5298
Kaunas county;2010;51;9522;4377;5145
Kaunas county;2010;52;8948;4108;4840
Kaunas county;2010;53;8321;3697;4624
Kaunas county;2010;54;8181;3682;4499
Kaunas county;2010;55;7617;3353;4264
Kaunas county;2010;56;7186;3209;3977
Kaunas county;2010;57;7528;3280;4248
Kaunas county;2010;58;7483;3212;4271
Kaunas county;2010;59;7425;3160;4265
Kaunas county;2010;60;7382;3105;4277
Kaunas county;2010;61;6709;2837;3872
Kaunas county;2010;62;6297;2609;3688
Kaunas county;2010;63;6036;2542;3494
Kaunas county;2010;64;6676;2738;3938
Kaunas county;2010;65;5792;2320;3472
Kaunas county;2010;66;6753;2601;4152
Kaunas county;2010;67;7212;2776;4436
Kaunas county;2010;68;6602;2495;4107
Kaunas county;2010;69;6293;2446;3847
Kaunas county;2010;70;6072;2295;3777
Kaunas county;2010;71;6044;2220;3824
Kaunas county;2010;72;5738;2001;3737
Kaunas county;2010;73;5538;2029;3509
Kaunas county;2010;74;5237;1789;3448
Kaunas county;2010;75;4993;1666;3327
Kaunas county;2010;76;5040;1653;3387
Kaunas county;2010;77;4844;1600;3244
Kaunas county;2010;78;4478;1406;3072
Kaunas county;2010;79;4285;1378;2907
Kaunas county;2010;80;3897;1239;2658
Kaunas county;2010;81;3694;1141;2553
Kaunas county;2010;82;3224;972;2252
Kaunas county;2010;83;2828;628;2200
Kaunas county;2010;84;2428;559;1869
Kaunas county;2010;85;10051;2264;7787
Kaunas county;2011;-1;610225;278856;331369
Kaunas county;2011;0;6366;3327;3039
Kaunas county;2011;1;6505;3280;3225
Kaunas county;2011;2;6027;3089;2938
Kaunas county;2011;3;5672;2919;2753
Kaunas county;2011;4;5388;2786;2602
Kaunas county;2011;5;5548;2815;2733
Kaunas county;2011;6;5357;2739;2618
Kaunas county;2011;7;5439;2755;2684
Kaunas county;2011;8;5388;2742;2646
Kaunas county;2011;9;5609;2942;2667
Kaunas county;2011;10;6078;3107;2971
Kaunas county;2011;11;6579;3355;3224
Kaunas county;2011;12;6766;3546;3220
Kaunas county;2011;13;6945;3542;3403
Kaunas county;2011;14;7303;3726;3577
Kaunas county;2011;15;7553;3915;3638
Kaunas county;2011;16;7498;3805;3693
Kaunas county;2011;17;8409;4310;4099
Kaunas county;2011;18;9273;4799;4474
Kaunas county;2011;19;9476;4898;4578
Kaunas county;2011;20;9377;4798;4579
Kaunas county;2011;21;8798;4428;4370
Kaunas county;2011;22;8721;4366;4355
Kaunas county;2011;23;9026;4529;4497
Kaunas county;2011;24;9040;4709;4331
Kaunas county;2011;25;8539;4214;4325
Kaunas county;2011;26;8361;4221;4140
Kaunas county;2011;27;8169;4138;4031
Kaunas county;2011;28;7626;3796;3830
Kaunas county;2011;29;7507;3840;3667
Kaunas county;2011;30;7381;3731;3650
Kaunas county;2011;31;7426;3784;3642
Kaunas county;2011;32;7507;3735;3772
Kaunas county;2011;33;7673;3778;3895
Kaunas county;2011;34;7648;3795;3853
Kaunas county;2011;35;7787;3788;3999
Kaunas county;2011;36;7879;3788;4091
Kaunas county;2011;37;7742;3791;3951
Kaunas county;2011;38;8214;3937;4277
Kaunas county;2011;39;8778;4278;4500
Kaunas county;2011;40;8674;4221;4453
Kaunas county;2011;41;8413;4110;4303
Kaunas county;2011;42;8525;4027;4498
Kaunas county;2011;43;8527;3996;4531
Kaunas county;2011;44;8458;3977;4481
Kaunas county;2011;45;8458;4074;4384
Kaunas county;2011;46;8646;4100;4546
Kaunas county;2011;47;8682;4077;4605
Kaunas county;2011;48;9312;4308;5004
Kaunas county;2011;49;9688;4463;5225
Kaunas county;2011;50;9539;4380;5159
Kaunas county;2011;51;9540;4376;5164
Kaunas county;2011;52;9273;4217;5056
Kaunas county;2011;53;8685;3973;4712
Kaunas county;2011;54;7935;3499;4436
Kaunas county;2011;55;7842;3564;4278
Kaunas county;2011;56;7406;3245;4161
Kaunas county;2011;57;6921;3077;3844
Kaunas county;2011;58;7217;3071;4146
Kaunas county;2011;59;7256;3077;4179
Kaunas county;2011;60;7237;3035;4202
Kaunas county;2011;61;7361;3082;4279
Kaunas county;2011;62;6540;2706;3834
Kaunas county;2011;63;6001;2411;3590
Kaunas county;2011;64;5769;2376;3393
Kaunas county;2011;65;6450;2606;3844
Kaunas county;2011;66;5544;2183;3361
Kaunas county;2011;67;6489;2439;4050
Kaunas county;2011;68;6934;2612;4322
Kaunas county;2011;69;6493;2410;4083
Kaunas county;2011;70;6137;2328;3809
Kaunas county;2011;71;5949;2224;3725
Kaunas county;2011;72;5923;2139;3784
Kaunas county;2011;73;5586;1902;3684
Kaunas county;2011;74;5392;1918;3474
Kaunas county;2011;75;5066;1690;3376
Kaunas county;2011;76;4734;1520;3214
Kaunas county;2011;77;4823;1542;3281
Kaunas county;2011;78;4667;1512;3155
Kaunas county;2011;79;4320;1329;2991
Kaunas county;2011;80;4063;1277;2786
Kaunas county;2011;81;3671;1132;2539
Kaunas county;2011;82;3437;1016;2421
Kaunas county;2011;83;3005;863;2142
Kaunas county;2011;84;2634;571;2063
Kaunas county;2011;85;10625;2360;8265
Kaunas county;2012;-1;599638;273584;326054
Kaunas county;2012;0;6004;3071;2933
Kaunas county;2012;1;6355;3329;3026
Kaunas county;2012;2;6412;3221;3191
Kaunas county;2012;3;5865;3003;2862
Kaunas county;2012;4;5586;2888;2698
Kaunas county;2012;5;5300;2748;2552
Kaunas county;2012;6;5455;2762;2693
Kaunas county;2012;7;5273;2708;2565
Kaunas county;2012;8;5373;2728;2645
Kaunas county;2012;9;5329;2720;2609
Kaunas county;2012;10;5554;2915;2639
Kaunas county;2012;11;5987;3060;2927
Kaunas county;2012;12;6489;3301;3188
Kaunas county;2012;13;6686;3504;3182
Kaunas county;2012;14;6880;3509;3371
Kaunas county;2012;15;7234;3693;3541
Kaunas county;2012;16;7505;3885;3620
Kaunas county;2012;17;7437;3772;3665
Kaunas county;2012;18;8289;4242;4047
Kaunas county;2012;19;8964;4673;4291
Kaunas county;2012;20;9292;4804;4488
Kaunas county;2012;21;9136;4666;4470
Kaunas county;2012;22;8487;4284;4203
Kaunas county;2012;23;8327;4182;4145
Kaunas county;2012;24;8641;4350;4291
Kaunas county;2012;25;8634;4509;4125
Kaunas county;2012;26;8126;3985;4141
Kaunas county;2012;27;8004;4017;3987
Kaunas county;2012;28;7922;3997;3925
Kaunas county;2012;29;7357;3661;3696
Kaunas county;2012;30;7240;3684;3556
Kaunas county;2012;31;7161;3601;3560
Kaunas county;2012;32;7190;3654;3536
Kaunas county;2012;33;7273;3619;3654
Kaunas county;2012;34;7422;3639;3783
Kaunas county;2012;35;7383;3647;3736
Kaunas county;2012;36;7559;3653;3906
Kaunas county;2012;37;7697;3679;4018
Kaunas county;2012;38;7551;3684;3867
Kaunas county;2012;39;8030;3832;4198
Kaunas county;2012;40;8628;4196;4432
Kaunas county;2012;41;8507;4109;4398
Kaunas county;2012;42;8263;4017;4246
Kaunas county;2012;43;8384;3951;4433
Kaunas county;2012;44;8351;3902;4449
Kaunas county;2012;45;8281;3895;4386
Kaunas county;2012;46;8336;4007;4329
Kaunas county;2012;47;8495;4016;4479
Kaunas county;2012;48;8527;3979;4548
Kaunas county;2012;49;9168;4226;4942
Kaunas county;2012;50;9521;4363;5158
Kaunas county;2012;51;9374;4283;5091
Kaunas county;2012;52;9426;4320;5106
Kaunas county;2012;53;9176;4154;5022
Kaunas county;2012;54;8534;3884;4650
Kaunas county;2012;55;7754;3412;4342
Kaunas county;2012;56;7723;3494;4229
Kaunas county;2012;57;7281;3169;4112
Kaunas county;2012;58;6809;3010;3799
Kaunas county;2012;59;7097;2992;4105
Kaunas county;2012;60;7140;3000;4140
Kaunas county;2012;61;7113;2951;4162
Kaunas county;2012;62;7241;3004;4237
Kaunas county;2012;63;6410;2615;3795
Kaunas county;2012;64;5859;2320;3539
Kaunas county;2012;65;5637;2296;3341
Kaunas county;2012;66;6302;2502;3800
Kaunas county;2012;67;5420;2107;3313
Kaunas county;2012;68;6333;2348;3985
Kaunas county;2012;69;6756;2496;4260
Kaunas county;2012;70;6332;2306;4026
Kaunas county;2012;71;5977;2236;3741
Kaunas county;2012;72;5778;2125;3653
Kaunas county;2012;73;5726;2018;3708
Kaunas county;2012;74;5442;1818;3624
Kaunas county;2012;75;5181;1803;3378
Kaunas county;2012;76;4868;1593;3275
Kaunas county;2012;77;4526;1428;3098
Kaunas county;2012;78;4590;1433;3157
Kaunas county;2012;79;4419;1405;3014
Kaunas county;2012;80;4078;1215;2863
Kaunas county;2012;81;3785;1153;2632
Kaunas county;2012;82;3413;1032;2381
Kaunas county;2012;83;3180;909;2271
Kaunas county;2012;84;2719;761;1958
Kaunas county;2012;85;11369;2452;8917
Kaunas county;2013;-1;592816;270399;322417
Kaunas county;2013;0;5995;3075;2920
Kaunas county;2013;1;6021;3076;2945
Kaunas county;2013;2;6323;3300;3023
Kaunas county;2013;3;6314;3172;3142
Kaunas county;2013;4;5786;2970;2816
Kaunas county;2013;5;5500;2843;2657
Kaunas county;2013;6;5212;2696;2516
Kaunas county;2013;7;5432;2755;2677
Kaunas county;2013;8;5236;2688;2548
Kaunas county;2013;9;5312;2687;2625
Kaunas county;2013;10;5286;2693;2593
Kaunas county;2013;11;5485;2894;2591
Kaunas county;2013;12;5931;3029;2902
Kaunas county;2013;13;6439;3281;3158
Kaunas county;2013;14;6629;3471;3158
Kaunas county;2013;15;6828;3478;3350
Kaunas county;2013;16;7176;3659;3517
Kaunas county;2013;17;7456;3862;3594
Kaunas county;2013;18;7373;3733;3640
Kaunas county;2013;19;8047;4141;3906
Kaunas county;2013;20;8809;4594;4215
Kaunas county;2013;21;9145;4720;4425
Kaunas county;2013;22;8956;4582;4374
Kaunas county;2013;23;8342;4241;4101
Kaunas county;2013;24;8154;4086;4068
Kaunas county;2013;25;8456;4249;4207
Kaunas county;2013;26;8457;4398;4059
Kaunas county;2013;27;7934;3890;4044
Kaunas county;2013;28;7938;3982;3956
Kaunas county;2013;29;7855;3963;3892
Kaunas county;2013;30;7197;3586;3611
Kaunas county;2013;31;7148;3660;3488
Kaunas county;2013;32;7040;3551;3489
Kaunas county;2013;33;7069;3592;3477
Kaunas county;2013;34;7121;3547;3574
Kaunas county;2013;35;7295;3560;3735
Kaunas county;2013;36;7272;3580;3692
Kaunas county;2013;37;7419;3574;3845
Kaunas county;2013;38;7583;3625;3958
Kaunas county;2013;39;7463;3646;3817
Kaunas county;2013;40;7888;3755;4133
Kaunas county;2013;41;8516;4145;4371
Kaunas county;2013;42;8386;4047;4339
Kaunas county;2013;43;8147;3952;4195
Kaunas county;2013;44;8287;3889;4398
Kaunas county;2013;45;8216;3843;4373
Kaunas county;2013;46;8195;3850;4345
Kaunas county;2013;47;8229;3941;4288
Kaunas county;2013;48;8406;3961;4445
Kaunas county;2013;49;8373;3885;4488
Kaunas county;2013;50;9062;4163;4899
Kaunas county;2013;51;9379;4274;5105
Kaunas county;2013;52;9252;4212;5040
Kaunas county;2013;53;9338;4270;5068
Kaunas county;2013;54;9077;4089;4988
Kaunas county;2013;55;8409;3798;4611
Kaunas county;2013;56;7658;3353;4305
Kaunas county;2013;57;7611;3425;4186
Kaunas county;2013;58;7183;3112;4071
Kaunas county;2013;59;6727;2947;3780
Kaunas county;2013;60;6994;2904;4090
Kaunas county;2013;61;7015;2904;4111
Kaunas county;2013;62;6995;2872;4123
Kaunas county;2013;63;7119;2921;4198
Kaunas county;2013;64;6283;2527;3756
Kaunas county;2013;65;5734;2231;3503
Kaunas county;2013;66;5512;2212;3300
Kaunas county;2013;67;6131;2396;3735
Kaunas county;2013;68;5292;2039;3253
Kaunas county;2013;69;6159;2249;3910
Kaunas county;2013;70;6583;2389;4194
Kaunas county;2013;71;6147;2192;3955
Kaunas county;2013;72;5809;2148;3661
Kaunas county;2013;73;5605;2029;3576
Kaunas county;2013;74;5537;1912;3625
Kaunas county;2013;75;5257;1723;3534
Kaunas county;2013;76;4984;1702;3282
Kaunas county;2013;77;4663;1489;3174
Kaunas county;2013;78;4299;1322;2977
Kaunas county;2013;79;4349;1333;3016
Kaunas county;2013;80;4159;1284;2875
Kaunas county;2013;81;3816;1111;2705
Kaunas county;2013;82;3503;1032;2471
Kaunas county;2013;83;3145;925;2220
Kaunas county;2013;84;2896;808;2088
Kaunas county;2013;85;12057;2705;9352
Kaunas county;2014;-1;587238;267773;319465
Kaunas county;2014;0;5814;2978;2836
Kaunas county;2014;1;6047;3091;2956
Kaunas county;2014;2;6012;3062;2950
Kaunas county;2014;3;6268;3279;2989
Kaunas county;2014;4;6280;3151;3129
Kaunas county;2014;5;5715;2920;2795
Kaunas county;2014;6;5431;2802;2629
Kaunas county;2014;7;5171;2670;2501
Kaunas county;2014;8;5368;2730;2638
Kaunas county;2014;9;5176;2655;2521
Kaunas county;2014;10;5258;2660;2598
Kaunas county;2014;11;5239;2665;2574
Kaunas county;2014;12;5426;2866;2560
Kaunas county;2014;13;5884;3009;2875
Kaunas county;2014;14;6366;3243;3123
Kaunas county;2014;15;6578;3455;3123
Kaunas county;2014;16;6772;3450;3322
Kaunas county;2014;17;7106;3630;3476
Kaunas county;2014;18;7393;3839;3554
Kaunas county;2014;19;7201;3658;3543
Kaunas county;2014;20;7878;4058;3820
Kaunas county;2014;21;8693;4529;4164
Kaunas county;2014;22;9017;4674;4343
Kaunas county;2014;23;8737;4478;4259
Kaunas county;2014;24;8214;4146;4068
Kaunas county;2014;25;8116;4058;4058
Kaunas county;2014;26;8408;4209;4199
Kaunas county;2014;27;8405;4336;4069
Kaunas county;2014;28;8005;3931;4074
Kaunas county;2014;29;7908;3968;3940
Kaunas county;2014;30;7823;3930;3893
Kaunas county;2014;31;7163;3583;3580
Kaunas county;2014;32;7044;3608;3436
Kaunas county;2014;33;6952;3531;3421
Kaunas county;2014;34;6965;3524;3441
Kaunas county;2014;35;6979;3469;3510
Kaunas county;2014;36;7164;3511;3653
Kaunas county;2014;37;7198;3523;3675
Kaunas county;2014;38;7351;3548;3803
Kaunas county;2014;39;7487;3577;3910
Kaunas county;2014;40;7398;3608;3790
Kaunas county;2014;41;7806;3705;4101
Kaunas county;2014;42;8417;4099;4318
Kaunas county;2014;43;8308;4004;4304
Kaunas county;2014;44;8058;3909;4149
Kaunas county;2014;45;8134;3806;4328
Kaunas county;2014;46;8106;3772;4334
Kaunas county;2014;47;8118;3804;4314
Kaunas county;2014;48;8130;3871;4259
Kaunas county;2014;49;8310;3911;4399
Kaunas county;2014;50;8292;3834;4458
Kaunas county;2014;51;8974;4098;4876
Kaunas county;2014;52;9270;4199;5071
Kaunas county;2014;53;9147;4150;4997
Kaunas county;2014;54;9218;4193;5025
Kaunas county;2014;55;8953;4016;4937
Kaunas county;2014;56;8297;3710;4587
Kaunas county;2014;57;7531;3282;4249
Kaunas county;2014;58;7490;3346;4144
Kaunas county;2014;59;7090;3056;4034
Kaunas county;2014;60;6647;2888;3759
Kaunas county;2014;61;6897;2826;4071
Kaunas county;2014;62;6919;2836;4083
Kaunas county;2014;63;6876;2787;4089
Kaunas county;2014;64;7000;2846;4154
Kaunas county;2014;65;6141;2439;3702
Kaunas county;2014;66;5599;2154;3445
Kaunas county;2014;67;5398;2137;3261
Kaunas county;2014;68;5990;2298;3692
Kaunas county;2014;69;5143;1944;3199
Kaunas county;2014;70;5982;2149;3833
Kaunas county;2014;71;6423;2299;4124
Kaunas county;2014;72;5969;2096;3873
Kaunas county;2014;73;5624;2039;3585
Kaunas county;2014;74;5433;1938;3495
Kaunas county;2014;75;5347;1822;3525
Kaunas county;2014;76;5061;1616;3445
Kaunas county;2014;77;4755;1585;3170
Kaunas county;2014;78;4434;1372;3062
Kaunas county;2014;79;4086;1222;2864
Kaunas county;2014;80;4094;1213;2881
Kaunas county;2014;81;3896;1192;2704
Kaunas county;2014;82;3538;984;2554
Kaunas county;2014;83;3224;934;2290
Kaunas county;2014;84;2878;826;2052
Kaunas county;2014;85;12825;2954;9871
Kaunas county;2015;-1;583047;265969;317078
Kaunas county;2015;0;5956;3019;2937
Kaunas county;2015;1;5855;3006;2849
Kaunas county;2015;2;6010;3074;2936
Kaunas county;2015;3;5951;3039;2912
Kaunas county;2015;4;6228;3256;2972
Kaunas county;2015;5;6228;3114;3114
Kaunas county;2015;6;5658;2875;2783
Kaunas county;2015;7;5389;2776;2613
Kaunas county;2015;8;5110;2639;2471
Kaunas county;2015;9;5333;2712;2621
Kaunas county;2015;10;5138;2636;2502
Kaunas county;2015;11;5206;2626;2580
Kaunas county;2015;12;5186;2626;2560
Kaunas county;2015;13;5382;2848;2534
Kaunas county;2015;14;5840;2980;2860
Kaunas county;2015;15;6326;3214;3112
Kaunas county;2015;16;6533;3422;3111
Kaunas county;2015;17;6717;3429;3288
Kaunas county;2015;18;7051;3596;3455
Kaunas county;2015;19;7245;3764;3481
Kaunas county;2015;20;7091;3610;3481
Kaunas county;2015;21;7772;3983;3789
Kaunas county;2015;22;8601;4492;4109
Kaunas county;2015;23;8855;4602;4253
Kaunas county;2015;24;8718;4447;4271
Kaunas county;2015;25;8205;4139;4066
Kaunas county;2015;26;8100;4031;4069
Kaunas county;2015;27;8379;4157;4222
Kaunas county;2015;28;8479;4371;4108
Kaunas county;2015;29;8045;3947;4098
Kaunas county;2015;30;7923;3982;3941
Kaunas county;2015;31;7778;3911;3867
Kaunas county;2015;32;7103;3562;3541
Kaunas county;2015;33;6980;3577;3403
Kaunas county;2015;34;6858;3498;3360
Kaunas county;2015;35;6847;3481;3366
Kaunas county;2015;36;6930;3429;3501
Kaunas county;2015;37;7080;3466;3614
Kaunas county;2015;38;7129;3489;3640
Kaunas county;2015;39;7280;3508;3772
Kaunas county;2015;40;7418;3533;3885
Kaunas county;2015;41;7331;3555;3776
Kaunas county;2015;42;7719;3664;4055
Kaunas county;2015;43;8358;4068;4290
Kaunas county;2015;44;8221;3957;4264
Kaunas county;2015;45;7954;3856;4098
Kaunas county;2015;46;8055;3758;4297
Kaunas county;2015;47;8082;3760;4322
Kaunas county;2015;48;8040;3767;4273
Kaunas county;2015;49;8069;3845;4224
Kaunas county;2015;50;8246;3882;4364
Kaunas county;2015;51;8238;3805;4433
Kaunas county;2015;52;8888;4044;4844
Kaunas county;2015;53;9152;4132;5020
Kaunas county;2015;54;9072;4108;4964
Kaunas county;2015;55;9110;4129;4981
Kaunas county;2015;56;8848;3947;4901
Kaunas county;2015;57;8189;3654;4535
Kaunas county;2015;58;7416;3218;4198
Kaunas county;2015;59;7395;3288;4107
Kaunas county;2015;60;6973;2973;4000
Kaunas county;2015;61;6579;2851;3728
Kaunas county;2015;62;6779;2749;4030
Kaunas county;2015;63;6803;2759;4044
Kaunas county;2015;64;6734;2690;4044
Kaunas county;2015;65;6866;2762;4104
Kaunas county;2015;66;6028;2372;3656
Kaunas county;2015;67;5497;2098;3399
Kaunas county;2015;68;5300;2080;3220
Kaunas county;2015;69;5850;2215;3635
Kaunas county;2015;70;4978;1850;3128
Kaunas county;2015;71;5832;2067;3765
Kaunas county;2015;72;6253;2202;4051
Kaunas county;2015;73;5778;2006;3772
Kaunas county;2015;74;5463;1949;3514
Kaunas county;2015;75;5237;1841;3396
Kaunas county;2015;76;5167;1732;3435
Kaunas county;2015;77;4874;1523;3351
Kaunas county;2015;78;4536;1486;3050
Kaunas county;2015;79;4201;1276;2925
Kaunas county;2015;80;3877;1124;2753
Kaunas county;2015;81;3825;1082;2743
Kaunas county;2015;82;3660;1091;2569
Kaunas county;2015;83;3259;886;2373
Kaunas county;2015;84;2955;834;2121
Kaunas county;2015;85;13447;3168;10279
Kaunas county;2016;-1;577358;263124;314234
Kaunas county;2016;0;6122;3175;2947
Kaunas county;2016;1;5951;3022;2929
Kaunas county;2016;2;5848;2998;2850
Kaunas county;2016;3;5949;3044;2905
Kaunas county;2016;4;5892;3019;2873
Kaunas county;2016;5;6174;3212;2962
Kaunas county;2016;6;6184;3083;3101
Kaunas county;2016;7;5621;2858;2763
Kaunas county;2016;8;5337;2751;2586
Kaunas county;2016;9;5075;2626;2449
Kaunas county;2016;10;5271;2691;2580
Kaunas county;2016;11;5077;2612;2465
Kaunas county;2016;12;5139;2585;2554
Kaunas county;2016;13;5153;2610;2543
Kaunas county;2016;14;5333;2819;2514
Kaunas county;2016;15;5785;2951;2834
Kaunas county;2016;16;6272;3187;3085
Kaunas county;2016;17;6480;3389;3091
Kaunas county;2016;18;6652;3401;3251
Kaunas county;2016;19;6901;3533;3368
Kaunas county;2016;20;7079;3650;3429
Kaunas county;2016;21;6953;3510;3443
Kaunas county;2016;22;7579;3844;3735
Kaunas county;2016;23;8338;4328;4010
Kaunas county;2016;24;8622;4453;4169
Kaunas county;2016;25;8639;4365;4274
Kaunas county;2016;26;8122;4058;4064
Kaunas county;2016;27;8012;3973;4039
Kaunas county;2016;28;8445;4193;4252
Kaunas county;2016;29;8500;4373;4127
Kaunas county;2016;30;8007;3878;4129
Kaunas county;2016;31;7922;3969;3953
Kaunas county;2016;32;7715;3866;3849
Kaunas county;2016;33;7035;3534;3501
Kaunas county;2016;34;6898;3532;3366
Kaunas county;2016;35;6759;3436;3323
Kaunas county;2016;36;6738;3419;3319
Kaunas county;2016;37;6819;3369;3450
Kaunas county;2016;38;7027;3447;3580
Kaunas county;2016;39;7056;3467;3589
Kaunas county;2016;40;7172;3466;3706
Kaunas county;2016;41;7355;3496;3859
Kaunas county;2016;42;7268;3530;3738
Kaunas county;2016;43;7655;3630;4025
Kaunas county;2016;44;8236;4019;4217
Kaunas county;2016;45;8110;3891;4219
Kaunas county;2016;46;7838;3783;4055
Kaunas county;2016;47;7974;3711;4263
Kaunas county;2016;48;8004;3716;4288
Kaunas county;2016;49;7993;3733;4260
Kaunas county;2016;50;7968;3789;4179
Kaunas county;2016;51;8165;3830;4335
Kaunas county;2016;52;8160;3756;4404
Kaunas county;2016;53;8825;3997;4828
Kaunas county;2016;54;9054;4063;4991
Kaunas county;2016;55;8937;4013;4924
Kaunas county;2016;56;9014;4053;4961
Kaunas county;2016;57;8722;3873;4849
Kaunas county;2016;58;8093;3588;4505
Kaunas county;2016;59;7287;3118;4169
Kaunas county;2016;60;7281;3212;4069
Kaunas county;2016;61;6899;2910;3989
Kaunas county;2016;62;6469;2772;3697
Kaunas county;2016;63;6653;2673;3980
Kaunas county;2016;64;6672;2678;3994
Kaunas county;2016;65;6578;2587;3991
Kaunas county;2016;66;6689;2644;4045
Kaunas county;2016;67;5894;2285;3609
Kaunas county;2016;68;5376;2005;3371
Kaunas county;2016;69;5165;1988;3177
Kaunas county;2016;70;5693;2121;3572
Kaunas county;2016;71;4834;1766;3068
Kaunas county;2016;72;5641;1947;3694
Kaunas county;2016;73;6055;2089;3966
Kaunas county;2016;74;5584;1898;3686
Kaunas county;2016;75;5256;1833;3423
Kaunas county;2016;76;5046;1742;3304
Kaunas county;2016;77;4975;1640;3335
Kaunas county;2016;78;4672;1428;3244
Kaunas county;2016;79;4296;1371;2925
Kaunas county;2016;80;3981;1185;2796
Kaunas county;2016;81;3604;1017;2587
Kaunas county;2016;82;3555;982;2573
Kaunas county;2016;83;3375;979;2396
Kaunas county;2016;84;2963;790;2173
Kaunas county;2016;85;13841;3297;10544
Kaunas county;2017;-1;569875;259871;310004
Kaunas county;2017;0;6001;3112;2889
Kaunas county;2017;1;6073;3138;2935
Kaunas county;2017;2;5867;2989;2878
Kaunas county;2017;3;5751;2945;2806
Kaunas county;2017;4;5861;2997;2864
Kaunas county;2017;5;5822;2971;2851
Kaunas county;2017;6;6103;3184;2919
Kaunas county;2017;7;6107;3054;3053
Kaunas county;2017;8;5560;2817;2743
Kaunas county;2017;9;5293;2724;2569
Kaunas county;2017;10;5034;2610;2424
Kaunas county;2017;11;5232;2679;2553
Kaunas county;2017;12;5032;2576;2456
Kaunas county;2017;13;5082;2560;2522
Kaunas county;2017;14;5133;2593;2540
Kaunas county;2017;15;5273;2784;2489
Kaunas county;2017;16;5726;2920;2806
Kaunas county;2017;17;6212;3163;3049
Kaunas county;2017;18;6406;3348;3058
Kaunas county;2017;19;6525;3341;3184
Kaunas county;2017;20;6779;3467;3312
Kaunas county;2017;21;6957;3595;3362
Kaunas county;2017;22;6810;3449;3361
Kaunas county;2017;23;7418;3783;3635
Kaunas county;2017;24;8166;4244;3922
Kaunas county;2017;25;8403;4329;4074
Kaunas county;2017;26;8491;4306;4185
Kaunas county;2017;27;7954;3977;3977
Kaunas county;2017;28;7912;3929;3983
Kaunas county;2017;29;8329;4132;4197
Kaunas county;2017;30;8356;4301;4055
Kaunas county;2017;31;7880;3839;4041
Kaunas county;2017;32;7722;3875;3847
Kaunas county;2017;33;7572;3823;3749
Kaunas county;2017;34;6852;3474;3378
Kaunas county;2017;35;6700;3430;3270
Kaunas county;2017;36;6593;3337;3256
Kaunas county;2017;37;6611;3359;3252
Kaunas county;2017;38;6694;3299;3395
Kaunas county;2017;39;6904;3364;3540
Kaunas county;2017;40;6942;3400;3542
Kaunas county;2017;41;7040;3408;3632
Kaunas county;2017;42;7206;3427;3779
Kaunas county;2017;43;7144;3468;3676
Kaunas county;2017;44;7546;3575;3971
Kaunas county;2017;45;8132;3968;4164
Kaunas county;2017;46;8020;3829;4191
Kaunas county;2017;47;7734;3739;3995
Kaunas county;2017;48;7856;3645;4211
Kaunas county;2017;49;7933;3679;4254
Kaunas county;2017;50;7886;3675;4211
Kaunas county;2017;51;7858;3725;4133
Kaunas county;2017;52;8044;3765;4279
Kaunas county;2017;53;8028;3680;4348
Kaunas county;2017;54;8701;3923;4778
Kaunas county;2017;55;8911;3993;4918
Kaunas county;2017;56;8836;3955;4881
Kaunas county;2017;57;8880;3972;4908
Kaunas county;2017;58;8598;3794;4804
Kaunas county;2017;59;7970;3504;4466
Kaunas county;2017;60;7198;3062;4136
Kaunas county;2017;61;7177;3143;4034
Kaunas county;2017;62;6775;2826;3949
Kaunas county;2017;63;6366;2718;3648
Kaunas county;2017;64;6533;2590;3943
Kaunas county;2017;65;6555;2599;3956
Kaunas county;2017;66;6423;2484;3939
Kaunas county;2017;67;6543;2556;3987
Kaunas county;2017;68;5735;2193;3542
Kaunas county;2017;69;5263;1937;3326
Kaunas county;2017;70;5043;1911;3132
Kaunas county;2017;71;5514;2017;3497
Kaunas county;2017;72;4671;1678;2993
Kaunas county;2017;73;5444;1835;3609
Kaunas county;2017;74;5876;1982;3894
Kaunas county;2017;75;5376;1795;3581
Kaunas county;2017;76;5074;1732;3342
Kaunas county;2017;77;4818;1629;3189
Kaunas county;2017;78;4731;1517;3214
Kaunas county;2017;79;4423;1318;3105
Kaunas county;2017;80;4046;1258;2788
Kaunas county;2017;81;3769;1095;2674
Kaunas county;2017;82;3318;921;2397
Kaunas county;2017;83;3311;891;2420
Kaunas county;2017;84;3079;871;2208
Kaunas county;2017;85;14353;3372;10981
Kaunas county;2018;-1;563112;257256;305856
Kaunas county;2018;0;5594;2859;2735
Kaunas county;2018;1;6025;3139;2886
Kaunas county;2018;2;6047;3130;2917
Kaunas county;2018;3;5814;2962;2852
Kaunas county;2018;4;5697;2931;2766
Kaunas county;2018;5;5817;2968;2849
Kaunas county;2018;6;5790;2947;2843
Kaunas county;2018;7;6060;3154;2906
Kaunas county;2018;8;6034;3022;3012
Kaunas county;2018;9;5496;2777;2719
Kaunas county;2018;10;5223;2689;2534
Kaunas county;2018;11;4984;2581;2403
Kaunas county;2018;12;5178;2641;2537
Kaunas county;2018;13;4981;2552;2429
Kaunas county;2018;14;5047;2547;2500
Kaunas county;2018;15;5093;2565;2528
Kaunas county;2018;16;5250;2769;2481
Kaunas county;2018;17;5685;2896;2789
Kaunas county;2018;18;6114;3114;3000
Kaunas county;2018;19;6211;3267;2944
Kaunas county;2018;20;6324;3249;3075
Kaunas county;2018;21;6565;3338;3227
Kaunas county;2018;22;6709;3473;3236
Kaunas county;2018;23;6519;3330;3189
Kaunas county;2018;24;7127;3645;3482
Kaunas county;2018;25;7883;4071;3812
Kaunas county;2018;26;8248;4260;3988
Kaunas county;2018;27;8358;4247;4111
Kaunas county;2018;28;7837;3900;3937
Kaunas county;2018;29;7845;3896;3949
Kaunas county;2018;30;8238;4132;4106
Kaunas county;2018;31;8252;4250;4002
Kaunas county;2018;32;7793;3829;3964
Kaunas county;2018;33;7625;3858;3767
Kaunas county;2018;34;7494;3802;3692
Kaunas county;2018;35;6775;3453;3322
Kaunas county;2018;36;6609;3398;3211
Kaunas county;2018;37;6503;3301;3202
Kaunas county;2018;38;6572;3368;3204
Kaunas county;2018;39;6634;3286;3348
Kaunas county;2018;40;6856;3373;3483
Kaunas county;2018;41;6872;3381;3491
Kaunas county;2018;42;6971;3381;3590
Kaunas county;2018;43;7145;3403;3742
Kaunas county;2018;44;7106;3453;3653
Kaunas county;2018;45;7436;3527;3909
Kaunas county;2018;46;8038;3924;4114
Kaunas county;2018;47;7929;3792;4137
Kaunas county;2018;48;7668;3705;3963
Kaunas county;2018;49;7761;3591;4170
Kaunas county;2018;50;7841;3632;4209
Kaunas county;2018;51;7793;3629;4164
Kaunas county;2018;52;7781;3676;4105
Kaunas county;2018;53;7963;3719;4244
Kaunas county;2018;54;7933;3636;4297
Kaunas county;2018;55;8598;3866;4732
Kaunas county;2018;56;8804;3934;4870
Kaunas county;2018;57;8745;3907;4838
Kaunas county;2018;58;8785;3906;4879
Kaunas county;2018;59;8485;3723;4762
Kaunas county;2018;60;7879;3445;4434
Kaunas county;2018;61;7095;2991;4104
Kaunas county;2018;62;7088;3071;4017
Kaunas county;2018;63;6670;2747;3923
Kaunas county;2018;64;6275;2661;3614
Kaunas county;2018;65;6434;2524;3910
Kaunas county;2018;66;6414;2508;3906
Kaunas county;2018;67;6285;2389;3896
Kaunas county;2018;68;6400;2464;3936
Kaunas county;2018;69;5608;2122;3486
Kaunas county;2018;70;5137;1873;3264
Kaunas county;2018;71;4909;1828;3081
Kaunas county;2018;72;5328;1908;3420
Kaunas county;2018;73;4526;1595;2931
Kaunas county;2018;74;5280;1748;3532
Kaunas county;2018;75;5693;1894;3799
Kaunas county;2018;76;5160;1682;3478
Kaunas county;2018;77;4871;1609;3262
Kaunas county;2018;78;4624;1522;3102
Kaunas county;2018;79;4509;1422;3087
Kaunas county;2018;80;4185;1215;2970
Kaunas county;2018;81;3805;1160;2645
Kaunas county;2018;82;3543;1011;2532
Kaunas county;2018;83;3070;831;2239
Kaunas county;2018;84;3009;781;2228
Kaunas county;2018;85;14755;3501;11254
Kaunas d. mun.;2001;-1;81373;38475;42898
Kaunas d. mun.;2001;0;792;401;391
Kaunas d. mun.;2001;1;856;456;400
Kaunas d. mun.;2001;2;904;443;461
Kaunas d. mun.;2001;3;919;456;463
Kaunas d. mun.;2001;4;1037;529;508
Kaunas d. mun.;2001;5;1048;536;512
Kaunas d. mun.;2001;6;1041;532;509
Kaunas d. mun.;2001;7;1109;582;527
Kaunas d. mun.;2001;8;1323;677;646
Kaunas d. mun.;2001;9;1277;695;582
Kaunas d. mun.;2001;10;1409;736;673
Kaunas d. mun.;2001;11;1258;633;625
Kaunas d. mun.;2001;12;1290;682;608
Kaunas d. mun.;2001;13;1309;647;662
Kaunas d. mun.;2001;14;1467;771;696
Kaunas d. mun.;2001;15;1418;691;727
Kaunas d. mun.;2001;16;1333;686;647
Kaunas d. mun.;2001;17;1229;646;583
Kaunas d. mun.;2001;18;1315;670;645
Kaunas d. mun.;2001;19;1379;675;704
Kaunas d. mun.;2001;20;1406;676;730
Kaunas d. mun.;2001;21;1318;665;653
Kaunas d. mun.;2001;22;1184;569;615
Kaunas d. mun.;2001;23;1135;542;593
Kaunas d. mun.;2001;24;993;488;505
Kaunas d. mun.;2001;25;1010;509;501
Kaunas d. mun.;2001;26;991;472;519
Kaunas d. mun.;2001;27;1016;513;503
Kaunas d. mun.;2001;28;1125;537;588
Kaunas d. mun.;2001;29;1118;550;568
Kaunas d. mun.;2001;30;1150;556;594
Kaunas d. mun.;2001;31;1162;586;576
Kaunas d. mun.;2001;32;1194;538;656
Kaunas d. mun.;2001;33;1234;594;640
Kaunas d. mun.;2001;34;1180;589;591
Kaunas d. mun.;2001;35;1170;567;603
Kaunas d. mun.;2001;36;1194;593;601
Kaunas d. mun.;2001;37;1260;634;626
Kaunas d. mun.;2001;38;1365;633;732
Kaunas d. mun.;2001;39;1402;659;743
Kaunas d. mun.;2001;40;1401;685;716
Kaunas d. mun.;2001;41;1335;682;653
Kaunas d. mun.;2001;42;1355;642;713
Kaunas d. mun.;2001;43;1271;637;634
Kaunas d. mun.;2001;44;1089;541;548
Kaunas d. mun.;2001;45;1103;546;557
Kaunas d. mun.;2001;46;989;484;505
Kaunas d. mun.;2001;47;960;470;490
Kaunas d. mun.;2001;48;961;463;498
Kaunas d. mun.;2001;49;937;434;503
Kaunas d. mun.;2001;50;974;481;493
Kaunas d. mun.;2001;51;875;399;476
Kaunas d. mun.;2001;52;829;388;441
Kaunas d. mun.;2001;53;745;352;393
Kaunas d. mun.;2001;54;677;311;366
Kaunas d. mun.;2001;55;859;402;457
Kaunas d. mun.;2001;56;762;350;412
Kaunas d. mun.;2001;57;861;415;446
Kaunas d. mun.;2001;58;966;425;541
Kaunas d. mun.;2001;59;917;408;509
Kaunas d. mun.;2001;60;807;369;438
Kaunas d. mun.;2001;61;811;350;461
Kaunas d. mun.;2001;62;776;346;430
Kaunas d. mun.;2001;63;729;326;403
Kaunas d. mun.;2001;64;684;294;390
Kaunas d. mun.;2001;65;776;316;460
Kaunas d. mun.;2001;66;702;302;400
Kaunas d. mun.;2001;67;748;281;467
Kaunas d. mun.;2001;68;723;300;423
Kaunas d. mun.;2001;69;757;288;469
Kaunas d. mun.;2001;70;689;284;405
Kaunas d. mun.;2001;71;598;229;369
Kaunas d. mun.;2001;72;618;231;387
Kaunas d. mun.;2001;73;529;196;333
Kaunas d. mun.;2001;74;500;172;328
Kaunas d. mun.;2001;75;476;140;336
Kaunas d. mun.;2001;76;418;115;303
Kaunas d. mun.;2001;77;397;134;263
Kaunas d. mun.;2001;78;361;104;257
Kaunas d. mun.;2001;79;300;95;205
Kaunas d. mun.;2001;80;273;88;185
Kaunas d. mun.;2001;81;225;60;165
Kaunas d. mun.;2001;82;157;33;124
Kaunas d. mun.;2001;83;125;37;88
Kaunas d. mun.;2001;84;132;26;106
Kaunas d. mun.;2001;85;876;230;646
Kaunas d. mun.;2002;-1;81650;38642;43008
Kaunas d. mun.;2002;0;759;403;356
Kaunas d. mun.;2002;1;794;399;395
Kaunas d. mun.;2002;2;870;467;403
Kaunas d. mun.;2002;3;920;453;467
Kaunas d. mun.;2002;4;920;462;458
Kaunas d. mun.;2002;5;1040;535;505
Kaunas d. mun.;2002;6;1059;543;516
Kaunas d. mun.;2002;7;1051;537;514
Kaunas d. mun.;2002;8;1127;590;537
Kaunas d. mun.;2002;9;1333;678;655
Kaunas d. mun.;2002;10;1294;704;590
Kaunas d. mun.;2002;11;1406;738;668
Kaunas d. mun.;2002;12;1254;631;623
Kaunas d. mun.;2002;13;1298;689;609
Kaunas d. mun.;2002;14;1314;647;667
Kaunas d. mun.;2002;15;1473;772;701
Kaunas d. mun.;2002;16;1419;687;732
Kaunas d. mun.;2002;17;1325;681;644
Kaunas d. mun.;2002;18;1221;643;578
Kaunas d. mun.;2002;19;1302;659;643
Kaunas d. mun.;2002;20;1380;673;707
Kaunas d. mun.;2002;21;1371;660;711
Kaunas d. mun.;2002;22;1290;649;641
Kaunas d. mun.;2002;23;1151;553;598
Kaunas d. mun.;2002;24;1120;539;581
Kaunas d. mun.;2002;25;976;484;492
Kaunas d. mun.;2002;26;1003;496;507
Kaunas d. mun.;2002;27;992;474;518
Kaunas d. mun.;2002;28;1008;502;506
Kaunas d. mun.;2002;29;1115;530;585
Kaunas d. mun.;2002;30;1118;553;565
Kaunas d. mun.;2002;31;1136;552;584
Kaunas d. mun.;2002;32;1163;587;576
Kaunas d. mun.;2002;33;1181;527;654
Kaunas d. mun.;2002;34;1226;589;637
Kaunas d. mun.;2002;35;1172;583;589
Kaunas d. mun.;2002;36;1172;571;601
Kaunas d. mun.;2002;37;1193;583;610
Kaunas d. mun.;2002;38;1254;626;628
Kaunas d. mun.;2002;39;1370;641;729
Kaunas d. mun.;2002;40;1403;661;742
Kaunas d. mun.;2002;41;1404;688;716
Kaunas d. mun.;2002;42;1331;681;650
Kaunas d. mun.;2002;43;1367;651;716
Kaunas d. mun.;2002;44;1275;637;638
Kaunas d. mun.;2002;45;1084;537;547
Kaunas d. mun.;2002;46;1098;545;553
Kaunas d. mun.;2002;47;990;481;509
Kaunas d. mun.;2002;48;947;459;488
Kaunas d. mun.;2002;49;961;464;497
Kaunas d. mun.;2002;50;930;427;503
Kaunas d. mun.;2002;51;966;479;487
Kaunas d. mun.;2002;52;883;407;476
Kaunas d. mun.;2002;53;832;392;440
Kaunas d. mun.;2002;54;753;359;394
Kaunas d. mun.;2002;55;669;305;364
Kaunas d. mun.;2002;56;852;397;455
Kaunas d. mun.;2002;57;760;351;409
Kaunas d. mun.;2002;58;848;408;440
Kaunas d. mun.;2002;59;954;423;531
Kaunas d. mun.;2002;60;924;409;515
Kaunas d. mun.;2002;61;809;367;442
Kaunas d. mun.;2002;62;817;349;468
Kaunas d. mun.;2002;63;787;348;439
Kaunas d. mun.;2002;64;738;330;408
Kaunas d. mun.;2002;65;684;298;386
Kaunas d. mun.;2002;66;772;311;461
Kaunas d. mun.;2002;67;696;298;398
Kaunas d. mun.;2002;68;740;276;464
Kaunas d. mun.;2002;69;720;299;421
Kaunas d. mun.;2002;70;748;281;467
Kaunas d. mun.;2002;71;684;283;401
Kaunas d. mun.;2002;72;583;219;364
Kaunas d. mun.;2002;73;604;227;377
Kaunas d. mun.;2002;74;519;191;328
Kaunas d. mun.;2002;75;490;164;326
Kaunas d. mun.;2002;76;459;132;327
Kaunas d. mun.;2002;77;407;111;296
Kaunas d. mun.;2002;78;383;126;257
Kaunas d. mun.;2002;79;348;97;251
Kaunas d. mun.;2002;80;283;86;197
Kaunas d. mun.;2002;81;253;76;177
Kaunas d. mun.;2002;82;211;52;159
Kaunas d. mun.;2002;83;145;30;115
Kaunas d. mun.;2002;84;117;34;83
Kaunas d. mun.;2002;85;852;206;646
Kaunas d. mun.;2003;-1;82108;38865;43243
Kaunas d. mun.;2003;0;773;406;367
Kaunas d. mun.;2003;1;783;420;363
Kaunas d. mun.;2003;2;809;407;402
Kaunas d. mun.;2003;3;885;473;412
Kaunas d. mun.;2003;4;943;470;473
Kaunas d. mun.;2003;5;944;476;468
Kaunas d. mun.;2003;6;1057;538;519
Kaunas d. mun.;2003;7;1080;556;524
Kaunas d. mun.;2003;8;1068;539;529
Kaunas d. mun.;2003;9;1153;605;548
Kaunas d. mun.;2003;10;1349;692;657
Kaunas d. mun.;2003;11;1305;710;595
Kaunas d. mun.;2003;12;1418;745;673
Kaunas d. mun.;2003;13;1262;641;621
Kaunas d. mun.;2003;14;1310;685;625
Kaunas d. mun.;2003;15;1316;646;670
Kaunas d. mun.;2003;16;1469;769;700
Kaunas d. mun.;2003;17;1396;671;725
Kaunas d. mun.;2003;18;1316;681;635
Kaunas d. mun.;2003;19;1230;650;580
Kaunas d. mun.;2003;20;1288;651;637
Kaunas d. mun.;2003;21;1355;664;691
Kaunas d. mun.;2003;22;1340;653;687
Kaunas d. mun.;2003;23;1262;634;628
Kaunas d. mun.;2003;24;1108;537;571
Kaunas d. mun.;2003;25;1094;526;568
Kaunas d. mun.;2003;26;966;484;482
Kaunas d. mun.;2003;27;989;486;503
Kaunas d. mun.;2003;28;1012;482;530
Kaunas d. mun.;2003;29;1007;499;508
Kaunas d. mun.;2003;30;1130;533;597
Kaunas d. mun.;2003;31;1099;542;557
Kaunas d. mun.;2003;32;1151;563;588
Kaunas d. mun.;2003;33;1168;586;582
Kaunas d. mun.;2003;34;1176;521;655
Kaunas d. mun.;2003;35;1217;583;634
Kaunas d. mun.;2003;36;1173;584;589
Kaunas d. mun.;2003;37;1172;565;607
Kaunas d. mun.;2003;38;1199;583;616
Kaunas d. mun.;2003;39;1276;641;635
Kaunas d. mun.;2003;40;1372;641;731
Kaunas d. mun.;2003;41;1396;652;744
Kaunas d. mun.;2003;42;1420;697;723
Kaunas d. mun.;2003;43;1350;689;661
Kaunas d. mun.;2003;44;1374;657;717
Kaunas d. mun.;2003;45;1276;636;640
Kaunas d. mun.;2003;46;1094;541;553
Kaunas d. mun.;2003;47;1101;545;556
Kaunas d. mun.;2003;48;984;478;506
Kaunas d. mun.;2003;49;950;460;490
Kaunas d. mun.;2003;50;957;459;498
Kaunas d. mun.;2003;51;935;426;509
Kaunas d. mun.;2003;52;967;475;492
Kaunas d. mun.;2003;53;902;419;483
Kaunas d. mun.;2003;54;834;388;446
Kaunas d. mun.;2003;55;755;358;397
Kaunas d. mun.;2003;56;671;304;367
Kaunas d. mun.;2003;57;848;398;450
Kaunas d. mun.;2003;58;763;347;416
Kaunas d. mun.;2003;59;850;407;443
Kaunas d. mun.;2003;60;945;413;532
Kaunas d. mun.;2003;61;913;404;509
Kaunas d. mun.;2003;62;808;372;436
Kaunas d. mun.;2003;63;802;341;461
Kaunas d. mun.;2003;64;769;337;432
Kaunas d. mun.;2003;65;736;322;414
Kaunas d. mun.;2003;66;682;300;382
Kaunas d. mun.;2003;67;785;317;468
Kaunas d. mun.;2003;68;691;291;400
Kaunas d. mun.;2003;69;726;263;463
Kaunas d. mun.;2003;70;711;290;421
Kaunas d. mun.;2003;71;729;268;461
Kaunas d. mun.;2003;72;660;271;389
Kaunas d. mun.;2003;73;562;202;360
Kaunas d. mun.;2003;74;578;208;370
Kaunas d. mun.;2003;75;496;176;320
Kaunas d. mun.;2003;76;472;163;309
Kaunas d. mun.;2003;77;440;126;314
Kaunas d. mun.;2003;78;396;106;290
Kaunas d. mun.;2003;79;375;121;254
Kaunas d. mun.;2003;80;334;92;242
Kaunas d. mun.;2003;81;269;81;188
Kaunas d. mun.;2003;82;242;71;171
Kaunas d. mun.;2003;83;201;47;154
Kaunas d. mun.;2003;84;132;24;108
Kaunas d. mun.;2003;85;807;185;622
Kaunas d. mun.;2004;-1;83167;39389;43778
Kaunas d. mun.;2004;0;822;420;402
Kaunas d. mun.;2004;1;807;419;388
Kaunas d. mun.;2004;2;820;444;376
Kaunas d. mun.;2004;3;846;426;420
Kaunas d. mun.;2004;4;920;487;433
Kaunas d. mun.;2004;5;981;486;495
Kaunas d. mun.;2004;6;981;495;486
Kaunas d. mun.;2004;7;1092;562;530
Kaunas d. mun.;2004;8;1112;568;544
Kaunas d. mun.;2004;9;1100;558;542
Kaunas d. mun.;2004;10;1187;621;566
Kaunas d. mun.;2004;11;1383;717;666
Kaunas d. mun.;2004;12;1334;717;617
Kaunas d. mun.;2004;13;1448;762;686
Kaunas d. mun.;2004;14;1281;653;628
Kaunas d. mun.;2004;15;1325;692;633
Kaunas d. mun.;2004;16;1312;644;668
Kaunas d. mun.;2004;17;1454;766;688
Kaunas d. mun.;2004;18;1379;667;712
Kaunas d. mun.;2004;19;1304;674;630
Kaunas d. mun.;2004;20;1236;651;585
Kaunas d. mun.;2004;21;1275;649;626
Kaunas d. mun.;2004;22;1346;662;684
Kaunas d. mun.;2004;23;1295;644;651
Kaunas d. mun.;2004;24;1225;621;604
Kaunas d. mun.;2004;25;1077;523;554
Kaunas d. mun.;2004;26;1075;513;562
Kaunas d. mun.;2004;27;943;472;471
Kaunas d. mun.;2004;28;994;477;517
Kaunas d. mun.;2004;29;1030;490;540
Kaunas d. mun.;2004;30;999;495;504
Kaunas d. mun.;2004;31;1138;538;600
Kaunas d. mun.;2004;32;1112;555;557
Kaunas d. mun.;2004;33;1155;558;597
Kaunas d. mun.;2004;34;1190;598;592
Kaunas d. mun.;2004;35;1193;535;658
Kaunas d. mun.;2004;36;1235;592;643
Kaunas d. mun.;2004;37;1174;584;590
Kaunas d. mun.;2004;38;1173;575;598
Kaunas d. mun.;2004;39;1201;583;618
Kaunas d. mun.;2004;40;1285;646;639
Kaunas d. mun.;2004;41;1384;654;730
Kaunas d. mun.;2004;42;1400;649;751
Kaunas d. mun.;2004;43;1442;710;732
Kaunas d. mun.;2004;44;1353;692;661
Kaunas d. mun.;2004;45;1392;665;727
Kaunas d. mun.;2004;46;1278;631;647
Kaunas d. mun.;2004;47;1102;545;557
Kaunas d. mun.;2004;48;1118;558;560
Kaunas d. mun.;2004;49;1003;483;520
Kaunas d. mun.;2004;50;960;469;491
Kaunas d. mun.;2004;51;955;458;497
Kaunas d. mun.;2004;52;923;415;508
Kaunas d. mun.;2004;53;973;475;498
Kaunas d. mun.;2004;54;922;424;498
Kaunas d. mun.;2004;55;840;388;452
Kaunas d. mun.;2004;56;761;358;403
Kaunas d. mun.;2004;57;684;305;379
Kaunas d. mun.;2004;58;859;400;459
Kaunas d. mun.;2004;59;757;337;420
Kaunas d. mun.;2004;60;855;403;452
Kaunas d. mun.;2004;61;957;413;544
Kaunas d. mun.;2004;62;908;395;513
Kaunas d. mun.;2004;63;820;374;446
Kaunas d. mun.;2004;64;805;340;465
Kaunas d. mun.;2004;65;788;346;442
Kaunas d. mun.;2004;66;729;314;415
Kaunas d. mun.;2004;67;669;293;376
Kaunas d. mun.;2004;68;778;312;466
Kaunas d. mun.;2004;69;690;293;397
Kaunas d. mun.;2004;70;713;248;465
Kaunas d. mun.;2004;71;706;292;414
Kaunas d. mun.;2004;72;719;260;459
Kaunas d. mun.;2004;73;646;258;388
Kaunas d. mun.;2004;74;551;195;356
Kaunas d. mun.;2004;75;561;190;371
Kaunas d. mun.;2004;76;479;168;311
Kaunas d. mun.;2004;77;459;156;303
Kaunas d. mun.;2004;78;429;122;307
Kaunas d. mun.;2004;79;382;100;282
Kaunas d. mun.;2004;80;355;111;244
Kaunas d. mun.;2004;81;325;84;241
Kaunas d. mun.;2004;82;256;75;181
Kaunas d. mun.;2004;83;228;68;160
Kaunas d. mun.;2004;84;183;43;140
Kaunas d. mun.;2004;85;831;181;650
Kaunas d. mun.;2005;-1;83200;39462;43738
Kaunas d. mun.;2005;0;716;365;351
Kaunas d. mun.;2005;1;828;426;402
Kaunas d. mun.;2005;2;804;416;388
Kaunas d. mun.;2005;3;812;438;374
Kaunas d. mun.;2005;4;849;431;418
Kaunas d. mun.;2005;5;930;489;441
Kaunas d. mun.;2005;6;996;493;503
Kaunas d. mun.;2005;7;991;502;489
Kaunas d. mun.;2005;8;1090;561;529
Kaunas d. mun.;2005;9;1113;568;545
Kaunas d. mun.;2005;10;1123;567;556
Kaunas d. mun.;2005;11;1175;612;563
Kaunas d. mun.;2005;12;1389;729;660
Kaunas d. mun.;2005;13;1332;722;610
Kaunas d. mun.;2005;14;1445;754;691
Kaunas d. mun.;2005;15;1286;651;635
Kaunas d. mun.;2005;16;1308;682;626
Kaunas d. mun.;2005;17;1293;641;652
Kaunas d. mun.;2005;18;1437;755;682
Kaunas d. mun.;2005;19;1368;656;712
Kaunas d. mun.;2005;20;1292;663;629
Kaunas d. mun.;2005;21;1218;645;573
Kaunas d. mun.;2005;22;1243;631;612
Kaunas d. mun.;2005;23;1317;650;667
Kaunas d. mun.;2005;24;1256;632;624
Kaunas d. mun.;2005;25;1152;604;548
Kaunas d. mun.;2005;26;1062;520;542
Kaunas d. mun.;2005;27;1049;503;546
Kaunas d. mun.;2005;28;947;473;474
Kaunas d. mun.;2005;29;1037;506;531
Kaunas d. mun.;2005;30;1020;491;529
Kaunas d. mun.;2005;31;1006;504;502
Kaunas d. mun.;2005;32;1139;534;605
Kaunas d. mun.;2005;33;1141;569;572
Kaunas d. mun.;2005;34;1183;572;611
Kaunas d. mun.;2005;35;1199;600;599
Kaunas d. mun.;2005;36;1208;543;665
Kaunas d. mun.;2005;37;1269;610;659
Kaunas d. mun.;2005;38;1178;583;595
Kaunas d. mun.;2005;39;1182;591;591
Kaunas d. mun.;2005;40;1207;590;617
Kaunas d. mun.;2005;41;1301;650;651
Kaunas d. mun.;2005;42;1379;648;731
Kaunas d. mun.;2005;43;1405;650;755
Kaunas d. mun.;2005;44;1447;712;735
Kaunas d. mun.;2005;45;1348;689;659
Kaunas d. mun.;2005;46;1391;664;727
Kaunas d. mun.;2005;47;1267;625;642
Kaunas d. mun.;2005;48;1091;537;554
Kaunas d. mun.;2005;49;1108;550;558
Kaunas d. mun.;2005;50;1012;498;514
Kaunas d. mun.;2005;51;963;472;491
Kaunas d. mun.;2005;52;960;456;504
Kaunas d. mun.;2005;53;925;419;506
Kaunas d. mun.;2005;54;967;469;498
Kaunas d. mun.;2005;55;927;427;500
Kaunas d. mun.;2005;56;840;384;456
Kaunas d. mun.;2005;57;762;363;399
Kaunas d. mun.;2005;58;676;299;377
Kaunas d. mun.;2005;59;868;399;469
Kaunas d. mun.;2005;60;754;340;414
Kaunas d. mun.;2005;61;852;393;459
Kaunas d. mun.;2005;62;935;393;542
Kaunas d. mun.;2005;63;899;388;511
Kaunas d. mun.;2005;64;821;376;445
Kaunas d. mun.;2005;65;795;336;459
Kaunas d. mun.;2005;66;781;340;441
Kaunas d. mun.;2005;67;712;308;404
Kaunas d. mun.;2005;68;658;284;374
Kaunas d. mun.;2005;69;757;297;460
Kaunas d. mun.;2005;70;668;281;387
Kaunas d. mun.;2005;71;696;234;462
Kaunas d. mun.;2005;72;689;282;407
Kaunas d. mun.;2005;73;685;239;446
Kaunas d. mun.;2005;74;617;241;376
Kaunas d. mun.;2005;75;523;183;340
Kaunas d. mun.;2005;76;543;179;364
Kaunas d. mun.;2005;77;464;159;305
Kaunas d. mun.;2005;78;444;148;296
Kaunas d. mun.;2005;79;407;110;297
Kaunas d. mun.;2005;80;367;97;270
Kaunas d. mun.;2005;81;337;101;236
Kaunas d. mun.;2005;82;295;70;225
Kaunas d. mun.;2005;83;240;67;173
Kaunas d. mun.;2005;84;195;58;137
Kaunas d. mun.;2005;85;839;175;664
Kaunas d. mun.;2006;-1;83091;39465;43626
Kaunas d. mun.;2006;0;749;391;358
Kaunas d. mun.;2006;1;709;364;345
Kaunas d. mun.;2006;2;820;423;397
Kaunas d. mun.;2006;3;803;415;388
Kaunas d. mun.;2006;4;807;433;374
Kaunas d. mun.;2006;5;846;427;419
Kaunas d. mun.;2006;6;929;491;438
Kaunas d. mun.;2006;7;1007;501;506
Kaunas d. mun.;2006;8;1001;506;495
Kaunas d. mun.;2006;9;1092;564;528
Kaunas d. mun.;2006;10;1127;572;555
Kaunas d. mun.;2006;11;1127;573;554
Kaunas d. mun.;2006;12;1189;618;571
Kaunas d. mun.;2006;13;1380;728;652
Kaunas d. mun.;2006;14;1336;724;612
Kaunas d. mun.;2006;15;1433;751;682
Kaunas d. mun.;2006;16;1260;642;618
Kaunas d. mun.;2006;17;1292;673;619
Kaunas d. mun.;2006;18;1265;628;637
Kaunas d. mun.;2006;19;1395;729;666
Kaunas d. mun.;2006;20;1316;630;686
Kaunas d. mun.;2006;21;1237;638;599
Kaunas d. mun.;2006;22;1187;635;552
Kaunas d. mun.;2006;23;1212;618;594
Kaunas d. mun.;2006;24;1282;631;651
Kaunas d. mun.;2006;25;1214;612;602
Kaunas d. mun.;2006;26;1127;590;537
Kaunas d. mun.;2006;27;1043;506;537
Kaunas d. mun.;2006;28;1053;505;548
Kaunas d. mun.;2006;29;975;495;480
Kaunas d. mun.;2006;30;1050;514;536
Kaunas d. mun.;2006;31;1023;494;529
Kaunas d. mun.;2006;32;1013;497;516
Kaunas d. mun.;2006;33;1133;539;594
Kaunas d. mun.;2006;34;1128;563;565
Kaunas d. mun.;2006;35;1172;569;603
Kaunas d. mun.;2006;36;1210;610;600
Kaunas d. mun.;2006;37;1211;545;666
Kaunas d. mun.;2006;38;1262;597;665
Kaunas d. mun.;2006;39;1178;588;590
Kaunas d. mun.;2006;40;1166;586;580
Kaunas d. mun.;2006;41;1206;591;615
Kaunas d. mun.;2006;42;1302;652;650
Kaunas d. mun.;2006;43;1367;636;731
Kaunas d. mun.;2006;44;1415;656;759
Kaunas d. mun.;2006;45;1477;730;747
Kaunas d. mun.;2006;46;1341;681;660
Kaunas d. mun.;2006;47;1388;660;728
Kaunas d. mun.;2006;48;1267;625;642
Kaunas d. mun.;2006;49;1080;530;550
Kaunas d. mun.;2006;50;1104;546;558
Kaunas d. mun.;2006;51;1017;511;506
Kaunas d. mun.;2006;52;961;458;503
Kaunas d. mun.;2006;53;964;456;508
Kaunas d. mun.;2006;54;915;410;505
Kaunas d. mun.;2006;55;972;474;498
Kaunas d. mun.;2006;56;934;429;505
Kaunas d. mun.;2006;57;835;380;455
Kaunas d. mun.;2006;58;773;366;407
Kaunas d. mun.;2006;59;676;301;375
Kaunas d. mun.;2006;60;863;394;469
Kaunas d. mun.;2006;61;748;335;413
Kaunas d. mun.;2006;62;852;395;457
Kaunas d. mun.;2006;63;943;397;546
Kaunas d. mun.;2006;64;887;382;505
Kaunas d. mun.;2006;65;815;371;444
Kaunas d. mun.;2006;66;791;329;462
Kaunas d. mun.;2006;67;769;333;436
Kaunas d. mun.;2006;68;701;295;406
Kaunas d. mun.;2006;69;647;275;372
Kaunas d. mun.;2006;70;747;296;451
Kaunas d. mun.;2006;71;654;272;382
Kaunas d. mun.;2006;72;665;216;449
Kaunas d. mun.;2006;73;670;271;399
Kaunas d. mun.;2006;74;667;233;434
Kaunas d. mun.;2006;75;608;234;374
Kaunas d. mun.;2006;76;508;175;333
Kaunas d. mun.;2006;77;525;168;357
Kaunas d. mun.;2006;78;450;154;296
Kaunas d. mun.;2006;79;421;141;280
Kaunas d. mun.;2006;80;387;104;283
Kaunas d. mun.;2006;81;344;83;261
Kaunas d. mun.;2006;82;313;95;218
Kaunas d. mun.;2006;83;266;63;203
Kaunas d. mun.;2006;84;216;59;157
Kaunas d. mun.;2006;85;881;188;693
Kaunas d. mun.;2007;-1;83346;39612;43734
Kaunas d. mun.;2007;0;778;396;382
Kaunas d. mun.;2007;1;756;395;361
Kaunas d. mun.;2007;2;702;360;342
Kaunas d. mun.;2007;3;825;428;397
Kaunas d. mun.;2007;4;807;418;389
Kaunas d. mun.;2007;5;806;432;374
Kaunas d. mun.;2007;6;855;432;423
Kaunas d. mun.;2007;7;956;502;454
Kaunas d. mun.;2007;8;1007;501;506
Kaunas d. mun.;2007;9;1013;511;502
Kaunas d. mun.;2007;10;1106;572;534
Kaunas d. mun.;2007;11;1140;581;559
Kaunas d. mun.;2007;12;1140;577;563
Kaunas d. mun.;2007;13;1195;622;573
Kaunas d. mun.;2007;14;1388;733;655
Kaunas d. mun.;2007;15;1349;738;611
Kaunas d. mun.;2007;16;1442;755;687
Kaunas d. mun.;2007;17;1251;637;614
Kaunas d. mun.;2007;18;1289;672;617
Kaunas d. mun.;2007;19;1253;626;627
Kaunas d. mun.;2007;20;1378;718;660
Kaunas d. mun.;2007;21;1279;610;669
Kaunas d. mun.;2007;22;1218;620;598
Kaunas d. mun.;2007;23;1160;609;551
Kaunas d. mun.;2007;24;1187;595;592
Kaunas d. mun.;2007;25;1265;622;643
Kaunas d. mun.;2007;26;1213;610;603
Kaunas d. mun.;2007;27;1122;588;534
Kaunas d. mun.;2007;28;1042;503;539
Kaunas d. mun.;2007;29;1059;501;558
Kaunas d. mun.;2007;30;976;496;480
Kaunas d. mun.;2007;31;1048;514;534
Kaunas d. mun.;2007;32;1041;503;538
Kaunas d. mun.;2007;33;1016;493;523
Kaunas d. mun.;2007;34;1145;549;596
Kaunas d. mun.;2007;35;1132;566;566
Kaunas d. mun.;2007;36;1181;578;603
Kaunas d. mun.;2007;37;1223;613;610
Kaunas d. mun.;2007;38;1214;551;663
Kaunas d. mun.;2007;39;1275;605;670
Kaunas d. mun.;2007;40;1187;594;593
Kaunas d. mun.;2007;41;1161;584;577
Kaunas d. mun.;2007;42;1216;594;622
Kaunas d. mun.;2007;43;1300;648;652
Kaunas d. mun.;2007;44;1362;629;733
Kaunas d. mun.;2007;45;1419;666;753
Kaunas d. mun.;2007;46;1480;733;747
Kaunas d. mun.;2007;47;1341;682;659
Kaunas d. mun.;2007;48;1406;670;736
Kaunas d. mun.;2007;49;1275;629;646
Kaunas d. mun.;2007;50;1079;531;548
Kaunas d. mun.;2007;51;1107;545;562
Kaunas d. mun.;2007;52;1022;519;503
Kaunas d. mun.;2007;53;949;450;499
Kaunas d. mun.;2007;54;956;455;501
Kaunas d. mun.;2007;55;913;411;502
Kaunas d. mun.;2007;56;965;467;498
Kaunas d. mun.;2007;57;924;426;498
Kaunas d. mun.;2007;58;831;372;459
Kaunas d. mun.;2007;59;764;358;406
Kaunas d. mun.;2007;60;678;299;379
Kaunas d. mun.;2007;61;858;388;470
Kaunas d. mun.;2007;62;739;328;411
Kaunas d. mun.;2007;63;837;385;452
Kaunas d. mun.;2007;64;937;396;541
Kaunas d. mun.;2007;65;873;375;498
Kaunas d. mun.;2007;66;799;361;438
Kaunas d. mun.;2007;67;780;322;458
Kaunas d. mun.;2007;68;759;327;432
Kaunas d. mun.;2007;69;681;282;399
Kaunas d. mun.;2007;70;640;272;368
Kaunas d. mun.;2007;71;737;292;445
Kaunas d. mun.;2007;72;640;264;376
Kaunas d. mun.;2007;73;645;206;439
Kaunas d. mun.;2007;74;649;254;395
Kaunas d. mun.;2007;75;651;227;424
Kaunas d. mun.;2007;76;586;220;366
Kaunas d. mun.;2007;77;496;172;324
Kaunas d. mun.;2007;78;502;157;345
Kaunas d. mun.;2007;79;430;143;287
Kaunas d. mun.;2007;80;397;127;270
Kaunas d. mun.;2007;81;365;98;267
Kaunas d. mun.;2007;82;324;75;249
Kaunas d. mun.;2007;83;292;85;207
Kaunas d. mun.;2007;84;245;57;188
Kaunas d. mun.;2007;85;917;205;712
Kaunas d. mun.;2008;-1;83946;39925;44021
Kaunas d. mun.;2008;0;815;430;385
Kaunas d. mun.;2008;1;787;399;388
Kaunas d. mun.;2008;2;767;402;365
Kaunas d. mun.;2008;3;722;368;354
Kaunas d. mun.;2008;4;832;433;399
Kaunas d. mun.;2008;5;813;419;394
Kaunas d. mun.;2008;6;819;446;373
Kaunas d. mun.;2008;7;870;446;424
Kaunas d. mun.;2008;8;968;513;455
Kaunas d. mun.;2008;9;1025;514;511
Kaunas d. mun.;2008;10;1036;522;514
Kaunas d. mun.;2008;11;1115;578;537
Kaunas d. mun.;2008;12;1148;583;565
Kaunas d. mun.;2008;13;1163;592;571
Kaunas d. mun.;2008;14;1216;634;582
Kaunas d. mun.;2008;15;1394;740;654
Kaunas d. mun.;2008;16;1362;748;614
Kaunas d. mun.;2008;17;1445;762;683
Kaunas d. mun.;2008;18;1252;639;613
Kaunas d. mun.;2008;19;1278;670;608
Kaunas d. mun.;2008;20;1239;623;616
Kaunas d. mun.;2008;21;1357;703;654
Kaunas d. mun.;2008;22;1270;612;658
Kaunas d. mun.;2008;23;1211;620;591
Kaunas d. mun.;2008;24;1153;603;550
Kaunas d. mun.;2008;25;1189;594;595
Kaunas d. mun.;2008;26;1264;614;650
Kaunas d. mun.;2008;27;1212;601;611
Kaunas d. mun.;2008;28;1135;588;547
Kaunas d. mun.;2008;29;1047;515;532
Kaunas d. mun.;2008;30;1102;524;578
Kaunas d. mun.;2008;31;1009;507;502
Kaunas d. mun.;2008;32;1063;521;542
Kaunas d. mun.;2008;33;1059;502;557
Kaunas d. mun.;2008;34;1052;511;541
Kaunas d. mun.;2008;35;1162;553;609
Kaunas d. mun.;2008;36;1141;569;572
Kaunas d. mun.;2008;37;1190;582;608
Kaunas d. mun.;2008;38;1240;635;605
Kaunas d. mun.;2008;39;1208;540;668
Kaunas d. mun.;2008;40;1286;609;677
Kaunas d. mun.;2008;41;1201;601;600
Kaunas d. mun.;2008;42;1179;600;579
Kaunas d. mun.;2008;43;1222;597;625
Kaunas d. mun.;2008;44;1292;639;653
Kaunas d. mun.;2008;45;1341;620;721
Kaunas d. mun.;2008;46;1420;667;753
Kaunas d. mun.;2008;47;1477;727;750
Kaunas d. mun.;2008;48;1350;683;667
Kaunas d. mun.;2008;49;1422;677;745
Kaunas d. mun.;2008;50;1268;624;644
Kaunas d. mun.;2008;51;1076;529;547
Kaunas d. mun.;2008;52;1111;546;565
Kaunas d. mun.;2008;53;1016;510;506
Kaunas d. mun.;2008;54;946;445;501
Kaunas d. mun.;2008;55;950;450;500
Kaunas d. mun.;2008;56;913;407;506
Kaunas d. mun.;2008;57;959;463;496
Kaunas d. mun.;2008;58;920;422;498
Kaunas d. mun.;2008;59;825;367;458
Kaunas d. mun.;2008;60;763;353;410
Kaunas d. mun.;2008;61;669;295;374
Kaunas d. mun.;2008;62;867;389;478
Kaunas d. mun.;2008;63;732;319;413
Kaunas d. mun.;2008;64;827;372;455
Kaunas d. mun.;2008;65;932;393;539
Kaunas d. mun.;2008;66;853;362;491
Kaunas d. mun.;2008;67;787;348;439
Kaunas d. mun.;2008;68;772;311;461
Kaunas d. mun.;2008;69;746;315;431
Kaunas d. mun.;2008;70;676;278;398
Kaunas d. mun.;2008;71;632;271;361
Kaunas d. mun.;2008;72;710;273;437
Kaunas d. mun.;2008;73;622;255;367
Kaunas d. mun.;2008;74;614;189;425
Kaunas d. mun.;2008;75;629;243;386
Kaunas d. mun.;2008;76;622;217;405
Kaunas d. mun.;2008;77;558;205;353
Kaunas d. mun.;2008;78;477;158;319
Kaunas d. mun.;2008;79;475;140;335
Kaunas d. mun.;2008;80;403;132;271
Kaunas d. mun.;2008;81;381;119;262
Kaunas d. mun.;2008;82;342;89;253
Kaunas d. mun.;2008;83;305;66;239
Kaunas d. mun.;2008;84;262;74;188
Kaunas d. mun.;2008;85;986;221;765
Kaunas d. mun.;2009;-1;85752;40848;44904
Kaunas d. mun.;2009;0;858;420;438
Kaunas d. mun.;2009;1;830;435;395
Kaunas d. mun.;2009;2;815;420;395
Kaunas d. mun.;2009;3;795;414;381
Kaunas d. mun.;2009;4;755;387;368
Kaunas d. mun.;2009;5;848;444;404
Kaunas d. mun.;2009;6;854;438;416
Kaunas d. mun.;2009;7;851;462;389
Kaunas d. mun.;2009;8;899;459;440
Kaunas d. mun.;2009;9;1010;526;484
Kaunas d. mun.;2009;10;1059;536;523
Kaunas d. mun.;2009;11;1068;544;524
Kaunas d. mun.;2009;12;1167;603;564
Kaunas d. mun.;2009;13;1184;608;576
Kaunas d. mun.;2009;14;1197;604;593
Kaunas d. mun.;2009;15;1235;640;595
Kaunas d. mun.;2009;16;1419;753;666
Kaunas d. mun.;2009;17;1386;761;625
Kaunas d. mun.;2009;18;1468;778;690
Kaunas d. mun.;2009;19;1253;636;617
Kaunas d. mun.;2009;20;1280;670;610
Kaunas d. mun.;2009;21;1258;631;627
Kaunas d. mun.;2009;22;1356;707;649
Kaunas d. mun.;2009;23;1274;616;658
Kaunas d. mun.;2009;24;1223;626;597
Kaunas d. mun.;2009;25;1185;618;567
Kaunas d. mun.;2009;26;1220;609;611
Kaunas d. mun.;2009;27;1291;638;653
Kaunas d. mun.;2009;28;1256;611;645
Kaunas d. mun.;2009;29;1182;608;574
Kaunas d. mun.;2009;30;1113;550;563
Kaunas d. mun.;2009;31;1134;545;589
Kaunas d. mun.;2009;32;1056;540;516
Kaunas d. mun.;2009;33;1116;545;571
Kaunas d. mun.;2009;34;1112;521;591
Kaunas d. mun.;2009;35;1089;525;564
Kaunas d. mun.;2009;36;1209;581;628
Kaunas d. mun.;2009;37;1173;591;582
Kaunas d. mun.;2009;38;1226;617;609
Kaunas d. mun.;2009;39;1277;658;619
Kaunas d. mun.;2009;40;1251;561;690
Kaunas d. mun.;2009;41;1305;625;680
Kaunas d. mun.;2009;42;1232;620;612
Kaunas d. mun.;2009;43;1211;617;594
Kaunas d. mun.;2009;44;1250;622;628
Kaunas d. mun.;2009;45;1318;653;665
Kaunas d. mun.;2009;46;1360;631;729
Kaunas d. mun.;2009;47;1431;676;755
Kaunas d. mun.;2009;48;1494;736;758
Kaunas d. mun.;2009;49;1367;687;680
Kaunas d. mun.;2009;50;1447;684;763
Kaunas d. mun.;2009;51;1270;623;647
Kaunas d. mun.;2009;52;1082;529;553
Kaunas d. mun.;2009;53;1106;546;560
Kaunas d. mun.;2009;54;1017;508;509
Kaunas d. mun.;2009;55;953;451;502
Kaunas d. mun.;2009;56;954;446;508
Kaunas d. mun.;2009;57;915;407;508
Kaunas d. mun.;2009;58;956;460;496
Kaunas d. mun.;2009;59;929;422;507
Kaunas d. mun.;2009;60;813;357;456
Kaunas d. mun.;2009;61;756;345;411
Kaunas d. mun.;2009;62;671;294;377
Kaunas d. mun.;2009;63;857;381;476
Kaunas d. mun.;2009;64;713;303;410
Kaunas d. mun.;2009;65;826;369;457
Kaunas d. mun.;2009;66;937;383;554
Kaunas d. mun.;2009;67;838;352;486
Kaunas d. mun.;2009;68;780;340;440
Kaunas d. mun.;2009;69;764;311;453
Kaunas d. mun.;2009;70;738;311;427
Kaunas d. mun.;2009;71;658;266;392
Kaunas d. mun.;2009;72;618;259;359
Kaunas d. mun.;2009;73;699;264;435
Kaunas d. mun.;2009;74;601;238;363
Kaunas d. mun.;2009;75;598;178;420
Kaunas d. mun.;2009;76;611;228;383
Kaunas d. mun.;2009;77;584;192;392
Kaunas d. mun.;2009;78;532;188;344
Kaunas d. mun.;2009;79;459;150;309
Kaunas d. mun.;2009;80;449;133;316
Kaunas d. mun.;2009;81;379;119;260
Kaunas d. mun.;2009;82;351;109;242
Kaunas d. mun.;2009;83;316;79;237
Kaunas d. mun.;2009;84;283;61;222
Kaunas d. mun.;2009;85;1092;259;833
Kaunas d. mun.;2010;-1;86978;41424;45554
Kaunas d. mun.;2010;0;946;494;452
Kaunas d. mun.;2010;1;895;436;459
Kaunas d. mun.;2010;2;853;445;408
Kaunas d. mun.;2010;3;834;426;408
Kaunas d. mun.;2010;4;806;414;392
Kaunas d. mun.;2010;5;785;401;384
Kaunas d. mun.;2010;6;885;460;425
Kaunas d. mun.;2010;7;892;460;432
Kaunas d. mun.;2010;8;854;469;385
Kaunas d. mun.;2010;9;917;469;448
Kaunas d. mun.;2010;10;1038;541;497
Kaunas d. mun.;2010;11;1084;548;536
Kaunas d. mun.;2010;12;1080;558;522
Kaunas d. mun.;2010;13;1189;617;572
Kaunas d. mun.;2010;14;1190;613;577
Kaunas d. mun.;2010;15;1206;609;597
Kaunas d. mun.;2010;16;1239;641;598
Kaunas d. mun.;2010;17;1437;764;673
Kaunas d. mun.;2010;18;1391;758;633
Kaunas d. mun.;2010;19;1458;765;693
Kaunas d. mun.;2010;20;1243;630;613
Kaunas d. mun.;2010;21;1277;667;610
Kaunas d. mun.;2010;22;1254;626;628
Kaunas d. mun.;2010;23;1337;694;643
Kaunas d. mun.;2010;24;1285;616;669
Kaunas d. mun.;2010;25;1239;627;612
Kaunas d. mun.;2010;26;1217;627;590
Kaunas d. mun.;2010;27;1258;628;630
Kaunas d. mun.;2010;28;1318;660;658
Kaunas d. mun.;2010;29;1280;626;654
Kaunas d. mun.;2010;30;1221;619;602
Kaunas d. mun.;2010;31;1154;568;586
Kaunas d. mun.;2010;32;1147;552;595
Kaunas d. mun.;2010;33;1104;565;539
Kaunas d. mun.;2010;34;1151;570;581
Kaunas d. mun.;2010;35;1135;535;600
Kaunas d. mun.;2010;36;1114;540;574
Kaunas d. mun.;2010;37;1201;576;625
Kaunas d. mun.;2010;38;1207;605;602
Kaunas d. mun.;2010;39;1250;624;626
Kaunas d. mun.;2010;40;1280;654;626
Kaunas d. mun.;2010;41;1266;569;697
Kaunas d. mun.;2010;42;1303;622;681
Kaunas d. mun.;2010;43;1241;627;614
Kaunas d. mun.;2010;44;1213;618;595
Kaunas d. mun.;2010;45;1248;618;630
Kaunas d. mun.;2010;46;1319;657;662
Kaunas d. mun.;2010;47;1371;630;741
Kaunas d. mun.;2010;48;1439;680;759
Kaunas d. mun.;2010;49;1498;738;760
Kaunas d. mun.;2010;50;1374;679;695
Kaunas d. mun.;2010;51;1459;689;770
Kaunas d. mun.;2010;52;1278;628;650
Kaunas d. mun.;2010;53;1083;528;555
Kaunas d. mun.;2010;54;1107;543;564
Kaunas d. mun.;2010;55;1029;511;518
Kaunas d. mun.;2010;56;948;439;509
Kaunas d. mun.;2010;57;948;436;512
Kaunas d. mun.;2010;58;916;409;507
Kaunas d. mun.;2010;59;950;458;492
Kaunas d. mun.;2010;60;917;417;500
Kaunas d. mun.;2010;61;813;359;454
Kaunas d. mun.;2010;62;751;341;410
Kaunas d. mun.;2010;63;672;293;379
Kaunas d. mun.;2010;64;844;375;469
Kaunas d. mun.;2010;65;700;293;407
Kaunas d. mun.;2010;66;822;359;463
Kaunas d. mun.;2010;67;933;376;557
Kaunas d. mun.;2010;68;824;340;484
Kaunas d. mun.;2010;69;771;333;438
Kaunas d. mun.;2010;70;749;304;445
Kaunas d. mun.;2010;71;730;310;420
Kaunas d. mun.;2010;72;646;254;392
Kaunas d. mun.;2010;73;600;247;353
Kaunas d. mun.;2010;74;686;257;429
Kaunas d. mun.;2010;75;587;231;356
Kaunas d. mun.;2010;76;585;172;413
Kaunas d. mun.;2010;77;590;218;372
Kaunas d. mun.;2010;78;566;181;385
Kaunas d. mun.;2010;79;521;187;334
Kaunas d. mun.;2010;80;434;142;292
Kaunas d. mun.;2010;81;426;124;302
Kaunas d. mun.;2010;82;358;106;252
Kaunas d. mun.;2010;83;319;94;225
Kaunas d. mun.;2010;84;296;70;226
Kaunas d. mun.;2010;85;1197;265;932
Kaunas d. mun.;2011;-1;85922;40903;45019
Kaunas d. mun.;2011;0;1113;592;521
Kaunas d. mun.;2011;1;1134;579;555
Kaunas d. mun.;2011;2;1028;517;511
Kaunas d. mun.;2011;3;938;498;440
Kaunas d. mun.;2011;4;868;448;420
Kaunas d. mun.;2011;5;902;439;463
Kaunas d. mun.;2011;6;819;412;407
Kaunas d. mun.;2011;7;912;469;443
Kaunas d. mun.;2011;8;903;454;449
Kaunas d. mun.;2011;9;855;483;372
Kaunas d. mun.;2011;10;941;469;472
Kaunas d. mun.;2011;11;1045;551;494
Kaunas d. mun.;2011;12;1053;514;539
Kaunas d. mun.;2011;13;1045;531;514
Kaunas d. mun.;2011;14;1178;604;574
Kaunas d. mun.;2011;15;1141;596;545
Kaunas d. mun.;2011;16;1167;601;566
Kaunas d. mun.;2011;17;1204;617;587
Kaunas d. mun.;2011;18;1402;740;662
Kaunas d. mun.;2011;19;1328;726;602
Kaunas d. mun.;2011;20;1406;763;643
Kaunas d. mun.;2011;21;1242;613;629
Kaunas d. mun.;2011;22;1193;626;567
Kaunas d. mun.;2011;23;1176;589;587
Kaunas d. mun.;2011;24;1270;668;602
Kaunas d. mun.;2011;25;1210;558;652
Kaunas d. mun.;2011;26;1166;597;569
Kaunas d. mun.;2011;27;1155;593;562
Kaunas d. mun.;2011;28;1085;538;547
Kaunas d. mun.;2011;29;1169;575;594
Kaunas d. mun.;2011;30;1139;567;572
Kaunas d. mun.;2011;31;1141;584;557
Kaunas d. mun.;2011;32;1104;539;565
Kaunas d. mun.;2011;33;1141;546;595
Kaunas d. mun.;2011;34;1143;569;574
Kaunas d. mun.;2011;35;1170;576;594
Kaunas d. mun.;2011;36;1186;586;600
Kaunas d. mun.;2011;37;1204;577;627
Kaunas d. mun.;2011;38;1262;619;643
Kaunas d. mun.;2011;39;1231;608;623
Kaunas d. mun.;2011;40;1252;609;643
Kaunas d. mun.;2011;41;1230;617;613
Kaunas d. mun.;2011;42;1292;601;691
Kaunas d. mun.;2011;43;1309;633;676
Kaunas d. mun.;2011;44;1240;601;639
Kaunas d. mun.;2011;45;1246;639;607
Kaunas d. mun.;2011;46;1236;615;621
Kaunas d. mun.;2011;47;1362;690;672
Kaunas d. mun.;2011;48;1352;635;717
Kaunas d. mun.;2011;49;1429;663;766
Kaunas d. mun.;2011;50;1382;672;710
Kaunas d. mun.;2011;51;1326;655;671
Kaunas d. mun.;2011;52;1377;648;729
Kaunas d. mun.;2011;53;1232;593;639
Kaunas d. mun.;2011;54;1049;510;539
Kaunas d. mun.;2011;55;1053;515;538
Kaunas d. mun.;2011;56;993;492;501
Kaunas d. mun.;2011;57;904;440;464
Kaunas d. mun.;2011;58;931;427;504
Kaunas d. mun.;2011;59;929;420;509
Kaunas d. mun.;2011;60;942;451;491
Kaunas d. mun.;2011;61;870;396;474
Kaunas d. mun.;2011;62;770;323;447
Kaunas d. mun.;2011;63;710;321;389
Kaunas d. mun.;2011;64;640;270;370
Kaunas d. mun.;2011;65;780;340;440
Kaunas d. mun.;2011;66;644;271;373
Kaunas d. mun.;2011;67;811;362;449
Kaunas d. mun.;2011;68;867;342;525
Kaunas d. mun.;2011;69;768;309;459
Kaunas d. mun.;2011;70;728;298;430
Kaunas d. mun.;2011;71;711;281;430
Kaunas d. mun.;2011;72;698;278;420
Kaunas d. mun.;2011;73;617;247;370
Kaunas d. mun.;2011;74;567;223;344
Kaunas d. mun.;2011;75;625;227;398
Kaunas d. mun.;2011;76;542;199;343
Kaunas d. mun.;2011;77;541;161;380
Kaunas d. mun.;2011;78;549;195;354
Kaunas d. mun.;2011;79;518;160;358
Kaunas d. mun.;2011;80;470;158;312
Kaunas d. mun.;2011;81;397;123;274
Kaunas d. mun.;2011;82;393;104;289
Kaunas d. mun.;2011;83;335;93;242
Kaunas d. mun.;2011;84;301;75;226
Kaunas d. mun.;2011;85;1235;290;945
Kaunas d. mun.;2012;-1;86109;41036;45073
Kaunas d. mun.;2012;0;908;487;421
Kaunas d. mun.;2012;1;1105;591;514
Kaunas d. mun.;2012;2;1137;578;559
Kaunas d. mun.;2012;3;1030;537;493
Kaunas d. mun.;2012;4;941;500;441
Kaunas d. mun.;2012;5;889;469;420
Kaunas d. mun.;2012;6;905;438;467
Kaunas d. mun.;2012;7;819;415;404
Kaunas d. mun.;2012;8;922;469;453
Kaunas d. mun.;2012;9;918;456;462
Kaunas d. mun.;2012;10;870;488;382
Kaunas d. mun.;2012;11;948;478;470
Kaunas d. mun.;2012;12;1050;552;498
Kaunas d. mun.;2012;13;1074;522;552
Kaunas d. mun.;2012;14;1049;532;517
Kaunas d. mun.;2012;15;1198;613;585
Kaunas d. mun.;2012;16;1139;592;547
Kaunas d. mun.;2012;17;1174;605;569
Kaunas d. mun.;2012;18;1196;614;582
Kaunas d. mun.;2012;19;1352;718;634
Kaunas d. mun.;2012;20;1312;721;591
Kaunas d. mun.;2012;21;1379;752;627
Kaunas d. mun.;2012;22;1208;601;607
Kaunas d. mun.;2012;23;1159;603;556
Kaunas d. mun.;2012;24;1155;583;572
Kaunas d. mun.;2012;25;1239;650;589
Kaunas d. mun.;2012;26;1159;543;616
Kaunas d. mun.;2012;27;1135;578;557
Kaunas d. mun.;2012;28;1162;603;559
Kaunas d. mun.;2012;29;1084;545;539
Kaunas d. mun.;2012;30;1182;578;604
Kaunas d. mun.;2012;31;1138;570;568
Kaunas d. mun.;2012;32;1138;577;561
Kaunas d. mun.;2012;33;1122;547;575
Kaunas d. mun.;2012;34;1161;550;611
Kaunas d. mun.;2012;35;1160;571;589
Kaunas d. mun.;2012;36;1184;583;601
Kaunas d. mun.;2012;37;1203;593;610
Kaunas d. mun.;2012;38;1206;577;629
Kaunas d. mun.;2012;39;1253;612;641
Kaunas d. mun.;2012;40;1251;625;626
Kaunas d. mun.;2012;41;1261;611;650
Kaunas d. mun.;2012;42;1248;628;620
Kaunas d. mun.;2012;43;1299;605;694
Kaunas d. mun.;2012;44;1298;627;671
Kaunas d. mun.;2012;45;1240;605;635
Kaunas d. mun.;2012;46;1239;639;600
Kaunas d. mun.;2012;47;1230;608;622
Kaunas d. mun.;2012;48;1367;690;677
Kaunas d. mun.;2012;49;1346;622;724
Kaunas d. mun.;2012;50;1407;649;758
Kaunas d. mun.;2012;51;1376;671;705
Kaunas d. mun.;2012;52;1330;662;668
Kaunas d. mun.;2012;53;1373;641;732
Kaunas d. mun.;2012;54;1228;588;640
Kaunas d. mun.;2012;55;1031;496;535
Kaunas d. mun.;2012;56;1041;515;526
Kaunas d. mun.;2012;57;976;483;493
Kaunas d. mun.;2012;58;901;436;465
Kaunas d. mun.;2012;59;910;414;496
Kaunas d. mun.;2012;60;934;418;516
Kaunas d. mun.;2012;61;934;445;489
Kaunas d. mun.;2012;62;864;392;472
Kaunas d. mun.;2012;63;770;311;459
Kaunas d. mun.;2012;64;705;314;391
Kaunas d. mun.;2012;65;633;261;372
Kaunas d. mun.;2012;66;776;334;442
Kaunas d. mun.;2012;67;635;267;368
Kaunas d. mun.;2012;68;794;350;444
Kaunas d. mun.;2012;69;843;326;517
Kaunas d. mun.;2012;70;754;298;456
Kaunas d. mun.;2012;71;718;292;426
Kaunas d. mun.;2012;72;695;268;427
Kaunas d. mun.;2012;73;677;258;419
Kaunas d. mun.;2012;74;607;241;366
Kaunas d. mun.;2012;75;545;208;337
Kaunas d. mun.;2012;76;611;216;395
Kaunas d. mun.;2012;77;523;196;327
Kaunas d. mun.;2012;78;514;151;363
Kaunas d. mun.;2012;79;529;183;346
Kaunas d. mun.;2012;80;504;157;347
Kaunas d. mun.;2012;81;428;139;289
Kaunas d. mun.;2012;82;378;114;264
Kaunas d. mun.;2012;83;376;94;282
Kaunas d. mun.;2012;84;317;86;231
Kaunas d. mun.;2012;85;1330;311;1019
Kaunas d. mun.;2013;-1;86419;41239;45180
Kaunas d. mun.;2013;0;924;476;448
Kaunas d. mun.;2013;1;893;487;406
Kaunas d. mun.;2013;2;1045;546;499
Kaunas d. mun.;2013;3;1102;559;543
Kaunas d. mun.;2013;4;1038;542;496
Kaunas d. mun.;2013;5;929;494;435
Kaunas d. mun.;2013;6;895;471;424
Kaunas d. mun.;2013;7;922;451;471
Kaunas d. mun.;2013;8;827;414;413
Kaunas d. mun.;2013;9;924;472;452
Kaunas d. mun.;2013;10;921;465;456
Kaunas d. mun.;2013;11;888;503;385
Kaunas d. mun.;2013;12;957;484;473
Kaunas d. mun.;2013;13;1052;551;501
Kaunas d. mun.;2013;14;1080;526;554
Kaunas d. mun.;2013;15;1055;531;524
Kaunas d. mun.;2013;16;1204;614;590
Kaunas d. mun.;2013;17;1138;596;542
Kaunas d. mun.;2013;18;1165;601;564
Kaunas d. mun.;2013;19;1165;608;557
Kaunas d. mun.;2013;20;1337;720;617
Kaunas d. mun.;2013;21;1302;707;595
Kaunas d. mun.;2013;22;1368;747;621
Kaunas d. mun.;2013;23;1195;602;593
Kaunas d. mun.;2013;24;1145;591;554
Kaunas d. mun.;2013;25;1172;588;584
Kaunas d. mun.;2013;26;1243;649;594
Kaunas d. mun.;2013;27;1132;537;595
Kaunas d. mun.;2013;28;1149;582;567
Kaunas d. mun.;2013;29;1184;623;561
Kaunas d. mun.;2013;30;1093;557;536
Kaunas d. mun.;2013;31;1193;591;602
Kaunas d. mun.;2013;32;1164;587;577
Kaunas d. mun.;2013;33;1148;572;576
Kaunas d. mun.;2013;34;1133;552;581
Kaunas d. mun.;2013;35;1184;561;623
Kaunas d. mun.;2013;36;1173;577;596
Kaunas d. mun.;2013;37;1211;603;608
Kaunas d. mun.;2013;38;1215;600;615
Kaunas d. mun.;2013;39;1229;590;639
Kaunas d. mun.;2013;40;1244;607;637
Kaunas d. mun.;2013;41;1263;629;634
Kaunas d. mun.;2013;42;1273;620;653
Kaunas d. mun.;2013;43;1253;633;620
Kaunas d. mun.;2013;44;1309;607;702
Kaunas d. mun.;2013;45;1284;619;665
Kaunas d. mun.;2013;46;1228;597;631
Kaunas d. mun.;2013;47;1240;631;609
Kaunas d. mun.;2013;48;1229;606;623
Kaunas d. mun.;2013;49;1368;692;676
Kaunas d. mun.;2013;50;1344;619;725
Kaunas d. mun.;2013;51;1411;649;762
Kaunas d. mun.;2013;52;1354;657;697
Kaunas d. mun.;2013;53;1331;665;666
Kaunas d. mun.;2013;54;1364;632;732
Kaunas d. mun.;2013;55;1220;578;642
Kaunas d. mun.;2013;56;1026;492;534
Kaunas d. mun.;2013;57;1032;511;521
Kaunas d. mun.;2013;58;984;492;492
Kaunas d. mun.;2013;59;904;437;467
Kaunas d. mun.;2013;60;908;405;503
Kaunas d. mun.;2013;61;919;406;513
Kaunas d. mun.;2013;62;915;432;483
Kaunas d. mun.;2013;63;852;386;466
Kaunas d. mun.;2013;64;768;310;458
Kaunas d. mun.;2013;65;701;308;393
Kaunas d. mun.;2013;66;627;252;375
Kaunas d. mun.;2013;67;765;329;436
Kaunas d. mun.;2013;68;618;257;361
Kaunas d. mun.;2013;69;772;336;436
Kaunas d. mun.;2013;70;826;315;511
Kaunas d. mun.;2013;71;737;292;445
Kaunas d. mun.;2013;72;703;286;417
Kaunas d. mun.;2013;73;685;264;421
Kaunas d. mun.;2013;74;660;242;418
Kaunas d. mun.;2013;75;581;225;356
Kaunas d. mun.;2013;76;527;197;330
Kaunas d. mun.;2013;77;591;207;384
Kaunas d. mun.;2013;78;497;181;316
Kaunas d. mun.;2013;79;498;143;355
Kaunas d. mun.;2013;80;491;162;329
Kaunas d. mun.;2013;81;477;147;330
Kaunas d. mun.;2013;82;402;128;274
Kaunas d. mun.;2013;83;353;101;252
Kaunas d. mun.;2013;84;344;85;259
Kaunas d. mun.;2013;85;1447;343;1104
Kaunas d. mun.;2014;-1;87138;41671;45467
Kaunas d. mun.;2014;0;933;480;453
Kaunas d. mun.;2014;1;912;472;440
Kaunas d. mun.;2014;2;841;461;380
Kaunas d. mun.;2014;3;1030;530;500
Kaunas d. mun.;2014;4;1100;557;543
Kaunas d. mun.;2014;5;1043;547;496
Kaunas d. mun.;2014;6;945;503;442
Kaunas d. mun.;2014;7;923;491;432
Kaunas d. mun.;2014;8;943;462;481
Kaunas d. mun.;2014;9;828;415;413
Kaunas d. mun.;2014;10;941;488;453
Kaunas d. mun.;2014;11;948;480;468
Kaunas d. mun.;2014;12;899;512;387
Kaunas d. mun.;2014;13;961;487;474
Kaunas d. mun.;2014;14;1050;552;498
Kaunas d. mun.;2014;15;1063;520;543
Kaunas d. mun.;2014;16;1075;539;536
Kaunas d. mun.;2014;17;1207;610;597
Kaunas d. mun.;2014;18;1128;594;534
Kaunas d. mun.;2014;19;1142;588;554
Kaunas d. mun.;2014;20;1159;608;551
Kaunas d. mun.;2014;21;1327;715;612
Kaunas d. mun.;2014;22;1290;704;586
Kaunas d. mun.;2014;23;1338;732;606
Kaunas d. mun.;2014;24;1188;596;592
Kaunas d. mun.;2014;25;1171;613;558
Kaunas d. mun.;2014;26;1188;589;599
Kaunas d. mun.;2014;27;1253;650;603
Kaunas d. mun.;2014;28;1171;561;610
Kaunas d. mun.;2014;29;1182;600;582
Kaunas d. mun.;2014;30;1209;632;577
Kaunas d. mun.;2014;31;1103;573;530
Kaunas d. mun.;2014;32;1213;609;604
Kaunas d. mun.;2014;33;1189;609;580
Kaunas d. mun.;2014;34;1178;594;584
Kaunas d. mun.;2014;35;1159;568;591
Kaunas d. mun.;2014;36;1196;579;617
Kaunas d. mun.;2014;37;1189;574;615
Kaunas d. mun.;2014;38;1251;629;622
Kaunas d. mun.;2014;39;1229;615;614
Kaunas d. mun.;2014;40;1236;592;644
Kaunas d. mun.;2014;41;1251;613;638
Kaunas d. mun.;2014;42;1278;633;645
Kaunas d. mun.;2014;43;1288;626;662
Kaunas d. mun.;2014;44;1264;642;622
Kaunas d. mun.;2014;45;1309;595;714
Kaunas d. mun.;2014;46;1283;619;664
Kaunas d. mun.;2014;47;1229;596;633
Kaunas d. mun.;2014;48;1222;618;604
Kaunas d. mun.;2014;49;1237;610;627
Kaunas d. mun.;2014;50;1371;689;682
Kaunas d. mun.;2014;51;1352;622;730
Kaunas d. mun.;2014;52;1411;644;767
Kaunas d. mun.;2014;53;1356;661;695
Kaunas d. mun.;2014;54;1326;664;662
Kaunas d. mun.;2014;55;1370;628;742
Kaunas d. mun.;2014;56;1200;559;641
Kaunas d. mun.;2014;57;1031;496;535
Kaunas d. mun.;2014;58;1041;509;532
Kaunas d. mun.;2014;59;1000;503;497
Kaunas d. mun.;2014;60;911;441;470
Kaunas d. mun.;2014;61;907;406;501
Kaunas d. mun.;2014;62;920;404;516
Kaunas d. mun.;2014;63;901;417;484
Kaunas d. mun.;2014;64;853;386;467
Kaunas d. mun.;2014;65;765;309;456
Kaunas d. mun.;2014;66;693;305;388
Kaunas d. mun.;2014;67;622;249;373
Kaunas d. mun.;2014;68;747;316;431
Kaunas d. mun.;2014;69;603;246;357
Kaunas d. mun.;2014;70;767;329;438
Kaunas d. mun.;2014;71;815;305;510
Kaunas d. mun.;2014;72;721;282;439
Kaunas d. mun.;2014;73;679;274;405
Kaunas d. mun.;2014;74;672;258;414
Kaunas d. mun.;2014;75;645;234;411
Kaunas d. mun.;2014;76;564;215;349
Kaunas d. mun.;2014;77;503;181;322
Kaunas d. mun.;2014;78;571;198;373
Kaunas d. mun.;2014;79;477;167;310
Kaunas d. mun.;2014;80;474;135;339
Kaunas d. mun.;2014;81;460;154;306
Kaunas d. mun.;2014;82;451;132;319
Kaunas d. mun.;2014;83;373;115;258
Kaunas d. mun.;2014;84;326;94;232
Kaunas d. mun.;2014;85;1568;362;1206
Kaunas d. mun.;2015;-1;88396;42409;45987
Kaunas d. mun.;2015;0;918;453;465
Kaunas d. mun.;2015;1;923;485;438
Kaunas d. mun.;2015;2;867;449;418
Kaunas d. mun.;2015;3;859;469;390
Kaunas d. mun.;2015;4;1066;548;518
Kaunas d. mun.;2015;5;1118;565;553
Kaunas d. mun.;2015;6;1064;550;514
Kaunas d. mun.;2015;7;984;522;462
Kaunas d. mun.;2015;8;940;502;438
Kaunas d. mun.;2015;9;948;470;478
Kaunas d. mun.;2015;10;846;429;417
Kaunas d. mun.;2015;11;962;500;462
Kaunas d. mun.;2015;12;956;480;476
Kaunas d. mun.;2015;13;909;516;393
Kaunas d. mun.;2015;14;959;491;468
Kaunas d. mun.;2015;15;1076;571;505
Kaunas d. mun.;2015;16;1071;519;552
Kaunas d. mun.;2015;17;1072;542;530
Kaunas d. mun.;2015;18;1215;606;609
Kaunas d. mun.;2015;19;1113;588;525
Kaunas d. mun.;2015;20;1144;594;550
Kaunas d. mun.;2015;21;1165;606;559
Kaunas d. mun.;2015;22;1338;719;619
Kaunas d. mun.;2015;23;1261;685;576
Kaunas d. mun.;2015;24;1354;728;626
Kaunas d. mun.;2015;25;1223;612;611
Kaunas d. mun.;2015;26;1195;629;566
Kaunas d. mun.;2015;27;1199;584;615
Kaunas d. mun.;2015;28;1333;693;640
Kaunas d. mun.;2015;29;1232;590;642
Kaunas d. mun.;2015;30;1244;652;592
Kaunas d. mun.;2015;31;1250;663;587
Kaunas d. mun.;2015;32;1131;598;533
Kaunas d. mun.;2015;33;1250;636;614
Kaunas d. mun.;2015;34;1222;630;592
Kaunas d. mun.;2015;35;1221;626;595
Kaunas d. mun.;2015;36;1174;587;587
Kaunas d. mun.;2015;37;1212;590;622
Kaunas d. mun.;2015;38;1204;584;620
Kaunas d. mun.;2015;39;1270;635;635
Kaunas d. mun.;2015;40;1242;626;616
Kaunas d. mun.;2015;41;1261;601;660
Kaunas d. mun.;2015;42;1278;624;654
Kaunas d. mun.;2015;43;1298;649;649
Kaunas d. mun.;2015;44;1319;646;673
Kaunas d. mun.;2015;45;1283;656;627
Kaunas d. mun.;2015;46;1316;600;716
Kaunas d. mun.;2015;47;1310;640;670
Kaunas d. mun.;2015;48;1234;598;636
Kaunas d. mun.;2015;49;1214;613;601
Kaunas d. mun.;2015;50;1242;613;629
Kaunas d. mun.;2015;51;1389;695;694
Kaunas d. mun.;2015;52;1369;633;736
Kaunas d. mun.;2015;53;1424;647;777
Kaunas d. mun.;2015;54;1359;658;701
Kaunas d. mun.;2015;55;1325;664;661
Kaunas d. mun.;2015;56;1385;633;752
Kaunas d. mun.;2015;57;1188;543;645
Kaunas d. mun.;2015;58;1025;489;536
Kaunas d. mun.;2015;59;1032;506;526
Kaunas d. mun.;2015;60;995;500;495
Kaunas d. mun.;2015;61;909;440;469
Kaunas d. mun.;2015;62;904;403;501
Kaunas d. mun.;2015;63;912;396;516
Kaunas d. mun.;2015;64;911;417;494
Kaunas d. mun.;2015;65;860;387;473
Kaunas d. mun.;2015;66;770;311;459
Kaunas d. mun.;2015;67;691;299;392
Kaunas d. mun.;2015;68;617;242;375
Kaunas d. mun.;2015;69;739;312;427
Kaunas d. mun.;2015;70;595;245;350
Kaunas d. mun.;2015;71;761;327;434
Kaunas d. mun.;2015;72;796;292;504
Kaunas d. mun.;2015;73;714;278;436
Kaunas d. mun.;2015;74;664;267;397
Kaunas d. mun.;2015;75;654;250;404
Kaunas d. mun.;2015;76;622;223;399
Kaunas d. mun.;2015;77;532;195;337
Kaunas d. mun.;2015;78;494;175;319
Kaunas d. mun.;2015;79;545;187;358
Kaunas d. mun.;2015;80;447;147;300
Kaunas d. mun.;2015;81;458;131;327
Kaunas d. mun.;2015;82;433;145;288
Kaunas d. mun.;2015;83;424;130;294
Kaunas d. mun.;2015;84;344;103;241
Kaunas d. mun.;2015;85;1624;377;1247
Kaunas d. mun.;2016;-1;89516;43018;46498
Kaunas d. mun.;2016;0;1054;535;519
Kaunas d. mun.;2016;1;893;445;448
Kaunas d. mun.;2016;2;911;466;445
Kaunas d. mun.;2016;3;872;451;421
Kaunas d. mun.;2016;4;864;468;396
Kaunas d. mun.;2016;5;1095;566;529
Kaunas d. mun.;2016;6;1165;589;576
Kaunas d. mun.;2016;7;1102;573;529
Kaunas d. mun.;2016;8;1006;526;480
Kaunas d. mun.;2016;9;955;514;441
Kaunas d. mun.;2016;10;956;474;482
Kaunas d. mun.;2016;11;862;445;417
Kaunas d. mun.;2016;12;974;504;470
Kaunas d. mun.;2016;13;969;490;479
Kaunas d. mun.;2016;14;916;516;400
Kaunas d. mun.;2016;15;962;497;465
Kaunas d. mun.;2016;16;1078;571;507
Kaunas d. mun.;2016;17;1082;527;555
Kaunas d. mun.;2016;18;1077;544;533
Kaunas d. mun.;2016;19;1203;609;594
Kaunas d. mun.;2016;20;1109;583;526
Kaunas d. mun.;2016;21;1143;589;554
Kaunas d. mun.;2016;22;1162;604;558
Kaunas d. mun.;2016;23;1315;704;611
Kaunas d. mun.;2016;24;1243;682;561
Kaunas d. mun.;2016;25;1359;725;634
Kaunas d. mun.;2016;26;1249;622;627
Kaunas d. mun.;2016;27;1247;651;596
Kaunas d. mun.;2016;28;1252;619;633
Kaunas d. mun.;2016;29;1370;709;661
Kaunas d. mun.;2016;30;1286;623;663
Kaunas d. mun.;2016;31;1289;682;607
Kaunas d. mun.;2016;32;1247;659;588
Kaunas d. mun.;2016;33;1155;620;535
Kaunas d. mun.;2016;34;1281;650;631
Kaunas d. mun.;2016;35;1267;643;624
Kaunas d. mun.;2016;36;1261;659;602
Kaunas d. mun.;2016;37;1196;599;597
Kaunas d. mun.;2016;38;1239;600;639
Kaunas d. mun.;2016;39;1212;593;619
Kaunas d. mun.;2016;40;1282;645;637
Kaunas d. mun.;2016;41;1261;632;629
Kaunas d. mun.;2016;42;1297;619;678
Kaunas d. mun.;2016;43;1286;635;651
Kaunas d. mun.;2016;44;1313;660;653
Kaunas d. mun.;2016;45;1313;647;666
Kaunas d. mun.;2016;46;1295;656;639
Kaunas d. mun.;2016;47;1333;611;722
Kaunas d. mun.;2016;48;1317;642;675
Kaunas d. mun.;2016;49;1237;595;642
Kaunas d. mun.;2016;50;1228;625;603
Kaunas d. mun.;2016;51;1237;609;628
Kaunas d. mun.;2016;52;1383;689;694
Kaunas d. mun.;2016;53;1386;639;747
Kaunas d. mun.;2016;54;1424;643;781
Kaunas d. mun.;2016;55;1368;665;703
Kaunas d. mun.;2016;56;1319;659;660
Kaunas d. mun.;2016;57;1372;621;751
Kaunas d. mun.;2016;58;1187;540;647
Kaunas d. mun.;2016;59;1026;488;538
Kaunas d. mun.;2016;60;1027;497;530
Kaunas d. mun.;2016;61;996;496;500
Kaunas d. mun.;2016;62;909;435;474
Kaunas d. mun.;2016;63;904;410;494
Kaunas d. mun.;2016;64;907;395;512
Kaunas d. mun.;2016;65;913;415;498
Kaunas d. mun.;2016;66;855;380;475
Kaunas d. mun.;2016;67;757;299;458
Kaunas d. mun.;2016;68;679;287;392
Kaunas d. mun.;2016;69;606;235;371
Kaunas d. mun.;2016;70;724;295;429
Kaunas d. mun.;2016;71;586;236;350
Kaunas d. mun.;2016;72;726;305;421
Kaunas d. mun.;2016;73;781;283;498
Kaunas d. mun.;2016;74;685;263;422
Kaunas d. mun.;2016;75;638;249;389
Kaunas d. mun.;2016;76;633;237;396
Kaunas d. mun.;2016;77;596;214;382
Kaunas d. mun.;2016;78;517;192;325
Kaunas d. mun.;2016;79;480;168;312
Kaunas d. mun.;2016;80;528;179;349
Kaunas d. mun.;2016;81;433;142;291
Kaunas d. mun.;2016;82;431;116;315
Kaunas d. mun.;2016;83;400;132;268
Kaunas d. mun.;2016;84;391;120;271
Kaunas d. mun.;2016;85;1672;392;1280
Kaunas d. mun.;2017;-1;91073;43848;47225
Kaunas d. mun.;2017;0;1008;524;484
Kaunas d. mun.;2017;1;1041;525;516
Kaunas d. mun.;2017;2;945;491;454
Kaunas d. mun.;2017;3;968;496;472
Kaunas d. mun.;2017;4;927;474;453
Kaunas d. mun.;2017;5;892;484;408
Kaunas d. mun.;2017;6;1146;597;549
Kaunas d. mun.;2017;7;1222;625;597
Kaunas d. mun.;2017;8;1135;588;547
Kaunas d. mun.;2017;9;1032;535;497
Kaunas d. mun.;2017;10;964;525;439
Kaunas d. mun.;2017;11;983;489;494
Kaunas d. mun.;2017;12;862;443;419
Kaunas d. mun.;2017;13;983;512;471
Kaunas d. mun.;2017;14;989;497;492
Kaunas d. mun.;2017;15;916;510;406
Kaunas d. mun.;2017;16;970;501;469
Kaunas d. mun.;2017;17;1087;575;512
Kaunas d. mun.;2017;18;1078;525;553
Kaunas d. mun.;2017;19;1083;547;536
Kaunas d. mun.;2017;20;1184;598;586
Kaunas d. mun.;2017;21;1106;587;519
Kaunas d. mun.;2017;22;1131;582;549
Kaunas d. mun.;2017;23;1159;599;560
Kaunas d. mun.;2017;24;1298;690;608
Kaunas d. mun.;2017;25;1272;692;580
Kaunas d. mun.;2017;26;1388;735;653
Kaunas d. mun.;2017;27;1288;637;651
Kaunas d. mun.;2017;28;1301;671;630
Kaunas d. mun.;2017;29;1286;633;653
Kaunas d. mun.;2017;30;1408;730;678
Kaunas d. mun.;2017;31;1336;659;677
Kaunas d. mun.;2017;32;1327;701;626
Kaunas d. mun.;2017;33;1311;691;620
Kaunas d. mun.;2017;34;1193;648;545
Kaunas d. mun.;2017;35;1327;663;664
Kaunas d. mun.;2017;36;1310;669;641
Kaunas d. mun.;2017;37;1288;676;612
Kaunas d. mun.;2017;38;1232;605;627
Kaunas d. mun.;2017;39;1280;628;652
Kaunas d. mun.;2017;40;1252;612;640
Kaunas d. mun.;2017;41;1300;659;641
Kaunas d. mun.;2017;42;1279;644;635
Kaunas d. mun.;2017;43;1323;638;685
Kaunas d. mun.;2017;44;1301;642;659
Kaunas d. mun.;2017;45;1327;668;659
Kaunas d. mun.;2017;46;1331;659;672
Kaunas d. mun.;2017;47;1295;653;642
Kaunas d. mun.;2017;48;1330;610;720
Kaunas d. mun.;2017;49;1351;656;695
Kaunas d. mun.;2017;50;1247;601;646
Kaunas d. mun.;2017;51;1236;628;608
Kaunas d. mun.;2017;52;1260;618;642
Kaunas d. mun.;2017;53;1379;675;704
Kaunas d. mun.;2017;54;1386;644;742
Kaunas d. mun.;2017;55;1434;643;791
Kaunas d. mun.;2017;56;1376;660;716
Kaunas d. mun.;2017;57;1329;665;664
Kaunas d. mun.;2017;58;1381;618;763
Kaunas d. mun.;2017;59;1191;538;653
Kaunas d. mun.;2017;60;1021;477;544
Kaunas d. mun.;2017;61;1023;493;530
Kaunas d. mun.;2017;62;992;493;499
Kaunas d. mun.;2017;63;892;428;464
Kaunas d. mun.;2017;64;889;402;487
Kaunas d. mun.;2017;65;899;392;507
Kaunas d. mun.;2017;66;911;416;495
Kaunas d. mun.;2017;67;847;375;472
Kaunas d. mun.;2017;68;741;291;450
Kaunas d. mun.;2017;69;673;286;387
Kaunas d. mun.;2017;70;605;230;375
Kaunas d. mun.;2017;71;713;284;429
Kaunas d. mun.;2017;72;569;223;346
Kaunas d. mun.;2017;73;706;286;420
Kaunas d. mun.;2017;74;762;270;492
Kaunas d. mun.;2017;75;663;246;417
Kaunas d. mun.;2017;76;616;234;382
Kaunas d. mun.;2017;77;595;223;372
Kaunas d. mun.;2017;78;567;201;366
Kaunas d. mun.;2017;79;484;175;309
Kaunas d. mun.;2017;80;454;158;296
Kaunas d. mun.;2017;81;499;170;329
Kaunas d. mun.;2017;82;411;138;273
Kaunas d. mun.;2017;83;395;104;291
Kaunas d. mun.;2017;84;374;124;250
Kaunas d. mun.;2017;85;1808;441;1367
Kaunas d. mun.;2018;-1;92644;44761;47883
Kaunas d. mun.;2018;0;973;498;475
Kaunas d. mun.;2018;1;1015;530;485
Kaunas d. mun.;2018;2;1022;525;497
Kaunas d. mun.;2018;3;969;498;471
Kaunas d. mun.;2018;4;1017;520;497
Kaunas d. mun.;2018;5;959;502;457
Kaunas d. mun.;2018;6;955;513;442
Kaunas d. mun.;2018;7;1181;612;569
Kaunas d. mun.;2018;8;1258;636;622
Kaunas d. mun.;2018;9;1148;599;549
Kaunas d. mun.;2018;10;1052;541;511
Kaunas d. mun.;2018;11;988;532;456
Kaunas d. mun.;2018;12;994;494;500
Kaunas d. mun.;2018;13;868;449;419
Kaunas d. mun.;2018;14;998;522;476
Kaunas d. mun.;2018;15;988;497;491
Kaunas d. mun.;2018;16;926;516;410
Kaunas d. mun.;2018;17;988;506;482
Kaunas d. mun.;2018;18;1090;575;515
Kaunas d. mun.;2018;19;1052;514;538
Kaunas d. mun.;2018;20;1072;533;539
Kaunas d. mun.;2018;21;1161;586;575
Kaunas d. mun.;2018;22;1092;588;504
Kaunas d. mun.;2018;23;1076;549;527
Kaunas d. mun.;2018;24;1153;596;557
Kaunas d. mun.;2018;25;1297;675;622
Kaunas d. mun.;2018;26;1314;703;611
Kaunas d. mun.;2018;27;1429;763;666
Kaunas d. mun.;2018;28;1345;675;670
Kaunas d. mun.;2018;29;1376;713;663
Kaunas d. mun.;2018;30;1354;683;671
Kaunas d. mun.;2018;31;1505;802;703
Kaunas d. mun.;2018;32;1400;703;697
Kaunas d. mun.;2018;33;1369;739;630
Kaunas d. mun.;2018;34;1355;717;638
Kaunas d. mun.;2018;35;1234;671;563
Kaunas d. mun.;2018;36;1378;687;691
Kaunas d. mun.;2018;37;1365;706;659
Kaunas d. mun.;2018;38;1339;712;627
Kaunas d. mun.;2018;39;1288;641;647
Kaunas d. mun.;2018;40;1303;645;658
Kaunas d. mun.;2018;41;1281;619;662
Kaunas d. mun.;2018;42;1335;678;657
Kaunas d. mun.;2018;43;1297;667;630
Kaunas d. mun.;2018;44;1340;646;694
Kaunas d. mun.;2018;45;1307;647;660
Kaunas d. mun.;2018;46;1324;666;658
Kaunas d. mun.;2018;47;1324;661;663
Kaunas d. mun.;2018;48;1312;662;650
Kaunas d. mun.;2018;49;1335;610;725
Kaunas d. mun.;2018;50;1362;659;703
Kaunas d. mun.;2018;51;1254;613;641
Kaunas d. mun.;2018;52;1237;624;613
Kaunas d. mun.;2018;53;1275;622;653
Kaunas d. mun.;2018;54;1400;682;718
Kaunas d. mun.;2018;55;1382;640;742
Kaunas d. mun.;2018;56;1438;649;789
Kaunas d. mun.;2018;57;1371;663;708
Kaunas d. mun.;2018;58;1337;669;668
Kaunas d. mun.;2018;59;1387;621;766
Kaunas d. mun.;2018;60;1209;542;667
Kaunas d. mun.;2018;61;1016;467;549
Kaunas d. mun.;2018;62;1032;493;539
Kaunas d. mun.;2018;63;994;494;500
Kaunas d. mun.;2018;64;894;424;470
Kaunas d. mun.;2018;65;889;393;496
Kaunas d. mun.;2018;66;890;385;505
Kaunas d. mun.;2018;67;906;407;499
Kaunas d. mun.;2018;68;830;362;468
Kaunas d. mun.;2018;69;728;282;446
Kaunas d. mun.;2018;70;656;274;382
Kaunas d. mun.;2018;71;597;223;374
Kaunas d. mun.;2018;72;698;277;421
Kaunas d. mun.;2018;73;567;220;347
Kaunas d. mun.;2018;74;680;269;411
Kaunas d. mun.;2018;75;743;259;484
Kaunas d. mun.;2018;76;638;226;412
Kaunas d. mun.;2018;77;601;223;378
Kaunas d. mun.;2018;78;575;213;362
Kaunas d. mun.;2018;79;555;196;359
Kaunas d. mun.;2018;80;463;166;297
Kaunas d. mun.;2018;81;435;152;283
Kaunas d. mun.;2018;82;473;154;319
Kaunas d. mun.;2018;83;379;124;255
Kaunas d. mun.;2018;84;365;88;277
Kaunas d. mun.;2018;85;1887;484;1403
Kazlų Rūda mun.;2001;-1;14934;7084;7850
Kazlų Rūda mun.;2001;0;153;82;71
Kazlų Rūda mun.;2001;1;156;79;77
Kazlų Rūda mun.;2001;2;170;93;77
Kazlų Rūda mun.;2001;3;182;96;86
Kazlų Rūda mun.;2001;4;182;90;92
Kazlų Rūda mun.;2001;5;199;94;105
Kazlų Rūda mun.;2001;6;200;98;102
Kazlų Rūda mun.;2001;7;207;117;90
Kazlų Rūda mun.;2001;8;230;107;123
Kazlų Rūda mun.;2001;9;239;131;108
Kazlų Rūda mun.;2001;10;259;137;122
Kazlų Rūda mun.;2001;11;231;117;114
Kazlų Rūda mun.;2001;12;251;144;107
Kazlų Rūda mun.;2001;13;258;131;127
Kazlų Rūda mun.;2001;14;261;138;123
Kazlų Rūda mun.;2001;15;232;102;130
Kazlų Rūda mun.;2001;16;235;97;138
Kazlų Rūda mun.;2001;17;233;133;100
Kazlų Rūda mun.;2001;18;201;90;111
Kazlų Rūda mun.;2001;19;172;88;84
Kazlų Rūda mun.;2001;20;188;113;75
Kazlų Rūda mun.;2001;21;150;75;75
Kazlų Rūda mun.;2001;22;202;118;84
Kazlų Rūda mun.;2001;23;182;95;87
Kazlų Rūda mun.;2001;24;189;102;87
Kazlų Rūda mun.;2001;25;182;102;80
Kazlų Rūda mun.;2001;26;191;100;91
Kazlų Rūda mun.;2001;27;205;108;97
Kazlų Rūda mun.;2001;28;192;97;95
Kazlų Rūda mun.;2001;29;196;101;95
Kazlų Rūda mun.;2001;30;231;122;109
Kazlų Rūda mun.;2001;31;216;112;104
Kazlų Rūda mun.;2001;32;187;88;99
Kazlų Rūda mun.;2001;33;183;104;79
Kazlų Rūda mun.;2001;34;186;84;102
Kazlų Rūda mun.;2001;35;186;98;88
Kazlų Rūda mun.;2001;36;237;113;124
Kazlų Rūda mun.;2001;37;231;119;112
Kazlų Rūda mun.;2001;38;212;103;109
Kazlų Rūda mun.;2001;39;241;114;127
Kazlų Rūda mun.;2001;40;260;140;120
Kazlų Rūda mun.;2001;41;195;90;105
Kazlų Rūda mun.;2001;42;208;109;99
Kazlų Rūda mun.;2001;43;209;101;108
Kazlų Rūda mun.;2001;44;189;85;104
Kazlų Rūda mun.;2001;45;194;99;95
Kazlų Rūda mun.;2001;46;155;73;82
Kazlų Rūda mun.;2001;47;145;62;83
Kazlų Rūda mun.;2001;48;169;82;87
Kazlų Rūda mun.;2001;49;170;80;90
Kazlų Rūda mun.;2001;50;189;101;88
Kazlų Rūda mun.;2001;51;196;90;106
Kazlų Rūda mun.;2001;52;166;77;89
Kazlų Rūda mun.;2001;53;125;70;55
Kazlų Rūda mun.;2001;54;137;56;81
Kazlų Rūda mun.;2001;55;159;77;82
Kazlų Rūda mun.;2001;56;114;52;62
Kazlų Rūda mun.;2001;57;151;71;80
Kazlų Rūda mun.;2001;58;156;70;86
Kazlų Rūda mun.;2001;59;167;73;94
Kazlų Rūda mun.;2001;60;143;72;71
Kazlų Rūda mun.;2001;61;144;55;89
Kazlų Rūda mun.;2001;62;163;72;91
Kazlų Rūda mun.;2001;63;179;83;96
Kazlų Rūda mun.;2001;64;154;67;87
Kazlų Rūda mun.;2001;65;174;72;102
Kazlų Rūda mun.;2001;66;99;41;58
Kazlų Rūda mun.;2001;67;174;73;101
Kazlų Rūda mun.;2001;68;173;68;105
Kazlų Rūda mun.;2001;69;138;45;93
Kazlų Rūda mun.;2001;70;158;66;92
Kazlų Rūda mun.;2001;71;156;46;110
Kazlų Rūda mun.;2001;72;155;55;100
Kazlų Rūda mun.;2001;73;128;46;82
Kazlų Rūda mun.;2001;74;119;29;90
Kazlų Rūda mun.;2001;75;129;41;88
Kazlų Rūda mun.;2001;76;121;43;78
Kazlų Rūda mun.;2001;77;98;40;58
Kazlų Rūda mun.;2001;78;78;24;54
Kazlų Rūda mun.;2001;79;59;13;46
Kazlų Rūda mun.;2001;80;80;20;60
Kazlų Rūda mun.;2001;81;54;14;40
Kazlų Rūda mun.;2001;82;56;17;39
Kazlų Rūda mun.;2001;83;40;13;27
Kazlų Rūda mun.;2001;84;30;8;22
Kazlų Rūda mun.;2001;85;240;71;169
Kazlų Rūda mun.;2002;-1;14893;7041;7852
Kazlų Rūda mun.;2002;0;153;73;80
Kazlų Rūda mun.;2002;1;158;84;74
Kazlų Rūda mun.;2002;2;154;80;74
Kazlų Rūda mun.;2002;3;170;94;76
Kazlų Rūda mun.;2002;4;183;96;87
Kazlų Rūda mun.;2002;5;177;89;88
Kazlų Rūda mun.;2002;6;197;92;105
Kazlų Rūda mun.;2002;7;197;97;100
Kazlų Rūda mun.;2002;8;209;117;92
Kazlų Rūda mun.;2002;9;232;106;126
Kazlų Rūda mun.;2002;10;239;132;107
Kazlų Rūda mun.;2002;11;258;137;121
Kazlų Rūda mun.;2002;12;231;118;113
Kazlų Rūda mun.;2002;13;247;140;107
Kazlų Rūda mun.;2002;14;257;129;128
Kazlų Rūda mun.;2002;15;258;135;123
Kazlų Rūda mun.;2002;16;231;101;130
Kazlų Rūda mun.;2002;17;235;97;138
Kazlų Rūda mun.;2002;18;235;134;101
Kazlų Rūda mun.;2002;19;196;87;109
Kazlų Rūda mun.;2002;20;168;85;83
Kazlų Rūda mun.;2002;21;185;108;77
Kazlų Rūda mun.;2002;22;151;74;77
Kazlų Rūda mun.;2002;23;198;115;83
Kazlų Rūda mun.;2002;24;181;92;89
Kazlų Rūda mun.;2002;25;188;102;86
Kazlų Rūda mun.;2002;26;182;102;80
Kazlų Rūda mun.;2002;27;187;98;89
Kazlų Rūda mun.;2002;28;199;103;96
Kazlų Rūda mun.;2002;29;190;96;94
Kazlų Rūda mun.;2002;30;193;99;94
Kazlų Rūda mun.;2002;31;227;119;108
Kazlų Rūda mun.;2002;32;213;109;104
Kazlų Rūda mun.;2002;33;185;86;99
Kazlų Rūda mun.;2002;34;186;105;81
Kazlų Rūda mun.;2002;35;189;84;105
Kazlų Rūda mun.;2002;36;187;98;89
Kazlų Rūda mun.;2002;37;234;111;123
Kazlų Rūda mun.;2002;38;232;119;113
Kazlų Rūda mun.;2002;39;214;104;110
Kazlų Rūda mun.;2002;40;240;112;128
Kazlų Rūda mun.;2002;41;261;141;120
Kazlų Rūda mun.;2002;42;198;91;107
Kazlų Rūda mun.;2002;43;207;108;99
Kazlų Rūda mun.;2002;44;205;98;107
Kazlų Rūda mun.;2002;45;188;85;103
Kazlų Rūda mun.;2002;46;195;102;93
Kazlų Rūda mun.;2002;47;154;72;82
Kazlų Rūda mun.;2002;48;144;63;81
Kazlų Rūda mun.;2002;49;167;81;86
Kazlų Rūda mun.;2002;50;168;79;89
Kazlų Rūda mun.;2002;51;189;100;89
Kazlų Rūda mun.;2002;52;196;90;106
Kazlų Rūda mun.;2002;53;165;77;88
Kazlų Rūda mun.;2002;54;121;67;54
Kazlų Rūda mun.;2002;55;134;55;79
Kazlų Rūda mun.;2002;56;151;71;80
Kazlų Rūda mun.;2002;57;113;51;62
Kazlų Rūda mun.;2002;58;146;68;78
Kazlų Rūda mun.;2002;59;151;68;83
Kazlų Rūda mun.;2002;60;165;71;94
Kazlų Rūda mun.;2002;61;140;69;71
Kazlų Rūda mun.;2002;62;145;57;88
Kazlų Rūda mun.;2002;63;162;69;93
Kazlų Rūda mun.;2002;64;178;82;96
Kazlų Rūda mun.;2002;65;152;66;86
Kazlų Rūda mun.;2002;66;172;71;101
Kazlų Rūda mun.;2002;67;100;41;59
Kazlų Rūda mun.;2002;68;172;70;102
Kazlų Rūda mun.;2002;69;172;68;104
Kazlų Rūda mun.;2002;70;136;44;92
Kazlų Rūda mun.;2002;71;156;65;91
Kazlų Rūda mun.;2002;72;156;45;111
Kazlų Rūda mun.;2002;73;153;55;98
Kazlų Rūda mun.;2002;74;123;44;79
Kazlų Rūda mun.;2002;75;117;28;89
Kazlų Rūda mun.;2002;76;124;39;85
Kazlų Rūda mun.;2002;77;105;34;71
Kazlų Rūda mun.;2002;78;88;32;56
Kazlų Rūda mun.;2002;79;74;23;51
Kazlų Rūda mun.;2002;80;58;11;47
Kazlų Rūda mun.;2002;81;77;19;58
Kazlų Rūda mun.;2002;82;45;13;32
Kazlų Rūda mun.;2002;83;54;15;39
Kazlų Rūda mun.;2002;84;36;12;24
Kazlų Rūda mun.;2002;85;234;72;162
Kazlų Rūda mun.;2003;-1;14783;6973;7810
Kazlų Rūda mun.;2003;0;134;74;60
Kazlų Rūda mun.;2003;1;152;72;80
Kazlų Rūda mun.;2003;2;158;84;74
Kazlų Rūda mun.;2003;3;153;79;74
Kazlų Rūda mun.;2003;4;167;91;76
Kazlų Rūda mun.;2003;5;182;95;87
Kazlų Rūda mun.;2003;6;179;89;90
Kazlų Rūda mun.;2003;7;196;91;105
Kazlų Rūda mun.;2003;8;198;96;102
Kazlų Rūda mun.;2003;9;208;115;93
Kazlų Rūda mun.;2003;10;231;105;126
Kazlų Rūda mun.;2003;11;237;130;107
Kazlų Rūda mun.;2003;12;254;134;120
Kazlų Rūda mun.;2003;13;226;116;110
Kazlų Rūda mun.;2003;14;241;137;104
Kazlų Rūda mun.;2003;15;252;127;125
Kazlų Rūda mun.;2003;16;255;133;122
Kazlų Rūda mun.;2003;17;227;99;128
Kazlų Rūda mun.;2003;18;232;95;137
Kazlų Rūda mun.;2003;19;234;133;101
Kazlų Rūda mun.;2003;20;195;83;112
Kazlų Rūda mun.;2003;21;172;87;85
Kazlų Rūda mun.;2003;22;191;111;80
Kazlų Rūda mun.;2003;23;146;70;76
Kazlų Rūda mun.;2003;24;199;115;84
Kazlų Rūda mun.;2003;25;171;89;82
Kazlų Rūda mun.;2003;26;186;102;84
Kazlų Rūda mun.;2003;27;181;101;80
Kazlų Rūda mun.;2003;28;189;100;89
Kazlų Rūda mun.;2003;29;197;100;97
Kazlų Rūda mun.;2003;30;188;95;93
Kazlų Rūda mun.;2003;31;191;96;95
Kazlų Rūda mun.;2003;32;228;120;108
Kazlų Rūda mun.;2003;33;210;109;101
Kazlų Rūda mun.;2003;34;182;83;99
Kazlų Rūda mun.;2003;35;185;104;81
Kazlų Rūda mun.;2003;36;187;84;103
Kazlų Rūda mun.;2003;37;185;98;87
Kazlų Rūda mun.;2003;38;229;111;118
Kazlų Rūda mun.;2003;39;225;116;109
Kazlų Rūda mun.;2003;40;208;101;107
Kazlų Rūda mun.;2003;41;235;110;125
Kazlų Rūda mun.;2003;42;261;142;119
Kazlų Rūda mun.;2003;43;199;91;108
Kazlų Rūda mun.;2003;44;206;107;99
Kazlų Rūda mun.;2003;45;202;97;105
Kazlų Rūda mun.;2003;46;188;86;102
Kazlų Rūda mun.;2003;47;191;99;92
Kazlų Rūda mun.;2003;48;151;72;79
Kazlų Rūda mun.;2003;49;143;62;81
Kazlų Rūda mun.;2003;50;168;83;85
Kazlų Rūda mun.;2003;51;164;75;89
Kazlų Rūda mun.;2003;52;185;97;88
Kazlų Rūda mun.;2003;53;197;89;108
Kazlų Rūda mun.;2003;54;163;76;87
Kazlų Rūda mun.;2003;55;122;67;55
Kazlų Rūda mun.;2003;56;133;56;77
Kazlų Rūda mun.;2003;57;150;69;81
Kazlų Rūda mun.;2003;58;109;50;59
Kazlų Rūda mun.;2003;59;145;68;77
Kazlų Rūda mun.;2003;60;149;66;83
Kazlų Rūda mun.;2003;61;168;73;95
Kazlų Rūda mun.;2003;62;143;69;74
Kazlų Rūda mun.;2003;63;144;54;90
Kazlų Rūda mun.;2003;64;163;71;92
Kazlų Rūda mun.;2003;65;175;79;96
Kazlų Rūda mun.;2003;66;149;61;88
Kazlų Rūda mun.;2003;67;175;71;104
Kazlų Rūda mun.;2003;68;93;36;57
Kazlų Rūda mun.;2003;69;169;67;102
Kazlų Rūda mun.;2003;70;169;66;103
Kazlų Rūda mun.;2003;71;133;41;92
Kazlų Rūda mun.;2003;72;152;62;90
Kazlų Rūda mun.;2003;73;150;43;107
Kazlų Rūda mun.;2003;74;146;49;97
Kazlų Rūda mun.;2003;75;119;42;77
Kazlų Rūda mun.;2003;76;110;28;82
Kazlų Rūda mun.;2003;77;125;37;88
Kazlų Rūda mun.;2003;78;98;30;68
Kazlų Rūda mun.;2003;79;85;30;55
Kazlų Rūda mun.;2003;80;66;18;48
Kazlų Rūda mun.;2003;81;55;10;45
Kazlų Rūda mun.;2003;82;71;17;54
Kazlų Rūda mun.;2003;83;41;11;30
Kazlų Rūda mun.;2003;84;51;13;38
Kazlų Rūda mun.;2003;85;211;63;148
Kazlų Rūda mun.;2004;-1;14781;6989;7792
Kazlų Rūda mun.;2004;0;184;98;86
Kazlų Rūda mun.;2004;1;133;74;59
Kazlų Rūda mun.;2004;2;152;72;80
Kazlų Rūda mun.;2004;3;157;82;75
Kazlų Rūda mun.;2004;4;152;78;74
Kazlų Rūda mun.;2004;5;169;93;76
Kazlų Rūda mun.;2004;6;185;96;89
Kazlų Rūda mun.;2004;7;180;88;92
Kazlų Rūda mun.;2004;8;195;91;104
Kazlų Rūda mun.;2004;9;199;95;104
Kazlų Rūda mun.;2004;10;209;116;93
Kazlų Rūda mun.;2004;11;235;109;126
Kazlų Rūda mun.;2004;12;235;129;106
Kazlų Rūda mun.;2004;13;254;134;120
Kazlų Rūda mun.;2004;14;227;118;109
Kazlų Rūda mun.;2004;15;242;137;105
Kazlų Rūda mun.;2004;16;245;123;122
Kazlų Rūda mun.;2004;17;253;133;120
Kazlų Rūda mun.;2004;18;229;99;130
Kazlų Rūda mun.;2004;19;227;95;132
Kazlų Rūda mun.;2004;20;229;128;101
Kazlų Rūda mun.;2004;21;193;83;110
Kazlų Rūda mun.;2004;22;172;87;85
Kazlų Rūda mun.;2004;23;191;110;81
Kazlų Rūda mun.;2004;24;147;72;75
Kazlų Rūda mun.;2004;25;195;115;80
Kazlų Rūda mun.;2004;26;159;87;72
Kazlų Rūda mun.;2004;27;179;97;82
Kazlų Rūda mun.;2004;28;179;103;76
Kazlų Rūda mun.;2004;29;184;96;88
Kazlų Rūda mun.;2004;30;189;97;92
Kazlų Rūda mun.;2004;31;190;93;97
Kazlų Rūda mun.;2004;32;192;99;93
Kazlų Rūda mun.;2004;33;227;118;109
Kazlų Rūda mun.;2004;34;211;108;103
Kazlų Rūda mun.;2004;35;179;83;96
Kazlų Rūda mun.;2004;36;186;108;78
Kazlų Rūda mun.;2004;37;183;83;100
Kazlų Rūda mun.;2004;38;187;97;90
Kazlų Rūda mun.;2004;39;227;107;120
Kazlų Rūda mun.;2004;40;225;116;109
Kazlų Rūda mun.;2004;41;207;101;106
Kazlų Rūda mun.;2004;42;235;111;124
Kazlų Rūda mun.;2004;43;262;144;118
Kazlų Rūda mun.;2004;44;197;91;106
Kazlų Rūda mun.;2004;45;205;108;97
Kazlų Rūda mun.;2004;46;205;100;105
Kazlų Rūda mun.;2004;47;185;84;101
Kazlų Rūda mun.;2004;48;191;98;93
Kazlų Rūda mun.;2004;49;151;74;77
Kazlų Rūda mun.;2004;50;142;60;82
Kazlų Rūda mun.;2004;51;165;83;82
Kazlų Rūda mun.;2004;52;162;74;88
Kazlų Rūda mun.;2004;53;184;97;87
Kazlų Rūda mun.;2004;54;196;90;106
Kazlų Rūda mun.;2004;55;162;74;88
Kazlų Rūda mun.;2004;56;120;66;54
Kazlų Rūda mun.;2004;57;134;57;77
Kazlų Rūda mun.;2004;58;146;64;82
Kazlų Rūda mun.;2004;59;108;50;58
Kazlų Rūda mun.;2004;60;141;64;77
Kazlų Rūda mun.;2004;61;148;67;81
Kazlų Rūda mun.;2004;62;165;71;94
Kazlų Rūda mun.;2004;63;140;66;74
Kazlų Rūda mun.;2004;64;140;51;89
Kazlų Rūda mun.;2004;65;161;68;93
Kazlų Rūda mun.;2004;66;170;78;92
Kazlų Rūda mun.;2004;67;151;64;87
Kazlų Rūda mun.;2004;68;170;65;105
Kazlų Rūda mun.;2004;69;90;34;56
Kazlų Rūda mun.;2004;70;163;66;97
Kazlų Rūda mun.;2004;71;168;64;104
Kazlų Rūda mun.;2004;72;130;39;91
Kazlų Rūda mun.;2004;73;151;60;91
Kazlų Rūda mun.;2004;74;145;41;104
Kazlų Rūda mun.;2004;75;143;48;95
Kazlų Rūda mun.;2004;76;117;41;76
Kazlų Rūda mun.;2004;77;103;27;76
Kazlų Rūda mun.;2004;78;127;37;90
Kazlų Rūda mun.;2004;79;92;29;63
Kazlų Rūda mun.;2004;80;77;27;50
Kazlų Rūda mun.;2004;81;62;17;45
Kazlų Rūda mun.;2004;82;53;10;43
Kazlų Rūda mun.;2004;83;69;16;53
Kazlų Rūda mun.;2004;84;38;8;30
Kazlų Rūda mun.;2004;85;224;58;166
Kazlų Rūda mun.;2005;-1;14688;6923;7765
Kazlų Rūda mun.;2005;0;154;79;75
Kazlų Rūda mun.;2005;1;181;95;86
Kazlų Rūda mun.;2005;2;130;71;59
Kazlų Rūda mun.;2005;3;152;70;82
Kazlų Rūda mun.;2005;4;156;82;74
Kazlų Rūda mun.;2005;5;149;78;71
Kazlų Rūda mun.;2005;6;168;91;77
Kazlų Rūda mun.;2005;7;185;96;89
Kazlų Rūda mun.;2005;8;179;90;89
Kazlų Rūda mun.;2005;9;193;90;103
Kazlų Rūda mun.;2005;10;202;96;106
Kazlų Rūda mun.;2005;11;213;116;97
Kazlų Rūda mun.;2005;12;236;110;126
Kazlų Rūda mun.;2005;13;230;125;105
Kazlų Rūda mun.;2005;14;252;133;119
Kazlų Rūda mun.;2005;15;221;115;106
Kazlų Rūda mun.;2005;16;240;138;102
Kazlų Rūda mun.;2005;17;246;124;122
Kazlų Rūda mun.;2005;18;248;131;117
Kazlų Rūda mun.;2005;19;219;94;125
Kazlų Rūda mun.;2005;20;222;93;129
Kazlų Rūda mun.;2005;21;227;126;101
Kazlų Rūda mun.;2005;22;191;82;109
Kazlų Rūda mun.;2005;23;167;85;82
Kazlų Rūda mun.;2005;24;186;109;77
Kazlų Rūda mun.;2005;25;156;74;82
Kazlų Rūda mun.;2005;26;202;118;84
Kazlų Rūda mun.;2005;27;157;84;73
Kazlų Rūda mun.;2005;28;178;96;82
Kazlų Rūda mun.;2005;29;171;97;74
Kazlų Rūda mun.;2005;30;176;92;84
Kazlų Rūda mun.;2005;31;189;95;94
Kazlų Rūda mun.;2005;32;191;91;100
Kazlų Rūda mun.;2005;33;188;97;91
Kazlų Rūda mun.;2005;34;221;115;106
Kazlų Rūda mun.;2005;35;207;106;101
Kazlų Rūda mun.;2005;36;173;82;91
Kazlų Rūda mun.;2005;37;184;107;77
Kazlų Rūda mun.;2005;38;184;84;100
Kazlų Rūda mun.;2005;39;189;97;92
Kazlų Rūda mun.;2005;40;225;107;118
Kazlų Rūda mun.;2005;41;222;113;109
Kazlų Rūda mun.;2005;42;204;98;106
Kazlų Rūda mun.;2005;43;236;110;126
Kazlų Rūda mun.;2005;44;262;143;119
Kazlų Rūda mun.;2005;45;195;90;105
Kazlų Rūda mun.;2005;46;204;106;98
Kazlų Rūda mun.;2005;47;202;99;103
Kazlų Rūda mun.;2005;48;186;82;104
Kazlų Rūda mun.;2005;49;190;95;95
Kazlų Rūda mun.;2005;50;149;73;76
Kazlų Rūda mun.;2005;51;142;61;81
Kazlų Rūda mun.;2005;52;165;82;83
Kazlų Rūda mun.;2005;53;160;72;88
Kazlų Rūda mun.;2005;54;179;94;85
Kazlų Rūda mun.;2005;55;197;90;107
Kazlų Rūda mun.;2005;56;164;73;91
Kazlų Rūda mun.;2005;57;117;64;53
Kazlų Rūda mun.;2005;58;131;55;76
Kazlų Rūda mun.;2005;59;146;63;83
Kazlų Rūda mun.;2005;60;106;49;57
Kazlų Rūda mun.;2005;61;141;63;78
Kazlų Rūda mun.;2005;62;145;65;80
Kazlų Rūda mun.;2005;63;168;72;96
Kazlų Rūda mun.;2005;64;142;67;75
Kazlų Rūda mun.;2005;65;136;49;87
Kazlų Rūda mun.;2005;66;160;64;96
Kazlų Rūda mun.;2005;67;168;78;90
Kazlų Rūda mun.;2005;68;146;61;85
Kazlų Rūda mun.;2005;69;169;63;106
Kazlų Rūda mun.;2005;70;89;35;54
Kazlų Rūda mun.;2005;71;159;65;94
Kazlų Rūda mun.;2005;72;161;59;102
Kazlų Rūda mun.;2005;73;126;37;89
Kazlų Rūda mun.;2005;74;138;51;87
Kazlų Rūda mun.;2005;75;137;36;101
Kazlų Rūda mun.;2005;76;139;46;93
Kazlų Rūda mun.;2005;77;112;38;74
Kazlų Rūda mun.;2005;78;102;26;76
Kazlų Rūda mun.;2005;79;113;32;81
Kazlų Rūda mun.;2005;80;87;29;58
Kazlų Rūda mun.;2005;81;73;23;50
Kazlų Rūda mun.;2005;82;52;14;38
Kazlų Rūda mun.;2005;83;53;9;44
Kazlų Rūda mun.;2005;84;62;13;49
Kazlų Rūda mun.;2005;85;215;55;160
Kazlų Rūda mun.;2006;-1;14420;6811;7609
Kazlų Rūda mun.;2006;0;135;67;68
Kazlų Rūda mun.;2006;1;152;80;72
Kazlų Rūda mun.;2006;2;178;92;86
Kazlų Rūda mun.;2006;3;129;72;57
Kazlų Rūda mun.;2006;4;150;70;80
Kazlų Rūda mun.;2006;5;157;82;75
Kazlų Rūda mun.;2006;6;150;79;71
Kazlų Rūda mun.;2006;7;166;90;76
Kazlų Rūda mun.;2006;8;183;94;89
Kazlų Rūda mun.;2006;9;176;87;89
Kazlų Rūda mun.;2006;10;193;89;104
Kazlų Rūda mun.;2006;11;197;94;103
Kazlų Rūda mun.;2006;12;212;115;97
Kazlų Rūda mun.;2006;13;235;109;126
Kazlų Rūda mun.;2006;14;225;122;103
Kazlų Rūda mun.;2006;15;247;130;117
Kazlų Rūda mun.;2006;16;212;114;98
Kazlų Rūda mun.;2006;17;234;136;98
Kazlų Rūda mun.;2006;18;236;119;117
Kazlų Rūda mun.;2006;19;233;123;110
Kazlų Rūda mun.;2006;20;213;90;123
Kazlų Rūda mun.;2006;21;206;87;119
Kazlų Rūda mun.;2006;22;215;121;94
Kazlų Rūda mun.;2006;23;186;83;103
Kazlų Rūda mun.;2006;24;158;84;74
Kazlų Rūda mun.;2006;25;176;100;76
Kazlų Rūda mun.;2006;26;145;69;76
Kazlų Rūda mun.;2006;27;188;112;76
Kazlų Rūda mun.;2006;28;159;84;75
Kazlų Rūda mun.;2006;29;175;95;80
Kazlų Rūda mun.;2006;30;172;101;71
Kazlų Rūda mun.;2006;31;172;91;81
Kazlų Rūda mun.;2006;32;187;94;93
Kazlų Rūda mun.;2006;33;188;89;99
Kazlų Rūda mun.;2006;34;188;98;90
Kazlų Rūda mun.;2006;35;217;112;105
Kazlų Rūda mun.;2006;36;206;104;102
Kazlų Rūda mun.;2006;37;167;80;87
Kazlų Rūda mun.;2006;38;180;107;73
Kazlų Rūda mun.;2006;39;181;83;98
Kazlų Rūda mun.;2006;40;183;93;90
Kazlų Rūda mun.;2006;41;215;103;112
Kazlų Rūda mun.;2006;42;218;108;110
Kazlų Rūda mun.;2006;43;204;98;106
Kazlų Rūda mun.;2006;44;230;108;122
Kazlų Rūda mun.;2006;45;258;140;118
Kazlų Rūda mun.;2006;46;193;91;102
Kazlų Rūda mun.;2006;47;202;104;98
Kazlų Rūda mun.;2006;48;199;97;102
Kazlų Rūda mun.;2006;49;183;80;103
Kazlų Rūda mun.;2006;50;187;93;94
Kazlų Rūda mun.;2006;51;148;73;75
Kazlų Rūda mun.;2006;52;142;61;81
Kazlų Rūda mun.;2006;53;161;80;81
Kazlų Rūda mun.;2006;54;155;70;85
Kazlų Rūda mun.;2006;55;172;88;84
Kazlų Rūda mun.;2006;56;192;91;101
Kazlų Rūda mun.;2006;57;160;72;88
Kazlų Rūda mun.;2006;58;117;63;54
Kazlų Rūda mun.;2006;59;129;54;75
Kazlų Rūda mun.;2006;60;143;62;81
Kazlų Rūda mun.;2006;61;103;48;55
Kazlų Rūda mun.;2006;62;139;63;76
Kazlų Rūda mun.;2006;63;141;65;76
Kazlų Rūda mun.;2006;64;159;65;94
Kazlų Rūda mun.;2006;65;141;64;77
Kazlų Rūda mun.;2006;66;135;49;86
Kazlų Rūda mun.;2006;67;157;62;95
Kazlų Rūda mun.;2006;68;169;79;90
Kazlų Rūda mun.;2006;69;139;55;84
Kazlų Rūda mun.;2006;70;166;60;106
Kazlų Rūda mun.;2006;71;89;35;54
Kazlų Rūda mun.;2006;72;150;59;91
Kazlų Rūda mun.;2006;73;156;56;100
Kazlų Rūda mun.;2006;74;123;35;88
Kazlų Rūda mun.;2006;75;128;44;84
Kazlų Rūda mun.;2006;76;130;33;97
Kazlų Rūda mun.;2006;77;132;39;93
Kazlų Rūda mun.;2006;78;108;36;72
Kazlų Rūda mun.;2006;79;98;24;74
Kazlų Rūda mun.;2006;80;104;28;76
Kazlų Rūda mun.;2006;81;83;29;54
Kazlų Rūda mun.;2006;82;65;21;44
Kazlų Rūda mun.;2006;83;48;13;35
Kazlų Rūda mun.;2006;84;47;9;38
Kazlų Rūda mun.;2006;85;240;63;177
Kazlų Rūda mun.;2007;-1;14241;6736;7505
Kazlų Rūda mun.;2007;0;124;65;59
Kazlų Rūda mun.;2007;1;133;65;68
Kazlų Rūda mun.;2007;2;152;80;72
Kazlų Rūda mun.;2007;3;173;94;79
Kazlų Rūda mun.;2007;4;130;72;58
Kazlų Rūda mun.;2007;5;147;69;78
Kazlų Rūda mun.;2007;6;153;83;70
Kazlų Rūda mun.;2007;7;147;80;67
Kazlų Rūda mun.;2007;8;163;88;75
Kazlų Rūda mun.;2007;9;180;95;85
Kazlų Rūda mun.;2007;10;176;88;88
Kazlų Rūda mun.;2007;11;192;88;104
Kazlų Rūda mun.;2007;12;196;96;100
Kazlų Rūda mun.;2007;13;209;113;96
Kazlų Rūda mun.;2007;14;232;110;122
Kazlų Rūda mun.;2007;15;218;120;98
Kazlų Rūda mun.;2007;16;244;131;113
Kazlų Rūda mun.;2007;17;211;113;98
Kazlų Rūda mun.;2007;18;225;131;94
Kazlų Rūda mun.;2007;19;230;115;115
Kazlų Rūda mun.;2007;20;228;122;106
Kazlų Rūda mun.;2007;21;208;88;120
Kazlų Rūda mun.;2007;22;200;86;114
Kazlų Rūda mun.;2007;23;214;120;94
Kazlų Rūda mun.;2007;24;174;78;96
Kazlų Rūda mun.;2007;25;154;83;71
Kazlų Rūda mun.;2007;26;177;100;77
Kazlų Rūda mun.;2007;27;141;67;74
Kazlų Rūda mun.;2007;28;181;107;74
Kazlų Rūda mun.;2007;29;162;84;78
Kazlų Rūda mun.;2007;30;171;92;79
Kazlų Rūda mun.;2007;31;161;93;68
Kazlų Rūda mun.;2007;32;170;90;80
Kazlų Rūda mun.;2007;33;188;96;92
Kazlų Rūda mun.;2007;34;187;89;98
Kazlų Rūda mun.;2007;35;191;100;91
Kazlų Rūda mun.;2007;36;209;107;102
Kazlų Rūda mun.;2007;37;201;101;100
Kazlų Rūda mun.;2007;38;168;78;90
Kazlų Rūda mun.;2007;39;183;108;75
Kazlų Rūda mun.;2007;40;178;83;95
Kazlų Rūda mun.;2007;41;182;93;89
Kazlų Rūda mun.;2007;42;214;101;113
Kazlų Rūda mun.;2007;43;216;107;109
Kazlų Rūda mun.;2007;44;201;96;105
Kazlų Rūda mun.;2007;45;229;108;121
Kazlų Rūda mun.;2007;46;254;137;117
Kazlų Rūda mun.;2007;47;190;89;101
Kazlų Rūda mun.;2007;48;202;105;97
Kazlų Rūda mun.;2007;49;201;98;103
Kazlų Rūda mun.;2007;50;180;78;102
Kazlų Rūda mun.;2007;51;181;88;93
Kazlų Rūda mun.;2007;52;146;70;76
Kazlų Rūda mun.;2007;53;143;59;84
Kazlų Rūda mun.;2007;54;164;81;83
Kazlų Rūda mun.;2007;55;151;69;82
Kazlų Rūda mun.;2007;56;170;85;85
Kazlų Rūda mun.;2007;57;195;91;104
Kazlų Rūda mun.;2007;58;158;71;87
Kazlų Rūda mun.;2007;59;115;59;56
Kazlų Rūda mun.;2007;60;130;54;76
Kazlų Rūda mun.;2007;61;140;62;78
Kazlų Rūda mun.;2007;62;99;46;53
Kazlų Rūda mun.;2007;63;134;59;75
Kazlų Rūda mun.;2007;64;135;60;75
Kazlų Rūda mun.;2007;65;158;64;94
Kazlų Rūda mun.;2007;66;138;61;77
Kazlų Rūda mun.;2007;67;132;49;83
Kazlų Rūda mun.;2007;68;152;60;92
Kazlų Rūda mun.;2007;69;163;76;87
Kazlų Rūda mun.;2007;70;136;55;81
Kazlų Rūda mun.;2007;71;161;57;104
Kazlų Rūda mun.;2007;72;88;35;53
Kazlų Rūda mun.;2007;73;148;56;92
Kazlų Rūda mun.;2007;74;154;53;101
Kazlų Rūda mun.;2007;75;120;34;86
Kazlų Rūda mun.;2007;76;122;41;81
Kazlų Rūda mun.;2007;77;125;30;95
Kazlų Rūda mun.;2007;78;130;38;92
Kazlų Rūda mun.;2007;79;101;34;67
Kazlų Rūda mun.;2007;80;88;23;65
Kazlų Rūda mun.;2007;81;98;27;71
Kazlų Rūda mun.;2007;82;78;28;50
Kazlų Rūda mun.;2007;83;63;21;42
Kazlų Rūda mun.;2007;84;41;11;30
Kazlų Rūda mun.;2007;85;234;49;185
Kazlų Rūda mun.;2008;-1;14080;6634;7446
Kazlų Rūda mun.;2008;0;134;68;66
Kazlų Rūda mun.;2008;1;126;65;61
Kazlų Rūda mun.;2008;2;132;64;68
Kazlų Rūda mun.;2008;3;148;80;68
Kazlų Rūda mun.;2008;4;171;92;79
Kazlų Rūda mun.;2008;5;126;69;57
Kazlų Rūda mun.;2008;6;143;67;76
Kazlų Rūda mun.;2008;7;153;82;71
Kazlų Rūda mun.;2008;8;146;79;67
Kazlų Rūda mun.;2008;9;164;87;77
Kazlų Rūda mun.;2008;10;177;94;83
Kazlų Rūda mun.;2008;11;176;87;89
Kazlų Rūda mun.;2008;12;190;86;104
Kazlų Rūda mun.;2008;13;191;93;98
Kazlų Rūda mun.;2008;14;212;114;98
Kazlų Rūda mun.;2008;15;233;111;122
Kazlų Rūda mun.;2008;16;215;117;98
Kazlų Rūda mun.;2008;17;239;129;110
Kazlų Rūda mun.;2008;18;208;109;99
Kazlų Rūda mun.;2008;19;219;127;92
Kazlų Rūda mun.;2008;20;220;110;110
Kazlų Rūda mun.;2008;21;222;118;104
Kazlų Rūda mun.;2008;22;202;87;115
Kazlų Rūda mun.;2008;23;194;83;111
Kazlų Rūda mun.;2008;24;202;114;88
Kazlų Rūda mun.;2008;25;167;76;91
Kazlų Rūda mun.;2008;26;153;81;72
Kazlų Rūda mun.;2008;27;173;94;79
Kazlų Rūda mun.;2008;28;133;62;71
Kazlų Rūda mun.;2008;29;175;103;72
Kazlų Rūda mun.;2008;30;160;83;77
Kazlų Rūda mun.;2008;31;166;90;76
Kazlų Rūda mun.;2008;32;153;89;64
Kazlų Rūda mun.;2008;33;174;93;81
Kazlų Rūda mun.;2008;34;186;95;91
Kazlų Rūda mun.;2008;35;181;86;95
Kazlų Rūda mun.;2008;36;188;97;91
Kazlų Rūda mun.;2008;37;209;106;103
Kazlų Rūda mun.;2008;38;203;100;103
Kazlų Rūda mun.;2008;39;169;78;91
Kazlų Rūda mun.;2008;40;181;106;75
Kazlų Rūda mun.;2008;41;177;81;96
Kazlų Rūda mun.;2008;42;179;91;88
Kazlų Rūda mun.;2008;43;208;99;109
Kazlų Rūda mun.;2008;44;215;105;110
Kazlų Rūda mun.;2008;45;204;97;107
Kazlų Rūda mun.;2008;46;225;105;120
Kazlų Rūda mun.;2008;47;251;135;116
Kazlų Rūda mun.;2008;48;191;86;105
Kazlų Rūda mun.;2008;49;199;104;95
Kazlų Rūda mun.;2008;50;195;96;99
Kazlų Rūda mun.;2008;51;177;76;101
Kazlų Rūda mun.;2008;52;185;92;93
Kazlų Rūda mun.;2008;53;148;70;78
Kazlų Rūda mun.;2008;54;142;57;85
Kazlų Rūda mun.;2008;55;162;80;82
Kazlų Rūda mun.;2008;56;151;68;83
Kazlų Rūda mun.;2008;57;170;84;86
Kazlų Rūda mun.;2008;58;190;90;100
Kazlų Rūda mun.;2008;59;158;69;89
Kazlų Rūda mun.;2008;60;115;58;57
Kazlų Rūda mun.;2008;61;128;53;75
Kazlų Rūda mun.;2008;62;138;60;78
Kazlų Rūda mun.;2008;63;100;46;54
Kazlų Rūda mun.;2008;64;132;57;75
Kazlų Rūda mun.;2008;65;131;57;74
Kazlų Rūda mun.;2008;66;156;63;93
Kazlų Rūda mun.;2008;67;133;60;73
Kazlų Rūda mun.;2008;68;128;47;81
Kazlų Rūda mun.;2008;69;152;57;95
Kazlų Rūda mun.;2008;70;161;74;87
Kazlų Rūda mun.;2008;71;133;53;80
Kazlų Rūda mun.;2008;72;158;58;100
Kazlų Rūda mun.;2008;73;84;31;53
Kazlų Rūda mun.;2008;74;139;50;89
Kazlų Rūda mun.;2008;75;146;50;96
Kazlų Rūda mun.;2008;76;115;30;85
Kazlų Rūda mun.;2008;77;119;42;77
Kazlų Rūda mun.;2008;78;121;28;93
Kazlų Rūda mun.;2008;79;121;37;84
Kazlų Rūda mun.;2008;80;94;32;62
Kazlų Rūda mun.;2008;81;81;19;62
Kazlų Rūda mun.;2008;82;95;25;70
Kazlų Rūda mun.;2008;83;72;25;47
Kazlų Rūda mun.;2008;84;53;18;35
Kazlų Rūda mun.;2008;85;234;48;186
Kazlų Rūda mun.;2009;-1;13906;6560;7346
Kazlų Rūda mun.;2009;0;121;60;61
Kazlų Rūda mun.;2009;1;136;70;66
Kazlų Rūda mun.;2009;2;126;65;61
Kazlų Rūda mun.;2009;3;128;62;66
Kazlų Rūda mun.;2009;4;148;80;68
Kazlų Rūda mun.;2009;5;173;91;82
Kazlų Rūda mun.;2009;6;124;70;54
Kazlų Rūda mun.;2009;7;138;64;74
Kazlų Rūda mun.;2009;8;153;80;73
Kazlų Rūda mun.;2009;9;138;79;59
Kazlų Rūda mun.;2009;10;160;85;75
Kazlų Rūda mun.;2009;11;175;91;84
Kazlų Rūda mun.;2009;12;173;88;85
Kazlų Rūda mun.;2009;13;187;82;105
Kazlų Rūda mun.;2009;14;189;91;98
Kazlų Rūda mun.;2009;15;210;111;99
Kazlų Rūda mun.;2009;16;230;110;120
Kazlų Rūda mun.;2009;17;214;118;96
Kazlų Rūda mun.;2009;18;238;129;109
Kazlų Rūda mun.;2009;19;202;107;95
Kazlų Rūda mun.;2009;20;221;127;94
Kazlų Rūda mun.;2009;21;218;109;109
Kazlų Rūda mun.;2009;22;212;114;98
Kazlų Rūda mun.;2009;23;200;89;111
Kazlų Rūda mun.;2009;24;190;81;109
Kazlų Rūda mun.;2009;25;200;113;87
Kazlų Rūda mun.;2009;26;161;76;85
Kazlų Rūda mun.;2009;27;146;78;68
Kazlų Rūda mun.;2009;28;168;92;76
Kazlų Rūda mun.;2009;29;127;61;66
Kazlų Rūda mun.;2009;30;173;99;74
Kazlų Rūda mun.;2009;31;161;84;77
Kazlų Rūda mun.;2009;32;160;86;74
Kazlų Rūda mun.;2009;33;153;91;62
Kazlų Rūda mun.;2009;34;174;91;83
Kazlų Rūda mun.;2009;35;188;97;91
Kazlų Rūda mun.;2009;36;180;85;95
Kazlų Rūda mun.;2009;37;184;94;90
Kazlų Rūda mun.;2009;38;209;108;101
Kazlų Rūda mun.;2009;39;201;100;101
Kazlų Rūda mun.;2009;40;168;79;89
Kazlų Rūda mun.;2009;41;182;107;75
Kazlų Rūda mun.;2009;42;176;80;96
Kazlų Rūda mun.;2009;43;178;91;87
Kazlų Rūda mun.;2009;44;202;96;106
Kazlų Rūda mun.;2009;45;208;101;107
Kazlų Rūda mun.;2009;46;199;94;105
Kazlų Rūda mun.;2009;47;222;103;119
Kazlų Rūda mun.;2009;48;249;134;115
Kazlų Rūda mun.;2009;49;190;84;106
Kazlų Rūda mun.;2009;50;191;96;95
Kazlų Rūda mun.;2009;51;193;94;99
Kazlų Rūda mun.;2009;52;177;77;100
Kazlų Rūda mun.;2009;53;181;89;92
Kazlų Rūda mun.;2009;54;144;69;75
Kazlų Rūda mun.;2009;55;139;56;83
Kazlų Rūda mun.;2009;56;158;77;81
Kazlų Rūda mun.;2009;57;146;67;79
Kazlų Rūda mun.;2009;58;168;82;86
Kazlų Rūda mun.;2009;59;188;89;99
Kazlų Rūda mun.;2009;60;156;67;89
Kazlų Rūda mun.;2009;61;108;54;54
Kazlų Rūda mun.;2009;62;125;52;73
Kazlų Rūda mun.;2009;63;139;60;79
Kazlų Rūda mun.;2009;64;100;46;54
Kazlų Rūda mun.;2009;65;129;54;75
Kazlų Rūda mun.;2009;66;129;55;74
Kazlų Rūda mun.;2009;67;155;63;92
Kazlų Rūda mun.;2009;68;133;59;74
Kazlų Rūda mun.;2009;69;129;46;83
Kazlų Rūda mun.;2009;70;150;56;94
Kazlų Rūda mun.;2009;71;155;69;86
Kazlų Rūda mun.;2009;72;126;49;77
Kazlų Rūda mun.;2009;73;155;58;97
Kazlų Rūda mun.;2009;74;83;30;53
Kazlų Rūda mun.;2009;75;130;42;88
Kazlų Rūda mun.;2009;76;143;51;92
Kazlų Rūda mun.;2009;77;114;30;84
Kazlų Rūda mun.;2009;78;110;36;74
Kazlų Rūda mun.;2009;79;123;30;93
Kazlų Rūda mun.;2009;80;112;34;78
Kazlų Rūda mun.;2009;81;88;30;58
Kazlų Rūda mun.;2009;82;74;19;55
Kazlų Rūda mun.;2009;83;86;22;64
Kazlų Rūda mun.;2009;84;64;21;43
Kazlų Rūda mun.;2009;85;242;54;188
Kazlų Rūda mun.;2010;-1;13659;6432;7227
Kazlų Rūda mun.;2010;0;120;68;52
Kazlų Rūda mun.;2010;1;120;58;62
Kazlų Rūda mun.;2010;2;134;70;64
Kazlų Rūda mun.;2010;3;124;62;62
Kazlų Rūda mun.;2010;4;127;61;66
Kazlų Rūda mun.;2010;5;146;78;68
Kazlų Rūda mun.;2010;6;171;90;81
Kazlų Rūda mun.;2010;7;119;70;49
Kazlų Rūda mun.;2010;8;137;63;74
Kazlų Rūda mun.;2010;9;151;76;75
Kazlų Rūda mun.;2010;10;138;78;60
Kazlų Rūda mun.;2010;11;159;83;76
Kazlų Rūda mun.;2010;12;171;89;82
Kazlų Rūda mun.;2010;13;170;86;84
Kazlų Rūda mun.;2010;14;189;83;106
Kazlų Rūda mun.;2010;15;187;92;95
Kazlų Rūda mun.;2010;16;211;114;97
Kazlų Rūda mun.;2010;17;228;107;121
Kazlų Rūda mun.;2010;18;214;117;97
Kazlų Rūda mun.;2010;19;231;125;106
Kazlų Rūda mun.;2010;20;199;107;92
Kazlų Rūda mun.;2010;21;219;127;92
Kazlų Rūda mun.;2010;22;213;107;106
Kazlų Rūda mun.;2010;23;206;111;95
Kazlų Rūda mun.;2010;24;192;86;106
Kazlų Rūda mun.;2010;25;179;74;105
Kazlų Rūda mun.;2010;26;192;107;85
Kazlų Rūda mun.;2010;27;153;71;82
Kazlų Rūda mun.;2010;28;134;73;61
Kazlų Rūda mun.;2010;29;160;87;73
Kazlų Rūda mun.;2010;30;123;58;65
Kazlų Rūda mun.;2010;31;170;97;73
Kazlų Rūda mun.;2010;32;158;84;74
Kazlų Rūda mun.;2010;33;152;83;69
Kazlų Rūda mun.;2010;34;147;88;59
Kazlų Rūda mun.;2010;35;167;89;78
Kazlų Rūda mun.;2010;36;186;97;89
Kazlų Rūda mun.;2010;37;178;86;92
Kazlų Rūda mun.;2010;38;183;94;89
Kazlų Rūda mun.;2010;39;205;106;99
Kazlų Rūda mun.;2010;40;203;100;103
Kazlų Rūda mun.;2010;41;164;76;88
Kazlų Rūda mun.;2010;42;175;101;74
Kazlų Rūda mun.;2010;43;179;82;97
Kazlų Rūda mun.;2010;44;175;91;84
Kazlų Rūda mun.;2010;45;199;96;103
Kazlų Rūda mun.;2010;46;207;100;107
Kazlų Rūda mun.;2010;47;197;92;105
Kazlų Rūda mun.;2010;48;222;103;119
Kazlų Rūda mun.;2010;49;241;127;114
Kazlų Rūda mun.;2010;50;192;86;106
Kazlų Rūda mun.;2010;51;184;90;94
Kazlų Rūda mun.;2010;52;194;96;98
Kazlų Rūda mun.;2010;53;176;74;102
Kazlų Rūda mun.;2010;54;176;84;92
Kazlų Rūda mun.;2010;55;142;68;74
Kazlų Rūda mun.;2010;56;140;56;84
Kazlų Rūda mun.;2010;57;154;75;79
Kazlų Rūda mun.;2010;58;147;68;79
Kazlų Rūda mun.;2010;59;167;81;86
Kazlų Rūda mun.;2010;60;182;84;98
Kazlų Rūda mun.;2010;61;157;67;90
Kazlų Rūda mun.;2010;62;107;52;55
Kazlų Rūda mun.;2010;63;122;50;72
Kazlų Rūda mun.;2010;64;137;59;78
Kazlų Rūda mun.;2010;65;94;41;53
Kazlų Rūda mun.;2010;66;127;53;74
Kazlų Rūda mun.;2010;67;130;55;75
Kazlų Rūda mun.;2010;68;150;60;90
Kazlų Rūda mun.;2010;69;125;53;72
Kazlų Rūda mun.;2010;70;129;47;82
Kazlų Rūda mun.;2010;71;148;53;95
Kazlų Rūda mun.;2010;72;150;66;84
Kazlų Rūda mun.;2010;73;123;45;78
Kazlų Rūda mun.;2010;74;147;55;92
Kazlų Rūda mun.;2010;75;82;29;53
Kazlų Rūda mun.;2010;76;123;39;84
Kazlų Rūda mun.;2010;77;139;47;92
Kazlų Rūda mun.;2010;78;108;26;82
Kazlų Rūda mun.;2010;79;102;32;70
Kazlų Rūda mun.;2010;80;115;26;89
Kazlų Rūda mun.;2010;81;101;33;68
Kazlų Rūda mun.;2010;82;74;22;52
Kazlų Rūda mun.;2010;83;63;16;47
Kazlų Rūda mun.;2010;84;78;20;58
Kazlų Rūda mun.;2010;85;249;54;195
Kazlų Rūda mun.;2011;-1;13273;6289;6984
Kazlų Rūda mun.;2011;0;131;72;59
Kazlų Rūda mun.;2011;1;109;61;48
Kazlų Rūda mun.;2011;2;121;63;58
Kazlų Rūda mun.;2011;3;130;62;68
Kazlų Rūda mun.;2011;4;121;63;58
Kazlų Rūda mun.;2011;5;112;65;47
Kazlų Rūda mun.;2011;6;156;83;73
Kazlų Rūda mun.;2011;7;180;97;83
Kazlų Rūda mun.;2011;8;131;76;55
Kazlų Rūda mun.;2011;9;131;63;68
Kazlų Rūda mun.;2011;10;154;80;74
Kazlų Rūda mun.;2011;11;145;84;61
Kazlų Rūda mun.;2011;12;163;82;81
Kazlų Rūda mun.;2011;13;170;92;78
Kazlų Rūda mun.;2011;14;157;80;77
Kazlų Rūda mun.;2011;15;180;84;96
Kazlų Rūda mun.;2011;16;187;93;94
Kazlų Rūda mun.;2011;17;196;110;86
Kazlų Rūda mun.;2011;18;218;105;113
Kazlų Rūda mun.;2011;19;210;115;95
Kazlų Rūda mun.;2011;20;208;110;98
Kazlų Rūda mun.;2011;21;188;106;82
Kazlų Rūda mun.;2011;22;189;111;78
Kazlų Rūda mun.;2011;23;182;99;83
Kazlų Rūda mun.;2011;24;179;101;78
Kazlų Rūda mun.;2011;25;161;69;92
Kazlų Rūda mun.;2011;26;139;63;76
Kazlų Rūda mun.;2011;27;146;82;64
Kazlų Rūda mun.;2011;28;134;64;70
Kazlų Rūda mun.;2011;29;144;71;73
Kazlų Rūda mun.;2011;30;163;87;76
Kazlų Rūda mun.;2011;31;137;64;73
Kazlų Rūda mun.;2011;32;160;93;67
Kazlų Rūda mun.;2011;33;182;95;87
Kazlų Rūda mun.;2011;34;167;79;88
Kazlų Rūda mun.;2011;35;146;84;62
Kazlų Rūda mun.;2011;36;168;86;82
Kazlų Rūda mun.;2011;37;184;98;86
Kazlų Rūda mun.;2011;38;188;100;88
Kazlų Rūda mun.;2011;39;193;99;94
Kazlų Rūda mun.;2011;40;199;100;99
Kazlų Rūda mun.;2011;41;199;97;102
Kazlų Rūda mun.;2011;42;163;79;84
Kazlų Rūda mun.;2011;43;180;108;72
Kazlų Rūda mun.;2011;44;188;88;100
Kazlų Rūda mun.;2011;45;171;81;90
Kazlų Rūda mun.;2011;46;195;82;113
Kazlų Rūda mun.;2011;47;207;104;103
Kazlų Rūda mun.;2011;48;185;91;94
Kazlų Rūda mun.;2011;49;216;95;121
Kazlų Rūda mun.;2011;50;233;119;114
Kazlų Rūda mun.;2011;51;194;89;105
Kazlų Rūda mun.;2011;52;173;87;86
Kazlų Rūda mun.;2011;53;188;88;100
Kazlų Rūda mun.;2011;54;175;73;102
Kazlų Rūda mun.;2011;55;174;84;90
Kazlų Rūda mun.;2011;56;130;64;66
Kazlų Rūda mun.;2011;57;142;61;81
Kazlų Rūda mun.;2011;58;151;72;79
Kazlų Rūda mun.;2011;59;150;66;84
Kazlų Rūda mun.;2011;60;182;81;101
Kazlų Rūda mun.;2011;61;171;76;95
Kazlų Rūda mun.;2011;62;151;63;88
Kazlų Rūda mun.;2011;63;110;55;55
Kazlų Rūda mun.;2011;64;123;50;73
Kazlų Rūda mun.;2011;65;128;58;70
Kazlų Rūda mun.;2011;66;101;46;55
Kazlų Rūda mun.;2011;67;130;53;77
Kazlų Rūda mun.;2011;68;129;53;76
Kazlų Rūda mun.;2011;69;146;55;91
Kazlų Rūda mun.;2011;70;118;51;67
Kazlų Rūda mun.;2011;71;119;41;78
Kazlų Rūda mun.;2011;72;130;44;86
Kazlų Rūda mun.;2011;73;140;59;81
Kazlų Rūda mun.;2011;74;113;40;73
Kazlų Rūda mun.;2011;75;124;45;79
Kazlų Rūda mun.;2011;76;75;25;50
Kazlų Rūda mun.;2011;77;107;31;76
Kazlų Rūda mun.;2011;78;127;41;86
Kazlų Rūda mun.;2011;79;92;22;70
Kazlų Rūda mun.;2011;80;94;31;63
Kazlų Rūda mun.;2011;81;93;21;72
Kazlų Rūda mun.;2011;82;96;31;65
Kazlų Rūda mun.;2011;83;69;19;50
Kazlų Rūda mun.;2011;84;52;14;38
Kazlų Rūda mun.;2011;85;280;65;215
Kazlų Rūda mun.;2012;-1;13034;6147;6887
Kazlų Rūda mun.;2012;0;139;68;71
Kazlų Rūda mun.;2012;1;132;71;61
Kazlų Rūda mun.;2012;2;112;65;47
Kazlų Rūda mun.;2012;3;119;59;60
Kazlų Rūda mun.;2012;4;132;62;70
Kazlų Rūda mun.;2012;5;122;63;59
Kazlų Rūda mun.;2012;6;105;62;43
Kazlų Rūda mun.;2012;7;157;82;75
Kazlų Rūda mun.;2012;8;178;96;82
Kazlų Rūda mun.;2012;9;128;72;56
Kazlų Rūda mun.;2012;10;128;63;65
Kazlų Rūda mun.;2012;11;156;81;75
Kazlų Rūda mun.;2012;12;147;85;62
Kazlų Rūda mun.;2012;13;158;79;79
Kazlų Rūda mun.;2012;14;171;90;81
Kazlų Rūda mun.;2012;15;151;77;74
Kazlų Rūda mun.;2012;16;180;83;97
Kazlų Rūda mun.;2012;17;190;96;94
Kazlų Rūda mun.;2012;18;196;110;86
Kazlų Rūda mun.;2012;19;206;99;107
Kazlų Rūda mun.;2012;20;197;109;88
Kazlų Rūda mun.;2012;21;198;102;96
Kazlų Rūda mun.;2012;22;170;94;76
Kazlų Rūda mun.;2012;23;172;101;71
Kazlų Rūda mun.;2012;24;183;105;78
Kazlų Rūda mun.;2012;25;166;95;71
Kazlų Rūda mun.;2012;26;157;66;91
Kazlų Rūda mun.;2012;27;129;61;68
Kazlų Rūda mun.;2012;28;143;81;62
Kazlų Rūda mun.;2012;29;124;58;66
Kazlų Rūda mun.;2012;30;140;66;74
Kazlų Rūda mun.;2012;31;155;85;70
Kazlų Rūda mun.;2012;32;128;61;67
Kazlų Rūda mun.;2012;33;155;89;66
Kazlų Rūda mun.;2012;34;175;89;86
Kazlų Rūda mun.;2012;35;163;77;86
Kazlų Rūda mun.;2012;36;148;85;63
Kazlų Rūda mun.;2012;37;166;86;80
Kazlų Rūda mun.;2012;38;183;99;84
Kazlų Rūda mun.;2012;39;184;99;85
Kazlų Rūda mun.;2012;40;192;100;92
Kazlų Rūda mun.;2012;41;193;97;96
Kazlų Rūda mun.;2012;42;193;94;99
Kazlų Rūda mun.;2012;43;161;79;82
Kazlų Rūda mun.;2012;44;181;108;73
Kazlų Rūda mun.;2012;45;181;84;97
Kazlų Rūda mun.;2012;46;167;77;90
Kazlų Rūda mun.;2012;47;196;82;114
Kazlų Rūda mun.;2012;48;205;104;101
Kazlų Rūda mun.;2012;49;182;87;95
Kazlų Rūda mun.;2012;50;209;90;119
Kazlų Rūda mun.;2012;51;232;120;112
Kazlų Rūda mun.;2012;52;187;84;103
Kazlų Rūda mun.;2012;53;167;84;83
Kazlų Rūda mun.;2012;54;185;84;101
Kazlų Rūda mun.;2012;55;175;72;103
Kazlų Rūda mun.;2012;56;170;80;90
Kazlų Rūda mun.;2012;57;130;63;67
Kazlų Rūda mun.;2012;58;138;59;79
Kazlų Rūda mun.;2012;59;147;69;78
Kazlų Rūda mun.;2012;60;153;66;87
Kazlų Rūda mun.;2012;61;175;77;98
Kazlų Rūda mun.;2012;62;165;71;94
Kazlų Rūda mun.;2012;63;151;61;90
Kazlų Rūda mun.;2012;64;108;54;54
Kazlų Rūda mun.;2012;65;123;50;73
Kazlų Rūda mun.;2012;66;124;58;66
Kazlų Rūda mun.;2012;67;96;42;54
Kazlų Rūda mun.;2012;68;134;55;79
Kazlų Rūda mun.;2012;69;126;50;76
Kazlų Rūda mun.;2012;70;141;51;90
Kazlų Rūda mun.;2012;71;114;47;67
Kazlų Rūda mun.;2012;72;117;40;77
Kazlų Rūda mun.;2012;73;128;42;86
Kazlų Rūda mun.;2012;74;134;55;79
Kazlų Rūda mun.;2012;75;109;37;72
Kazlų Rūda mun.;2012;76;120;41;79
Kazlų Rūda mun.;2012;77;71;22;49
Kazlų Rūda mun.;2012;78;101;28;73
Kazlų Rūda mun.;2012;79;116;37;79
Kazlų Rūda mun.;2012;80;91;22;69
Kazlų Rūda mun.;2012;81;90;29;61
Kazlų Rūda mun.;2012;82;82;16;66
Kazlų Rūda mun.;2012;83;86;25;61
Kazlų Rūda mun.;2012;84;66;17;49
Kazlų Rūda mun.;2012;85;279;66;213
Kazlų Rūda mun.;2013;-1;12738;6012;6726
Kazlų Rūda mun.;2013;0;134;57;77
Kazlų Rūda mun.;2013;1;139;71;68
Kazlų Rūda mun.;2013;2;127;66;61
Kazlų Rūda mun.;2013;3;110;64;46
Kazlų Rūda mun.;2013;4;114;56;58
Kazlų Rūda mun.;2013;5;121;57;64
Kazlų Rūda mun.;2013;6;116;59;57
Kazlų Rūda mun.;2013;7;100;60;40
Kazlų Rūda mun.;2013;8;156;81;75
Kazlų Rūda mun.;2013;9;174;91;83
Kazlų Rūda mun.;2013;10;127;72;55
Kazlų Rūda mun.;2013;11;125;62;63
Kazlų Rūda mun.;2013;12;154;80;74
Kazlų Rūda mun.;2013;13;148;88;60
Kazlų Rūda mun.;2013;14;152;78;74
Kazlų Rūda mun.;2013;15;169;88;81
Kazlų Rūda mun.;2013;16;149;78;71
Kazlų Rūda mun.;2013;17;177;80;97
Kazlų Rūda mun.;2013;18;184;93;91
Kazlų Rūda mun.;2013;19;191;109;82
Kazlų Rūda mun.;2013;20;191;93;98
Kazlų Rūda mun.;2013;21;196;110;86
Kazlų Rūda mun.;2013;22;182;96;86
Kazlų Rūda mun.;2013;23;156;88;68
Kazlų Rūda mun.;2013;24;162;98;64
Kazlų Rūda mun.;2013;25;174;102;72
Kazlų Rūda mun.;2013;26;149;85;64
Kazlų Rūda mun.;2013;27;150;62;88
Kazlų Rūda mun.;2013;28;129;62;67
Kazlų Rūda mun.;2013;29;137;74;63
Kazlų Rūda mun.;2013;30;117;54;63
Kazlų Rūda mun.;2013;31;127;57;70
Kazlų Rūda mun.;2013;32;141;75;66
Kazlų Rūda mun.;2013;33;117;58;59
Kazlų Rūda mun.;2013;34;146;87;59
Kazlų Rūda mun.;2013;35;169;90;79
Kazlų Rūda mun.;2013;36;157;74;83
Kazlų Rūda mun.;2013;37;141;82;59
Kazlų Rūda mun.;2013;38;161;84;77
Kazlų Rūda mun.;2013;39;180;100;80
Kazlų Rūda mun.;2013;40;182;98;84
Kazlų Rūda mun.;2013;41;192;100;92
Kazlų Rūda mun.;2013;42;189;93;96
Kazlų Rūda mun.;2013;43;193;93;100
Kazlų Rūda mun.;2013;44;156;77;79
Kazlų Rūda mun.;2013;45;179;106;73
Kazlų Rūda mun.;2013;46;178;84;94
Kazlų Rūda mun.;2013;47;169;80;89
Kazlų Rūda mun.;2013;48;196;85;111
Kazlų Rūda mun.;2013;49;201;100;101
Kazlų Rūda mun.;2013;50;184;87;97
Kazlų Rūda mun.;2013;51;210;91;119
Kazlų Rūda mun.;2013;52;224;112;112
Kazlų Rūda mun.;2013;53;191;87;104
Kazlų Rūda mun.;2013;54;165;84;81
Kazlų Rūda mun.;2013;55;183;84;99
Kazlų Rūda mun.;2013;56;177;73;104
Kazlų Rūda mun.;2013;57;164;75;89
Kazlų Rūda mun.;2013;58;128;63;65
Kazlų Rūda mun.;2013;59;136;59;77
Kazlų Rūda mun.;2013;60;146;69;77
Kazlų Rūda mun.;2013;61;149;64;85
Kazlų Rūda mun.;2013;62;174;77;97
Kazlų Rūda mun.;2013;63;164;73;91
Kazlų Rūda mun.;2013;64;149;60;89
Kazlų Rūda mun.;2013;65;107;52;55
Kazlų Rūda mun.;2013;66;122;49;73
Kazlų Rūda mun.;2013;67;123;58;65
Kazlų Rūda mun.;2013;68;96;41;55
Kazlų Rūda mun.;2013;69;131;54;77
Kazlų Rūda mun.;2013;70;124;49;75
Kazlų Rūda mun.;2013;71;138;50;88
Kazlų Rūda mun.;2013;72;111;43;68
Kazlų Rūda mun.;2013;73;114;38;76
Kazlų Rūda mun.;2013;74;120;37;83
Kazlų Rūda mun.;2013;75;131;52;79
Kazlų Rūda mun.;2013;76;102;31;71
Kazlų Rūda mun.;2013;77;114;38;76
Kazlų Rūda mun.;2013;78;68;20;48
Kazlų Rūda mun.;2013;79;93;25;68
Kazlų Rūda mun.;2013;80;108;36;72
Kazlų Rūda mun.;2013;81;86;19;67
Kazlų Rūda mun.;2013;82;82;23;59
Kazlų Rūda mun.;2013;83;70;15;55
Kazlų Rūda mun.;2013;84;83;23;60
Kazlų Rūda mun.;2013;85;287;64;223
Kazlų Rūda mun.;2014;-1;12634;5963;6671
Kazlų Rūda mun.;2014;0;139;73;66
Kazlų Rūda mun.;2014;1;135;59;76
Kazlų Rūda mun.;2014;2;137;69;68
Kazlų Rūda mun.;2014;3;125;65;60
Kazlų Rūda mun.;2014;4;111;65;46
Kazlų Rūda mun.;2014;5;114;58;56
Kazlų Rūda mun.;2014;6;122;57;65
Kazlų Rūda mun.;2014;7;117;59;58
Kazlų Rūda mun.;2014;8;99;60;39
Kazlų Rūda mun.;2014;9;155;80;75
Kazlų Rūda mun.;2014;10;177;92;85
Kazlų Rūda mun.;2014;11;128;74;54
Kazlų Rūda mun.;2014;12;126;62;64
Kazlų Rūda mun.;2014;13;154;82;72
Kazlų Rūda mun.;2014;14;149;89;60
Kazlų Rūda mun.;2014;15;152;78;74
Kazlų Rūda mun.;2014;16;171;89;82
Kazlų Rūda mun.;2014;17;151;77;74
Kazlų Rūda mun.;2014;18;174;79;95
Kazlų Rūda mun.;2014;19;173;87;86
Kazlų Rūda mun.;2014;20;194;107;87
Kazlų Rūda mun.;2014;21;191;93;98
Kazlų Rūda mun.;2014;22;189;105;84
Kazlų Rūda mun.;2014;23;178;95;83
Kazlų Rūda mun.;2014;24;157;88;69
Kazlų Rūda mun.;2014;25;151;91;60
Kazlų Rūda mun.;2014;26;168;97;71
Kazlų Rūda mun.;2014;27;147;80;67
Kazlų Rūda mun.;2014;28;147;64;83
Kazlų Rūda mun.;2014;29;120;61;59
Kazlų Rūda mun.;2014;30;128;68;60
Kazlų Rūda mun.;2014;31;114;54;60
Kazlų Rūda mun.;2014;32;139;63;76
Kazlų Rūda mun.;2014;33;139;71;68
Kazlų Rūda mun.;2014;34;116;58;58
Kazlų Rūda mun.;2014;35;144;90;54
Kazlų Rūda mun.;2014;36;171;91;80
Kazlų Rūda mun.;2014;37;150;69;81
Kazlų Rūda mun.;2014;38;140;80;60
Kazlų Rūda mun.;2014;39;157;79;78
Kazlų Rūda mun.;2014;40;179;98;81
Kazlų Rūda mun.;2014;41;176;96;80
Kazlų Rūda mun.;2014;42;193;101;92
Kazlų Rūda mun.;2014;43;188;92;96
Kazlų Rūda mun.;2014;44;193;94;99
Kazlų Rūda mun.;2014;45;152;77;75
Kazlų Rūda mun.;2014;46;181;109;72
Kazlų Rūda mun.;2014;47;170;78;92
Kazlų Rūda mun.;2014;48;170;81;89
Kazlų Rūda mun.;2014;49;200;86;114
Kazlų Rūda mun.;2014;50;197;95;102
Kazlų Rūda mun.;2014;51;182;86;96
Kazlų Rūda mun.;2014;52;209;90;119
Kazlų Rūda mun.;2014;53;220;107;113
Kazlų Rūda mun.;2014;54;191;87;104
Kazlų Rūda mun.;2014;55;170;86;84
Kazlų Rūda mun.;2014;56;183;85;98
Kazlų Rūda mun.;2014;57;170;67;103
Kazlų Rūda mun.;2014;58;162;72;90
Kazlų Rūda mun.;2014;59;126;61;65
Kazlų Rūda mun.;2014;60;137;58;79
Kazlų Rūda mun.;2014;61;145;68;77
Kazlų Rūda mun.;2014;62;147;63;84
Kazlų Rūda mun.;2014;63;173;76;97
Kazlų Rūda mun.;2014;64;161;72;89
Kazlų Rūda mun.;2014;65;148;61;87
Kazlų Rūda mun.;2014;66;103;49;54
Kazlų Rūda mun.;2014;67;121;48;73
Kazlų Rūda mun.;2014;68;115;52;63
Kazlų Rūda mun.;2014;69;96;42;54
Kazlų Rūda mun.;2014;70;125;50;75
Kazlų Rūda mun.;2014;71;118;43;75
Kazlų Rūda mun.;2014;72;135;49;86
Kazlų Rūda mun.;2014;73;110;43;67
Kazlų Rūda mun.;2014;74;108;34;74
Kazlų Rūda mun.;2014;75;117;36;81
Kazlų Rūda mun.;2014;76;125;50;75
Kazlų Rūda mun.;2014;77;96;30;66
Kazlų Rūda mun.;2014;78;106;34;72
Kazlų Rūda mun.;2014;79;61;16;45
Kazlų Rūda mun.;2014;80;90;24;66
Kazlų Rūda mun.;2014;81;100;34;66
Kazlų Rūda mun.;2014;82;82;17;65
Kazlų Rūda mun.;2014;83;71;19;52
Kazlų Rūda mun.;2014;84;67;15;52
Kazlų Rūda mun.;2014;85;316;74;242
Kazlų Rūda mun.;2015;-1;12494;5921;6573
Kazlų Rūda mun.;2015;0;125;71;54
Kazlų Rūda mun.;2015;1;135;72;63
Kazlų Rūda mun.;2015;2;129;58;71
Kazlų Rūda mun.;2015;3;139;70;69
Kazlų Rūda mun.;2015;4;121;64;57
Kazlų Rūda mun.;2015;5;108;63;45
Kazlų Rūda mun.;2015;6;112;58;54
Kazlų Rūda mun.;2015;7;118;57;61
Kazlų Rūda mun.;2015;8;123;62;61
Kazlų Rūda mun.;2015;9;99;60;39
Kazlų Rūda mun.;2015;10;156;80;76
Kazlų Rūda mun.;2015;11;175;91;84
Kazlų Rūda mun.;2015;12;129;75;54
Kazlų Rūda mun.;2015;13;122;60;62
Kazlų Rūda mun.;2015;14;152;80;72
Kazlų Rūda mun.;2015;15;146;88;58
Kazlų Rūda mun.;2015;16;153;78;75
Kazlų Rūda mun.;2015;17;167;85;82
Kazlų Rūda mun.;2015;18;152;76;76
Kazlų Rūda mun.;2015;19;169;77;92
Kazlų Rūda mun.;2015;20;167;87;80
Kazlų Rūda mun.;2015;21;192;104;88
Kazlų Rūda mun.;2015;22;184;90;94
Kazlų Rūda mun.;2015;23;184;100;84
Kazlų Rūda mun.;2015;24;176;99;77
Kazlų Rūda mun.;2015;25;157;93;64
Kazlų Rūda mun.;2015;26;144;86;58
Kazlų Rūda mun.;2015;27;162;95;67
Kazlų Rūda mun.;2015;28;147;83;64
Kazlų Rūda mun.;2015;29;146;62;84
Kazlų Rūda mun.;2015;30;115;60;55
Kazlų Rūda mun.;2015;31;124;69;55
Kazlų Rūda mun.;2015;32;107;49;58
Kazlų Rūda mun.;2015;33;139;63;76
Kazlų Rūda mun.;2015;34;138;69;69
Kazlų Rūda mun.;2015;35;106;52;54
Kazlų Rūda mun.;2015;36;139;86;53
Kazlų Rūda mun.;2015;37;162;84;78
Kazlų Rūda mun.;2015;38;145;66;79
Kazlų Rūda mun.;2015;39;134;75;59
Kazlų Rūda mun.;2015;40;158;82;76
Kazlų Rūda mun.;2015;41;183;101;82
Kazlų Rūda mun.;2015;42;176;98;78
Kazlų Rūda mun.;2015;43;193;99;94
Kazlų Rūda mun.;2015;44;187;92;95
Kazlų Rūda mun.;2015;45;191;93;98
Kazlų Rūda mun.;2015;46;154;79;75
Kazlų Rūda mun.;2015;47;179;107;72
Kazlų Rūda mun.;2015;48;170;80;90
Kazlų Rūda mun.;2015;49;170;80;90
Kazlų Rūda mun.;2015;50;197;86;111
Kazlų Rūda mun.;2015;51;196;95;101
Kazlų Rūda mun.;2015;52;184;87;97
Kazlų Rūda mun.;2015;53;205;88;117
Kazlų Rūda mun.;2015;54;217;105;112
Kazlų Rūda mun.;2015;55;189;87;102
Kazlų Rūda mun.;2015;56;161;80;81
Kazlų Rūda mun.;2015;57;183;85;98
Kazlų Rūda mun.;2015;58;167;66;101
Kazlų Rūda mun.;2015;59;157;69;88
Kazlų Rūda mun.;2015;60;126;63;63
Kazlų Rūda mun.;2015;61;136;56;80
Kazlų Rūda mun.;2015;62;144;68;76
Kazlų Rūda mun.;2015;63;143;60;83
Kazlų Rūda mun.;2015;64;174;78;96
Kazlų Rūda mun.;2015;65;161;72;89
Kazlų Rūda mun.;2015;66;148;60;88
Kazlų Rūda mun.;2015;67;106;50;56
Kazlų Rūda mun.;2015;68;118;45;73
Kazlų Rūda mun.;2015;69;116;51;65
Kazlų Rūda mun.;2015;70;94;40;54
Kazlų Rūda mun.;2015;71;122;45;77
Kazlų Rūda mun.;2015;72;113;40;73
Kazlų Rūda mun.;2015;73;136;47;89
Kazlų Rūda mun.;2015;74;109;41;68
Kazlų Rūda mun.;2015;75;105;32;73
Kazlų Rūda mun.;2015;76;114;33;81
Kazlų Rūda mun.;2015;77;118;46;72
Kazlų Rūda mun.;2015;78;91;29;62
Kazlų Rūda mun.;2015;79;101;34;67
Kazlų Rūda mun.;2015;80;57;14;43
Kazlų Rūda mun.;2015;81;84;22;62
Kazlų Rūda mun.;2015;82;93;31;62
Kazlų Rūda mun.;2015;83;80;15;65
Kazlų Rūda mun.;2015;84;69;18;51
Kazlų Rūda mun.;2015;85;321;75;246
Kazlų Rūda mun.;2016;-1;12379;5859;6520
Kazlų Rūda mun.;2016;0;130;73;57
Kazlų Rūda mun.;2016;1;123;68;55
Kazlų Rūda mun.;2016;2;137;72;65
Kazlų Rūda mun.;2016;3;131;56;75
Kazlų Rūda mun.;2016;4;144;74;70
Kazlų Rūda mun.;2016;5;124;66;58
Kazlų Rūda mun.;2016;6;109;65;44
Kazlų Rūda mun.;2016;7;117;58;59
Kazlų Rūda mun.;2016;8;120;59;61
Kazlų Rūda mun.;2016;9;128;64;64
Kazlų Rūda mun.;2016;10;100;62;38
Kazlų Rūda mun.;2016;11;154;78;76
Kazlų Rūda mun.;2016;12;176;91;85
Kazlų Rūda mun.;2016;13;131;75;56
Kazlų Rūda mun.;2016;14;123;62;61
Kazlų Rūda mun.;2016;15;151;79;72
Kazlų Rūda mun.;2016;16;147;87;60
Kazlų Rūda mun.;2016;17;152;77;75
Kazlų Rūda mun.;2016;18;167;85;82
Kazlų Rūda mun.;2016;19;152;75;77
Kazlų Rūda mun.;2016;20;168;77;91
Kazlų Rūda mun.;2016;21;162;84;78
Kazlų Rūda mun.;2016;22;179;94;85
Kazlų Rūda mun.;2016;23;178;88;90
Kazlų Rūda mun.;2016;24;178;96;82
Kazlų Rūda mun.;2016;25;176;97;79
Kazlų Rūda mun.;2016;26;151;91;60
Kazlų Rūda mun.;2016;27;142;87;55
Kazlų Rūda mun.;2016;28;163;92;71
Kazlų Rūda mun.;2016;29;133;76;57
Kazlų Rūda mun.;2016;30;143;60;83
Kazlų Rūda mun.;2016;31;112;56;56
Kazlų Rūda mun.;2016;32;133;71;62
Kazlų Rūda mun.;2016;33;100;45;55
Kazlų Rūda mun.;2016;34;135;57;78
Kazlų Rūda mun.;2016;35;135;68;67
Kazlų Rūda mun.;2016;36;110;53;57
Kazlų Rūda mun.;2016;37;138;86;52
Kazlų Rūda mun.;2016;38;164;85;79
Kazlų Rūda mun.;2016;39;142;62;80
Kazlų Rūda mun.;2016;40;138;79;59
Kazlų Rūda mun.;2016;41;153;81;72
Kazlų Rūda mun.;2016;42;173;95;78
Kazlų Rūda mun.;2016;43;173;96;77
Kazlų Rūda mun.;2016;44;194;100;94
Kazlų Rūda mun.;2016;45;189;93;96
Kazlų Rūda mun.;2016;46;192;93;99
Kazlų Rūda mun.;2016;47;150;76;74
Kazlų Rūda mun.;2016;48;178;108;70
Kazlų Rūda mun.;2016;49;172;83;89
Kazlų Rūda mun.;2016;50;170;81;89
Kazlų Rūda mun.;2016;51;193;83;110
Kazlų Rūda mun.;2016;52;192;94;98
Kazlų Rūda mun.;2016;53;184;87;97
Kazlų Rūda mun.;2016;54;200;83;117
Kazlų Rūda mun.;2016;55;214;101;113
Kazlų Rūda mun.;2016;56;188;86;102
Kazlų Rūda mun.;2016;57;158;79;79
Kazlų Rūda mun.;2016;58;177;82;95
Kazlų Rūda mun.;2016;59;168;66;102
Kazlų Rūda mun.;2016;60;156;68;88
Kazlų Rūda mun.;2016;61;127;64;63
Kazlų Rūda mun.;2016;62;132;52;80
Kazlų Rūda mun.;2016;63;144;69;75
Kazlų Rūda mun.;2016;64;138;56;82
Kazlų Rūda mun.;2016;65;166;72;94
Kazlų Rūda mun.;2016;66;159;69;90
Kazlų Rūda mun.;2016;67;143;57;86
Kazlų Rūda mun.;2016;68;104;49;55
Kazlų Rūda mun.;2016;69;113;44;69
Kazlų Rūda mun.;2016;70;115;50;65
Kazlų Rūda mun.;2016;71;91;37;54
Kazlų Rūda mun.;2016;72;121;45;76
Kazlų Rūda mun.;2016;73;112;38;74
Kazlų Rūda mun.;2016;74;130;46;84
Kazlų Rūda mun.;2016;75;105;40;65
Kazlų Rūda mun.;2016;76;100;28;72
Kazlų Rūda mun.;2016;77;108;33;75
Kazlų Rūda mun.;2016;78;109;43;66
Kazlų Rūda mun.;2016;79;86;26;60
Kazlų Rūda mun.;2016;80;93;29;64
Kazlų Rūda mun.;2016;81;52;13;39
Kazlų Rūda mun.;2016;82;75;18;57
Kazlų Rūda mun.;2016;83;85;26;59
Kazlų Rūda mun.;2016;84;71;14;57
Kazlų Rūda mun.;2016;85;330;76;254
Kazlų Rūda mun.;2017;-1;12125;5758;6367
Kazlų Rūda mun.;2017;0;138;79;59
Kazlų Rūda mun.;2017;1;126;70;56
Kazlų Rūda mun.;2017;2;119;64;55
Kazlų Rūda mun.;2017;3;137;73;64
Kazlų Rūda mun.;2017;4;128;55;73
Kazlų Rūda mun.;2017;5;139;74;65
Kazlų Rūda mun.;2017;6;126;67;59
Kazlų Rūda mun.;2017;7;107;63;44
Kazlų Rūda mun.;2017;8;111;58;53
Kazlų Rūda mun.;2017;9;116;57;59
Kazlų Rūda mun.;2017;10;125;61;64
Kazlų Rūda mun.;2017;11;95;58;37
Kazlų Rūda mun.;2017;12;152;77;75
Kazlų Rūda mun.;2017;13;175;90;85
Kazlų Rūda mun.;2017;14;129;73;56
Kazlų Rūda mun.;2017;15;123;62;61
Kazlų Rūda mun.;2017;16;146;73;73
Kazlų Rūda mun.;2017;17;144;84;60
Kazlų Rūda mun.;2017;18;150;73;77
Kazlų Rūda mun.;2017;19;157;84;73
Kazlų Rūda mun.;2017;20;147;70;77
Kazlų Rūda mun.;2017;21;164;74;90
Kazlų Rūda mun.;2017;22;156;83;73
Kazlų Rūda mun.;2017;23;171;92;79
Kazlų Rūda mun.;2017;24;167;81;86
Kazlų Rūda mun.;2017;25;169;93;76
Kazlų Rūda mun.;2017;26;169;95;74
Kazlų Rūda mun.;2017;27;148;91;57
Kazlų Rūda mun.;2017;28;135;81;54
Kazlų Rūda mun.;2017;29;156;87;69
Kazlų Rūda mun.;2017;30;131;78;53
Kazlų Rūda mun.;2017;31;130;53;77
Kazlų Rūda mun.;2017;32;107;55;52
Kazlų Rūda mun.;2017;33;128;71;57
Kazlų Rūda mun.;2017;34;97;46;51
Kazlų Rūda mun.;2017;35;132;59;73
Kazlų Rūda mun.;2017;36;125;61;64
Kazlų Rūda mun.;2017;37;106;54;52
Kazlų Rūda mun.;2017;38;139;88;51
Kazlų Rūda mun.;2017;39;153;80;73
Kazlų Rūda mun.;2017;40;139;60;79
Kazlų Rūda mun.;2017;41;134;77;57
Kazlų Rūda mun.;2017;42;151;84;67
Kazlų Rūda mun.;2017;43;171;93;78
Kazlų Rūda mun.;2017;44;167;90;77
Kazlų Rūda mun.;2017;45;188;96;92
Kazlų Rūda mun.;2017;46;185;92;93
Kazlų Rūda mun.;2017;47;190;93;97
Kazlų Rūda mun.;2017;48;140;71;69
Kazlų Rūda mun.;2017;49;171;103;68
Kazlų Rūda mun.;2017;50;169;82;87
Kazlų Rūda mun.;2017;51;164;78;86
Kazlų Rūda mun.;2017;52;191;82;109
Kazlų Rūda mun.;2017;53;192;95;97
Kazlų Rūda mun.;2017;54;181;86;95
Kazlų Rūda mun.;2017;55;198;83;115
Kazlų Rūda mun.;2017;56;213;101;112
Kazlų Rūda mun.;2017;57;186;85;101
Kazlų Rūda mun.;2017;58;157;77;80
Kazlų Rūda mun.;2017;59;179;82;97
Kazlų Rūda mun.;2017;60;165;64;101
Kazlų Rūda mun.;2017;61;156;68;88
Kazlų Rūda mun.;2017;62;123;59;64
Kazlų Rūda mun.;2017;63;127;49;78
Kazlų Rūda mun.;2017;64;141;68;73
Kazlų Rūda mun.;2017;65;133;49;84
Kazlų Rūda mun.;2017;66;167;72;95
Kazlų Rūda mun.;2017;67;155;67;88
Kazlų Rūda mun.;2017;68;139;55;84
Kazlų Rūda mun.;2017;69;100;47;53
Kazlų Rūda mun.;2017;70;113;46;67
Kazlų Rūda mun.;2017;71;113;49;64
Kazlų Rūda mun.;2017;72;89;34;55
Kazlų Rūda mun.;2017;73;119;44;75
Kazlų Rūda mun.;2017;74;110;37;73
Kazlų Rūda mun.;2017;75;125;43;82
Kazlų Rūda mun.;2017;76;101;38;63
Kazlų Rūda mun.;2017;77;95;26;69
Kazlų Rūda mun.;2017;78;102;29;73
Kazlų Rūda mun.;2017;79;103;39;64
Kazlų Rūda mun.;2017;80;83;24;59
Kazlų Rūda mun.;2017;81;87;29;58
Kazlų Rūda mun.;2017;82;47;11;36
Kazlų Rūda mun.;2017;83;72;17;55
Kazlų Rūda mun.;2017;84;78;24;54
Kazlų Rūda mun.;2017;85;343;73;270
Kazlų Rūda mun.;2018;-1;11764;5589;6175
Kazlų Rūda mun.;2018;0;98;50;48
Kazlų Rūda mun.;2018;1;133;76;57
Kazlų Rūda mun.;2018;2;121;67;54
Kazlų Rūda mun.;2018;3;115;65;50
Kazlų Rūda mun.;2018;4;140;76;64
Kazlų Rūda mun.;2018;5;122;52;70
Kazlų Rūda mun.;2018;6;139;72;67
Kazlų Rūda mun.;2018;7;125;65;60
Kazlų Rūda mun.;2018;8;105;59;46
Kazlų Rūda mun.;2018;9;104;55;49
Kazlų Rūda mun.;2018;10;113;57;56
Kazlų Rūda mun.;2018;11;122;58;64
Kazlų Rūda mun.;2018;12;95;58;37
Kazlų Rūda mun.;2018;13;153;76;77
Kazlų Rūda mun.;2018;14;170;89;81
Kazlų Rūda mun.;2018;15;129;73;56
Kazlų Rūda mun.;2018;16;122;60;62
Kazlų Rūda mun.;2018;17;143;72;71
Kazlų Rūda mun.;2018;18;141;80;61
Kazlų Rūda mun.;2018;19;139;73;66
Kazlų Rūda mun.;2018;20;152;81;71
Kazlų Rūda mun.;2018;21;141;69;72
Kazlų Rūda mun.;2018;22;147;70;77
Kazlų Rūda mun.;2018;23;148;78;70
Kazlų Rūda mun.;2018;24;159;86;73
Kazlų Rūda mun.;2018;25;160;82;78
Kazlų Rūda mun.;2018;26;158;91;67
Kazlų Rūda mun.;2018;27;154;89;65
Kazlų Rūda mun.;2018;28;130;82;48
Kazlų Rūda mun.;2018;29;125;74;51
Kazlų Rūda mun.;2018;30;140;81;59
Kazlų Rūda mun.;2018;31;119;70;49
Kazlų Rūda mun.;2018;32;122;49;73
Kazlų Rūda mun.;2018;33;100;51;49
Kazlų Rūda mun.;2018;34;115;61;54
Kazlų Rūda mun.;2018;35;93;45;48
Kazlų Rūda mun.;2018;36;132;56;76
Kazlų Rūda mun.;2018;37;123;61;62
Kazlų Rūda mun.;2018;38;100;49;51
Kazlų Rūda mun.;2018;39;134;85;49
Kazlų Rūda mun.;2018;40;153;78;75
Kazlų Rūda mun.;2018;41;136;60;76
Kazlų Rūda mun.;2018;42;131;74;57
Kazlų Rūda mun.;2018;43;147;81;66
Kazlų Rūda mun.;2018;44;163;88;75
Kazlų Rūda mun.;2018;45;164;87;77
Kazlų Rūda mun.;2018;46;181;93;88
Kazlų Rūda mun.;2018;47;183;91;92
Kazlų Rūda mun.;2018;48;188;93;95
Kazlų Rūda mun.;2018;49;140;73;67
Kazlų Rūda mun.;2018;50;177;105;72
Kazlų Rūda mun.;2018;51;165;78;87
Kazlų Rūda mun.;2018;52;161;75;86
Kazlų Rūda mun.;2018;53;191;80;111
Kazlų Rūda mun.;2018;54;189;92;97
Kazlų Rūda mun.;2018;55;177;85;92
Kazlų Rūda mun.;2018;56;197;83;114
Kazlų Rūda mun.;2018;57;212;98;114
Kazlų Rūda mun.;2018;58;179;82;97
Kazlų Rūda mun.;2018;59;156;77;79
Kazlų Rūda mun.;2018;60;172;80;92
Kazlų Rūda mun.;2018;61;158;62;96
Kazlų Rūda mun.;2018;62;152;65;87
Kazlų Rūda mun.;2018;63;126;61;65
Kazlų Rūda mun.;2018;64;127;49;78
Kazlų Rūda mun.;2018;65;137;67;70
Kazlų Rūda mun.;2018;66;133;48;85
Kazlų Rūda mun.;2018;67;163;73;90
Kazlų Rūda mun.;2018;68;151;64;87
Kazlų Rūda mun.;2018;69;134;53;81
Kazlų Rūda mun.;2018;70;99;46;53
Kazlų Rūda mun.;2018;71;110;44;66
Kazlų Rūda mun.;2018;72;111;47;64
Kazlų Rūda mun.;2018;73;85;31;54
Kazlų Rūda mun.;2018;74;115;39;76
Kazlų Rūda mun.;2018;75;102;31;71
Kazlų Rūda mun.;2018;76;122;40;82
Kazlų Rūda mun.;2018;77;99;36;63
Kazlų Rūda mun.;2018;78;89;25;64
Kazlų Rūda mun.;2018;79;96;27;69
Kazlų Rūda mun.;2018;80;97;37;60
Kazlų Rūda mun.;2018;81;75;22;53
Kazlų Rūda mun.;2018;82;83;25;58
Kazlų Rūda mun.;2018;83;40;9;31
Kazlų Rūda mun.;2018;84;65;15;50
Kazlų Rūda mun.;2018;85;352;77;275
Kėdainiai d. mun.;2001;-1;65717;30790;34927
Kėdainiai d. mun.;2001;0;709;373;336
Kėdainiai d. mun.;2001;1;682;358;324
Kėdainiai d. mun.;2001;2;725;382;343
Kėdainiai d. mun.;2001;3;745;383;362
Kėdainiai d. mun.;2001;4;762;397;365
Kėdainiai d. mun.;2001;5;782;411;371
Kėdainiai d. mun.;2001;6;789;398;391
Kėdainiai d. mun.;2001;7;883;461;422
Kėdainiai d. mun.;2001;8;1073;507;566
Kėdainiai d. mun.;2001;9;1015;526;489
Kėdainiai d. mun.;2001;10;1022;521;501
Kėdainiai d. mun.;2001;11;1025;521;504
Kėdainiai d. mun.;2001;12;1002;506;496
Kėdainiai d. mun.;2001;13;1090;532;558
Kėdainiai d. mun.;2001;14;1124;551;573
Kėdainiai d. mun.;2001;15;1069;518;551
Kėdainiai d. mun.;2001;16;1051;547;504
Kėdainiai d. mun.;2001;17;1029;547;482
Kėdainiai d. mun.;2001;18;860;446;414
Kėdainiai d. mun.;2001;19;759;422;337
Kėdainiai d. mun.;2001;20;737;382;355
Kėdainiai d. mun.;2001;21;769;407;362
Kėdainiai d. mun.;2001;22;782;387;395
Kėdainiai d. mun.;2001;23;798;393;405
Kėdainiai d. mun.;2001;24;924;449;475
Kėdainiai d. mun.;2001;25;832;430;402
Kėdainiai d. mun.;2001;26;830;432;398
Kėdainiai d. mun.;2001;27;865;418;447
Kėdainiai d. mun.;2001;28;920;475;445
Kėdainiai d. mun.;2001;29;945;464;481
Kėdainiai d. mun.;2001;30;964;493;471
Kėdainiai d. mun.;2001;31;916;450;466
Kėdainiai d. mun.;2001;32;977;501;476
Kėdainiai d. mun.;2001;33;927;452;475
Kėdainiai d. mun.;2001;34;987;493;494
Kėdainiai d. mun.;2001;35;949;497;452
Kėdainiai d. mun.;2001;36;959;474;485
Kėdainiai d. mun.;2001;37;925;475;450
Kėdainiai d. mun.;2001;38;921;480;441
Kėdainiai d. mun.;2001;39;1015;490;525
Kėdainiai d. mun.;2001;40;996;443;553
Kėdainiai d. mun.;2001;41;987;475;512
Kėdainiai d. mun.;2001;42;912;451;461
Kėdainiai d. mun.;2001;43;805;412;393
Kėdainiai d. mun.;2001;44;824;399;425
Kėdainiai d. mun.;2001;45;830;399;431
Kėdainiai d. mun.;2001;46;823;394;429
Kėdainiai d. mun.;2001;47;767;365;402
Kėdainiai d. mun.;2001;48;870;387;483
Kėdainiai d. mun.;2001;49;774;382;392
Kėdainiai d. mun.;2001;50;797;371;426
Kėdainiai d. mun.;2001;51;809;383;426
Kėdainiai d. mun.;2001;52;759;379;380
Kėdainiai d. mun.;2001;53;697;319;378
Kėdainiai d. mun.;2001;54;688;331;357
Kėdainiai d. mun.;2001;55;791;346;445
Kėdainiai d. mun.;2001;56;662;283;379
Kėdainiai d. mun.;2001;57;826;358;468
Kėdainiai d. mun.;2001;58;878;386;492
Kėdainiai d. mun.;2001;59;817;333;484
Kėdainiai d. mun.;2001;60;769;349;420
Kėdainiai d. mun.;2001;61;781;351;430
Kėdainiai d. mun.;2001;62;729;309;420
Kėdainiai d. mun.;2001;63;731;306;425
Kėdainiai d. mun.;2001;64;750;333;417
Kėdainiai d. mun.;2001;65;701;283;418
Kėdainiai d. mun.;2001;66;677;260;417
Kėdainiai d. mun.;2001;67;662;264;398
Kėdainiai d. mun.;2001;68;670;246;424
Kėdainiai d. mun.;2001;69;613;239;374
Kėdainiai d. mun.;2001;70;587;218;369
Kėdainiai d. mun.;2001;71;513;177;336
Kėdainiai d. mun.;2001;72;530;178;352
Kėdainiai d. mun.;2001;73;520;184;336
Kėdainiai d. mun.;2001;74;479;115;364
Kėdainiai d. mun.;2001;75;429;112;317
Kėdainiai d. mun.;2001;76;431;152;279
Kėdainiai d. mun.;2001;77;353;104;249
Kėdainiai d. mun.;2001;78;349;102;247
Kėdainiai d. mun.;2001;79;316;102;214
Kėdainiai d. mun.;2001;80;251;68;183
Kėdainiai d. mun.;2001;81;191;63;128
Kėdainiai d. mun.;2001;82;154;33;121
Kėdainiai d. mun.;2001;83;135;38;97
Kėdainiai d. mun.;2001;84;163;41;122
Kėdainiai d. mun.;2001;85;783;218;565
Kėdainiai d. mun.;2002;-1;65127;30557;34570
Kėdainiai d. mun.;2002;0;660;356;304
Kėdainiai d. mun.;2002;1;701;371;330
Kėdainiai d. mun.;2002;2;682;357;325
Kėdainiai d. mun.;2002;3;722;383;339
Kėdainiai d. mun.;2002;4;742;382;360
Kėdainiai d. mun.;2002;5;758;396;362
Kėdainiai d. mun.;2002;6;780;411;369
Kėdainiai d. mun.;2002;7;776;393;383
Kėdainiai d. mun.;2002;8;876;459;417
Kėdainiai d. mun.;2002;9;1062;501;561
Kėdainiai d. mun.;2002;10;1017;527;490
Kėdainiai d. mun.;2002;11;1016;517;499
Kėdainiai d. mun.;2002;12;1011;514;497
Kėdainiai d. mun.;2002;13;990;498;492
Kėdainiai d. mun.;2002;14;1080;526;554
Kėdainiai d. mun.;2002;15;1110;543;567
Kėdainiai d. mun.;2002;16;1061;514;547
Kėdainiai d. mun.;2002;17;1040;537;503
Kėdainiai d. mun.;2002;18;1015;543;472
Kėdainiai d. mun.;2002;19;829;431;398
Kėdainiai d. mun.;2002;20;750;414;336
Kėdainiai d. mun.;2002;21;747;386;361
Kėdainiai d. mun.;2002;22;757;401;356
Kėdainiai d. mun.;2002;23;788;389;399
Kėdainiai d. mun.;2002;24;781;386;395
Kėdainiai d. mun.;2002;25;911;444;467
Kėdainiai d. mun.;2002;26;813;425;388
Kėdainiai d. mun.;2002;27;815;423;392
Kėdainiai d. mun.;2002;28;851;409;442
Kėdainiai d. mun.;2002;29;895;462;433
Kėdainiai d. mun.;2002;30;930;458;472
Kėdainiai d. mun.;2002;31;944;482;462
Kėdainiai d. mun.;2002;32;903;444;459
Kėdainiai d. mun.;2002;33;955;486;469
Kėdainiai d. mun.;2002;34;910;442;468
Kėdainiai d. mun.;2002;35;972;484;488
Kėdainiai d. mun.;2002;36;935;489;446
Kėdainiai d. mun.;2002;37;948;467;481
Kėdainiai d. mun.;2002;38;912;465;447
Kėdainiai d. mun.;2002;39;895;463;432
Kėdainiai d. mun.;2002;40;991;472;519
Kėdainiai d. mun.;2002;41;990;441;549
Kėdainiai d. mun.;2002;42;974;470;504
Kėdainiai d. mun.;2002;43;907;454;453
Kėdainiai d. mun.;2002;44;800;408;392
Kėdainiai d. mun.;2002;45;808;390;418
Kėdainiai d. mun.;2002;46;819;391;428
Kėdainiai d. mun.;2002;47;826;399;427
Kėdainiai d. mun.;2002;48;749;352;397
Kėdainiai d. mun.;2002;49;853;374;479
Kėdainiai d. mun.;2002;50;765;374;391
Kėdainiai d. mun.;2002;51;776;360;416
Kėdainiai d. mun.;2002;52;804;380;424
Kėdainiai d. mun.;2002;53;752;377;375
Kėdainiai d. mun.;2002;54;679;312;367
Kėdainiai d. mun.;2002;55;671;318;353
Kėdainiai d. mun.;2002;56;775;341;434
Kėdainiai d. mun.;2002;57;650;278;372
Kėdainiai d. mun.;2002;58;803;347;456
Kėdainiai d. mun.;2002;59;857;381;476
Kėdainiai d. mun.;2002;60;801;325;476
Kėdainiai d. mun.;2002;61;766;347;419
Kėdainiai d. mun.;2002;62;769;343;426
Kėdainiai d. mun.;2002;63;721;305;416
Kėdainiai d. mun.;2002;64;723;304;419
Kėdainiai d. mun.;2002;65;740;329;411
Kėdainiai d. mun.;2002;66;687;276;411
Kėdainiai d. mun.;2002;67;659;251;408
Kėdainiai d. mun.;2002;68;655;260;395
Kėdainiai d. mun.;2002;69;651;234;417
Kėdainiai d. mun.;2002;70;602;233;369
Kėdainiai d. mun.;2002;71;568;205;363
Kėdainiai d. mun.;2002;72;495;168;327
Kėdainiai d. mun.;2002;73;511;169;342
Kėdainiai d. mun.;2002;74;512;182;330
Kėdainiai d. mun.;2002;75;456;106;350
Kėdainiai d. mun.;2002;76;408;104;304
Kėdainiai d. mun.;2002;77;415;148;267
Kėdainiai d. mun.;2002;78;334;96;238
Kėdainiai d. mun.;2002;79;336;97;239
Kėdainiai d. mun.;2002;80;304;96;208
Kėdainiai d. mun.;2002;81;227;54;173
Kėdainiai d. mun.;2002;82;164;53;111
Kėdainiai d. mun.;2002;83;134;27;107
Kėdainiai d. mun.;2002;84;116;30;86
Kėdainiai d. mun.;2002;85;784;218;566
Kėdainiai d. mun.;2003;-1;64554;30282;34272
Kėdainiai d. mun.;2003;0;566;302;264
Kėdainiai d. mun.;2003;1;658;352;306
Kėdainiai d. mun.;2003;2;696;370;326
Kėdainiai d. mun.;2003;3;685;357;328
Kėdainiai d. mun.;2003;4;727;383;344
Kėdainiai d. mun.;2003;5;737;380;357
Kėdainiai d. mun.;2003;6;760;398;362
Kėdainiai d. mun.;2003;7;785;413;372
Kėdainiai d. mun.;2003;8;770;390;380
Kėdainiai d. mun.;2003;9;874;460;414
Kėdainiai d. mun.;2003;10;1049;490;559
Kėdainiai d. mun.;2003;11;1015;525;490
Kėdainiai d. mun.;2003;12;1008;513;495
Kėdainiai d. mun.;2003;13;995;503;492
Kėdainiai d. mun.;2003;14;971;486;485
Kėdainiai d. mun.;2003;15;1060;516;544
Kėdainiai d. mun.;2003;16;1091;535;556
Kėdainiai d. mun.;2003;17;1043;505;538
Kėdainiai d. mun.;2003;18;1023;529;494
Kėdainiai d. mun.;2003;19;1005;536;469
Kėdainiai d. mun.;2003;20;815;427;388
Kėdainiai d. mun.;2003;21;745;411;334
Kėdainiai d. mun.;2003;22;756;383;373
Kėdainiai d. mun.;2003;23;768;398;370
Kėdainiai d. mun.;2003;24;780;386;394
Kėdainiai d. mun.;2003;25;776;387;389
Kėdainiai d. mun.;2003;26;900;439;461
Kėdainiai d. mun.;2003;27;809;423;386
Kėdainiai d. mun.;2003;28;808;416;392
Kėdainiai d. mun.;2003;29;842;403;439
Kėdainiai d. mun.;2003;30;883;457;426
Kėdainiai d. mun.;2003;31;925;455;470
Kėdainiai d. mun.;2003;32;933;478;455
Kėdainiai d. mun.;2003;33;899;445;454
Kėdainiai d. mun.;2003;34;940;479;461
Kėdainiai d. mun.;2003;35;896;436;460
Kėdainiai d. mun.;2003;36;956;476;480
Kėdainiai d. mun.;2003;37;933;492;441
Kėdainiai d. mun.;2003;38;940;461;479
Kėdainiai d. mun.;2003;39;898;456;442
Kėdainiai d. mun.;2003;40;881;458;423
Kėdainiai d. mun.;2003;41;978;466;512
Kėdainiai d. mun.;2003;42;979;432;547
Kėdainiai d. mun.;2003;43;965;462;503
Kėdainiai d. mun.;2003;44;900;450;450
Kėdainiai d. mun.;2003;45;790;403;387
Kėdainiai d. mun.;2003;46;800;385;415
Kėdainiai d. mun.;2003;47;814;388;426
Kėdainiai d. mun.;2003;48;813;392;421
Kėdainiai d. mun.;2003;49;744;349;395
Kėdainiai d. mun.;2003;50;841;370;471
Kėdainiai d. mun.;2003;51;748;361;387
Kėdainiai d. mun.;2003;52;771;355;416
Kėdainiai d. mun.;2003;53;804;383;421
Kėdainiai d. mun.;2003;54;742;368;374
Kėdainiai d. mun.;2003;55;675;309;366
Kėdainiai d. mun.;2003;56;663;310;353
Kėdainiai d. mun.;2003;57;760;330;430
Kėdainiai d. mun.;2003;58;640;271;369
Kėdainiai d. mun.;2003;59;790;340;450
Kėdainiai d. mun.;2003;60;834;369;465
Kėdainiai d. mun.;2003;61;788;316;472
Kėdainiai d. mun.;2003;62;754;339;415
Kėdainiai d. mun.;2003;63;755;338;417
Kėdainiai d. mun.;2003;64;711;300;411
Kėdainiai d. mun.;2003;65;710;298;412
Kėdainiai d. mun.;2003;66;728;320;408
Kėdainiai d. mun.;2003;67;677;269;408
Kėdainiai d. mun.;2003;68;640;241;399
Kėdainiai d. mun.;2003;69;644;250;394
Kėdainiai d. mun.;2003;70;625;223;402
Kėdainiai d. mun.;2003;71;582;224;358
Kėdainiai d. mun.;2003;72;546;194;352
Kėdainiai d. mun.;2003;73;475;158;317
Kėdainiai d. mun.;2003;74;497;162;335
Kėdainiai d. mun.;2003;75;485;167;318
Kėdainiai d. mun.;2003;76;433;94;339
Kėdainiai d. mun.;2003;77;387;98;289
Kėdainiai d. mun.;2003;78;392;135;257
Kėdainiai d. mun.;2003;79;306;88;218
Kėdainiai d. mun.;2003;80;297;80;217
Kėdainiai d. mun.;2003;81;271;84;187
Kėdainiai d. mun.;2003;82;210;51;159
Kėdainiai d. mun.;2003;83;144;45;99
Kėdainiai d. mun.;2003;84;123;23;100
Kėdainiai d. mun.;2003;85;722;183;539
Kėdainiai d. mun.;2004;-1;63692;29852;33840
Kėdainiai d. mun.;2004;0;594;292;302
Kėdainiai d. mun.;2004;1;562;301;261
Kėdainiai d. mun.;2004;2;658;349;309
Kėdainiai d. mun.;2004;3;693;368;325
Kėdainiai d. mun.;2004;4;676;351;325
Kėdainiai d. mun.;2004;5;724;379;345
Kėdainiai d. mun.;2004;6;732;377;355
Kėdainiai d. mun.;2004;7;757;393;364
Kėdainiai d. mun.;2004;8;781;413;368
Kėdainiai d. mun.;2004;9;769;390;379
Kėdainiai d. mun.;2004;10;872;460;412
Kėdainiai d. mun.;2004;11;1044;491;553
Kėdainiai d. mun.;2004;12;1001;518;483
Kėdainiai d. mun.;2004;13;986;503;483
Kėdainiai d. mun.;2004;14;975;494;481
Kėdainiai d. mun.;2004;15;963;481;482
Kėdainiai d. mun.;2004;16;1037;509;528
Kėdainiai d. mun.;2004;17;1068;527;541
Kėdainiai d. mun.;2004;18;1016;495;521
Kėdainiai d. mun.;2004;19;993;514;479
Kėdainiai d. mun.;2004;20;976;522;454
Kėdainiai d. mun.;2004;21;799;417;382
Kėdainiai d. mun.;2004;22;737;404;333
Kėdainiai d. mun.;2004;23;754;380;374
Kėdainiai d. mun.;2004;24;762;390;372
Kėdainiai d. mun.;2004;25;767;384;383
Kėdainiai d. mun.;2004;26;753;373;380
Kėdainiai d. mun.;2004;27;874;426;448
Kėdainiai d. mun.;2004;28;790;424;366
Kėdainiai d. mun.;2004;29;785;400;385
Kėdainiai d. mun.;2004;30;816;386;430
Kėdainiai d. mun.;2004;31;865;448;417
Kėdainiai d. mun.;2004;32;900;440;460
Kėdainiai d. mun.;2004;33;918;469;449
Kėdainiai d. mun.;2004;34;882;439;443
Kėdainiai d. mun.;2004;35;914;462;452
Kėdainiai d. mun.;2004;36;880;425;455
Kėdainiai d. mun.;2004;37;937;470;467
Kėdainiai d. mun.;2004;38;913;480;433
Kėdainiai d. mun.;2004;39;926;458;468
Kėdainiai d. mun.;2004;40;884;449;435
Kėdainiai d. mun.;2004;41;870;453;417
Kėdainiai d. mun.;2004;42;954;457;497
Kėdainiai d. mun.;2004;43;969;428;541
Kėdainiai d. mun.;2004;44;947;454;493
Kėdainiai d. mun.;2004;45;895;443;452
Kėdainiai d. mun.;2004;46;784;401;383
Kėdainiai d. mun.;2004;47;790;379;411
Kėdainiai d. mun.;2004;48;803;383;420
Kėdainiai d. mun.;2004;49;811;396;415
Kėdainiai d. mun.;2004;50;726;337;389
Kėdainiai d. mun.;2004;51;823;360;463
Kėdainiai d. mun.;2004;52;731;354;377
Kėdainiai d. mun.;2004;53;754;347;407
Kėdainiai d. mun.;2004;54;787;371;416
Kėdainiai d. mun.;2004;55;733;360;373
Kėdainiai d. mun.;2004;56;659;299;360
Kėdainiai d. mun.;2004;57;648;301;347
Kėdainiai d. mun.;2004;58;754;327;427
Kėdainiai d. mun.;2004;59;625;264;361
Kėdainiai d. mun.;2004;60;767;325;442
Kėdainiai d. mun.;2004;61;813;353;460
Kėdainiai d. mun.;2004;62;774;309;465
Kėdainiai d. mun.;2004;63;742;331;411
Kėdainiai d. mun.;2004;64;739;325;414
Kėdainiai d. mun.;2004;65;700;294;406
Kėdainiai d. mun.;2004;66;697;287;410
Kėdainiai d. mun.;2004;67;707;303;404
Kėdainiai d. mun.;2004;68;664;259;405
Kėdainiai d. mun.;2004;69;631;234;397
Kėdainiai d. mun.;2004;70;622;242;380
Kėdainiai d. mun.;2004;71;612;214;398
Kėdainiai d. mun.;2004;72;566;212;354
Kėdainiai d. mun.;2004;73;530;189;341
Kėdainiai d. mun.;2004;74;461;148;313
Kėdainiai d. mun.;2004;75;473;144;329
Kėdainiai d. mun.;2004;76;461;155;306
Kėdainiai d. mun.;2004;77;407;83;324
Kėdainiai d. mun.;2004;78;362;95;267
Kėdainiai d. mun.;2004;79;362;117;245
Kėdainiai d. mun.;2004;80;274;77;197
Kėdainiai d. mun.;2004;81;279;72;207
Kėdainiai d. mun.;2004;82;246;75;171
Kėdainiai d. mun.;2004;83;190;44;146
Kėdainiai d. mun.;2004;84;127;41;86
Kėdainiai d. mun.;2004;85;690;159;531
Kėdainiai d. mun.;2005;-1;62551;29326;33225
Kėdainiai d. mun.;2005;0;571;285;286
Kėdainiai d. mun.;2005;1;584;286;298
Kėdainiai d. mun.;2005;2;554;296;258
Kėdainiai d. mun.;2005;3;651;346;305
Kėdainiai d. mun.;2005;4;680;362;318
Kėdainiai d. mun.;2005;5;668;348;320
Kėdainiai d. mun.;2005;6;716;373;343
Kėdainiai d. mun.;2005;7;722;372;350
Kėdainiai d. mun.;2005;8;744;387;357
Kėdainiai d. mun.;2005;9;772;411;361
Kėdainiai d. mun.;2005;10;766;388;378
Kėdainiai d. mun.;2005;11;859;454;405
Kėdainiai d. mun.;2005;12;1028;484;544
Kėdainiai d. mun.;2005;13;992;515;477
Kėdainiai d. mun.;2005;14;968;495;473
Kėdainiai d. mun.;2005;15;959;485;474
Kėdainiai d. mun.;2005;16;940;469;471
Kėdainiai d. mun.;2005;17;1016;499;517
Kėdainiai d. mun.;2005;18;1036;508;528
Kėdainiai d. mun.;2005;19;980;480;500
Kėdainiai d. mun.;2005;20;970;498;472
Kėdainiai d. mun.;2005;21;931;502;429
Kėdainiai d. mun.;2005;22;767;404;363
Kėdainiai d. mun.;2005;23;720;395;325
Kėdainiai d. mun.;2005;24;724;368;356
Kėdainiai d. mun.;2005;25;731;379;352
Kėdainiai d. mun.;2005;26;733;362;371
Kėdainiai d. mun.;2005;27;720;356;364
Kėdainiai d. mun.;2005;28;848;415;433
Kėdainiai d. mun.;2005;29;782;416;366
Kėdainiai d. mun.;2005;30;768;396;372
Kėdainiai d. mun.;2005;31;791;374;417
Kėdainiai d. mun.;2005;32;839;432;407
Kėdainiai d. mun.;2005;33;891;432;459
Kėdainiai d. mun.;2005;34;908;470;438
Kėdainiai d. mun.;2005;35;859;427;432
Kėdainiai d. mun.;2005;36;907;460;447
Kėdainiai d. mun.;2005;37;869;420;449
Kėdainiai d. mun.;2005;38;925;464;461
Kėdainiai d. mun.;2005;39;890;465;425
Kėdainiai d. mun.;2005;40;905;447;458
Kėdainiai d. mun.;2005;41;871;443;428
Kėdainiai d. mun.;2005;42;852;442;410
Kėdainiai d. mun.;2005;43;929;445;484
Kėdainiai d. mun.;2005;44;952;421;531
Kėdainiai d. mun.;2005;45;934;445;489
Kėdainiai d. mun.;2005;46;885;436;449
Kėdainiai d. mun.;2005;47;769;393;376
Kėdainiai d. mun.;2005;48;767;368;399
Kėdainiai d. mun.;2005;49;785;372;413
Kėdainiai d. mun.;2005;50;796;388;408
Kėdainiai d. mun.;2005;51;701;329;372
Kėdainiai d. mun.;2005;52;812;354;458
Kėdainiai d. mun.;2005;53;720;350;370
Kėdainiai d. mun.;2005;54;747;342;405
Kėdainiai d. mun.;2005;55;778;365;413
Kėdainiai d. mun.;2005;56;717;349;368
Kėdainiai d. mun.;2005;57;654;297;357
Kėdainiai d. mun.;2005;58;632;296;336
Kėdainiai d. mun.;2005;59;738;317;421
Kėdainiai d. mun.;2005;60;611;253;358
Kėdainiai d. mun.;2005;61;743;311;432
Kėdainiai d. mun.;2005;62;789;344;445
Kėdainiai d. mun.;2005;63;752;296;456
Kėdainiai d. mun.;2005;64;721;311;410
Kėdainiai d. mun.;2005;65;719;318;401
Kėdainiai d. mun.;2005;66;684;284;400
Kėdainiai d. mun.;2005;67;679;271;408
Kėdainiai d. mun.;2005;68;685;292;393
Kėdainiai d. mun.;2005;69;643;245;398
Kėdainiai d. mun.;2005;70;609;224;385
Kėdainiai d. mun.;2005;71;597;228;369
Kėdainiai d. mun.;2005;72;594;204;390
Kėdainiai d. mun.;2005;73;545;197;348
Kėdainiai d. mun.;2005;74;510;178;332
Kėdainiai d. mun.;2005;75;440;137;303
Kėdainiai d. mun.;2005;76;456;138;318
Kėdainiai d. mun.;2005;77;429;139;290
Kėdainiai d. mun.;2005;78;387;77;310
Kėdainiai d. mun.;2005;79;352;91;261
Kėdainiai d. mun.;2005;80;344;112;232
Kėdainiai d. mun.;2005;81;249;64;185
Kėdainiai d. mun.;2005;82;240;60;180
Kėdainiai d. mun.;2005;83;225;72;153
Kėdainiai d. mun.;2005;84;166;36;130
Kėdainiai d. mun.;2005;85;659;167;492
Kėdainiai d. mun.;2006;-1;60352;28180;32172
Kėdainiai d. mun.;2006;0;549;290;259
Kėdainiai d. mun.;2006;1;553;275;278
Kėdainiai d. mun.;2006;2;571;279;292
Kėdainiai d. mun.;2006;3;537;285;252
Kėdainiai d. mun.;2006;4;632;337;295
Kėdainiai d. mun.;2006;5;657;348;309
Kėdainiai d. mun.;2006;6;647;340;307
Kėdainiai d. mun.;2006;7;701;367;334
Kėdainiai d. mun.;2006;8;704;363;341
Kėdainiai d. mun.;2006;9;735;384;351
Kėdainiai d. mun.;2006;10;756;403;353
Kėdainiai d. mun.;2006;11;747;381;366
Kėdainiai d. mun.;2006;12;842;444;398
Kėdainiai d. mun.;2006;13;999;467;532
Kėdainiai d. mun.;2006;14;959;498;461
Kėdainiai d. mun.;2006;15;924;475;449
Kėdainiai d. mun.;2006;16;911;460;451
Kėdainiai d. mun.;2006;17;905;449;456
Kėdainiai d. mun.;2006;18;967;471;496
Kėdainiai d. mun.;2006;19;972;477;495
Kėdainiai d. mun.;2006;20;921;445;476
Kėdainiai d. mun.;2006;21;901;461;440
Kėdainiai d. mun.;2006;22;864;473;391
Kėdainiai d. mun.;2006;23;727;384;343
Kėdainiai d. mun.;2006;24;679;375;304
Kėdainiai d. mun.;2006;25;661;330;331
Kėdainiai d. mun.;2006;26;686;353;333
Kėdainiai d. mun.;2006;27;689;340;349
Kėdainiai d. mun.;2006;28;683;334;349
Kėdainiai d. mun.;2006;29;801;393;408
Kėdainiai d. mun.;2006;30;751;399;352
Kėdainiai d. mun.;2006;31;732;376;356
Kėdainiai d. mun.;2006;32;765;360;405
Kėdainiai d. mun.;2006;33;804;414;390
Kėdainiai d. mun.;2006;34;855;412;443
Kėdainiai d. mun.;2006;35;869;447;422
Kėdainiai d. mun.;2006;36;820;401;419
Kėdainiai d. mun.;2006;37;875;444;431
Kėdainiai d. mun.;2006;38;845;407;438
Kėdainiai d. mun.;2006;39;890;437;453
Kėdainiai d. mun.;2006;40;859;444;415
Kėdainiai d. mun.;2006;41;875;430;445
Kėdainiai d. mun.;2006;42;851;427;424
Kėdainiai d. mun.;2006;43;821;422;399
Kėdainiai d. mun.;2006;44;904;429;475
Kėdainiai d. mun.;2006;45;925;407;518
Kėdainiai d. mun.;2006;46;903;429;474
Kėdainiai d. mun.;2006;47;860;419;441
Kėdainiai d. mun.;2006;48;748;379;369
Kėdainiai d. mun.;2006;49;748;358;390
Kėdainiai d. mun.;2006;50;761;358;403
Kėdainiai d. mun.;2006;51;778;378;400
Kėdainiai d. mun.;2006;52;670;312;358
Kėdainiai d. mun.;2006;53;785;341;444
Kėdainiai d. mun.;2006;54;699;339;360
Kėdainiai d. mun.;2006;55;722;328;394
Kėdainiai d. mun.;2006;56;753;349;404
Kėdainiai d. mun.;2006;57;690;330;360
Kėdainiai d. mun.;2006;58;627;280;347
Kėdainiai d. mun.;2006;59;617;288;329
Kėdainiai d. mun.;2006;60;712;298;414
Kėdainiai d. mun.;2006;61;589;240;349
Kėdainiai d. mun.;2006;62;711;289;422
Kėdainiai d. mun.;2006;63;767;330;437
Kėdainiai d. mun.;2006;64;723;276;447
Kėdainiai d. mun.;2006;65;695;296;399
Kėdainiai d. mun.;2006;66;688;296;392
Kėdainiai d. mun.;2006;67;661;271;390
Kėdainiai d. mun.;2006;68;653;259;394
Kėdainiai d. mun.;2006;69;652;272;380
Kėdainiai d. mun.;2006;70;617;236;381
Kėdainiai d. mun.;2006;71;578;208;370
Kėdainiai d. mun.;2006;72;572;213;359
Kėdainiai d. mun.;2006;73;562;186;376
Kėdainiai d. mun.;2006;74;513;185;328
Kėdainiai d. mun.;2006;75;474;163;311
Kėdainiai d. mun.;2006;76;411;124;287
Kėdainiai d. mun.;2006;77;420;125;295
Kėdainiai d. mun.;2006;78;397;126;271
Kėdainiai d. mun.;2006;79;369;71;298
Kėdainiai d. mun.;2006;80;316;77;239
Kėdainiai d. mun.;2006;81;308;102;206
Kėdainiai d. mun.;2006;82;232;60;172
Kėdainiai d. mun.;2006;83;212;54;158
Kėdainiai d. mun.;2006;84;194;59;135
Kėdainiai d. mun.;2006;85;644;139;505
Kėdainiai d. mun.;2007;-1;59253;27577;31676
Kėdainiai d. mun.;2007;0;517;265;252
Kėdainiai d. mun.;2007;1;542;284;258
Kėdainiai d. mun.;2007;2;555;276;279
Kėdainiai d. mun.;2007;3;568;277;291
Kėdainiai d. mun.;2007;4;527;281;246
Kėdainiai d. mun.;2007;5;620;330;290
Kėdainiai d. mun.;2007;6;652;344;308
Kėdainiai d. mun.;2007;7;640;334;306
Kėdainiai d. mun.;2007;8;694;365;329
Kėdainiai d. mun.;2007;9;700;359;341
Kėdainiai d. mun.;2007;10;729;379;350
Kėdainiai d. mun.;2007;11;757;404;353
Kėdainiai d. mun.;2007;12;740;377;363
Kėdainiai d. mun.;2007;13;832;438;394
Kėdainiai d. mun.;2007;14;991;465;526
Kėdainiai d. mun.;2007;15;946;492;454
Kėdainiai d. mun.;2007;16;907;467;440
Kėdainiai d. mun.;2007;17;896;454;442
Kėdainiai d. mun.;2007;18;884;440;444
Kėdainiai d. mun.;2007;19;940;454;486
Kėdainiai d. mun.;2007;20;939;461;478
Kėdainiai d. mun.;2007;21;886;430;456
Kėdainiai d. mun.;2007;22;863;439;424
Kėdainiai d. mun.;2007;23;832;451;381
Kėdainiai d. mun.;2007;24;695;368;327
Kėdainiai d. mun.;2007;25;641;352;289
Kėdainiai d. mun.;2007;26;638;321;317
Kėdainiai d. mun.;2007;27;672;345;327
Kėdainiai d. mun.;2007;28;679;338;341
Kėdainiai d. mun.;2007;29;668;326;342
Kėdainiai d. mun.;2007;30;783;384;399
Kėdainiai d. mun.;2007;31;727;390;337
Kėdainiai d. mun.;2007;32;710;366;344
Kėdainiai d. mun.;2007;33;754;353;401
Kėdainiai d. mun.;2007;34;786;405;381
Kėdainiai d. mun.;2007;35;843;404;439
Kėdainiai d. mun.;2007;36;853;439;414
Kėdainiai d. mun.;2007;37;805;391;414
Kėdainiai d. mun.;2007;38;859;428;431
Kėdainiai d. mun.;2007;39;831;397;434
Kėdainiai d. mun.;2007;40;874;428;446
Kėdainiai d. mun.;2007;41;843;432;411
Kėdainiai d. mun.;2007;42;867;423;444
Kėdainiai d. mun.;2007;43;839;418;421
Kėdainiai d. mun.;2007;44;810;416;394
Kėdainiai d. mun.;2007;45;879;414;465
Kėdainiai d. mun.;2007;46;912;397;515
Kėdainiai d. mun.;2007;47;880;414;466
Kėdainiai d. mun.;2007;48;843;410;433
Kėdainiai d. mun.;2007;49;742;376;366
Kėdainiai d. mun.;2007;50;739;353;386
Kėdainiai d. mun.;2007;51;743;348;395
Kėdainiai d. mun.;2007;52;768;375;393
Kėdainiai d. mun.;2007;53;658;305;353
Kėdainiai d. mun.;2007;54;780;336;444
Kėdainiai d. mun.;2007;55;683;328;355
Kėdainiai d. mun.;2007;56;707;319;388
Kėdainiai d. mun.;2007;57;738;339;399
Kėdainiai d. mun.;2007;58;671;319;352
Kėdainiai d. mun.;2007;59;620;276;344
Kėdainiai d. mun.;2007;60;592;272;320
Kėdainiai d. mun.;2007;61;690;286;404
Kėdainiai d. mun.;2007;62;579;235;344
Kėdainiai d. mun.;2007;63;689;270;419
Kėdainiai d. mun.;2007;64;751;317;434
Kėdainiai d. mun.;2007;65;697;260;437
Kėdainiai d. mun.;2007;66;672;280;392
Kėdainiai d. mun.;2007;67;659;274;385
Kėdainiai d. mun.;2007;68;644;263;381
Kėdainiai d. mun.;2007;69;639;252;387
Kėdainiai d. mun.;2007;70;627;258;369
Kėdainiai d. mun.;2007;71;588;217;371
Kėdainiai d. mun.;2007;72;548;191;357
Kėdainiai d. mun.;2007;73;547;195;352
Kėdainiai d. mun.;2007;74;542;173;369
Kėdainiai d. mun.;2007;75;485;169;316
Kėdainiai d. mun.;2007;76;441;143;298
Kėdainiai d. mun.;2007;77;388;114;274
Kėdainiai d. mun.;2007;78;402;118;284
Kėdainiai d. mun.;2007;79;362;113;249
Kėdainiai d. mun.;2007;80;342;62;280
Kėdainiai d. mun.;2007;81;297;69;228
Kėdainiai d. mun.;2007;82;272;85;187
Kėdainiai d. mun.;2007;83;209;53;156
Kėdainiai d. mun.;2007;84;187;48;139
Kėdainiai d. mun.;2007;85;707;161;546
Kėdainiai d. mun.;2008;-1;58226;27044;31182
Kėdainiai d. mun.;2008;0;512;265;247
Kėdainiai d. mun.;2008;1;511;261;250
Kėdainiai d. mun.;2008;2;539;283;256
Kėdainiai d. mun.;2008;3;550;273;277
Kėdainiai d. mun.;2008;4;556;271;285
Kėdainiai d. mun.;2008;5;522;279;243
Kėdainiai d. mun.;2008;6;615;325;290
Kėdainiai d. mun.;2008;7;647;339;308
Kėdainiai d. mun.;2008;8;640;336;304
Kėdainiai d. mun.;2008;9;688;363;325
Kėdainiai d. mun.;2008;10;688;356;332
Kėdainiai d. mun.;2008;11;722;372;350
Kėdainiai d. mun.;2008;12;749;402;347
Kėdainiai d. mun.;2008;13;740;379;361
Kėdainiai d. mun.;2008;14;823;431;392
Kėdainiai d. mun.;2008;15;977;456;521
Kėdainiai d. mun.;2008;16;942;490;452
Kėdainiai d. mun.;2008;17;892;460;432
Kėdainiai d. mun.;2008;18;880;447;433
Kėdainiai d. mun.;2008;19;859;428;431
Kėdainiai d. mun.;2008;20;923;450;473
Kėdainiai d. mun.;2008;21;915;451;464
Kėdainiai d. mun.;2008;22;861;417;444
Kėdainiai d. mun.;2008;23;845;431;414
Kėdainiai d. mun.;2008;24;809;435;374
Kėdainiai d. mun.;2008;25;661;346;315
Kėdainiai d. mun.;2008;26;616;336;280
Kėdainiai d. mun.;2008;27;607;303;304
Kėdainiai d. mun.;2008;28;650;334;316
Kėdainiai d. mun.;2008;29;661;327;334
Kėdainiai d. mun.;2008;30;653;323;330
Kėdainiai d. mun.;2008;31;759;369;390
Kėdainiai d. mun.;2008;32;721;383;338
Kėdainiai d. mun.;2008;33;699;361;338
Kėdainiai d. mun.;2008;34;737;346;391
Kėdainiai d. mun.;2008;35;776;396;380
Kėdainiai d. mun.;2008;36;832;397;435
Kėdainiai d. mun.;2008;37;836;427;409
Kėdainiai d. mun.;2008;38;794;388;406
Kėdainiai d. mun.;2008;39;842;419;423
Kėdainiai d. mun.;2008;40;818;389;429
Kėdainiai d. mun.;2008;41;854;418;436
Kėdainiai d. mun.;2008;42;838;430;408
Kėdainiai d. mun.;2008;43;855;422;433
Kėdainiai d. mun.;2008;44;818;405;413
Kėdainiai d. mun.;2008;45;797;409;388
Kėdainiai d. mun.;2008;46;861;403;458
Kėdainiai d. mun.;2008;47;901;395;506
Kėdainiai d. mun.;2008;48;864;404;460
Kėdainiai d. mun.;2008;49;837;404;433
Kėdainiai d. mun.;2008;50;721;361;360
Kėdainiai d. mun.;2008;51;723;343;380
Kėdainiai d. mun.;2008;52;734;347;387
Kėdainiai d. mun.;2008;53;752;364;388
Kėdainiai d. mun.;2008;54;643;295;348
Kėdainiai d. mun.;2008;55;766;329;437
Kėdainiai d. mun.;2008;56;659;312;347
Kėdainiai d. mun.;2008;57;691;310;381
Kėdainiai d. mun.;2008;58;720;325;395
Kėdainiai d. mun.;2008;59;659;310;349
Kėdainiai d. mun.;2008;60;604;265;339
Kėdainiai d. mun.;2008;61;577;259;318
Kėdainiai d. mun.;2008;62;678;278;400
Kėdainiai d. mun.;2008;63;562;225;337
Kėdainiai d. mun.;2008;64;672;256;416
Kėdainiai d. mun.;2008;65;735;306;429
Kėdainiai d. mun.;2008;66;677;242;435
Kėdainiai d. mun.;2008;67;650;263;387
Kėdainiai d. mun.;2008;68;642;261;381
Kėdainiai d. mun.;2008;69;624;252;372
Kėdainiai d. mun.;2008;70;606;229;377
Kėdainiai d. mun.;2008;71;600;243;357
Kėdainiai d. mun.;2008;72;564;208;356
Kėdainiai d. mun.;2008;73;527;176;351
Kėdainiai d. mun.;2008;74;516;179;337
Kėdainiai d. mun.;2008;75;519;161;358
Kėdainiai d. mun.;2008;76;459;156;303
Kėdainiai d. mun.;2008;77;420;133;287
Kėdainiai d. mun.;2008;78;376;112;264
Kėdainiai d. mun.;2008;79;376;109;267
Kėdainiai d. mun.;2008;80;332;102;230
Kėdainiai d. mun.;2008;81;316;59;257
Kėdainiai d. mun.;2008;82;267;60;207
Kėdainiai d. mun.;2008;83;243;75;168
Kėdainiai d. mun.;2008;84;188;46;142
Kėdainiai d. mun.;2008;85;736;159;577
Kėdainiai d. mun.;2009;-1;57399;26611;30788
Kėdainiai d. mun.;2009;0;543;274;269
Kėdainiai d. mun.;2009;1;506;259;247
Kėdainiai d. mun.;2009;2;507;257;250
Kėdainiai d. mun.;2009;3;534;281;253
Kėdainiai d. mun.;2009;4;547;269;278
Kėdainiai d. mun.;2009;5;553;267;286
Kėdainiai d. mun.;2009;6;522;281;241
Kėdainiai d. mun.;2009;7;608;323;285
Kėdainiai d. mun.;2009;8;645;337;308
Kėdainiai d. mun.;2009;9;632;331;301
Kėdainiai d. mun.;2009;10;684;359;325
Kėdainiai d. mun.;2009;11;682;350;332
Kėdainiai d. mun.;2009;12;718;367;351
Kėdainiai d. mun.;2009;13;742;398;344
Kėdainiai d. mun.;2009;14;735;377;358
Kėdainiai d. mun.;2009;15;820;432;388
Kėdainiai d. mun.;2009;16;971;454;517
Kėdainiai d. mun.;2009;17;936;487;449
Kėdainiai d. mun.;2009;18;886;455;431
Kėdainiai d. mun.;2009;19;865;436;429
Kėdainiai d. mun.;2009;20;845;418;427
Kėdainiai d. mun.;2009;21;900;438;462
Kėdainiai d. mun.;2009;22;892;440;452
Kėdainiai d. mun.;2009;23;844;412;432
Kėdainiai d. mun.;2009;24;829;427;402
Kėdainiai d. mun.;2009;25;766;418;348
Kėdainiai d. mun.;2009;26;637;337;300
Kėdainiai d. mun.;2009;27;593;325;268
Kėdainiai d. mun.;2009;28;579;286;293
Kėdainiai d. mun.;2009;29;630;326;304
Kėdainiai d. mun.;2009;30;644;319;325
Kėdainiai d. mun.;2009;31;645;319;326
Kėdainiai d. mun.;2009;32;752;370;382
Kėdainiai d. mun.;2009;33;714;379;335
Kėdainiai d. mun.;2009;34;693;354;339
Kėdainiai d. mun.;2009;35;726;342;384
Kėdainiai d. mun.;2009;36;757;382;375
Kėdainiai d. mun.;2009;37;829;398;431
Kėdainiai d. mun.;2009;38;835;427;408
Kėdainiai d. mun.;2009;39;793;386;407
Kėdainiai d. mun.;2009;40;835;416;419
Kėdainiai d. mun.;2009;41;810;383;427
Kėdainiai d. mun.;2009;42;838;407;431
Kėdainiai d. mun.;2009;43;831;423;408
Kėdainiai d. mun.;2009;44;841;408;433
Kėdainiai d. mun.;2009;45;807;397;410
Kėdainiai d. mun.;2009;46;788;403;385
Kėdainiai d. mun.;2009;47;854;394;460
Kėdainiai d. mun.;2009;48;885;387;498
Kėdainiai d. mun.;2009;49;853;399;454
Kėdainiai d. mun.;2009;50;824;397;427
Kėdainiai d. mun.;2009;51;710;356;354
Kėdainiai d. mun.;2009;52;715;334;381
Kėdainiai d. mun.;2009;53;719;338;381
Kėdainiai d. mun.;2009;54;740;359;381
Kėdainiai d. mun.;2009;55;632;287;345
Kėdainiai d. mun.;2009;56;747;321;426
Kėdainiai d. mun.;2009;57;645;298;347
Kėdainiai d. mun.;2009;58;676;298;378
Kėdainiai d. mun.;2009;59;705;316;389
Kėdainiai d. mun.;2009;60;642;299;343
Kėdainiai d. mun.;2009;61;586;252;334
Kėdainiai d. mun.;2009;62;565;253;312
Kėdainiai d. mun.;2009;63;664;270;394
Kėdainiai d. mun.;2009;64;546;212;334
Kėdainiai d. mun.;2009;65;657;243;414
Kėdainiai d. mun.;2009;66;713;286;427
Kėdainiai d. mun.;2009;67;654;229;425
Kėdainiai d. mun.;2009;68;630;255;375
Kėdainiai d. mun.;2009;69;617;247;370
Kėdainiai d. mun.;2009;70;601;242;359
Kėdainiai d. mun.;2009;71;589;217;372
Kėdainiai d. mun.;2009;72;574;228;346
Kėdainiai d. mun.;2009;73;541;191;350
Kėdainiai d. mun.;2009;74;507;167;340
Kėdainiai d. mun.;2009;75;490;165;325
Kėdainiai d. mun.;2009;76;492;147;345
Kėdainiai d. mun.;2009;77;428;145;283
Kėdainiai d. mun.;2009;78;393;119;274
Kėdainiai d. mun.;2009;79;362;107;255
Kėdainiai d. mun.;2009;80;350;98;252
Kėdainiai d. mun.;2009;81;310;96;214
Kėdainiai d. mun.;2009;82;287;52;235
Kėdainiai d. mun.;2009;83;236;53;183
Kėdainiai d. mun.;2009;84;211;62;149
Kėdainiai d. mun.;2009;85;760;158;602
Kėdainiai d. mun.;2010;-1;56025;25828;30197
Kėdainiai d. mun.;2010;0;555;260;295
Kėdainiai d. mun.;2010;1;532;265;267
Kėdainiai d. mun.;2010;2;497;254;243
Kėdainiai d. mun.;2010;3;501;250;251
Kėdainiai d. mun.;2010;4;523;275;248
Kėdainiai d. mun.;2010;5;539;261;278
Kėdainiai d. mun.;2010;6;544;258;286
Kėdainiai d. mun.;2010;7;522;281;241
Kėdainiai d. mun.;2010;8;603;321;282
Kėdainiai d. mun.;2010;9;634;329;305
Kėdainiai d. mun.;2010;10;626;329;297
Kėdainiai d. mun.;2010;11;680;354;326
Kėdainiai d. mun.;2010;12;673;345;328
Kėdainiai d. mun.;2010;13;717;366;351
Kėdainiai d. mun.;2010;14;734;394;340
Kėdainiai d. mun.;2010;15;726;371;355
Kėdainiai d. mun.;2010;16;802;423;379
Kėdainiai d. mun.;2010;17;958;448;510
Kėdainiai d. mun.;2010;18;916;475;441
Kėdainiai d. mun.;2010;19;863;443;420
Kėdainiai d. mun.;2010;20;845;424;421
Kėdainiai d. mun.;2010;21;818;405;413
Kėdainiai d. mun.;2010;22;856;419;437
Kėdainiai d. mun.;2010;23;855;423;432
Kėdainiai d. mun.;2010;24;795;386;409
Kėdainiai d. mun.;2010;25;783;402;381
Kėdainiai d. mun.;2010;26;715;387;328
Kėdainiai d. mun.;2010;27;600;313;287
Kėdainiai d. mun.;2010;28;560;307;253
Kėdainiai d. mun.;2010;29;543;267;276
Kėdainiai d. mun.;2010;30;610;319;291
Kėdainiai d. mun.;2010;31;626;306;320
Kėdainiai d. mun.;2010;32;628;305;323
Kėdainiai d. mun.;2010;33;721;348;373
Kėdainiai d. mun.;2010;34;692;367;325
Kėdainiai d. mun.;2010;35;667;337;330
Kėdainiai d. mun.;2010;36;704;330;374
Kėdainiai d. mun.;2010;37;734;367;367
Kėdainiai d. mun.;2010;38;813;388;425
Kėdainiai d. mun.;2010;39;810;409;401
Kėdainiai d. mun.;2010;40;782;378;404
Kėdainiai d. mun.;2010;41;818;403;415
Kėdainiai d. mun.;2010;42;792;372;420
Kėdainiai d. mun.;2010;43;818;396;422
Kėdainiai d. mun.;2010;44;808;408;400
Kėdainiai d. mun.;2010;45;818;395;423
Kėdainiai d. mun.;2010;46;791;386;405
Kėdainiai d. mun.;2010;47;771;395;376
Kėdainiai d. mun.;2010;48;828;381;447
Kėdainiai d. mun.;2010;49;865;378;487
Kėdainiai d. mun.;2010;50;835;388;447
Kėdainiai d. mun.;2010;51;797;376;421
Kėdainiai d. mun.;2010;52;693;343;350
Kėdainiai d. mun.;2010;53;704;325;379
Kėdainiai d. mun.;2010;54;707;335;372
Kėdainiai d. mun.;2010;55;728;351;377
Kėdainiai d. mun.;2010;56;624;281;343
Kėdainiai d. mun.;2010;57;730;311;419
Kėdainiai d. mun.;2010;58;627;285;342
Kėdainiai d. mun.;2010;59;656;283;373
Kėdainiai d. mun.;2010;60;678;295;383
Kėdainiai d. mun.;2010;61;622;289;333
Kėdainiai d. mun.;2010;62;559;236;323
Kėdainiai d. mun.;2010;63;546;242;304
Kėdainiai d. mun.;2010;64;648;261;387
Kėdainiai d. mun.;2010;65;530;201;329
Kėdainiai d. mun.;2010;66;640;233;407
Kėdainiai d. mun.;2010;67;693;274;419
Kėdainiai d. mun.;2010;68;630;219;411
Kėdainiai d. mun.;2010;69;607;241;366
Kėdainiai d. mun.;2010;70;589;225;364
Kėdainiai d. mun.;2010;71;579;226;353
Kėdainiai d. mun.;2010;72;561;198;363
Kėdainiai d. mun.;2010;73;550;214;336
Kėdainiai d. mun.;2010;74;513;178;335
Kėdainiai d. mun.;2010;75;480;157;323
Kėdainiai d. mun.;2010;76;463;150;313
Kėdainiai d. mun.;2010;77;469;137;332
Kėdainiai d. mun.;2010;78;402;133;269
Kėdainiai d. mun.;2010;79;357;98;259
Kėdainiai d. mun.;2010;80;336;98;238
Kėdainiai d. mun.;2010;81;320;88;232
Kėdainiai d. mun.;2010;82;270;76;194
Kėdainiai d. mun.;2010;83;262;46;216
Kėdainiai d. mun.;2010;84;209;48;161
Kėdainiai d. mun.;2010;85;800;184;616
Kėdainiai d. mun.;2011;-1;54254;24997;29257
Kėdainiai d. mun.;2011;0;460;261;199
Kėdainiai d. mun.;2011;1;514;243;271
Kėdainiai d. mun.;2011;2;501;247;254
Kėdainiai d. mun.;2011;3;492;252;240
Kėdainiai d. mun.;2011;4;495;257;238
Kėdainiai d. mun.;2011;5;519;272;247
Kėdainiai d. mun.;2011;6;540;271;269
Kėdainiai d. mun.;2011;7;518;252;266
Kėdainiai d. mun.;2011;8;503;262;241
Kėdainiai d. mun.;2011;9;574;306;268
Kėdainiai d. mun.;2011;10;631;333;298
Kėdainiai d. mun.;2011;11;610;318;292
Kėdainiai d. mun.;2011;12;643;347;296
Kėdainiai d. mun.;2011;13;672;345;327
Kėdainiai d. mun.;2011;14;695;359;336
Kėdainiai d. mun.;2011;15;733;384;349
Kėdainiai d. mun.;2011;16;745;382;363
Kėdainiai d. mun.;2011;17;820;443;377
Kėdainiai d. mun.;2011;18;922;444;478
Kėdainiai d. mun.;2011;19;748;421;327
Kėdainiai d. mun.;2011;20;681;367;314
Kėdainiai d. mun.;2011;21;685;354;331
Kėdainiai d. mun.;2011;22;689;355;334
Kėdainiai d. mun.;2011;23;710;362;348
Kėdainiai d. mun.;2011;24;692;358;334
Kėdainiai d. mun.;2011;25;618;306;312
Kėdainiai d. mun.;2011;26;593;301;292
Kėdainiai d. mun.;2011;27;510;284;226
Kėdainiai d. mun.;2011;28;499;250;249
Kėdainiai d. mun.;2011;29;570;296;274
Kėdainiai d. mun.;2011;30;508;241;267
Kėdainiai d. mun.;2011;31;577;293;284
Kėdainiai d. mun.;2011;32;597;287;310
Kėdainiai d. mun.;2011;33;587;280;307
Kėdainiai d. mun.;2011;34;697;339;358
Kėdainiai d. mun.;2011;35;652;339;313
Kėdainiai d. mun.;2011;36;675;331;344
Kėdainiai d. mun.;2011;37;696;324;372
Kėdainiai d. mun.;2011;38;745;367;378
Kėdainiai d. mun.;2011;39;820;395;425
Kėdainiai d. mun.;2011;40;818;413;405
Kėdainiai d. mun.;2011;41;791;385;406
Kėdainiai d. mun.;2011;42;825;392;433
Kėdainiai d. mun.;2011;43;792;378;414
Kėdainiai d. mun.;2011;44;855;411;444
Kėdainiai d. mun.;2011;45;808;409;399
Kėdainiai d. mun.;2011;46;820;384;436
Kėdainiai d. mun.;2011;47;784;391;393
Kėdainiai d. mun.;2011;48;795;404;391
Kėdainiai d. mun.;2011;49;855;397;458
Kėdainiai d. mun.;2011;50;869;373;496
Kėdainiai d. mun.;2011;51;877;398;479
Kėdainiai d. mun.;2011;52;782;379;403
Kėdainiai d. mun.;2011;53;679;340;339
Kėdainiai d. mun.;2011;54;703;321;382
Kėdainiai d. mun.;2011;55;714;343;371
Kėdainiai d. mun.;2011;56;727;344;383
Kėdainiai d. mun.;2011;57;627;273;354
Kėdainiai d. mun.;2011;58;759;321;438
Kėdainiai d. mun.;2011;59;631;294;337
Kėdainiai d. mun.;2011;60;668;278;390
Kėdainiai d. mun.;2011;61;697;303;394
Kėdainiai d. mun.;2011;62;622;284;338
Kėdainiai d. mun.;2011;63;549;228;321
Kėdainiai d. mun.;2011;64;549;242;307
Kėdainiai d. mun.;2011;65;648;249;399
Kėdainiai d. mun.;2011;66;525;201;324
Kėdainiai d. mun.;2011;67;621;225;396
Kėdainiai d. mun.;2011;68;673;252;421
Kėdainiai d. mun.;2011;69;624;205;419
Kėdainiai d. mun.;2011;70;606;234;372
Kėdainiai d. mun.;2011;71;593;216;377
Kėdainiai d. mun.;2011;72;571;221;350
Kėdainiai d. mun.;2011;73;550;184;366
Kėdainiai d. mun.;2011;74;552;219;333
Kėdainiai d. mun.;2011;75;492;166;326
Kėdainiai d. mun.;2011;76;481;154;327
Kėdainiai d. mun.;2011;77;444;137;307
Kėdainiai d. mun.;2011;78;444;130;314
Kėdainiai d. mun.;2011;79;380;122;258
Kėdainiai d. mun.;2011;80;332;88;244
Kėdainiai d. mun.;2011;81;316;95;221
Kėdainiai d. mun.;2011;82;307;81;226
Kėdainiai d. mun.;2011;83;242;65;177
Kėdainiai d. mun.;2011;84;233;40;193
Kėdainiai d. mun.;2011;85;888;200;688
Kėdainiai d. mun.;2012;-1;52911;24380;28531
Kėdainiai d. mun.;2012;0;520;261;259
Kėdainiai d. mun.;2012;1;455;258;197
Kėdainiai d. mun.;2012;2;501;235;266
Kėdainiai d. mun.;2012;3;484;234;250
Kėdainiai d. mun.;2012;4;478;241;237
Kėdainiai d. mun.;2012;5;485;254;231
Kėdainiai d. mun.;2012;6;503;257;246
Kėdainiai d. mun.;2012;7;532;267;265
Kėdainiai d. mun.;2012;8;513;255;258
Kėdainiai d. mun.;2012;9;495;261;234
Kėdainiai d. mun.;2012;10;568;302;266
Kėdainiai d. mun.;2012;11;618;323;295
Kėdainiai d. mun.;2012;12;595;308;287
Kėdainiai d. mun.;2012;13;627;341;286
Kėdainiai d. mun.;2012;14;664;337;327
Kėdainiai d. mun.;2012;15;684;358;326
Kėdainiai d. mun.;2012;16;727;380;347
Kėdainiai d. mun.;2012;17;739;380;359
Kėdainiai d. mun.;2012;18;803;437;366
Kėdainiai d. mun.;2012;19;905;437;468
Kėdainiai d. mun.;2012;20;722;411;311
Kėdainiai d. mun.;2012;21;637;342;295
Kėdainiai d. mun.;2012;22;631;334;297
Kėdainiai d. mun.;2012;23;638;331;307
Kėdainiai d. mun.;2012;24;644;337;307
Kėdainiai d. mun.;2012;25;621;323;298
Kėdainiai d. mun.;2012;26;565;278;287
Kėdainiai d. mun.;2012;27;539;283;256
Kėdainiai d. mun.;2012;28;455;261;194
Kėdainiai d. mun.;2012;29;463;230;233
Kėdainiai d. mun.;2012;30;549;281;268
Kėdainiai d. mun.;2012;31;494;235;259
Kėdainiai d. mun.;2012;32;547;279;268
Kėdainiai d. mun.;2012;33;571;277;294
Kėdainiai d. mun.;2012;34;552;266;286
Kėdainiai d. mun.;2012;35;677;325;352
Kėdainiai d. mun.;2012;36;632;332;300
Kėdainiai d. mun.;2012;37;658;316;342
Kėdainiai d. mun.;2012;38;676;308;368
Kėdainiai d. mun.;2012;39;723;356;367
Kėdainiai d. mun.;2012;40;806;391;415
Kėdainiai d. mun.;2012;41;808;402;406
Kėdainiai d. mun.;2012;42;777;374;403
Kėdainiai d. mun.;2012;43;805;382;423
Kėdainiai d. mun.;2012;44;787;376;411
Kėdainiai d. mun.;2012;45;841;405;436
Kėdainiai d. mun.;2012;46;800;408;392
Kėdainiai d. mun.;2012;47;805;375;430
Kėdainiai d. mun.;2012;48;765;381;384
Kėdainiai d. mun.;2012;49;790;403;387
Kėdainiai d. mun.;2012;50;843;393;450
Kėdainiai d. mun.;2012;51;854;366;488
Kėdainiai d. mun.;2012;52;859;386;473
Kėdainiai d. mun.;2012;53;779;380;399
Kėdainiai d. mun.;2012;54;660;326;334
Kėdainiai d. mun.;2012;55;675;309;366
Kėdainiai d. mun.;2012;56;710;340;370
Kėdainiai d. mun.;2012;57;713;335;378
Kėdainiai d. mun.;2012;58;613;266;347
Kėdainiai d. mun.;2012;59;741;307;434
Kėdainiai d. mun.;2012;60;620;288;332
Kėdainiai d. mun.;2012;61;665;275;390
Kėdainiai d. mun.;2012;62;681;299;382
Kėdainiai d. mun.;2012;63;606;269;337
Kėdainiai d. mun.;2012;64;532;219;313
Kėdainiai d. mun.;2012;65;532;231;301
Kėdainiai d. mun.;2012;66;632;239;393
Kėdainiai d. mun.;2012;67;503;190;313
Kėdainiai d. mun.;2012;68;604;220;384
Kėdainiai d. mun.;2012;69;654;239;415
Kėdainiai d. mun.;2012;70;615;202;413
Kėdainiai d. mun.;2012;71;587;224;363
Kėdainiai d. mun.;2012;72;580;210;370
Kėdainiai d. mun.;2012;73;549;206;343
Kėdainiai d. mun.;2012;74;532;176;356
Kėdainiai d. mun.;2012;75;532;211;321
Kėdainiai d. mun.;2012;76;468;155;313
Kėdainiai d. mun.;2012;77;461;146;315
Kėdainiai d. mun.;2012;78;421;126;295
Kėdainiai d. mun.;2012;79;422;121;301
Kėdainiai d. mun.;2012;80;355;113;242
Kėdainiai d. mun.;2012;81;305;75;230
Kėdainiai d. mun.;2012;82;288;88;200
Kėdainiai d. mun.;2012;83;282;69;213
Kėdainiai d. mun.;2012;84;216;56;160
Kėdainiai d. mun.;2012;85;948;197;751
Kėdainiai d. mun.;2013;-1;51969;23929;28040
Kėdainiai d. mun.;2013;0;491;260;231
Kėdainiai d. mun.;2013;1;512;257;255
Kėdainiai d. mun.;2013;2;437;247;190
Kėdainiai d. mun.;2013;3;489;232;257
Kėdainiai d. mun.;2013;4;471;226;245
Kėdainiai d. mun.;2013;5;477;241;236
Kėdainiai d. mun.;2013;6;487;253;234
Kėdainiai d. mun.;2013;7;501;258;243
Kėdainiai d. mun.;2013;8;530;268;262
Kėdainiai d. mun.;2013;9;505;249;256
Kėdainiai d. mun.;2013;10;489;256;233
Kėdainiai d. mun.;2013;11;561;298;263
Kėdainiai d. mun.;2013;12;606;320;286
Kėdainiai d. mun.;2013;13;591;308;283
Kėdainiai d. mun.;2013;14;628;340;288
Kėdainiai d. mun.;2013;15;654;332;322
Kėdainiai d. mun.;2013;16;684;359;325
Kėdainiai d. mun.;2013;17;720;376;344
Kėdainiai d. mun.;2013;18;729;375;354
Kėdainiai d. mun.;2013;19;782;427;355
Kėdainiai d. mun.;2013;20;878;423;455
Kėdainiai d. mun.;2013;21;701;393;308
Kėdainiai d. mun.;2013;22;605;325;280
Kėdainiai d. mun.;2013;23;603;320;283
Kėdainiai d. mun.;2013;24;594;313;281
Kėdainiai d. mun.;2013;25;593;307;286
Kėdainiai d. mun.;2013;26;589;312;277
Kėdainiai d. mun.;2013;27;509;243;266
Kėdainiai d. mun.;2013;28;519;272;247
Kėdainiai d. mun.;2013;29;442;254;188
Kėdainiai d. mun.;2013;30;427;218;209
Kėdainiai d. mun.;2013;31;530;272;258
Kėdainiai d. mun.;2013;32;474;226;248
Kėdainiai d. mun.;2013;33;538;273;265
Kėdainiai d. mun.;2013;34;552;270;282
Kėdainiai d. mun.;2013;35;548;264;284
Kėdainiai d. mun.;2013;36;659;318;341
Kėdainiai d. mun.;2013;37;617;318;299
Kėdainiai d. mun.;2013;38;647;307;340
Kėdainiai d. mun.;2013;39;667;305;362
Kėdainiai d. mun.;2013;40;710;357;353
Kėdainiai d. mun.;2013;41;788;383;405
Kėdainiai d. mun.;2013;42;798;395;403
Kėdainiai d. mun.;2013;43;767;369;398
Kėdainiai d. mun.;2013;44;795;378;417
Kėdainiai d. mun.;2013;45;780;370;410
Kėdainiai d. mun.;2013;46;835;397;438
Kėdainiai d. mun.;2013;47;792;404;388
Kėdainiai d. mun.;2013;48;808;376;432
Kėdainiai d. mun.;2013;49;747;371;376
Kėdainiai d. mun.;2013;50;780;398;382
Kėdainiai d. mun.;2013;51;839;394;445
Kėdainiai d. mun.;2013;52;845;364;481
Kėdainiai d. mun.;2013;53;849;378;471
Kėdainiai d. mun.;2013;54;767;371;396
Kėdainiai d. mun.;2013;55;656;324;332
Kėdainiai d. mun.;2013;56;668;307;361
Kėdainiai d. mun.;2013;57;707;342;365
Kėdainiai d. mun.;2013;58;707;330;377
Kėdainiai d. mun.;2013;59;600;257;343
Kėdainiai d. mun.;2013;60;726;297;429
Kėdainiai d. mun.;2013;61;605;274;331
Kėdainiai d. mun.;2013;62;658;269;389
Kėdainiai d. mun.;2013;63;669;291;378
Kėdainiai d. mun.;2013;64;595;263;332
Kėdainiai d. mun.;2013;65;519;210;309
Kėdainiai d. mun.;2013;66;518;221;297
Kėdainiai d. mun.;2013;67;621;229;392
Kėdainiai d. mun.;2013;68;494;186;308
Kėdainiai d. mun.;2013;69;584;215;369
Kėdainiai d. mun.;2013;70;628;223;405
Kėdainiai d. mun.;2013;71;592;188;404
Kėdainiai d. mun.;2013;72;575;216;359
Kėdainiai d. mun.;2013;73;560;199;361
Kėdainiai d. mun.;2013;74;528;190;338
Kėdainiai d. mun.;2013;75;513;166;347
Kėdainiai d. mun.;2013;76;511;196;315
Kėdainiai d. mun.;2013;77;446;143;303
Kėdainiai d. mun.;2013;78;435;138;297
Kėdainiai d. mun.;2013;79;393;113;280
Kėdainiai d. mun.;2013;80;399;109;290
Kėdainiai d. mun.;2013;81;333;103;230
Kėdainiai d. mun.;2013;82;283;70;213
Kėdainiai d. mun.;2013;83;267;79;188
Kėdainiai d. mun.;2013;84;251;57;194
Kėdainiai d. mun.;2013;85;992;204;788
Kėdainiai d. mun.;2014;-1;50881;23436;27445
Kėdainiai d. mun.;2014;0;500;263;237
Kėdainiai d. mun.;2014;1;476;254;222
Kėdainiai d. mun.;2014;2;497;248;249
Kėdainiai d. mun.;2014;3;430;243;187
Kėdainiai d. mun.;2014;4;482;226;256
Kėdainiai d. mun.;2014;5;461;224;237
Kėdainiai d. mun.;2014;6;468;235;233
Kėdainiai d. mun.;2014;7;472;244;228
Kėdainiai d. mun.;2014;8;488;255;233
Kėdainiai d. mun.;2014;9;517;260;257
Kėdainiai d. mun.;2014;10;497;245;252
Kėdainiai d. mun.;2014;11;481;250;231
Kėdainiai d. mun.;2014;12;551;296;255
Kėdainiai d. mun.;2014;13;601;318;283
Kėdainiai d. mun.;2014;14;580;301;279
Kėdainiai d. mun.;2014;15;621;340;281
Kėdainiai d. mun.;2014;16;639;324;315
Kėdainiai d. mun.;2014;17;666;349;317
Kėdainiai d. mun.;2014;18;712;375;337
Kėdainiai d. mun.;2014;19;702;365;337
Kėdainiai d. mun.;2014;20;756;416;340
Kėdainiai d. mun.;2014;21;848;416;432
Kėdainiai d. mun.;2014;22;656;381;275
Kėdainiai d. mun.;2014;23;557;300;257
Kėdainiai d. mun.;2014;24;579;309;270
Kėdainiai d. mun.;2014;25;575;304;271
Kėdainiai d. mun.;2014;26;576;306;270
Kėdainiai d. mun.;2014;27;557;294;263
Kėdainiai d. mun.;2014;28;477;234;243
Kėdainiai d. mun.;2014;29;476;256;220
Kėdainiai d. mun.;2014;30;413;242;171
Kėdainiai d. mun.;2014;31;414;215;199
Kėdainiai d. mun.;2014;32;521;266;255
Kėdainiai d. mun.;2014;33;467;224;243
Kėdainiai d. mun.;2014;34;516;254;262
Kėdainiai d. mun.;2014;35;516;246;270
Kėdainiai d. mun.;2014;36;521;251;270
Kėdainiai d. mun.;2014;37;650;312;338
Kėdainiai d. mun.;2014;38;611;313;298
Kėdainiai d. mun.;2014;39;629;296;333
Kėdainiai d. mun.;2014;40;660;300;360
Kėdainiai d. mun.;2014;41;696;345;351
Kėdainiai d. mun.;2014;42;776;372;404
Kėdainiai d. mun.;2014;43;793;392;401
Kėdainiai d. mun.;2014;44;760;367;393
Kėdainiai d. mun.;2014;45;784;368;416
Kėdainiai d. mun.;2014;46;770;365;405
Kėdainiai d. mun.;2014;47;829;399;430
Kėdainiai d. mun.;2014;48;777;391;386
Kėdainiai d. mun.;2014;49;794;367;427
Kėdainiai d. mun.;2014;50;742;366;376
Kėdainiai d. mun.;2014;51;775;394;381
Kėdainiai d. mun.;2014;52;821;381;440
Kėdainiai d. mun.;2014;53;841;364;477
Kėdainiai d. mun.;2014;54;843;372;471
Kėdainiai d. mun.;2014;55;754;363;391
Kėdainiai d. mun.;2014;56;648;320;328
Kėdainiai d. mun.;2014;57;662;308;354
Kėdainiai d. mun.;2014;58;697;331;366
Kėdainiai d. mun.;2014;59;704;328;376
Kėdainiai d. mun.;2014;60;587;249;338
Kėdainiai d. mun.;2014;61;712;285;427
Kėdainiai d. mun.;2014;62;595;267;328
Kėdainiai d. mun.;2014;63;641;255;386
Kėdainiai d. mun.;2014;64;660;286;374
Kėdainiai d. mun.;2014;65;576;250;326
Kėdainiai d. mun.;2014;66;505;203;302
Kėdainiai d. mun.;2014;67;505;210;295
Kėdainiai d. mun.;2014;68;604;218;386
Kėdainiai d. mun.;2014;69;478;176;302
Kėdainiai d. mun.;2014;70;552;197;355
Kėdainiai d. mun.;2014;71;611;214;397
Kėdainiai d. mun.;2014;72;570;178;392
Kėdainiai d. mun.;2014;73;555;201;354
Kėdainiai d. mun.;2014;74;548;196;352
Kėdainiai d. mun.;2014;75;511;181;330
Kėdainiai d. mun.;2014;76;492;155;337
Kėdainiai d. mun.;2014;77;482;175;307
Kėdainiai d. mun.;2014;78;421;133;288
Kėdainiai d. mun.;2014;79;407;127;280
Kėdainiai d. mun.;2014;80;369;101;268
Kėdainiai d. mun.;2014;81;362;99;263
Kėdainiai d. mun.;2014;82;302;85;217
Kėdainiai d. mun.;2014;83;264;65;199
Kėdainiai d. mun.;2014;84;244;69;175
Kėdainiai d. mun.;2014;85;1046;218;828
Kėdainiai d. mun.;2015;-1;49939;23000;26939
Kėdainiai d. mun.;2015;0;476;227;249
Kėdainiai d. mun.;2015;1;488;255;233
Kėdainiai d. mun.;2015;2;461;247;214
Kėdainiai d. mun.;2015;3;474;236;238
Kėdainiai d. mun.;2015;4;425;240;185
Kėdainiai d. mun.;2015;5;456;213;243
Kėdainiai d. mun.;2015;6;453;214;239
Kėdainiai d. mun.;2015;7;470;236;234
Kėdainiai d. mun.;2015;8;464;240;224
Kėdainiai d. mun.;2015;9;481;252;229
Kėdainiai d. mun.;2015;10;512;257;255
Kėdainiai d. mun.;2015;11;480;236;244
Kėdainiai d. mun.;2015;12;473;242;231
Kėdainiai d. mun.;2015;13;543;293;250
Kėdainiai d. mun.;2015;14;597;316;281
Kėdainiai d. mun.;2015;15;572;298;274
Kėdainiai d. mun.;2015;16;618;340;278
Kėdainiai d. mun.;2015;17;635;323;312
Kėdainiai d. mun.;2015;18;659;342;317
Kėdainiai d. mun.;2015;19;691;359;332
Kėdainiai d. mun.;2015;20;685;363;322
Kėdainiai d. mun.;2015;21;733;405;328
Kėdainiai d. mun.;2015;22;815;406;409
Kėdainiai d. mun.;2015;23;641;373;268
Kėdainiai d. mun.;2015;24;527;298;229
Kėdainiai d. mun.;2015;25;548;302;246
Kėdainiai d. mun.;2015;26;554;294;260
Kėdainiai d. mun.;2015;27;564;305;259
Kėdainiai d. mun.;2015;28;528;280;248
Kėdainiai d. mun.;2015;29;467;234;233
Kėdainiai d. mun.;2015;30;454;246;208
Kėdainiai d. mun.;2015;31;405;231;174
Kėdainiai d. mun.;2015;32;400;207;193
Kėdainiai d. mun.;2015;33;505;258;247
Kėdainiai d. mun.;2015;34;459;222;237
Kėdainiai d. mun.;2015;35;500;252;248
Kėdainiai d. mun.;2015;36;509;240;269
Kėdainiai d. mun.;2015;37;506;244;262
Kėdainiai d. mun.;2015;38;633;306;327
Kėdainiai d. mun.;2015;39;601;307;294
Kėdainiai d. mun.;2015;40;624;291;333
Kėdainiai d. mun.;2015;41;649;288;361
Kėdainiai d. mun.;2015;42;686;338;348
Kėdainiai d. mun.;2015;43;781;377;404
Kėdainiai d. mun.;2015;44;786;384;402
Kėdainiai d. mun.;2015;45;743;359;384
Kėdainiai d. mun.;2015;46;775;360;415
Kėdainiai d. mun.;2015;47;763;360;403
Kėdainiai d. mun.;2015;48;830;402;428
Kėdainiai d. mun.;2015;49;770;390;380
Kėdainiai d. mun.;2015;50;783;361;422
Kėdainiai d. mun.;2015;51;731;356;375
Kėdainiai d. mun.;2015;52;771;391;380
Kėdainiai d. mun.;2015;53;811;374;437
Kėdainiai d. mun.;2015;54;832;358;474
Kėdainiai d. mun.;2015;55;833;368;465
Kėdainiai d. mun.;2015;56;734;351;383
Kėdainiai d. mun.;2015;57;642;319;323
Kėdainiai d. mun.;2015;58;651;301;350
Kėdainiai d. mun.;2015;59;689;327;362
Kėdainiai d. mun.;2015;60;690;319;371
Kėdainiai d. mun.;2015;61;586;248;338
Kėdainiai d. mun.;2015;62;699;276;423
Kėdainiai d. mun.;2015;63;582;261;321
Kėdainiai d. mun.;2015;64;616;240;376
Kėdainiai d. mun.;2015;65;640;273;367
Kėdainiai d. mun.;2015;66;566;246;320
Kėdainiai d. mun.;2015;67;492;195;297
Kėdainiai d. mun.;2015;68;490;207;283
Kėdainiai d. mun.;2015;69;587;206;381
Kėdainiai d. mun.;2015;70;464;167;297
Kėdainiai d. mun.;2015;71;530;184;346
Kėdainiai d. mun.;2015;72;594;203;391
Kėdainiai d. mun.;2015;73;546;164;382
Kėdainiai d. mun.;2015;74;527;184;343
Kėdainiai d. mun.;2015;75;527;185;342
Kėdainiai d. mun.;2015;76;486;162;324
Kėdainiai d. mun.;2015;77;470;145;325
Kėdainiai d. mun.;2015;78;456;164;292
Kėdainiai d. mun.;2015;79;395;121;274
Kėdainiai d. mun.;2015;80;386;115;271
Kėdainiai d. mun.;2015;81;341;90;251
Kėdainiai d. mun.;2015;82;328;86;242
Kėdainiai d. mun.;2015;83;277;75;202
Kėdainiai d. mun.;2015;84;239;56;183
Kėdainiai d. mun.;2015;85;1079;234;845
Kėdainiai d. mun.;2016;-1;49053;22587;26466
Kėdainiai d. mun.;2016;0;480;255;225
Kėdainiai d. mun.;2016;1;476;228;248
Kėdainiai d. mun.;2016;2;482;250;232
Kėdainiai d. mun.;2016;3;459;253;206
Kėdainiai d. mun.;2016;4;474;228;246
Kėdainiai d. mun.;2016;5;420;237;183
Kėdainiai d. mun.;2016;6;445;212;233
Kėdainiai d. mun.;2016;7;449;216;233
Kėdainiai d. mun.;2016;8;465;238;227
Kėdainiai d. mun.;2016;9;458;234;224
Kėdainiai d. mun.;2016;10;475;249;226
Kėdainiai d. mun.;2016;11;500;250;250
Kėdainiai d. mun.;2016;12;475;232;243
Kėdainiai d. mun.;2016;13;474;246;228
Kėdainiai d. mun.;2016;14;540;288;252
Kėdainiai d. mun.;2016;15;592;313;279
Kėdainiai d. mun.;2016;16;567;294;273
Kėdainiai d. mun.;2016;17;608;336;272
Kėdainiai d. mun.;2016;18;629;320;309
Kėdainiai d. mun.;2016;19;638;333;305
Kėdainiai d. mun.;2016;20;664;345;319
Kėdainiai d. mun.;2016;21;666;352;314
Kėdainiai d. mun.;2016;22;705;388;317
Kėdainiai d. mun.;2016;23;776;380;396
Kėdainiai d. mun.;2016;24;601;355;246
Kėdainiai d. mun.;2016;25;498;279;219
Kėdainiai d. mun.;2016;26;521;288;233
Kėdainiai d. mun.;2016;27;521;279;242
Kėdainiai d. mun.;2016;28;558;307;251
Kėdainiai d. mun.;2016;29;507;277;230
Kėdainiai d. mun.;2016;30;449;222;227
Kėdainiai d. mun.;2016;31;441;239;202
Kėdainiai d. mun.;2016;32;405;226;179
Kėdainiai d. mun.;2016;33;386;203;183
Kėdainiai d. mun.;2016;34;499;252;247
Kėdainiai d. mun.;2016;35;453;213;240
Kėdainiai d. mun.;2016;36;484;246;238
Kėdainiai d. mun.;2016;37;498;240;258
Kėdainiai d. mun.;2016;38;502;239;263
Kėdainiai d. mun.;2016;39;620;301;319
Kėdainiai d. mun.;2016;40;584;294;290
Kėdainiai d. mun.;2016;41;619;287;332
Kėdainiai d. mun.;2016;42;639;285;354
Kėdainiai d. mun.;2016;43;685;334;351
Kėdainiai d. mun.;2016;44;758;361;397
Kėdainiai d. mun.;2016;45;777;385;392
Kėdainiai d. mun.;2016;46;739;360;379
Kėdainiai d. mun.;2016;47;767;358;409
Kėdainiai d. mun.;2016;48;758;362;396
Kėdainiai d. mun.;2016;49;827;394;433
Kėdainiai d. mun.;2016;50;757;384;373
Kėdainiai d. mun.;2016;51;777;357;420
Kėdainiai d. mun.;2016;52;718;348;370
Kėdainiai d. mun.;2016;53;762;388;374
Kėdainiai d. mun.;2016;54;788;358;430
Kėdainiai d. mun.;2016;55;824;353;471
Kėdainiai d. mun.;2016;56;826;364;462
Kėdainiai d. mun.;2016;57;724;346;378
Kėdainiai d. mun.;2016;58;640;318;322
Kėdainiai d. mun.;2016;59;643;295;348
Kėdainiai d. mun.;2016;60;677;319;358
Kėdainiai d. mun.;2016;61;680;312;368
Kėdainiai d. mun.;2016;62;569;232;337
Kėdainiai d. mun.;2016;63;692;269;423
Kėdainiai d. mun.;2016;64;568;253;315
Kėdainiai d. mun.;2016;65;602;233;369
Kėdainiai d. mun.;2016;66;619;256;363
Kėdainiai d. mun.;2016;67;543;228;315
Kėdainiai d. mun.;2016;68;481;188;293
Kėdainiai d. mun.;2016;69;485;204;281
Kėdainiai d. mun.;2016;70;569;194;375
Kėdainiai d. mun.;2016;71;449;160;289
Kėdainiai d. mun.;2016;72;512;171;341
Kėdainiai d. mun.;2016;73;574;188;386
Kėdainiai d. mun.;2016;74;526;155;371
Kėdainiai d. mun.;2016;75;509;176;333
Kėdainiai d. mun.;2016;76;505;171;334
Kėdainiai d. mun.;2016;77;470;156;314
Kėdainiai d. mun.;2016;78;451;135;316
Kėdainiai d. mun.;2016;79;435;152;283
Kėdainiai d. mun.;2016;80;363;109;254
Kėdainiai d. mun.;2016;81;354;103;251
Kėdainiai d. mun.;2016;82;317;81;236
Kėdainiai d. mun.;2016;83;298;75;223
Kėdainiai d. mun.;2016;84;249;64;185
Kėdainiai d. mun.;2016;85;1084;229;855
Kėdainiai d. mun.;2017;-1;47872;22068;25804
Kėdainiai d. mun.;2017;0;459;224;235
Kėdainiai d. mun.;2017;1;466;248;218
Kėdainiai d. mun.;2017;2;454;217;237
Kėdainiai d. mun.;2017;3;467;246;221
Kėdainiai d. mun.;2017;4;443;240;203
Kėdainiai d. mun.;2017;5;467;225;242
Kėdainiai d. mun.;2017;6;416;235;181
Kėdainiai d. mun.;2017;7;430;206;224
Kėdainiai d. mun.;2017;8;439;210;229
Kėdainiai d. mun.;2017;9;460;238;222
Kėdainiai d. mun.;2017;10;451;235;216
Kėdainiai d. mun.;2017;11;476;249;227
Kėdainiai d. mun.;2017;12;498;247;251
Kėdainiai d. mun.;2017;13;470;230;240
Kėdainiai d. mun.;2017;14;466;239;227
Kėdainiai d. mun.;2017;15;539;287;252
Kėdainiai d. mun.;2017;16;580;307;273
Kėdainiai d. mun.;2017;17;562;288;274
Kėdainiai d. mun.;2017;18;610;334;276
Kėdainiai d. mun.;2017;19;593;305;288
Kėdainiai d. mun.;2017;20;622;328;294
Kėdainiai d. mun.;2017;21;636;331;305
Kėdainiai d. mun.;2017;22;637;337;300
Kėdainiai d. mun.;2017;23;678;379;299
Kėdainiai d. mun.;2017;24;740;373;367
Kėdainiai d. mun.;2017;25;554;333;221
Kėdainiai d. mun.;2017;26;465;272;193
Kėdainiai d. mun.;2017;27;465;263;202
Kėdainiai d. mun.;2017;28;470;260;210
Kėdainiai d. mun.;2017;29;515;290;225
Kėdainiai d. mun.;2017;30;461;253;208
Kėdainiai d. mun.;2017;31;426;214;212
Kėdainiai d. mun.;2017;32;408;221;187
Kėdainiai d. mun.;2017;33;370;209;161
Kėdainiai d. mun.;2017;34;364;193;171
Kėdainiai d. mun.;2017;35;484;247;237
Kėdainiai d. mun.;2017;36;433;201;232
Kėdainiai d. mun.;2017;37;471;245;226
Kėdainiai d. mun.;2017;38;479;225;254
Kėdainiai d. mun.;2017;39;479;222;257
Kėdainiai d. mun.;2017;40;610;295;315
Kėdainiai d. mun.;2017;41;569;290;279
Kėdainiai d. mun.;2017;42;617;287;330
Kėdainiai d. mun.;2017;43;634;281;353
Kėdainiai d. mun.;2017;44;682;336;346
Kėdainiai d. mun.;2017;45;760;361;399
Kėdainiai d. mun.;2017;46;765;377;388
Kėdainiai d. mun.;2017;47;727;351;376
Kėdainiai d. mun.;2017;48;759;356;403
Kėdainiai d. mun.;2017;49;749;358;391
Kėdainiai d. mun.;2017;50;810;388;422
Kėdainiai d. mun.;2017;51;747;375;372
Kėdainiai d. mun.;2017;52;766;352;414
Kėdainiai d. mun.;2017;53;701;338;363
Kėdainiai d. mun.;2017;54;759;387;372
Kėdainiai d. mun.;2017;55;778;354;424
Kėdainiai d. mun.;2017;56;825;352;473
Kėdainiai d. mun.;2017;57;808;353;455
Kėdainiai d. mun.;2017;58;713;340;373
Kėdainiai d. mun.;2017;59;636;316;320
Kėdainiai d. mun.;2017;60;628;285;343
Kėdainiai d. mun.;2017;61;669;312;357
Kėdainiai d. mun.;2017;62;666;301;365
Kėdainiai d. mun.;2017;63;556;226;330
Kėdainiai d. mun.;2017;64;682;263;419
Kėdainiai d. mun.;2017;65;558;245;313
Kėdainiai d. mun.;2017;66;581;224;357
Kėdainiai d. mun.;2017;67;606;248;358
Kėdainiai d. mun.;2017;68;524;217;307
Kėdainiai d. mun.;2017;69;471;181;290
Kėdainiai d. mun.;2017;70;472;195;277
Kėdainiai d. mun.;2017;71;548;180;368
Kėdainiai d. mun.;2017;72;436;147;289
Kėdainiai d. mun.;2017;73;491;158;333
Kėdainiai d. mun.;2017;74;558;176;382
Kėdainiai d. mun.;2017;75;505;146;359
Kėdainiai d. mun.;2017;76;488;163;325
Kėdainiai d. mun.;2017;77;484;163;321
Kėdainiai d. mun.;2017;78;444;146;298
Kėdainiai d. mun.;2017;79;426;123;303
Kėdainiai d. mun.;2017;80;405;143;262
Kėdainiai d. mun.;2017;81;339;99;240
Kėdainiai d. mun.;2017;82;325;94;231
Kėdainiai d. mun.;2017;83;294;72;222
Kėdainiai d. mun.;2017;84;274;67;207
Kėdainiai d. mun.;2017;85;1124;241;883
Kėdainiai d. mun.;2018;-1;46626;21500;25126
Kėdainiai d. mun.;2018;0;425;224;201
Kėdainiai d. mun.;2018;1;447;219;228
Kėdainiai d. mun.;2018;2;459;246;213
Kėdainiai d. mun.;2018;3;455;219;236
Kėdainiai d. mun.;2018;4;455;242;213
Kėdainiai d. mun.;2018;5;444;239;205
Kėdainiai d. mun.;2018;6;466;228;238
Kėdainiai d. mun.;2018;7;412;230;182
Kėdainiai d. mun.;2018;8;424;203;221
Kėdainiai d. mun.;2018;9;437;206;231
Kėdainiai d. mun.;2018;10;447;230;217
Kėdainiai d. mun.;2018;11;445;234;211
Kėdainiai d. mun.;2018;12;470;245;225
Kėdainiai d. mun.;2018;13;489;242;247
Kėdainiai d. mun.;2018;14;454;224;230
Kėdainiai d. mun.;2018;15;459;234;225
Kėdainiai d. mun.;2018;16;532;282;250
Kėdainiai d. mun.;2018;17;573;306;267
Kėdainiai d. mun.;2018;18;552;282;270
Kėdainiai d. mun.;2018;19;570;311;259
Kėdainiai d. mun.;2018;20;574;295;279
Kėdainiai d. mun.;2018;21;580;297;283
Kėdainiai d. mun.;2018;22;581;292;289
Kėdainiai d. mun.;2018;23;596;318;278
Kėdainiai d. mun.;2018;24;626;357;269
Kėdainiai d. mun.;2018;25;673;346;327
Kėdainiai d. mun.;2018;26;488;304;184
Kėdainiai d. mun.;2018;27;432;248;184
Kėdainiai d. mun.;2018;28;421;234;187
Kėdainiai d. mun.;2018;29;443;250;193
Kėdainiai d. mun.;2018;30;488;281;207
Kėdainiai d. mun.;2018;31;438;240;198
Kėdainiai d. mun.;2018;32;396;197;199
Kėdainiai d. mun.;2018;33;395;219;176
Kėdainiai d. mun.;2018;34;358;202;156
Kėdainiai d. mun.;2018;35;348;184;164
Kėdainiai d. mun.;2018;36;469;242;227
Kėdainiai d. mun.;2018;37;417;190;227
Kėdainiai d. mun.;2018;38;465;247;218
Kėdainiai d. mun.;2018;39;466;222;244
Kėdainiai d. mun.;2018;40;481;228;253
Kėdainiai d. mun.;2018;41;597;289;308
Kėdainiai d. mun.;2018;42;560;288;272
Kėdainiai d. mun.;2018;43;599;273;326
Kėdainiai d. mun.;2018;44;638;287;351
Kėdainiai d. mun.;2018;45;669;329;340
Kėdainiai d. mun.;2018;46;759;361;398
Kėdainiai d. mun.;2018;47;756;373;383
Kėdainiai d. mun.;2018;48;727;356;371
Kėdainiai d. mun.;2018;49;744;347;397
Kėdainiai d. mun.;2018;50;736;354;382
Kėdainiai d. mun.;2018;51;796;382;414
Kėdainiai d. mun.;2018;52;739;373;366
Kėdainiai d. mun.;2018;53;760;352;408
Kėdainiai d. mun.;2018;54;693;337;356
Kėdainiai d. mun.;2018;55;747;381;366
Kėdainiai d. mun.;2018;56;762;349;413
Kėdainiai d. mun.;2018;57;820;345;475
Kėdainiai d. mun.;2018;58;803;349;454
Kėdainiai d. mun.;2018;59;703;335;368
Kėdainiai d. mun.;2018;60;627;311;316
Kėdainiai d. mun.;2018;61;614;278;336
Kėdainiai d. mun.;2018;62;655;304;351
Kėdainiai d. mun.;2018;63;653;291;362
Kėdainiai d. mun.;2018;64;550;224;326
Kėdainiai d. mun.;2018;65;662;251;411
Kėdainiai d. mun.;2018;66;546;235;311
Kėdainiai d. mun.;2018;67;559;206;353
Kėdainiai d. mun.;2018;68;591;237;354
Kėdainiai d. mun.;2018;69;514;213;301
Kėdainiai d. mun.;2018;70;461;176;285
Kėdainiai d. mun.;2018;71;461;185;276
Kėdainiai d. mun.;2018;72;522;164;358
Kėdainiai d. mun.;2018;73;410;134;276
Kėdainiai d. mun.;2018;74;477;148;329
Kėdainiai d. mun.;2018;75;537;163;374
Kėdainiai d. mun.;2018;76;477;136;341
Kėdainiai d. mun.;2018;77;467;148;319
Kėdainiai d. mun.;2018;78;458;151;307
Kėdainiai d. mun.;2018;79;410;132;278
Kėdainiai d. mun.;2018;80;401;113;288
Kėdainiai d. mun.;2018;81;371;125;246
Kėdainiai d. mun.;2018;82;305;89;216
Kėdainiai d. mun.;2018;83;297;82;215
Kėdainiai d. mun.;2018;84;261;59;202
Kėdainiai d. mun.;2018;85;1182;246;936
Kelmė d. mun.;2001;-1;40858;19607;21251
Kelmė d. mun.;2001;0;379;186;193
Kelmė d. mun.;2001;1;423;232;191
Kelmė d. mun.;2001;2;469;256;213
Kelmė d. mun.;2001;3;456;232;224
Kelmė d. mun.;2001;4;490;267;223
Kelmė d. mun.;2001;5;499;245;254
Kelmė d. mun.;2001;6;505;281;224
Kelmė d. mun.;2001;7;576;294;282
Kelmė d. mun.;2001;8;692;358;334
Kelmė d. mun.;2001;9;661;361;300
Kelmė d. mun.;2001;10;664;331;333
Kelmė d. mun.;2001;11;717;387;330
Kelmė d. mun.;2001;12;639;313;326
Kelmė d. mun.;2001;13;702;339;363
Kelmė d. mun.;2001;14;739;367;372
Kelmė d. mun.;2001;15;692;348;344
Kelmė d. mun.;2001;16;657;353;304
Kelmė d. mun.;2001;17;678;349;329
Kelmė d. mun.;2001;18;536;294;242
Kelmė d. mun.;2001;19;493;286;207
Kelmė d. mun.;2001;20;475;260;215
Kelmė d. mun.;2001;21;466;262;204
Kelmė d. mun.;2001;22;488;256;232
Kelmė d. mun.;2001;23;472;238;234
Kelmė d. mun.;2001;24;495;279;216
Kelmė d. mun.;2001;25;499;256;243
Kelmė d. mun.;2001;26;444;227;217
Kelmė d. mun.;2001;27;487;260;227
Kelmė d. mun.;2001;28;492;252;240
Kelmė d. mun.;2001;29;510;255;255
Kelmė d. mun.;2001;30;522;247;275
Kelmė d. mun.;2001;31;508;252;256
Kelmė d. mun.;2001;32;557;279;278
Kelmė d. mun.;2001;33;525;258;267
Kelmė d. mun.;2001;34;516;268;248
Kelmė d. mun.;2001;35;554;287;267
Kelmė d. mun.;2001;36;583;299;284
Kelmė d. mun.;2001;37;547;298;249
Kelmė d. mun.;2001;38;588;327;261
Kelmė d. mun.;2001;39;599;331;268
Kelmė d. mun.;2001;40;600;305;295
Kelmė d. mun.;2001;41;607;321;286
Kelmė d. mun.;2001;42;605;287;318
Kelmė d. mun.;2001;43;532;296;236
Kelmė d. mun.;2001;44;525;272;253
Kelmė d. mun.;2001;45;484;243;241
Kelmė d. mun.;2001;46;465;240;225
Kelmė d. mun.;2001;47;445;219;226
Kelmė d. mun.;2001;48;458;244;214
Kelmė d. mun.;2001;49;490;261;229
Kelmė d. mun.;2001;50;514;255;259
Kelmė d. mun.;2001;51;493;249;244
Kelmė d. mun.;2001;52;413;196;217
Kelmė d. mun.;2001;53;402;194;208
Kelmė d. mun.;2001;54;314;137;177
Kelmė d. mun.;2001;55;461;216;245
Kelmė d. mun.;2001;56;326;139;187
Kelmė d. mun.;2001;57;414;183;231
Kelmė d. mun.;2001;58;498;222;276
Kelmė d. mun.;2001;59;435;191;244
Kelmė d. mun.;2001;60;419;181;238
Kelmė d. mun.;2001;61;426;179;247
Kelmė d. mun.;2001;62;465;199;266
Kelmė d. mun.;2001;63;467;182;285
Kelmė d. mun.;2001;64;515;217;298
Kelmė d. mun.;2001;65;494;170;324
Kelmė d. mun.;2001;66;434;156;278
Kelmė d. mun.;2001;67;504;216;288
Kelmė d. mun.;2001;68;455;178;277
Kelmė d. mun.;2001;69;489;186;303
Kelmė d. mun.;2001;70;431;153;278
Kelmė d. mun.;2001;71;425;163;262
Kelmė d. mun.;2001;72;437;170;267
Kelmė d. mun.;2001;73;404;139;265
Kelmė d. mun.;2001;74;380;102;278
Kelmė d. mun.;2001;75;358;108;250
Kelmė d. mun.;2001;76;306;118;188
Kelmė d. mun.;2001;77;306;91;215
Kelmė d. mun.;2001;78;253;89;164
Kelmė d. mun.;2001;79;245;95;150
Kelmė d. mun.;2001;80;197;70;127
Kelmė d. mun.;2001;81;155;47;108
Kelmė d. mun.;2001;82;101;24;77
Kelmė d. mun.;2001;83;99;37;62
Kelmė d. mun.;2001;84;101;31;70
Kelmė d. mun.;2001;85;517;166;351
Kelmė d. mun.;2002;-1;40469;19420;21049
Kelmė d. mun.;2002;0;386;185;201
Kelmė d. mun.;2002;1;370;182;188
Kelmė d. mun.;2002;2;422;233;189
Kelmė d. mun.;2002;3;463;251;212
Kelmė d. mun.;2002;4;451;229;222
Kelmė d. mun.;2002;5;484;266;218
Kelmė d. mun.;2002;6;500;245;255
Kelmė d. mun.;2002;7;505;283;222
Kelmė d. mun.;2002;8;570;292;278
Kelmė d. mun.;2002;9;688;357;331
Kelmė d. mun.;2002;10;659;362;297
Kelmė d. mun.;2002;11;660;329;331
Kelmė d. mun.;2002;12;707;382;325
Kelmė d. mun.;2002;13;628;308;320
Kelmė d. mun.;2002;14;695;333;362
Kelmė d. mun.;2002;15;728;360;368
Kelmė d. mun.;2002;16;683;345;338
Kelmė d. mun.;2002;17;651;348;303
Kelmė d. mun.;2002;18;662;342;320
Kelmė d. mun.;2002;19;527;287;240
Kelmė d. mun.;2002;20;481;277;204
Kelmė d. mun.;2002;21;464;250;214
Kelmė d. mun.;2002;22;464;260;204
Kelmė d. mun.;2002;23;476;254;222
Kelmė d. mun.;2002;24;466;240;226
Kelmė d. mun.;2002;25;495;284;211
Kelmė d. mun.;2002;26;487;249;238
Kelmė d. mun.;2002;27;429;215;214
Kelmė d. mun.;2002;28;481;254;227
Kelmė d. mun.;2002;29;472;242;230
Kelmė d. mun.;2002;30;498;249;249
Kelmė d. mun.;2002;31;505;239;266
Kelmė d. mun.;2002;32;497;244;253
Kelmė d. mun.;2002;33;545;274;271
Kelmė d. mun.;2002;34;516;251;265
Kelmė d. mun.;2002;35;505;260;245
Kelmė d. mun.;2002;36;550;285;265
Kelmė d. mun.;2002;37;571;291;280
Kelmė d. mun.;2002;38;541;294;247
Kelmė d. mun.;2002;39;574;317;257
Kelmė d. mun.;2002;40;584;323;261
Kelmė d. mun.;2002;41;593;298;295
Kelmė d. mun.;2002;42;599;319;280
Kelmė d. mun.;2002;43;606;289;317
Kelmė d. mun.;2002;44;528;297;231
Kelmė d. mun.;2002;45;515;267;248
Kelmė d. mun.;2002;46;480;242;238
Kelmė d. mun.;2002;47;469;244;225
Kelmė d. mun.;2002;48;432;210;222
Kelmė d. mun.;2002;49;454;242;212
Kelmė d. mun.;2002;50;482;254;228
Kelmė d. mun.;2002;51;507;251;256
Kelmė d. mun.;2002;52;490;248;242
Kelmė d. mun.;2002;53;411;198;213
Kelmė d. mun.;2002;54;390;190;200
Kelmė d. mun.;2002;55;310;136;174
Kelmė d. mun.;2002;56;450;212;238
Kelmė d. mun.;2002;57;321;136;185
Kelmė d. mun.;2002;58;403;178;225
Kelmė d. mun.;2002;59;488;216;272
Kelmė d. mun.;2002;60;428;189;239
Kelmė d. mun.;2002;61;411;177;234
Kelmė d. mun.;2002;62;428;179;249
Kelmė d. mun.;2002;63;459;195;264
Kelmė d. mun.;2002;64;457;179;278
Kelmė d. mun.;2002;65;508;214;294
Kelmė d. mun.;2002;66;485;166;319
Kelmė d. mun.;2002;67;430;154;276
Kelmė d. mun.;2002;68;495;210;285
Kelmė d. mun.;2002;69;440;171;269
Kelmė d. mun.;2002;70;490;187;303
Kelmė d. mun.;2002;71;424;147;277
Kelmė d. mun.;2002;72;418;160;258
Kelmė d. mun.;2002;73;427;166;261
Kelmė d. mun.;2002;74;401;137;264
Kelmė d. mun.;2002;75;375;101;274
Kelmė d. mun.;2002;76;348;105;243
Kelmė d. mun.;2002;77;289;107;182
Kelmė d. mun.;2002;78;295;87;208
Kelmė d. mun.;2002;79;246;87;159
Kelmė d. mun.;2002;80;228;81;147
Kelmė d. mun.;2002;81;178;64;114
Kelmė d. mun.;2002;82;146;46;100
Kelmė d. mun.;2002;83;92;22;70
Kelmė d. mun.;2002;84;93;34;59
Kelmė d. mun.;2002;85;510;157;353
Kelmė d. mun.;2003;-1;40178;19263;20915
Kelmė d. mun.;2003;0;383;199;184
Kelmė d. mun.;2003;1;385;186;199
Kelmė d. mun.;2003;2;372;184;188
Kelmė d. mun.;2003;3;422;232;190
Kelmė d. mun.;2003;4;462;251;211
Kelmė d. mun.;2003;5;453;230;223
Kelmė d. mun.;2003;6;483;265;218
Kelmė d. mun.;2003;7;500;244;256
Kelmė d. mun.;2003;8;505;282;223
Kelmė d. mun.;2003;9;569;291;278
Kelmė d. mun.;2003;10;685;356;329
Kelmė d. mun.;2003;11;658;363;295
Kelmė d. mun.;2003;12;655;325;330
Kelmė d. mun.;2003;13;698;377;321
Kelmė d. mun.;2003;14;618;300;318
Kelmė d. mun.;2003;15;683;326;357
Kelmė d. mun.;2003;16;719;354;365
Kelmė d. mun.;2003;17;675;339;336
Kelmė d. mun.;2003;18;644;343;301
Kelmė d. mun.;2003;19;657;338;319
Kelmė d. mun.;2003;20;525;283;242
Kelmė d. mun.;2003;21;475;272;203
Kelmė d. mun.;2003;22;463;249;214
Kelmė d. mun.;2003;23;454;255;199
Kelmė d. mun.;2003;24;465;247;218
Kelmė d. mun.;2003;25;463;240;223
Kelmė d. mun.;2003;26;484;280;204
Kelmė d. mun.;2003;27;477;243;234
Kelmė d. mun.;2003;28;414;206;208
Kelmė d. mun.;2003;29;466;244;222
Kelmė d. mun.;2003;30;463;237;226
Kelmė d. mun.;2003;31;488;244;244
Kelmė d. mun.;2003;32;502;242;260
Kelmė d. mun.;2003;33;494;243;251
Kelmė d. mun.;2003;34;543;276;267
Kelmė d. mun.;2003;35;506;245;261
Kelmė d. mun.;2003;36;504;260;244
Kelmė d. mun.;2003;37;542;281;261
Kelmė d. mun.;2003;38;562;286;276
Kelmė d. mun.;2003;39;538;292;246
Kelmė d. mun.;2003;40;568;313;255
Kelmė d. mun.;2003;41;581;320;261
Kelmė d. mun.;2003;42;590;293;297
Kelmė d. mun.;2003;43;594;314;280
Kelmė d. mun.;2003;44;604;288;316
Kelmė d. mun.;2003;45;523;294;229
Kelmė d. mun.;2003;46;512;263;249
Kelmė d. mun.;2003;47;473;237;236
Kelmė d. mun.;2003;48;471;242;229
Kelmė d. mun.;2003;49;432;209;223
Kelmė d. mun.;2003;50;450;238;212
Kelmė d. mun.;2003;51;478;251;227
Kelmė d. mun.;2003;52;497;244;253
Kelmė d. mun.;2003;53;494;254;240
Kelmė d. mun.;2003;54;410;197;213
Kelmė d. mun.;2003;55;382;185;197
Kelmė d. mun.;2003;56;305;134;171
Kelmė d. mun.;2003;57;445;209;236
Kelmė d. mun.;2003;58;319;136;183
Kelmė d. mun.;2003;59;392;169;223
Kelmė d. mun.;2003;60;482;209;273
Kelmė d. mun.;2003;61;423;187;236
Kelmė d. mun.;2003;62;403;170;233
Kelmė d. mun.;2003;63;420;176;244
Kelmė d. mun.;2003;64;455;192;263
Kelmė d. mun.;2003;65;455;178;277
Kelmė d. mun.;2003;66;508;211;297
Kelmė d. mun.;2003;67;478;163;315
Kelmė d. mun.;2003;68;420;150;270
Kelmė d. mun.;2003;69;491;209;282
Kelmė d. mun.;2003;70;443;174;269
Kelmė d. mun.;2003;71;480;181;299
Kelmė d. mun.;2003;72;410;138;272
Kelmė d. mun.;2003;73;404;155;249
Kelmė d. mun.;2003;74;417;161;256
Kelmė d. mun.;2003;75;389;133;256
Kelmė d. mun.;2003;76;354;94;260
Kelmė d. mun.;2003;77;334;97;237
Kelmė d. mun.;2003;78;276;100;176
Kelmė d. mun.;2003;79;271;78;193
Kelmė d. mun.;2003;80;227;75;152
Kelmė d. mun.;2003;81;216;77;139
Kelmė d. mun.;2003;82;161;58;103
Kelmė d. mun.;2003;83;128;38;90
Kelmė d. mun.;2003;84;79;19;60
Kelmė d. mun.;2003;85;480;140;340
Kelmė d. mun.;2004;-1;39498;18902;20596
Kelmė d. mun.;2004;0;367;190;177
Kelmė d. mun.;2004;1;384;201;183
Kelmė d. mun.;2004;2;387;184;203
Kelmė d. mun.;2004;3;366;180;186
Kelmė d. mun.;2004;4;417;228;189
Kelmė d. mun.;2004;5;463;252;211
Kelmė d. mun.;2004;6;448;227;221
Kelmė d. mun.;2004;7;482;263;219
Kelmė d. mun.;2004;8;492;239;253
Kelmė d. mun.;2004;9;504;281;223
Kelmė d. mun.;2004;10;568;291;277
Kelmė d. mun.;2004;11;683;354;329
Kelmė d. mun.;2004;12;648;355;293
Kelmė d. mun.;2004;13;639;318;321
Kelmė d. mun.;2004;14;680;367;313
Kelmė d. mun.;2004;15;613;299;314
Kelmė d. mun.;2004;16;672;325;347
Kelmė d. mun.;2004;17;703;347;356
Kelmė d. mun.;2004;18;659;330;329
Kelmė d. mun.;2004;19;625;332;293
Kelmė d. mun.;2004;20;642;330;312
Kelmė d. mun.;2004;21;512;273;239
Kelmė d. mun.;2004;22;460;265;195
Kelmė d. mun.;2004;23;451;241;210
Kelmė d. mun.;2004;24;444;246;198
Kelmė d. mun.;2004;25;439;235;204
Kelmė d. mun.;2004;26;444;230;214
Kelmė d. mun.;2004;27;460;266;194
Kelmė d. mun.;2004;28;458;233;225
Kelmė d. mun.;2004;29;393;198;195
Kelmė d. mun.;2004;30;446;230;216
Kelmė d. mun.;2004;31;445;226;219
Kelmė d. mun.;2004;32;476;234;242
Kelmė d. mun.;2004;33;493;237;256
Kelmė d. mun.;2004;34;488;237;251
Kelmė d. mun.;2004;35;529;269;260
Kelmė d. mun.;2004;36;496;239;257
Kelmė d. mun.;2004;37;487;253;234
Kelmė d. mun.;2004;38;535;278;257
Kelmė d. mun.;2004;39;552;282;270
Kelmė d. mun.;2004;40;528;290;238
Kelmė d. mun.;2004;41;561;310;251
Kelmė d. mun.;2004;42;569;317;252
Kelmė d. mun.;2004;43;580;286;294
Kelmė d. mun.;2004;44;582;307;275
Kelmė d. mun.;2004;45;596;284;312
Kelmė d. mun.;2004;46;511;288;223
Kelmė d. mun.;2004;47;502;258;244
Kelmė d. mun.;2004;48;469;235;234
Kelmė d. mun.;2004;49;465;237;228
Kelmė d. mun.;2004;50;427;207;220
Kelmė d. mun.;2004;51;443;235;208
Kelmė d. mun.;2004;52;465;244;221
Kelmė d. mun.;2004;53;487;236;251
Kelmė d. mun.;2004;54;489;251;238
Kelmė d. mun.;2004;55;402;192;210
Kelmė d. mun.;2004;56;382;186;196
Kelmė d. mun.;2004;57;298;131;167
Kelmė d. mun.;2004;58;442;203;239
Kelmė d. mun.;2004;59;316;132;184
Kelmė d. mun.;2004;60;387;166;221
Kelmė d. mun.;2004;61;471;203;268
Kelmė d. mun.;2004;62;421;186;235
Kelmė d. mun.;2004;63;397;171;226
Kelmė d. mun.;2004;64;415;173;242
Kelmė d. mun.;2004;65;447;186;261
Kelmė d. mun.;2004;66;449;175;274
Kelmė d. mun.;2004;67;502;209;293
Kelmė d. mun.;2004;68;462;153;309
Kelmė d. mun.;2004;69;412;144;268
Kelmė d. mun.;2004;70;467;192;275
Kelmė d. mun.;2004;71;428;163;265
Kelmė d. mun.;2004;72;458;171;287
Kelmė d. mun.;2004;73;395;130;265
Kelmė d. mun.;2004;74;385;142;243
Kelmė d. mun.;2004;75;391;144;247
Kelmė d. mun.;2004;76;368;125;243
Kelmė d. mun.;2004;77;337;86;251
Kelmė d. mun.;2004;78;321;87;234
Kelmė d. mun.;2004;79;256;89;167
Kelmė d. mun.;2004;80;256;72;184
Kelmė d. mun.;2004;81;205;67;138
Kelmė d. mun.;2004;82;196;67;129
Kelmė d. mun.;2004;83;146;49;97
Kelmė d. mun.;2004;84;113;33;80
Kelmė d. mun.;2004;85;449;125;324
Kelmė d. mun.;2005;-1;38551;18443;20108
Kelmė d. mun.;2005;0;322;156;166
Kelmė d. mun.;2005;1;355;181;174
Kelmė d. mun.;2005;2;381;199;182
Kelmė d. mun.;2005;3;382;184;198
Kelmė d. mun.;2005;4;359;177;182
Kelmė d. mun.;2005;5;410;227;183
Kelmė d. mun.;2005;6;457;250;207
Kelmė d. mun.;2005;7;444;227;217
Kelmė d. mun.;2005;8;472;259;213
Kelmė d. mun.;2005;9;481;235;246
Kelmė d. mun.;2005;10;500;277;223
Kelmė d. mun.;2005;11;560;287;273
Kelmė d. mun.;2005;12;671;349;322
Kelmė d. mun.;2005;13;641;352;289
Kelmė d. mun.;2005;14;623;311;312
Kelmė d. mun.;2005;15;672;361;311
Kelmė d. mun.;2005;16;600;294;306
Kelmė d. mun.;2005;17;656;319;337
Kelmė d. mun.;2005;18;682;337;345
Kelmė d. mun.;2005;19;633;319;314
Kelmė d. mun.;2005;20;604;319;285
Kelmė d. mun.;2005;21;615;318;297
Kelmė d. mun.;2005;22;493;266;227
Kelmė d. mun.;2005;23;434;257;177
Kelmė d. mun.;2005;24;431;224;207
Kelmė d. mun.;2005;25;409;236;173
Kelmė d. mun.;2005;26;413;222;191
Kelmė d. mun.;2005;27;408;213;195
Kelmė d. mun.;2005;28;446;259;187
Kelmė d. mun.;2005;29;433;219;214
Kelmė d. mun.;2005;30;373;189;184
Kelmė d. mun.;2005;31;434;225;209
Kelmė d. mun.;2005;32;415;208;207
Kelmė d. mun.;2005;33;462;229;233
Kelmė d. mun.;2005;34;477;227;250
Kelmė d. mun.;2005;35;477;231;246
Kelmė d. mun.;2005;36;521;265;256
Kelmė d. mun.;2005;37;482;230;252
Kelmė d. mun.;2005;38;469;243;226
Kelmė d. mun.;2005;39;519;267;252
Kelmė d. mun.;2005;40;542;274;268
Kelmė d. mun.;2005;41;522;287;235
Kelmė d. mun.;2005;42;551;304;247
Kelmė d. mun.;2005;43;558;310;248
Kelmė d. mun.;2005;44;582;288;294
Kelmė d. mun.;2005;45;576;303;273
Kelmė d. mun.;2005;46;591;282;309
Kelmė d. mun.;2005;47;499;282;217
Kelmė d. mun.;2005;48;490;251;239
Kelmė d. mun.;2005;49;463;232;231
Kelmė d. mun.;2005;50;462;237;225
Kelmė d. mun.;2005;51;414;198;216
Kelmė d. mun.;2005;52;430;227;203
Kelmė d. mun.;2005;53;454;237;217
Kelmė d. mun.;2005;54;477;229;248
Kelmė d. mun.;2005;55;479;245;234
Kelmė d. mun.;2005;56;389;183;206
Kelmė d. mun.;2005;57;376;182;194
Kelmė d. mun.;2005;58;291;126;165
Kelmė d. mun.;2005;59;427;200;227
Kelmė d. mun.;2005;60;313;130;183
Kelmė d. mun.;2005;61;373;159;214
Kelmė d. mun.;2005;62;458;196;262
Kelmė d. mun.;2005;63;408;177;231
Kelmė d. mun.;2005;64;385;163;222
Kelmė d. mun.;2005;65;400;164;236
Kelmė d. mun.;2005;66;428;175;253
Kelmė d. mun.;2005;67;435;170;265
Kelmė d. mun.;2005;68;483;196;287
Kelmė d. mun.;2005;69;443;143;300
Kelmė d. mun.;2005;70;395;135;260
Kelmė d. mun.;2005;71;452;184;268
Kelmė d. mun.;2005;72;417;158;259
Kelmė d. mun.;2005;73;440;163;277
Kelmė d. mun.;2005;74;384;126;258
Kelmė d. mun.;2005;75;368;133;235
Kelmė d. mun.;2005;76;373;138;235
Kelmė d. mun.;2005;77;349;118;231
Kelmė d. mun.;2005;78;317;79;238
Kelmė d. mun.;2005;79;308;81;227
Kelmė d. mun.;2005;80;239;84;155
Kelmė d. mun.;2005;81;235;70;165
Kelmė d. mun.;2005;82;185;58;127
Kelmė d. mun.;2005;83;181;57;124
Kelmė d. mun.;2005;84;129;47;82
Kelmė d. mun.;2005;85;464;114;350
Kelmė d. mun.;2006;-1;37383;17827;19556
Kelmė d. mun.;2006;0;306;138;168
Kelmė d. mun.;2006;1;308;147;161
Kelmė d. mun.;2006;2;341;172;169
Kelmė d. mun.;2006;3;372;195;177
Kelmė d. mun.;2006;4;374;179;195
Kelmė d. mun.;2006;5;353;172;181
Kelmė d. mun.;2006;6;399;221;178
Kelmė d. mun.;2006;7;450;246;204
Kelmė d. mun.;2006;8;441;226;215
Kelmė d. mun.;2006;9;467;258;209
Kelmė d. mun.;2006;10;472;233;239
Kelmė d. mun.;2006;11;493;274;219
Kelmė d. mun.;2006;12;554;286;268
Kelmė d. mun.;2006;13;658;340;318
Kelmė d. mun.;2006;14;627;344;283
Kelmė d. mun.;2006;15;606;303;303
Kelmė d. mun.;2006;16;651;347;304
Kelmė d. mun.;2006;17;581;281;300
Kelmė d. mun.;2006;18;636;309;327
Kelmė d. mun.;2006;19;648;317;331
Kelmė d. mun.;2006;20;592;303;289
Kelmė d. mun.;2006;21;569;304;265
Kelmė d. mun.;2006;22;573;299;274
Kelmė d. mun.;2006;23;466;250;216
Kelmė d. mun.;2006;24;397;234;163
Kelmė d. mun.;2006;25;399;210;189
Kelmė d. mun.;2006;26;374;216;158
Kelmė d. mun.;2006;27;383;211;172
Kelmė d. mun.;2006;28;381;200;181
Kelmė d. mun.;2006;29;423;244;179
Kelmė d. mun.;2006;30;418;211;207
Kelmė d. mun.;2006;31;357;182;175
Kelmė d. mun.;2006;32;411;211;200
Kelmė d. mun.;2006;33;401;197;204
Kelmė d. mun.;2006;34;437;213;224
Kelmė d. mun.;2006;35;460;217;243
Kelmė d. mun.;2006;36;466;225;241
Kelmė d. mun.;2006;37;510;254;256
Kelmė d. mun.;2006;38;470;223;247
Kelmė d. mun.;2006;39;447;230;217
Kelmė d. mun.;2006;40;519;264;255
Kelmė d. mun.;2006;41;532;267;265
Kelmė d. mun.;2006;42;509;278;231
Kelmė d. mun.;2006;43;536;298;238
Kelmė d. mun.;2006;44;545;302;243
Kelmė d. mun.;2006;45;569;284;285
Kelmė d. mun.;2006;46;564;299;265
Kelmė d. mun.;2006;47;582;277;305
Kelmė d. mun.;2006;48;488;271;217
Kelmė d. mun.;2006;49;476;244;232
Kelmė d. mun.;2006;50;449;224;225
Kelmė d. mun.;2006;51;449;229;220
Kelmė d. mun.;2006;52;400;192;208
Kelmė d. mun.;2006;53;420;220;200
Kelmė d. mun.;2006;54;438;229;209
Kelmė d. mun.;2006;55;463;222;241
Kelmė d. mun.;2006;56;472;238;234
Kelmė d. mun.;2006;57;377;177;200
Kelmė d. mun.;2006;58;369;179;190
Kelmė d. mun.;2006;59;286;122;164
Kelmė d. mun.;2006;60;419;196;223
Kelmė d. mun.;2006;61;300;123;177
Kelmė d. mun.;2006;62;362;152;210
Kelmė d. mun.;2006;63;449;191;258
Kelmė d. mun.;2006;64;395;171;224
Kelmė d. mun.;2006;65;375;155;220
Kelmė d. mun.;2006;66;386;158;228
Kelmė d. mun.;2006;67;418;172;246
Kelmė d. mun.;2006;68;429;167;262
Kelmė d. mun.;2006;69;470;190;280
Kelmė d. mun.;2006;70;425;133;292
Kelmė d. mun.;2006;71;376;122;254
Kelmė d. mun.;2006;72;432;173;259
Kelmė d. mun.;2006;73;390;141;249
Kelmė d. mun.;2006;74;422;154;268
Kelmė d. mun.;2006;75;371;122;249
Kelmė d. mun.;2006;76;355;126;229
Kelmė d. mun.;2006;77;361;131;230
Kelmė d. mun.;2006;78;324;107;217
Kelmė d. mun.;2006;79;294;68;226
Kelmė d. mun.;2006;80;268;68;200
Kelmė d. mun.;2006;81;225;76;149
Kelmė d. mun.;2006;82;213;61;152
Kelmė d. mun.;2006;83;159;47;112
Kelmė d. mun.;2006;84;156;50;106
Kelmė d. mun.;2006;85;495;135;360
Kelmė d. mun.;2007;-1;36488;17337;19151
Kelmė d. mun.;2007;0;300;137;163
Kelmė d. mun.;2007;1;300;137;163
Kelmė d. mun.;2007;2;301;147;154
Kelmė d. mun.;2007;3;327;163;164
Kelmė d. mun.;2007;4;367;193;174
Kelmė d. mun.;2007;5;371;177;194
Kelmė d. mun.;2007;6;348;173;175
Kelmė d. mun.;2007;7;393;218;175
Kelmė d. mun.;2007;8;448;245;203
Kelmė d. mun.;2007;9;433;218;215
Kelmė d. mun.;2007;10;463;256;207
Kelmė d. mun.;2007;11;470;234;236
Kelmė d. mun.;2007;12;489;270;219
Kelmė d. mun.;2007;13;546;283;263
Kelmė d. mun.;2007;14;649;335;314
Kelmė d. mun.;2007;15;625;343;282
Kelmė d. mun.;2007;16;596;298;298
Kelmė d. mun.;2007;17;642;341;301
Kelmė d. mun.;2007;18;573;277;296
Kelmė d. mun.;2007;19;617;303;314
Kelmė d. mun.;2007;20;626;305;321
Kelmė d. mun.;2007;21;570;292;278
Kelmė d. mun.;2007;22;533;287;246
Kelmė d. mun.;2007;23;537;284;253
Kelmė d. mun.;2007;24;441;233;208
Kelmė d. mun.;2007;25;361;216;145
Kelmė d. mun.;2007;26;366;193;173
Kelmė d. mun.;2007;27;347;202;145
Kelmė d. mun.;2007;28;371;204;167
Kelmė d. mun.;2007;29;357;187;170
Kelmė d. mun.;2007;30;412;234;178
Kelmė d. mun.;2007;31;401;203;198
Kelmė d. mun.;2007;32;350;178;172
Kelmė d. mun.;2007;33;402;200;202
Kelmė d. mun.;2007;34;394;190;204
Kelmė d. mun.;2007;35;425;205;220
Kelmė d. mun.;2007;36;455;212;243
Kelmė d. mun.;2007;37;457;219;238
Kelmė d. mun.;2007;38;498;250;248
Kelmė d. mun.;2007;39;461;220;241
Kelmė d. mun.;2007;40;439;223;216
Kelmė d. mun.;2007;41;515;263;252
Kelmė d. mun.;2007;42;523;260;263
Kelmė d. mun.;2007;43;495;267;228
Kelmė d. mun.;2007;44;519;287;232
Kelmė d. mun.;2007;45;530;289;241
Kelmė d. mun.;2007;46;555;275;280
Kelmė d. mun.;2007;47;554;294;260
Kelmė d. mun.;2007;48;572;269;303
Kelmė d. mun.;2007;49;485;270;215
Kelmė d. mun.;2007;50;472;240;232
Kelmė d. mun.;2007;51;434;215;219
Kelmė d. mun.;2007;52;442;225;217
Kelmė d. mun.;2007;53;391;185;206
Kelmė d. mun.;2007;54;411;213;198
Kelmė d. mun.;2007;55;434;225;209
Kelmė d. mun.;2007;56;450;214;236
Kelmė d. mun.;2007;57;465;233;232
Kelmė d. mun.;2007;58;371;173;198
Kelmė d. mun.;2007;59;359;169;190
Kelmė d. mun.;2007;60;278;117;161
Kelmė d. mun.;2007;61;405;186;219
Kelmė d. mun.;2007;62;296;121;175
Kelmė d. mun.;2007;63;356;145;211
Kelmė d. mun.;2007;64;440;183;257
Kelmė d. mun.;2007;65;389;169;220
Kelmė d. mun.;2007;66;365;150;215
Kelmė d. mun.;2007;67;379;153;226
Kelmė d. mun.;2007;68;408;163;245
Kelmė d. mun.;2007;69;418;162;256
Kelmė d. mun.;2007;70;465;185;280
Kelmė d. mun.;2007;71;412;131;281
Kelmė d. mun.;2007;72;363;114;249
Kelmė d. mun.;2007;73;415;164;251
Kelmė d. mun.;2007;74;371;130;241
Kelmė d. mun.;2007;75;397;140;257
Kelmė d. mun.;2007;76;353;112;241
Kelmė d. mun.;2007;77;334;118;216
Kelmė d. mun.;2007;78;334;120;214
Kelmė d. mun.;2007;79;304;93;211
Kelmė d. mun.;2007;80;275;61;214
Kelmė d. mun.;2007;81;244;59;185
Kelmė d. mun.;2007;82;198;67;131
Kelmė d. mun.;2007;83;199;58;141
Kelmė d. mun.;2007;84;133;36;97
Kelmė d. mun.;2007;85;519;149;370
Kelmė d. mun.;2008;-1;35602;16863;18739
Kelmė d. mun.;2008;0;316;153;163
Kelmė d. mun.;2008;1;291;132;159
Kelmė d. mun.;2008;2;296;134;162
Kelmė d. mun.;2008;3;293;143;150
Kelmė d. mun.;2008;4;314;158;156
Kelmė d. mun.;2008;5;363;194;169
Kelmė d. mun.;2008;6;363;169;194
Kelmė d. mun.;2008;7;348;172;176
Kelmė d. mun.;2008;8;391;215;176
Kelmė d. mun.;2008;9;443;245;198
Kelmė d. mun.;2008;10;434;219;215
Kelmė d. mun.;2008;11;466;259;207
Kelmė d. mun.;2008;12;461;230;231
Kelmė d. mun.;2008;13;484;266;218
Kelmė d. mun.;2008;14;541;282;259
Kelmė d. mun.;2008;15;643;330;313
Kelmė d. mun.;2008;16;620;341;279
Kelmė d. mun.;2008;17;586;293;293
Kelmė d. mun.;2008;18;633;336;297
Kelmė d. mun.;2008;19;560;269;291
Kelmė d. mun.;2008;20;602;298;304
Kelmė d. mun.;2008;21;606;301;305
Kelmė d. mun.;2008;22;552;285;267
Kelmė d. mun.;2008;23;512;278;234
Kelmė d. mun.;2008;24;512;270;242
Kelmė d. mun.;2008;25;405;216;189
Kelmė d. mun.;2008;26;327;198;129
Kelmė d. mun.;2008;27;346;186;160
Kelmė d. mun.;2008;28;326;190;136
Kelmė d. mun.;2008;29;341;189;152
Kelmė d. mun.;2008;30;336;179;157
Kelmė d. mun.;2008;31;394;219;175
Kelmė d. mun.;2008;32;382;191;191
Kelmė d. mun.;2008;33;340;171;169
Kelmė d. mun.;2008;34;387;188;199
Kelmė d. mun.;2008;35;385;183;202
Kelmė d. mun.;2008;36;418;202;216
Kelmė d. mun.;2008;37;441;200;241
Kelmė d. mun.;2008;38;450;217;233
Kelmė d. mun.;2008;39;487;241;246
Kelmė d. mun.;2008;40;451;214;237
Kelmė d. mun.;2008;41;434;221;213
Kelmė d. mun.;2008;42;505;259;246
Kelmė d. mun.;2008;43;516;259;257
Kelmė d. mun.;2008;44;485;261;224
Kelmė d. mun.;2008;45;505;275;230
Kelmė d. mun.;2008;46;522;284;238
Kelmė d. mun.;2008;47;547;269;278
Kelmė d. mun.;2008;48;543;285;258
Kelmė d. mun.;2008;49;554;256;298
Kelmė d. mun.;2008;50;480;265;215
Kelmė d. mun.;2008;51;458;232;226
Kelmė d. mun.;2008;52;425;210;215
Kelmė d. mun.;2008;53;438;221;217
Kelmė d. mun.;2008;54;376;173;203
Kelmė d. mun.;2008;55;402;208;194
Kelmė d. mun.;2008;56;427;221;206
Kelmė d. mun.;2008;57;437;208;229
Kelmė d. mun.;2008;58;450;223;227
Kelmė d. mun.;2008;59;358;167;191
Kelmė d. mun.;2008;60;346;161;185
Kelmė d. mun.;2008;61;272;111;161
Kelmė d. mun.;2008;62;400;179;221
Kelmė d. mun.;2008;63;293;116;177
Kelmė d. mun.;2008;64;352;145;207
Kelmė d. mun.;2008;65;430;177;253
Kelmė d. mun.;2008;66;380;162;218
Kelmė d. mun.;2008;67;356;142;214
Kelmė d. mun.;2008;68;371;151;220
Kelmė d. mun.;2008;69;395;154;241
Kelmė d. mun.;2008;70;394;148;246
Kelmė d. mun.;2008;71;443;170;273
Kelmė d. mun.;2008;72;399;127;272
Kelmė d. mun.;2008;73;351;110;241
Kelmė d. mun.;2008;74;394;152;242
Kelmė d. mun.;2008;75;355;122;233
Kelmė d. mun.;2008;76;370;125;245
Kelmė d. mun.;2008;77;323;96;227
Kelmė d. mun.;2008;78;321;114;207
Kelmė d. mun.;2008;79;314;108;206
Kelmė d. mun.;2008;80;280;83;197
Kelmė d. mun.;2008;81;248;54;194
Kelmė d. mun.;2008;82;222;56;166
Kelmė d. mun.;2008;83;176;56;120
Kelmė d. mun.;2008;84;179;45;134
Kelmė d. mun.;2008;85;530;146;384
Kelmė d. mun.;2009;-1;34777;16464;18313
Kelmė d. mun.;2009;0;295;155;140
Kelmė d. mun.;2009;1;304;145;159
Kelmė d. mun.;2009;2;286;131;155
Kelmė d. mun.;2009;3;286;128;158
Kelmė d. mun.;2009;4;286;139;147
Kelmė d. mun.;2009;5;311;155;156
Kelmė d. mun.;2009;6;351;186;165
Kelmė d. mun.;2009;7;355;167;188
Kelmė d. mun.;2009;8;345;170;175
Kelmė d. mun.;2009;9;384;211;173
Kelmė d. mun.;2009;10;437;242;195
Kelmė d. mun.;2009;11;425;215;210
Kelmė d. mun.;2009;12;463;258;205
Kelmė d. mun.;2009;13;462;229;233
Kelmė d. mun.;2009;14;481;264;217
Kelmė d. mun.;2009;15;537;277;260
Kelmė d. mun.;2009;16;642;331;311
Kelmė d. mun.;2009;17;612;336;276
Kelmė d. mun.;2009;18;577;286;291
Kelmė d. mun.;2009;19;623;331;292
Kelmė d. mun.;2009;20;548;262;286
Kelmė d. mun.;2009;21;588;290;298
Kelmė d. mun.;2009;22;588;294;294
Kelmė d. mun.;2009;23;525;276;249
Kelmė d. mun.;2009;24;485;262;223
Kelmė d. mun.;2009;25;482;252;230
Kelmė d. mun.;2009;26;378;199;179
Kelmė d. mun.;2009;27;308;190;118
Kelmė d. mun.;2009;28;314;172;142
Kelmė d. mun.;2009;29;298;176;122
Kelmė d. mun.;2009;30;326;184;142
Kelmė d. mun.;2009;31;321;174;147
Kelmė d. mun.;2009;32;373;212;161
Kelmė d. mun.;2009;33;366;185;181
Kelmė d. mun.;2009;34;335;168;167
Kelmė d. mun.;2009;35;368;177;191
Kelmė d. mun.;2009;36;380;179;201
Kelmė d. mun.;2009;37;408;195;213
Kelmė d. mun.;2009;38;431;197;234
Kelmė d. mun.;2009;39;440;210;230
Kelmė d. mun.;2009;40;477;234;243
Kelmė d. mun.;2009;41;445;213;232
Kelmė d. mun.;2009;42;424;215;209
Kelmė d. mun.;2009;43;493;253;240
Kelmė d. mun.;2009;44;516;259;257
Kelmė d. mun.;2009;45;471;251;220
Kelmė d. mun.;2009;46;493;266;227
Kelmė d. mun.;2009;47;519;280;239
Kelmė d. mun.;2009;48;533;262;271
Kelmė d. mun.;2009;49;540;286;254
Kelmė d. mun.;2009;50;543;250;293
Kelmė d. mun.;2009;51;471;258;213
Kelmė d. mun.;2009;52;452;228;224
Kelmė d. mun.;2009;53;415;203;212
Kelmė d. mun.;2009;54;430;216;214
Kelmė d. mun.;2009;55;373;172;201
Kelmė d. mun.;2009;56;389;196;193
Kelmė d. mun.;2009;57;411;207;204
Kelmė d. mun.;2009;58;427;199;228
Kelmė d. mun.;2009;59;442;215;227
Kelmė d. mun.;2009;60;348;161;187
Kelmė d. mun.;2009;61;341;158;183
Kelmė d. mun.;2009;62;268;111;157
Kelmė d. mun.;2009;63;394;177;217
Kelmė d. mun.;2009;64;290;114;176
Kelmė d. mun.;2009;65;343;141;202
Kelmė d. mun.;2009;66;413;165;248
Kelmė d. mun.;2009;67;373;157;216
Kelmė d. mun.;2009;68;349;138;211
Kelmė d. mun.;2009;69;357;143;214
Kelmė d. mun.;2009;70;382;145;237
Kelmė d. mun.;2009;71;380;141;239
Kelmė d. mun.;2009;72;430;161;269
Kelmė d. mun.;2009;73;387;125;262
Kelmė d. mun.;2009;74;336;103;233
Kelmė d. mun.;2009;75;381;145;236
Kelmė d. mun.;2009;76;333;113;220
Kelmė d. mun.;2009;77;356;119;237
Kelmė d. mun.;2009;78;298;88;210
Kelmė d. mun.;2009;79;300;107;193
Kelmė d. mun.;2009;80;289;94;195
Kelmė d. mun.;2009;81;253;69;184
Kelmė d. mun.;2009;82;233;49;184
Kelmė d. mun.;2009;83;201;49;152
Kelmė d. mun.;2009;84;164;56;108
Kelmė d. mun.;2009;85;590;162;428
Kelmė d. mun.;2010;-1;33842;15983;17859
Kelmė d. mun.;2010;0;318;163;155
Kelmė d. mun.;2010;1;288;149;139
Kelmė d. mun.;2010;2;284;134;150
Kelmė d. mun.;2010;3;279;133;146
Kelmė d. mun.;2010;4;276;121;155
Kelmė d. mun.;2010;5;283;135;148
Kelmė d. mun.;2010;6;308;154;154
Kelmė d. mun.;2010;7;344;182;162
Kelmė d. mun.;2010;8;349;163;186
Kelmė d. mun.;2010;9;341;166;175
Kelmė d. mun.;2010;10;381;210;171
Kelmė d. mun.;2010;11;431;239;192
Kelmė d. mun.;2010;12;418;210;208
Kelmė d. mun.;2010;13;461;255;206
Kelmė d. mun.;2010;14;459;228;231
Kelmė d. mun.;2010;15;472;260;212
Kelmė d. mun.;2010;16;531;276;255
Kelmė d. mun.;2010;17;642;331;311
Kelmė d. mun.;2010;18;598;330;268
Kelmė d. mun.;2010;19;566;279;287
Kelmė d. mun.;2010;20;600;322;278
Kelmė d. mun.;2010;21;530;256;274
Kelmė d. mun.;2010;22;562;276;286
Kelmė d. mun.;2010;23;555;276;279
Kelmė d. mun.;2010;24;497;261;236
Kelmė d. mun.;2010;25;450;248;202
Kelmė d. mun.;2010;26;441;234;207
Kelmė d. mun.;2010;27;346;183;163
Kelmė d. mun.;2010;28;289;183;106
Kelmė d. mun.;2010;29;292;157;135
Kelmė d. mun.;2010;30;276;169;107
Kelmė d. mun.;2010;31;304;171;133
Kelmė d. mun.;2010;32;305;163;142
Kelmė d. mun.;2010;33;352;200;152
Kelmė d. mun.;2010;34;351;179;172
Kelmė d. mun.;2010;35;316;160;156
Kelmė d. mun.;2010;36;352;165;187
Kelmė d. mun.;2010;37;366;169;197
Kelmė d. mun.;2010;38;398;186;212
Kelmė d. mun.;2010;39;419;186;233
Kelmė d. mun.;2010;40;429;204;225
Kelmė d. mun.;2010;41;470;232;238
Kelmė d. mun.;2010;42;445;212;233
Kelmė d. mun.;2010;43;408;205;203
Kelmė d. mun.;2010;44;486;247;239
Kelmė d. mun.;2010;45;512;256;256
Kelmė d. mun.;2010;46;465;245;220
Kelmė d. mun.;2010;47;483;261;222
Kelmė d. mun.;2010;48;502;269;233
Kelmė d. mun.;2010;49;524;256;268
Kelmė d. mun.;2010;50;532;283;249
Kelmė d. mun.;2010;51;532;245;287
Kelmė d. mun.;2010;52;463;252;211
Kelmė d. mun.;2010;53;446;223;223
Kelmė d. mun.;2010;54;399;196;203
Kelmė d. mun.;2010;55;418;209;209
Kelmė d. mun.;2010;56;369;170;199
Kelmė d. mun.;2010;57;383;192;191
Kelmė d. mun.;2010;58;403;203;200
Kelmė d. mun.;2010;59;418;194;224
Kelmė d. mun.;2010;60;433;208;225
Kelmė d. mun.;2010;61;341;158;183
Kelmė d. mun.;2010;62;328;148;180
Kelmė d. mun.;2010;63;258;105;153
Kelmė d. mun.;2010;64;380;168;212
Kelmė d. mun.;2010;65;287;113;174
Kelmė d. mun.;2010;66;335;134;201
Kelmė d. mun.;2010;67;397;156;241
Kelmė d. mun.;2010;68;360;147;213
Kelmė d. mun.;2010;69;336;131;205
Kelmė d. mun.;2010;70;349;138;211
Kelmė d. mun.;2010;71;377;141;236
Kelmė d. mun.;2010;72;364;133;231
Kelmė d. mun.;2010;73;421;156;265
Kelmė d. mun.;2010;74;377;120;257
Kelmė d. mun.;2010;75;317;96;221
Kelmė d. mun.;2010;76;357;129;228
Kelmė d. mun.;2010;77;312;101;211
Kelmė d. mun.;2010;78;330;107;223
Kelmė d. mun.;2010;79;280;83;197
Kelmė d. mun.;2010;80;280;98;182
Kelmė d. mun.;2010;81;270;86;184
Kelmė d. mun.;2010;82;229;63;166
Kelmė d. mun.;2010;83;215;48;167
Kelmė d. mun.;2010;84;175;39;136
Kelmė d. mun.;2010;85;617;161;456
Kelmė d. mun.;2011;-1;32566;15377;17189
Kelmė d. mun.;2011;0;263;151;112
Kelmė d. mun.;2011;1;279;151;128
Kelmė d. mun.;2011;2;259;133;126
Kelmė d. mun.;2011;3;234;112;122
Kelmė d. mun.;2011;4;243;110;133
Kelmė d. mun.;2011;5;260;121;139
Kelmė d. mun.;2011;6;267;123;144
Kelmė d. mun.;2011;7;309;156;153
Kelmė d. mun.;2011;8;301;172;129
Kelmė d. mun.;2011;9;336;158;178
Kelmė d. mun.;2011;10;341;176;165
Kelmė d. mun.;2011;11;381;206;175
Kelmė d. mun.;2011;12;434;241;193
Kelmė d. mun.;2011;13;420;212;208
Kelmė d. mun.;2011;14;462;254;208
Kelmė d. mun.;2011;15;459;231;228
Kelmė d. mun.;2011;16;473;260;213
Kelmė d. mun.;2011;17;543;274;269
Kelmė d. mun.;2011;18;634;329;305
Kelmė d. mun.;2011;19;512;300;212
Kelmė d. mun.;2011;20;445;243;202
Kelmė d. mun.;2011;21;461;260;201
Kelmė d. mun.;2011;22;395;211;184
Kelmė d. mun.;2011;23;414;220;194
Kelmė d. mun.;2011;24;400;211;189
Kelmė d. mun.;2011;25;351;181;170
Kelmė d. mun.;2011;26;292;168;124
Kelmė d. mun.;2011;27;306;163;143
Kelmė d. mun.;2011;28;279;142;137
Kelmė d. mun.;2011;29;252;138;114
Kelmė d. mun.;2011;30;285;146;139
Kelmė d. mun.;2011;31;300;153;147
Kelmė d. mun.;2011;32;338;175;163
Kelmė d. mun.;2011;33;350;172;178
Kelmė d. mun.;2011;34;369;195;174
Kelmė d. mun.;2011;35;348;168;180
Kelmė d. mun.;2011;36;351;172;179
Kelmė d. mun.;2011;37;392;199;193
Kelmė d. mun.;2011;38;415;196;219
Kelmė d. mun.;2011;39;419;199;220
Kelmė d. mun.;2011;40;447;204;243
Kelmė d. mun.;2011;41;436;215;221
Kelmė d. mun.;2011;42;495;246;249
Kelmė d. mun.;2011;43;469;232;237
Kelmė d. mun.;2011;44;442;234;208
Kelmė d. mun.;2011;45;479;245;234
Kelmė d. mun.;2011;46;522;268;254
Kelmė d. mun.;2011;47;462;240;222
Kelmė d. mun.;2011;48;506;272;234
Kelmė d. mun.;2011;49;513;283;230
Kelmė d. mun.;2011;50;538;264;274
Kelmė d. mun.;2011;51;515;269;246
Kelmė d. mun.;2011;52;542;254;288
Kelmė d. mun.;2011;53;442;230;212
Kelmė d. mun.;2011;54;440;219;221
Kelmė d. mun.;2011;55;402;188;214
Kelmė d. mun.;2011;56;400;191;209
Kelmė d. mun.;2011;57;376;171;205
Kelmė d. mun.;2011;58;390;199;191
Kelmė d. mun.;2011;59;423;212;211
Kelmė d. mun.;2011;60;426;197;229
Kelmė d. mun.;2011;61;408;188;220
Kelmė d. mun.;2011;62;353;159;194
Kelmė d. mun.;2011;63;325;139;186
Kelmė d. mun.;2011;64;258;107;151
Kelmė d. mun.;2011;65;382;163;219
Kelmė d. mun.;2011;66;286;103;183
Kelmė d. mun.;2011;67;334;133;201
Kelmė d. mun.;2011;68;398;157;241
Kelmė d. mun.;2011;69;368;150;218
Kelmė d. mun.;2011;70;330;131;199
Kelmė d. mun.;2011;71;346;131;215
Kelmė d. mun.;2011;72;363;128;235
Kelmė d. mun.;2011;73;357;129;228
Kelmė d. mun.;2011;74;414;154;260
Kelmė d. mun.;2011;75;357;111;246
Kelmė d. mun.;2011;76;301;85;216
Kelmė d. mun.;2011;77;323;106;217
Kelmė d. mun.;2011;78;300;89;211
Kelmė d. mun.;2011;79;309;98;211
Kelmė d. mun.;2011;80;258;78;180
Kelmė d. mun.;2011;81;254;86;168
Kelmė d. mun.;2011;82;238;72;166
Kelmė d. mun.;2011;83;205;61;144
Kelmė d. mun.;2011;84;182;39;143
Kelmė d. mun.;2011;85;680;165;515
Kelmė d. mun.;2012;-1;31722;14995;16727
Kelmė d. mun.;2012;0;264;133;131
Kelmė d. mun.;2012;1;249;148;101
Kelmė d. mun.;2012;2;260;140;120
Kelmė d. mun.;2012;3;252;129;123
Kelmė d. mun.;2012;4;225;112;113
Kelmė d. mun.;2012;5;238;105;133
Kelmė d. mun.;2012;6;257;120;137
Kelmė d. mun.;2012;7;264;124;140
Kelmė d. mun.;2012;8;308;153;155
Kelmė d. mun.;2012;9;296;170;126
Kelmė d. mun.;2012;10;322;151;171
Kelmė d. mun.;2012;11;336;173;163
Kelmė d. mun.;2012;12;379;205;174
Kelmė d. mun.;2012;13;433;242;191
Kelmė d. mun.;2012;14;414;208;206
Kelmė d. mun.;2012;15;458;251;207
Kelmė d. mun.;2012;16;457;229;228
Kelmė d. mun.;2012;17;470;261;209
Kelmė d. mun.;2012;18;540;271;269
Kelmė d. mun.;2012;19;623;323;300
Kelmė d. mun.;2012;20;492;289;203
Kelmė d. mun.;2012;21;430;238;192
Kelmė d. mun.;2012;22;435;246;189
Kelmė d. mun.;2012;23;363;198;165
Kelmė d. mun.;2012;24;372;200;172
Kelmė d. mun.;2012;25;349;186;163
Kelmė d. mun.;2012;26;312;169;143
Kelmė d. mun.;2012;27;263;149;114
Kelmė d. mun.;2012;28;284;152;132
Kelmė d. mun.;2012;29;258;135;123
Kelmė d. mun.;2012;30;227;121;106
Kelmė d. mun.;2012;31;273;142;131
Kelmė d. mun.;2012;32;279;142;137
Kelmė d. mun.;2012;33;320;165;155
Kelmė d. mun.;2012;34;336;167;169
Kelmė d. mun.;2012;35;356;185;171
Kelmė d. mun.;2012;36;329;159;170
Kelmė d. mun.;2012;37;347;173;174
Kelmė d. mun.;2012;38;381;196;185
Kelmė d. mun.;2012;39;406;194;212
Kelmė d. mun.;2012;40;396;182;214
Kelmė d. mun.;2012;41;435;199;236
Kelmė d. mun.;2012;42;435;212;223
Kelmė d. mun.;2012;43;488;239;249
Kelmė d. mun.;2012;44;460;229;231
Kelmė d. mun.;2012;45;435;233;202
Kelmė d. mun.;2012;46;468;237;231
Kelmė d. mun.;2012;47;514;262;252
Kelmė d. mun.;2012;48;449;232;217
Kelmė d. mun.;2012;49;508;272;236
Kelmė d. mun.;2012;50;504;277;227
Kelmė d. mun.;2012;51;530;262;268
Kelmė d. mun.;2012;52;513;266;247
Kelmė d. mun.;2012;53;540;254;286
Kelmė d. mun.;2012;54;435;222;213
Kelmė d. mun.;2012;55;427;212;215
Kelmė d. mun.;2012;56;400;185;215
Kelmė d. mun.;2012;57;397;192;205
Kelmė d. mun.;2012;58;366;161;205
Kelmė d. mun.;2012;59;384;196;188
Kelmė d. mun.;2012;60;418;208;210
Kelmė d. mun.;2012;61;416;191;225
Kelmė d. mun.;2012;62;405;187;218
Kelmė d. mun.;2012;63;350;160;190
Kelmė d. mun.;2012;64;318;135;183
Kelmė d. mun.;2012;65;260;108;152
Kelmė d. mun.;2012;66;379;163;216
Kelmė d. mun.;2012;67;279;97;182
Kelmė d. mun.;2012;68;327;128;199
Kelmė d. mun.;2012;69;391;154;237
Kelmė d. mun.;2012;70;360;143;217
Kelmė d. mun.;2012;71;317;124;193
Kelmė d. mun.;2012;72;334;121;213
Kelmė d. mun.;2012;73;352;123;229
Kelmė d. mun.;2012;74;349;125;224
Kelmė d. mun.;2012;75;396;144;252
Kelmė d. mun.;2012;76;335;101;234
Kelmė d. mun.;2012;77;290;80;210
Kelmė d. mun.;2012;78;303;101;202
Kelmė d. mun.;2012;79;279;81;198
Kelmė d. mun.;2012;80;292;94;198
Kelmė d. mun.;2012;81;245;72;173
Kelmė d. mun.;2012;82;241;81;160
Kelmė d. mun.;2012;83;222;65;157
Kelmė d. mun.;2012;84;184;54;130
Kelmė d. mun.;2012;85;739;177;562
Kelmė d. mun.;2013;-1;31037;14692;16345
Kelmė d. mun.;2013;0;272;144;128
Kelmė d. mun.;2013;1;256;133;123
Kelmė d. mun.;2013;2;238;143;95
Kelmė d. mun.;2013;3;251;133;118
Kelmė d. mun.;2013;4;249;130;119
Kelmė d. mun.;2013;5;218;105;113
Kelmė d. mun.;2013;6;236;106;130
Kelmė d. mun.;2013;7;254;119;135
Kelmė d. mun.;2013;8;265;124;141
Kelmė d. mun.;2013;9;305;152;153
Kelmė d. mun.;2013;10;291;167;124
Kelmė d. mun.;2013;11;326;154;172
Kelmė d. mun.;2013;12;334;170;164
Kelmė d. mun.;2013;13;374;203;171
Kelmė d. mun.;2013;14;431;242;189
Kelmė d. mun.;2013;15;415;210;205
Kelmė d. mun.;2013;16;456;250;206
Kelmė d. mun.;2013;17;453;225;228
Kelmė d. mun.;2013;18;465;257;208
Kelmė d. mun.;2013;19;528;267;261
Kelmė d. mun.;2013;20;606;319;287
Kelmė d. mun.;2013;21;478;284;194
Kelmė d. mun.;2013;22;409;236;173
Kelmė d. mun.;2013;23;414;248;166
Kelmė d. mun.;2013;24;344;191;153
Kelmė d. mun.;2013;25;358;188;170
Kelmė d. mun.;2013;26;319;177;142
Kelmė d. mun.;2013;27;288;159;129
Kelmė d. mun.;2013;28;237;135;102
Kelmė d. mun.;2013;29;260;134;126
Kelmė d. mun.;2013;30;246;131;115
Kelmė d. mun.;2013;31;210;107;103
Kelmė d. mun.;2013;32;260;132;128
Kelmė d. mun.;2013;33;271;137;134
Kelmė d. mun.;2013;34;314;156;158
Kelmė d. mun.;2013;35;325;161;164
Kelmė d. mun.;2013;36;344;176;168
Kelmė d. mun.;2013;37;324;155;169
Kelmė d. mun.;2013;38;343;170;173
Kelmė d. mun.;2013;39;375;193;182
Kelmė d. mun.;2013;40;401;189;212
Kelmė d. mun.;2013;41;391;179;212
Kelmė d. mun.;2013;42;426;192;234
Kelmė d. mun.;2013;43;431;211;220
Kelmė d. mun.;2013;44;486;241;245
Kelmė d. mun.;2013;45;456;227;229
Kelmė d. mun.;2013;46;434;234;200
Kelmė d. mun.;2013;47;466;236;230
Kelmė d. mun.;2013;48;509;258;251
Kelmė d. mun.;2013;49;440;231;209
Kelmė d. mun.;2013;50;495;266;229
Kelmė d. mun.;2013;51;501;274;227
Kelmė d. mun.;2013;52;532;265;267
Kelmė d. mun.;2013;53;507;263;244
Kelmė d. mun.;2013;54;533;251;282
Kelmė d. mun.;2013;55;427;218;209
Kelmė d. mun.;2013;56;422;207;215
Kelmė d. mun.;2013;57;398;183;215
Kelmė d. mun.;2013;58;389;186;203
Kelmė d. mun.;2013;59;359;155;204
Kelmė d. mun.;2013;60;380;192;188
Kelmė d. mun.;2013;61;416;207;209
Kelmė d. mun.;2013;62;413;186;227
Kelmė d. mun.;2013;63;394;178;216
Kelmė d. mun.;2013;64;342;157;185
Kelmė d. mun.;2013;65;307;131;176
Kelmė d. mun.;2013;66;250;103;147
Kelmė d. mun.;2013;67;368;153;215
Kelmė d. mun.;2013;68;272;91;181
Kelmė d. mun.;2013;69;315;120;195
Kelmė d. mun.;2013;70;379;144;235
Kelmė d. mun.;2013;71;353;139;214
Kelmė d. mun.;2013;72;308;118;190
Kelmė d. mun.;2013;73;317;114;203
Kelmė d. mun.;2013;74;338;118;220
Kelmė d. mun.;2013;75;339;120;219
Kelmė d. mun.;2013;76;377;138;239
Kelmė d. mun.;2013;77;324;95;229
Kelmė d. mun.;2013;78;273;73;200
Kelmė d. mun.;2013;79;284;89;195
Kelmė d. mun.;2013;80;256;76;180
Kelmė d. mun.;2013;81;269;81;188
Kelmė d. mun.;2013;82;227;69;158
Kelmė d. mun.;2013;83;217;69;148
Kelmė d. mun.;2013;84;202;58;144
Kelmė d. mun.;2013;85;772;184;588
Kelmė d. mun.;2014;-1;30305;14372;15933
Kelmė d. mun.;2014;0;280;149;131
Kelmė d. mun.;2014;1;265;140;125
Kelmė d. mun.;2014;2;247;125;122
Kelmė d. mun.;2014;3;226;137;89
Kelmė d. mun.;2014;4;243;130;113
Kelmė d. mun.;2014;5;252;129;123
Kelmė d. mun.;2014;6;211;104;107
Kelmė d. mun.;2014;7;227;99;128
Kelmė d. mun.;2014;8;249;115;134
Kelmė d. mun.;2014;9;264;125;139
Kelmė d. mun.;2014;10;304;152;152
Kelmė d. mun.;2014;11;288;164;124
Kelmė d. mun.;2014;12;319;151;168
Kelmė d. mun.;2014;13;327;163;164
Kelmė d. mun.;2014;14;373;202;171
Kelmė d. mun.;2014;15;432;244;188
Kelmė d. mun.;2014;16;406;204;202
Kelmė d. mun.;2014;17;452;248;204
Kelmė d. mun.;2014;18;453;224;229
Kelmė d. mun.;2014;19;453;250;203
Kelmė d. mun.;2014;20;515;260;255
Kelmė d. mun.;2014;21;593;312;281
Kelmė d. mun.;2014;22;467;283;184
Kelmė d. mun.;2014;23;384;229;155
Kelmė d. mun.;2014;24;382;237;145
Kelmė d. mun.;2014;25;309;179;130
Kelmė d. mun.;2014;26;306;165;141
Kelmė d. mun.;2014;27;291;161;130
Kelmė d. mun.;2014;28;277;153;124
Kelmė d. mun.;2014;29;221;126;95
Kelmė d. mun.;2014;30;244;124;120
Kelmė d. mun.;2014;31;234;125;109
Kelmė d. mun.;2014;32;196;99;97
Kelmė d. mun.;2014;33;252;127;125
Kelmė d. mun.;2014;34;267;136;131
Kelmė d. mun.;2014;35;302;153;149
Kelmė d. mun.;2014;36;314;156;158
Kelmė d. mun.;2014;37;339;174;165
Kelmė d. mun.;2014;38;326;155;171
Kelmė d. mun.;2014;39;327;161;166
Kelmė d. mun.;2014;40;374;191;183
Kelmė d. mun.;2014;41;399;188;211
Kelmė d. mun.;2014;42;382;177;205
Kelmė d. mun.;2014;43;425;190;235
Kelmė d. mun.;2014;44;424;210;214
Kelmė d. mun.;2014;45;482;240;242
Kelmė d. mun.;2014;46;448;223;225
Kelmė d. mun.;2014;47;436;234;202
Kelmė d. mun.;2014;48;461;234;227
Kelmė d. mun.;2014;49;504;254;250
Kelmė d. mun.;2014;50;442;232;210
Kelmė d. mun.;2014;51;487;259;228
Kelmė d. mun.;2014;52;496;269;227
Kelmė d. mun.;2014;53;526;260;266
Kelmė d. mun.;2014;54;502;260;242
Kelmė d. mun.;2014;55;531;250;281
Kelmė d. mun.;2014;56;418;213;205
Kelmė d. mun.;2014;57;414;202;212
Kelmė d. mun.;2014;58;399;183;216
Kelmė d. mun.;2014;59;385;181;204
Kelmė d. mun.;2014;60;349;150;199
Kelmė d. mun.;2014;61;374;188;186
Kelmė d. mun.;2014;62;406;198;208
Kelmė d. mun.;2014;63;407;183;224
Kelmė d. mun.;2014;64;385;171;214
Kelmė d. mun.;2014;65;332;151;181
Kelmė d. mun.;2014;66;297;123;174
Kelmė d. mun.;2014;67;247;102;145
Kelmė d. mun.;2014;68;363;150;213
Kelmė d. mun.;2014;69;263;86;177
Kelmė d. mun.;2014;70;300;111;189
Kelmė d. mun.;2014;71;370;139;231
Kelmė d. mun.;2014;72;340;133;207
Kelmė d. mun.;2014;73;303;114;189
Kelmė d. mun.;2014;74;307;107;200
Kelmė d. mun.;2014;75;325;115;210
Kelmė d. mun.;2014;76;326;113;213
Kelmė d. mun.;2014;77;360;130;230
Kelmė d. mun.;2014;78;309;87;222
Kelmė d. mun.;2014;79;255;69;186
Kelmė d. mun.;2014;80;267;85;182
Kelmė d. mun.;2014;81;239;73;166
Kelmė d. mun.;2014;82;253;77;176
Kelmė d. mun.;2014;83;205;61;144
Kelmė d. mun.;2014;84;193;57;136
Kelmė d. mun.;2014;85;778;179;599
Kelmė d. mun.;2015;-1;29559;14068;15491
Kelmė d. mun.;2015;0;272;140;132
Kelmė d. mun.;2015;1;271;147;124
Kelmė d. mun.;2015;2;251;132;119
Kelmė d. mun.;2015;3;235;119;116
Kelmė d. mun.;2015;4;223;136;87
Kelmė d. mun.;2015;5;230;121;109
Kelmė d. mun.;2015;6;256;133;123
Kelmė d. mun.;2015;7;206;103;103
Kelmė d. mun.;2015;8;219;95;124
Kelmė d. mun.;2015;9;240;110;130
Kelmė d. mun.;2015;10;260;122;138
Kelmė d. mun.;2015;11;302;152;150
Kelmė d. mun.;2015;12;281;160;121
Kelmė d. mun.;2015;13;314;146;168
Kelmė d. mun.;2015;14;321;161;160
Kelmė d. mun.;2015;15;372;202;170
Kelmė d. mun.;2015;16;430;244;186
Kelmė d. mun.;2015;17;399;203;196
Kelmė d. mun.;2015;18;451;248;203
Kelmė d. mun.;2015;19;433;215;218
Kelmė d. mun.;2015;20;437;244;193
Kelmė d. mun.;2015;21;496;255;241
Kelmė d. mun.;2015;22;561;296;265
Kelmė d. mun.;2015;23;439;271;168
Kelmė d. mun.;2015;24;360;216;144
Kelmė d. mun.;2015;25;357;222;135
Kelmė d. mun.;2015;26;291;173;118
Kelmė d. mun.;2015;27;297;163;134
Kelmė d. mun.;2015;28;284;163;121
Kelmė d. mun.;2015;29;248;135;113
Kelmė d. mun.;2015;30;202;120;82
Kelmė d. mun.;2015;31;239;127;112
Kelmė d. mun.;2015;32;211;112;99
Kelmė d. mun.;2015;33;185;92;93
Kelmė d. mun.;2015;34;236;118;118
Kelmė d. mun.;2015;35;261;137;124
Kelmė d. mun.;2015;36;288;144;144
Kelmė d. mun.;2015;37;302;151;151
Kelmė d. mun.;2015;38;331;171;160
Kelmė d. mun.;2015;39;322;151;171
Kelmė d. mun.;2015;40;327;161;166
Kelmė d. mun.;2015;41;376;193;183
Kelmė d. mun.;2015;42;398;187;211
Kelmė d. mun.;2015;43;380;176;204
Kelmė d. mun.;2015;44;413;182;231
Kelmė d. mun.;2015;45;416;208;208
Kelmė d. mun.;2015;46;481;239;242
Kelmė d. mun.;2015;47;446;222;224
Kelmė d. mun.;2015;48;436;234;202
Kelmė d. mun.;2015;49;451;227;224
Kelmė d. mun.;2015;50;509;254;255
Kelmė d. mun.;2015;51;443;231;212
Kelmė d. mun.;2015;52;482;258;224
Kelmė d. mun.;2015;53;489;267;222
Kelmė d. mun.;2015;54;520;258;262
Kelmė d. mun.;2015;55;487;250;237
Kelmė d. mun.;2015;56;526;250;276
Kelmė d. mun.;2015;57;407;205;202
Kelmė d. mun.;2015;58;401;191;210
Kelmė d. mun.;2015;59;393;177;216
Kelmė d. mun.;2015;60;386;180;206
Kelmė d. mun.;2015;61;349;149;200
Kelmė d. mun.;2015;62;371;186;185
Kelmė d. mun.;2015;63;397;191;206
Kelmė d. mun.;2015;64;407;184;223
Kelmė d. mun.;2015;65;373;164;209
Kelmė d. mun.;2015;66;323;145;178
Kelmė d. mun.;2015;67;289;121;168
Kelmė d. mun.;2015;68;240;98;142
Kelmė d. mun.;2015;69;349;143;206
Kelmė d. mun.;2015;70;257;82;175
Kelmė d. mun.;2015;71;294;106;188
Kelmė d. mun.;2015;72;358;133;225
Kelmė d. mun.;2015;73;328;123;205
Kelmė d. mun.;2015;74;288;103;185
Kelmė d. mun.;2015;75;291;102;189
Kelmė d. mun.;2015;76;315;109;206
Kelmė d. mun.;2015;77;307;108;199
Kelmė d. mun.;2015;78;335;121;214
Kelmė d. mun.;2015;79;283;75;208
Kelmė d. mun.;2015;80;237;63;174
Kelmė d. mun.;2015;81;250;78;172
Kelmė d. mun.;2015;82;216;64;152
Kelmė d. mun.;2015;83;231;71;160
Kelmė d. mun.;2015;84;182;53;129
Kelmė d. mun.;2015;85;809;196;613
Kelmė d. mun.;2016;-1;28647;13678;14969
Kelmė d. mun.;2016;0;239;120;119
Kelmė d. mun.;2016;1;273;141;132
Kelmė d. mun.;2016;2;260;143;117
Kelmė d. mun.;2016;3;237;126;111
Kelmė d. mun.;2016;4;230;115;115
Kelmė d. mun.;2016;5;214;133;81
Kelmė d. mun.;2016;6;219;119;100
Kelmė d. mun.;2016;7;251;130;121
Kelmė d. mun.;2016;8;201;101;100
Kelmė d. mun.;2016;9;217;92;125
Kelmė d. mun.;2016;10;237;107;130
Kelmė d. mun.;2016;11;253;118;135
Kelmė d. mun.;2016;12;302;151;151
Kelmė d. mun.;2016;13;278;159;119
Kelmė d. mun.;2016;14;315;145;170
Kelmė d. mun.;2016;15;316;160;156
Kelmė d. mun.;2016;16;367;199;168
Kelmė d. mun.;2016;17;421;235;186
Kelmė d. mun.;2016;18;395;204;191
Kelmė d. mun.;2016;19;443;243;200
Kelmė d. mun.;2016;20;410;206;204
Kelmė d. mun.;2016;21;423;239;184
Kelmė d. mun.;2016;22;465;237;228
Kelmė d. mun.;2016;23;528;283;245
Kelmė d. mun.;2016;24;404;260;144
Kelmė d. mun.;2016;25;334;205;129
Kelmė d. mun.;2016;26;320;204;116
Kelmė d. mun.;2016;27;264;159;105
Kelmė d. mun.;2016;28;262;150;112
Kelmė d. mun.;2016;29;249;148;101
Kelmė d. mun.;2016;30;229;126;103
Kelmė d. mun.;2016;31;183;119;64
Kelmė d. mun.;2016;32;224;119;105
Kelmė d. mun.;2016;33;197;108;89
Kelmė d. mun.;2016;34;171;84;87
Kelmė d. mun.;2016;35;230;116;114
Kelmė d. mun.;2016;36;251;130;121
Kelmė d. mun.;2016;37;286;142;144
Kelmė d. mun.;2016;38;290;147;143
Kelmė d. mun.;2016;39;325;167;158
Kelmė d. mun.;2016;40;317;150;167
Kelmė d. mun.;2016;41;322;161;161
Kelmė d. mun.;2016;42;372;193;179
Kelmė d. mun.;2016;43;392;183;209
Kelmė d. mun.;2016;44;372;172;200
Kelmė d. mun.;2016;45;405;178;227
Kelmė d. mun.;2016;46;415;209;206
Kelmė d. mun.;2016;47;469;231;238
Kelmė d. mun.;2016;48;445;223;222
Kelmė d. mun.;2016;49;432;230;202
Kelmė d. mun.;2016;50;451;231;220
Kelmė d. mun.;2016;51;502;251;251
Kelmė d. mun.;2016;52;436;225;211
Kelmė d. mun.;2016;53;472;246;226
Kelmė d. mun.;2016;54;485;264;221
Kelmė d. mun.;2016;55;521;261;260
Kelmė d. mun.;2016;56;472;242;230
Kelmė d. mun.;2016;57;520;244;276
Kelmė d. mun.;2016;58;396;200;196
Kelmė d. mun.;2016;59;394;187;207
Kelmė d. mun.;2016;60;387;169;218
Kelmė d. mun.;2016;61;371;168;203
Kelmė d. mun.;2016;62;342;145;197
Kelmė d. mun.;2016;63;366;184;182
Kelmė d. mun.;2016;64;383;179;204
Kelmė d. mun.;2016;65;396;177;219
Kelmė d. mun.;2016;66;357;157;200
Kelmė d. mun.;2016;67;318;143;175
Kelmė d. mun.;2016;68;283;117;166
Kelmė d. mun.;2016;69;237;96;141
Kelmė d. mun.;2016;70;342;140;202
Kelmė d. mun.;2016;71;244;76;168
Kelmė d. mun.;2016;72;284;101;183
Kelmė d. mun.;2016;73;339;125;214
Kelmė d. mun.;2016;74;317;119;198
Kelmė d. mun.;2016;75;274;95;179
Kelmė d. mun.;2016;76;275;94;181
Kelmė d. mun.;2016;77;295;100;195
Kelmė d. mun.;2016;78;290;99;191
Kelmė d. mun.;2016;79;317;111;206
Kelmė d. mun.;2016;80;262;66;196
Kelmė d. mun.;2016;81;214;53;161
Kelmė d. mun.;2016;82;236;73;163
Kelmė d. mun.;2016;83;197;56;141
Kelmė d. mun.;2016;84;209;62;147
Kelmė d. mun.;2016;85;809;202;607
Kelmė d. mun.;2017;-1;27745;13250;14495
Kelmė d. mun.;2017;0;238;122;116
Kelmė d. mun.;2017;1;235;122;113
Kelmė d. mun.;2017;2;264;138;126
Kelmė d. mun.;2017;3;258;143;115
Kelmė d. mun.;2017;4;228;119;109
Kelmė d. mun.;2017;5;219;110;109
Kelmė d. mun.;2017;6;213;131;82
Kelmė d. mun.;2017;7;210;110;100
Kelmė d. mun.;2017;8;248;132;116
Kelmė d. mun.;2017;9;200;100;100
Kelmė d. mun.;2017;10;212;89;123
Kelmė d. mun.;2017;11;229;106;123
Kelmė d. mun.;2017;12;246;111;135
Kelmė d. mun.;2017;13;296;145;151
Kelmė d. mun.;2017;14;270;153;117
Kelmė d. mun.;2017;15;307;142;165
Kelmė d. mun.;2017;16;313;160;153
Kelmė d. mun.;2017;17;361;198;163
Kelmė d. mun.;2017;18;413;232;181
Kelmė d. mun.;2017;19;389;207;182
Kelmė d. mun.;2017;20;431;238;193
Kelmė d. mun.;2017;21;396;203;193
Kelmė d. mun.;2017;22;416;236;180
Kelmė d. mun.;2017;23;439;221;218
Kelmė d. mun.;2017;24;502;266;236
Kelmė d. mun.;2017;25;354;236;118
Kelmė d. mun.;2017;26;288;187;101
Kelmė d. mun.;2017;27;285;182;103
Kelmė d. mun.;2017;28;237;147;90
Kelmė d. mun.;2017;29;227;135;92
Kelmė d. mun.;2017;30;213;135;78
Kelmė d. mun.;2017;31;210;116;94
Kelmė d. mun.;2017;32;151;100;51
Kelmė d. mun.;2017;33;202;108;94
Kelmė d. mun.;2017;34;178;94;84
Kelmė d. mun.;2017;35;171;84;87
Kelmė d. mun.;2017;36;222;113;109
Kelmė d. mun.;2017;37;246;129;117
Kelmė d. mun.;2017;38;283;141;142
Kelmė d. mun.;2017;39;284;145;139
Kelmė d. mun.;2017;40;321;168;153
Kelmė d. mun.;2017;41;309;145;164
Kelmė d. mun.;2017;42;319;160;159
Kelmė d. mun.;2017;43;359;185;174
Kelmė d. mun.;2017;44;389;179;210
Kelmė d. mun.;2017;45;365;167;198
Kelmė d. mun.;2017;46;403;177;226
Kelmė d. mun.;2017;47;413;208;205
Kelmė d. mun.;2017;48;463;230;233
Kelmė d. mun.;2017;49;439;220;219
Kelmė d. mun.;2017;50;416;219;197
Kelmė d. mun.;2017;51;438;222;216
Kelmė d. mun.;2017;52;491;246;245
Kelmė d. mun.;2017;53;429;221;208
Kelmė d. mun.;2017;54;465;238;227
Kelmė d. mun.;2017;55;481;260;221
Kelmė d. mun.;2017;56;516;258;258
Kelmė d. mun.;2017;57;463;233;230
Kelmė d. mun.;2017;58;517;242;275
Kelmė d. mun.;2017;59;383;192;191
Kelmė d. mun.;2017;60;389;179;210
Kelmė d. mun.;2017;61;379;165;214
Kelmė d. mun.;2017;62;362;164;198
Kelmė d. mun.;2017;63;341;143;198
Kelmė d. mun.;2017;64;358;177;181
Kelmė d. mun.;2017;65;372;172;200
Kelmė d. mun.;2017;66;384;168;216
Kelmė d. mun.;2017;67;349;154;195
Kelmė d. mun.;2017;68;303;135;168
Kelmė d. mun.;2017;69;276;112;164
Kelmė d. mun.;2017;70;229;92;137
Kelmė d. mun.;2017;71;336;136;200
Kelmė d. mun.;2017;72;235;70;165
Kelmė d. mun.;2017;73;275;96;179
Kelmė d. mun.;2017;74;325;116;209
Kelmė d. mun.;2017;75;307;114;193
Kelmė d. mun.;2017;76;263;91;172
Kelmė d. mun.;2017;77;260;86;174
Kelmė d. mun.;2017;78;285;93;192
Kelmė d. mun.;2017;79;275;93;182
Kelmė d. mun.;2017;80;300;101;199
Kelmė d. mun.;2017;81;242;60;182
Kelmė d. mun.;2017;82;199;47;152
Kelmė d. mun.;2017;83;218;68;150
Kelmė d. mun.;2017;84;178;51;127
Kelmė d. mun.;2017;85;842;211;631
Kelmė d. mun.;2018;-1;26778;12817;13961
Kelmė d. mun.;2018;0;230;124;106
Kelmė d. mun.;2018;1;224;112;112
Kelmė d. mun.;2018;2;231;120;111
Kelmė d. mun.;2018;3;262;134;128
Kelmė d. mun.;2018;4;254;138;116
Kelmė d. mun.;2018;5;226;118;108
Kelmė d. mun.;2018;6;217;109;108
Kelmė d. mun.;2018;7;205;126;79
Kelmė d. mun.;2018;8;203;107;96
Kelmė d. mun.;2018;9;248;134;114
Kelmė d. mun.;2018;10;205;103;102
Kelmė d. mun.;2018;11;208;89;119
Kelmė d. mun.;2018;12;223;106;117
Kelmė d. mun.;2018;13;243;110;133
Kelmė d. mun.;2018;14;294;146;148
Kelmė d. mun.;2018;15;269;153;116
Kelmė d. mun.;2018;16;308;143;165
Kelmė d. mun.;2018;17;307;157;150
Kelmė d. mun.;2018;18;347;193;154
Kelmė d. mun.;2018;19;397;228;169
Kelmė d. mun.;2018;20;363;200;163
Kelmė d. mun.;2018;21;402;225;177
Kelmė d. mun.;2018;22;371;192;179
Kelmė d. mun.;2018;23;387;222;165
Kelmė d. mun.;2018;24;404;199;205
Kelmė d. mun.;2018;25;441;244;197
Kelmė d. mun.;2018;26;320;223;97
Kelmė d. mun.;2018;27;239;168;71
Kelmė d. mun.;2018;28;245;159;86
Kelmė d. mun.;2018;29;209;132;77
Kelmė d. mun.;2018;30;208;130;78
Kelmė d. mun.;2018;31;190;117;73
Kelmė d. mun.;2018;32;193;103;90
Kelmė d. mun.;2018;33;141;92;49
Kelmė d. mun.;2018;34;188;101;87
Kelmė d. mun.;2018;35;176;95;81
Kelmė d. mun.;2018;36;163;79;84
Kelmė d. mun.;2018;37;207;109;98
Kelmė d. mun.;2018;38;232;119;113
Kelmė d. mun.;2018;39;278;136;142
Kelmė d. mun.;2018;40;279;141;138
Kelmė d. mun.;2018;41;317;167;150
Kelmė d. mun.;2018;42;300;139;161
Kelmė d. mun.;2018;43;312;155;157
Kelmė d. mun.;2018;44;352;182;170
Kelmė d. mun.;2018;45;389;178;211
Kelmė d. mun.;2018;46;363;168;195
Kelmė d. mun.;2018;47;393;170;223
Kelmė d. mun.;2018;48;406;205;201
Kelmė d. mun.;2018;49;453;221;232
Kelmė d. mun.;2018;50;437;221;216
Kelmė d. mun.;2018;51;405;211;194
Kelmė d. mun.;2018;52;433;221;212
Kelmė d. mun.;2018;53;481;241;240
Kelmė d. mun.;2018;54;428;221;207
Kelmė d. mun.;2018;55;460;235;225
Kelmė d. mun.;2018;56;468;250;218
Kelmė d. mun.;2018;57;509;251;258
Kelmė d. mun.;2018;58;449;226;223
Kelmė d. mun.;2018;59;511;240;271
Kelmė d. mun.;2018;60;378;187;191
Kelmė d. mun.;2018;61;382;175;207
Kelmė d. mun.;2018;62;371;158;213
Kelmė d. mun.;2018;63;354;160;194
Kelmė d. mun.;2018;64;335;138;197
Kelmė d. mun.;2018;65;349;172;177
Kelmė d. mun.;2018;66;361;163;198
Kelmė d. mun.;2018;67;376;162;214
Kelmė d. mun.;2018;68;336;147;189
Kelmė d. mun.;2018;69;290;130;160
Kelmė d. mun.;2018;70;270;109;161
Kelmė d. mun.;2018;71;225;91;134
Kelmė d. mun.;2018;72;325;129;196
Kelmė d. mun.;2018;73;224;65;159
Kelmė d. mun.;2018;74;270;95;175
Kelmė d. mun.;2018;75;311;111;200
Kelmė d. mun.;2018;76;294;107;187
Kelmė d. mun.;2018;77;248;84;164
Kelmė d. mun.;2018;78;251;81;170
Kelmė d. mun.;2018;79;275;89;186
Kelmė d. mun.;2018;80;253;77;176
Kelmė d. mun.;2018;81;279;93;186
Kelmė d. mun.;2018;82;222;53;169
Kelmė d. mun.;2018;83;178;39;139
Kelmė d. mun.;2018;84;207;63;144
Kelmė d. mun.;2018;85;811;201;610
Klaipėda c. mun.;2001;-1;193220;89651;103569
Klaipėda c. mun.;2001;0;1693;863;830
Klaipėda c. mun.;2001;1;1682;873;809
Klaipėda c. mun.;2001;2;1752;896;856
Klaipėda c. mun.;2001;3;1730;871;859
Klaipėda c. mun.;2001;4;1785;942;843
Klaipėda c. mun.;2001;5;1865;932;933
Klaipėda c. mun.;2001;6;1889;965;924
Klaipėda c. mun.;2001;7;2209;1121;1088
Klaipėda c. mun.;2001;8;2558;1346;1212
Klaipėda c. mun.;2001;9;2701;1403;1298
Klaipėda c. mun.;2001;10;2795;1369;1426
Klaipėda c. mun.;2001;11;2723;1420;1303
Klaipėda c. mun.;2001;12;2866;1456;1410
Klaipėda c. mun.;2001;13;2907;1427;1480
Klaipėda c. mun.;2001;14;2994;1541;1453
Klaipėda c. mun.;2001;15;2948;1502;1446
Klaipėda c. mun.;2001;16;3024;1496;1528
Klaipėda c. mun.;2001;17;3077;1601;1476
Klaipėda c. mun.;2001;18;2952;1484;1468
Klaipėda c. mun.;2001;19;3153;1550;1603
Klaipėda c. mun.;2001;20;3180;1545;1635
Klaipėda c. mun.;2001;21;3031;1446;1585
Klaipėda c. mun.;2001;22;2925;1389;1536
Klaipėda c. mun.;2001;23;2889;1385;1504
Klaipėda c. mun.;2001;24;2818;1312;1506
Klaipėda c. mun.;2001;25;2766;1306;1460
Klaipėda c. mun.;2001;26;2801;1300;1501
Klaipėda c. mun.;2001;27;2848;1441;1407
Klaipėda c. mun.;2001;28;2905;1446;1459
Klaipėda c. mun.;2001;29;2931;1389;1542
Klaipėda c. mun.;2001;30;2861;1356;1505
Klaipėda c. mun.;2001;31;2932;1400;1532
Klaipėda c. mun.;2001;32;2935;1410;1525
Klaipėda c. mun.;2001;33;2934;1429;1505
Klaipėda c. mun.;2001;34;3026;1518;1508
Klaipėda c. mun.;2001;35;3030;1535;1495
Klaipėda c. mun.;2001;36;3205;1584;1621
Klaipėda c. mun.;2001;37;3227;1576;1651
Klaipėda c. mun.;2001;38;3526;1783;1743
Klaipėda c. mun.;2001;39;3445;1639;1806
Klaipėda c. mun.;2001;40;3385;1598;1787
Klaipėda c. mun.;2001;41;3491;1617;1874
Klaipėda c. mun.;2001;42;3186;1456;1730
Klaipėda c. mun.;2001;43;3094;1465;1629
Klaipėda c. mun.;2001;44;3103;1430;1673
Klaipėda c. mun.;2001;45;2902;1337;1565
Klaipėda c. mun.;2001;46;2665;1238;1427
Klaipėda c. mun.;2001;47;2567;1192;1375
Klaipėda c. mun.;2001;48;2650;1165;1485
Klaipėda c. mun.;2001;49;2581;1192;1389
Klaipėda c. mun.;2001;50;2542;1164;1378
Klaipėda c. mun.;2001;51;2567;1225;1342
Klaipėda c. mun.;2001;52;2223;992;1231
Klaipėda c. mun.;2001;53;2072;902;1170
Klaipėda c. mun.;2001;54;1893;856;1037
Klaipėda c. mun.;2001;55;1839;788;1051
Klaipėda c. mun.;2001;56;1635;694;941
Klaipėda c. mun.;2001;57;1814;772;1042
Klaipėda c. mun.;2001;58;2053;866;1187
Klaipėda c. mun.;2001;59;2157;902;1255
Klaipėda c. mun.;2001;60;2111;902;1209
Klaipėda c. mun.;2001;61;2323;1020;1303
Klaipėda c. mun.;2001;62;2243;973;1270
Klaipėda c. mun.;2001;63;2244;920;1324
Klaipėda c. mun.;2001;64;2074;891;1183
Klaipėda c. mun.;2001;65;1993;802;1191
Klaipėda c. mun.;2001;66;1678;651;1027
Klaipėda c. mun.;2001;67;1757;678;1079
Klaipėda c. mun.;2001;68;1709;669;1040
Klaipėda c. mun.;2001;69;1611;644;967
Klaipėda c. mun.;2001;70;1574;613;961
Klaipėda c. mun.;2001;71;1532;611;921
Klaipėda c. mun.;2001;72;1510;551;959
Klaipėda c. mun.;2001;73;1348;496;852
Klaipėda c. mun.;2001;74;1175;362;813
Klaipėda c. mun.;2001;75;1040;295;745
Klaipėda c. mun.;2001;76;890;256;634
Klaipėda c. mun.;2001;77;817;251;566
Klaipėda c. mun.;2001;78;652;168;484
Klaipėda c. mun.;2001;79;525;165;360
Klaipėda c. mun.;2001;80;413;124;289
Klaipėda c. mun.;2001;81;337;98;239
Klaipėda c. mun.;2001;82;247;61;186
Klaipėda c. mun.;2001;83;217;56;161
Klaipėda c. mun.;2001;84;192;57;135
Klaipėda c. mun.;2001;85;1071;239;832
Klaipėda c. mun.;2002;-1;190911;88541;102370
Klaipėda c. mun.;2002;0;1630;855;775
Klaipėda c. mun.;2002;1;1694;861;833
Klaipėda c. mun.;2002;2;1667;864;803
Klaipėda c. mun.;2002;3;1737;884;853
Klaipėda c. mun.;2002;4;1717;857;860
Klaipėda c. mun.;2002;5;1779;937;842
Klaipėda c. mun.;2002;6;1855;931;924
Klaipėda c. mun.;2002;7;1879;963;916
Klaipėda c. mun.;2002;8;2203;1117;1086
Klaipėda c. mun.;2002;9;2525;1324;1201
Klaipėda c. mun.;2002;10;2674;1391;1283
Klaipėda c. mun.;2002;11;2751;1348;1403
Klaipėda c. mun.;2002;12;2691;1401;1290
Klaipėda c. mun.;2002;13;2813;1427;1386
Klaipėda c. mun.;2002;14;2864;1398;1466
Klaipėda c. mun.;2002;15;2952;1511;1441
Klaipėda c. mun.;2002;16;2901;1483;1418
Klaipėda c. mun.;2002;17;2973;1466;1507
Klaipėda c. mun.;2002;18;3039;1573;1466
Klaipėda c. mun.;2002;19;2880;1436;1444
Klaipėda c. mun.;2002;20;3060;1500;1560
Klaipėda c. mun.;2002;21;3073;1475;1598
Klaipėda c. mun.;2002;22;2920;1397;1523
Klaipėda c. mun.;2002;23;2869;1355;1514
Klaipėda c. mun.;2002;24;2811;1350;1461
Klaipėda c. mun.;2002;25;2785;1314;1471
Klaipėda c. mun.;2002;26;2731;1289;1442
Klaipėda c. mun.;2002;27;2801;1306;1495
Klaipėda c. mun.;2002;28;2786;1394;1392
Klaipėda c. mun.;2002;29;2856;1419;1437
Klaipėda c. mun.;2002;30;2883;1374;1509
Klaipėda c. mun.;2002;31;2808;1330;1478
Klaipėda c. mun.;2002;32;2875;1371;1504
Klaipėda c. mun.;2002;33;2892;1390;1502
Klaipėda c. mun.;2002;34;2899;1413;1486
Klaipėda c. mun.;2002;35;2965;1476;1489
Klaipėda c. mun.;2002;36;2978;1503;1475
Klaipėda c. mun.;2002;37;3135;1540;1595
Klaipėda c. mun.;2002;38;3169;1541;1628
Klaipėda c. mun.;2002;39;3448;1737;1711
Klaipėda c. mun.;2002;40;3367;1598;1769
Klaipėda c. mun.;2002;41;3323;1558;1765
Klaipėda c. mun.;2002;42;3429;1584;1845
Klaipėda c. mun.;2002;43;3156;1446;1710
Klaipėda c. mun.;2002;44;3040;1437;1603
Klaipėda c. mun.;2002;45;3039;1403;1636
Klaipėda c. mun.;2002;46;2846;1308;1538
Klaipėda c. mun.;2002;47;2638;1228;1410
Klaipėda c. mun.;2002;48;2512;1166;1346
Klaipėda c. mun.;2002;49;2585;1133;1452
Klaipėda c. mun.;2002;50;2529;1158;1371
Klaipėda c. mun.;2002;51;2474;1131;1343
Klaipėda c. mun.;2002;52;2533;1202;1331
Klaipėda c. mun.;2002;53;2171;967;1204
Klaipėda c. mun.;2002;54;2023;886;1137
Klaipėda c. mun.;2002;55;1837;831;1006
Klaipėda c. mun.;2002;56;1786;761;1025
Klaipėda c. mun.;2002;57;1601;681;920
Klaipėda c. mun.;2002;58;1754;749;1005
Klaipėda c. mun.;2002;59;2011;845;1166
Klaipėda c. mun.;2002;60;2118;881;1237
Klaipėda c. mun.;2002;61;2074;876;1198
Klaipėda c. mun.;2002;62;2295;1012;1283
Klaipėda c. mun.;2002;63;2209;958;1251
Klaipėda c. mun.;2002;64;2213;906;1307
Klaipėda c. mun.;2002;65;2045;876;1169
Klaipėda c. mun.;2002;66;1948;775;1173
Klaipėda c. mun.;2002;67;1636;630;1006
Klaipėda c. mun.;2002;68;1710;656;1054
Klaipėda c. mun.;2002;69;1669;644;1025
Klaipėda c. mun.;2002;70;1584;628;956
Klaipėda c. mun.;2002;71;1532;584;948
Klaipėda c. mun.;2002;72;1491;587;904
Klaipėda c. mun.;2002;73;1461;523;938
Klaipėda c. mun.;2002;74;1302;475;827
Klaipėda c. mun.;2002;75;1134;351;783
Klaipėda c. mun.;2002;76;991;282;709
Klaipėda c. mun.;2002;77;838;239;599
Klaipėda c. mun.;2002;78;774;234;540
Klaipėda c. mun.;2002;79;619;160;459
Klaipėda c. mun.;2002;80;494;145;349
Klaipėda c. mun.;2002;81;368;106;262
Klaipėda c. mun.;2002;82;317;93;224
Klaipėda c. mun.;2002;83;216;50;166
Klaipėda c. mun.;2002;84;202;51;151
Klaipėda c. mun.;2002;85;1049;246;803
Klaipėda c. mun.;2003;-1;189526;87745;101781
Klaipėda c. mun.;2003;0;1511;763;748
Klaipėda c. mun.;2003;1;1621;848;773
Klaipėda c. mun.;2003;2;1674;848;826
Klaipėda c. mun.;2003;3;1646;851;795
Klaipėda c. mun.;2003;4;1717;872;845
Klaipėda c. mun.;2003;5;1696;844;852
Klaipėda c. mun.;2003;6;1764;927;837
Klaipėda c. mun.;2003;7;1836;920;916
Klaipėda c. mun.;2003;8;1866;957;909
Klaipėda c. mun.;2003;9;2185;1109;1076
Klaipėda c. mun.;2003;10;2496;1313;1183
Klaipėda c. mun.;2003;11;2657;1382;1275
Klaipėda c. mun.;2003;12;2699;1323;1376
Klaipėda c. mun.;2003;13;2643;1371;1272
Klaipėda c. mun.;2003;14;2764;1393;1371
Klaipėda c. mun.;2003;15;2818;1366;1452
Klaipėda c. mun.;2003;16;2906;1487;1419
Klaipėda c. mun.;2003;17;2838;1447;1391
Klaipėda c. mun.;2003;18;2925;1437;1488
Klaipėda c. mun.;2003;19;2983;1546;1437
Klaipėda c. mun.;2003;20;2821;1411;1410
Klaipėda c. mun.;2003;21;3006;1482;1524
Klaipėda c. mun.;2003;22;3015;1456;1559
Klaipėda c. mun.;2003;23;2879;1369;1510
Klaipėda c. mun.;2003;24;2858;1350;1508
Klaipėda c. mun.;2003;25;2820;1357;1463
Klaipėda c. mun.;2003;26;2796;1323;1473
Klaipėda c. mun.;2003;27;2752;1302;1450
Klaipėda c. mun.;2003;28;2803;1295;1508
Klaipėda c. mun.;2003;29;2792;1394;1398
Klaipėda c. mun.;2003;30;2848;1410;1438
Klaipėda c. mun.;2003;31;2890;1375;1515
Klaipėda c. mun.;2003;32;2796;1328;1468
Klaipėda c. mun.;2003;33;2858;1372;1486
Klaipėda c. mun.;2003;34;2846;1367;1479
Klaipėda c. mun.;2003;35;2862;1389;1473
Klaipėda c. mun.;2003;36;2931;1456;1475
Klaipėda c. mun.;2003;37;2935;1479;1456
Klaipėda c. mun.;2003;38;3087;1515;1572
Klaipėda c. mun.;2003;39;3132;1523;1609
Klaipėda c. mun.;2003;40;3415;1722;1693
Klaipėda c. mun.;2003;41;3331;1576;1755
Klaipėda c. mun.;2003;42;3275;1524;1751
Klaipėda c. mun.;2003;43;3402;1572;1830
Klaipėda c. mun.;2003;44;3145;1439;1706
Klaipėda c. mun.;2003;45;3013;1426;1587
Klaipėda c. mun.;2003;46;2990;1376;1614
Klaipėda c. mun.;2003;47;2804;1280;1524
Klaipėda c. mun.;2003;48;2611;1208;1403
Klaipėda c. mun.;2003;49;2473;1137;1336
Klaipėda c. mun.;2003;50;2559;1119;1440
Klaipėda c. mun.;2003;51;2487;1139;1348
Klaipėda c. mun.;2003;52;2429;1101;1328
Klaipėda c. mun.;2003;53;2511;1190;1321
Klaipėda c. mun.;2003;54;2135;940;1195
Klaipėda c. mun.;2003;55;1997;867;1130
Klaipėda c. mun.;2003;56;1801;810;991
Klaipėda c. mun.;2003;57;1758;745;1013
Klaipėda c. mun.;2003;58;1572;664;908
Klaipėda c. mun.;2003;59;1724;736;988
Klaipėda c. mun.;2003;60;1962;812;1150
Klaipėda c. mun.;2003;61;2073;854;1219
Klaipėda c. mun.;2003;62;2042;858;1184
Klaipėda c. mun.;2003;63;2258;987;1271
Klaipėda c. mun.;2003;64;2187;946;1241
Klaipėda c. mun.;2003;65;2186;886;1300
Klaipėda c. mun.;2003;66;2012;854;1158
Klaipėda c. mun.;2003;67;1913;747;1166
Klaipėda c. mun.;2003;68;1586;596;990
Klaipėda c. mun.;2003;69;1673;630;1043
Klaipėda c. mun.;2003;70;1637;625;1012
Klaipėda c. mun.;2003;71;1520;592;928
Klaipėda c. mun.;2003;72;1491;564;927
Klaipėda c. mun.;2003;73;1432;556;876
Klaipėda c. mun.;2003;74;1419;498;921
Klaipėda c. mun.;2003;75;1258;447;811
Klaipėda c. mun.;2003;76;1089;328;761
Klaipėda c. mun.;2003;77;952;267;685
Klaipėda c. mun.;2003;78;788;219;569
Klaipėda c. mun.;2003;79;730;215;515
Klaipėda c. mun.;2003;80;576;148;428
Klaipėda c. mun.;2003;81;455;133;322
Klaipėda c. mun.;2003;82;339;89;250
Klaipėda c. mun.;2003;83;284;82;202
Klaipėda c. mun.;2003;84;194;46;148
Klaipėda c. mun.;2003;85;1066;238;828
Klaipėda c. mun.;2004;-1;186811;86303;100508
Klaipėda c. mun.;2004;0;1468;765;703
Klaipėda c. mun.;2004;1;1486;750;736
Klaipėda c. mun.;2004;2;1605;841;764
Klaipėda c. mun.;2004;3;1651;835;816
Klaipėda c. mun.;2004;4;1638;842;796
Klaipėda c. mun.;2004;5;1698;865;833
Klaipėda c. mun.;2004;6;1684;838;846
Klaipėda c. mun.;2004;7;1741;916;825
Klaipėda c. mun.;2004;8;1823;917;906
Klaipėda c. mun.;2004;9;1842;942;900
Klaipėda c. mun.;2004;10;2172;1097;1075
Klaipėda c. mun.;2004;11;2453;1294;1159
Klaipėda c. mun.;2004;12;2607;1349;1258
Klaipėda c. mun.;2004;13;2638;1301;1337
Klaipėda c. mun.;2004;14;2563;1333;1230
Klaipėda c. mun.;2004;15;2700;1368;1332
Klaipėda c. mun.;2004;16;2758;1342;1416
Klaipėda c. mun.;2004;17;2858;1461;1397
Klaipėda c. mun.;2004;18;2776;1417;1359
Klaipėda c. mun.;2004;19;2860;1399;1461
Klaipėda c. mun.;2004;20;2911;1513;1398
Klaipėda c. mun.;2004;21;2741;1372;1369
Klaipėda c. mun.;2004;22;2928;1433;1495
Klaipėda c. mun.;2004;23;2949;1429;1520
Klaipėda c. mun.;2004;24;2808;1335;1473
Klaipėda c. mun.;2004;25;2865;1360;1505
Klaipėda c. mun.;2004;26;2796;1343;1453
Klaipėda c. mun.;2004;27;2813;1332;1481
Klaipėda c. mun.;2004;28;2742;1286;1456
Klaipėda c. mun.;2004;29;2805;1302;1503
Klaipėda c. mun.;2004;30;2771;1381;1390
Klaipėda c. mun.;2004;31;2823;1396;1427
Klaipėda c. mun.;2004;32;2834;1344;1490
Klaipėda c. mun.;2004;33;2753;1304;1449
Klaipėda c. mun.;2004;34;2803;1336;1467
Klaipėda c. mun.;2004;35;2801;1347;1454
Klaipėda c. mun.;2004;36;2811;1371;1440
Klaipėda c. mun.;2004;37;2884;1434;1450
Klaipėda c. mun.;2004;38;2858;1437;1421
Klaipėda c. mun.;2004;39;3012;1465;1547
Klaipėda c. mun.;2004;40;3065;1490;1575
Klaipėda c. mun.;2004;41;3361;1702;1659
Klaipėda c. mun.;2004;42;3277;1545;1732
Klaipėda c. mun.;2004;43;3214;1489;1725
Klaipėda c. mun.;2004;44;3312;1519;1793
Klaipėda c. mun.;2004;45;3091;1413;1678
Klaipėda c. mun.;2004;46;2951;1393;1558
Klaipėda c. mun.;2004;47;2915;1329;1586
Klaipėda c. mun.;2004;48;2736;1240;1496
Klaipėda c. mun.;2004;49;2547;1172;1375
Klaipėda c. mun.;2004;50;2419;1111;1308
Klaipėda c. mun.;2004;51;2497;1086;1411
Klaipėda c. mun.;2004;52;2417;1103;1314
Klaipėda c. mun.;2004;53;2373;1069;1304
Klaipėda c. mun.;2004;54;2462;1158;1304
Klaipėda c. mun.;2004;55;2073;906;1167
Klaipėda c. mun.;2004;56;1945;837;1108
Klaipėda c. mun.;2004;57;1752;779;973
Klaipėda c. mun.;2004;58;1701;711;990
Klaipėda c. mun.;2004;59;1525;636;889
Klaipėda c. mun.;2004;60;1675;712;963
Klaipėda c. mun.;2004;61;1919;797;1122
Klaipėda c. mun.;2004;62;2027;832;1195
Klaipėda c. mun.;2004;63;1994;826;1168
Klaipėda c. mun.;2004;64;2197;941;1256
Klaipėda c. mun.;2004;65;2137;911;1226
Klaipėda c. mun.;2004;66;2143;861;1282
Klaipėda c. mun.;2004;67;1960;821;1139
Klaipėda c. mun.;2004;68;1878;720;1158
Klaipėda c. mun.;2004;69;1549;568;981
Klaipėda c. mun.;2004;70;1612;591;1021
Klaipėda c. mun.;2004;71;1608;606;1002
Klaipėda c. mun.;2004;72;1459;561;898
Klaipėda c. mun.;2004;73;1441;536;905
Klaipėda c. mun.;2004;74;1361;512;849
Klaipėda c. mun.;2004;75;1362;463;899
Klaipėda c. mun.;2004;76;1191;415;776
Klaipėda c. mun.;2004;77;1038;303;735
Klaipėda c. mun.;2004;78;900;247;653
Klaipėda c. mun.;2004;79;741;198;543
Klaipėda c. mun.;2004;80;674;189;485
Klaipėda c. mun.;2004;81;539;133;406
Klaipėda c. mun.;2004;82;408;109;299
Klaipėda c. mun.;2004;83;305;81;224
Klaipėda c. mun.;2004;84;250;70;180
Klaipėda c. mun.;2004;85;1081;220;861
Klaipėda c. mun.;2005;-1;183627;84614;99013
Klaipėda c. mun.;2005;0;1541;785;756
Klaipėda c. mun.;2005;1;1458;756;702
Klaipėda c. mun.;2005;2;1459;739;720
Klaipėda c. mun.;2005;3;1573;822;751
Klaipėda c. mun.;2005;4;1618;821;797
Klaipėda c. mun.;2005;5;1614;828;786
Klaipėda c. mun.;2005;6;1677;851;826
Klaipėda c. mun.;2005;7;1669;833;836
Klaipėda c. mun.;2005;8;1732;905;827
Klaipėda c. mun.;2005;9;1809;913;896
Klaipėda c. mun.;2005;10;1825;935;890
Klaipėda c. mun.;2005;11;2151;1091;1060
Klaipėda c. mun.;2005;12;2398;1265;1133
Klaipėda c. mun.;2005;13;2581;1333;1248
Klaipėda c. mun.;2005;14;2584;1275;1309
Klaipėda c. mun.;2005;15;2504;1297;1207
Klaipėda c. mun.;2005;16;2634;1334;1300
Klaipėda c. mun.;2005;17;2703;1308;1395
Klaipėda c. mun.;2005;18;2793;1417;1376
Klaipėda c. mun.;2005;19;2690;1368;1322
Klaipėda c. mun.;2005;20;2769;1352;1417
Klaipėda c. mun.;2005;21;2827;1457;1370
Klaipėda c. mun.;2005;22;2647;1319;1328
Klaipėda c. mun.;2005;23;2817;1379;1438
Klaipėda c. mun.;2005;24;2869;1384;1485
Klaipėda c. mun.;2005;25;2742;1294;1448
Klaipėda c. mun.;2005;26;2839;1338;1501
Klaipėda c. mun.;2005;27;2777;1323;1454
Klaipėda c. mun.;2005;28;2798;1324;1474
Klaipėda c. mun.;2005;29;2712;1271;1441
Klaipėda c. mun.;2005;30;2794;1293;1501
Klaipėda c. mun.;2005;31;2746;1365;1381
Klaipėda c. mun.;2005;32;2772;1367;1405
Klaipėda c. mun.;2005;33;2810;1346;1464
Klaipėda c. mun.;2005;34;2711;1281;1430
Klaipėda c. mun.;2005;35;2730;1294;1436
Klaipėda c. mun.;2005;36;2740;1319;1421
Klaipėda c. mun.;2005;37;2760;1352;1408
Klaipėda c. mun.;2005;38;2830;1415;1415
Klaipėda c. mun.;2005;39;2795;1406;1389
Klaipėda c. mun.;2005;40;2929;1424;1505
Klaipėda c. mun.;2005;41;2982;1443;1539
Klaipėda c. mun.;2005;42;3289;1656;1633
Klaipėda c. mun.;2005;43;3209;1508;1701
Klaipėda c. mun.;2005;44;3148;1455;1693
Klaipėda c. mun.;2005;45;3231;1477;1754
Klaipėda c. mun.;2005;46;3030;1377;1653
Klaipėda c. mun.;2005;47;2874;1348;1526
Klaipėda c. mun.;2005;48;2832;1282;1550
Klaipėda c. mun.;2005;49;2701;1227;1474
Klaipėda c. mun.;2005;50;2485;1140;1345
Klaipėda c. mun.;2005;51;2348;1068;1280
Klaipėda c. mun.;2005;52;2446;1056;1390
Klaipėda c. mun.;2005;53;2363;1072;1291
Klaipėda c. mun.;2005;54;2321;1038;1283
Klaipėda c. mun.;2005;55;2399;1112;1287
Klaipėda c. mun.;2005;56;2034;878;1156
Klaipėda c. mun.;2005;57;1889;807;1082
Klaipėda c. mun.;2005;58;1700;746;954
Klaipėda c. mun.;2005;59;1666;694;972
Klaipėda c. mun.;2005;60;1483;611;872
Klaipėda c. mun.;2005;61;1625;682;943
Klaipėda c. mun.;2005;62;1855;763;1092
Klaipėda c. mun.;2005;63;1976;798;1178
Klaipėda c. mun.;2005;64;1939;795;1144
Klaipėda c. mun.;2005;65;2125;892;1233
Klaipėda c. mun.;2005;66;2069;876;1193
Klaipėda c. mun.;2005;67;2085;826;1259
Klaipėda c. mun.;2005;68;1888;777;1111
Klaipėda c. mun.;2005;69;1821;688;1133
Klaipėda c. mun.;2005;70;1486;528;958
Klaipėda c. mun.;2005;71;1554;566;988
Klaipėda c. mun.;2005;72;1540;572;968
Klaipėda c. mun.;2005;73;1393;527;866
Klaipėda c. mun.;2005;74;1375;500;875
Klaipėda c. mun.;2005;75;1296;483;813
Klaipėda c. mun.;2005;76;1271;413;858
Klaipėda c. mun.;2005;77;1122;384;738
Klaipėda c. mun.;2005;78;971;278;693
Klaipėda c. mun.;2005;79;842;228;614
Klaipėda c. mun.;2005;80;680;176;504
Klaipėda c. mun.;2005;81;618;168;450
Klaipėda c. mun.;2005;82;489;118;371
Klaipėda c. mun.;2005;83;359;93;266
Klaipėda c. mun.;2005;84;275;68;207
Klaipėda c. mun.;2005;85;1116;241;875
Klaipėda c. mun.;2006;-1;178380;82126;96254
Klaipėda c. mun.;2006;0;1505;802;703
Klaipėda c. mun.;2006;1;1513;767;746
Klaipėda c. mun.;2006;2;1418;737;681
Klaipėda c. mun.;2006;3;1419;720;699
Klaipėda c. mun.;2006;4;1520;791;729
Klaipėda c. mun.;2006;5;1576;801;775
Klaipėda c. mun.;2006;6;1579;813;766
Klaipėda c. mun.;2006;7;1634;834;800
Klaipėda c. mun.;2006;8;1626;811;815
Klaipėda c. mun.;2006;9;1709;893;816
Klaipėda c. mun.;2006;10;1780;895;885
Klaipėda c. mun.;2006;11;1794;918;876
Klaipėda c. mun.;2006;12;2107;1075;1032
Klaipėda c. mun.;2006;13;2325;1229;1096
Klaipėda c. mun.;2006;14;2488;1286;1202
Klaipėda c. mun.;2006;15;2477;1220;1257
Klaipėda c. mun.;2006;16;2392;1239;1153
Klaipėda c. mun.;2006;17;2540;1278;1262
Klaipėda c. mun.;2006;18;2607;1261;1346
Klaipėda c. mun.;2006;19;2639;1339;1300
Klaipėda c. mun.;2006;20;2548;1289;1259
Klaipėda c. mun.;2006;21;2601;1271;1330
Klaipėda c. mun.;2006;22;2657;1369;1288
Klaipėda c. mun.;2006;23;2521;1251;1270
Klaipėda c. mun.;2006;24;2683;1308;1375
Klaipėda c. mun.;2006;25;2702;1313;1389
Klaipėda c. mun.;2006;26;2654;1259;1395
Klaipėda c. mun.;2006;27;2757;1290;1467
Klaipėda c. mun.;2006;28;2709;1284;1425
Klaipėda c. mun.;2006;29;2762;1309;1453
Klaipėda c. mun.;2006;30;2653;1252;1401
Klaipėda c. mun.;2006;31;2729;1256;1473
Klaipėda c. mun.;2006;32;2661;1325;1336
Klaipėda c. mun.;2006;33;2692;1334;1358
Klaipėda c. mun.;2006;34;2691;1289;1402
Klaipėda c. mun.;2006;35;2621;1237;1384
Klaipėda c. mun.;2006;36;2626;1249;1377
Klaipėda c. mun.;2006;37;2634;1257;1377
Klaipėda c. mun.;2006;38;2641;1288;1353
Klaipėda c. mun.;2006;39;2753;1371;1382
Klaipėda c. mun.;2006;40;2700;1349;1351
Klaipėda c. mun.;2006;41;2845;1378;1467
Klaipėda c. mun.;2006;42;2879;1392;1487
Klaipėda c. mun.;2006;43;3182;1603;1579
Klaipėda c. mun.;2006;44;3112;1462;1650
Klaipėda c. mun.;2006;45;3062;1415;1647
Klaipėda c. mun.;2006;46;3125;1417;1708
Klaipėda c. mun.;2006;47;2952;1332;1620
Klaipėda c. mun.;2006;48;2809;1321;1488
Klaipėda c. mun.;2006;49;2739;1237;1502
Klaipėda c. mun.;2006;50;2610;1181;1429
Klaipėda c. mun.;2006;51;2400;1088;1312
Klaipėda c. mun.;2006;52;2275;1029;1246
Klaipėda c. mun.;2006;53;2370;1016;1354
Klaipėda c. mun.;2006;54;2293;1039;1254
Klaipėda c. mun.;2006;55;2230;995;1235
Klaipėda c. mun.;2006;56;2333;1075;1258
Klaipėda c. mun.;2006;57;1966;838;1128
Klaipėda c. mun.;2006;58;1826;771;1055
Klaipėda c. mun.;2006;59;1656;723;933
Klaipėda c. mun.;2006;60;1610;666;944
Klaipėda c. mun.;2006;61;1433;591;842
Klaipėda c. mun.;2006;62;1573;652;921
Klaipėda c. mun.;2006;63;1798;730;1068
Klaipėda c. mun.;2006;64;1902;760;1142
Klaipėda c. mun.;2006;65;1882;760;1122
Klaipėda c. mun.;2006;66;2054;854;1200
Klaipėda c. mun.;2006;67;2013;841;1172
Klaipėda c. mun.;2006;68;1999;790;1209
Klaipėda c. mun.;2006;69;1820;734;1086
Klaipėda c. mun.;2006;70;1764;657;1107
Klaipėda c. mun.;2006;71;1424;495;929
Klaipėda c. mun.;2006;72;1488;534;954
Klaipėda c. mun.;2006;73;1466;537;929
Klaipėda c. mun.;2006;74;1321;491;830
Klaipėda c. mun.;2006;75;1312;472;840
Klaipėda c. mun.;2006;76;1226;445;781
Klaipėda c. mun.;2006;77;1177;377;800
Klaipėda c. mun.;2006;78;1042;345;697
Klaipėda c. mun.;2006;79;890;253;637
Klaipėda c. mun.;2006;80;771;204;567
Klaipėda c. mun.;2006;81;622;157;465
Klaipėda c. mun.;2006;82;560;150;410
Klaipėda c. mun.;2006;83;432;100;332
Klaipėda c. mun.;2006;84;316;84;232
Klaipėda c. mun.;2006;85;1178;276;902
Klaipėda c. mun.;2007;-1;175389;80607;94782
Klaipėda c. mun.;2007;0;1640;851;789
Klaipėda c. mun.;2007;1;1484;791;693
Klaipėda c. mun.;2007;2;1473;750;723
Klaipėda c. mun.;2007;3;1396;733;663
Klaipėda c. mun.;2007;4;1397;714;683
Klaipėda c. mun.;2007;5;1497;781;716
Klaipėda c. mun.;2007;6;1564;796;768
Klaipėda c. mun.;2007;7;1570;805;765
Klaipėda c. mun.;2007;8;1613;830;783
Klaipėda c. mun.;2007;9;1609;805;804
Klaipėda c. mun.;2007;10;1680;884;796
Klaipėda c. mun.;2007;11;1755;884;871
Klaipėda c. mun.;2007;12;1764;905;859
Klaipėda c. mun.;2007;13;2068;1052;1016
Klaipėda c. mun.;2007;14;2274;1200;1074
Klaipėda c. mun.;2007;15;2443;1264;1179
Klaipėda c. mun.;2007;16;2422;1194;1228
Klaipėda c. mun.;2007;17;2356;1212;1144
Klaipėda c. mun.;2007;18;2506;1254;1252
Klaipėda c. mun.;2007;19;2548;1234;1314
Klaipėda c. mun.;2007;20;2552;1292;1260
Klaipėda c. mun.;2007;21;2471;1240;1231
Klaipėda c. mun.;2007;22;2538;1227;1311
Klaipėda c. mun.;2007;23;2596;1333;1263
Klaipėda c. mun.;2007;24;2477;1210;1267
Klaipėda c. mun.;2007;25;2600;1247;1353
Klaipėda c. mun.;2007;26;2649;1278;1371
Klaipėda c. mun.;2007;27;2639;1241;1398
Klaipėda c. mun.;2007;28;2735;1276;1459
Klaipėda c. mun.;2007;29;2688;1285;1403
Klaipėda c. mun.;2007;30;2732;1287;1445
Klaipėda c. mun.;2007;31;2636;1234;1402
Klaipėda c. mun.;2007;32;2696;1256;1440
Klaipėda c. mun.;2007;33;2638;1318;1320
Klaipėda c. mun.;2007;34;2631;1305;1326
Klaipėda c. mun.;2007;35;2632;1260;1372
Klaipėda c. mun.;2007;36;2565;1209;1356
Klaipėda c. mun.;2007;37;2568;1219;1349
Klaipėda c. mun.;2007;38;2584;1230;1354
Klaipėda c. mun.;2007;39;2583;1256;1327
Klaipėda c. mun.;2007;40;2682;1336;1346
Klaipėda c. mun.;2007;41;2628;1310;1318
Klaipėda c. mun.;2007;42;2791;1352;1439
Klaipėda c. mun.;2007;43;2820;1359;1461
Klaipėda c. mun.;2007;44;3104;1555;1549
Klaipėda c. mun.;2007;45;3034;1423;1611
Klaipėda c. mun.;2007;46;3007;1377;1630
Klaipėda c. mun.;2007;47;3056;1385;1671
Klaipėda c. mun.;2007;48;2893;1297;1596
Klaipėda c. mun.;2007;49;2748;1285;1463
Klaipėda c. mun.;2007;50;2658;1192;1466
Klaipėda c. mun.;2007;51;2539;1137;1402
Klaipėda c. mun.;2007;52;2342;1047;1295
Klaipėda c. mun.;2007;53;2211;991;1220
Klaipėda c. mun.;2007;54;2297;975;1322
Klaipėda c. mun.;2007;55;2237;1012;1225
Klaipėda c. mun.;2007;56;2176;966;1210
Klaipėda c. mun.;2007;57;2272;1039;1233
Klaipėda c. mun.;2007;58;1921;815;1106
Klaipėda c. mun.;2007;59;1784;752;1032
Klaipėda c. mun.;2007;60;1622;707;915
Klaipėda c. mun.;2007;61;1564;640;924
Klaipėda c. mun.;2007;62;1395;565;830
Klaipėda c. mun.;2007;63;1523;617;906
Klaipėda c. mun.;2007;64;1747;704;1043
Klaipėda c. mun.;2007;65;1858;737;1121
Klaipėda c. mun.;2007;66;1811;721;1090
Klaipėda c. mun.;2007;67;1994;818;1176
Klaipėda c. mun.;2007;68;1945;794;1151
Klaipėda c. mun.;2007;69;1926;743;1183
Klaipėda c. mun.;2007;70;1758;694;1064
Klaipėda c. mun.;2007;71;1681;622;1059
Klaipėda c. mun.;2007;72;1360;474;886
Klaipėda c. mun.;2007;73;1422;494;928
Klaipėda c. mun.;2007;74;1395;504;891
Klaipėda c. mun.;2007;75;1255;456;799
Klaipėda c. mun.;2007;76;1235;438;797
Klaipėda c. mun.;2007;77;1159;412;747
Klaipėda c. mun.;2007;78;1092;348;744
Klaipėda c. mun.;2007;79;962;307;655
Klaipėda c. mun.;2007;80;818;231;587
Klaipėda c. mun.;2007;81;711;189;522
Klaipėda c. mun.;2007;82;565;137;428
Klaipėda c. mun.;2007;83;504;129;375
Klaipėda c. mun.;2007;84;365;80;285
Klaipėda c. mun.;2007;85;1253;299;954
Klaipėda c. mun.;2008;-1;172686;79259;93427
Klaipėda c. mun.;2008;0;1670;878;792
Klaipėda c. mun.;2008;1;1614;836;778
Klaipėda c. mun.;2008;2;1456;777;679
Klaipėda c. mun.;2008;3;1454;738;716
Klaipėda c. mun.;2008;4;1364;720;644
Klaipėda c. mun.;2008;5;1383;710;673
Klaipėda c. mun.;2008;6;1478;772;706
Klaipėda c. mun.;2008;7;1553;791;762
Klaipėda c. mun.;2008;8;1541;788;753
Klaipėda c. mun.;2008;9;1567;804;763
Klaipėda c. mun.;2008;10;1576;786;790
Klaipėda c. mun.;2008;11;1653;866;787
Klaipėda c. mun.;2008;12;1723;870;853
Klaipėda c. mun.;2008;13;1742;892;850
Klaipėda c. mun.;2008;14;2043;1037;1006
Klaipėda c. mun.;2008;15;2233;1170;1063
Klaipėda c. mun.;2008;16;2391;1235;1156
Klaipėda c. mun.;2008;17;2379;1174;1205
Klaipėda c. mun.;2008;18;2316;1191;1125
Klaipėda c. mun.;2008;19;2459;1229;1230
Klaipėda c. mun.;2008;20;2507;1219;1288
Klaipėda c. mun.;2008;21;2505;1269;1236
Klaipėda c. mun.;2008;22;2426;1211;1215
Klaipėda c. mun.;2008;23;2499;1212;1287
Klaipėda c. mun.;2008;24;2542;1303;1239
Klaipėda c. mun.;2008;25;2441;1181;1260
Klaipėda c. mun.;2008;26;2588;1234;1354
Klaipėda c. mun.;2008;27;2625;1268;1357
Klaipėda c. mun.;2008;28;2619;1226;1393
Klaipėda c. mun.;2008;29;2699;1254;1445
Klaipėda c. mun.;2008;30;2657;1274;1383
Klaipėda c. mun.;2008;31;2712;1268;1444
Klaipėda c. mun.;2008;32;2616;1235;1381
Klaipėda c. mun.;2008;33;2663;1253;1410
Klaipėda c. mun.;2008;34;2587;1293;1294
Klaipėda c. mun.;2008;35;2589;1287;1302
Klaipėda c. mun.;2008;36;2577;1235;1342
Klaipėda c. mun.;2008;37;2518;1186;1332
Klaipėda c. mun.;2008;38;2507;1194;1313
Klaipėda c. mun.;2008;39;2538;1214;1324
Klaipėda c. mun.;2008;40;2516;1229;1287
Klaipėda c. mun.;2008;41;2614;1308;1306
Klaipėda c. mun.;2008;42;2578;1278;1300
Klaipėda c. mun.;2008;43;2708;1310;1398
Klaipėda c. mun.;2008;44;2758;1327;1431
Klaipėda c. mun.;2008;45;3000;1496;1504
Klaipėda c. mun.;2008;46;2951;1379;1572
Klaipėda c. mun.;2008;47;2942;1343;1599
Klaipėda c. mun.;2008;48;2991;1342;1649
Klaipėda c. mun.;2008;49;2821;1250;1571
Klaipėda c. mun.;2008;50;2670;1243;1427
Klaipėda c. mun.;2008;51;2600;1156;1444
Klaipėda c. mun.;2008;52;2482;1104;1378
Klaipėda c. mun.;2008;53;2291;1017;1274
Klaipėda c. mun.;2008;54;2158;957;1201
Klaipėda c. mun.;2008;55;2257;952;1305
Klaipėda c. mun.;2008;56;2179;976;1203
Klaipėda c. mun.;2008;57;2126;939;1187
Klaipėda c. mun.;2008;58;2229;1013;1216
Klaipėda c. mun.;2008;59;1861;779;1082
Klaipėda c. mun.;2008;60;1720;714;1006
Klaipėda c. mun.;2008;61;1563;667;896
Klaipėda c. mun.;2008;62;1531;619;912
Klaipėda c. mun.;2008;63;1357;540;817
Klaipėda c. mun.;2008;64;1483;591;892
Klaipėda c. mun.;2008;65;1695;676;1019
Klaipėda c. mun.;2008;66;1814;715;1099
Klaipėda c. mun.;2008;67;1760;703;1057
Klaipėda c. mun.;2008;68;1927;776;1151
Klaipėda c. mun.;2008;69;1877;756;1121
Klaipėda c. mun.;2008;70;1857;707;1150
Klaipėda c. mun.;2008;71;1691;657;1034
Klaipėda c. mun.;2008;72;1624;586;1038
Klaipėda c. mun.;2008;73;1308;449;859
Klaipėda c. mun.;2008;74;1367;465;902
Klaipėda c. mun.;2008;75;1325;470;855
Klaipėda c. mun.;2008;76;1185;424;761
Klaipėda c. mun.;2008;77;1157;404;753
Klaipėda c. mun.;2008;78;1087;375;712
Klaipėda c. mun.;2008;79;1011;303;708
Klaipėda c. mun.;2008;80;888;274;614
Klaipėda c. mun.;2008;81;741;203;538
Klaipėda c. mun.;2008;82;650;167;483
Klaipėda c. mun.;2008;83;508;119;389
Klaipėda c. mun.;2008;84;447;107;340
Klaipėda c. mun.;2008;85;1371;314;1057
Klaipėda c. mun.;2009;-1;170699;78207;92492
Klaipėda c. mun.;2009;0;1766;914;852
Klaipėda c. mun.;2009;1;1660;873;787
Klaipėda c. mun.;2009;2;1599;837;762
Klaipėda c. mun.;2009;3;1467;784;683
Klaipėda c. mun.;2009;4;1462;747;715
Klaipėda c. mun.;2009;5;1372;717;655
Klaipėda c. mun.;2009;6;1388;704;684
Klaipėda c. mun.;2009;7;1470;769;701
Klaipėda c. mun.;2009;8;1539;778;761
Klaipėda c. mun.;2009;9;1514;770;744
Klaipėda c. mun.;2009;10;1553;796;757
Klaipėda c. mun.;2009;11;1548;768;780
Klaipėda c. mun.;2009;12;1627;856;771
Klaipėda c. mun.;2009;13;1698;851;847
Klaipėda c. mun.;2009;14;1722;885;837
Klaipėda c. mun.;2009;15;2019;1028;991
Klaipėda c. mun.;2009;16;2208;1156;1052
Klaipėda c. mun.;2009;17;2386;1228;1158
Klaipėda c. mun.;2009;18;2353;1159;1194
Klaipėda c. mun.;2009;19;2297;1179;1118
Klaipėda c. mun.;2009;20;2414;1212;1202
Klaipėda c. mun.;2009;21;2423;1185;1238
Klaipėda c. mun.;2009;22;2441;1243;1198
Klaipėda c. mun.;2009;23;2397;1193;1204
Klaipėda c. mun.;2009;24;2482;1212;1270
Klaipėda c. mun.;2009;25;2523;1290;1233
Klaipėda c. mun.;2009;26;2380;1149;1231
Klaipėda c. mun.;2009;27;2577;1240;1337
Klaipėda c. mun.;2009;28;2618;1248;1370
Klaipėda c. mun.;2009;29;2630;1231;1399
Klaipėda c. mun.;2009;30;2681;1250;1431
Klaipėda c. mun.;2009;31;2654;1281;1373
Klaipėda c. mun.;2009;32;2674;1256;1418
Klaipėda c. mun.;2009;33;2590;1216;1374
Klaipėda c. mun.;2009;34;2626;1233;1393
Klaipėda c. mun.;2009;35;2514;1250;1264
Klaipėda c. mun.;2009;36;2522;1246;1276
Klaipėda c. mun.;2009;37;2522;1206;1316
Klaipėda c. mun.;2009;38;2453;1150;1303
Klaipėda c. mun.;2009;39;2460;1164;1296
Klaipėda c. mun.;2009;40;2496;1188;1308
Klaipėda c. mun.;2009;41;2457;1196;1261
Klaipėda c. mun.;2009;42;2577;1286;1291
Klaipėda c. mun.;2009;43;2538;1248;1290
Klaipėda c. mun.;2009;44;2652;1277;1375
Klaipėda c. mun.;2009;45;2692;1295;1397
Klaipėda c. mun.;2009;46;2952;1472;1480
Klaipėda c. mun.;2009;47;2906;1347;1559
Klaipėda c. mun.;2009;48;2902;1314;1588
Klaipėda c. mun.;2009;49;2935;1310;1625
Klaipėda c. mun.;2009;50;2767;1216;1551
Klaipėda c. mun.;2009;51;2624;1211;1413
Klaipėda c. mun.;2009;52;2538;1119;1419
Klaipėda c. mun.;2009;53;2414;1059;1355
Klaipėda c. mun.;2009;54;2236;984;1252
Klaipėda c. mun.;2009;55;2098;917;1181
Klaipėda c. mun.;2009;56;2219;931;1288
Klaipėda c. mun.;2009;57;2129;946;1183
Klaipėda c. mun.;2009;58;2070;897;1173
Klaipėda c. mun.;2009;59;2168;969;1199
Klaipėda c. mun.;2009;60;1808;744;1064
Klaipėda c. mun.;2009;61;1660;675;985
Klaipėda c. mun.;2009;62;1526;644;882
Klaipėda c. mun.;2009;63;1475;584;891
Klaipėda c. mun.;2009;64;1317;515;802
Klaipėda c. mun.;2009;65;1445;569;876
Klaipėda c. mun.;2009;66;1663;655;1008
Klaipėda c. mun.;2009;67;1764;687;1077
Klaipėda c. mun.;2009;68;1723;691;1032
Klaipėda c. mun.;2009;69;1864;737;1127
Klaipėda c. mun.;2009;70;1822;726;1096
Klaipėda c. mun.;2009;71;1796;669;1127
Klaipėda c. mun.;2009;72;1619;612;1007
Klaipėda c. mun.;2009;73;1545;545;1000
Klaipėda c. mun.;2009;74;1258;422;836
Klaipėda c. mun.;2009;75;1300;436;864
Klaipėda c. mun.;2009;76;1267;433;834
Klaipėda c. mun.;2009;77;1132;399;733
Klaipėda c. mun.;2009;78;1080;376;704
Klaipėda c. mun.;2009;79;1004;338;666
Klaipėda c. mun.;2009;80;937;276;661
Klaipėda c. mun.;2009;81;826;250;576
Klaipėda c. mun.;2009;82;679;179;500
Klaipėda c. mun.;2009;83;592;156;436
Klaipėda c. mun.;2009;84;472;110;362
Klaipėda c. mun.;2009;85;1526;343;1183
Klaipėda c. mun.;2010;-1;168134;76747;91387
Klaipėda c. mun.;2010;0;1920;1010;910
Klaipėda c. mun.;2010;1;1763;910;853
Klaipėda c. mun.;2010;2;1699;894;805
Klaipėda c. mun.;2010;3;1588;825;763
Klaipėda c. mun.;2010;4;1452;775;677
Klaipėda c. mun.;2010;5;1442;736;706
Klaipėda c. mun.;2010;6;1352;703;649
Klaipėda c. mun.;2010;7;1386;707;679
Klaipėda c. mun.;2010;8;1459;766;693
Klaipėda c. mun.;2010;9;1513;765;748
Klaipėda c. mun.;2010;10;1498;758;740
Klaipėda c. mun.;2010;11;1548;793;755
Klaipėda c. mun.;2010;12;1530;765;765
Klaipėda c. mun.;2010;13;1608;848;760
Klaipėda c. mun.;2010;14;1669;835;834
Klaipėda c. mun.;2010;15;1702;875;827
Klaipėda c. mun.;2010;16;1984;1010;974
Klaipėda c. mun.;2010;17;2179;1133;1046
Klaipėda c. mun.;2010;18;2354;1211;1143
Klaipėda c. mun.;2010;19;2301;1138;1163
Klaipėda c. mun.;2010;20;2245;1150;1095
Klaipėda c. mun.;2010;21;2338;1171;1167
Klaipėda c. mun.;2010;22;2360;1142;1218
Klaipėda c. mun.;2010;23;2374;1199;1175
Klaipėda c. mun.;2010;24;2356;1162;1194
Klaipėda c. mun.;2010;25;2434;1184;1250
Klaipėda c. mun.;2010;26;2437;1235;1202
Klaipėda c. mun.;2010;27;2335;1120;1215
Klaipėda c. mun.;2010;28;2535;1206;1329
Klaipėda c. mun.;2010;29;2579;1226;1353
Klaipėda c. mun.;2010;30;2617;1212;1405
Klaipėda c. mun.;2010;31;2619;1219;1400
Klaipėda c. mun.;2010;32;2613;1252;1361
Klaipėda c. mun.;2010;33;2609;1208;1401
Klaipėda c. mun.;2010;34;2530;1186;1344
Klaipėda c. mun.;2010;35;2546;1186;1360
Klaipėda c. mun.;2010;36;2435;1202;1233
Klaipėda c. mun.;2010;37;2443;1193;1250
Klaipėda c. mun.;2010;38;2446;1160;1286
Klaipėda c. mun.;2010;39;2389;1111;1278
Klaipėda c. mun.;2010;40;2410;1130;1280
Klaipėda c. mun.;2010;41;2443;1159;1284
Klaipėda c. mun.;2010;42;2412;1167;1245
Klaipėda c. mun.;2010;43;2507;1239;1268
Klaipėda c. mun.;2010;44;2473;1205;1268
Klaipėda c. mun.;2010;45;2588;1241;1347
Klaipėda c. mun.;2010;46;2613;1246;1367
Klaipėda c. mun.;2010;47;2869;1413;1456
Klaipėda c. mun.;2010;48;2858;1317;1541
Klaipėda c. mun.;2010;49;2836;1276;1560
Klaipėda c. mun.;2010;50;2876;1278;1598
Klaipėda c. mun.;2010;51;2694;1172;1522
Klaipėda c. mun.;2010;52;2557;1165;1392
Klaipėda c. mun.;2010;53;2472;1075;1397
Klaipėda c. mun.;2010;54;2360;1027;1333
Klaipėda c. mun.;2010;55;2174;943;1231
Klaipėda c. mun.;2010;56;2049;888;1161
Klaipėda c. mun.;2010;57;2155;887;1268
Klaipėda c. mun.;2010;58;2083;918;1165
Klaipėda c. mun.;2010;59;2014;861;1153
Klaipėda c. mun.;2010;60;2111;929;1182
Klaipėda c. mun.;2010;61;1766;725;1041
Klaipėda c. mun.;2010;62;1622;654;968
Klaipėda c. mun.;2010;63;1472;611;861
Klaipėda c. mun.;2010;64;1443;567;876
Klaipėda c. mun.;2010;65;1281;493;788
Klaipėda c. mun.;2010;66;1412;553;859
Klaipėda c. mun.;2010;67;1613;626;987
Klaipėda c. mun.;2010;68;1706;659;1047
Klaipėda c. mun.;2010;69;1668;665;1003
Klaipėda c. mun.;2010;70;1796;686;1110
Klaipėda c. mun.;2010;71;1737;680;1057
Klaipėda c. mun.;2010;72;1730;637;1093
Klaipėda c. mun.;2010;73;1569;592;977
Klaipėda c. mun.;2010;74;1479;512;967
Klaipėda c. mun.;2010;75;1203;394;809
Klaipėda c. mun.;2010;76;1241;407;834
Klaipėda c. mun.;2010;77;1205;409;796
Klaipėda c. mun.;2010;78;1071;372;699
Klaipėda c. mun.;2010;79;996;339;657
Klaipėda c. mun.;2010;80;938;311;627
Klaipėda c. mun.;2010;81;859;252;607
Klaipėda c. mun.;2010;82;758;224;534
Klaipėda c. mun.;2010;83;600;150;450
Klaipėda c. mun.;2010;84;526;132;394
Klaipėda c. mun.;2010;85;1702;380;1322
Klaipėda c. mun.;2011;-1;162898;74086;88812
Klaipėda c. mun.;2011;0;1901;941;960
Klaipėda c. mun.;2011;1;1997;1067;930
Klaipėda c. mun.;2011;2;1816;943;873
Klaipėda c. mun.;2011;3;1677;890;787
Klaipėda c. mun.;2011;4;1580;824;756
Klaipėda c. mun.;2011;5;1472;776;696
Klaipėda c. mun.;2011;6;1419;714;705
Klaipėda c. mun.;2011;7;1347;694;653
Klaipėda c. mun.;2011;8;1318;683;635
Klaipėda c. mun.;2011;9;1349;700;649
Klaipėda c. mun.;2011;10;1462;725;737
Klaipėda c. mun.;2011;11;1455;707;748
Klaipėda c. mun.;2011;12;1538;809;729
Klaipėda c. mun.;2011;13;1513;758;755
Klaipėda c. mun.;2011;14;1615;843;772
Klaipėda c. mun.;2011;15;1703;835;868
Klaipėda c. mun.;2011;16;1711;841;870
Klaipėda c. mun.;2011;17;1988;989;999
Klaipėda c. mun.;2011;18;2193;1104;1089
Klaipėda c. mun.;2011;19;2436;1154;1282
Klaipėda c. mun.;2011;20;2439;1118;1321
Klaipėda c. mun.;2011;21;2361;1146;1215
Klaipėda c. mun.;2011;22;2313;1143;1170
Klaipėda c. mun.;2011;23;2327;1072;1255
Klaipėda c. mun.;2011;24;2356;1131;1225
Klaipėda c. mun.;2011;25;2355;1158;1197
Klaipėda c. mun.;2011;26;2430;1198;1232
Klaipėda c. mun.;2011;27;2485;1233;1252
Klaipėda c. mun.;2011;28;2195;1096;1099
Klaipėda c. mun.;2011;29;2236;1144;1092
Klaipėda c. mun.;2011;30;2267;1133;1134
Klaipėda c. mun.;2011;31;2253;1122;1131
Klaipėda c. mun.;2011;32;2235;1107;1128
Klaipėda c. mun.;2011;33;2301;1132;1169
Klaipėda c. mun.;2011;34;2202;1077;1125
Klaipėda c. mun.;2011;35;2169;1078;1091
Klaipėda c. mun.;2011;36;2194;1035;1159
Klaipėda c. mun.;2011;37;2143;1071;1072
Klaipėda c. mun.;2011;38;2166;1041;1125
Klaipėda c. mun.;2011;39;2248;1057;1191
Klaipėda c. mun.;2011;40;2187;1004;1183
Klaipėda c. mun.;2011;41;2200;989;1211
Klaipėda c. mun.;2011;42;2115;953;1162
Klaipėda c. mun.;2011;43;2184;991;1193
Klaipėda c. mun.;2011;44;2268;1058;1210
Klaipėda c. mun.;2011;45;2197;1066;1131
Klaipėda c. mun.;2011;46;2345;1104;1241
Klaipėda c. mun.;2011;47;2372;1119;1253
Klaipėda c. mun.;2011;48;2669;1295;1374
Klaipėda c. mun.;2011;49;2674;1200;1474
Klaipėda c. mun.;2011;50;2747;1259;1488
Klaipėda c. mun.;2011;51;2726;1227;1499
Klaipėda c. mun.;2011;52;2661;1185;1476
Klaipėda c. mun.;2011;53;2541;1166;1375
Klaipėda c. mun.;2011;54;2318;1028;1290
Klaipėda c. mun.;2011;55;2281;1010;1271
Klaipėda c. mun.;2011;56;2196;951;1245
Klaipėda c. mun.;2011;57;1999;874;1125
Klaipėda c. mun.;2011;58;2046;855;1191
Klaipėda c. mun.;2011;59;1975;865;1110
Klaipėda c. mun.;2011;60;1952;846;1106
Klaipėda c. mun.;2011;61;2141;947;1194
Klaipėda c. mun.;2011;62;1771;725;1046
Klaipėda c. mun.;2011;63;1605;654;951
Klaipėda c. mun.;2011;64;1508;625;883
Klaipėda c. mun.;2011;65;1431;579;852
Klaipėda c. mun.;2011;66;1258;485;773
Klaipėda c. mun.;2011;67;1358;516;842
Klaipėda c. mun.;2011;68;1587;587;1000
Klaipėda c. mun.;2011;69;1663;608;1055
Klaipėda c. mun.;2011;70;1634;625;1009
Klaipėda c. mun.;2011;71;1772;657;1115
Klaipėda c. mun.;2011;72;1773;696;1077
Klaipėda c. mun.;2011;73;1742;630;1112
Klaipėda c. mun.;2011;74;1596;612;984
Klaipėda c. mun.;2011;75;1492;511;981
Klaipėda c. mun.;2011;76;1176;389;787
Klaipėda c. mun.;2011;77;1220;404;816
Klaipėda c. mun.;2011;78;1199;401;798
Klaipėda c. mun.;2011;79;1065;374;691
Klaipėda c. mun.;2011;80;1008;343;665
Klaipėda c. mun.;2011;81;915;300;615
Klaipėda c. mun.;2011;82;857;261;596
Klaipėda c. mun.;2011;83;731;215;516
Klaipėda c. mun.;2011;84;565;141;424
Klaipėda c. mun.;2011;85;2013;467;1546
Klaipėda c. mun.;2012;-1;160142;72654;87488
Klaipėda c. mun.;2012;0;1807;917;890
Klaipėda c. mun.;2012;1;1936;960;976
Klaipėda c. mun.;2012;2;2000;1062;938
Klaipėda c. mun.;2012;3;1822;946;876
Klaipėda c. mun.;2012;4;1648;876;772
Klaipėda c. mun.;2012;5;1554;809;745
Klaipėda c. mun.;2012;6;1458;777;681
Klaipėda c. mun.;2012;7;1394;696;698
Klaipėda c. mun.;2012;8;1321;679;642
Klaipėda c. mun.;2012;9;1299;670;629
Klaipėda c. mun.;2012;10;1335;687;648
Klaipėda c. mun.;2012;11;1434;710;724
Klaipėda c. mun.;2012;12;1426;686;740
Klaipėda c. mun.;2012;13;1519;809;710
Klaipėda c. mun.;2012;14;1483;750;733
Klaipėda c. mun.;2012;15;1587;827;760
Klaipėda c. mun.;2012;16;1682;816;866
Klaipėda c. mun.;2012;17;1679;818;861
Klaipėda c. mun.;2012;18;1941;969;972
Klaipėda c. mun.;2012;19;2114;1078;1036
Klaipėda c. mun.;2012;20;2368;1132;1236
Klaipėda c. mun.;2012;21;2360;1072;1288
Klaipėda c. mun.;2012;22;2289;1114;1175
Klaipėda c. mun.;2012;23;2212;1104;1108
Klaipėda c. mun.;2012;24;2272;1028;1244
Klaipėda c. mun.;2012;25;2298;1100;1198
Klaipėda c. mun.;2012;26;2293;1136;1157
Klaipėda c. mun.;2012;27;2387;1182;1205
Klaipėda c. mun.;2012;28;2451;1207;1244
Klaipėda c. mun.;2012;29;2151;1081;1070
Klaipėda c. mun.;2012;30;2172;1118;1054
Klaipėda c. mun.;2012;31;2178;1087;1091
Klaipėda c. mun.;2012;32;2190;1076;1114
Klaipėda c. mun.;2012;33;2171;1058;1113
Klaipėda c. mun.;2012;34;2233;1091;1142
Klaipėda c. mun.;2012;35;2156;1063;1093
Klaipėda c. mun.;2012;36;2103;1040;1063
Klaipėda c. mun.;2012;37;2147;1004;1143
Klaipėda c. mun.;2012;38;2062;1023;1039
Klaipėda c. mun.;2012;39;2091;999;1092
Klaipėda c. mun.;2012;40;2174;1019;1155
Klaipėda c. mun.;2012;41;2126;967;1159
Klaipėda c. mun.;2012;42;2139;961;1178
Klaipėda c. mun.;2012;43;2060;933;1127
Klaipėda c. mun.;2012;44;2127;955;1172
Klaipėda c. mun.;2012;45;2198;1025;1173
Klaipėda c. mun.;2012;46;2151;1037;1114
Klaipėda c. mun.;2012;47;2288;1070;1218
Klaipėda c. mun.;2012;48;2321;1086;1235
Klaipėda c. mun.;2012;49;2596;1249;1347
Klaipėda c. mun.;2012;50;2607;1158;1449
Klaipėda c. mun.;2012;51;2685;1220;1465
Klaipėda c. mun.;2012;52;2663;1185;1478
Klaipėda c. mun.;2012;53;2602;1158;1444
Klaipėda c. mun.;2012;54;2497;1147;1350
Klaipėda c. mun.;2012;55;2240;981;1259
Klaipėda c. mun.;2012;56;2244;982;1262
Klaipėda c. mun.;2012;57;2140;915;1225
Klaipėda c. mun.;2012;58;1957;851;1106
Klaipėda c. mun.;2012;59;2011;831;1180
Klaipėda c. mun.;2012;60;1931;842;1089
Klaipėda c. mun.;2012;61;1908;822;1086
Klaipėda c. mun.;2012;62;2094;921;1173
Klaipėda c. mun.;2012;63;1726;693;1033
Klaipėda c. mun.;2012;64;1558;623;935
Klaipėda c. mun.;2012;65;1457;590;867
Klaipėda c. mun.;2012;66;1398;557;841
Klaipėda c. mun.;2012;67;1228;463;765
Klaipėda c. mun.;2012;68;1321;492;829
Klaipėda c. mun.;2012;69;1545;564;981
Klaipėda c. mun.;2012;70;1620;583;1037
Klaipėda c. mun.;2012;71;1591;595;996
Klaipėda c. mun.;2012;72;1710;621;1089
Klaipėda c. mun.;2012;73;1714;663;1051
Klaipėda c. mun.;2012;74;1687;599;1088
Klaipėda c. mun.;2012;75;1535;577;958
Klaipėda c. mun.;2012;76;1431;479;952
Klaipėda c. mun.;2012;77;1118;362;756
Klaipėda c. mun.;2012;78;1171;388;783
Klaipėda c. mun.;2012;79;1134;370;764
Klaipėda c. mun.;2012;80;1001;354;647
Klaipėda c. mun.;2012;81;928;307;621
Klaipėda c. mun.;2012;82;834;266;568
Klaipėda c. mun.;2012;83;792;242;550
Klaipėda c. mun.;2012;84;654;185;469
Klaipėda c. mun.;2012;85;2207;509;1698
Klaipėda c. mun.;2013;-1;158541;71892;86649
Klaipėda c. mun.;2013;0;1851;950;901
Klaipėda c. mun.;2013;1;1872;956;916
Klaipėda c. mun.;2013;2;1953;974;979
Klaipėda c. mun.;2013;3;1978;1058;920
Klaipėda c. mun.;2013;4;1805;937;868
Klaipėda c. mun.;2013;5;1637;871;766
Klaipėda c. mun.;2013;6;1522;799;723
Klaipėda c. mun.;2013;7;1419;751;668
Klaipėda c. mun.;2013;8;1367;683;684
Klaipėda c. mun.;2013;9;1291;664;627
Klaipėda c. mun.;2013;10;1269;661;608
Klaipėda c. mun.;2013;11;1294;656;638
Klaipėda c. mun.;2013;12;1406;700;706
Klaipėda c. mun.;2013;13;1394;672;722
Klaipėda c. mun.;2013;14;1492;790;702
Klaipėda c. mun.;2013;15;1461;744;717
Klaipėda c. mun.;2013;16;1575;809;766
Klaipėda c. mun.;2013;17;1665;809;856
Klaipėda c. mun.;2013;18;1663;803;860
Klaipėda c. mun.;2013;19;1910;955;955
Klaipėda c. mun.;2013;20;2093;1069;1024
Klaipėda c. mun.;2013;21;2329;1114;1215
Klaipėda c. mun.;2013;22;2334;1063;1271
Klaipėda c. mun.;2013;23;2250;1096;1154
Klaipėda c. mun.;2013;24;2164;1073;1091
Klaipėda c. mun.;2013;25;2259;1012;1247
Klaipėda c. mun.;2013;26;2277;1066;1211
Klaipėda c. mun.;2013;27;2279;1112;1167
Klaipėda c. mun.;2013;28;2378;1179;1199
Klaipėda c. mun.;2013;29;2460;1211;1249
Klaipėda c. mun.;2013;30;2147;1099;1048
Klaipėda c. mun.;2013;31;2152;1116;1036
Klaipėda c. mun.;2013;32;2129;1076;1053
Klaipėda c. mun.;2013;33;2162;1061;1101
Klaipėda c. mun.;2013;34;2110;1035;1075
Klaipėda c. mun.;2013;35;2160;1049;1111
Klaipėda c. mun.;2013;36;2120;1060;1060
Klaipėda c. mun.;2013;37;2064;1023;1041
Klaipėda c. mun.;2013;38;2084;974;1110
Klaipėda c. mun.;2013;39;2023;1005;1018
Klaipėda c. mun.;2013;40;2075;994;1081
Klaipėda c. mun.;2013;41;2140;1006;1134
Klaipėda c. mun.;2013;42;2094;950;1144
Klaipėda c. mun.;2013;43;2097;935;1162
Klaipėda c. mun.;2013;44;2012;912;1100
Klaipėda c. mun.;2013;45;2083;939;1144
Klaipėda c. mun.;2013;46;2180;1021;1159
Klaipėda c. mun.;2013;47;2128;1024;1104
Klaipėda c. mun.;2013;48;2271;1057;1214
Klaipėda c. mun.;2013;49;2276;1054;1222
Klaipėda c. mun.;2013;50;2556;1223;1333
Klaipėda c. mun.;2013;51;2573;1137;1436
Klaipėda c. mun.;2013;52;2644;1205;1439
Klaipėda c. mun.;2013;53;2612;1158;1454
Klaipėda c. mun.;2013;54;2567;1136;1431
Klaipėda c. mun.;2013;55;2461;1126;1335
Klaipėda c. mun.;2013;56;2191;953;1238
Klaipėda c. mun.;2013;57;2192;951;1241
Klaipėda c. mun.;2013;58;2100;889;1211
Klaipėda c. mun.;2013;59;1905;819;1086
Klaipėda c. mun.;2013;60;1974;804;1170
Klaipėda c. mun.;2013;61;1903;818;1085
Klaipėda c. mun.;2013;62;1864;790;1074
Klaipėda c. mun.;2013;63;2035;889;1146
Klaipėda c. mun.;2013;64;1690;673;1017
Klaipėda c. mun.;2013;65;1524;595;929
Klaipėda c. mun.;2013;66;1425;567;858
Klaipėda c. mun.;2013;67;1363;540;823
Klaipėda c. mun.;2013;68;1195;448;747
Klaipėda c. mun.;2013;69;1285;465;820
Klaipėda c. mun.;2013;70;1489;526;963
Klaipėda c. mun.;2013;71;1574;554;1020
Klaipėda c. mun.;2013;72;1533;564;969
Klaipėda c. mun.;2013;73;1670;596;1074
Klaipėda c. mun.;2013;74;1644;615;1029
Klaipėda c. mun.;2013;75;1632;566;1066
Klaipėda c. mun.;2013;76;1476;545;931
Klaipėda c. mun.;2013;77;1360;449;911
Klaipėda c. mun.;2013;78;1077;350;727
Klaipėda c. mun.;2013;79;1100;353;747
Klaipėda c. mun.;2013;80;1061;337;724
Klaipėda c. mun.;2013;81;926;313;613
Klaipėda c. mun.;2013;82;859;278;581
Klaipėda c. mun.;2013;83;762;238;524
Klaipėda c. mun.;2013;84;736;221;515
Klaipėda c. mun.;2013;85;2429;574;1855
Klaipėda c. mun.;2014;-1;157305;71163;86142
Klaipėda c. mun.;2014;0;1770;872;898
Klaipėda c. mun.;2014;1;1900;977;923
Klaipėda c. mun.;2014;2;1891;954;937
Klaipėda c. mun.;2014;3;1931;958;973
Klaipėda c. mun.;2014;4;1946;1040;906
Klaipėda c. mun.;2014;5;1777;919;858
Klaipėda c. mun.;2014;6;1624;863;761
Klaipėda c. mun.;2014;7;1472;768;704
Klaipėda c. mun.;2014;8;1401;737;664
Klaipėda c. mun.;2014;9;1354;671;683
Klaipėda c. mun.;2014;10;1267;650;617
Klaipėda c. mun.;2014;11;1250;651;599
Klaipėda c. mun.;2014;12;1264;636;628
Klaipėda c. mun.;2014;13;1395;696;699
Klaipėda c. mun.;2014;14;1399;674;725
Klaipėda c. mun.;2014;15;1498;789;709
Klaipėda c. mun.;2014;16;1450;735;715
Klaipėda c. mun.;2014;17;1561;801;760
Klaipėda c. mun.;2014;18;1641;800;841
Klaipėda c. mun.;2014;19;1635;790;845
Klaipėda c. mun.;2014;20;1896;945;951
Klaipėda c. mun.;2014;21;2073;1060;1013
Klaipėda c. mun.;2014;22;2301;1103;1198
Klaipėda c. mun.;2014;23;2323;1060;1263
Klaipėda c. mun.;2014;24;2241;1096;1145
Klaipėda c. mun.;2014;25;2204;1081;1123
Klaipėda c. mun.;2014;26;2263;998;1265
Klaipėda c. mun.;2014;27;2285;1074;1211
Klaipėda c. mun.;2014;28;2324;1131;1193
Klaipėda c. mun.;2014;29;2398;1186;1212
Klaipėda c. mun.;2014;30;2469;1224;1245
Klaipėda c. mun.;2014;31;2144;1100;1044
Klaipėda c. mun.;2014;32;2099;1099;1000
Klaipėda c. mun.;2014;33;2094;1066;1028
Klaipėda c. mun.;2014;34;2116;1026;1090
Klaipėda c. mun.;2014;35;2060;1005;1055
Klaipėda c. mun.;2014;36;2106;1005;1101
Klaipėda c. mun.;2014;37;2091;1046;1045
Klaipėda c. mun.;2014;38;2051;1020;1031
Klaipėda c. mun.;2014;39;2061;970;1091
Klaipėda c. mun.;2014;40;2017;999;1018
Klaipėda c. mun.;2014;41;2054;984;1070
Klaipėda c. mun.;2014;42;2114;980;1134
Klaipėda c. mun.;2014;43;2065;939;1126
Klaipėda c. mun.;2014;44;2074;926;1148
Klaipėda c. mun.;2014;45;1957;878;1079
Klaipėda c. mun.;2014;46;2044;920;1124
Klaipėda c. mun.;2014;47;2153;1009;1144
Klaipėda c. mun.;2014;48;2093;1005;1088
Klaipėda c. mun.;2014;49;2227;1027;1200
Klaipėda c. mun.;2014;50;2231;1033;1198
Klaipėda c. mun.;2014;51;2492;1185;1307
Klaipėda c. mun.;2014;52;2539;1118;1421
Klaipėda c. mun.;2014;53;2600;1178;1422
Klaipėda c. mun.;2014;54;2565;1141;1424
Klaipėda c. mun.;2014;55;2521;1102;1419
Klaipėda c. mun.;2014;56;2426;1099;1327
Klaipėda c. mun.;2014;57;2149;923;1226
Klaipėda c. mun.;2014;58;2158;926;1232
Klaipėda c. mun.;2014;59;2054;866;1188
Klaipėda c. mun.;2014;60;1877;795;1082
Klaipėda c. mun.;2014;61;1949;787;1162
Klaipėda c. mun.;2014;62;1859;789;1070
Klaipėda c. mun.;2014;63;1818;755;1063
Klaipėda c. mun.;2014;64;1986;859;1127
Klaipėda c. mun.;2014;65;1645;648;997
Klaipėda c. mun.;2014;66;1491;580;911
Klaipėda c. mun.;2014;67;1378;546;832
Klaipėda c. mun.;2014;68;1337;522;815
Klaipėda c. mun.;2014;69;1154;428;726
Klaipėda c. mun.;2014;70;1237;443;794
Klaipėda c. mun.;2014;71;1447;496;951
Klaipėda c. mun.;2014;72;1537;532;1005
Klaipėda c. mun.;2014;73;1485;541;944
Klaipėda c. mun.;2014;74;1609;556;1053
Klaipėda c. mun.;2014;75;1565;572;993
Klaipėda c. mun.;2014;76;1569;531;1038
Klaipėda c. mun.;2014;77;1417;509;908
Klaipėda c. mun.;2014;78;1288;408;880
Klaipėda c. mun.;2014;79;1030;330;700
Klaipėda c. mun.;2014;80;1043;322;721
Klaipėda c. mun.;2014;81;985;309;676
Klaipėda c. mun.;2014;82;839;273;566
Klaipėda c. mun.;2014;83;782;246;536
Klaipėda c. mun.;2014;84;689;209;480
Klaipėda c. mun.;2014;85;2731;663;2068
Klaipėda c. mun.;2015;-1;156141;70563;85578
Klaipėda c. mun.;2015;0;1844;966;878
Klaipėda c. mun.;2015;1;1829;904;925
Klaipėda c. mun.;2015;2;1945;1000;945
Klaipėda c. mun.;2015;3;1881;953;928
Klaipėda c. mun.;2015;4;1923;944;979
Klaipėda c. mun.;2015;5;1903;1015;888
Klaipėda c. mun.;2015;6;1742;899;843
Klaipėda c. mun.;2015;7;1578;846;732
Klaipėda c. mun.;2015;8;1444;757;687
Klaipėda c. mun.;2015;9;1386;731;655
Klaipėda c. mun.;2015;10;1333;661;672
Klaipėda c. mun.;2015;11;1258;641;617
Klaipėda c. mun.;2015;12;1234;637;597
Klaipėda c. mun.;2015;13;1256;640;616
Klaipėda c. mun.;2015;14;1363;678;685
Klaipėda c. mun.;2015;15;1399;675;724
Klaipėda c. mun.;2015;16;1458;766;692
Klaipėda c. mun.;2015;17;1425;712;713
Klaipėda c. mun.;2015;18;1542;790;752
Klaipėda c. mun.;2015;19;1598;779;819
Klaipėda c. mun.;2015;20;1594;769;825
Klaipėda c. mun.;2015;21;1862;929;933
Klaipėda c. mun.;2015;22;2043;1039;1004
Klaipėda c. mun.;2015;23;2288;1088;1200
Klaipėda c. mun.;2015;24;2315;1052;1263
Klaipėda c. mun.;2015;25;2256;1093;1163
Klaipėda c. mun.;2015;26;2233;1094;1139
Klaipėda c. mun.;2015;27;2285;993;1292
Klaipėda c. mun.;2015;28;2335;1075;1260
Klaipėda c. mun.;2015;29;2319;1132;1187
Klaipėda c. mun.;2015;30;2404;1187;1217
Klaipėda c. mun.;2015;31;2477;1227;1250
Klaipėda c. mun.;2015;32;2135;1101;1034
Klaipėda c. mun.;2015;33;2053;1068;985
Klaipėda c. mun.;2015;34;2081;1062;1019
Klaipėda c. mun.;2015;35;2068;993;1075
Klaipėda c. mun.;2015;36;2039;1003;1036
Klaipėda c. mun.;2015;37;2070;992;1078
Klaipėda c. mun.;2015;38;2056;1031;1025
Klaipėda c. mun.;2015;39;2015;988;1027
Klaipėda c. mun.;2015;40;2034;953;1081
Klaipėda c. mun.;2015;41;2001;989;1012
Klaipėda c. mun.;2015;42;2010;963;1047
Klaipėda c. mun.;2015;43;2106;988;1118
Klaipėda c. mun.;2015;44;2028;923;1105
Klaipėda c. mun.;2015;45;2015;894;1121
Klaipėda c. mun.;2015;46;1922;868;1054
Klaipėda c. mun.;2015;47;2007;894;1113
Klaipėda c. mun.;2015;48;2132;1010;1122
Klaipėda c. mun.;2015;49;2070;1000;1070
Klaipėda c. mun.;2015;50;2214;1021;1193
Klaipėda c. mun.;2015;51;2204;1019;1185
Klaipėda c. mun.;2015;52;2438;1153;1285
Klaipėda c. mun.;2015;53;2487;1068;1419
Klaipėda c. mun.;2015;54;2552;1153;1399
Klaipėda c. mun.;2015;55;2489;1102;1387
Klaipėda c. mun.;2015;56;2470;1070;1400
Klaipėda c. mun.;2015;57;2386;1073;1313
Klaipėda c. mun.;2015;58;2124;906;1218
Klaipėda c. mun.;2015;59;2107;893;1214
Klaipėda c. mun.;2015;60;1999;833;1166
Klaipėda c. mun.;2015;61;1851;778;1073
Klaipėda c. mun.;2015;62;1923;771;1152
Klaipėda c. mun.;2015;63;1834;775;1059
Klaipėda c. mun.;2015;64;1769;719;1050
Klaipėda c. mun.;2015;65;1956;836;1120
Klaipėda c. mun.;2015;66;1613;626;987
Klaipėda c. mun.;2015;67;1448;550;898
Klaipėda c. mun.;2015;68;1339;519;820
Klaipėda c. mun.;2015;69;1299;499;800
Klaipėda c. mun.;2015;70;1115;404;711
Klaipėda c. mun.;2015;71;1202;422;780
Klaipėda c. mun.;2015;72;1404;472;932
Klaipėda c. mun.;2015;73;1494;506;988
Klaipėda c. mun.;2015;74;1444;510;934
Klaipėda c. mun.;2015;75;1554;527;1027
Klaipėda c. mun.;2015;76;1518;543;975
Klaipėda c. mun.;2015;77;1501;496;1005
Klaipėda c. mun.;2015;78;1336;461;875
Klaipėda c. mun.;2015;79;1221;381;840
Klaipėda c. mun.;2015;80;966;308;658
Klaipėda c. mun.;2015;81;984;299;685
Klaipėda c. mun.;2015;82;914;283;631
Klaipėda c. mun.;2015;83;789;254;535
Klaipėda c. mun.;2015;84;707;218;489
Klaipėda c. mun.;2015;85;2896;723;2173
Klaipėda c. mun.;2016;-1;154326;69453;84873
Klaipėda c. mun.;2016;0;1922;1012;910
Klaipėda c. mun.;2016;1;1868;978;890
Klaipėda c. mun.;2016;2;1840;915;925
Klaipėda c. mun.;2016;3;1924;991;933
Klaipėda c. mun.;2016;4;1878;955;923
Klaipėda c. mun.;2016;5;1914;939;975
Klaipėda c. mun.;2016;6;1907;1014;893
Klaipėda c. mun.;2016;7;1704;883;821
Klaipėda c. mun.;2016;8;1543;830;713
Klaipėda c. mun.;2016;9;1417;738;679
Klaipėda c. mun.;2016;10;1362;712;650
Klaipėda c. mun.;2016;11;1302;647;655
Klaipėda c. mun.;2016;12;1221;626;595
Klaipėda c. mun.;2016;13;1216;626;590
Klaipėda c. mun.;2016;14;1237;626;611
Klaipėda c. mun.;2016;15;1363;685;678
Klaipėda c. mun.;2016;16;1375;669;706
Klaipėda c. mun.;2016;17;1430;750;680
Klaipėda c. mun.;2016;18;1411;700;711
Klaipėda c. mun.;2016;19;1495;763;732
Klaipėda c. mun.;2016;20;1547;748;799
Klaipėda c. mun.;2016;21;1527;726;801
Klaipėda c. mun.;2016;22;1817;888;929
Klaipėda c. mun.;2016;23;1944;971;973
Klaipėda c. mun.;2016;24;2271;1058;1213
Klaipėda c. mun.;2016;25;2307;1024;1283
Klaipėda c. mun.;2016;26;2216;1059;1157
Klaipėda c. mun.;2016;27;2223;1080;1143
Klaipėda c. mun.;2016;28;2288;996;1292
Klaipėda c. mun.;2016;29;2319;1049;1270
Klaipėda c. mun.;2016;30;2305;1116;1189
Klaipėda c. mun.;2016;31;2409;1189;1220
Klaipėda c. mun.;2016;32;2449;1213;1236
Klaipėda c. mun.;2016;33;2115;1095;1020
Klaipėda c. mun.;2016;34;2025;1053;972
Klaipėda c. mun.;2016;35;2036;1021;1015
Klaipėda c. mun.;2016;36;2017;962;1055
Klaipėda c. mun.;2016;37;2002;972;1030
Klaipėda c. mun.;2016;38;2026;965;1061
Klaipėda c. mun.;2016;39;1992;989;1003
Klaipėda c. mun.;2016;40;1969;952;1017
Klaipėda c. mun.;2016;41;2025;953;1072
Klaipėda c. mun.;2016;42;1973;968;1005
Klaipėda c. mun.;2016;43;1950;930;1020
Klaipėda c. mun.;2016;44;2064;960;1104
Klaipėda c. mun.;2016;45;1969;886;1083
Klaipėda c. mun.;2016;46;1973;870;1103
Klaipėda c. mun.;2016;47;1871;835;1036
Klaipėda c. mun.;2016;48;1949;858;1091
Klaipėda c. mun.;2016;49;2075;981;1094
Klaipėda c. mun.;2016;50;2005;957;1048
Klaipėda c. mun.;2016;51;2175;991;1184
Klaipėda c. mun.;2016;52;2147;988;1159
Klaipėda c. mun.;2016;53;2406;1133;1273
Klaipėda c. mun.;2016;54;2446;1035;1411
Klaipėda c. mun.;2016;55;2497;1120;1377
Klaipėda c. mun.;2016;56;2433;1061;1372
Klaipėda c. mun.;2016;57;2441;1060;1381
Klaipėda c. mun.;2016;58;2348;1044;1304
Klaipėda c. mun.;2016;59;2097;884;1213
Klaipėda c. mun.;2016;60;2076;870;1206
Klaipėda c. mun.;2016;61;1977;809;1168
Klaipėda c. mun.;2016;62;1821;755;1066
Klaipėda c. mun.;2016;63;1898;758;1140
Klaipėda c. mun.;2016;64;1788;742;1046
Klaipėda c. mun.;2016;65;1726;688;1038
Klaipėda c. mun.;2016;66;1894;793;1101
Klaipėda c. mun.;2016;67;1567;597;970
Klaipėda c. mun.;2016;68;1408;523;885
Klaipėda c. mun.;2016;69;1303;494;809
Klaipėda c. mun.;2016;70;1251;469;782
Klaipėda c. mun.;2016;71;1087;388;699
Klaipėda c. mun.;2016;72;1167;407;760
Klaipėda c. mun.;2016;73;1356;444;912
Klaipėda c. mun.;2016;74;1444;482;962
Klaipėda c. mun.;2016;75;1387;476;911
Klaipėda c. mun.;2016;76;1493;497;996
Klaipėda c. mun.;2016;77;1432;498;934
Klaipėda c. mun.;2016;78;1430;470;960
Klaipėda c. mun.;2016;79;1269;421;848
Klaipėda c. mun.;2016;80;1153;349;804
Klaipėda c. mun.;2016;81;908;286;622
Klaipėda c. mun.;2016;82;920;270;650
Klaipėda c. mun.;2016;83;832;250;582
Klaipėda c. mun.;2016;84;700;224;476
Klaipėda c. mun.;2016;85;3062;794;2268
Klaipėda c. mun.;2017;-1;151309;67976;83333
Klaipėda c. mun.;2017;0;1818;967;851
Klaipėda c. mun.;2017;1;1927;1016;911
Klaipėda c. mun.;2017;2;1845;955;890
Klaipėda c. mun.;2017;3;1809;899;910
Klaipėda c. mun.;2017;4;1885;971;914
Klaipėda c. mun.;2017;5;1846;949;897
Klaipėda c. mun.;2017;6;1906;939;967
Klaipėda c. mun.;2017;7;1833;965;868
Klaipėda c. mun.;2017;8;1633;848;785
Klaipėda c. mun.;2017;9;1492;802;690
Klaipėda c. mun.;2017;10;1389;725;664
Klaipėda c. mun.;2017;11;1308;681;627
Klaipėda c. mun.;2017;12;1261;625;636
Klaipėda c. mun.;2017;13;1198;610;588
Klaipėda c. mun.;2017;14;1199;619;580
Klaipėda c. mun.;2017;15;1225;623;602
Klaipėda c. mun.;2017;16;1324;669;655
Klaipėda c. mun.;2017;17;1347;657;690
Klaipėda c. mun.;2017;18;1402;739;663
Klaipėda c. mun.;2017;19;1370;676;694
Klaipėda c. mun.;2017;20;1436;732;704
Klaipėda c. mun.;2017;21;1516;734;782
Klaipėda c. mun.;2017;22;1468;702;766
Klaipėda c. mun.;2017;23;1749;868;881
Klaipėda c. mun.;2017;24;1875;947;928
Klaipėda c. mun.;2017;25;2255;1050;1205
Klaipėda c. mun.;2017;26;2284;1023;1261
Klaipėda c. mun.;2017;27;2198;1053;1145
Klaipėda c. mun.;2017;28;2182;1056;1126
Klaipėda c. mun.;2017;29;2265;991;1274
Klaipėda c. mun.;2017;30;2253;1008;1245
Klaipėda c. mun.;2017;31;2259;1100;1159
Klaipėda c. mun.;2017;32;2354;1168;1186
Klaipėda c. mun.;2017;33;2348;1166;1182
Klaipėda c. mun.;2017;34;2075;1093;982
Klaipėda c. mun.;2017;35;1933;990;943
Klaipėda c. mun.;2017;36;1943;971;972
Klaipėda c. mun.;2017;37;1957;943;1014
Klaipėda c. mun.;2017;38;1946;939;1007
Klaipėda c. mun.;2017;39;1981;928;1053
Klaipėda c. mun.;2017;40;1944;968;976
Klaipėda c. mun.;2017;41;1907;922;985
Klaipėda c. mun.;2017;42;1959;922;1037
Klaipėda c. mun.;2017;43;1907;935;972
Klaipėda c. mun.;2017;44;1892;894;998
Klaipėda c. mun.;2017;45;1974;897;1077
Klaipėda c. mun.;2017;46;1917;861;1056
Klaipėda c. mun.;2017;47;1912;829;1083
Klaipėda c. mun.;2017;48;1805;796;1009
Klaipėda c. mun.;2017;49;1884;821;1063
Klaipėda c. mun.;2017;50;2017;946;1071
Klaipėda c. mun.;2017;51;1965;936;1029
Klaipėda c. mun.;2017;52;2105;945;1160
Klaipėda c. mun.;2017;53;2104;959;1145
Klaipėda c. mun.;2017;54;2337;1101;1236
Klaipėda c. mun.;2017;55;2376;989;1387
Klaipėda c. mun.;2017;56;2448;1083;1365
Klaipėda c. mun.;2017;57;2361;1018;1343
Klaipėda c. mun.;2017;58;2394;1038;1356
Klaipėda c. mun.;2017;59;2289;1010;1279
Klaipėda c. mun.;2017;60;2050;854;1196
Klaipėda c. mun.;2017;61;2036;845;1191
Klaipėda c. mun.;2017;62;1929;772;1157
Klaipėda c. mun.;2017;63;1783;734;1049
Klaipėda c. mun.;2017;64;1837;719;1118
Klaipėda c. mun.;2017;65;1732;709;1023
Klaipėda c. mun.;2017;66;1685;661;1024
Klaipėda c. mun.;2017;67;1857;768;1089
Klaipėda c. mun.;2017;68;1517;566;951
Klaipėda c. mun.;2017;69;1364;498;866
Klaipėda c. mun.;2017;70;1264;464;800
Klaipėda c. mun.;2017;71;1203;439;764
Klaipėda c. mun.;2017;72;1044;362;682
Klaipėda c. mun.;2017;73;1122;380;742
Klaipėda c. mun.;2017;74;1302;417;885
Klaipėda c. mun.;2017;75;1390;446;944
Klaipėda c. mun.;2017;76;1332;444;888
Klaipėda c. mun.;2017;77;1432;473;959
Klaipėda c. mun.;2017;78;1360;462;898
Klaipėda c. mun.;2017;79;1343;430;913
Klaipėda c. mun.;2017;80;1190;381;809
Klaipėda c. mun.;2017;81;1069;318;751
Klaipėda c. mun.;2017;82;841;257;584
Klaipėda c. mun.;2017;83;856;241;615
Klaipėda c. mun.;2017;84;755;219;536
Klaipėda c. mun.;2017;85;3225;850;2375
Klaipėda c. mun.;2018;-1;148908;66953;81955
Klaipėda c. mun.;2018;0;1745;927;818
Klaipėda c. mun.;2018;1;1895;1009;886
Klaipėda c. mun.;2018;2;1937;1023;914
Klaipėda c. mun.;2018;3;1806;929;877
Klaipėda c. mun.;2018;4;1730;851;879
Klaipėda c. mun.;2018;5;1812;939;873
Klaipėda c. mun.;2018;6;1841;958;883
Klaipėda c. mun.;2018;7;1832;910;922
Klaipėda c. mun.;2018;8;1755;919;836
Klaipėda c. mun.;2018;9;1583;827;756
Klaipėda c. mun.;2018;10;1464;777;687
Klaipėda c. mun.;2018;11;1346;709;637
Klaipėda c. mun.;2018;12;1270;661;609
Klaipėda c. mun.;2018;13;1238;615;623
Klaipėda c. mun.;2018;14;1183;600;583
Klaipėda c. mun.;2018;15;1175;603;572
Klaipėda c. mun.;2018;16;1185;595;590
Klaipėda c. mun.;2018;17;1296;656;640
Klaipėda c. mun.;2018;18;1320;642;678
Klaipėda c. mun.;2018;19;1338;710;628
Klaipėda c. mun.;2018;20;1328;651;677
Klaipėda c. mun.;2018;21;1413;711;702
Klaipėda c. mun.;2018;22;1482;719;763
Klaipėda c. mun.;2018;23;1435;687;748
Klaipėda c. mun.;2018;24;1708;834;874
Klaipėda c. mun.;2018;25;1847;931;916
Klaipėda c. mun.;2018;26;2188;1005;1183
Klaipėda c. mun.;2018;27;2259;1009;1250
Klaipėda c. mun.;2018;28;2187;1075;1112
Klaipėda c. mun.;2018;29;2153;1051;1102
Klaipėda c. mun.;2018;30;2227;966;1261
Klaipėda c. mun.;2018;31;2256;1017;1239
Klaipėda c. mun.;2018;32;2222;1083;1139
Klaipėda c. mun.;2018;33;2289;1153;1136
Klaipėda c. mun.;2018;34;2288;1142;1146
Klaipėda c. mun.;2018;35;2048;1065;983
Klaipėda c. mun.;2018;36;1890;974;916
Klaipėda c. mun.;2018;37;1900;961;939
Klaipėda c. mun.;2018;38;1927;930;997
Klaipėda c. mun.;2018;39;1896;929;967
Klaipėda c. mun.;2018;40;1924;913;1011
Klaipėda c. mun.;2018;41;1900;937;963
Klaipėda c. mun.;2018;42;1871;914;957
Klaipėda c. mun.;2018;43;1907;893;1014
Klaipėda c. mun.;2018;44;1857;910;947
Klaipėda c. mun.;2018;45;1847;871;976
Klaipėda c. mun.;2018;46;1912;870;1042
Klaipėda c. mun.;2018;47;1883;841;1042
Klaipėda c. mun.;2018;48;1859;812;1047
Klaipėda c. mun.;2018;49;1766;773;993
Klaipėda c. mun.;2018;50;1861;812;1049
Klaipėda c. mun.;2018;51;1954;914;1040
Klaipėda c. mun.;2018;52;1910;900;1010
Klaipėda c. mun.;2018;53;2055;915;1140
Klaipėda c. mun.;2018;54;2080;942;1138
Klaipėda c. mun.;2018;55;2292;1071;1221
Klaipėda c. mun.;2018;56;2337;969;1368
Klaipėda c. mun.;2018;57;2403;1060;1343
Klaipėda c. mun.;2018;58;2308;986;1322
Klaipėda c. mun.;2018;59;2349;1005;1344
Klaipėda c. mun.;2018;60;2255;984;1271
Klaipėda c. mun.;2018;61;2015;836;1179
Klaipėda c. mun.;2018;62;2000;823;1177
Klaipėda c. mun.;2018;63;1877;732;1145
Klaipėda c. mun.;2018;64;1735;701;1034
Klaipėda c. mun.;2018;65;1792;691;1101
Klaipėda c. mun.;2018;66;1684;680;1004
Klaipėda c. mun.;2018;67;1642;634;1008
Klaipėda c. mun.;2018;68;1804;742;1062
Klaipėda c. mun.;2018;69;1462;539;923
Klaipėda c. mun.;2018;70;1320;473;847
Klaipėda c. mun.;2018;71;1224;447;777
Klaipėda c. mun.;2018;72;1173;423;750
Klaipėda c. mun.;2018;73;1007;344;663
Klaipėda c. mun.;2018;74;1082;358;724
Klaipėda c. mun.;2018;75;1255;397;858
Klaipėda c. mun.;2018;76;1324;413;911
Klaipėda c. mun.;2018;77;1264;409;855
Klaipėda c. mun.;2018;78;1376;453;923
Klaipėda c. mun.;2018;79;1278;422;856
Klaipėda c. mun.;2018;80;1272;398;874
Klaipėda c. mun.;2018;81;1123;348;775
Klaipėda c. mun.;2018;82;996;286;710
Klaipėda c. mun.;2018;83;776;233;543
Klaipėda c. mun.;2018;84;781;209;572
Klaipėda c. mun.;2018;85;3422;917;2505
Klaipėda county;2001;-1;386129;181988;204141
Klaipėda county;2001;0;3760;1957;1803
Klaipėda county;2001;1;3964;2044;1920
Klaipėda county;2001;2;3987;2054;1933
Klaipėda county;2001;3;4052;2049;2003
Klaipėda county;2001;4;4244;2140;2104
Klaipėda county;2001;5;4349;2260;2089
Klaipėda county;2001;6;4500;2346;2154
Klaipėda county;2001;7;5130;2604;2526
Klaipėda county;2001;8;5869;3052;2817
Klaipėda county;2001;9;6109;3169;2940
Klaipėda county;2001;10;6360;3147;3213
Klaipėda county;2001;11;6119;3143;2976
Klaipėda county;2001;12;6204;3143;3061
Klaipėda county;2001;13;6426;3249;3177
Klaipėda county;2001;14;6625;3406;3219
Klaipėda county;2001;15;6400;3258;3142
Klaipėda county;2001;16;6322;3213;3109
Klaipėda county;2001;17;6290;3201;3089
Klaipėda county;2001;18;5704;2932;2772
Klaipėda county;2001;19;5506;2833;2673
Klaipėda county;2001;20;5461;2780;2681
Klaipėda county;2001;21;5299;2629;2670
Klaipėda county;2001;22;5201;2593;2608
Klaipėda county;2001;23;5240;2623;2617
Klaipėda county;2001;24;5215;2550;2665
Klaipėda county;2001;25;5102;2492;2610
Klaipėda county;2001;26;5137;2506;2631
Klaipėda county;2001;27;5394;2722;2672
Klaipėda county;2001;28;5514;2744;2770
Klaipėda county;2001;29;5745;2793;2952
Klaipėda county;2001;30;5596;2691;2905
Klaipėda county;2001;31;5708;2758;2950
Klaipėda county;2001;32;5705;2810;2895
Klaipėda county;2001;33;5656;2804;2852
Klaipėda county;2001;34;5834;2895;2939
Klaipėda county;2001;35;5918;3030;2888
Klaipėda county;2001;36;6112;3046;3066
Klaipėda county;2001;37;6199;3076;3123
Klaipėda county;2001;38;6479;3273;3206
Klaipėda county;2001;39;6604;3209;3395
Klaipėda county;2001;40;6353;3047;3306
Klaipėda county;2001;41;6516;3082;3434
Klaipėda county;2001;42;6037;2870;3167
Klaipėda county;2001;43;5899;2836;3063
Klaipėda county;2001;44;5584;2642;2942
Klaipėda county;2001;45;5347;2575;2772
Klaipėda county;2001;46;5014;2389;2625
Klaipėda county;2001;47;4747;2248;2499
Klaipėda county;2001;48;4831;2252;2579
Klaipėda county;2001;49;4710;2240;2470
Klaipėda county;2001;50;4743;2202;2541
Klaipėda county;2001;51;4749;2297;2452
Klaipėda county;2001;52;4303;1959;2344
Klaipėda county;2001;53;3857;1702;2155
Klaipėda county;2001;54;3606;1630;1976
Klaipėda county;2001;55;3663;1631;2032
Klaipėda county;2001;56;3323;1443;1880
Klaipėda county;2001;57;3663;1604;2059
Klaipėda county;2001;58;4050;1749;2301
Klaipėda county;2001;59;4290;1839;2451
Klaipėda county;2001;60;4098;1777;2321
Klaipėda county;2001;61;4287;1864;2423
Klaipėda county;2001;62;4233;1860;2373
Klaipėda county;2001;63;4172;1733;2439
Klaipėda county;2001;64;4100;1724;2376
Klaipėda county;2001;65;4055;1661;2394
Klaipėda county;2001;66;3498;1410;2088
Klaipėda county;2001;67;3612;1418;2194
Klaipėda county;2001;68;3516;1401;2115
Klaipėda county;2001;69;3423;1352;2071
Klaipėda county;2001;70;3326;1308;2018
Klaipėda county;2001;71;3015;1180;1835
Klaipėda county;2001;72;3170;1124;2046
Klaipėda county;2001;73;2801;1036;1765
Klaipėda county;2001;74;2545;851;1694
Klaipėda county;2001;75;2297;716;1581
Klaipėda county;2001;76;1983;609;1374
Klaipėda county;2001;77;1941;633;1308
Klaipėda county;2001;78;1618;481;1137
Klaipėda county;2001;79;1357;433;924
Klaipėda county;2001;80;1088;324;764
Klaipėda county;2001;81;898;264;634
Klaipėda county;2001;82;599;168;431
Klaipėda county;2001;83;545;169;376
Klaipėda county;2001;84;516;166;350
Klaipėda county;2001;85;3112;865;2247
Klaipėda county;2002;-1;382076;179716;202360
Klaipėda county;2002;0;3487;1744;1743
Klaipėda county;2002;1;3738;1944;1794
Klaipėda county;2002;2;3924;2024;1900
Klaipėda county;2002;3;3950;2032;1918
Klaipėda county;2002;4;4023;2029;1994
Klaipėda county;2002;5;4225;2129;2096
Klaipėda county;2002;6;4331;2250;2081
Klaipėda county;2002;7;4475;2336;2139
Klaipėda county;2002;8;5107;2587;2520
Klaipėda county;2002;9;5812;3006;2806
Klaipėda county;2002;10;6067;3144;2923
Klaipėda county;2002;11;6283;3101;3182
Klaipėda county;2002;12;6047;3101;2946
Klaipėda county;2002;13;6089;3075;3014
Klaipėda county;2002;14;6338;3195;3143
Klaipėda county;2002;15;6527;3331;3196
Klaipėda county;2002;16;6311;3209;3102
Klaipėda county;2002;17;6217;3147;3070
Klaipėda county;2002;18;6185;3139;3046
Klaipėda county;2002;19;5563;2854;2709
Klaipėda county;2002;20;5363;2745;2618
Klaipėda county;2002;21;5306;2691;2615
Klaipėda county;2002;22;5150;2550;2600
Klaipėda county;2002;23;5110;2535;2575
Klaipėda county;2002;24;5109;2554;2555
Klaipėda county;2002;25;5135;2525;2610
Klaipėda county;2002;26;5022;2449;2573
Klaipėda county;2002;27;5091;2474;2617
Klaipėda county;2002;28;5290;2649;2641
Klaipėda county;2002;29;5403;2679;2724
Klaipėda county;2002;30;5630;2745;2885
Klaipėda county;2002;31;5489;2633;2856
Klaipėda county;2002;32;5598;2698;2900
Klaipėda county;2002;33;5624;2767;2857
Klaipėda county;2002;34;5580;2755;2825
Klaipėda county;2002;35;5730;2825;2905
Klaipėda county;2002;36;5823;2971;2852
Klaipėda county;2002;37;6000;2978;3022
Klaipėda county;2002;38;6084;3002;3082
Klaipėda county;2002;39;6348;3188;3160
Klaipėda county;2002;40;6467;3127;3340
Klaipėda county;2002;41;6251;2988;3263
Klaipėda county;2002;42;6418;3026;3392
Klaipėda county;2002;43;5978;2841;3137
Klaipėda county;2002;44;5820;2794;3026
Klaipėda county;2002;45;5466;2579;2887
Klaipėda county;2002;46;5262;2535;2727
Klaipėda county;2002;47;4977;2377;2600
Klaipėda county;2002;48;4647;2198;2449
Klaipėda county;2002;49;4715;2186;2529
Klaipėda county;2002;50;4629;2181;2448
Klaipėda county;2002;51;4619;2138;2481
Klaipėda county;2002;52;4697;2260;2437
Klaipėda county;2002;53;4230;1928;2302
Klaipėda county;2002;54;3767;1662;2105
Klaipėda county;2002;55;3517;1584;1933
Klaipėda county;2002;56;3564;1578;1986
Klaipėda county;2002;57;3254;1415;1839
Klaipėda county;2002;58;3553;1552;2001
Klaipėda county;2002;59;3947;1692;2255
Klaipėda county;2002;60;4223;1798;2425
Klaipėda county;2002;61;4048;1746;2302
Klaipėda county;2002;62;4250;1845;2405
Klaipėda county;2002;63;4179;1822;2357
Klaipėda county;2002;64;4127;1705;2422
Klaipėda county;2002;65;4054;1693;2361
Klaipėda county;2002;66;3966;1601;2365
Klaipėda county;2002;67;3398;1353;2045
Klaipėda county;2002;68;3537;1372;2165
Klaipėda county;2002;69;3449;1356;2093
Klaipėda county;2002;70;3364;1318;2046
Klaipėda county;2002;71;3252;1259;1993
Klaipėda county;2002;72;2950;1137;1813
Klaipėda county;2002;73;3089;1080;2009
Klaipėda county;2002;74;2716;992;1724
Klaipėda county;2002;75;2473;821;1652
Klaipėda county;2002;76;2194;681;1513
Klaipėda county;2002;77;1885;570;1315
Klaipėda county;2002;78;1862;602;1260
Klaipėda county;2002;79;1541;458;1083
Klaipėda county;2002;80;1285;395;890
Klaipėda county;2002;81;994;295;699
Klaipėda county;2002;82;823;235;588
Klaipėda county;2002;83;537;149;388
Klaipėda county;2002;84;493;150;343
Klaipėda county;2002;85;3025;852;2173
Klaipėda county;2003;-1;379878;178473;201405
Klaipėda county;2003;0;3279;1709;1570
Klaipėda county;2003;1;3462;1732;1730
Klaipėda county;2003;2;3713;1928;1785
Klaipėda county;2003;3;3903;2011;1892
Klaipėda county;2003;4;3921;2015;1906
Klaipėda county;2003;5;3996;2013;1983
Klaipėda county;2003;6;4207;2116;2091
Klaipėda county;2003;7;4301;2236;2065
Klaipėda county;2003;8;4455;2330;2125
Klaipėda county;2003;9;5099;2584;2515
Klaipėda county;2003;10;5771;2992;2779
Klaipėda county;2003;11;6035;3131;2904
Klaipėda county;2003;12;6201;3061;3140
Klaipėda county;2003;13;5946;3040;2906
Klaipėda county;2003;14;6001;3021;2980
Klaipėda county;2003;15;6238;3132;3106
Klaipėda county;2003;16;6421;3281;3140
Klaipėda county;2003;17;6204;3145;3059
Klaipėda county;2003;18;6141;3103;3038
Klaipėda county;2003;19;6100;3090;3010
Klaipėda county;2003;20;5479;2812;2667
Klaipėda county;2003;21;5296;2731;2565
Klaipėda county;2003;22;5234;2669;2565
Klaipėda county;2003;23;5105;2527;2578
Klaipėda county;2003;24;5099;2526;2573
Klaipėda county;2003;25;5103;2560;2543
Klaipėda county;2003;26;5130;2523;2607
Klaipėda county;2003;27;5015;2443;2572
Klaipėda county;2003;28;5062;2447;2615
Klaipėda county;2003;29;5267;2637;2630
Klaipėda county;2003;30;5376;2664;2712
Klaipėda county;2003;31;5616;2745;2871
Klaipėda county;2003;32;5459;2624;2835
Klaipėda county;2003;33;5547;2678;2869
Klaipėda county;2003;34;5562;2737;2825
Klaipėda county;2003;35;5512;2717;2795
Klaipėda county;2003;36;5681;2797;2884
Klaipėda county;2003;37;5750;2934;2816
Klaipėda county;2003;38;5942;2953;2989
Klaipėda county;2003;39;6026;2974;3052
Klaipėda county;2003;40;6287;3154;3133
Klaipėda county;2003;41;6411;3092;3319
Klaipėda county;2003;42;6207;2953;3254
Klaipėda county;2003;43;6365;3003;3362
Klaipėda county;2003;44;5966;2843;3123
Klaipėda county;2003;45;5761;2759;3002
Klaipėda county;2003;46;5395;2532;2863
Klaipėda county;2003;47;5201;2493;2708
Klaipėda county;2003;48;4922;2337;2585
Klaipėda county;2003;49;4581;2154;2427
Klaipėda county;2003;50;4653;2142;2511
Klaipėda county;2003;51;4552;2139;2413
Klaipėda county;2003;52;4538;2076;2462
Klaipėda county;2003;53;4667;2243;2424
Klaipėda county;2003;54;4193;1898;2295
Klaipėda county;2003;55;3727;1629;2098
Klaipėda county;2003;56;3464;1549;1915
Klaipėda county;2003;57;3514;1542;1972
Klaipėda county;2003;58;3182;1360;1822
Klaipėda county;2003;59;3503;1526;1977
Klaipėda county;2003;60;3876;1641;2235
Klaipėda county;2003;61;4163;1765;2398
Klaipėda county;2003;62;4007;1722;2285
Klaipėda county;2003;63;4206;1817;2389
Klaipėda county;2003;64;4144;1800;2344
Klaipėda county;2003;65;4092;1669;2423
Klaipėda county;2003;66;4011;1655;2356
Klaipėda county;2003;67;3916;1555;2361
Klaipėda county;2003;68;3338;1310;2028
Klaipėda county;2003;69;3453;1307;2146
Klaipėda county;2003;70;3396;1323;2073
Klaipėda county;2003;71;3247;1247;2000
Klaipėda county;2003;72;3148;1207;1941
Klaipėda county;2003;73;2839;1076;1763
Klaipėda county;2003;74;2996;1026;1970
Klaipėda county;2003;75;2630;937;1693
Klaipėda county;2003;76;2366;764;1602
Klaipėda county;2003;77;2090;636;1454
Klaipėda county;2003;78;1781;529;1252
Klaipėda county;2003;79;1746;548;1198
Klaipėda county;2003;80;1438;410;1028
Klaipėda county;2003;81;1186;359;827
Klaipėda county;2003;82;907;257;650
Klaipėda county;2003;83;752;203;549
Klaipėda county;2003;84;478;131;347
Klaipėda county;2003;85;2928;787;2141
Klaipėda county;2004;-1;376854;176714;200140
Klaipėda county;2004;0;3355;1744;1611
Klaipėda county;2004;1;3260;1699;1561
Klaipėda county;2004;2;3440;1725;1715
Klaipėda county;2004;3;3695;1921;1774
Klaipėda county;2004;4;3894;2001;1893
Klaipėda county;2004;5;3903;2012;1891
Klaipėda county;2004;6;3990;2009;1981
Klaipėda county;2004;7;4179;2101;2078
Klaipėda county;2004;8;4278;2226;2052
Klaipėda county;2004;9;4439;2321;2118
Klaipėda county;2004;10;5082;2572;2510
Klaipėda county;2004;11;5716;2972;2744
Klaipėda county;2004;12;5959;3092;2867
Klaipėda county;2004;13;6114;3030;3084
Klaipėda county;2004;14;5838;2980;2858
Klaipėda county;2004;15;5911;2978;2933
Klaipėda county;2004;16;6143;3095;3048
Klaipėda county;2004;17;6318;3236;3082
Klaipėda county;2004;18;6081;3087;2994
Klaipėda county;2004;19;6036;3043;2993
Klaipėda county;2004;20;5986;3032;2954
Klaipėda county;2004;21;5355;2759;2596
Klaipėda county;2004;22;5214;2673;2541
Klaipėda county;2004;23;5160;2631;2529
Klaipėda county;2004;24;5024;2473;2551
Klaipėda county;2004;25;5067;2510;2557
Klaipėda county;2004;26;5065;2549;2516
Klaipėda county;2004;27;5117;2506;2611
Klaipėda county;2004;28;4984;2411;2573
Klaipėda county;2004;29;5049;2446;2603
Klaipėda county;2004;30;5211;2604;2607
Klaipėda county;2004;31;5313;2635;2678
Klaipėda county;2004;32;5559;2713;2846
Klaipėda county;2004;33;5407;2591;2816
Klaipėda county;2004;34;5470;2622;2848
Klaipėda county;2004;35;5516;2713;2803
Klaipėda county;2004;36;5441;2681;2760
Klaipėda county;2004;37;5613;2766;2847
Klaipėda county;2004;38;5667;2883;2784
Klaipėda county;2004;39;5857;2904;2953
Klaipėda county;2004;40;5942;2932;3010
Klaipėda county;2004;41;6228;3127;3101
Klaipėda county;2004;42;6343;3053;3290
Klaipėda county;2004;43;6145;2917;3228
Klaipėda county;2004;44;6267;2935;3332
Klaipėda county;2004;45;5914;2821;3093
Klaipėda county;2004;46;5695;2722;2973
Klaipėda county;2004;47;5315;2481;2834
Klaipėda county;2004;48;5115;2436;2679
Klaipėda county;2004;49;4864;2296;2568
Klaipėda county;2004;50;4510;2121;2389
Klaipėda county;2004;51;4583;2090;2493
Klaipėda county;2004;52;4476;2094;2382
Klaipėda county;2004;53;4462;2031;2431
Klaipėda county;2004;54;4630;2220;2410
Klaipėda county;2004;55;4126;1852;2274
Klaipėda county;2004;56;3663;1589;2074
Klaipėda county;2004;57;3395;1504;1891
Klaipėda county;2004;58;3454;1497;1957
Klaipėda county;2004;59;3120;1320;1800
Klaipėda county;2004;60;3417;1477;1940
Klaipėda county;2004;61;3815;1612;2203
Klaipėda county;2004;62;4101;1730;2371
Klaipėda county;2004;63;3938;1669;2269
Klaipėda county;2004;64;4128;1759;2369
Klaipėda county;2004;65;4059;1742;2317
Klaipėda county;2004;66;4014;1613;2401
Klaipėda county;2004;67;3911;1576;2335
Klaipėda county;2004;68;3848;1494;2354
Klaipėda county;2004;69;3285;1260;2025
Klaipėda county;2004;70;3349;1245;2104
Klaipėda county;2004;71;3327;1273;2054
Klaipėda county;2004;72;3154;1195;1959
Klaipėda county;2004;73;3060;1155;1905
Klaipėda county;2004;74;2730;1005;1725
Klaipėda county;2004;75;2893;966;1927
Klaipėda county;2004;76;2509;880;1629
Klaipėda county;2004;77;2232;694;1538
Klaipėda county;2004;78;1988;588;1400
Klaipėda county;2004;79;1682;490;1192
Klaipėda county;2004;80;1629;483;1146
Klaipėda county;2004;81;1348;373;975
Klaipėda county;2004;82;1072;309;763
Klaipėda county;2004;83;834;229;605
Klaipėda county;2004;84;685;176;509
Klaipėda county;2004;85;2893;737;2156
Klaipėda county;2005;-1;372541;174451;198090
Klaipėda county;2005;0;3368;1704;1664
Klaipėda county;2005;1;3324;1723;1601
Klaipėda county;2005;2;3229;1684;1545
Klaipėda county;2005;3;3399;1705;1694
Klaipėda county;2005;4;3654;1899;1755
Klaipėda county;2005;5;3850;1979;1871
Klaipėda county;2005;6;3871;1997;1874
Klaipėda county;2005;7;3960;1999;1961
Klaipėda county;2005;8;4153;2086;2067
Klaipėda county;2005;9;4257;2215;2042
Klaipėda county;2005;10;4407;2304;2103
Klaipėda county;2005;11;5060;2558;2502
Klaipėda county;2005;12;5656;2940;2716
Klaipėda county;2005;13;5916;3067;2849
Klaipėda county;2005;14;6030;2984;3046
Klaipėda county;2005;15;5752;2937;2815
Klaipėda county;2005;16;5794;2912;2882
Klaipėda county;2005;17;6025;3026;2999
Klaipėda county;2005;18;6182;3155;3027
Klaipėda county;2005;19;5935;3012;2923
Klaipėda county;2005;20;5901;2981;2920
Klaipėda county;2005;21;5834;2944;2890
Klaipėda county;2005;22;5221;2679;2542
Klaipėda county;2005;23;5067;2601;2466
Klaipėda county;2005;24;5040;2569;2471
Klaipėda county;2005;25;4867;2412;2455
Klaipėda county;2005;26;4995;2469;2526
Klaipėda county;2005;27;4999;2497;2502
Klaipėda county;2005;28;5045;2476;2569
Klaipėda county;2005;29;4930;2384;2546
Klaipėda county;2005;30;5025;2437;2588
Klaipėda county;2005;31;5161;2584;2577
Klaipėda county;2005;32;5246;2592;2654
Klaipėda county;2005;33;5508;2704;2804
Klaipėda county;2005;34;5359;2571;2788
Klaipėda county;2005;35;5387;2574;2813
Klaipėda county;2005;36;5440;2670;2770
Klaipėda county;2005;37;5368;2653;2715
Klaipėda county;2005;38;5534;2727;2807
Klaipėda county;2005;39;5569;2837;2732
Klaipėda county;2005;40;5761;2847;2914
Klaipėda county;2005;41;5824;2856;2968
Klaipėda county;2005;42;6122;3056;3066
Klaipėda county;2005;43;6262;3014;3248
Klaipėda county;2005;44;6082;2879;3203
Klaipėda county;2005;45;6174;2892;3282
Klaipėda county;2005;46;5843;2782;3061
Klaipėda county;2005;47;5624;2683;2941
Klaipėda county;2005;48;5205;2423;2782
Klaipėda county;2005;49;5060;2411;2649
Klaipėda county;2005;50;4799;2268;2531
Klaipėda county;2005;51;4428;2070;2358
Klaipėda county;2005;52;4515;2046;2469
Klaipėda county;2005;53;4407;2044;2363
Klaipėda county;2005;54;4394;1995;2399
Klaipėda county;2005;55;4553;2161;2392
Klaipėda county;2005;56;4061;1802;2259
Klaipėda county;2005;57;3598;1547;2051
Klaipėda county;2005;58;3330;1467;1863
Klaipėda county;2005;59;3399;1470;1929
Klaipėda county;2005;60;3057;1275;1782
Klaipėda county;2005;61;3349;1437;1912
Klaipėda county;2005;62;3720;1557;2163
Klaipėda county;2005;63;4021;1673;2348
Klaipėda county;2005;64;3850;1617;2233
Klaipėda county;2005;65;4025;1688;2337
Klaipėda county;2005;66;3967;1679;2288
Klaipėda county;2005;67;3922;1557;2365
Klaipėda county;2005;68;3796;1500;2296
Klaipėda county;2005;69;3751;1434;2317
Klaipėda county;2005;70;3187;1195;1992
Klaipėda county;2005;71;3257;1198;2059
Klaipėda county;2005;72;3216;1210;2006
Klaipėda county;2005;73;3026;1126;1900
Klaipėda county;2005;74;2944;1092;1852
Klaipėda county;2005;75;2601;933;1668
Klaipėda county;2005;76;2743;889;1854
Klaipėda county;2005;77;2372;821;1551
Klaipėda county;2005;78;2092;640;1452
Klaipėda county;2005;79;1869;546;1323
Klaipėda county;2005;80;1557;444;1113
Klaipėda county;2005;81;1512;434;1078
Klaipėda county;2005;82;1231;328;903
Klaipėda county;2005;83;962;268;694
Klaipėda county;2005;84;757;202;555
Klaipėda county;2005;85;2998;748;2250
Klaipėda county;2006;-1;364486;170458;194028
Klaipėda county;2006;0;3244;1703;1541
Klaipėda county;2006;1;3317;1677;1640
Klaipėda county;2006;2;3270;1694;1576
Klaipėda county;2006;3;3164;1655;1509
Klaipėda county;2006;4;3321;1663;1658
Klaipėda county;2006;5;3599;1870;1729
Klaipėda county;2006;6;3792;1956;1836
Klaipėda county;2006;7;3803;1970;1833
Klaipėda county;2006;8;3901;1974;1927
Klaipėda county;2006;9;4104;2065;2039
Klaipėda county;2006;10;4226;2201;2025
Klaipėda county;2006;11;4366;2283;2083
Klaipėda county;2006;12;5002;2538;2464
Klaipėda county;2006;13;5519;2871;2648
Klaipėda county;2006;14;5807;3009;2798
Klaipėda county;2006;15;5840;2884;2956
Klaipėda county;2006;16;5566;2834;2732
Klaipėda county;2006;17;5626;2814;2812
Klaipėda county;2006;18;5820;2921;2899
Klaipėda county;2006;19;5872;2990;2882
Klaipėda county;2006;20;5622;2836;2786
Klaipėda county;2006;21;5552;2797;2755
Klaipėda county;2006;22;5531;2808;2723
Klaipėda county;2006;23;5002;2570;2432
Klaipėda county;2006;24;4853;2491;2362
Klaipėda county;2006;25;4779;2455;2324
Klaipėda county;2006;26;4702;2348;2354
Klaipėda county;2006;27;4854;2382;2472
Klaipėda county;2006;28;4868;2421;2447
Klaipėda county;2006;29;4953;2411;2542
Klaipėda county;2006;30;4852;2358;2494
Klaipėda county;2006;31;4923;2377;2546
Klaipėda county;2006;32;5044;2516;2528
Klaipėda county;2006;33;5132;2533;2599
Klaipėda county;2006;34;5350;2620;2730
Klaipėda county;2006;35;5206;2488;2718
Klaipėda county;2006;36;5256;2512;2744
Klaipėda county;2006;37;5283;2575;2708
Klaipėda county;2006;38;5224;2576;2648
Klaipėda county;2006;39;5409;2656;2753
Klaipėda county;2006;40;5438;2753;2685
Klaipėda county;2006;41;5621;2760;2861
Klaipėda county;2006;42;5672;2774;2898
Klaipėda county;2006;43;5972;2975;2997
Klaipėda county;2006;44;6113;2939;3174
Klaipėda county;2006;45;5973;2827;3146
Klaipėda county;2006;46;6032;2818;3214
Klaipėda county;2006;47;5748;2722;3026
Klaipėda county;2006;48;5546;2645;2901
Klaipėda county;2006;49;5096;2356;2740
Klaipėda county;2006;50;4950;2352;2598
Klaipėda county;2006;51;4686;2195;2491
Klaipėda county;2006;52;4333;2018;2315
Klaipėda county;2006;53;4403;1986;2417
Klaipėda county;2006;54;4298;1984;2314
Klaipėda county;2006;55;4281;1934;2347
Klaipėda county;2006;56;4458;2101;2357
Klaipėda county;2006;57;3969;1747;2222
Klaipėda county;2006;58;3519;1497;2022
Klaipėda county;2006;59;3263;1433;1830
Klaipėda county;2006;60;3314;1427;1887
Klaipėda county;2006;61;2978;1234;1744
Klaipėda county;2006;62;3269;1385;1884
Klaipėda county;2006;63;3641;1510;2131
Klaipėda county;2006;64;3916;1618;2298
Klaipėda county;2006;65;3738;1547;2191
Klaipėda county;2006;66;3904;1611;2293
Klaipėda county;2006;67;3862;1607;2255
Klaipėda county;2006;68;3798;1495;2303
Klaipėda county;2006;69;3682;1431;2251
Klaipėda county;2006;70;3649;1372;2277
Klaipėda county;2006;71;3088;1147;1941
Klaipėda county;2006;72;3123;1135;1988
Klaipėda county;2006;73;3089;1141;1948
Klaipėda county;2006;74;2877;1050;1827
Klaipėda county;2006;75;2823;1032;1791
Klaipėda county;2006;76;2476;857;1619
Klaipėda county;2006;77;2550;808;1742
Klaipėda county;2006;78;2223;740;1483
Klaipėda county;2006;79;1954;593;1361
Klaipėda county;2006;80;1724;483;1241
Klaipėda county;2006;81;1429;398;1031
Klaipėda county;2006;82;1374;389;985
Klaipėda county;2006;83;1096;285;811
Klaipėda county;2006;84;870;245;625
Klaipėda county;2006;85;3114;800;2314
Klaipėda county;2007;-1;360434;168296;192138
Klaipėda county;2007;0;3383;1716;1667
Klaipėda county;2007;1;3222;1690;1532
Klaipėda county;2007;2;3282;1665;1617
Klaipėda county;2007;3;3249;1689;1560
Klaipėda county;2007;4;3143;1645;1498
Klaipėda county;2007;5;3300;1655;1645
Klaipėda county;2007;6;3582;1864;1718
Klaipėda county;2007;7;3773;1946;1827
Klaipėda county;2007;8;3788;1974;1814
Klaipėda county;2007;9;3896;1975;1921
Klaipėda county;2007;10;4084;2061;2023
Klaipėda county;2007;11;4196;2190;2006
Klaipėda county;2007;12;4349;2276;2073
Klaipėda county;2007;13;4972;2522;2450
Klaipėda county;2007;14;5489;2857;2632
Klaipėda county;2007;15;5769;2994;2775
Klaipėda county;2007;16;5761;2851;2910
Klaipėda county;2007;17;5497;2794;2703
Klaipėda county;2007;18;5546;2771;2775
Klaipėda county;2007;19;5700;2865;2835
Klaipėda county;2007;20;5715;2910;2805
Klaipėda county;2007;21;5476;2752;2724
Klaipėda county;2007;22;5404;2703;2701
Klaipėda county;2007;23;5424;2743;2681
Klaipėda county;2007;24;4893;2494;2399
Klaipėda county;2007;25;4738;2428;2310
Klaipėda county;2007;26;4701;2400;2301
Klaipėda county;2007;27;4667;2313;2354
Klaipėda county;2007;28;4803;2349;2454
Klaipėda county;2007;29;4808;2396;2412
Klaipėda county;2007;30;4906;2383;2523
Klaipėda county;2007;31;4816;2325;2491
Klaipėda county;2007;32;4892;2361;2531
Klaipėda county;2007;33;5002;2496;2506
Klaipėda county;2007;34;5072;2485;2587
Klaipėda county;2007;35;5265;2575;2690
Klaipėda county;2007;36;5130;2449;2681
Klaipėda county;2007;37;5186;2483;2703
Klaipėda county;2007;38;5221;2538;2683
Klaipėda county;2007;39;5154;2530;2624
Klaipėda county;2007;40;5326;2611;2715
Klaipėda county;2007;41;5338;2697;2641
Klaipėda county;2007;42;5548;2726;2822
Klaipėda county;2007;43;5586;2726;2860
Klaipėda county;2007;44;5882;2917;2965
Klaipėda county;2007;45;6019;2888;3131
Klaipėda county;2007;46;5906;2777;3129
Klaipėda county;2007;47;5934;2764;3170
Klaipėda county;2007;48;5675;2676;2999
Klaipėda county;2007;49;5471;2596;2875
Klaipėda county;2007;50;4985;2285;2700
Klaipėda county;2007;51;4849;2286;2563
Klaipėda county;2007;52;4616;2143;2473
Klaipėda county;2007;53;4254;1961;2293
Klaipėda county;2007;54;4308;1924;2384
Klaipėda county;2007;55;4217;1939;2278
Klaipėda county;2007;56;4204;1884;2320
Klaipėda county;2007;57;4383;2047;2336
Klaipėda county;2007;58;3903;1706;2197
Klaipėda county;2007;59;3453;1461;1992
Klaipėda county;2007;60;3198;1391;1807
Klaipėda county;2007;61;3229;1383;1846
Klaipėda county;2007;62;2903;1184;1719
Klaipėda county;2007;63;3181;1326;1855
Klaipėda county;2007;64;3559;1453;2106
Klaipėda county;2007;65;3818;1556;2262
Klaipėda county;2007;66;3646;1490;2156
Klaipėda county;2007;67;3793;1555;2238
Klaipėda county;2007;68;3770;1549;2221
Klaipėda county;2007;69;3707;1433;2274
Klaipėda county;2007;70;3574;1361;2213
Klaipėda county;2007;71;3508;1297;2211
Klaipėda county;2007;72;2976;1099;1877
Klaipėda county;2007;73;3001;1064;1937
Klaipėda county;2007;74;2966;1068;1898
Klaipėda county;2007;75;2768;994;1774
Klaipėda county;2007;76;2686;971;1715
Klaipėda county;2007;77;2353;800;1553
Klaipėda county;2007;78;2400;747;1653
Klaipėda county;2007;79;2074;672;1402
Klaipėda county;2007;80;1798;532;1266
Klaipėda county;2007;81;1592;440;1152
Klaipėda county;2007;82;1313;361;952
Klaipėda county;2007;83;1237;337;900
Klaipėda county;2007;84;955;246;709
Klaipėda county;2007;85;3318;860;2458
Klaipėda county;2008;-1;357201;166748;190453
Klaipėda county;2008;0;3546;1843;1703
Klaipėda county;2008;1;3354;1698;1656
Klaipėda county;2008;2;3207;1688;1519
Klaipėda county;2008;3;3273;1663;1610
Klaipėda county;2008;4;3228;1686;1542
Klaipėda county;2008;5;3126;1637;1489
Klaipėda county;2008;6;3275;1650;1625
Klaipėda county;2008;7;3569;1860;1709
Klaipėda county;2008;8;3766;1938;1828
Klaipėda county;2008;9;3767;1956;1811
Klaipėda county;2008;10;3872;1965;1907
Klaipėda county;2008;11;4066;2049;2017
Klaipėda county;2008;12;4187;2183;2004
Klaipėda county;2008;13;4355;2280;2075
Klaipėda county;2008;14;4947;2509;2438
Klaipėda county;2008;15;5445;2828;2617
Klaipėda county;2008;16;5722;2971;2751
Klaipėda county;2008;17;5704;2829;2875
Klaipėda county;2008;18;5427;2760;2667
Klaipėda county;2008;19;5480;2742;2738
Klaipėda county;2008;20;5611;2830;2781
Klaipėda county;2008;21;5613;2865;2748
Klaipėda county;2008;22;5372;2689;2683
Klaipėda county;2008;23;5311;2665;2646
Klaipėda county;2008;24;5346;2694;2652
Klaipėda county;2008;25;4837;2446;2391
Klaipėda county;2008;26;4670;2383;2287
Klaipėda county;2008;27;4650;2375;2275
Klaipėda county;2008;28;4628;2294;2334
Klaipėda county;2008;29;4764;2327;2437
Klaipėda county;2008;30;4772;2373;2399
Klaipėda county;2008;31;4875;2371;2504
Klaipėda county;2008;32;4810;2331;2479
Klaipėda county;2008;33;4869;2362;2507
Klaipėda county;2008;34;4948;2472;2476
Klaipėda county;2008;35;5037;2460;2577
Klaipėda county;2008;36;5208;2558;2650
Klaipėda county;2008;37;5094;2429;2665
Klaipėda county;2008;38;5138;2463;2675
Klaipėda county;2008;39;5153;2508;2645
Klaipėda county;2008;40;5092;2506;2586
Klaipėda county;2008;41;5256;2582;2674
Klaipėda county;2008;42;5275;2656;2619
Klaipėda county;2008;43;5446;2675;2771
Klaipėda county;2008;44;5494;2673;2821
Klaipėda county;2008;45;5772;2862;2910
Klaipėda county;2008;46;5910;2836;3074
Klaipėda county;2008;47;5822;2740;3082
Klaipėda county;2008;48;5855;2708;3147
Klaipėda county;2008;49;5598;2616;2982
Klaipėda county;2008;50;5395;2552;2843
Klaipėda county;2008;51;4914;2235;2679
Klaipėda county;2008;52;4773;2240;2533
Klaipėda county;2008;53;4560;2103;2457
Klaipėda county;2008;54;4174;1908;2266
Klaipėda county;2008;55;4237;1879;2358
Klaipėda county;2008;56;4124;1882;2242
Klaipėda county;2008;57;4123;1839;2284
Klaipėda county;2008;58;4309;2000;2309
Klaipėda county;2008;59;3827;1660;2167
Klaipėda county;2008;60;3358;1409;1949
Klaipėda county;2008;61;3114;1330;1784
Klaipėda county;2008;62;3166;1335;1831
Klaipėda county;2008;63;2837;1142;1695
Klaipėda county;2008;64;3112;1283;1829
Klaipėda county;2008;65;3469;1401;2068
Klaipėda county;2008;66;3735;1504;2231
Klaipėda county;2008;67;3560;1444;2116
Klaipėda county;2008;68;3687;1488;2199
Klaipėda county;2008;69;3640;1476;2164
Klaipėda county;2008;70;3583;1368;2215
Klaipėda county;2008;71;3466;1303;2163
Klaipėda county;2008;72;3380;1223;2157
Klaipėda county;2008;73;2867;1046;1821
Klaipėda county;2008;74;2871;1002;1869
Klaipėda county;2008;75;2831;1004;1827
Klaipėda county;2008;76;2635;927;1708
Klaipėda county;2008;77;2541;901;1640
Klaipėda county;2008;78;2232;734;1498
Klaipėda county;2008;79;2237;667;1570
Klaipėda county;2008;80;1924;611;1313
Klaipėda county;2008;81;1648;474;1174
Klaipėda county;2008;82;1467;390;1077
Klaipėda county;2008;83;1191;319;872
Klaipėda county;2008;84;1101;287;814
Klaipėda county;2008;85;3571;898;2673
Klaipėda county;2009;-1;355084;165645;189439
Klaipėda county;2009;0;3687;1875;1812
Klaipėda county;2009;1;3522;1821;1701
Klaipėda county;2009;2;3335;1697;1638
Klaipėda county;2009;3;3184;1680;1504
Klaipėda county;2009;4;3262;1662;1600
Klaipėda county;2009;5;3240;1682;1558
Klaipėda county;2009;6;3118;1631;1487
Klaipėda county;2009;7;3280;1655;1625
Klaipėda county;2009;8;3555;1842;1713
Klaipėda county;2009;9;3770;1937;1833
Klaipėda county;2009;10;3762;1948;1814
Klaipėda county;2009;11;3868;1963;1905
Klaipėda county;2009;12;4060;2047;2013
Klaipėda county;2009;13;4176;2172;2004
Klaipėda county;2009;14;4341;2277;2064
Klaipėda county;2009;15;4949;2518;2431
Klaipėda county;2009;16;5415;2807;2608
Klaipėda county;2009;17;5715;2963;2752
Klaipėda county;2009;18;5681;2815;2866
Klaipėda county;2009;19;5399;2745;2654
Klaipėda county;2009;20;5407;2712;2695
Klaipėda county;2009;21;5482;2774;2708
Klaipėda county;2009;22;5507;2811;2696
Klaipėda county;2009;23;5293;2656;2637
Klaipėda county;2009;24;5261;2651;2610
Klaipėda county;2009;25;5291;2668;2623
Klaipėda county;2009;26;4729;2396;2333
Klaipėda county;2009;27;4644;2383;2261
Klaipėda county;2009;28;4626;2358;2268
Klaipėda county;2009;29;4610;2296;2314
Klaipėda county;2009;30;4735;2309;2426
Klaipėda county;2009;31;4773;2382;2391
Klaipėda county;2009;32;4856;2373;2483
Klaipėda county;2009;33;4793;2325;2468
Klaipėda county;2009;34;4832;2340;2492
Klaipėda county;2009;35;4869;2435;2434
Klaipėda county;2009;36;4981;2427;2554
Klaipėda county;2009;37;5167;2539;2628
Klaipėda county;2009;38;5051;2407;2644
Klaipėda county;2009;39;5079;2428;2651
Klaipėda county;2009;40;5134;2491;2643
Klaipėda county;2009;41;5057;2489;2568
Klaipėda county;2009;42;5212;2551;2661
Klaipėda county;2009;43;5223;2622;2601
Klaipėda county;2009;44;5370;2627;2743
Klaipėda county;2009;45;5430;2646;2784
Klaipėda county;2009;46;5733;2845;2888
Klaipėda county;2009;47;5875;2806;3069
Klaipėda county;2009;48;5785;2714;3071
Klaipėda county;2009;49;5814;2680;3134
Klaipėda county;2009;50;5550;2584;2966
Klaipėda county;2009;51;5341;2510;2831
Klaipėda county;2009;52;4837;2180;2657
Klaipėda county;2009;53;4696;2186;2510
Klaipėda county;2009;54;4485;2050;2435
Klaipėda county;2009;55;4105;1857;2248
Klaipėda county;2009;56;4166;1832;2334
Klaipėda county;2009;57;4049;1827;2222
Klaipėda county;2009;58;4047;1781;2266
Klaipėda county;2009;59;4216;1933;2283
Klaipėda county;2009;60;3741;1599;2142
Klaipėda county;2009;61;3296;1367;1929
Klaipėda county;2009;62;3057;1302;1755
Klaipėda county;2009;63;3091;1287;1804
Klaipėda county;2009;64;2771;1091;1680
Klaipėda county;2009;65;3047;1238;1809
Klaipėda county;2009;66;3401;1359;2042
Klaipėda county;2009;67;3629;1436;2193
Klaipėda county;2009;68;3479;1412;2067
Klaipėda county;2009;69;3588;1426;2162
Klaipėda county;2009;70;3544;1419;2125
Klaipėda county;2009;71;3483;1310;2173
Klaipėda county;2009;72;3346;1229;2117
Klaipėda county;2009;73;3250;1154;2096
Klaipėda county;2009;74;2760;991;1769
Klaipėda county;2009;75;2747;938;1809
Klaipėda county;2009;76;2712;929;1783
Klaipėda county;2009;77;2515;865;1650
Klaipėda county;2009;78;2383;846;1537
Klaipėda county;2009;79;2088;668;1420
Klaipėda county;2009;80;2092;609;1483
Klaipėda county;2009;81;1765;540;1225
Klaipėda county;2009;82;1517;422;1095
Klaipėda county;2009;83;1345;362;983
Klaipėda county;2009;84;1084;276;808
Klaipėda county;2009;85;3923;952;2971
Klaipėda county;2010;-1;350306;163018;187288
Klaipėda county;2010;0;3813;1991;1822
Klaipėda county;2010;1;3636;1842;1794
Klaipėda county;2010;2;3490;1811;1679
Klaipėda county;2010;3;3280;1665;1615
Klaipėda county;2010;4;3154;1660;1494
Klaipėda county;2010;5;3209;1627;1582
Klaipėda county;2010;6;3200;1662;1538
Klaipėda county;2010;7;3097;1625;1472
Klaipėda county;2010;8;3254;1638;1616
Klaipėda county;2010;9;3522;1819;1703
Klaipėda county;2010;10;3741;1922;1819
Klaipėda county;2010;11;3748;1946;1802
Klaipėda county;2010;12;3850;1955;1895
Klaipėda county;2010;13;4041;2037;2004
Klaipėda county;2010;14;4137;2150;1987
Klaipėda county;2010;15;4322;2269;2053
Klaipėda county;2010;16;4898;2487;2411
Klaipėda county;2010;17;5369;2772;2597
Klaipėda county;2010;18;5671;2934;2737
Klaipėda county;2010;19;5586;2767;2819
Klaipėda county;2010;20;5294;2691;2603
Klaipėda county;2010;21;5251;2636;2615
Klaipėda county;2010;22;5325;2683;2642
Klaipėda county;2010;23;5332;2713;2619
Klaipėda county;2010;24;5142;2572;2570
Klaipėda county;2010;25;5093;2565;2528
Klaipėda county;2010;26;5056;2550;2506
Klaipėda county;2010;27;4563;2310;2253
Klaipėda county;2010;28;4519;2299;2220
Klaipėda county;2010;29;4525;2304;2221
Klaipėda county;2010;30;4535;2256;2279
Klaipėda county;2010;31;4632;2260;2372
Klaipėda county;2010;32;4688;2333;2355
Klaipėda county;2010;33;4761;2320;2441
Klaipėda county;2010;34;4691;2269;2422
Klaipėda county;2010;35;4711;2261;2450
Klaipėda county;2010;36;4746;2364;2382
Klaipėda county;2010;37;4862;2351;2511
Klaipėda county;2010;38;5070;2477;2593
Klaipėda county;2010;39;4948;2346;2602
Klaipėda county;2010;40;5007;2377;2630
Klaipėda county;2010;41;5034;2431;2603
Klaipėda county;2010;42;4974;2430;2544
Klaipėda county;2010;43;5117;2487;2630
Klaipėda county;2010;44;5129;2552;2577
Klaipėda county;2010;45;5268;2569;2699
Klaipėda county;2010;46;5328;2575;2753
Klaipėda county;2010;47;5615;2762;2853
Klaipėda county;2010;48;5796;2754;3042
Klaipėda county;2010;49;5686;2655;3031
Klaipėda county;2010;50;5725;2628;3097
Klaipėda county;2010;51;5452;2508;2944
Klaipėda county;2010;52;5249;2446;2803
Klaipėda county;2010;53;4754;2121;2633
Klaipėda county;2010;54;4619;2134;2485
Klaipėda county;2010;55;4387;1984;2403
Klaipėda county;2010;56;4035;1814;2221
Klaipėda county;2010;57;4079;1770;2309
Klaipėda county;2010;58;3981;1784;2197
Klaipėda county;2010;59;3972;1735;2237
Klaipėda county;2010;60;4134;1871;2263
Klaipėda county;2010;61;3661;1553;2108
Klaipėda county;2010;62;3227;1328;1899
Klaipėda county;2010;63;2980;1251;1729
Klaipėda county;2010;64;3018;1233;1785
Klaipėda county;2010;65;2707;1056;1651
Klaipėda county;2010;66;2963;1184;1779
Klaipėda county;2010;67;3316;1309;2007
Klaipėda county;2010;68;3526;1371;2155
Klaipėda county;2010;69;3376;1356;2020
Klaipėda county;2010;70;3473;1342;2131
Klaipėda county;2010;71;3421;1350;2071
Klaipėda county;2010;72;3370;1250;2120
Klaipėda county;2010;73;3249;1175;2074
Klaipėda county;2010;74;3135;1099;2036
Klaipėda county;2010;75;2649;936;1713
Klaipėda county;2010;76;2634;884;1750
Klaipėda county;2010;77;2595;878;1717
Klaipėda county;2010;78;2390;807;1583
Klaipėda county;2010;79;2232;778;1454
Klaipėda county;2010;80;1951;614;1337
Klaipėda county;2010;81;1943;557;1386
Klaipėda county;2010;82;1629;487;1142
Klaipėda county;2010;83;1369;371;998
Klaipėda county;2010;84;1202;314;888
Klaipėda county;2010;85;4187;1009;3178
Klaipėda county;2011;-1;340047;157884;182163
Klaipėda county;2011;0;3683;1852;1831
Klaipėda county;2011;1;3865;2015;1850
Klaipėda county;2011;2;3688;1862;1826
Klaipėda county;2011;3;3432;1792;1640
Klaipėda county;2011;4;3271;1661;1610
Klaipėda county;2011;5;3172;1641;1531
Klaipėda county;2011;6;3156;1613;1543
Klaipėda county;2011;7;3132;1612;1520
Klaipėda county;2011;8;3040;1610;1430
Klaipėda county;2011;9;3206;1595;1611
Klaipėda county;2011;10;3535;1817;1718
Klaipėda county;2011;11;3695;1868;1827
Klaipėda county;2011;12;3766;1957;1809
Klaipėda county;2011;13;3825;1941;1884
Klaipėda county;2011;14;4044;2034;2010
Klaipėda county;2011;15;4161;2139;2022
Klaipėda county;2011;16;4343;2250;2093
Klaipėda county;2011;17;4912;2485;2427
Klaipėda county;2011;18;5302;2736;2566
Klaipėda county;2011;19;5232;2666;2566
Klaipėda county;2011;20;5068;2491;2577
Klaipėda county;2011;21;4779;2409;2370
Klaipėda county;2011;22;4583;2328;2255
Klaipėda county;2011;23;4627;2318;2309
Klaipėda county;2011;24;4605;2330;2275
Klaipėda county;2011;25;4477;2269;2208
Klaipėda county;2011;26;4415;2247;2168
Klaipėda county;2011;27;4490;2238;2252
Klaipėda county;2011;28;4084;2036;2048
Klaipėda county;2011;29;4125;2116;2009
Klaipėda county;2011;30;4222;2144;2078
Klaipėda county;2011;31;4186;2098;2088
Klaipėda county;2011;32;4271;2113;2158
Klaipėda county;2011;33;4402;2177;2225
Klaipėda county;2011;34;4429;2197;2232
Klaipėda county;2011;35;4368;2155;2213
Klaipėda county;2011;36;4417;2147;2270
Klaipėda county;2011;37;4504;2253;2251
Klaipėda county;2011;38;4692;2270;2422
Klaipėda county;2011;39;4932;2408;2524
Klaipėda county;2011;40;4829;2283;2546
Klaipėda county;2011;41;4908;2295;2613
Klaipėda county;2011;42;4779;2284;2495
Klaipėda county;2011;43;4781;2282;2499
Klaipėda county;2011;44;4898;2315;2583
Klaipėda county;2011;45;4913;2449;2464
Klaipėda county;2011;46;5061;2474;2587
Klaipėda county;2011;47;5130;2459;2671
Klaipėda county;2011;48;5489;2702;2787
Klaipėda county;2011;49;5637;2672;2965
Klaipėda county;2011;50;5564;2625;2939
Klaipėda county;2011;51;5586;2599;2987
Klaipėda county;2011;52;5404;2503;2901
Klaipėda county;2011;53;5232;2449;2783
Klaipėda county;2011;54;4610;2075;2535
Klaipėda county;2011;55;4525;2096;2429
Klaipėda county;2011;56;4359;1963;2396
Klaipėda county;2011;57;4024;1800;2224
Klaipėda county;2011;58;4037;1780;2257
Klaipėda county;2011;59;3923;1760;2163
Klaipėda county;2011;60;3991;1750;2241
Klaipėda county;2011;61;4157;1868;2289
Klaipėda county;2011;62;3678;1560;2118
Klaipėda county;2011;63;3258;1350;1908
Klaipėda county;2011;64;3032;1257;1775
Klaipėda county;2011;65;3008;1234;1774
Klaipėda county;2011;66;2719;1049;1670
Klaipėda county;2011;67;2915;1156;1759
Klaipėda county;2011;68;3271;1279;1992
Klaipėda county;2011;69;3435;1294;2141
Klaipėda county;2011;70;3318;1296;2022
Klaipėda county;2011;71;3392;1261;2131
Klaipėda county;2011;72;3376;1320;2056
Klaipėda county;2011;73;3318;1208;2110
Klaipėda county;2011;74;3193;1144;2049
Klaipėda county;2011;75;3028;1046;1982
Klaipėda county;2011;76;2542;890;1652
Klaipėda county;2011;77;2542;846;1696
Klaipėda county;2011;78;2466;813;1653
Klaipėda county;2011;79;2286;756;1530
Klaipėda county;2011;80;2144;729;1415
Klaipėda county;2011;81;1833;580;1253
Klaipėda county;2011;82;1856;540;1316
Klaipėda county;2011;83;1515;438;1077
Klaipėda county;2011;84;1242;328;914
Klaipėda county;2011;85;4707;1137;3570
Klaipėda county;2012;-1;334744;155168;179576
Klaipėda county;2012;0;3580;1810;1770
Klaipėda county;2012;1;3678;1850;1828
Klaipėda county;2012;2;3846;2004;1842
Klaipėda county;2012;3;3651;1839;1812
Klaipėda county;2012;4;3380;1754;1626
Klaipėda county;2012;5;3226;1640;1586
Klaipėda county;2012;6;3143;1635;1508
Klaipėda county;2012;7;3114;1584;1530
Klaipėda county;2012;8;3102;1591;1511
Klaipėda county;2012;9;3008;1592;1416
Klaipėda county;2012;10;3167;1571;1596
Klaipėda county;2012;11;3494;1801;1693
Klaipėda county;2012;12;3637;1833;1804
Klaipėda county;2012;13;3728;1941;1787
Klaipėda county;2012;14;3783;1921;1862
Klaipėda county;2012;15;3997;2010;1987
Klaipėda county;2012;16;4143;2124;2019
Klaipėda county;2012;17;4313;2235;2078
Klaipėda county;2012;18;4832;2456;2376
Klaipėda county;2012;19;5120;2670;2450
Klaipėda county;2012;20;5088;2599;2489
Klaipėda county;2012;21;4900;2398;2502
Klaipėda county;2012;22;4608;2331;2277
Klaipėda county;2012;23;4354;2231;2123
Klaipėda county;2012;24;4420;2214;2206
Klaipėda county;2012;25;4435;2245;2190
Klaipėda county;2012;26;4272;2181;2091
Klaipėda county;2012;27;4221;2147;2074
Klaipėda county;2012;28;4367;2178;2189
Klaipėda county;2012;29;3943;1976;1967
Klaipėda county;2012;30;3992;2038;1954
Klaipėda county;2012;31;4074;2063;2011
Klaipėda county;2012;32;4065;2021;2044
Klaipėda county;2012;33;4178;2049;2129
Klaipėda county;2012;34;4294;2133;2161
Klaipėda county;2012;35;4313;2143;2170
Klaipėda county;2012;36;4257;2085;2172
Klaipėda county;2012;37;4335;2096;2239
Klaipėda county;2012;38;4395;2188;2207
Klaipėda county;2012;39;4590;2218;2372
Klaipėda county;2012;40;4834;2354;2480
Klaipėda county;2012;41;4757;2237;2520
Klaipėda county;2012;42;4819;2248;2571
Klaipėda county;2012;43;4706;2242;2464
Klaipėda county;2012;44;4701;2236;2465
Klaipėda county;2012;45;4776;2249;2527
Klaipėda county;2012;46;4818;2392;2426
Klaipėda county;2012;47;4986;2430;2556
Klaipėda county;2012;48;5059;2416;2643
Klaipėda county;2012;49;5399;2649;2750
Klaipėda county;2012;50;5543;2619;2924
Klaipėda county;2012;51;5463;2567;2896
Klaipėda county;2012;52;5495;2539;2956
Klaipėda county;2012;53;5322;2459;2863
Klaipėda county;2012;54;5154;2412;2742
Klaipėda county;2012;55;4521;2015;2506
Klaipėda county;2012;56;4469;2053;2416
Klaipėda county;2012;57;4272;1906;2366
Klaipėda county;2012;58;3953;1755;2198
Klaipėda county;2012;59;3989;1744;2245
Klaipėda county;2012;60;3870;1722;2148
Klaipėda county;2012;61;3920;1710;2210
Klaipėda county;2012;62;4086;1820;2266
Klaipėda county;2012;63;3601;1510;2091
Klaipėda county;2012;64;3204;1311;1893
Klaipėda county;2012;65;2948;1208;1740
Klaipėda county;2012;66;2936;1187;1749
Klaipėda county;2012;67;2659;1010;1649
Klaipėda county;2012;68;2866;1119;1747
Klaipėda county;2012;69;3190;1230;1960
Klaipėda county;2012;70;3340;1239;2101
Klaipėda county;2012;71;3228;1237;1991
Klaipėda county;2012;72;3287;1199;2088
Klaipėda county;2012;73;3271;1261;2010
Klaipėda county;2012;74;3215;1144;2071
Klaipėda county;2012;75;3075;1071;2004
Klaipėda county;2012;76;2903;971;1932
Klaipėda county;2012;77;2415;829;1586
Klaipėda county;2012;78;2410;792;1618
Klaipėda county;2012;79;2342;754;1588
Klaipėda county;2012;80;2139;700;1439
Klaipėda county;2012;81;1975;651;1324
Klaipėda county;2012;82;1681;511;1170
Klaipėda county;2012;83;1718;490;1228
Klaipėda county;2012;84;1330;363;967
Klaipėda county;2012;85;5056;1212;3844
Klaipėda county;2013;-1;331553;153725;177828
Klaipėda county;2013;0;3628;1845;1783
Klaipėda county;2013;1;3600;1827;1773
Klaipėda county;2013;2;3673;1852;1821
Klaipėda county;2013;3;3806;1995;1811
Klaipėda county;2013;4;3606;1817;1789
Klaipėda county;2013;5;3344;1740;1604
Klaipėda county;2013;6;3173;1619;1554
Klaipėda county;2013;7;3099;1612;1487
Klaipėda county;2013;8;3096;1582;1514
Klaipėda county;2013;9;3072;1585;1487
Klaipėda county;2013;10;2970;1576;1394
Klaipėda county;2013;11;3112;1536;1576
Klaipėda county;2013;12;3445;1779;1666
Klaipėda county;2013;13;3587;1809;1778
Klaipėda county;2013;14;3690;1923;1767
Klaipėda county;2013;15;3738;1896;1842
Klaipėda county;2013;16;3974;1991;1983
Klaipėda county;2013;17;4117;2111;2006
Klaipėda county;2013;18;4276;2211;2065
Klaipėda county;2013;19;4711;2416;2295
Klaipėda county;2013;20;5035;2630;2405
Klaipėda county;2013;21;4969;2558;2411
Klaipėda county;2013;22;4789;2349;2440
Klaipėda county;2013;23;4477;2273;2204
Klaipėda county;2013;24;4220;2178;2042
Klaipėda county;2013;25;4311;2159;2152
Klaipėda county;2013;26;4304;2165;2139
Klaipėda county;2013;27;4143;2103;2040
Klaipėda county;2013;28;4146;2117;2029
Klaipėda county;2013;29;4347;2180;2167
Klaipėda county;2013;30;3905;1968;1937
Klaipėda county;2013;31;3945;2026;1919
Klaipėda county;2013;32;3997;2031;1966
Klaipėda county;2013;33;3967;1976;1991
Klaipėda county;2013;34;4110;2023;2087
Klaipėda county;2013;35;4215;2084;2131
Klaipėda county;2013;36;4256;2125;2131
Klaipėda county;2013;37;4194;2056;2138
Klaipėda county;2013;38;4275;2072;2203
Klaipėda county;2013;39;4349;2170;2179
Klaipėda county;2013;40;4562;2200;2362
Klaipėda county;2013;41;4764;2310;2454
Klaipėda county;2013;42;4704;2213;2491
Klaipėda county;2013;43;4769;2218;2551
Klaipėda county;2013;44;4648;2216;2432
Klaipėda county;2013;45;4631;2205;2426
Klaipėda county;2013;46;4737;2233;2504
Klaipėda county;2013;47;4774;2359;2415
Klaipėda county;2013;48;4951;2410;2541
Klaipėda county;2013;49;5016;2386;2630
Klaipėda county;2013;50;5364;2621;2743
Klaipėda county;2013;51;5492;2584;2908
Klaipėda county;2013;52;5409;2537;2872
Klaipėda county;2013;53;5418;2493;2925
Klaipėda county;2013;54;5263;2420;2843
Klaipėda county;2013;55;5093;2363;2730
Klaipėda county;2013;56;4458;1975;2483
Klaipėda county;2013;57;4404;2011;2393
Klaipėda county;2013;58;4213;1866;2347
Klaipėda county;2013;59;3893;1714;2179
Klaipėda county;2013;60;3934;1702;2232
Klaipėda county;2013;61;3817;1677;2140
Klaipėda county;2013;62;3864;1665;2199
Klaipėda county;2013;63;4013;1777;2236
Klaipėda county;2013;64;3536;1467;2069
Klaipėda county;2013;65;3140;1268;1872
Klaipėda county;2013;66;2905;1169;1736
Klaipėda county;2013;67;2870;1151;1719
Klaipėda county;2013;68;2595;971;1624
Klaipėda county;2013;69;2811;1082;1729
Klaipėda county;2013;70;3105;1171;1934
Klaipėda county;2013;71;3252;1187;2065
Klaipėda county;2013;72;3136;1183;1953
Klaipėda county;2013;73;3198;1146;2052
Klaipėda county;2013;74;3137;1180;1957
Klaipėda county;2013;75;3103;1079;2024
Klaipėda county;2013;76;2955;1006;1949
Klaipėda county;2013;77;2768;907;1861
Klaipėda county;2013;78;2315;784;1531
Klaipėda county;2013;79;2258;717;1541
Klaipėda county;2013;80;2208;691;1517
Klaipėda county;2013;81;2000;632;1368
Klaipėda county;2013;82;1840;594;1246
Klaipėda county;2013;83;1556;466;1090
Klaipėda county;2013;84;1577;439;1138
Klaipėda county;2013;85;5426;1315;4111
Klaipėda county;2014;-1;329013;152499;176514
Klaipėda county;2014;0;3621;1819;1802
Klaipėda county;2014;1;3639;1859;1780
Klaipėda county;2014;2;3593;1826;1767
Klaipėda county;2014;3;3637;1835;1802
Klaipėda county;2014;4;3754;1984;1770
Klaipėda county;2014;5;3559;1775;1784
Klaipėda county;2014;6;3321;1715;1606
Klaipėda county;2014;7;3129;1595;1534
Klaipėda county;2014;8;3083;1591;1492
Klaipėda county;2014;9;3078;1571;1507
Klaipėda county;2014;10;3033;1563;1470
Klaipėda county;2014;11;2931;1558;1373
Klaipėda county;2014;12;3072;1513;1559
Klaipėda county;2014;13;3427;1768;1659
Klaipėda county;2014;14;3584;1802;1782
Klaipėda county;2014;15;3653;1907;1746
Klaipėda county;2014;16;3722;1888;1834
Klaipėda county;2014;17;3954;1982;1972
Klaipėda county;2014;18;4076;2090;1986
Klaipėda county;2014;19;4204;2183;2021
Klaipėda county;2014;20;4633;2363;2270
Klaipėda county;2014;21;4951;2597;2354
Klaipėda county;2014;22;4872;2518;2354
Klaipėda county;2014;23;4680;2317;2363
Klaipėda county;2014;24;4393;2256;2137
Klaipėda county;2014;25;4203;2154;2049
Klaipėda county;2014;26;4242;2103;2139
Klaipėda county;2014;27;4248;2137;2111
Klaipėda county;2014;28;4138;2100;2038
Klaipėda county;2014;29;4141;2118;2023
Klaipėda county;2014;30;4286;2162;2124
Klaipėda county;2014;31;3885;1972;1913
Klaipėda county;2014;32;3888;2006;1882
Klaipėda county;2014;33;3938;2006;1932
Klaipėda county;2014;34;3919;1946;1973
Klaipėda county;2014;35;4047;1983;2064
Klaipėda county;2014;36;4140;2024;2116
Klaipėda county;2014;37;4214;2112;2102
Klaipėda county;2014;38;4159;2040;2119
Klaipėda county;2014;39;4236;2063;2173
Klaipėda county;2014;40;4326;2157;2169
Klaipėda county;2014;41;4531;2191;2340
Klaipėda county;2014;42;4713;2286;2427
Klaipėda county;2014;43;4660;2191;2469
Klaipėda county;2014;44;4754;2211;2543
Klaipėda county;2014;45;4573;2174;2399
Klaipėda county;2014;46;4573;2175;2398
Klaipėda county;2014;47;4692;2210;2482
Klaipėda county;2014;48;4713;2314;2399
Klaipėda county;2014;49;4910;2380;2530
Klaipėda county;2014;50;4958;2356;2602
Klaipėda county;2014;51;5288;2574;2714
Klaipėda county;2014;52;5441;2548;2893
Klaipėda county;2014;53;5356;2502;2854
Klaipėda county;2014;54;5346;2453;2893
Klaipėda county;2014;55;5198;2367;2831
Klaipėda county;2014;56;5039;2328;2711
Klaipėda county;2014;57;4420;1939;2481
Klaipėda county;2014;58;4345;1964;2381
Klaipėda county;2014;59;4162;1834;2328
Klaipėda county;2014;60;3840;1670;2170
Klaipėda county;2014;61;3891;1667;2224
Klaipėda county;2014;62;3763;1637;2126
Klaipėda county;2014;63;3802;1621;2181
Klaipėda county;2014;64;3945;1730;2215
Klaipėda county;2014;65;3460;1416;2044
Klaipėda county;2014;66;3072;1230;1842
Klaipėda county;2014;67;2846;1141;1705
Klaipėda county;2014;68;2801;1108;1693
Klaipėda county;2014;69;2518;929;1589
Klaipėda county;2014;70;2728;1038;1690
Klaipėda county;2014;71;3031;1130;1901
Klaipėda county;2014;72;3168;1135;2033
Klaipėda county;2014;73;3043;1140;1903
Klaipėda county;2014;74;3084;1082;2002
Klaipėda county;2014;75;3009;1113;1896
Klaipėda county;2014;76;2981;1006;1975
Klaipėda county;2014;77;2825;936;1889
Klaipėda county;2014;78;2640;836;1804
Klaipėda county;2014;79;2204;735;1469
Klaipėda county;2014;80;2128;654;1474
Klaipėda county;2014;81;2060;634;1426
Klaipėda county;2014;82;1821;553;1268
Klaipėda county;2014;83;1678;523;1155
Klaipėda county;2014;84;1417;422;995
Klaipėda county;2014;85;5977;1458;4519
Klaipėda county;2015;-1;327300;151574;175726
Klaipėda county;2015;0;3645;1866;1779
Klaipėda county;2015;1;3650;1823;1827
Klaipėda county;2015;2;3659;1864;1795
Klaipėda county;2015;3;3555;1810;1745
Klaipėda county;2015;4;3612;1818;1794
Klaipėda county;2015;5;3694;1950;1744
Klaipėda county;2015;6;3518;1748;1770
Klaipėda county;2015;7;3273;1691;1582
Klaipėda county;2015;8;3124;1595;1529
Klaipėda county;2015;9;3070;1586;1484
Klaipėda county;2015;10;3059;1561;1498
Klaipėda county;2015;11;3009;1554;1455
Klaipėda county;2015;12;2907;1543;1364
Klaipėda county;2015;13;3054;1507;1547
Klaipėda county;2015;14;3407;1757;1650
Klaipėda county;2015;15;3548;1786;1762
Klaipėda county;2015;16;3628;1896;1732
Klaipėda county;2015;17;3697;1869;1828
Klaipėda county;2015;18;3916;1962;1954
Klaipėda county;2015;19;4002;2056;1946
Klaipėda county;2015;20;4109;2127;1982
Klaipėda county;2015;21;4573;2334;2239
Klaipėda county;2015;22;4858;2530;2328
Klaipėda county;2015;23;4782;2472;2310
Klaipėda county;2015;24;4597;2291;2306
Klaipėda county;2015;25;4344;2234;2110
Klaipėda county;2015;26;4148;2107;2041
Klaipėda county;2015;27;4218;2074;2144
Klaipėda county;2015;28;4234;2125;2109
Klaipėda county;2015;29;4115;2075;2040
Klaipėda county;2015;30;4133;2105;2028
Klaipėda county;2015;31;4301;2166;2135
Klaipėda county;2015;32;3850;1949;1901
Klaipėda county;2015;33;3827;1978;1849
Klaipėda county;2015;34;3931;2006;1925
Klaipėda county;2015;35;3864;1902;1962
Klaipėda county;2015;36;4008;1967;2041
Klaipėda county;2015;37;4074;1988;2086
Klaipėda county;2015;38;4193;2106;2087
Klaipėda county;2015;39;4138;2032;2106
Klaipėda county;2015;40;4228;2066;2162
Klaipėda county;2015;41;4316;2152;2164
Klaipėda county;2015;42;4482;2171;2311
Klaipėda county;2015;43;4697;2277;2420
Klaipėda county;2015;44;4640;2184;2456
Klaipėda county;2015;45;4706;2186;2520
Klaipėda county;2015;46;4540;2160;2380
Klaipėda county;2015;47;4554;2157;2397
Klaipėda county;2015;48;4688;2208;2480
Klaipėda county;2015;49;4689;2307;2382
Klaipėda county;2015;50;4895;2372;2523
Klaipėda county;2015;51;4941;2340;2601
Klaipėda county;2015;52;5211;2518;2693
Klaipėda county;2015;53;5404;2503;2901
Klaipėda county;2015;54;5313;2468;2845
Klaipėda county;2015;55;5273;2409;2864
Klaipėda county;2015;56;5152;2335;2817
Klaipėda county;2015;57;4990;2293;2697
Klaipėda county;2015;58;4390;1917;2473
Klaipėda county;2015;59;4296;1930;2366
Klaipėda county;2015;60;4102;1792;2310
Klaipėda county;2015;61;3796;1632;2164
Klaipėda county;2015;62;3839;1633;2206
Klaipėda county;2015;63;3715;1602;2113
Klaipėda county;2015;64;3740;1574;2166
Klaipėda county;2015;65;3887;1690;2197
Klaipėda county;2015;66;3392;1370;2022
Klaipėda county;2015;67;3004;1182;1822
Klaipėda county;2015;68;2794;1104;1690
Klaipėda county;2015;69;2730;1064;1666
Klaipėda county;2015;70;2451;888;1563
Klaipėda county;2015;71;2655;993;1662
Klaipėda county;2015;72;2943;1080;1863
Klaipėda county;2015;73;3091;1090;2001
Klaipėda county;2015;74;2945;1076;1869
Klaipėda county;2015;75;2990;1031;1959
Klaipėda county;2015;76;2911;1054;1857
Klaipėda county;2015;77;2860;939;1921
Klaipėda county;2015;78;2690;858;1832
Klaipėda county;2015;79;2507;784;1723
Klaipėda county;2015;80;2071;675;1396
Klaipėda county;2015;81;2009;601;1408
Klaipėda county;2015;82;1908;566;1342
Klaipėda county;2015;83;1688;503;1185
Klaipėda county;2015;84;1510;452;1058
Klaipėda county;2015;85;6343;1578;4765
Klaipėda county;2016;-1;324618;150164;174454
Klaipėda county;2016;0;3852;1989;1863
Klaipėda county;2016;1;3648;1867;1781
Klaipėda county;2016;2;3627;1829;1798
Klaipėda county;2016;3;3625;1852;1773
Klaipėda county;2016;4;3543;1806;1737
Klaipėda county;2016;5;3599;1813;1786
Klaipėda county;2016;6;3668;1942;1726
Klaipėda county;2016;7;3493;1732;1761
Klaipėda county;2016;8;3252;1680;1572
Klaipėda county;2016;9;3107;1582;1525
Klaipėda county;2016;10;3039;1557;1482
Klaipėda county;2016;11;3026;1552;1474
Klaipėda county;2016;12;2966;1536;1430
Klaipėda county;2016;13;2887;1536;1351
Klaipėda county;2016;14;3021;1478;1543
Klaipėda county;2016;15;3384;1756;1628
Klaipėda county;2016;16;3513;1768;1745
Klaipėda county;2016;17;3604;1887;1717
Klaipėda county;2016;18;3657;1854;1803
Klaipėda county;2016;19;3829;1916;1913
Klaipėda county;2016;20;3907;2000;1907
Klaipėda county;2016;21;3995;2049;1946
Klaipėda county;2016;22;4440;2241;2199
Klaipėda county;2016;23;4634;2393;2241
Klaipėda county;2016;24;4685;2389;2296
Klaipėda county;2016;25;4478;2199;2279
Klaipėda county;2016;26;4241;2165;2076
Klaipėda county;2016;27;4063;2058;2005
Klaipėda county;2016;28;4180;2046;2134
Klaipėda county;2016;29;4155;2084;2071
Klaipėda county;2016;30;4103;2066;2037
Klaipėda county;2016;31;4103;2081;2022
Klaipėda county;2016;32;4257;2151;2106
Klaipėda county;2016;33;3809;1942;1867
Klaipėda county;2016;34;3763;1958;1805
Klaipėda county;2016;35;3854;1952;1902
Klaipėda county;2016;36;3798;1855;1943
Klaipėda county;2016;37;3954;1934;2020
Klaipėda county;2016;38;4026;1969;2057
Klaipėda county;2016;39;4134;2069;2065
Klaipėda county;2016;40;4100;2015;2085
Klaipėda county;2016;41;4206;2054;2152
Klaipėda county;2016;42;4306;2146;2160
Klaipėda county;2016;43;4436;2148;2288
Klaipėda county;2016;44;4666;2253;2413
Klaipėda county;2016;45;4577;2141;2436
Klaipėda county;2016;46;4665;2170;2495
Klaipėda county;2016;47;4481;2118;2363
Klaipėda county;2016;48;4512;2129;2383
Klaipėda county;2016;49;4638;2180;2458
Klaipėda county;2016;50;4631;2265;2366
Klaipėda county;2016;51;4865;2349;2516
Klaipėda county;2016;52;4896;2308;2588
Klaipėda county;2016;53;5157;2480;2677
Klaipėda county;2016;54;5361;2476;2885
Klaipėda county;2016;55;5256;2430;2826
Klaipėda county;2016;56;5203;2352;2851
Klaipėda county;2016;57;5131;2326;2805
Klaipėda county;2016;58;4938;2254;2684
Klaipėda county;2016;59;4348;1884;2464
Klaipėda county;2016;60;4261;1904;2357
Klaipėda county;2016;61;4072;1753;2319
Klaipėda county;2016;62;3749;1588;2161
Klaipėda county;2016;63;3804;1606;2198
Klaipėda county;2016;64;3651;1557;2094
Klaipėda county;2016;65;3668;1519;2149
Klaipėda county;2016;66;3781;1610;2171
Klaipėda county;2016;67;3326;1332;1994
Klaipėda county;2016;68;2952;1153;1799
Klaipėda county;2016;69;2723;1061;1662
Klaipėda county;2016;70;2658;1018;1640
Klaipėda county;2016;71;2378;842;1536
Klaipėda county;2016;72;2584;952;1632
Klaipėda county;2016;73;2859;1034;1825
Klaipėda county;2016;74;2996;1046;1950
Klaipėda county;2016;75;2838;1014;1824
Klaipėda county;2016;76;2870;972;1898
Klaipėda county;2016;77;2765;972;1793
Klaipėda county;2016;78;2726;886;1840
Klaipėda county;2016;79;2554;796;1758
Klaipėda county;2016;80;2366;721;1645
Klaipėda county;2016;81;1944;626;1318
Klaipėda county;2016;82;1887;549;1338
Klaipėda county;2016;83;1745;506;1239
Klaipėda county;2016;84;1527;439;1088
Klaipėda county;2016;85;6642;1697;4945
Klaipėda county;2017;-1;320507;148337;172170
Klaipėda county;2017;0;3578;1859;1719
Klaipėda county;2017;1;3831;1977;1854
Klaipėda county;2017;2;3625;1848;1777
Klaipėda county;2017;3;3594;1803;1791
Klaipėda county;2017;4;3594;1838;1756
Klaipėda county;2017;5;3511;1789;1722
Klaipėda county;2017;6;3567;1792;1775
Klaipėda county;2017;7;3618;1911;1707
Klaipėda county;2017;8;3452;1722;1730
Klaipėda county;2017;9;3201;1660;1541
Klaipėda county;2017;10;3078;1572;1506
Klaipėda county;2017;11;2983;1526;1457
Klaipėda county;2017;12;2972;1527;1445
Klaipėda county;2017;13;2931;1513;1418
Klaipėda county;2017;14;2862;1523;1339
Klaipėda county;2017;15;2985;1452;1533
Klaipėda county;2017;16;3350;1738;1612
Klaipėda county;2017;17;3493;1757;1736
Klaipėda county;2017;18;3551;1858;1693
Klaipėda county;2017;19;3558;1797;1761
Klaipėda county;2017;20;3711;1849;1862
Klaipėda county;2017;21;3827;1954;1873
Klaipėda county;2017;22;3888;1996;1892
Klaipėda county;2017;23;4240;2170;2070
Klaipėda county;2017;24;4475;2335;2140
Klaipėda county;2017;25;4553;2324;2229
Klaipėda county;2017;26;4321;2137;2184
Klaipėda county;2017;27;4144;2126;2018
Klaipėda county;2017;28;3990;2033;1957
Klaipėda county;2017;29;4098;2011;2087
Klaipėda county;2017;30;4059;2025;2034
Klaipėda county;2017;31;4001;2013;1988
Klaipėda county;2017;32;3985;2037;1948
Klaipėda county;2017;33;4138;2101;2037
Klaipėda county;2017;34;3706;1904;1802
Klaipėda county;2017;35;3641;1882;1759
Klaipėda county;2017;36;3747;1888;1859
Klaipėda county;2017;37;3743;1845;1898
Klaipėda county;2017;38;3900;1903;1997
Klaipėda county;2017;39;3973;1943;2030
Klaipėda county;2017;40;4083;2046;2037
Klaipėda county;2017;41;4052;1998;2054
Klaipėda county;2017;42;4157;2030;2127
Klaipėda county;2017;43;4238;2114;2124
Klaipėda county;2017;44;4366;2112;2254
Klaipėda county;2017;45;4568;2193;2375
Klaipėda county;2017;46;4526;2130;2396
Klaipėda county;2017;47;4608;2134;2474
Klaipėda county;2017;48;4431;2097;2334
Klaipėda county;2017;49;4474;2109;2365
Klaipėda county;2017;50;4579;2148;2431
Klaipėda county;2017;51;4579;2240;2339
Klaipėda county;2017;52;4809;2307;2502
Klaipėda county;2017;53;4853;2275;2578
Klaipėda county;2017;54;5094;2463;2631
Klaipėda county;2017;55;5272;2422;2850
Klaipėda county;2017;56;5189;2375;2814
Klaipėda county;2017;57;5117;2305;2812
Klaipėda county;2017;58;5069;2292;2777
Klaipėda county;2017;59;4874;2215;2659
Klaipėda county;2017;60;4290;1845;2445
Klaipėda county;2017;61;4189;1849;2340
Klaipėda county;2017;62;4020;1708;2312
Klaipėda county;2017;63;3697;1556;2141
Klaipėda county;2017;64;3751;1564;2187
Klaipėda county;2017;65;3579;1510;2069
Klaipėda county;2017;66;3601;1471;2130
Klaipėda county;2017;67;3713;1563;2150
Klaipėda county;2017;68;3250;1283;1967
Klaipėda county;2017;69;2891;1116;1775
Klaipėda county;2017;70;2653;1016;1637
Klaipėda county;2017;71;2592;982;1610
Klaipėda county;2017;72;2317;802;1515
Klaipėda county;2017;73;2504;902;1602
Klaipėda county;2017;74;2763;985;1778
Klaipėda county;2017;75;2887;987;1900
Klaipėda county;2017;76;2738;959;1779
Klaipėda county;2017;77;2765;914;1851
Klaipėda county;2017;78;2623;907;1716
Klaipėda county;2017;79;2588;824;1764
Klaipėda county;2017;80;2402;732;1670
Klaipėda county;2017;81;2212;656;1556
Klaipėda county;2017;82;1799;564;1235
Klaipėda county;2017;83;1750;487;1263
Klaipėda county;2017;84;1591;457;1134
Klaipėda county;2017;85;6930;1755;5175
Klaipėda county;2018;-1;317252;147365;169887
Klaipėda county;2018;0;3469;1813;1656
Klaipėda county;2018;1;3632;1881;1751
Klaipėda county;2018;2;3806;1965;1841
Klaipėda county;2018;3;3594;1818;1776
Klaipėda county;2018;4;3539;1764;1775
Klaipėda county;2018;5;3541;1797;1744
Klaipėda county;2018;6;3488;1786;1702
Klaipėda county;2018;7;3537;1786;1751
Klaipėda county;2018;8;3584;1896;1688
Klaipėda county;2018;9;3416;1715;1701
Klaipėda county;2018;10;3174;1641;1533
Klaipėda county;2018;11;3043;1557;1486
Klaipėda county;2018;12;2958;1516;1442
Klaipėda county;2018;13;2950;1509;1441
Klaipėda county;2018;14;2914;1503;1411
Klaipėda county;2018;15;2829;1501;1328
Klaipėda county;2018;16;2945;1434;1511
Klaipėda county;2018;17;3318;1721;1597
Klaipėda county;2018;18;3442;1730;1712
Klaipėda county;2018;19;3412;1798;1614
Klaipėda county;2018;20;3428;1721;1707
Klaipėda county;2018;21;3572;1778;1794
Klaipėda county;2018;22;3670;1884;1786
Klaipėda county;2018;23;3686;1906;1780
Klaipėda county;2018;24;4048;2066;1982
Klaipėda county;2018;25;4283;2228;2055
Klaipėda county;2018;26;4358;2208;2150
Klaipėda county;2018;27;4148;2073;2075
Klaipėda county;2018;28;4057;2110;1947
Klaipėda county;2018;29;3884;2002;1882
Klaipėda county;2018;30;4032;1982;2050
Klaipėda county;2018;31;4012;2017;1995
Klaipėda county;2018;32;3947;1998;1949
Klaipėda county;2018;33;3943;2031;1912
Klaipėda county;2018;34;4100;2101;1999
Klaipėda county;2018;35;3679;1893;1786
Klaipėda county;2018;36;3609;1888;1721
Klaipėda county;2018;37;3734;1911;1823
Klaipėda county;2018;38;3721;1840;1881
Klaipėda county;2018;39;3864;1913;1951
Klaipėda county;2018;40;3921;1940;1981
Klaipėda county;2018;41;4070;2048;2022
Klaipėda county;2018;42;4046;2022;2024
Klaipėda county;2018;43;4142;2036;2106
Klaipėda county;2018;44;4214;2125;2089
Klaipėda county;2018;45;4364;2117;2247
Klaipėda county;2018;46;4541;2196;2345
Klaipėda county;2018;47;4503;2126;2377
Klaipėda county;2018;48;4585;2160;2425
Klaipėda county;2018;49;4416;2107;2309
Klaipėda county;2018;50;4450;2107;2343
Klaipėda county;2018;51;4530;2136;2394
Klaipėda county;2018;52;4557;2234;2323
Klaipėda county;2018;53;4779;2293;2486
Klaipėda county;2018;54;4818;2260;2558
Klaipėda county;2018;55;5057;2434;2623
Klaipėda county;2018;56;5238;2401;2837
Klaipėda county;2018;57;5139;2344;2795
Klaipėda county;2018;58;5069;2274;2795
Klaipėda county;2018;59;5018;2250;2768
Klaipėda county;2018;60;4822;2171;2651
Klaipėda county;2018;61;4249;1810;2439
Klaipėda county;2018;62;4148;1816;2332
Klaipėda county;2018;63;3946;1657;2289
Klaipėda county;2018;64;3643;1515;2128
Klaipėda county;2018;65;3688;1523;2165
Klaipėda county;2018;66;3510;1463;2047
Klaipėda county;2018;67;3541;1436;2105
Klaipėda county;2018;68;3643;1525;2118
Klaipėda county;2018;69;3167;1234;1933
Klaipėda county;2018;70;2826;1078;1748
Klaipėda county;2018;71;2591;981;1610
Klaipėda county;2018;72;2528;946;1582
Klaipėda county;2018;73;2253;767;1486
Klaipėda county;2018;74;2435;868;1567
Klaipėda county;2018;75;2658;932;1726
Klaipėda county;2018;76;2775;928;1847
Klaipėda county;2018;77;2621;894;1727
Klaipėda county;2018;78;2654;870;1784
Klaipėda county;2018;79;2484;845;1639
Klaipėda county;2018;80;2456;762;1694
Klaipėda county;2018;81;2265;674;1591
Klaipėda county;2018;82;2073;598;1475
Klaipėda county;2018;83;1659;502;1157
Klaipėda county;2018;84;1586;425;1161
Klaipėda county;2018;85;7208;1854;5354
Klaipėda d. mun.;2001;-1;46179;22381;23798
Klaipėda d. mun.;2001;0;522;285;237
Klaipėda d. mun.;2001;1;608;324;284
Klaipėda d. mun.;2001;2;534;291;243
Klaipėda d. mun.;2001;3;511;255;256
Klaipėda d. mun.;2001;4;543;263;280
Klaipėda d. mun.;2001;5;572;320;252
Klaipėda d. mun.;2001;6;623;324;299
Klaipėda d. mun.;2001;7;703;372;331
Klaipėda d. mun.;2001;8;754;407;347
Klaipėda d. mun.;2001;9;805;452;353
Klaipėda d. mun.;2001;10;836;406;430
Klaipėda d. mun.;2001;11;788;386;402
Klaipėda d. mun.;2001;12;777;402;375
Klaipėda d. mun.;2001;13;815;431;384
Klaipėda d. mun.;2001;14;885;442;443
Klaipėda d. mun.;2001;15;851;431;420
Klaipėda d. mun.;2001;16;768;399;369
Klaipėda d. mun.;2001;17;756;383;373
Klaipėda d. mun.;2001;18;726;354;372
Klaipėda d. mun.;2001;19;577;303;274
Klaipėda d. mun.;2001;20;565;305;260
Klaipėda d. mun.;2001;21;550;284;266
Klaipėda d. mun.;2001;22;549;271;278
Klaipėda d. mun.;2001;23;593;297;296
Klaipėda d. mun.;2001;24;587;282;305
Klaipėda d. mun.;2001;25;539;276;263
Klaipėda d. mun.;2001;26;563;293;270
Klaipėda d. mun.;2001;27;633;314;319
Klaipėda d. mun.;2001;28;644;348;296
Klaipėda d. mun.;2001;29;711;351;360
Klaipėda d. mun.;2001;30;656;324;332
Klaipėda d. mun.;2001;31;700;369;331
Klaipėda d. mun.;2001;32;677;359;318
Klaipėda d. mun.;2001;33;649;333;316
Klaipėda d. mun.;2001;34;685;363;322
Klaipėda d. mun.;2001;35;670;342;328
Klaipėda d. mun.;2001;36;691;348;343
Klaipėda d. mun.;2001;37;707;353;354
Klaipėda d. mun.;2001;38;718;346;372
Klaipėda d. mun.;2001;39;769;386;383
Klaipėda d. mun.;2001;40;713;368;345
Klaipėda d. mun.;2001;41;752;379;373
Klaipėda d. mun.;2001;42;668;339;329
Klaipėda d. mun.;2001;43;685;361;324
Klaipėda d. mun.;2001;44;553;283;270
Klaipėda d. mun.;2001;45;564;301;263
Klaipėda d. mun.;2001;46;556;272;284
Klaipėda d. mun.;2001;47;524;246;278
Klaipėda d. mun.;2001;48;510;240;270
Klaipėda d. mun.;2001;49;487;254;233
Klaipėda d. mun.;2001;50;520;242;278
Klaipėda d. mun.;2001;51;501;247;254
Klaipėda d. mun.;2001;52;488;212;276
Klaipėda d. mun.;2001;53;427;202;225
Klaipėda d. mun.;2001;54;407;191;216
Klaipėda d. mun.;2001;55;439;214;225
Klaipėda d. mun.;2001;56;400;155;245
Klaipėda d. mun.;2001;57;424;182;242
Klaipėda d. mun.;2001;58;470;214;256
Klaipėda d. mun.;2001;59;551;251;300
Klaipėda d. mun.;2001;60;513;230;283
Klaipėda d. mun.;2001;61;533;238;295
Klaipėda d. mun.;2001;62;495;221;274
Klaipėda d. mun.;2001;63;496;219;277
Klaipėda d. mun.;2001;64;478;206;272
Klaipėda d. mun.;2001;65;488;216;272
Klaipėda d. mun.;2001;66;442;198;244
Klaipėda d. mun.;2001;67;443;181;262
Klaipėda d. mun.;2001;68;489;201;288
Klaipėda d. mun.;2001;69;465;181;284
Klaipėda d. mun.;2001;70;410;180;230
Klaipėda d. mun.;2001;71;354;145;209
Klaipėda d. mun.;2001;72;402;141;261
Klaipėda d. mun.;2001;73;317;110;207
Klaipėda d. mun.;2001;74;282;111;171
Klaipėda d. mun.;2001;75;268;96;172
Klaipėda d. mun.;2001;76;254;77;177
Klaipėda d. mun.;2001;77;247;91;156
Klaipėda d. mun.;2001;78;213;66;147
Klaipėda d. mun.;2001;79;168;65;103
Klaipėda d. mun.;2001;80;153;42;111
Klaipėda d. mun.;2001;81;120;31;89
Klaipėda d. mun.;2001;82;64;17;47
Klaipėda d. mun.;2001;83;80;30;50
Klaipėda d. mun.;2001;84;77;29;48
Klaipėda d. mun.;2001;85;479;132;347
Klaipėda d. mun.;2002;-1;46413;22484;23929
Klaipėda d. mun.;2002;0;466;226;240
Klaipėda d. mun.;2002;1;518;284;234
Klaipėda d. mun.;2002;2;614;326;288
Klaipėda d. mun.;2002;3;534;294;240
Klaipėda d. mun.;2002;4;520;261;259
Klaipėda d. mun.;2002;5;546;266;280
Klaipėda d. mun.;2002;6;573;320;253
Klaipėda d. mun.;2002;7;632;330;302
Klaipėda d. mun.;2002;8;707;372;335
Klaipėda d. mun.;2002;9;760;408;352
Klaipėda d. mun.;2002;10;812;453;359
Klaipėda d. mun.;2002;11;834;402;432
Klaipėda d. mun.;2002;12;789;388;401
Klaipėda d. mun.;2002;13;773;399;374
Klaipėda d. mun.;2002;14;811;433;378
Klaipėda d. mun.;2002;15;880;437;443
Klaipėda d. mun.;2002;16;849;427;422
Klaipėda d. mun.;2002;17;768;397;371
Klaipėda d. mun.;2002;18;746;377;369
Klaipėda d. mun.;2002;19;723;354;369
Klaipėda d. mun.;2002;20;579;300;279
Klaipėda d. mun.;2002;21;560;304;256
Klaipėda d. mun.;2002;22;549;279;270
Klaipėda d. mun.;2002;23;552;269;283
Klaipėda d. mun.;2002;24;593;296;297
Klaipėda d. mun.;2002;25;580;284;296
Klaipėda d. mun.;2002;26;544;279;265
Klaipėda d. mun.;2002;27;561;288;273
Klaipėda d. mun.;2002;28;633;315;318
Klaipėda d. mun.;2002;29;644;350;294
Klaipėda d. mun.;2002;30;697;346;351
Klaipėda d. mun.;2002;31;648;321;327
Klaipėda d. mun.;2002;32;699;369;330
Klaipėda d. mun.;2002;33;676;359;317
Klaipėda d. mun.;2002;34;639;327;312
Klaipėda d. mun.;2002;35;681;362;319
Klaipėda d. mun.;2002;36;667;342;325
Klaipėda d. mun.;2002;37;689;348;341
Klaipėda d. mun.;2002;38;699;347;352
Klaipėda d. mun.;2002;39;719;347;372
Klaipėda d. mun.;2002;40;760;377;383
Klaipėda d. mun.;2002;41;719;373;346
Klaipėda d. mun.;2002;42;755;379;376
Klaipėda d. mun.;2002;43;667;336;331
Klaipėda d. mun.;2002;44;690;366;324
Klaipėda d. mun.;2002;45;552;279;273
Klaipėda d. mun.;2002;46;564;304;260
Klaipėda d. mun.;2002;47;563;277;286
Klaipėda d. mun.;2002;48;522;248;274
Klaipėda d. mun.;2002;49;504;235;269
Klaipėda d. mun.;2002;50;485;253;232
Klaipėda d. mun.;2002;51;507;232;275
Klaipėda d. mun.;2002;52;503;250;253
Klaipėda d. mun.;2002;53;482;211;271
Klaipėda d. mun.;2002;54;420;194;226
Klaipėda d. mun.;2002;55;405;190;215
Klaipėda d. mun.;2002;56;429;209;220
Klaipėda d. mun.;2002;57;397;157;240
Klaipėda d. mun.;2002;58;415;176;239
Klaipėda d. mun.;2002;59;465;209;256
Klaipėda d. mun.;2002;60;555;254;301
Klaipėda d. mun.;2002;61;517;232;285
Klaipėda d. mun.;2002;62;540;240;300
Klaipėda d. mun.;2002;63;496;221;275
Klaipėda d. mun.;2002;64;503;222;281
Klaipėda d. mun.;2002;65;483;208;275
Klaipėda d. mun.;2002;66;485;214;271
Klaipėda d. mun.;2002;67;432;189;243
Klaipėda d. mun.;2002;68;445;184;261
Klaipėda d. mun.;2002;69;490;201;289
Klaipėda d. mun.;2002;70;470;182;288
Klaipėda d. mun.;2002;71;397;172;225
Klaipėda d. mun.;2002;72;348;143;205
Klaipėda d. mun.;2002;73;398;139;259
Klaipėda d. mun.;2002;74;315;108;207
Klaipėda d. mun.;2002;75;277;110;167
Klaipėda d. mun.;2002;76;259;88;171
Klaipėda d. mun.;2002;77;240;72;168
Klaipėda d. mun.;2002;78;248;90;158
Klaipėda d. mun.;2002;79;209;67;142
Klaipėda d. mun.;2002;80;156;56;100
Klaipėda d. mun.;2002;81;148;40;108
Klaipėda d. mun.;2002;82;106;26;80
Klaipėda d. mun.;2002;83;63;16;47
Klaipėda d. mun.;2002;84;76;28;48
Klaipėda d. mun.;2002;85;489;141;348
Klaipėda d. mun.;2003;-1;46570;22547;24023
Klaipėda d. mun.;2003;0;442;245;197
Klaipėda d. mun.;2003;1;469;228;241
Klaipėda d. mun.;2003;2;519;281;238
Klaipėda d. mun.;2003;3;620;331;289
Klaipėda d. mun.;2003;4;537;296;241
Klaipėda d. mun.;2003;5;524;263;261
Klaipėda d. mun.;2003;6;543;262;281
Klaipėda d. mun.;2003;7;571;319;252
Klaipėda d. mun.;2003;8;633;332;301
Klaipėda d. mun.;2003;9;716;377;339
Klaipėda d. mun.;2003;10;758;409;349
Klaipėda d. mun.;2003;11;817;456;361
Klaipėda d. mun.;2003;12;831;396;435
Klaipėda d. mun.;2003;13;775;378;397
Klaipėda d. mun.;2003;14;767;397;370
Klaipėda d. mun.;2003;15;804;426;378
Klaipėda d. mun.;2003;16;873;433;440
Klaipėda d. mun.;2003;17;843;423;420
Klaipėda d. mun.;2003;18;766;399;367
Klaipėda d. mun.;2003;19;746;373;373
Klaipėda d. mun.;2003;20;723;352;371
Klaipėda d. mun.;2003;21;576;301;275
Klaipėda d. mun.;2003;22;555;303;252
Klaipėda d. mun.;2003;23;560;284;276
Klaipėda d. mun.;2003;24;559;273;286
Klaipėda d. mun.;2003;25;604;305;299
Klaipėda d. mun.;2003;26;584;284;300
Klaipėda d. mun.;2003;27;543;277;266
Klaipėda d. mun.;2003;28;563;291;272
Klaipėda d. mun.;2003;29;620;312;308
Klaipėda d. mun.;2003;30;639;348;291
Klaipėda d. mun.;2003;31;695;345;350
Klaipėda d. mun.;2003;32;646;320;326
Klaipėda d. mun.;2003;33;689;359;330
Klaipėda d. mun.;2003;34;675;361;314
Klaipėda d. mun.;2003;35;639;327;312
Klaipėda d. mun.;2003;36;686;365;321
Klaipėda d. mun.;2003;37;662;345;317
Klaipėda d. mun.;2003;38;691;349;342
Klaipėda d. mun.;2003;39;696;347;349
Klaipėda d. mun.;2003;40;714;341;373
Klaipėda d. mun.;2003;41;765;381;384
Klaipėda d. mun.;2003;42;728;378;350
Klaipėda d. mun.;2003;43;753;379;374
Klaipėda d. mun.;2003;44;677;345;332
Klaipėda d. mun.;2003;45;688;361;327
Klaipėda d. mun.;2003;46;551;275;276
Klaipėda d. mun.;2003;47;564;301;263
Klaipėda d. mun.;2003;48;559;275;284
Klaipėda d. mun.;2003;49;520;248;272
Klaipėda d. mun.;2003;50;501;233;268
Klaipėda d. mun.;2003;51;484;252;232
Klaipėda d. mun.;2003;52;501;228;273
Klaipėda d. mun.;2003;53;503;249;254
Klaipėda d. mun.;2003;54;481;208;273
Klaipėda d. mun.;2003;55;424;197;227
Klaipėda d. mun.;2003;56;404;188;216
Klaipėda d. mun.;2003;57;426;205;221
Klaipėda d. mun.;2003;58;384;144;240
Klaipėda d. mun.;2003;59;410;171;239
Klaipėda d. mun.;2003;60;456;201;255
Klaipėda d. mun.;2003;61;559;258;301
Klaipėda d. mun.;2003;62;515;231;284
Klaipėda d. mun.;2003;63;542;240;302
Klaipėda d. mun.;2003;64;500;223;277
Klaipėda d. mun.;2003;65;502;217;285
Klaipėda d. mun.;2003;66;480;201;279
Klaipėda d. mun.;2003;67;486;213;273
Klaipėda d. mun.;2003;68;436;188;248
Klaipėda d. mun.;2003;69;436;173;263
Klaipėda d. mun.;2003;70;481;193;288
Klaipėda d. mun.;2003;71;459;175;284
Klaipėda d. mun.;2003;72;390;171;219
Klaipėda d. mun.;2003;73;335;136;199
Klaipėda d. mun.;2003;74;384;135;249
Klaipėda d. mun.;2003;75;315;105;210
Klaipėda d. mun.;2003;76;274;107;167
Klaipėda d. mun.;2003;77;248;82;166
Klaipėda d. mun.;2003;78;227;70;157
Klaipėda d. mun.;2003;79;236;82;154
Klaipėda d. mun.;2003;80;195;61;134
Klaipėda d. mun.;2003;81;147;55;92
Klaipėda d. mun.;2003;82;137;35;102
Klaipėda d. mun.;2003;83;103;21;82
Klaipėda d. mun.;2003;84;53;13;40
Klaipėda d. mun.;2003;85;478;130;348
Klaipėda d. mun.;2004;-1;47367;22995;24372
Klaipėda d. mun.;2004;0;479;252;227
Klaipėda d. mun.;2004;1;443;246;197
Klaipėda d. mun.;2004;2;465;228;237
Klaipėda d. mun.;2004;3;517;282;235
Klaipėda d. mun.;2004;4;620;333;287
Klaipėda d. mun.;2004;5;533;295;238
Klaipėda d. mun.;2004;6;526;265;261
Klaipėda d. mun.;2004;7;544;263;281
Klaipėda d. mun.;2004;8;571;319;252
Klaipėda d. mun.;2004;9;639;335;304
Klaipėda d. mun.;2004;10;716;378;338
Klaipėda d. mun.;2004;11;761;413;348
Klaipėda d. mun.;2004;12;820;462;358
Klaipėda d. mun.;2004;13;833;400;433
Klaipėda d. mun.;2004;14;778;379;399
Klaipėda d. mun.;2004;15;770;402;368
Klaipėda d. mun.;2004;16;798;428;370
Klaipėda d. mun.;2004;17;868;438;430
Klaipėda d. mun.;2004;18;842;426;416
Klaipėda d. mun.;2004;19;773;404;369
Klaipėda d. mun.;2004;20;757;379;378
Klaipėda d. mun.;2004;21;723;354;369
Klaipėda d. mun.;2004;22;584;310;274
Klaipėda d. mun.;2004;23;569;304;265
Klaipėda d. mun.;2004;24;579;291;288
Klaipėda d. mun.;2004;25;550;270;280
Klaipėda d. mun.;2004;26;634;322;312
Klaipėda d. mun.;2004;27;597;285;312
Klaipėda d. mun.;2004;28;565;286;279
Klaipėda d. mun.;2004;29;576;296;280
Klaipėda d. mun.;2004;30;632;321;311
Klaipėda d. mun.;2004;31;646;354;292
Klaipėda d. mun.;2004;32;716;358;358
Klaipėda d. mun.;2004;33;655;322;333
Klaipėda d. mun.;2004;34;707;367;340
Klaipėda d. mun.;2004;35;694;370;324
Klaipėda d. mun.;2004;36;653;331;322
Klaipėda d. mun.;2004;37;688;366;322
Klaipėda d. mun.;2004;38;667;349;318
Klaipėda d. mun.;2004;39;704;363;341
Klaipėda d. mun.;2004;40;712;355;357
Klaipėda d. mun.;2004;41;725;348;377
Klaipėda d. mun.;2004;42;777;389;388
Klaipėda d. mun.;2004;43;741;385;356
Klaipėda d. mun.;2004;44;772;390;382
Klaipėda d. mun.;2004;45;695;359;336
Klaipėda d. mun.;2004;46;709;372;337
Klaipėda d. mun.;2004;47;565;282;283
Klaipėda d. mun.;2004;48;574;303;271
Klaipėda d. mun.;2004;49;573;282;291
Klaipėda d. mun.;2004;50;532;259;273
Klaipėda d. mun.;2004;51;523;238;285
Klaipėda d. mun.;2004;52;491;257;234
Klaipėda d. mun.;2004;53;507;231;276
Klaipėda d. mun.;2004;54;522;261;261
Klaipėda d. mun.;2004;55;500;215;285
Klaipėda d. mun.;2004;56;435;204;231
Klaipėda d. mun.;2004;57;409;191;218
Klaipėda d. mun.;2004;58;437;210;227
Klaipėda d. mun.;2004;59;390;147;243
Klaipėda d. mun.;2004;60;405;166;239
Klaipėda d. mun.;2004;61;458;203;255
Klaipėda d. mun.;2004;62;557;256;301
Klaipėda d. mun.;2004;63;522;231;291
Klaipėda d. mun.;2004;64;550;245;305
Klaipėda d. mun.;2004;65;501;230;271
Klaipėda d. mun.;2004;66;505;215;290
Klaipėda d. mun.;2004;67;482;196;286
Klaipėda d. mun.;2004;68;478;201;277
Klaipėda d. mun.;2004;69;429;181;248
Klaipėda d. mun.;2004;70;427;168;259
Klaipėda d. mun.;2004;71;470;184;286
Klaipėda d. mun.;2004;72;459;178;281
Klaipėda d. mun.;2004;73;390;167;223
Klaipėda d. mun.;2004;74;333;133;200
Klaipėda d. mun.;2004;75;374;126;248
Klaipėda d. mun.;2004;76;307;101;206
Klaipėda d. mun.;2004;77;249;95;154
Klaipėda d. mun.;2004;78;240;79;161
Klaipėda d. mun.;2004;79;217;65;152
Klaipėda d. mun.;2004;80;227;76;151
Klaipėda d. mun.;2004;81;182;57;125
Klaipėda d. mun.;2004;82;133;46;87
Klaipėda d. mun.;2004;83;131;30;101
Klaipėda d. mun.;2004;84;96;18;78
Klaipėda d. mun.;2004;85;464;124;340
Klaipėda d. mun.;2005;-1;48104;23412;24692
Klaipėda d. mun.;2005;0;477;236;241
Klaipėda d. mun.;2005;1;478;249;229
Klaipėda d. mun.;2005;2;444;247;197
Klaipėda d. mun.;2005;3;470;230;240
Klaipėda d. mun.;2005;4;526;284;242
Klaipėda d. mun.;2005;5;621;335;286
Klaipėda d. mun.;2005;6;535;297;238
Klaipėda d. mun.;2005;7;533;268;265
Klaipėda d. mun.;2005;8;548;266;282
Klaipėda d. mun.;2005;9;567;316;251
Klaipėda d. mun.;2005;10;645;339;306
Klaipėda d. mun.;2005;11;724;381;343
Klaipėda d. mun.;2005;12;774;421;353
Klaipėda d. mun.;2005;13;826;462;364
Klaipėda d. mun.;2005;14;833;402;431
Klaipėda d. mun.;2005;15;790;391;399
Klaipėda d. mun.;2005;16;774;403;371
Klaipėda d. mun.;2005;17;800;429;371
Klaipėda d. mun.;2005;18;866;440;426
Klaipėda d. mun.;2005;19;844;435;409
Klaipėda d. mun.;2005;20;785;417;368
Klaipėda d. mun.;2005;21;758;380;378
Klaipėda d. mun.;2005;22;721;355;366
Klaipėda d. mun.;2005;23;605;320;285
Klaipėda d. mun.;2005;24;585;312;273
Klaipėda d. mun.;2005;25;579;301;278
Klaipėda d. mun.;2005;26;562;278;284
Klaipėda d. mun.;2005;27;651;328;323
Klaipėda d. mun.;2005;28;596;285;311
Klaipėda d. mun.;2005;29;581;297;284
Klaipėda d. mun.;2005;30;593;307;286
Klaipėda d. mun.;2005;31;631;322;309
Klaipėda d. mun.;2005;32;671;371;300
Klaipėda d. mun.;2005;33;726;364;362
Klaipėda d. mun.;2005;34;661;330;331
Klaipėda d. mun.;2005;35;735;380;355
Klaipėda d. mun.;2005;36;696;368;328
Klaipėda d. mun.;2005;37;667;338;329
Klaipėda d. mun.;2005;38;693;365;328
Klaipėda d. mun.;2005;39;682;357;325
Klaipėda d. mun.;2005;40;720;369;351
Klaipėda d. mun.;2005;41;717;349;368
Klaipėda d. mun.;2005;42;732;348;384
Klaipėda d. mun.;2005;43;794;406;388
Klaipėda d. mun.;2005;44;765;395;370
Klaipėda d. mun.;2005;45;788;402;386
Klaipėda d. mun.;2005;46;709;368;341
Klaipėda d. mun.;2005;47;730;385;345
Klaipėda d. mun.;2005;48;576;292;284
Klaipėda d. mun.;2005;49;575;303;272
Klaipėda d. mun.;2005;50;592;298;294
Klaipėda d. mun.;2005;51;554;272;282
Klaipėda d. mun.;2005;52;529;242;287
Klaipėda d. mun.;2005;53;500;262;238
Klaipėda d. mun.;2005;54;514;239;275
Klaipėda d. mun.;2005;55;536;270;266
Klaipėda d. mun.;2005;56;501;217;284
Klaipėda d. mun.;2005;57;448;210;238
Klaipėda d. mun.;2005;58;416;200;216
Klaipėda d. mun.;2005;59;432;209;223
Klaipėda d. mun.;2005;60;389;146;243
Klaipėda d. mun.;2005;61;404;170;234
Klaipėda d. mun.;2005;62;463;204;259
Klaipėda d. mun.;2005;63;551;252;299
Klaipėda d. mun.;2005;64;517;227;290
Klaipėda d. mun.;2005;65;550;243;307
Klaipėda d. mun.;2005;66;506;227;279
Klaipėda d. mun.;2005;67;502;212;290
Klaipėda d. mun.;2005;68;473;183;290
Klaipėda d. mun.;2005;69;479;202;277
Klaipėda d. mun.;2005;70;422;177;245
Klaipėda d. mun.;2005;71;415;162;253
Klaipėda d. mun.;2005;72;461;176;285
Klaipėda d. mun.;2005;73;440;165;275
Klaipėda d. mun.;2005;74;380;159;221
Klaipėda d. mun.;2005;75;327;123;204
Klaipėda d. mun.;2005;76;366;119;247
Klaipėda d. mun.;2005;77;297;97;200
Klaipėda d. mun.;2005;78;233;87;146
Klaipėda d. mun.;2005;79;229;76;153
Klaipėda d. mun.;2005;80;206;63;143
Klaipėda d. mun.;2005;81;217;70;147
Klaipėda d. mun.;2005;82;171;48;123
Klaipėda d. mun.;2005;83;124;42;82
Klaipėda d. mun.;2005;84;122;28;94
Klaipėda d. mun.;2005;85;479;112;367
Klaipėda d. mun.;2006;-1;48488;23548;24940
Klaipėda d. mun.;2006;0;469;235;234
Klaipėda d. mun.;2006;1;473;235;238
Klaipėda d. mun.;2006;2;483;253;230
Klaipėda d. mun.;2006;3;442;246;196
Klaipėda d. mun.;2006;4;478;235;243
Klaipėda d. mun.;2006;5;535;289;246
Klaipėda d. mun.;2006;6;626;341;285
Klaipėda d. mun.;2006;7;536;300;236
Klaipėda d. mun.;2006;8;543;276;267
Klaipėda d. mun.;2006;9;553;271;282
Klaipėda d. mun.;2006;10;580;325;255
Klaipėda d. mun.;2006;11;652;341;311
Klaipėda d. mun.;2006;12;738;386;352
Klaipėda d. mun.;2006;13;767;414;353
Klaipėda d. mun.;2006;14;850;473;377
Klaipėda d. mun.;2006;15;834;407;427
Klaipėda d. mun.;2006;16;786;387;399
Klaipėda d. mun.;2006;17;771;399;372
Klaipėda d. mun.;2006;18;789;422;367
Klaipėda d. mun.;2006;19;841;424;417
Klaipėda d. mun.;2006;20;817;422;395
Klaipėda d. mun.;2006;21;753;397;356
Klaipėda d. mun.;2006;22;750;378;372
Klaipėda d. mun.;2006;23;708;354;354
Klaipėda d. mun.;2006;24;602;312;290
Klaipėda d. mun.;2006;25;574;311;263
Klaipėda d. mun.;2006;26;574;299;275
Klaipėda d. mun.;2006;27;556;275;281
Klaipėda d. mun.;2006;28;652;334;318
Klaipėda d. mun.;2006;29;596;279;317
Klaipėda d. mun.;2006;30;587;301;286
Klaipėda d. mun.;2006;31;603;311;292
Klaipėda d. mun.;2006;32;643;319;324
Klaipėda d. mun.;2006;33;676;365;311
Klaipėda d. mun.;2006;34;734;367;367
Klaipėda d. mun.;2006;35;664;330;334
Klaipėda d. mun.;2006;36;753;386;367
Klaipėda d. mun.;2006;37;699;369;330
Klaipėda d. mun.;2006;38;681;347;334
Klaipėda d. mun.;2006;39;701;370;331
Klaipėda d. mun.;2006;40;694;362;332
Klaipėda d. mun.;2006;41;725;369;356
Klaipėda d. mun.;2006;42;730;353;377
Klaipėda d. mun.;2006;43;743;351;392
Klaipėda d. mun.;2006;44;795;407;388
Klaipėda d. mun.;2006;45;784;410;374
Klaipėda d. mun.;2006;46;792;406;386
Klaipėda d. mun.;2006;47;730;374;356
Klaipėda d. mun.;2006;48;738;388;350
Klaipėda d. mun.;2006;49;592;291;301
Klaipėda d. mun.;2006;50;587;310;277
Klaipėda d. mun.;2006;51;606;306;300
Klaipėda d. mun.;2006;52;556;271;285
Klaipėda d. mun.;2006;53;533;242;291
Klaipėda d. mun.;2006;54;500;258;242
Klaipėda d. mun.;2006;55;527;243;284
Klaipėda d. mun.;2006;56;539;272;267
Klaipėda d. mun.;2006;57;510;217;293
Klaipėda d. mun.;2006;58;451;208;243
Klaipėda d. mun.;2006;59;411;194;217
Klaipėda d. mun.;2006;60;435;211;224
Klaipėda d. mun.;2006;61;392;144;248
Klaipėda d. mun.;2006;62;407;174;233
Klaipėda d. mun.;2006;63;461;201;260
Klaipėda d. mun.;2006;64;548;248;300
Klaipėda d. mun.;2006;65;507;221;286
Klaipėda d. mun.;2006;66;543;233;310
Klaipėda d. mun.;2006;67;501;224;277
Klaipėda d. mun.;2006;68;496;203;293
Klaipėda d. mun.;2006;69;464;174;290
Klaipėda d. mun.;2006;70;473;197;276
Klaipėda d. mun.;2006;71;415;174;241
Klaipėda d. mun.;2006;72;403;158;245
Klaipėda d. mun.;2006;73;451;167;284
Klaipėda d. mun.;2006;74;426;155;271
Klaipėda d. mun.;2006;75;376;150;226
Klaipėda d. mun.;2006;76;311;110;201
Klaipėda d. mun.;2006;77;341;106;235
Klaipėda d. mun.;2006;78;282;88;194
Klaipėda d. mun.;2006;79;233;85;148
Klaipėda d. mun.;2006;80;212;68;144
Klaipėda d. mun.;2006;81;191;59;132
Klaipėda d. mun.;2006;82;199;63;136
Klaipėda d. mun.;2006;83;164;45;119
Klaipėda d. mun.;2006;84;118;42;76
Klaipėda d. mun.;2006;85;527;131;396
Klaipėda d. mun.;2007;-1;49293;23891;25402
Klaipėda d. mun.;2007;0;502;251;251
Klaipėda d. mun.;2007;1;471;236;235
Klaipėda d. mun.;2007;2;502;254;248
Klaipėda d. mun.;2007;3;497;259;238
Klaipėda d. mun.;2007;4;457;248;209
Klaipėda d. mun.;2007;5;482;235;247
Klaipėda d. mun.;2007;6;546;294;252
Klaipėda d. mun.;2007;7;628;345;283
Klaipėda d. mun.;2007;8;552;311;241
Klaipėda d. mun.;2007;9;561;284;277
Klaipėda d. mun.;2007;10;570;284;286
Klaipėda d. mun.;2007;11;600;334;266
Klaipėda d. mun.;2007;12;673;346;327
Klaipėda d. mun.;2007;13;769;404;365
Klaipėda d. mun.;2007;14;793;430;363
Klaipėda d. mun.;2007;15;869;484;385
Klaipėda d. mun.;2007;16;840;413;427
Klaipėda d. mun.;2007;17;787;387;400
Klaipėda d. mun.;2007;18;776;402;374
Klaipėda d. mun.;2007;19;785;419;366
Klaipėda d. mun.;2007;20;840;425;415
Klaipėda d. mun.;2007;21;814;418;396
Klaipėda d. mun.;2007;22;749;389;360
Klaipėda d. mun.;2007;23;766;383;383
Klaipėda d. mun.;2007;24;708;348;360
Klaipėda d. mun.;2007;25;616;326;290
Klaipėda d. mun.;2007;26;600;314;286
Klaipėda d. mun.;2007;27;600;305;295
Klaipėda d. mun.;2007;28;566;277;289
Klaipėda d. mun.;2007;29;654;332;322
Klaipėda d. mun.;2007;30;611;287;324
Klaipėda d. mun.;2007;31;603;311;292
Klaipėda d. mun.;2007;32;620;316;304
Klaipėda d. mun.;2007;33;645;317;328
Klaipėda d. mun.;2007;34;695;365;330
Klaipėda d. mun.;2007;35;757;378;379
Klaipėda d. mun.;2007;36;683;335;348
Klaipėda d. mun.;2007;37;766;399;367
Klaipėda d. mun.;2007;38;717;375;342
Klaipėda d. mun.;2007;39;699;352;347
Klaipėda d. mun.;2007;40;717;377;340
Klaipėda d. mun.;2007;41;712;374;338
Klaipėda d. mun.;2007;42;735;377;358
Klaipėda d. mun.;2007;43;733;355;378
Klaipėda d. mun.;2007;44;750;349;401
Klaipėda d. mun.;2007;45;809;413;396
Klaipėda d. mun.;2007;46;801;418;383
Klaipėda d. mun.;2007;47;796;403;393
Klaipėda d. mun.;2007;48;738;378;360
Klaipėda d. mun.;2007;49;754;398;356
Klaipėda d. mun.;2007;50;598;289;309
Klaipėda d. mun.;2007;51;593;313;280
Klaipėda d. mun.;2007;52;612;311;301
Klaipėda d. mun.;2007;53;570;275;295
Klaipėda d. mun.;2007;54;532;236;296
Klaipėda d. mun.;2007;55;500;257;243
Klaipėda d. mun.;2007;56;533;244;289
Klaipėda d. mun.;2007;57;551;279;272
Klaipėda d. mun.;2007;58;510;214;296
Klaipėda d. mun.;2007;59;452;206;246
Klaipėda d. mun.;2007;60;408;191;217
Klaipėda d. mun.;2007;61;433;209;224
Klaipėda d. mun.;2007;62;388;140;248
Klaipėda d. mun.;2007;63;399;168;231
Klaipėda d. mun.;2007;64;457;197;260
Klaipėda d. mun.;2007;65;544;240;304
Klaipėda d. mun.;2007;66;509;219;290
Klaipėda d. mun.;2007;67;533;230;303
Klaipėda d. mun.;2007;68;505;227;278
Klaipėda d. mun.;2007;69;503;206;297
Klaipėda d. mun.;2007;70;460;173;287
Klaipėda d. mun.;2007;71;465;190;275
Klaipėda d. mun.;2007;72;409;164;245
Klaipėda d. mun.;2007;73;387;151;236
Klaipėda d. mun.;2007;74;428;152;276
Klaipėda d. mun.;2007;75;420;153;267
Klaipėda d. mun.;2007;76;359;138;221
Klaipėda d. mun.;2007;77;305;103;202
Klaipėda d. mun.;2007;78;326;100;226
Klaipėda d. mun.;2007;79;263;86;177
Klaipėda d. mun.;2007;80;209;73;136
Klaipėda d. mun.;2007;81;189;57;132
Klaipėda d. mun.;2007;82;184;57;127
Klaipėda d. mun.;2007;83;184;54;130
Klaipėda d. mun.;2007;84;153;44;109
Klaipėda d. mun.;2007;85;508;131;377
Klaipėda d. mun.;2008;-1;50488;24492;25996
Klaipėda d. mun.;2008;0;603;303;300
Klaipėda d. mun.;2008;1;514;257;257
Klaipėda d. mun.;2008;2;495;248;247
Klaipėda d. mun.;2008;3;518;264;254
Klaipėda d. mun.;2008;4;518;267;251
Klaipėda d. mun.;2008;5;469;248;221
Klaipėda d. mun.;2008;6;494;246;248
Klaipėda d. mun.;2008;7;559;305;254
Klaipėda d. mun.;2008;8;656;359;297
Klaipėda d. mun.;2008;9;572;323;249
Klaipėda d. mun.;2008;10;586;302;284
Klaipėda d. mun.;2008;11;586;293;293
Klaipėda d. mun.;2008;12;622;341;281
Klaipėda d. mun.;2008;13;702;360;342
Klaipėda d. mun.;2008;14;783;406;377
Klaipėda d. mun.;2008;15;809;442;367
Klaipėda d. mun.;2008;16;893;499;394
Klaipėda d. mun.;2008;17;849;419;430
Klaipėda d. mun.;2008;18;795;393;402
Klaipėda d. mun.;2008;19;789;413;376
Klaipėda d. mun.;2008;20;785;420;365
Klaipėda d. mun.;2008;21;842;430;412
Klaipėda d. mun.;2008;22;822;418;404
Klaipėda d. mun.;2008;23;753;386;367
Klaipėda d. mun.;2008;24;794;393;401
Klaipėda d. mun.;2008;25;727;358;369
Klaipėda d. mun.;2008;26;620;324;296
Klaipėda d. mun.;2008;27;632;329;303
Klaipėda d. mun.;2008;28;617;316;301
Klaipėda d. mun.;2008;29;590;288;302
Klaipėda d. mun.;2008;30;678;341;337
Klaipėda d. mun.;2008;31;647;313;334
Klaipėda d. mun.;2008;32;643;330;313
Klaipėda d. mun.;2008;33;642;324;318
Klaipėda d. mun.;2008;34;666;332;334
Klaipėda d. mun.;2008;35;720;370;350
Klaipėda d. mun.;2008;36;774;389;385
Klaipėda d. mun.;2008;37;704;345;359
Klaipėda d. mun.;2008;38;787;412;375
Klaipėda d. mun.;2008;39;733;380;353
Klaipėda d. mun.;2008;40;712;357;355
Klaipėda d. mun.;2008;41;739;390;349
Klaipėda d. mun.;2008;42;731;383;348
Klaipėda d. mun.;2008;43;747;390;357
Klaipėda d. mun.;2008;44;738;356;382
Klaipėda d. mun.;2008;45;772;365;407
Klaipėda d. mun.;2008;46;820;421;399
Klaipėda d. mun.;2008;47;814;429;385
Klaipėda d. mun.;2008;48;814;410;404
Klaipėda d. mun.;2008;49;751;380;371
Klaipėda d. mun.;2008;50;771;407;364
Klaipėda d. mun.;2008;51;608;293;315
Klaipėda d. mun.;2008;52;598;316;282
Klaipėda d. mun.;2008;53;622;311;311
Klaipėda d. mun.;2008;54;578;278;300
Klaipėda d. mun.;2008;55;531;237;294
Klaipėda d. mun.;2008;56;502;260;242
Klaipėda d. mun.;2008;57;530;243;287
Klaipėda d. mun.;2008;58;544;274;270
Klaipėda d. mun.;2008;59;518;217;301
Klaipėda d. mun.;2008;60;444;202;242
Klaipėda d. mun.;2008;61;417;197;220
Klaipėda d. mun.;2008;62;421;201;220
Klaipėda d. mun.;2008;63;378;133;245
Klaipėda d. mun.;2008;64;397;170;227
Klaipėda d. mun.;2008;65;452;189;263
Klaipėda d. mun.;2008;66;541;234;307
Klaipėda d. mun.;2008;67;508;217;291
Klaipėda d. mun.;2008;68;534;228;306
Klaipėda d. mun.;2008;69;492;219;273
Klaipėda d. mun.;2008;70;485;197;288
Klaipėda d. mun.;2008;71;461;171;290
Klaipėda d. mun.;2008;72;449;181;268
Klaipėda d. mun.;2008;73;390;156;234
Klaipėda d. mun.;2008;74;376;145;231
Klaipėda d. mun.;2008;75;424;150;274
Klaipėda d. mun.;2008;76;408;146;262
Klaipėda d. mun.;2008;77;347;130;217
Klaipėda d. mun.;2008;78;299;99;200
Klaipėda d. mun.;2008;79;306;89;217
Klaipėda d. mun.;2008;80;251;81;170
Klaipėda d. mun.;2008;81;191;61;130
Klaipėda d. mun.;2008;82;173;51;122
Klaipėda d. mun.;2008;83;174;51;123
Klaipėda d. mun.;2008;84;174;52;122
Klaipėda d. mun.;2008;85;568;139;429
Klaipėda d. mun.;2009;-1;51690;25049;26641
Klaipėda d. mun.;2009;0;614;313;301
Klaipėda d. mun.;2009;1;601;298;303
Klaipėda d. mun.;2009;2;532;264;268
Klaipėda d. mun.;2009;3;493;249;244
Klaipėda d. mun.;2009;4;517;259;258
Klaipėda d. mun.;2009;5;537;276;261
Klaipėda d. mun.;2009;6;473;255;218
Klaipėda d. mun.;2009;7;512;256;256
Klaipėda d. mun.;2009;8;577;316;261
Klaipėda d. mun.;2009;9;686;375;311
Klaipėda d. mun.;2009;10;590;329;261
Klaipėda d. mun.;2009;11;610;314;296
Klaipėda d. mun.;2009;12;611;303;308
Klaipėda d. mun.;2009;13;636;348;288
Klaipėda d. mun.;2009;14;706;363;343
Klaipėda d. mun.;2009;15;815;422;393
Klaipėda d. mun.;2009;16;821;448;373
Klaipėda d. mun.;2009;17;915;506;409
Klaipėda d. mun.;2009;18;868;427;441
Klaipėda d. mun.;2009;19;802;398;404
Klaipėda d. mun.;2009;20;794;414;380
Klaipėda d. mun.;2009;21;798;421;377
Klaipėda d. mun.;2009;22;850;424;426
Klaipėda d. mun.;2009;23;827;419;408
Klaipėda d. mun.;2009;24;758;385;373
Klaipėda d. mun.;2009;25;815;398;417
Klaipėda d. mun.;2009;26;752;374;378
Klaipėda d. mun.;2009;27;642;336;306
Klaipėda d. mun.;2009;28;652;342;310
Klaipėda d. mun.;2009;29;641;331;310
Klaipėda d. mun.;2009;30;623;300;323
Klaipėda d. mun.;2009;31;697;354;343
Klaipėda d. mun.;2009;32;691;334;357
Klaipėda d. mun.;2009;33;674;347;327
Klaipėda d. mun.;2009;34;667;330;337
Klaipėda d. mun.;2009;35;687;347;340
Klaipėda d. mun.;2009;36;741;382;359
Klaipėda d. mun.;2009;37;805;409;396
Klaipėda d. mun.;2009;38;743;365;378
Klaipėda d. mun.;2009;39;807;426;381
Klaipėda d. mun.;2009;40;755;390;365
Klaipėda d. mun.;2009;41;748;383;365
Klaipėda d. mun.;2009;42;747;392;355
Klaipėda d. mun.;2009;43;729;384;345
Klaipėda d. mun.;2009;44;749;384;365
Klaipėda d. mun.;2009;45;754;364;390
Klaipėda d. mun.;2009;46;792;374;418
Klaipėda d. mun.;2009;47;844;439;405
Klaipėda d. mun.;2009;48;827;440;387
Klaipėda d. mun.;2009;49;832;418;414
Klaipėda d. mun.;2009;50;765;384;381
Klaipėda d. mun.;2009;51;786;417;369
Klaipėda d. mun.;2009;52;617;290;327
Klaipėda d. mun.;2009;53;601;315;286
Klaipėda d. mun.;2009;54;628;310;318
Klaipėda d. mun.;2009;55;583;277;306
Klaipėda d. mun.;2009;56;529;230;299
Klaipėda d. mun.;2009;57;500;256;244
Klaipėda d. mun.;2009;58;539;250;289
Klaipėda d. mun.;2009;59;549;277;272
Klaipėda d. mun.;2009;60;516;216;300
Klaipėda d. mun.;2009;61;452;205;247
Klaipėda d. mun.;2009;62;409;196;213
Klaipėda d. mun.;2009;63;421;198;223
Klaipėda d. mun.;2009;64;373;129;244
Klaipėda d. mun.;2009;65;389;162;227
Klaipėda d. mun.;2009;66;448;187;261
Klaipėda d. mun.;2009;67;531;228;303
Klaipėda d. mun.;2009;68;497;212;285
Klaipėda d. mun.;2009;69;525;216;309
Klaipėda d. mun.;2009;70;479;213;266
Klaipėda d. mun.;2009;71;477;190;287
Klaipėda d. mun.;2009;72;451;162;289
Klaipėda d. mun.;2009;73;444;176;268
Klaipėda d. mun.;2009;74;377;153;224
Klaipėda d. mun.;2009;75;363;132;231
Klaipėda d. mun.;2009;76;408;138;270
Klaipėda d. mun.;2009;77;399;137;262
Klaipėda d. mun.;2009;78;328;124;204
Klaipėda d. mun.;2009;79;281;89;192
Klaipėda d. mun.;2009;80;299;89;210
Klaipėda d. mun.;2009;81;227;69;158
Klaipėda d. mun.;2009;82;178;54;124
Klaipėda d. mun.;2009;83;155;46;109
Klaipėda d. mun.;2009;84;156;45;111
Klaipėda d. mun.;2009;85;653;152;501
Klaipėda d. mun.;2010;-1;51843;25122;26721
Klaipėda d. mun.;2010;0;612;324;288
Klaipėda d. mun.;2010;1;603;307;296
Klaipėda d. mun.;2010;2;554;274;280
Klaipėda d. mun.;2010;3;511;253;258
Klaipėda d. mun.;2010;4;498;254;244
Klaipėda d. mun.;2010;5;506;252;254
Klaipėda d. mun.;2010;6;540;283;257
Klaipėda d. mun.;2010;7;468;252;216
Klaipėda d. mun.;2010;8;515;251;264
Klaipėda d. mun.;2010;9;581;318;263
Klaipėda d. mun.;2010;10;691;379;312
Klaipėda d. mun.;2010;11;592;332;260
Klaipėda d. mun.;2010;12;616;313;303
Klaipėda d. mun.;2010;13;620;308;312
Klaipėda d. mun.;2010;14;642;352;290
Klaipėda d. mun.;2010;15;713;367;346
Klaipėda d. mun.;2010;16;823;424;399
Klaipėda d. mun.;2010;17;830;453;377
Klaipėda d. mun.;2010;18;925;510;415
Klaipėda d. mun.;2010;19;868;427;441
Klaipėda d. mun.;2010;20;803;399;404
Klaipėda d. mun.;2010;21;781;408;373
Klaipėda d. mun.;2010;22;776;413;363
Klaipėda d. mun.;2010;23;834;413;421
Klaipėda d. mun.;2010;24;812;410;402
Klaipėda d. mun.;2010;25;737;374;363
Klaipėda d. mun.;2010;26;808;395;413
Klaipėda d. mun.;2010;27;743;373;370
Klaipėda d. mun.;2010;28;633;330;303
Klaipėda d. mun.;2010;29;660;349;311
Klaipėda d. mun.;2010;30;625;332;293
Klaipėda d. mun.;2010;31;625;304;321
Klaipėda d. mun.;2010;32;692;355;337
Klaipėda d. mun.;2010;33;699;346;353
Klaipėda d. mun.;2010;34;672;342;330
Klaipėda d. mun.;2010;35;669;324;345
Klaipėda d. mun.;2010;36;686;348;338
Klaipėda d. mun.;2010;37;740;382;358
Klaipėda d. mun.;2010;38;809;407;402
Klaipėda d. mun.;2010;39;740;361;379
Klaipėda d. mun.;2010;40;811;426;385
Klaipėda d. mun.;2010;41;749;387;362
Klaipėda d. mun.;2010;42;747;380;367
Klaipėda d. mun.;2010;43;757;394;363
Klaipėda d. mun.;2010;44;734;384;350
Klaipėda d. mun.;2010;45;751;385;366
Klaipėda d. mun.;2010;46;754;360;394
Klaipėda d. mun.;2010;47;793;375;418
Klaipėda d. mun.;2010;48;841;434;407
Klaipėda d. mun.;2010;49;825;437;388
Klaipėda d. mun.;2010;50;831;416;415
Klaipėda d. mun.;2010;51;766;381;385
Klaipėda d. mun.;2010;52;795;420;375
Klaipėda d. mun.;2010;53;627;292;335
Klaipėda d. mun.;2010;54;605;315;290
Klaipėda d. mun.;2010;55;628;310;318
Klaipėda d. mun.;2010;56;583;274;309
Klaipėda d. mun.;2010;57;533;231;302
Klaipėda d. mun.;2010;58;502;256;246
Klaipėda d. mun.;2010;59;545;252;293
Klaipėda d. mun.;2010;60;546;271;275
Klaipėda d. mun.;2010;61;518;215;303
Klaipėda d. mun.;2010;62;454;203;251
Klaipėda d. mun.;2010;63;407;190;217
Klaipėda d. mun.;2010;64;411;187;224
Klaipėda d. mun.;2010;65;370;126;244
Klaipėda d. mun.;2010;66;385;157;228
Klaipėda d. mun.;2010;67;444;183;261
Klaipėda d. mun.;2010;68;527;221;306
Klaipėda d. mun.;2010;69;485;203;282
Klaipėda d. mun.;2010;70;513;207;306
Klaipėda d. mun.;2010;71;477;213;264
Klaipėda d. mun.;2010;72;470;182;288
Klaipėda d. mun.;2010;73;436;152;284
Klaipėda d. mun.;2010;74;438;173;265
Klaipėda d. mun.;2010;75;365;148;217
Klaipėda d. mun.;2010;76;349;125;224
Klaipėda d. mun.;2010;77;396;134;262
Klaipėda d. mun.;2010;78;373;122;251
Klaipėda d. mun.;2010;79;316;119;197
Klaipėda d. mun.;2010;80;268;84;184
Klaipėda d. mun.;2010;81;287;86;201
Klaipėda d. mun.;2010;82;210;61;149
Klaipėda d. mun.;2010;83;170;50;120
Klaipėda d. mun.;2010;84;148;45;103
Klaipėda d. mun.;2010;85;651;158;493
Klaipėda d. mun.;2011;-1;51279;24845;26434
Klaipėda d. mun.;2011;0;655;340;315
Klaipėda d. mun.;2011;1;675;343;332
Klaipėda d. mun.;2011;2;654;332;322
Klaipėda d. mun.;2011;3;606;301;305
Klaipėda d. mun.;2011;4;573;294;279
Klaipėda d. mun.;2011;5;560;269;291
Klaipėda d. mun.;2011;6;547;283;264
Klaipėda d. mun.;2011;7;559;295;264
Klaipėda d. mun.;2011;8;506;267;239
Klaipėda d. mun.;2011;9;551;274;277
Klaipėda d. mun.;2011;10;631;354;277
Klaipėda d. mun.;2011;11;709;380;329
Klaipėda d. mun.;2011;12;647;353;294
Klaipėda d. mun.;2011;13;610;305;305
Klaipėda d. mun.;2011;14;619;305;314
Klaipėda d. mun.;2011;15;675;369;306
Klaipėda d. mun.;2011;16;722;377;345
Klaipėda d. mun.;2011;17;819;419;400
Klaipėda d. mun.;2011;18;855;474;381
Klaipėda d. mun.;2011;19;799;465;334
Klaipėda d. mun.;2011;20;736;381;355
Klaipėda d. mun.;2011;21;680;349;331
Klaipėda d. mun.;2011;22;637;339;298
Klaipėda d. mun.;2011;23;639;350;289
Klaipėda d. mun.;2011;24;674;343;331
Klaipėda d. mun.;2011;25;685;341;344
Klaipėda d. mun.;2011;26;615;316;299
Klaipėda d. mun.;2011;27;668;327;341
Klaipėda d. mun.;2011;28;667;314;353
Klaipėda d. mun.;2011;29;665;332;333
Klaipėda d. mun.;2011;30;683;350;333
Klaipėda d. mun.;2011;31;668;335;333
Klaipėda d. mun.;2011;32;686;333;353
Klaipėda d. mun.;2011;33;721;359;362
Klaipėda d. mun.;2011;34;757;365;392
Klaipėda d. mun.;2011;35;710;350;360
Klaipėda d. mun.;2011;36;675;331;344
Klaipėda d. mun.;2011;37;732;380;352
Klaipėda d. mun.;2011;38;788;400;388
Klaipėda d. mun.;2011;39;830;419;411
Klaipėda d. mun.;2011;40;792;380;412
Klaipėda d. mun.;2011;41;808;434;374
Klaipėda d. mun.;2011;42;768;395;373
Klaipėda d. mun.;2011;43;764;393;371
Klaipėda d. mun.;2011;44;761;391;370
Klaipėda d. mun.;2011;45;741;382;359
Klaipėda d. mun.;2011;46;755;388;367
Klaipėda d. mun.;2011;47;776;363;413
Klaipėda d. mun.;2011;48;831;406;425
Klaipėda d. mun.;2011;49;857;442;415
Klaipėda d. mun.;2011;50;802;419;383
Klaipėda d. mun.;2011;51;841;415;426
Klaipėda d. mun.;2011;52;751;376;375
Klaipėda d. mun.;2011;53;775;411;364
Klaipėda d. mun.;2011;54;624;288;336
Klaipėda d. mun.;2011;55;602;304;298
Klaipėda d. mun.;2011;56;577;285;292
Klaipėda d. mun.;2011;57;565;257;308
Klaipėda d. mun.;2011;58;550;241;309
Klaipėda d. mun.;2011;59;515;265;250
Klaipėda d. mun.;2011;60;536;241;295
Klaipėda d. mun.;2011;61;498;230;268
Klaipėda d. mun.;2011;62;504;210;294
Klaipėda d. mun.;2011;63;456;205;251
Klaipėda d. mun.;2011;64;399;187;212
Klaipėda d. mun.;2011;65;398;174;224
Klaipėda d. mun.;2011;66;353;118;235
Klaipėda d. mun.;2011;67;383;158;225
Klaipėda d. mun.;2011;68;422;185;237
Klaipėda d. mun.;2011;69;475;202;273
Klaipėda d. mun.;2011;70;454;188;266
Klaipėda d. mun.;2011;71;455;166;289
Klaipėda d. mun.;2011;72;426;182;244
Klaipėda d. mun.;2011;73;431;168;263
Klaipėda d. mun.;2011;74;382;119;263
Klaipėda d. mun.;2011;75;373;143;230
Klaipėda d. mun.;2011;76;329;127;202
Klaipėda d. mun.;2011;77;310;105;205
Klaipėda d. mun.;2011;78;331;106;225
Klaipėda d. mun.;2011;79;325;100;225
Klaipėda d. mun.;2011;80;267;95;172
Klaipėda d. mun.;2011;81;231;77;154
Klaipėda d. mun.;2011;82;244;67;177
Klaipėda d. mun.;2011;83;178;48;130
Klaipėda d. mun.;2011;84;146;39;107
Klaipėda d. mun.;2011;85;630;157;473
Klaipėda d. mun.;2012;-1;51405;24914;26491
Klaipėda d. mun.;2012;0;547;272;275
Klaipėda d. mun.;2012;1;646;336;310
Klaipėda d. mun.;2012;2;666;334;332
Klaipėda d. mun.;2012;3;634;323;311
Klaipėda d. mun.;2012;4;613;303;310
Klaipėda d. mun.;2012;5;579;303;276
Klaipėda d. mun.;2012;6;560;269;291
Klaipėda d. mun.;2012;7;550;285;265
Klaipėda d. mun.;2012;8;562;299;263
Klaipėda d. mun.;2012;9;511;272;239
Klaipėda d. mun.;2012;10;556;279;277
Klaipėda d. mun.;2012;11;635;358;277
Klaipėda d. mun.;2012;12;715;383;332
Klaipėda d. mun.;2012;13;649;351;298
Klaipėda d. mun.;2012;14;617;306;311
Klaipėda d. mun.;2012;15;618;308;310
Klaipėda d. mun.;2012;16;685;377;308
Klaipėda d. mun.;2012;17;731;385;346
Klaipėda d. mun.;2012;18;828;426;402
Klaipėda d. mun.;2012;19;836;466;370
Klaipėda d. mun.;2012;20;803;465;338
Klaipėda d. mun.;2012;21;726;370;356
Klaipėda d. mun.;2012;22;662;342;320
Klaipėda d. mun.;2012;23;617;325;292
Klaipėda d. mun.;2012;24;627;351;276
Klaipėda d. mun.;2012;25;669;338;331
Klaipėda d. mun.;2012;26;669;333;336
Klaipėda d. mun.;2012;27;603;309;294
Klaipėda d. mun.;2012;28;659;329;330
Klaipėda d. mun.;2012;29;652;308;344
Klaipėda d. mun.;2012;30;642;321;321
Klaipėda d. mun.;2012;31;692;355;337
Klaipėda d. mun.;2012;32;665;337;328
Klaipėda d. mun.;2012;33;698;341;357
Klaipėda d. mun.;2012;34;722;365;357
Klaipėda d. mun.;2012;35;752;365;387
Klaipėda d. mun.;2012;36;714;350;364
Klaipėda d. mun.;2012;37;679;335;344
Klaipėda d. mun.;2012;38;748;387;361
Klaipėda d. mun.;2012;39;793;405;388
Klaipėda d. mun.;2012;40;841;422;419
Klaipėda d. mun.;2012;41;807;386;421
Klaipėda d. mun.;2012;42;810;424;386
Klaipėda d. mun.;2012;43;772;393;379
Klaipėda d. mun.;2012;44;762;394;368
Klaipėda d. mun.;2012;45;755;385;370
Klaipėda d. mun.;2012;46;736;381;355
Klaipėda d. mun.;2012;47;760;394;366
Klaipėda d. mun.;2012;48;775;361;414
Klaipėda d. mun.;2012;49;841;413;428
Klaipėda d. mun.;2012;50;859;442;417
Klaipėda d. mun.;2012;51;807;427;380
Klaipėda d. mun.;2012;52;840;418;422
Klaipėda d. mun.;2012;53;753;375;378
Klaipėda d. mun.;2012;54;764;401;363
Klaipėda d. mun.;2012;55;637;295;342
Klaipėda d. mun.;2012;56;594;296;298
Klaipėda d. mun.;2012;57;577;280;297
Klaipėda d. mun.;2012;58;560;250;310
Klaipėda d. mun.;2012;59;551;241;310
Klaipėda d. mun.;2012;60;516;261;255
Klaipėda d. mun.;2012;61;531;238;293
Klaipėda d. mun.;2012;62;499;232;267
Klaipėda d. mun.;2012;63;493;205;288
Klaipėda d. mun.;2012;64;457;206;251
Klaipėda d. mun.;2012;65;394;185;209
Klaipėda d. mun.;2012;66;399;173;226
Klaipėda d. mun.;2012;67;346;114;232
Klaipėda d. mun.;2012;68;383;157;226
Klaipėda d. mun.;2012;69;412;179;233
Klaipėda d. mun.;2012;70;454;190;264
Klaipėda d. mun.;2012;71;443;180;263
Klaipėda d. mun.;2012;72;452;163;289
Klaipėda d. mun.;2012;73;409;170;239
Klaipėda d. mun.;2012;74;419;158;261
Klaipėda d. mun.;2012;75;374;113;261
Klaipėda d. mun.;2012;76;351;126;225
Klaipėda d. mun.;2012;77;313;120;193
Klaipėda d. mun.;2012;78;294;96;198
Klaipėda d. mun.;2012;79;312;94;218
Klaipėda d. mun.;2012;80;311;93;218
Klaipėda d. mun.;2012;81;240;79;161
Klaipėda d. mun.;2012;82;214;70;144
Klaipėda d. mun.;2012;83;234;66;168
Klaipėda d. mun.;2012;84;154;39;115
Klaipėda d. mun.;2012;85;670;163;507
Klaipėda d. mun.;2013;-1;51614;25091;26523
Klaipėda d. mun.;2013;0;520;284;236
Klaipėda d. mun.;2013;1;522;255;267
Klaipėda d. mun.;2013;2;644;336;308
Klaipėda d. mun.;2013;3;664;331;333
Klaipėda d. mun.;2013;4;629;323;306
Klaipėda d. mun.;2013;5;607;299;308
Klaipėda d. mun.;2013;6;576;302;274
Klaipėda d. mun.;2013;7;563;272;291
Klaipėda d. mun.;2013;8;557;290;267
Klaipėda d. mun.;2013;9;576;309;267
Klaipėda d. mun.;2013;10;517;274;243
Klaipėda d. mun.;2013;11;562;286;276
Klaipėda d. mun.;2013;12;641;359;282
Klaipėda d. mun.;2013;13;721;382;339
Klaipėda d. mun.;2013;14;656;359;297
Klaipėda d. mun.;2013;15;614;305;309
Klaipėda d. mun.;2013;16;620;312;308
Klaipėda d. mun.;2013;17;688;375;313
Klaipėda d. mun.;2013;18;737;390;347
Klaipėda d. mun.;2013;19;816;425;391
Klaipėda d. mun.;2013;20;824;457;367
Klaipėda d. mun.;2013;21;785;461;324
Klaipėda d. mun.;2013;22;735;379;356
Klaipėda d. mun.;2013;23;639;327;312
Klaipėda d. mun.;2013;24;602;326;276
Klaipėda d. mun.;2013;25;610;344;266
Klaipėda d. mun.;2013;26;648;337;311
Klaipėda d. mun.;2013;27;660;326;334
Klaipėda d. mun.;2013;28;596;306;290
Klaipėda d. mun.;2013;29;671;339;332
Klaipėda d. mun.;2013;30;653;307;346
Klaipėda d. mun.;2013;31;653;328;325
Klaipėda d. mun.;2013;32;691;349;342
Klaipėda d. mun.;2013;33;652;342;310
Klaipėda d. mun.;2013;34;708;346;362
Klaipėda d. mun.;2013;35;745;378;367
Klaipėda d. mun.;2013;36;758;370;388
Klaipėda d. mun.;2013;37;719;355;364
Klaipėda d. mun.;2013;38;691;344;347
Klaipėda d. mun.;2013;39;756;394;362
Klaipėda d. mun.;2013;40;805;410;395
Klaipėda d. mun.;2013;41;848;421;427
Klaipėda d. mun.;2013;42;813;388;425
Klaipėda d. mun.;2013;43;817;426;391
Klaipėda d. mun.;2013;44;779;395;384
Klaipėda d. mun.;2013;45;775;405;370
Klaipėda d. mun.;2013;46;758;389;369
Klaipėda d. mun.;2013;47;738;381;357
Klaipėda d. mun.;2013;48;762;398;364
Klaipėda d. mun.;2013;49;787;368;419
Klaipėda d. mun.;2013;50;845;411;434
Klaipėda d. mun.;2013;51;866;444;422
Klaipėda d. mun.;2013;52;810;425;385
Klaipėda d. mun.;2013;53;842;417;425
Klaipėda d. mun.;2013;54;748;372;376
Klaipėda d. mun.;2013;55;763;397;366
Klaipėda d. mun.;2013;56;639;293;346
Klaipėda d. mun.;2013;57;592;292;300
Klaipėda d. mun.;2013;58;579;283;296
Klaipėda d. mun.;2013;59;573;258;315
Klaipėda d. mun.;2013;60;547;238;309
Klaipėda d. mun.;2013;61;508;259;249
Klaipėda d. mun.;2013;62;524;233;291
Klaipėda d. mun.;2013;63;501;228;273
Klaipėda d. mun.;2013;64;489;201;288
Klaipėda d. mun.;2013;65;452;202;250
Klaipėda d. mun.;2013;66;391;180;211
Klaipėda d. mun.;2013;67;395;171;224
Klaipėda d. mun.;2013;68;348;111;237
Klaipėda d. mun.;2013;69;375;155;220
Klaipėda d. mun.;2013;70;405;172;233
Klaipėda d. mun.;2013;71;442;183;259
Klaipėda d. mun.;2013;72;438;178;260
Klaipėda d. mun.;2013;73;429;149;280
Klaipėda d. mun.;2013;74;388;158;230
Klaipėda d. mun.;2013;75;410;154;256
Klaipėda d. mun.;2013;76;362;107;255
Klaipėda d. mun.;2013;77;334;119;215
Klaipėda d. mun.;2013;78;297;108;189
Klaipėda d. mun.;2013;79;278;89;189
Klaipėda d. mun.;2013;80;299;85;214
Klaipėda d. mun.;2013;81;298;87;211
Klaipėda d. mun.;2013;82;223;73;150
Klaipėda d. mun.;2013;83;195;61;134
Klaipėda d. mun.;2013;84;214;58;156
Klaipėda d. mun.;2013;85;707;176;531
Klaipėda d. mun.;2014;-1;52110;25376;26734
Klaipėda d. mun.;2014;0;626;314;312
Klaipėda d. mun.;2014;1;517;284;233
Klaipėda d. mun.;2014;2;525;260;265
Klaipėda d. mun.;2014;3;647;342;305
Klaipėda d. mun.;2014;4;676;343;333
Klaipėda d. mun.;2014;5;638;319;319
Klaipėda d. mun.;2014;6;616;300;316
Klaipėda d. mun.;2014;7;594;315;279
Klaipėda d. mun.;2014;8;567;273;294
Klaipėda d. mun.;2014;9;569;302;267
Klaipėda d. mun.;2014;10;590;316;274
Klaipėda d. mun.;2014;11;520;277;243
Klaipėda d. mun.;2014;12;564;287;277
Klaipėda d. mun.;2014;13;650;362;288
Klaipėda d. mun.;2014;14;730;382;348
Klaipėda d. mun.;2014;15;641;355;286
Klaipėda d. mun.;2014;16;625;310;315
Klaipėda d. mun.;2014;17;622;313;309
Klaipėda d. mun.;2014;18;692;377;315
Klaipėda d. mun.;2014;19;729;388;341
Klaipėda d. mun.;2014;20;806;420;386
Klaipėda d. mun.;2014;21;813;455;358
Klaipėda d. mun.;2014;22;777;458;319
Klaipėda d. mun.;2014;23;720;372;348
Klaipėda d. mun.;2014;24;640;332;308
Klaipėda d. mun.;2014;25;590;317;273
Klaipėda d. mun.;2014;26;605;340;265
Klaipėda d. mun.;2014;27;637;334;303
Klaipėda d. mun.;2014;28;667;334;333
Klaipėda d. mun.;2014;29;596;308;288
Klaipėda d. mun.;2014;30;665;341;324
Klaipėda d. mun.;2014;31;674;320;354
Klaipėda d. mun.;2014;32;681;344;337
Klaipėda d. mun.;2014;33;714;352;362
Klaipėda d. mun.;2014;34;670;352;318
Klaipėda d. mun.;2014;35;718;352;366
Klaipėda d. mun.;2014;36;764;390;374
Klaipėda d. mun.;2014;37;762;373;389
Klaipėda d. mun.;2014;38;714;356;358
Klaipėda d. mun.;2014;39;690;345;345
Klaipėda d. mun.;2014;40;756;391;365
Klaipėda d. mun.;2014;41;807;415;392
Klaipėda d. mun.;2014;42;849;435;414
Klaipėda d. mun.;2014;43;819;389;430
Klaipėda d. mun.;2014;44;832;436;396
Klaipėda d. mun.;2014;45;789;402;387
Klaipėda d. mun.;2014;46;785;410;375
Klaipėda d. mun.;2014;47;756;382;374
Klaipėda d. mun.;2014;48;734;376;358
Klaipėda d. mun.;2014;49;775;402;373
Klaipėda d. mun.;2014;50;796;373;423
Klaipėda d. mun.;2014;51;846;407;439
Klaipėda d. mun.;2014;52;873;444;429
Klaipėda d. mun.;2014;53;812;423;389
Klaipėda d. mun.;2014;54;848;412;436
Klaipėda d. mun.;2014;55;760;380;380
Klaipėda d. mun.;2014;56;756;393;363
Klaipėda d. mun.;2014;57;647;294;353
Klaipėda d. mun.;2014;58;588;285;303
Klaipėda d. mun.;2014;59;591;286;305
Klaipėda d. mun.;2014;60;570;254;316
Klaipėda d. mun.;2014;61;537;231;306
Klaipėda d. mun.;2014;62;514;262;252
Klaipėda d. mun.;2014;63;529;235;294
Klaipėda d. mun.;2014;64;503;226;277
Klaipėda d. mun.;2014;65;483;196;287
Klaipėda d. mun.;2014;66;442;193;249
Klaipėda d. mun.;2014;67;393;180;213
Klaipėda d. mun.;2014;68;392;171;221
Klaipėda d. mun.;2014;69;340;104;236
Klaipėda d. mun.;2014;70;369;150;219
Klaipėda d. mun.;2014;71;397;170;227
Klaipėda d. mun.;2014;72;431;177;254
Klaipėda d. mun.;2014;73;432;174;258
Klaipėda d. mun.;2014;74;412;144;268
Klaipėda d. mun.;2014;75;380;154;226
Klaipėda d. mun.;2014;76;398;145;253
Klaipėda d. mun.;2014;77;345;97;248
Klaipėda d. mun.;2014;78;320;113;207
Klaipėda d. mun.;2014;79;281;100;181
Klaipėda d. mun.;2014;80;262;81;181
Klaipėda d. mun.;2014;81;285;79;206
Klaipėda d. mun.;2014;82;276;75;201
Klaipėda d. mun.;2014;83;204;63;141
Klaipėda d. mun.;2014;84;186;57;129
Klaipėda d. mun.;2014;85;769;196;573
Klaipėda d. mun.;2015;-1;52831;25790;27041
Klaipėda d. mun.;2015;0;558;289;269
Klaipėda d. mun.;2015;1;608;302;306
Klaipėda d. mun.;2015;2;510;282;228
Klaipėda d. mun.;2015;3;523;258;265
Klaipėda d. mun.;2015;4;649;348;301
Klaipėda d. mun.;2015;5;681;345;336
Klaipėda d. mun.;2015;6;638;320;318
Klaipėda d. mun.;2015;7;622;297;325
Klaipėda d. mun.;2015;8;618;326;292
Klaipėda d. mun.;2015;9;581;285;296
Klaipėda d. mun.;2015;10;578;307;271
Klaipėda d. mun.;2015;11;592;318;274
Klaipėda d. mun.;2015;12;524;282;242
Klaipėda d. mun.;2015;13;573;289;284
Klaipėda d. mun.;2015;14;666;370;296
Klaipėda d. mun.;2015;15;714;373;341
Klaipėda d. mun.;2015;16;673;371;302
Klaipėda d. mun.;2015;17;640;320;320
Klaipėda d. mun.;2015;18;625;313;312
Klaipėda d. mun.;2015;19;692;375;317
Klaipėda d. mun.;2015;20;719;381;338
Klaipėda d. mun.;2015;21;814;427;387
Klaipėda d. mun.;2015;22;801;447;354
Klaipėda d. mun.;2015;23;747;448;299
Klaipėda d. mun.;2015;24;713;369;344
Klaipėda d. mun.;2015;25;643;333;310
Klaipėda d. mun.;2015;26;583;311;272
Klaipėda d. mun.;2015;27;597;341;256
Klaipėda d. mun.;2015;28;635;349;286
Klaipėda d. mun.;2015;29;686;341;345
Klaipėda d. mun.;2015;30;616;327;289
Klaipėda d. mun.;2015;31;669;347;322
Klaipėda d. mun.;2015;32;695;331;364
Klaipėda d. mun.;2015;33;698;356;342
Klaipėda d. mun.;2015;34;725;363;362
Klaipėda d. mun.;2015;35;691;362;329
Klaipėda d. mun.;2015;36;730;360;370
Klaipėda d. mun.;2015;37;763;389;374
Klaipėda d. mun.;2015;38;787;385;402
Klaipėda d. mun.;2015;39;742;373;369
Klaipėda d. mun.;2015;40;709;362;347
Klaipėda d. mun.;2015;41;778;402;376
Klaipėda d. mun.;2015;42;827;423;404
Klaipėda d. mun.;2015;43;858;436;422
Klaipėda d. mun.;2015;44;849;405;444
Klaipėda d. mun.;2015;45;843;442;401
Klaipėda d. mun.;2015;46;805;409;396
Klaipėda d. mun.;2015;47;806;424;382
Klaipėda d. mun.;2015;48;773;388;385
Klaipėda d. mun.;2015;49;749;383;366
Klaipėda d. mun.;2015;50;779;405;374
Klaipėda d. mun.;2015;51;815;381;434
Klaipėda d. mun.;2015;52;854;404;450
Klaipėda d. mun.;2015;53;885;451;434
Klaipėda d. mun.;2015;54;826;427;399
Klaipėda d. mun.;2015;55;869;421;448
Klaipėda d. mun.;2015;56;775;385;390
Klaipėda d. mun.;2015;57;763;397;366
Klaipėda d. mun.;2015;58;650;294;356
Klaipėda d. mun.;2015;59;603;296;307
Klaipėda d. mun.;2015;60;603;293;310
Klaipėda d. mun.;2015;61;568;249;319
Klaipėda d. mun.;2015;62;526;226;300
Klaipėda d. mun.;2015;63;509;254;255
Klaipėda d. mun.;2015;64;527;234;293
Klaipėda d. mun.;2015;65;503;224;279
Klaipėda d. mun.;2015;66;479;194;285
Klaipėda d. mun.;2015;67;441;193;248
Klaipėda d. mun.;2015;68;393;178;215
Klaipėda d. mun.;2015;69;388;168;220
Klaipėda d. mun.;2015;70;338;103;235
Klaipėda d. mun.;2015;71;361;146;215
Klaipėda d. mun.;2015;72;387;165;222
Klaipėda d. mun.;2015;73;415;170;245
Klaipėda d. mun.;2015;74;410;165;245
Klaipėda d. mun.;2015;75;404;139;265
Klaipėda d. mun.;2015;76;364;143;221
Klaipėda d. mun.;2015;77;387;137;250
Klaipėda d. mun.;2015;78;339;92;247
Klaipėda d. mun.;2015;79;306;107;199
Klaipėda d. mun.;2015;80;265;91;174
Klaipėda d. mun.;2015;81;249;72;177
Klaipėda d. mun.;2015;82;258;69;189
Klaipėda d. mun.;2015;83;251;65;186
Klaipėda d. mun.;2015;84;183;54;129
Klaipėda d. mun.;2015;85;842;214;628
Klaipėda d. mun.;2016;-1;53459;26166;27293
Klaipėda d. mun.;2016;0;563;287;276
Klaipėda d. mun.;2016;1;562;293;269
Klaipėda d. mun.;2016;2;590;299;291
Klaipėda d. mun.;2016;3;532;294;238
Klaipėda d. mun.;2016;4;522;256;266
Klaipėda d. mun.;2016;5;659;353;306
Klaipėda d. mun.;2016;6;676;346;330
Klaipėda d. mun.;2016;7;647;321;326
Klaipėda d. mun.;2016;8;641;306;335
Klaipėda d. mun.;2016;9;634;334;300
Klaipėda d. mun.;2016;10;582;280;302
Klaipėda d. mun.;2016;11;585;317;268
Klaipėda d. mun.;2016;12;605;324;281
Klaipėda d. mun.;2016;13;532;288;244
Klaipėda d. mun.;2016;14;572;285;287
Klaipėda d. mun.;2016;15;656;369;287
Klaipėda d. mun.;2016;16;720;368;352
Klaipėda d. mun.;2016;17;687;380;307
Klaipėda d. mun.;2016;18;637;323;314
Klaipėda d. mun.;2016;19;623;312;311
Klaipėda d. mun.;2016;20;687;372;315
Klaipėda d. mun.;2016;21;716;383;333
Klaipėda d. mun.;2016;22;795;415;380
Klaipėda d. mun.;2016;23;770;438;332
Klaipėda d. mun.;2016;24;741;440;301
Klaipėda d. mun.;2016;25;695;352;343
Klaipėda d. mun.;2016;26;647;330;317
Klaipėda d. mun.;2016;27;578;304;274
Klaipėda d. mun.;2016;28;594;335;259
Klaipėda d. mun.;2016;29;654;366;288
Klaipėda d. mun.;2016;30;700;348;352
Klaipėda d. mun.;2016;31;642;343;299
Klaipėda d. mun.;2016;32;695;370;325
Klaipėda d. mun.;2016;33;703;343;360
Klaipėda d. mun.;2016;34;711;371;340
Klaipėda d. mun.;2016;35;718;366;352
Klaipėda d. mun.;2016;36;700;361;339
Klaipėda d. mun.;2016;37;735;368;367
Klaipėda d. mun.;2016;38;774;398;376
Klaipėda d. mun.;2016;39;810;404;406
Klaipėda d. mun.;2016;40;761;392;369
Klaipėda d. mun.;2016;41;708;365;343
Klaipėda d. mun.;2016;42;801;414;387
Klaipėda d. mun.;2016;43;848;434;414
Klaipėda d. mun.;2016;44;875;447;428
Klaipėda d. mun.;2016;45;857;407;450
Klaipėda d. mun.;2016;46;854;451;403
Klaipėda d. mun.;2016;47;814;416;398
Klaipėda d. mun.;2016;48;821;431;390
Klaipėda d. mun.;2016;49;788;397;391
Klaipėda d. mun.;2016;50;766;393;373
Klaipėda d. mun.;2016;51;796;419;377
Klaipėda d. mun.;2016;52;829;382;447
Klaipėda d. mun.;2016;53;859;403;456
Klaipėda d. mun.;2016;54;898;460;438
Klaipėda d. mun.;2016;55;835;425;410
Klaipėda d. mun.;2016;56;873;418;455
Klaipėda d. mun.;2016;57;789;390;399
Klaipėda d. mun.;2016;58;776;404;372
Klaipėda d. mun.;2016;59;649;295;354
Klaipėda d. mun.;2016;60;608;303;305
Klaipėda d. mun.;2016;61;607;289;318
Klaipėda d. mun.;2016;62;563;241;322
Klaipėda d. mun.;2016;63;533;228;305
Klaipėda d. mun.;2016;64;516;257;259
Klaipėda d. mun.;2016;65;518;226;292
Klaipėda d. mun.;2016;66;497;218;279
Klaipėda d. mun.;2016;67;481;192;289
Klaipėda d. mun.;2016;68;442;197;245
Klaipėda d. mun.;2016;69;384;171;213
Klaipėda d. mun.;2016;70;386;164;222
Klaipėda d. mun.;2016;71;325;97;228
Klaipėda d. mun.;2016;72;359;144;215
Klaipėda d. mun.;2016;73;382;163;219
Klaipėda d. mun.;2016;74;407;163;244
Klaipėda d. mun.;2016;75;398;159;239
Klaipėda d. mun.;2016;76;384;130;254
Klaipėda d. mun.;2016;77;354;136;218
Klaipėda d. mun.;2016;78;372;125;247
Klaipėda d. mun.;2016;79;328;89;239
Klaipėda d. mun.;2016;80;294;100;194
Klaipėda d. mun.;2016;81;254;82;172
Klaipėda d. mun.;2016;82;236;65;171
Klaipėda d. mun.;2016;83;240;65;175
Klaipėda d. mun.;2016;84;236;59;177
Klaipėda d. mun.;2016;85;868;218;650
Klaipėda d. mun.;2017;-1;54635;26934;27701
Klaipėda d. mun.;2017;0;558;284;274
Klaipėda d. mun.;2017;1;559;283;276
Klaipėda d. mun.;2017;2;584;307;277
Klaipėda d. mun.;2017;3;602;302;300
Klaipėda d. mun.;2017;4;563;320;243
Klaipėda d. mun.;2017;5;550;263;287
Klaipėda d. mun.;2017;6;658;350;308
Klaipėda d. mun.;2017;7;713;373;340
Klaipėda d. mun.;2017;8;675;336;339
Klaipėda d. mun.;2017;9;657;318;339
Klaipėda d. mun.;2017;10;644;340;304
Klaipėda d. mun.;2017;11;613;302;311
Klaipėda d. mun.;2017;12;594;322;272
Klaipėda d. mun.;2017;13;606;325;281
Klaipėda d. mun.;2017;14;538;293;245
Klaipėda d. mun.;2017;15;575;282;293
Klaipėda d. mun.;2017;16;668;370;298
Klaipėda d. mun.;2017;17;735;376;359
Klaipėda d. mun.;2017;18;694;382;312
Klaipėda d. mun.;2017;19;633;318;315
Klaipėda d. mun.;2017;20;602;297;305
Klaipėda d. mun.;2017;21;683;369;314
Klaipėda d. mun.;2017;22;714;375;339
Klaipėda d. mun.;2017;23;760;400;360
Klaipėda d. mun.;2017;24;775;441;334
Klaipėda d. mun.;2017;25;740;431;309
Klaipėda d. mun.;2017;26;712;367;345
Klaipėda d. mun.;2017;27;663;350;313
Klaipėda d. mun.;2017;28;609;324;285
Klaipėda d. mun.;2017;29;621;344;277
Klaipėda d. mun.;2017;30;684;383;301
Klaipėda d. mun.;2017;31;722;363;359
Klaipėda d. mun.;2017;32;667;366;301
Klaipėda d. mun.;2017;33;730;394;336
Klaipėda d. mun.;2017;34;717;348;369
Klaipėda d. mun.;2017;35;725;382;343
Klaipėda d. mun.;2017;36;734;372;362
Klaipėda d. mun.;2017;37;742;388;354
Klaipėda d. mun.;2017;38;765;389;376
Klaipėda d. mun.;2017;39;801;424;377
Klaipėda d. mun.;2017;40;832;420;412
Klaipėda d. mun.;2017;41;791;417;374
Klaipėda d. mun.;2017;42;740;381;359
Klaipėda d. mun.;2017;43;822;432;390
Klaipėda d. mun.;2017;44;873;460;413
Klaipėda d. mun.;2017;45;902;472;430
Klaipėda d. mun.;2017;46;881;431;450
Klaipėda d. mun.;2017;47;871;463;408
Klaipėda d. mun.;2017;48;833;432;401
Klaipėda d. mun.;2017;49;841;443;398
Klaipėda d. mun.;2017;50;804;409;395
Klaipėda d. mun.;2017;51;775;401;374
Klaipėda d. mun.;2017;52;828;431;397
Klaipėda d. mun.;2017;53;853;397;456
Klaipėda d. mun.;2017;54;877;418;459
Klaipėda d. mun.;2017;55;910;468;442
Klaipėda d. mun.;2017;56;845;426;419
Klaipėda d. mun.;2017;57;885;427;458
Klaipėda d. mun.;2017;58;800;398;402
Klaipėda d. mun.;2017;59;791;411;380
Klaipėda d. mun.;2017;60;653;297;356
Klaipėda d. mun.;2017;61;602;298;304
Klaipėda d. mun.;2017;62;607;288;319
Klaipėda d. mun.;2017;63;566;241;325
Klaipėda d. mun.;2017;64;543;233;310
Klaipėda d. mun.;2017;65;519;260;259
Klaipėda d. mun.;2017;66;516;226;290
Klaipėda d. mun.;2017;67;489;214;275
Klaipėda d. mun.;2017;68;479;190;289
Klaipėda d. mun.;2017;69;444;197;247
Klaipėda d. mun.;2017;70;379;168;211
Klaipėda d. mun.;2017;71;377;160;217
Klaipėda d. mun.;2017;72;321;94;227
Klaipėda d. mun.;2017;73;359;141;218
Klaipėda d. mun.;2017;74;375;159;216
Klaipėda d. mun.;2017;75;398;160;238
Klaipėda d. mun.;2017;76;383;151;232
Klaipėda d. mun.;2017;77;374;123;251
Klaipėda d. mun.;2017;78;342;132;210
Klaipėda d. mun.;2017;79;360;120;240
Klaipėda d. mun.;2017;80;317;84;233
Klaipėda d. mun.;2017;81;275;91;184
Klaipėda d. mun.;2017;82;237;73;164
Klaipėda d. mun.;2017;83;217;56;161
Klaipėda d. mun.;2017;84;220;60;160
Klaipėda d. mun.;2017;85;944;228;716
Klaipėda d. mun.;2018;-1;56131;28048;28083
Klaipėda d. mun.;2018;0;593;315;278
Klaipėda d. mun.;2018;1;559;281;278
Klaipėda d. mun.;2018;2;560;284;276
Klaipėda d. mun.;2018;3;612;327;285
Klaipėda d. mun.;2018;4;638;321;317
Klaipėda d. mun.;2018;5;602;327;275
Klaipėda d. mun.;2018;6;542;255;287
Klaipėda d. mun.;2018;7;696;361;335
Klaipėda d. mun.;2018;8;770;409;361
Klaipėda d. mun.;2018;9;683;342;341
Klaipėda d. mun.;2018;10;654;324;330
Klaipėda d. mun.;2018;11;663;345;318
Klaipėda d. mun.;2018;12;632;311;321
Klaipėda d. mun.;2018;13;599;320;279
Klaipėda d. mun.;2018;14;615;329;286
Klaipėda d. mun.;2018;15;542;294;248
Klaipėda d. mun.;2018;16;587;292;295
Klaipėda d. mun.;2018;17;683;376;307
Klaipėda d. mun.;2018;18;744;381;363
Klaipėda d. mun.;2018;19;659;367;292
Klaipėda d. mun.;2018;20;610;303;307
Klaipėda d. mun.;2018;21;590;292;298
Klaipėda d. mun.;2018;22;657;360;297
Klaipėda d. mun.;2018;23;681;363;318
Klaipėda d. mun.;2018;24;725;379;346
Klaipėda d. mun.;2018;25;760;423;337
Klaipėda d. mun.;2018;26;735;429;306
Klaipėda d. mun.;2018;27;701;369;332
Klaipėda d. mun.;2018;28;691;365;326
Klaipėda d. mun.;2018;29;629;341;288
Klaipėda d. mun.;2018;30;684;387;297
Klaipėda d. mun.;2018;31;726;413;313
Klaipėda d. mun.;2018;32;770;409;361
Klaipėda d. mun.;2018;33;706;397;309
Klaipėda d. mun.;2018;34;795;440;355
Klaipėda d. mun.;2018;35;751;384;367
Klaipėda d. mun.;2018;36;763;417;346
Klaipėda d. mun.;2018;37;790;418;372
Klaipėda d. mun.;2018;38;774;411;363
Klaipėda d. mun.;2018;39;815;423;392
Klaipėda d. mun.;2018;40;835;456;379
Klaipėda d. mun.;2018;41;860;452;408
Klaipėda d. mun.;2018;42;825;447;378
Klaipėda d. mun.;2018;43;804;428;376
Klaipėda d. mun.;2018;44;869;477;392
Klaipėda d. mun.;2018;45;916;489;427
Klaipėda d. mun.;2018;46;951;504;447
Klaipėda d. mun.;2018;47;905;448;457
Klaipėda d. mun.;2018;48;914;506;408
Klaipėda d. mun.;2018;49;861;459;402
Klaipėda d. mun.;2018;50;865;461;404
Klaipėda d. mun.;2018;51;837;439;398
Klaipėda d. mun.;2018;52;814;433;381
Klaipėda d. mun.;2018;53;851;451;400
Klaipėda d. mun.;2018;54;857;406;451
Klaipėda d. mun.;2018;55;896;429;467
Klaipėda d. mun.;2018;56;931;488;443
Klaipėda d. mun.;2018;57;859;430;429
Klaipėda d. mun.;2018;58;903;432;471
Klaipėda d. mun.;2018;59;811;408;403
Klaipėda d. mun.;2018;60;801;416;385
Klaipėda d. mun.;2018;61;659;297;362
Klaipėda d. mun.;2018;62;599;296;303
Klaipėda d. mun.;2018;63;611;291;320
Klaipėda d. mun.;2018;64;570;242;328
Klaipėda d. mun.;2018;65;545;231;314
Klaipėda d. mun.;2018;66;514;253;261
Klaipėda d. mun.;2018;67;513;225;288
Klaipėda d. mun.;2018;68;494;217;277
Klaipėda d. mun.;2018;69;477;187;290
Klaipėda d. mun.;2018;70;439;192;247
Klaipėda d. mun.;2018;71;378;165;213
Klaipėda d. mun.;2018;72;373;156;217
Klaipėda d. mun.;2018;73;311;88;223
Klaipėda d. mun.;2018;74;355;139;216
Klaipėda d. mun.;2018;75;365;152;213
Klaipėda d. mun.;2018;76;383;152;231
Klaipėda d. mun.;2018;77;380;151;229
Klaipėda d. mun.;2018;78;365;118;247
Klaipėda d. mun.;2018;79;328;131;197
Klaipėda d. mun.;2018;80;349;115;234
Klaipėda d. mun.;2018;81;298;76;222
Klaipėda d. mun.;2018;82;255;81;174
Klaipėda d. mun.;2018;83;216;62;154
Klaipėda d. mun.;2018;84;197;50;147
Klaipėda d. mun.;2018;85;1006;238;768
Kretinga d. mun.;2001;-1;45723;21749;23974
Kretinga d. mun.;2001;0;483;267;216
Kretinga d. mun.;2001;1;484;236;248
Kretinga d. mun.;2001;2;515;276;239
Kretinga d. mun.;2001;3;547;273;274
Kretinga d. mun.;2001;4;634;309;325
Kretinga d. mun.;2001;5;588;302;286
Kretinga d. mun.;2001;6;632;317;315
Kretinga d. mun.;2001;7;692;323;369
Kretinga d. mun.;2001;8;789;388;401
Kretinga d. mun.;2001;9;784;405;379
Kretinga d. mun.;2001;10;804;394;410
Kretinga d. mun.;2001;11;780;384;396
Kretinga d. mun.;2001;12;732;364;368
Kretinga d. mun.;2001;13;782;396;386
Kretinga d. mun.;2001;14;768;398;370
Kretinga d. mun.;2001;15;775;396;379
Kretinga d. mun.;2001;16;754;381;373
Kretinga d. mun.;2001;17;719;354;365
Kretinga d. mun.;2001;18;644;334;310
Kretinga d. mun.;2001;19;600;307;293
Kretinga d. mun.;2001;20;595;307;288
Kretinga d. mun.;2001;21;562;293;269
Kretinga d. mun.;2001;22;580;297;283
Kretinga d. mun.;2001;23;572;300;272
Kretinga d. mun.;2001;24;564;297;267
Kretinga d. mun.;2001;25;610;306;304
Kretinga d. mun.;2001;26;593;308;285
Kretinga d. mun.;2001;27;599;303;296
Kretinga d. mun.;2001;28;643;311;332
Kretinga d. mun.;2001;29;688;356;332
Kretinga d. mun.;2001;30;642;315;327
Kretinga d. mun.;2001;31;676;321;355
Kretinga d. mun.;2001;32;669;316;353
Kretinga d. mun.;2001;33;679;344;335
Kretinga d. mun.;2001;34;676;321;355
Kretinga d. mun.;2001;35;673;355;318
Kretinga d. mun.;2001;36;715;363;352
Kretinga d. mun.;2001;37;686;368;318
Kretinga d. mun.;2001;38;709;356;353
Kretinga d. mun.;2001;39;744;374;370
Kretinga d. mun.;2001;40;678;316;362
Kretinga d. mun.;2001;41;654;321;333
Kretinga d. mun.;2001;42;664;339;325
Kretinga d. mun.;2001;43;613;307;306
Kretinga d. mun.;2001;44;588;307;281
Kretinga d. mun.;2001;45;567;287;280
Kretinga d. mun.;2001;46;549;260;289
Kretinga d. mun.;2001;47;518;248;270
Kretinga d. mun.;2001;48;514;267;247
Kretinga d. mun.;2001;49;508;240;268
Kretinga d. mun.;2001;50;485;229;256
Kretinga d. mun.;2001;51;491;252;239
Kretinga d. mun.;2001;52;461;219;242
Kretinga d. mun.;2001;53;425;182;243
Kretinga d. mun.;2001;54;408;195;213
Kretinga d. mun.;2001;55;423;195;228
Kretinga d. mun.;2001;56;406;200;206
Kretinga d. mun.;2001;57;463;209;254
Kretinga d. mun.;2001;58;501;221;280
Kretinga d. mun.;2001;59;488;202;286
Kretinga d. mun.;2001;60;482;220;262
Kretinga d. mun.;2001;61;436;190;246
Kretinga d. mun.;2001;62;491;223;268
Kretinga d. mun.;2001;63;472;189;283
Kretinga d. mun.;2001;64;487;206;281
Kretinga d. mun.;2001;65;530;199;331
Kretinga d. mun.;2001;66;413;165;248
Kretinga d. mun.;2001;67;458;191;267
Kretinga d. mun.;2001;68;397;174;223
Kretinga d. mun.;2001;69;398;164;234
Kretinga d. mun.;2001;70;439;171;268
Kretinga d. mun.;2001;71;358;132;226
Kretinga d. mun.;2001;72;385;135;250
Kretinga d. mun.;2001;73;365;138;227
Kretinga d. mun.;2001;74;346;125;221
Kretinga d. mun.;2001;75;318;116;202
Kretinga d. mun.;2001;76;274;97;177
Kretinga d. mun.;2001;77;297;103;194
Kretinga d. mun.;2001;78;227;68;159
Kretinga d. mun.;2001;79;235;65;170
Kretinga d. mun.;2001;80;189;61;128
Kretinga d. mun.;2001;81;142;43;99
Kretinga d. mun.;2001;82;95;31;64
Kretinga d. mun.;2001;83;75;23;52
Kretinga d. mun.;2001;84;83;33;50
Kretinga d. mun.;2001;85;546;176;370
Kretinga d. mun.;2002;-1;45438;21534;23904
Kretinga d. mun.;2002;0;424;196;228
Kretinga d. mun.;2002;1;484;269;215
Kretinga d. mun.;2002;2;478;231;247
Kretinga d. mun.;2002;3;514;276;238
Kretinga d. mun.;2002;4;543;271;272
Kretinga d. mun.;2002;5;631;308;323
Kretinga d. mun.;2002;6;591;300;291
Kretinga d. mun.;2002;7;630;315;315
Kretinga d. mun.;2002;8;692;324;368
Kretinga d. mun.;2002;9;785;385;400
Kretinga d. mun.;2002;10;783;403;380
Kretinga d. mun.;2002;11;800;393;407
Kretinga d. mun.;2002;12;774;379;395
Kretinga d. mun.;2002;13;721;360;361
Kretinga d. mun.;2002;14;773;389;384
Kretinga d. mun.;2002;15;758;393;365
Kretinga d. mun.;2002;16;768;390;378
Kretinga d. mun.;2002;17;738;370;368
Kretinga d. mun.;2002;18;719;355;364
Kretinga d. mun.;2002;19;631;331;300
Kretinga d. mun.;2002;20;590;300;290
Kretinga d. mun.;2002;21;589;309;280
Kretinga d. mun.;2002;22;554;288;266
Kretinga d. mun.;2002;23;574;291;283
Kretinga d. mun.;2002;24;562;293;269
Kretinga d. mun.;2002;25;563;297;266
Kretinga d. mun.;2002;26;597;299;298
Kretinga d. mun.;2002;27;591;305;286
Kretinga d. mun.;2002;28;587;294;293
Kretinga d. mun.;2002;29;629;301;328
Kretinga d. mun.;2002;30;672;348;324
Kretinga d. mun.;2002;31;634;308;326
Kretinga d. mun.;2002;32;673;316;357
Kretinga d. mun.;2002;33;656;310;346
Kretinga d. mun.;2002;34;678;338;340
Kretinga d. mun.;2002;35;674;319;355
Kretinga d. mun.;2002;36;665;351;314
Kretinga d. mun.;2002;37;705;357;348
Kretinga d. mun.;2002;38;674;362;312
Kretinga d. mun.;2002;39;699;349;350
Kretinga d. mun.;2002;40;734;365;369
Kretinga d. mun.;2002;41;665;312;353
Kretinga d. mun.;2002;42;648;317;331
Kretinga d. mun.;2002;43;657;334;323
Kretinga d. mun.;2002;44;606;302;304
Kretinga d. mun.;2002;45;573;296;277
Kretinga d. mun.;2002;46;564;286;278
Kretinga d. mun.;2002;47;547;260;287
Kretinga d. mun.;2002;48;506;243;263
Kretinga d. mun.;2002;49;500;259;241
Kretinga d. mun.;2002;50;508;237;271
Kretinga d. mun.;2002;51;478;227;251
Kretinga d. mun.;2002;52;490;249;241
Kretinga d. mun.;2002;53;464;221;243
Kretinga d. mun.;2002;54;417;179;238
Kretinga d. mun.;2002;55;404;190;214
Kretinga d. mun.;2002;56;413;187;226
Kretinga d. mun.;2002;57;399;197;202
Kretinga d. mun.;2002;58;457;206;251
Kretinga d. mun.;2002;59;490;212;278
Kretinga d. mun.;2002;60;478;193;285
Kretinga d. mun.;2002;61;484;223;261
Kretinga d. mun.;2002;62;429;186;243
Kretinga d. mun.;2002;63;484;215;269
Kretinga d. mun.;2002;64;472;188;284
Kretinga d. mun.;2002;65;477;197;280
Kretinga d. mun.;2002;66;517;188;329
Kretinga d. mun.;2002;67;402;160;242
Kretinga d. mun.;2002;68;452;184;268
Kretinga d. mun.;2002;69;388;164;224
Kretinga d. mun.;2002;70;391;158;233
Kretinga d. mun.;2002;71;437;169;268
Kretinga d. mun.;2002;72;356;129;227
Kretinga d. mun.;2002;73;378;130;248
Kretinga d. mun.;2002;74;354;131;223
Kretinga d. mun.;2002;75;339;120;219
Kretinga d. mun.;2002;76;313;117;196
Kretinga d. mun.;2002;77;262;92;170
Kretinga d. mun.;2002;78;290;102;188
Kretinga d. mun.;2002;79;217;65;152
Kretinga d. mun.;2002;80;229;65;164
Kretinga d. mun.;2002;81;182;60;122
Kretinga d. mun.;2002;82;120;35;85
Kretinga d. mun.;2002;83;84;25;59
Kretinga d. mun.;2002;84;61;19;42
Kretinga d. mun.;2002;85;519;167;352
Kretinga d. mun.;2003;-1;45419;21503;23916
Kretinga d. mun.;2003;0;423;225;198
Kretinga d. mun.;2003;1;424;194;230
Kretinga d. mun.;2003;2;490;273;217
Kretinga d. mun.;2003;3;482;230;252
Kretinga d. mun.;2003;4;513;273;240
Kretinga d. mun.;2003;5;543;270;273
Kretinga d. mun.;2003;6;633;308;325
Kretinga d. mun.;2003;7;594;304;290
Kretinga d. mun.;2003;8;632;316;316
Kretinga d. mun.;2003;9;698;326;372
Kretinga d. mun.;2003;10;788;386;402
Kretinga d. mun.;2003;11;784;405;379
Kretinga d. mun.;2003;12;800;393;407
Kretinga d. mun.;2003;13;763;373;390
Kretinga d. mun.;2003;14;715;358;357
Kretinga d. mun.;2003;15;759;382;377
Kretinga d. mun.;2003;16;747;386;361
Kretinga d. mun.;2003;17;753;379;374
Kretinga d. mun.;2003;18;735;368;367
Kretinga d. mun.;2003;19;716;353;363
Kretinga d. mun.;2003;20;627;327;300
Kretinga d. mun.;2003;21;579;296;283
Kretinga d. mun.;2003;22;592;310;282
Kretinga d. mun.;2003;23;551;287;264
Kretinga d. mun.;2003;24;580;293;287
Kretinga d. mun.;2003;25;557;296;261
Kretinga d. mun.;2003;26;559;295;264
Kretinga d. mun.;2003;27;594;296;298
Kretinga d. mun.;2003;28;585;300;285
Kretinga d. mun.;2003;29;581;294;287
Kretinga d. mun.;2003;30;629;302;327
Kretinga d. mun.;2003;31;670;351;319
Kretinga d. mun.;2003;32;631;307;324
Kretinga d. mun.;2003;33;669;313;356
Kretinga d. mun.;2003;34;663;315;348
Kretinga d. mun.;2003;35;672;334;338
Kretinga d. mun.;2003;36;678;319;359
Kretinga d. mun.;2003;37;665;353;312
Kretinga d. mun.;2003;38;709;362;347
Kretinga d. mun.;2003;39;673;359;314
Kretinga d. mun.;2003;40;698;348;350
Kretinga d. mun.;2003;41;729;361;368
Kretinga d. mun.;2003;42;671;315;356
Kretinga d. mun.;2003;43;644;315;329
Kretinga d. mun.;2003;44;659;337;322
Kretinga d. mun.;2003;45;605;301;304
Kretinga d. mun.;2003;46;567;290;277
Kretinga d. mun.;2003;47;564;285;279
Kretinga d. mun.;2003;48;548;260;288
Kretinga d. mun.;2003;49;505;241;264
Kretinga d. mun.;2003;50;491;252;239
Kretinga d. mun.;2003;51;498;231;267
Kretinga d. mun.;2003;52;470;219;251
Kretinga d. mun.;2003;53;489;246;243
Kretinga d. mun.;2003;54;466;219;247
Kretinga d. mun.;2003;55;414;176;238
Kretinga d. mun.;2003;56;401;187;214
Kretinga d. mun.;2003;57;410;183;227
Kretinga d. mun.;2003;58;388;187;201
Kretinga d. mun.;2003;59;451;205;246
Kretinga d. mun.;2003;60;487;210;277
Kretinga d. mun.;2003;61;477;193;284
Kretinga d. mun.;2003;62;480;218;262
Kretinga d. mun.;2003;63;429;182;247
Kretinga d. mun.;2003;64;477;210;267
Kretinga d. mun.;2003;65;468;185;283
Kretinga d. mun.;2003;66;479;198;281
Kretinga d. mun.;2003;67;516;183;333
Kretinga d. mun.;2003;68;401;159;242
Kretinga d. mun.;2003;69;448;180;268
Kretinga d. mun.;2003;70;387;163;224
Kretinga d. mun.;2003;71;385;154;231
Kretinga d. mun.;2003;72;426;162;264
Kretinga d. mun.;2003;73;343;119;224
Kretinga d. mun.;2003;74;362;119;243
Kretinga d. mun.;2003;75;341;124;217
Kretinga d. mun.;2003;76;324;114;210
Kretinga d. mun.;2003;77;302;111;191
Kretinga d. mun.;2003;78;254;87;167
Kretinga d. mun.;2003;79;274;94;180
Kretinga d. mun.;2003;80;204;57;147
Kretinga d. mun.;2003;81;207;58;149
Kretinga d. mun.;2003;82;164;53;111
Kretinga d. mun.;2003;83;108;29;79
Kretinga d. mun.;2003;84;76;23;53
Kretinga d. mun.;2003;85;476;149;327
Kretinga d. mun.;2004;-1;45454;21447;24007
Kretinga d. mun.;2004;0;468;236;232
Kretinga d. mun.;2004;1;431;229;202
Kretinga d. mun.;2004;2;430;197;233
Kretinga d. mun.;2004;3;496;274;222
Kretinga d. mun.;2004;4;490;234;256
Kretinga d. mun.;2004;5;514;273;241
Kretinga d. mun.;2004;6;552;276;276
Kretinga d. mun.;2004;7;637;310;327
Kretinga d. mun.;2004;8;595;304;291
Kretinga d. mun.;2004;9;633;315;318
Kretinga d. mun.;2004;10;701;328;373
Kretinga d. mun.;2004;11;784;386;398
Kretinga d. mun.;2004;12;784;407;377
Kretinga d. mun.;2004;13;800;393;407
Kretinga d. mun.;2004;14;766;369;397
Kretinga d. mun.;2004;15;710;353;357
Kretinga d. mun.;2004;16;759;384;375
Kretinga d. mun.;2004;17;735;383;352
Kretinga d. mun.;2004;18;743;376;367
Kretinga d. mun.;2004;19;725;361;364
Kretinga d. mun.;2004;20;715;351;364
Kretinga d. mun.;2004;21;622;327;295
Kretinga d. mun.;2004;22;585;297;288
Kretinga d. mun.;2004;23;599;316;283
Kretinga d. mun.;2004;24;544;286;258
Kretinga d. mun.;2004;25;574;287;287
Kretinga d. mun.;2004;26;550;296;254
Kretinga d. mun.;2004;27;547;286;261
Kretinga d. mun.;2004;28;589;289;300
Kretinga d. mun.;2004;29;586;302;284
Kretinga d. mun.;2004;30;574;289;285
Kretinga d. mun.;2004;31;619;298;321
Kretinga d. mun.;2004;32;678;357;321
Kretinga d. mun.;2004;33;632;308;324
Kretinga d. mun.;2004;34;661;306;355
Kretinga d. mun.;2004;35;661;313;348
Kretinga d. mun.;2004;36;664;328;336
Kretinga d. mun.;2004;37;671;317;354
Kretinga d. mun.;2004;38;659;346;313
Kretinga d. mun.;2004;39;704;358;346
Kretinga d. mun.;2004;40;667;355;312
Kretinga d. mun.;2004;41;694;341;353
Kretinga d. mun.;2004;42;723;359;364
Kretinga d. mun.;2004;43;674;317;357
Kretinga d. mun.;2004;44;636;306;330
Kretinga d. mun.;2004;45;653;330;323
Kretinga d. mun.;2004;46;599;298;301
Kretinga d. mun.;2004;47;573;295;278
Kretinga d. mun.;2004;48;556;278;278
Kretinga d. mun.;2004;49;552;258;294
Kretinga d. mun.;2004;50;496;234;262
Kretinga d. mun.;2004;51;490;250;240
Kretinga d. mun.;2004;52;503;233;270
Kretinga d. mun.;2004;53;463;212;251
Kretinga d. mun.;2004;54;485;243;242
Kretinga d. mun.;2004;55;463;215;248
Kretinga d. mun.;2004;56;409;173;236
Kretinga d. mun.;2004;57;394;181;213
Kretinga d. mun.;2004;58;407;179;228
Kretinga d. mun.;2004;59;379;180;199
Kretinga d. mun.;2004;60;441;202;239
Kretinga d. mun.;2004;61;488;208;280
Kretinga d. mun.;2004;62;470;184;286
Kretinga d. mun.;2004;63;475;212;263
Kretinga d. mun.;2004;64;425;177;248
Kretinga d. mun.;2004;65;472;205;267
Kretinga d. mun.;2004;66;464;179;285
Kretinga d. mun.;2004;67;468;191;277
Kretinga d. mun.;2004;68;507;174;333
Kretinga d. mun.;2004;69;400;158;242
Kretinga d. mun.;2004;70;436;172;264
Kretinga d. mun.;2004;71;392;163;229
Kretinga d. mun.;2004;72;377;147;230
Kretinga d. mun.;2004;73;409;152;257
Kretinga d. mun.;2004;74;337;113;224
Kretinga d. mun.;2004;75;361;117;244
Kretinga d. mun.;2004;76;330;121;209
Kretinga d. mun.;2004;77;313;109;204
Kretinga d. mun.;2004;78;290;104;186
Kretinga d. mun.;2004;79;247;85;162
Kretinga d. mun.;2004;80;254;78;176
Kretinga d. mun.;2004;81;195;53;142
Kretinga d. mun.;2004;82;184;50;134
Kretinga d. mun.;2004;83;151;48;103
Kretinga d. mun.;2004;84;102;27;75
Kretinga d. mun.;2004;85;463;136;327
Kretinga d. mun.;2005;-1;45119;21236;23883
Kretinga d. mun.;2005;0;428;205;223
Kretinga d. mun.;2005;1;464;232;232
Kretinga d. mun.;2005;2;432;231;201
Kretinga d. mun.;2005;3;427;196;231
Kretinga d. mun.;2005;4;488;269;219
Kretinga d. mun.;2005;5;485;233;252
Kretinga d. mun.;2005;6;513;273;240
Kretinga d. mun.;2005;7;548;274;274
Kretinga d. mun.;2005;8;635;312;323
Kretinga d. mun.;2005;9;597;307;290
Kretinga d. mun.;2005;10;634;315;319
Kretinga d. mun.;2005;11;702;325;377
Kretinga d. mun.;2005;12;790;386;404
Kretinga d. mun.;2005;13;782;408;374
Kretinga d. mun.;2005;14;797;388;409
Kretinga d. mun.;2005;15;766;373;393
Kretinga d. mun.;2005;16;698;346;352
Kretinga d. mun.;2005;17;749;378;371
Kretinga d. mun.;2005;18;720;376;344
Kretinga d. mun.;2005;19;731;367;364
Kretinga d. mun.;2005;20;709;353;356
Kretinga d. mun.;2005;21;703;344;359
Kretinga d. mun.;2005;22;615;318;297
Kretinga d. mun.;2005;23;574;288;286
Kretinga d. mun.;2005;24;580;310;270
Kretinga d. mun.;2005;25;515;277;238
Kretinga d. mun.;2005;26;565;278;287
Kretinga d. mun.;2005;27;547;293;254
Kretinga d. mun.;2005;28;543;289;254
Kretinga d. mun.;2005;29;583;286;297
Kretinga d. mun.;2005;30;581;301;280
Kretinga d. mun.;2005;31;566;287;279
Kretinga d. mun.;2005;32;607;285;322
Kretinga d. mun.;2005;33;672;350;322
Kretinga d. mun.;2005;34;634;312;322
Kretinga d. mun.;2005;35;656;302;354
Kretinga d. mun.;2005;36;656;309;347
Kretinga d. mun.;2005;37;653;320;333
Kretinga d. mun.;2005;38;666;314;352
Kretinga d. mun.;2005;39;651;342;309
Kretinga d. mun.;2005;40;695;349;346
Kretinga d. mun.;2005;41;656;348;308
Kretinga d. mun.;2005;42;680;332;348
Kretinga d. mun.;2005;43;723;357;366
Kretinga d. mun.;2005;44;671;315;356
Kretinga d. mun.;2005;45;630;301;329
Kretinga d. mun.;2005;46;648;327;321
Kretinga d. mun.;2005;47;597;299;298
Kretinga d. mun.;2005;48;567;292;275
Kretinga d. mun.;2005;49;552;276;276
Kretinga d. mun.;2005;50;542;255;287
Kretinga d. mun.;2005;51;487;229;258
Kretinga d. mun.;2005;52;485;244;241
Kretinga d. mun.;2005;53;498;228;270
Kretinga d. mun.;2005;54;459;211;248
Kretinga d. mun.;2005;55;479;237;242
Kretinga d. mun.;2005;56;452;205;247
Kretinga d. mun.;2005;57;407;172;235
Kretinga d. mun.;2005;58;389;178;211
Kretinga d. mun.;2005;59;405;179;226
Kretinga d. mun.;2005;60;378;178;200
Kretinga d. mun.;2005;61;435;196;239
Kretinga d. mun.;2005;62;478;200;278
Kretinga d. mun.;2005;63;465;181;284
Kretinga d. mun.;2005;64;466;205;261
Kretinga d. mun.;2005;65;415;169;246
Kretinga d. mun.;2005;66;467;197;270
Kretinga d. mun.;2005;67;459;177;282
Kretinga d. mun.;2005;68;456;183;273
Kretinga d. mun.;2005;69;489;164;325
Kretinga d. mun.;2005;70;394;154;240
Kretinga d. mun.;2005;71;432;171;261
Kretinga d. mun.;2005;72;379;154;225
Kretinga d. mun.;2005;73;365;139;226
Kretinga d. mun.;2005;74;396;145;251
Kretinga d. mun.;2005;75;320;102;218
Kretinga d. mun.;2005;76;351;114;237
Kretinga d. mun.;2005;77;315;111;204
Kretinga d. mun.;2005;78;296;101;195
Kretinga d. mun.;2005;79;279;97;182
Kretinga d. mun.;2005;80;228;77;151
Kretinga d. mun.;2005;81;235;69;166
Kretinga d. mun.;2005;82;168;43;125
Kretinga d. mun.;2005;83;168;44;124
Kretinga d. mun.;2005;84;136;43;93
Kretinga d. mun.;2005;85;465;136;329
Kretinga d. mun.;2006;-1;44423;20857;23566
Kretinga d. mun.;2006;0;424;233;191
Kretinga d. mun.;2006;1;426;204;222
Kretinga d. mun.;2006;2;459;227;232
Kretinga d. mun.;2006;3;428;229;199
Kretinga d. mun.;2006;4;420;191;229
Kretinga d. mun.;2006;5;484;266;218
Kretinga d. mun.;2006;6;482;231;251
Kretinga d. mun.;2006;7;510;272;238
Kretinga d. mun.;2006;8;543;274;269
Kretinga d. mun.;2006;9;631;308;323
Kretinga d. mun.;2006;10;599;311;288
Kretinga d. mun.;2006;11;630;313;317
Kretinga d. mun.;2006;12;697;322;375
Kretinga d. mun.;2006;13;771;379;392
Kretinga d. mun.;2006;14;777;404;373
Kretinga d. mun.;2006;15;784;385;399
Kretinga d. mun.;2006;16;746;361;385
Kretinga d. mun.;2006;17;678;332;346
Kretinga d. mun.;2006;18;731;370;361
Kretinga d. mun.;2006;19;691;360;331
Kretinga d. mun.;2006;20;690;344;346
Kretinga d. mun.;2006;21;667;330;337
Kretinga d. mun.;2006;22;666;329;337
Kretinga d. mun.;2006;23;585;307;278
Kretinga d. mun.;2006;24;552;277;275
Kretinga d. mun.;2006;25;548;291;257
Kretinga d. mun.;2006;26;495;271;224
Kretinga d. mun.;2006;27;555;270;285
Kretinga d. mun.;2006;28;533;283;250
Kretinga d. mun.;2006;29;527;274;253
Kretinga d. mun.;2006;30;581;285;296
Kretinga d. mun.;2006;31;570;292;278
Kretinga d. mun.;2006;32;554;279;275
Kretinga d. mun.;2006;33;596;277;319
Kretinga d. mun.;2006;34;667;342;325
Kretinga d. mun.;2006;35;616;299;317
Kretinga d. mun.;2006;36;645;299;346
Kretinga d. mun.;2006;37;641;300;341
Kretinga d. mun.;2006;38;648;314;334
Kretinga d. mun.;2006;39;650;306;344
Kretinga d. mun.;2006;40;635;333;302
Kretinga d. mun.;2006;41;682;337;345
Kretinga d. mun.;2006;42;639;334;305
Kretinga d. mun.;2006;43;668;325;343
Kretinga d. mun.;2006;44;714;353;361
Kretinga d. mun.;2006;45;663;317;346
Kretinga d. mun.;2006;46;622;297;325
Kretinga d. mun.;2006;47;643;323;320
Kretinga d. mun.;2006;48;598;298;300
Kretinga d. mun.;2006;49;561;287;274
Kretinga d. mun.;2006;50;547;273;274
Kretinga d. mun.;2006;51;531;246;285
Kretinga d. mun.;2006;52;481;226;255
Kretinga d. mun.;2006;53;471;237;234
Kretinga d. mun.;2006;54;489;218;271
Kretinga d. mun.;2006;55;454;206;248
Kretinga d. mun.;2006;56;475;233;242
Kretinga d. mun.;2006;57;448;203;245
Kretinga d. mun.;2006;58;399;168;231
Kretinga d. mun.;2006;59;383;177;206
Kretinga d. mun.;2006;60;400;177;223
Kretinga d. mun.;2006;61;369;169;200
Kretinga d. mun.;2006;62;426;188;238
Kretinga d. mun.;2006;63;474;199;275
Kretinga d. mun.;2006;64;462;178;284
Kretinga d. mun.;2006;65;452;193;259
Kretinga d. mun.;2006;66;404;163;241
Kretinga d. mun.;2006;67;455;187;268
Kretinga d. mun.;2006;68;457;173;284
Kretinga d. mun.;2006;69;454;180;274
Kretinga d. mun.;2006;70;478;160;318
Kretinga d. mun.;2006;71;382;150;232
Kretinga d. mun.;2006;72;418;162;256
Kretinga d. mun.;2006;73;365;142;223
Kretinga d. mun.;2006;74;347;129;218
Kretinga d. mun.;2006;75;386;139;247
Kretinga d. mun.;2006;76;308;96;212
Kretinga d. mun.;2006;77;325;102;223
Kretinga d. mun.;2006;78;293;95;198
Kretinga d. mun.;2006;79;285;94;191
Kretinga d. mun.;2006;80;266;88;178
Kretinga d. mun.;2006;81;208;69;139
Kretinga d. mun.;2006;82;216;64;152
Kretinga d. mun.;2006;83;150;39;111
Kretinga d. mun.;2006;84;158;44;114
Kretinga d. mun.;2006;85;485;145;340
Kretinga d. mun.;2007;-1;44187;20733;23454
Kretinga d. mun.;2007;0;418;206;212
Kretinga d. mun.;2007;1;426;232;194
Kretinga d. mun.;2007;2;424;201;223
Kretinga d. mun.;2007;3;463;230;233
Kretinga d. mun.;2007;4;428;228;200
Kretinga d. mun.;2007;5;425;197;228
Kretinga d. mun.;2007;6;482;267;215
Kretinga d. mun.;2007;7;487;236;251
Kretinga d. mun.;2007;8;506;269;237
Kretinga d. mun.;2007;9;548;277;271
Kretinga d. mun.;2007;10;633;308;325
Kretinga d. mun.;2007;11;590;309;281
Kretinga d. mun.;2007;12;638;317;321
Kretinga d. mun.;2007;13;694;324;370
Kretinga d. mun.;2007;14;772;378;394
Kretinga d. mun.;2007;15;778;407;371
Kretinga d. mun.;2007;16;783;383;400
Kretinga d. mun.;2007;17;740;365;375
Kretinga d. mun.;2007;18;671;329;342
Kretinga d. mun.;2007;19;714;364;350
Kretinga d. mun.;2007;20;675;355;320
Kretinga d. mun.;2007;21;679;337;342
Kretinga d. mun.;2007;22;654;324;330
Kretinga d. mun.;2007;23;656;318;338
Kretinga d. mun.;2007;24;576;302;274
Kretinga d. mun.;2007;25;542;274;268
Kretinga d. mun.;2007;26;537;288;249
Kretinga d. mun.;2007;27;488;270;218
Kretinga d. mun.;2007;28;537;264;273
Kretinga d. mun.;2007;29;535;285;250
Kretinga d. mun.;2007;30;526;274;252
Kretinga d. mun.;2007;31;569;278;291
Kretinga d. mun.;2007;32;572;291;281
Kretinga d. mun.;2007;33;560;283;277
Kretinga d. mun.;2007;34;588;269;319
Kretinga d. mun.;2007;35;655;334;321
Kretinga d. mun.;2007;36;608;296;312
Kretinga d. mun.;2007;37;639;293;346
Kretinga d. mun.;2007;38;640;299;341
Kretinga d. mun.;2007;39;641;308;333
Kretinga d. mun.;2007;40;643;301;342
Kretinga d. mun.;2007;41;632;333;299
Kretinga d. mun.;2007;42;671;330;341
Kretinga d. mun.;2007;43;638;334;304
Kretinga d. mun.;2007;44;669;325;344
Kretinga d. mun.;2007;45;713;353;360
Kretinga d. mun.;2007;46;657;310;347
Kretinga d. mun.;2007;47;614;296;318
Kretinga d. mun.;2007;48;645;324;321
Kretinga d. mun.;2007;49;599;297;302
Kretinga d. mun.;2007;50;552;279;273
Kretinga d. mun.;2007;51;542;269;273
Kretinga d. mun.;2007;52;525;241;284
Kretinga d. mun.;2007;53;476;223;253
Kretinga d. mun.;2007;54;466;234;232
Kretinga d. mun.;2007;55;479;212;267
Kretinga d. mun.;2007;56;450;204;246
Kretinga d. mun.;2007;57;463;222;241
Kretinga d. mun.;2007;58;448;203;245
Kretinga d. mun.;2007;59;393;164;229
Kretinga d. mun.;2007;60;376;171;205
Kretinga d. mun.;2007;61;391;169;222
Kretinga d. mun.;2007;62;362;164;198
Kretinga d. mun.;2007;63;412;176;236
Kretinga d. mun.;2007;64;467;189;278
Kretinga d. mun.;2007;65;454;175;279
Kretinga d. mun.;2007;66;444;189;255
Kretinga d. mun.;2007;67;396;157;239
Kretinga d. mun.;2007;68;441;178;263
Kretinga d. mun.;2007;69;450;169;281
Kretinga d. mun.;2007;70;441;170;271
Kretinga d. mun.;2007;71;461;150;311
Kretinga d. mun.;2007;72;379;151;228
Kretinga d. mun.;2007;73;405;155;250
Kretinga d. mun.;2007;74;357;135;222
Kretinga d. mun.;2007;75;334;120;214
Kretinga d. mun.;2007;76;380;136;244
Kretinga d. mun.;2007;77;289;84;205
Kretinga d. mun.;2007;78;312;95;217
Kretinga d. mun.;2007;79;280;88;192
Kretinga d. mun.;2007;80;270;85;185
Kretinga d. mun.;2007;81;254;81;173
Kretinga d. mun.;2007;82;198;64;134
Kretinga d. mun.;2007;83;189;55;134
Kretinga d. mun.;2007;84;131;35;96
Kretinga d. mun.;2007;85;542;169;373
Kretinga d. mun.;2008;-1;43786;20564;23222
Kretinga d. mun.;2008;0;423;220;203
Kretinga d. mun.;2008;1;411;203;208
Kretinga d. mun.;2008;2;425;235;190
Kretinga d. mun.;2008;3;426;205;221
Kretinga d. mun.;2008;4;471;235;236
Kretinga d. mun.;2008;5;424;230;194
Kretinga d. mun.;2008;6;421;196;225
Kretinga d. mun.;2008;7;474;262;212
Kretinga d. mun.;2008;8;488;234;254
Kretinga d. mun.;2008;9;510;272;238
Kretinga d. mun.;2008;10;546;277;269
Kretinga d. mun.;2008;11;631;309;322
Kretinga d. mun.;2008;12;589;307;282
Kretinga d. mun.;2008;13;640;320;320
Kretinga d. mun.;2008;14;688;323;365
Kretinga d. mun.;2008;15;767;376;391
Kretinga d. mun.;2008;16;770;403;367
Kretinga d. mun.;2008;17;780;386;394
Kretinga d. mun.;2008;18;728;358;370
Kretinga d. mun.;2008;19;666;327;339
Kretinga d. mun.;2008;20;704;360;344
Kretinga d. mun.;2008;21;664;350;314
Kretinga d. mun.;2008;22;669;326;343
Kretinga d. mun.;2008;23;640;324;316
Kretinga d. mun.;2008;24;639;310;329
Kretinga d. mun.;2008;25;560;294;266
Kretinga d. mun.;2008;26;526;264;262
Kretinga d. mun.;2008;27;518;278;240
Kretinga d. mun.;2008;28;489;270;219
Kretinga d. mun.;2008;29;530;264;266
Kretinga d. mun.;2008;30;532;281;251
Kretinga d. mun.;2008;31;516;273;243
Kretinga d. mun.;2008;32;562;273;289
Kretinga d. mun.;2008;33;564;288;276
Kretinga d. mun.;2008;34;553;281;272
Kretinga d. mun.;2008;35;575;263;312
Kretinga d. mun.;2008;36;648;328;320
Kretinga d. mun.;2008;37;603;290;313
Kretinga d. mun.;2008;38;640;294;346
Kretinga d. mun.;2008;39;623;291;332
Kretinga d. mun.;2008;40;638;308;330
Kretinga d. mun.;2008;41;641;301;340
Kretinga d. mun.;2008;42;625;331;294
Kretinga d. mun.;2008;43;662;324;338
Kretinga d. mun.;2008;44;627;325;302
Kretinga d. mun.;2008;45;660;322;338
Kretinga d. mun.;2008;46;704;350;354
Kretinga d. mun.;2008;47;650;310;340
Kretinga d. mun.;2008;48;606;292;314
Kretinga d. mun.;2008;49;645;324;321
Kretinga d. mun.;2008;50;592;292;300
Kretinga d. mun.;2008;51;550;275;275
Kretinga d. mun.;2008;52;537;263;274
Kretinga d. mun.;2008;53;521;239;282
Kretinga d. mun.;2008;54;469;219;250
Kretinga d. mun.;2008;55;458;225;233
Kretinga d. mun.;2008;56;470;204;266
Kretinga d. mun.;2008;57;445;203;242
Kretinga d. mun.;2008;58;454;217;237
Kretinga d. mun.;2008;59;442;199;243
Kretinga d. mun.;2008;60;383;154;229
Kretinga d. mun.;2008;61;369;165;204
Kretinga d. mun.;2008;62;386;163;223
Kretinga d. mun.;2008;63;351;158;193
Kretinga d. mun.;2008;64;409;174;235
Kretinga d. mun.;2008;65;461;184;277
Kretinga d. mun.;2008;66;438;165;273
Kretinga d. mun.;2008;67;438;182;256
Kretinga d. mun.;2008;68;383;147;236
Kretinga d. mun.;2008;69;435;175;260
Kretinga d. mun.;2008;70;435;161;274
Kretinga d. mun.;2008;71;430;163;267
Kretinga d. mun.;2008;72;443;139;304
Kretinga d. mun.;2008;73;371;149;222
Kretinga d. mun.;2008;74;384;143;241
Kretinga d. mun.;2008;75;335;125;210
Kretinga d. mun.;2008;76;320;113;207
Kretinga d. mun.;2008;77;365;127;238
Kretinga d. mun.;2008;78;279;79;200
Kretinga d. mun.;2008;79;293;89;204
Kretinga d. mun.;2008;80;269;88;181
Kretinga d. mun.;2008;81;254;78;176
Kretinga d. mun.;2008;82;243;75;168
Kretinga d. mun.;2008;83;175;56;119
Kretinga d. mun.;2008;84;159;44;115
Kretinga d. mun.;2008;85;549;165;384
Kretinga d. mun.;2009;-1;43573;20451;23122
Kretinga d. mun.;2009;0;432;228;204
Kretinga d. mun.;2009;1;421;217;204
Kretinga d. mun.;2009;2;404;199;205
Kretinga d. mun.;2009;3;420;235;185
Kretinga d. mun.;2009;4;422;201;221
Kretinga d. mun.;2009;5;469;234;235
Kretinga d. mun.;2009;6;421;230;191
Kretinga d. mun.;2009;7;423;195;228
Kretinga d. mun.;2009;8;478;261;217
Kretinga d. mun.;2009;9;495;237;258
Kretinga d. mun.;2009;10;510;270;240
Kretinga d. mun.;2009;11;551;279;272
Kretinga d. mun.;2009;12;626;305;321
Kretinga d. mun.;2009;13;592;308;284
Kretinga d. mun.;2009;14;644;323;321
Kretinga d. mun.;2009;15;687;323;364
Kretinga d. mun.;2009;16;765;375;390
Kretinga d. mun.;2009;17;770;405;365
Kretinga d. mun.;2009;18;779;385;394
Kretinga d. mun.;2009;19;731;359;372
Kretinga d. mun.;2009;20;657;321;336
Kretinga d. mun.;2009;21;698;359;339
Kretinga d. mun.;2009;22;654;343;311
Kretinga d. mun.;2009;23;657;325;332
Kretinga d. mun.;2009;24;641;326;315
Kretinga d. mun.;2009;25;638;309;329
Kretinga d. mun.;2009;26;544;285;259
Kretinga d. mun.;2009;27;512;256;256
Kretinga d. mun.;2009;28;508;280;228
Kretinga d. mun.;2009;29;482;268;214
Kretinga d. mun.;2009;30;520;251;269
Kretinga d. mun.;2009;31;531;281;250
Kretinga d. mun.;2009;32;510;270;240
Kretinga d. mun.;2009;33;565;280;285
Kretinga d. mun.;2009;34;552;287;265
Kretinga d. mun.;2009;35;544;278;266
Kretinga d. mun.;2009;36;568;260;308
Kretinga d. mun.;2009;37;641;324;317
Kretinga d. mun.;2009;38;600;290;310
Kretinga d. mun.;2009;39;633;289;344
Kretinga d. mun.;2009;40;620;289;331
Kretinga d. mun.;2009;41;633;305;328
Kretinga d. mun.;2009;42;641;301;340
Kretinga d. mun.;2009;43;623;329;294
Kretinga d. mun.;2009;44;653;320;333
Kretinga d. mun.;2009;45;620;321;299
Kretinga d. mun.;2009;46;658;325;333
Kretinga d. mun.;2009;47;698;347;351
Kretinga d. mun.;2009;48;643;304;339
Kretinga d. mun.;2009;49;602;289;313
Kretinga d. mun.;2009;50;644;320;324
Kretinga d. mun.;2009;51;587;284;303
Kretinga d. mun.;2009;52;541;270;271
Kretinga d. mun.;2009;53;532;258;274
Kretinga d. mun.;2009;54;521;236;285
Kretinga d. mun.;2009;55;464;218;246
Kretinga d. mun.;2009;56;451;223;228
Kretinga d. mun.;2009;57;464;196;268
Kretinga d. mun.;2009;58;439;197;242
Kretinga d. mun.;2009;59;441;208;233
Kretinga d. mun.;2009;60;430;193;237
Kretinga d. mun.;2009;61;381;153;228
Kretinga d. mun.;2009;62;363;163;200
Kretinga d. mun.;2009;63;386;162;224
Kretinga d. mun.;2009;64;348;153;195
Kretinga d. mun.;2009;65;408;175;233
Kretinga d. mun.;2009;66;449;177;272
Kretinga d. mun.;2009;67;428;157;271
Kretinga d. mun.;2009;68;424;172;252
Kretinga d. mun.;2009;69;376;142;234
Kretinga d. mun.;2009;70;419;164;255
Kretinga d. mun.;2009;71;424;156;268
Kretinga d. mun.;2009;72;417;155;262
Kretinga d. mun.;2009;73;435;137;298
Kretinga d. mun.;2009;74;357;140;217
Kretinga d. mun.;2009;75;369;136;233
Kretinga d. mun.;2009;76;328;120;208
Kretinga d. mun.;2009;77;300;103;197
Kretinga d. mun.;2009;78;351;123;228
Kretinga d. mun.;2009;79;275;77;198
Kretinga d. mun.;2009;80;275;82;193
Kretinga d. mun.;2009;81;251;79;172
Kretinga d. mun.;2009;82;237;71;166
Kretinga d. mun.;2009;83;230;69;161
Kretinga d. mun.;2009;84;155;46;109
Kretinga d. mun.;2009;85;587;155;432
Kretinga d. mun.;2010;-1;42607;19971;22636
Kretinga d. mun.;2010;0;443;236;207
Kretinga d. mun.;2010;1;420;218;202
Kretinga d. mun.;2010;2;406;211;195
Kretinga d. mun.;2010;3;401;200;201
Kretinga d. mun.;2010;4;407;228;179
Kretinga d. mun.;2010;5;411;195;216
Kretinga d. mun.;2010;6;462;233;229
Kretinga d. mun.;2010;7;415;227;188
Kretinga d. mun.;2010;8;416;192;224
Kretinga d. mun.;2010;9;471;257;214
Kretinga d. mun.;2010;10;484;234;250
Kretinga d. mun.;2010;11;504;266;238
Kretinga d. mun.;2010;12;548;279;269
Kretinga d. mun.;2010;13;623;300;323
Kretinga d. mun.;2010;14;581;303;278
Kretinga d. mun.;2010;15;639;320;319
Kretinga d. mun.;2010;16;675;317;358
Kretinga d. mun.;2010;17;750;366;384
Kretinga d. mun.;2010;18;754;397;357
Kretinga d. mun.;2010;19;759;372;387
Kretinga d. mun.;2010;20;707;349;358
Kretinga d. mun.;2010;21;633;311;322
Kretinga d. mun.;2010;22;666;342;324
Kretinga d. mun.;2010;23;624;327;297
Kretinga d. mun.;2010;24;630;314;316
Kretinga d. mun.;2010;25;600;306;294
Kretinga d. mun.;2010;26;586;290;296
Kretinga d. mun.;2010;27;493;259;234
Kretinga d. mun.;2010;28;485;239;246
Kretinga d. mun.;2010;29;484;264;220
Kretinga d. mun.;2010;30;453;258;195
Kretinga d. mun.;2010;31;504;242;262
Kretinga d. mun.;2010;32;508;267;241
Kretinga d. mun.;2010;33;487;256;231
Kretinga d. mun.;2010;34;548;272;276
Kretinga d. mun.;2010;35;528;274;254
Kretinga d. mun.;2010;36;533;269;264
Kretinga d. mun.;2010;37;552;248;304
Kretinga d. mun.;2010;38;630;323;307
Kretinga d. mun.;2010;39;586;287;299
Kretinga d. mun.;2010;40;617;277;340
Kretinga d. mun.;2010;41;603;278;325
Kretinga d. mun.;2010;42;620;294;326
Kretinga d. mun.;2010;43;627;292;335
Kretinga d. mun.;2010;44;608;319;289
Kretinga d. mun.;2010;45;629;303;326
Kretinga d. mun.;2010;46;608;314;294
Kretinga d. mun.;2010;47;637;312;325
Kretinga d. mun.;2010;48;687;340;347
Kretinga d. mun.;2010;49;630;297;333
Kretinga d. mun.;2010;50;594;283;311
Kretinga d. mun.;2010;51;638;312;326
Kretinga d. mun.;2010;52;574;280;294
Kretinga d. mun.;2010;53;531;263;268
Kretinga d. mun.;2010;54;523;250;273
Kretinga d. mun.;2010;55;502;224;278
Kretinga d. mun.;2010;56;456;213;243
Kretinga d. mun.;2010;57;441;215;226
Kretinga d. mun.;2010;58;463;198;265
Kretinga d. mun.;2010;59;436;198;238
Kretinga d. mun.;2010;60;433;203;230
Kretinga d. mun.;2010;61;420;184;236
Kretinga d. mun.;2010;62;368;149;219
Kretinga d. mun.;2010;63;355;158;197
Kretinga d. mun.;2010;64;376;154;222
Kretinga d. mun.;2010;65;341;149;192
Kretinga d. mun.;2010;66;385;157;228
Kretinga d. mun.;2010;67;436;168;268
Kretinga d. mun.;2010;68;418;152;266
Kretinga d. mun.;2010;69;417;168;249
Kretinga d. mun.;2010;70;371;139;232
Kretinga d. mun.;2010;71;400;152;248
Kretinga d. mun.;2010;72;407;147;260
Kretinga d. mun.;2010;73;414;148;266
Kretinga d. mun.;2010;74;419;127;292
Kretinga d. mun.;2010;75;342;132;210
Kretinga d. mun.;2010;76;361;132;229
Kretinga d. mun.;2010;77;319;112;207
Kretinga d. mun.;2010;78;294;101;193
Kretinga d. mun.;2010;79;333;118;215
Kretinga d. mun.;2010;80;248;68;180
Kretinga d. mun.;2010;81;249;71;178
Kretinga d. mun.;2010;82;235;75;160
Kretinga d. mun.;2010;83;217;66;151
Kretinga d. mun.;2010;84;207;64;143
Kretinga d. mun.;2010;85;612;167;445
Kretinga d. mun.;2011;-1;41461;19423;22038
Kretinga d. mun.;2011;0;433;234;199
Kretinga d. mun.;2011;1;415;216;199
Kretinga d. mun.;2011;2;409;214;195
Kretinga d. mun.;2011;3;376;192;184
Kretinga d. mun.;2011;4;412;193;219
Kretinga d. mun.;2011;5;405;212;193
Kretinga d. mun.;2011;6;405;196;209
Kretinga d. mun.;2011;7;437;217;220
Kretinga d. mun.;2011;8;415;228;187
Kretinga d. mun.;2011;9;443;206;237
Kretinga d. mun.;2011;10;477;257;220
Kretinga d. mun.;2011;11;475;233;242
Kretinga d. mun.;2011;12;499;255;244
Kretinga d. mun.;2011;13;529;267;262
Kretinga d. mun.;2011;14;621;301;320
Kretinga d. mun.;2011;15;563;294;269
Kretinga d. mun.;2011;16;651;329;322
Kretinga d. mun.;2011;17;699;328;371
Kretinga d. mun.;2011;18;727;370;357
Kretinga d. mun.;2011;19;636;345;291
Kretinga d. mun.;2011;20;626;321;305
Kretinga d. mun.;2011;21;580;306;274
Kretinga d. mun.;2011;22;494;256;238
Kretinga d. mun.;2011;23;524;275;249
Kretinga d. mun.;2011;24;511;274;237
Kretinga d. mun.;2011;25;503;262;241
Kretinga d. mun.;2011;26;478;248;230
Kretinga d. mun.;2011;27;473;239;234
Kretinga d. mun.;2011;28;451;224;227
Kretinga d. mun.;2011;29;436;215;221
Kretinga d. mun.;2011;30;464;245;219
Kretinga d. mun.;2011;31;460;238;222
Kretinga d. mun.;2011;32;493;237;256
Kretinga d. mun.;2011;33;475;243;232
Kretinga d. mun.;2011;34;509;256;253
Kretinga d. mun.;2011;35;549;269;280
Kretinga d. mun.;2011;36;548;276;272
Kretinga d. mun.;2011;37;552;282;270
Kretinga d. mun.;2011;38;589;279;310
Kretinga d. mun.;2011;39;637;331;306
Kretinga d. mun.;2011;40;617;303;314
Kretinga d. mun.;2011;41;649;302;347
Kretinga d. mun.;2011;42;616;292;324
Kretinga d. mun.;2011;43;626;301;325
Kretinga d. mun.;2011;44;626;292;334
Kretinga d. mun.;2011;45;653;345;308
Kretinga d. mun.;2011;46;650;321;329
Kretinga d. mun.;2011;47;604;304;300
Kretinga d. mun.;2011;48;636;316;320
Kretinga d. mun.;2011;49;653;310;343
Kretinga d. mun.;2011;50;621;282;339
Kretinga d. mun.;2011;51;594;285;309
Kretinga d. mun.;2011;52;626;293;333
Kretinga d. mun.;2011;53;577;275;302
Kretinga d. mun.;2011;54;531;259;272
Kretinga d. mun.;2011;55;511;244;267
Kretinga d. mun.;2011;56;499;230;269
Kretinga d. mun.;2011;57;470;210;260
Kretinga d. mun.;2011;58;450;215;235
Kretinga d. mun.;2011;59;448;194;254
Kretinga d. mun.;2011;60;440;197;243
Kretinga d. mun.;2011;61;449;208;241
Kretinga d. mun.;2011;62;428;186;242
Kretinga d. mun.;2011;63;379;151;228
Kretinga d. mun.;2011;64;356;151;205
Kretinga d. mun.;2011;65;366;142;224
Kretinga d. mun.;2011;66;354;149;205
Kretinga d. mun.;2011;67;375;148;227
Kretinga d. mun.;2011;68;423;167;256
Kretinga d. mun.;2011;69;419;154;265
Kretinga d. mun.;2011;70;414;169;245
Kretinga d. mun.;2011;71;370;141;229
Kretinga d. mun.;2011;72;397;150;247
Kretinga d. mun.;2011;73;387;131;256
Kretinga d. mun.;2011;74;400;141;259
Kretinga d. mun.;2011;75;388;113;275
Kretinga d. mun.;2011;76;325;124;201
Kretinga d. mun.;2011;77;336;121;215
Kretinga d. mun.;2011;78;288;98;190
Kretinga d. mun.;2011;79;275;91;184
Kretinga d. mun.;2011;80;297;104;193
Kretinga d. mun.;2011;81;219;63;156
Kretinga d. mun.;2011;82;239;71;168
Kretinga d. mun.;2011;83;206;64;142
Kretinga d. mun.;2011;84;193;59;134
Kretinga d. mun.;2011;85;702;194;508
Kretinga d. mun.;2012;-1;40880;19126;21754
Kretinga d. mun.;2012;0;414;223;191
Kretinga d. mun.;2012;1;421;226;195
Kretinga d. mun.;2012;2;412;217;195
Kretinga d. mun.;2012;3;415;213;202
Kretinga d. mun.;2012;4;369;186;183
Kretinga d. mun.;2012;5;411;190;221
Kretinga d. mun.;2012;6;405;205;200
Kretinga d. mun.;2012;7;409;199;210
Kretinga d. mun.;2012;8;429;213;216
Kretinga d. mun.;2012;9;408;223;185
Kretinga d. mun.;2012;10;442;209;233
Kretinga d. mun.;2012;11;475;257;218
Kretinga d. mun.;2012;12;464;228;236
Kretinga d. mun.;2012;13;500;255;245
Kretinga d. mun.;2012;14;524;263;261
Kretinga d. mun.;2012;15;622;303;319
Kretinga d. mun.;2012;16;564;292;272
Kretinga d. mun.;2012;17;648;328;320
Kretinga d. mun.;2012;18;694;328;366
Kretinga d. mun.;2012;19;714;371;343
Kretinga d. mun.;2012;20;628;337;291
Kretinga d. mun.;2012;21;607;316;291
Kretinga d. mun.;2012;22;562;294;268
Kretinga d. mun.;2012;23;464;246;218
Kretinga d. mun.;2012;24;500;262;238
Kretinga d. mun.;2012;25;485;263;222
Kretinga d. mun.;2012;26;460;240;220
Kretinga d. mun.;2012;27;452;235;217
Kretinga d. mun.;2012;28;458;227;231
Kretinga d. mun.;2012;29;433;217;216
Kretinga d. mun.;2012;30;430;208;222
Kretinga d. mun.;2012;31;442;228;214
Kretinga d. mun.;2012;32;445;228;217
Kretinga d. mun.;2012;33;486;234;252
Kretinga d. mun.;2012;34;464;238;226
Kretinga d. mun.;2012;35;493;245;248
Kretinga d. mun.;2012;36;539;264;275
Kretinga d. mun.;2012;37;530;261;269
Kretinga d. mun.;2012;38;543;279;264
Kretinga d. mun.;2012;39;582;276;306
Kretinga d. mun.;2012;40;629;326;303
Kretinga d. mun.;2012;41;613;302;311
Kretinga d. mun.;2012;42;646;304;342
Kretinga d. mun.;2012;43;612;287;325
Kretinga d. mun.;2012;44;623;303;320
Kretinga d. mun.;2012;45;607;278;329
Kretinga d. mun.;2012;46;640;334;306
Kretinga d. mun.;2012;47;645;316;329
Kretinga d. mun.;2012;48;594;298;296
Kretinga d. mun.;2012;49;631;311;320
Kretinga d. mun.;2012;50;645;307;338
Kretinga d. mun.;2012;51;609;269;340
Kretinga d. mun.;2012;52;590;284;306
Kretinga d. mun.;2012;53;625;294;331
Kretinga d. mun.;2012;54;570;272;298
Kretinga d. mun.;2012;55;526;252;274
Kretinga d. mun.;2012;56;505;241;264
Kretinga d. mun.;2012;57;490;225;265
Kretinga d. mun.;2012;58;460;202;258
Kretinga d. mun.;2012;59;444;211;233
Kretinga d. mun.;2012;60;446;191;255
Kretinga d. mun.;2012;61;441;196;245
Kretinga d. mun.;2012;62;447;206;241
Kretinga d. mun.;2012;63;419;182;237
Kretinga d. mun.;2012;64;378;150;228
Kretinga d. mun.;2012;65;351;152;199
Kretinga d. mun.;2012;66;356;137;219
Kretinga d. mun.;2012;67;351;147;204
Kretinga d. mun.;2012;68;373;146;227
Kretinga d. mun.;2012;69;412;161;251
Kretinga d. mun.;2012;70;414;151;263
Kretinga d. mun.;2012;71;406;166;240
Kretinga d. mun.;2012;72;364;137;227
Kretinga d. mun.;2012;73;385;144;241
Kretinga d. mun.;2012;74;374;121;253
Kretinga d. mun.;2012;75;387;127;260
Kretinga d. mun.;2012;76;374;105;269
Kretinga d. mun.;2012;77;308;116;192
Kretinga d. mun.;2012;78;311;111;200
Kretinga d. mun.;2012;79;276;90;186
Kretinga d. mun.;2012;80;252;79;173
Kretinga d. mun.;2012;81;270;91;179
Kretinga d. mun.;2012;82;204;55;149
Kretinga d. mun.;2012;83;212;58;154
Kretinga d. mun.;2012;84;175;48;127
Kretinga d. mun.;2012;85;747;216;531
Kretinga d. mun.;2013;-1;40595;18985;21610
Kretinga d. mun.;2013;0;416;201;215
Kretinga d. mun.;2013;1;416;227;189
Kretinga d. mun.;2013;2;421;228;193
Kretinga d. mun.;2013;3;414;221;193
Kretinga d. mun.;2013;4;413;207;206
Kretinga d. mun.;2013;5;368;188;180
Kretinga d. mun.;2013;6;409;191;218
Kretinga d. mun.;2013;7;402;203;199
Kretinga d. mun.;2013;8;412;201;211
Kretinga d. mun.;2013;9;421;209;212
Kretinga d. mun.;2013;10;408;223;185
Kretinga d. mun.;2013;11;435;207;228
Kretinga d. mun.;2013;12;468;255;213
Kretinga d. mun.;2013;13;464;228;236
Kretinga d. mun.;2013;14;497;256;241
Kretinga d. mun.;2013;15;527;263;264
Kretinga d. mun.;2013;16;627;308;319
Kretinga d. mun.;2013;17;562;292;270
Kretinga d. mun.;2013;18;642;325;317
Kretinga d. mun.;2013;19;681;323;358
Kretinga d. mun.;2013;20;702;366;336
Kretinga d. mun.;2013;21;613;331;282
Kretinga d. mun.;2013;22;576;299;277
Kretinga d. mun.;2013;23;550;291;259
Kretinga d. mun.;2013;24;446;238;208
Kretinga d. mun.;2013;25;479;259;220
Kretinga d. mun.;2013;26;470;255;215
Kretinga d. mun.;2013;27;445;236;209
Kretinga d. mun.;2013;28;448;236;212
Kretinga d. mun.;2013;29;442;222;220
Kretinga d. mun.;2013;30;418;203;215
Kretinga d. mun.;2013;31;423;210;213
Kretinga d. mun.;2013;32;443;230;213
Kretinga d. mun.;2013;33;433;222;211
Kretinga d. mun.;2013;34;493;240;253
Kretinga d. mun.;2013;35;462;235;227
Kretinga d. mun.;2013;36;487;239;248
Kretinga d. mun.;2013;37;538;264;274
Kretinga d. mun.;2013;38;524;260;264
Kretinga d. mun.;2013;39;540;278;262
Kretinga d. mun.;2013;40;580;272;308
Kretinga d. mun.;2013;41;619;318;301
Kretinga d. mun.;2013;42;600;294;306
Kretinga d. mun.;2013;43;641;300;341
Kretinga d. mun.;2013;44;605;284;321
Kretinga d. mun.;2013;45;610;298;312
Kretinga d. mun.;2013;46;600;273;327
Kretinga d. mun.;2013;47;636;331;305
Kretinga d. mun.;2013;48;639;313;326
Kretinga d. mun.;2013;49;595;299;296
Kretinga d. mun.;2013;50;635;313;322
Kretinga d. mun.;2013;51;631;297;334
Kretinga d. mun.;2013;52;606;264;342
Kretinga d. mun.;2013;53;587;279;308
Kretinga d. mun.;2013;54;620;286;334
Kretinga d. mun.;2013;55;560;263;297
Kretinga d. mun.;2013;56;522;250;272
Kretinga d. mun.;2013;57;502;239;263
Kretinga d. mun.;2013;58;482;219;263
Kretinga d. mun.;2013;59;459;198;261
Kretinga d. mun.;2013;60;438;205;233
Kretinga d. mun.;2013;61;451;192;259
Kretinga d. mun.;2013;62;444;199;245
Kretinga d. mun.;2013;63;440;202;238
Kretinga d. mun.;2013;64;409;173;236
Kretinga d. mun.;2013;65;371;146;225
Kretinga d. mun.;2013;66;347;148;199
Kretinga d. mun.;2013;67;344;129;215
Kretinga d. mun.;2013;68;338;136;202
Kretinga d. mun.;2013;69;369;147;222
Kretinga d. mun.;2013;70;406;154;252
Kretinga d. mun.;2013;71;407;146;261
Kretinga d. mun.;2013;72;395;157;238
Kretinga d. mun.;2013;73;360;134;226
Kretinga d. mun.;2013;74;376;140;236
Kretinga d. mun.;2013;75;363;111;252
Kretinga d. mun.;2013;76;372;117;255
Kretinga d. mun.;2013;77;361;98;263
Kretinga d. mun.;2013;78;297;112;185
Kretinga d. mun.;2013;79;297;103;194
Kretinga d. mun.;2013;80;264;86;178
Kretinga d. mun.;2013;81;242;72;170
Kretinga d. mun.;2013;82;261;88;173
Kretinga d. mun.;2013;83;192;55;137
Kretinga d. mun.;2013;84;190;50;140
Kretinga d. mun.;2013;85;797;225;572
Kretinga d. mun.;2014;-1;40133;18763;21370
Kretinga d. mun.;2014;0;396;194;202
Kretinga d. mun.;2014;1;416;203;213
Kretinga d. mun.;2014;2;421;231;190
Kretinga d. mun.;2014;3;423;230;193
Kretinga d. mun.;2014;4;405;219;186
Kretinga d. mun.;2014;5;407;204;203
Kretinga d. mun.;2014;6;360;183;177
Kretinga d. mun.;2014;7;400;188;212
Kretinga d. mun.;2014;8;405;203;202
Kretinga d. mun.;2014;9;407;198;209
Kretinga d. mun.;2014;10;412;202;210
Kretinga d. mun.;2014;11;398;219;179
Kretinga d. mun.;2014;12;426;203;223
Kretinga d. mun.;2014;13;460;250;210
Kretinga d. mun.;2014;14;455;223;232
Kretinga d. mun.;2014;15;496;255;241
Kretinga d. mun.;2014;16;521;262;259
Kretinga d. mun.;2014;17;625;309;316
Kretinga d. mun.;2014;18;560;291;269
Kretinga d. mun.;2014;19;632;321;311
Kretinga d. mun.;2014;20;667;315;352
Kretinga d. mun.;2014;21;686;362;324
Kretinga d. mun.;2014;22;598;323;275
Kretinga d. mun.;2014;23;557;292;265
Kretinga d. mun.;2014;24;524;283;241
Kretinga d. mun.;2014;25;430;231;199
Kretinga d. mun.;2014;26;455;247;208
Kretinga d. mun.;2014;27;461;247;214
Kretinga d. mun.;2014;28;430;226;204
Kretinga d. mun.;2014;29;446;232;214
Kretinga d. mun.;2014;30;416;208;208
Kretinga d. mun.;2014;31;408;203;205
Kretinga d. mun.;2014;32;412;207;205
Kretinga d. mun.;2014;33;428;222;206
Kretinga d. mun.;2014;34;426;219;207
Kretinga d. mun.;2014;35;479;231;248
Kretinga d. mun.;2014;36;440;221;219
Kretinga d. mun.;2014;37;482;239;243
Kretinga d. mun.;2014;38;531;255;276
Kretinga d. mun.;2014;39;519;255;264
Kretinga d. mun.;2014;40;534;276;258
Kretinga d. mun.;2014;41;581;275;306
Kretinga d. mun.;2014;42;606;312;294
Kretinga d. mun.;2014;43;593;287;306
Kretinga d. mun.;2014;44;641;298;343
Kretinga d. mun.;2014;45;601;285;316
Kretinga d. mun.;2014;46;609;297;312
Kretinga d. mun.;2014;47;589;270;319
Kretinga d. mun.;2014;48;639;332;307
Kretinga d. mun.;2014;49;633;306;327
Kretinga d. mun.;2014;50;591;292;299
Kretinga d. mun.;2014;51;629;309;320
Kretinga d. mun.;2014;52;623;293;330
Kretinga d. mun.;2014;53;600;260;340
Kretinga d. mun.;2014;54;577;270;307
Kretinga d. mun.;2014;55;608;274;334
Kretinga d. mun.;2014;56;561;266;295
Kretinga d. mun.;2014;57;522;250;272
Kretinga d. mun.;2014;58;498;235;263
Kretinga d. mun.;2014;59;481;215;266
Kretinga d. mun.;2014;60;456;196;260
Kretinga d. mun.;2014;61;439;204;235
Kretinga d. mun.;2014;62;447;190;257
Kretinga d. mun.;2014;63;441;197;244
Kretinga d. mun.;2014;64;440;202;238
Kretinga d. mun.;2014;65;403;167;236
Kretinga d. mun.;2014;66;362;143;219
Kretinga d. mun.;2014;67;339;143;196
Kretinga d. mun.;2014;68;338;125;213
Kretinga d. mun.;2014;69;331;133;198
Kretinga d. mun.;2014;70;366;145;221
Kretinga d. mun.;2014;71;397;151;246
Kretinga d. mun.;2014;72;396;138;258
Kretinga d. mun.;2014;73;381;150;231
Kretinga d. mun.;2014;74;350;131;219
Kretinga d. mun.;2014;75;368;135;233
Kretinga d. mun.;2014;76;349;102;247
Kretinga d. mun.;2014;77;363;113;250
Kretinga d. mun.;2014;78;351;93;258
Kretinga d. mun.;2014;79;284;105;179
Kretinga d. mun.;2014;80;274;95;179
Kretinga d. mun.;2014;81;249;81;168
Kretinga d. mun.;2014;82;222;62;160
Kretinga d. mun.;2014;83;235;80;155
Kretinga d. mun.;2014;84;177;50;127
Kretinga d. mun.;2014;85;839;224;615
Kretinga d. mun.;2015;-1;39758;18584;21174
Kretinga d. mun.;2015;0;402;199;203
Kretinga d. mun.;2015;1;390;192;198
Kretinga d. mun.;2015;2;412;201;211
Kretinga d. mun.;2015;3;417;227;190
Kretinga d. mun.;2015;4;423;229;194
Kretinga d. mun.;2015;5;399;213;186
Kretinga d. mun.;2015;6;393;196;197
Kretinga d. mun.;2015;7;352;180;172
Kretinga d. mun.;2015;8;391;185;206
Kretinga d. mun.;2015;9;403;197;206
Kretinga d. mun.;2015;10;400;191;209
Kretinga d. mun.;2015;11;408;201;207
Kretinga d. mun.;2015;12;398;221;177
Kretinga d. mun.;2015;13;421;201;220
Kretinga d. mun.;2015;14;470;254;216
Kretinga d. mun.;2015;15;452;221;231
Kretinga d. mun.;2015;16;494;258;236
Kretinga d. mun.;2015;17;523;265;258
Kretinga d. mun.;2015;18;617;308;309
Kretinga d. mun.;2015;19;550;284;266
Kretinga d. mun.;2015;20;624;317;307
Kretinga d. mun.;2015;21;655;309;346
Kretinga d. mun.;2015;22;673;352;321
Kretinga d. mun.;2015;23;585;320;265
Kretinga d. mun.;2015;24;539;286;253
Kretinga d. mun.;2015;25;494;278;216
Kretinga d. mun.;2015;26;409;214;195
Kretinga d. mun.;2015;27;439;236;203
Kretinga d. mun.;2015;28;446;244;202
Kretinga d. mun.;2015;29;417;222;195
Kretinga d. mun.;2015;30;443;230;213
Kretinga d. mun.;2015;31;406;204;202
Kretinga d. mun.;2015;32;404;201;203
Kretinga d. mun.;2015;33;399;204;195
Kretinga d. mun.;2015;34;419;218;201
Kretinga d. mun.;2015;35;407;203;204
Kretinga d. mun.;2015;36;477;229;248
Kretinga d. mun.;2015;37;432;211;221
Kretinga d. mun.;2015;38;477;233;244
Kretinga d. mun.;2015;39;519;253;266
Kretinga d. mun.;2015;40;517;250;267
Kretinga d. mun.;2015;41;528;272;256
Kretinga d. mun.;2015;42;574;270;304
Kretinga d. mun.;2015;43;599;306;293
Kretinga d. mun.;2015;44;591;284;307
Kretinga d. mun.;2015;45;646;300;346
Kretinga d. mun.;2015;46;595;278;317
Kretinga d. mun.;2015;47;609;296;313
Kretinga d. mun.;2015;48;593;271;322
Kretinga d. mun.;2015;49;630;326;304
Kretinga d. mun.;2015;50;621;299;322
Kretinga d. mun.;2015;51;587;287;300
Kretinga d. mun.;2015;52;622;307;315
Kretinga d. mun.;2015;53;628;288;340
Kretinga d. mun.;2015;54;603;260;343
Kretinga d. mun.;2015;55;571;264;307
Kretinga d. mun.;2015;56;610;278;332
Kretinga d. mun.;2015;57;558;266;292
Kretinga d. mun.;2015;58;522;253;269
Kretinga d. mun.;2015;59;491;230;261
Kretinga d. mun.;2015;60;477;210;267
Kretinga d. mun.;2015;61;450;191;259
Kretinga d. mun.;2015;62;431;199;232
Kretinga d. mun.;2015;63;437;184;253
Kretinga d. mun.;2015;64;436;196;240
Kretinga d. mun.;2015;65;432;201;231
Kretinga d. mun.;2015;66;403;165;238
Kretinga d. mun.;2015;67;356;139;217
Kretinga d. mun.;2015;68;336;143;193
Kretinga d. mun.;2015;69;331;122;209
Kretinga d. mun.;2015;70;323;128;195
Kretinga d. mun.;2015;71;360;142;218
Kretinga d. mun.;2015;72;386;145;241
Kretinga d. mun.;2015;73;392;136;256
Kretinga d. mun.;2015;74;370;141;229
Kretinga d. mun.;2015;75;344;128;216
Kretinga d. mun.;2015;76;357;133;224
Kretinga d. mun.;2015;77;341;99;242
Kretinga d. mun.;2015;78;349;104;245
Kretinga d. mun.;2015;79;339;91;248
Kretinga d. mun.;2015;80;264;95;169
Kretinga d. mun.;2015;81;253;85;168
Kretinga d. mun.;2015;82;224;65;159
Kretinga d. mun.;2015;83;207;61;146
Kretinga d. mun.;2015;84;212;73;139
Kretinga d. mun.;2015;85;874;236;638
Kretinga d. mun.;2016;-1;39121;18290;20831
Kretinga d. mun.;2016;0;390;197;193
Kretinga d. mun.;2016;1;396;199;197
Kretinga d. mun.;2016;2;386;190;196
Kretinga d. mun.;2016;3;400;193;207
Kretinga d. mun.;2016;4;414;227;187
Kretinga d. mun.;2016;5;409;225;184
Kretinga d. mun.;2016;6;395;211;184
Kretinga d. mun.;2016;7;394;197;197
Kretinga d. mun.;2016;8;351;179;172
Kretinga d. mun.;2016;9;382;182;200
Kretinga d. mun.;2016;10;400;197;203
Kretinga d. mun.;2016;11;386;183;203
Kretinga d. mun.;2016;12;409;201;208
Kretinga d. mun.;2016;13;392;219;173
Kretinga d. mun.;2016;14;414;198;216
Kretinga d. mun.;2016;15;465;255;210
Kretinga d. mun.;2016;16;447;218;229
Kretinga d. mun.;2016;17;490;257;233
Kretinga d. mun.;2016;18;515;261;254
Kretinga d. mun.;2016;19;608;303;305
Kretinga d. mun.;2016;20;534;276;258
Kretinga d. mun.;2016;21;611;310;301
Kretinga d. mun.;2016;22;629;298;331
Kretinga d. mun.;2016;23;635;330;305
Kretinga d. mun.;2016;24;559;298;261
Kretinga d. mun.;2016;25;501;270;231
Kretinga d. mun.;2016;26;475;274;201
Kretinga d. mun.;2016;27;383;207;176
Kretinga d. mun.;2016;28;427;222;205
Kretinga d. mun.;2016;29;420;230;190
Kretinga d. mun.;2016;30;406;219;187
Kretinga d. mun.;2016;31;421;219;202
Kretinga d. mun.;2016;32;391;189;202
Kretinga d. mun.;2016;33;387;190;197
Kretinga d. mun.;2016;34;385;194;191
Kretinga d. mun.;2016;35;404;210;194
Kretinga d. mun.;2016;36;399;190;209
Kretinga d. mun.;2016;37;466;226;240
Kretinga d. mun.;2016;38;428;210;218
Kretinga d. mun.;2016;39;472;231;241
Kretinga d. mun.;2016;40;517;253;264
Kretinga d. mun.;2016;41;507;244;263
Kretinga d. mun.;2016;42;521;271;250
Kretinga d. mun.;2016;43;573;274;299
Kretinga d. mun.;2016;44;598;306;292
Kretinga d. mun.;2016;45;587;284;303
Kretinga d. mun.;2016;46;634;295;339
Kretinga d. mun.;2016;47;589;274;315
Kretinga d. mun.;2016;48;607;292;315
Kretinga d. mun.;2016;49;586;266;320
Kretinga d. mun.;2016;50;631;327;304
Kretinga d. mun.;2016;51;619;300;319
Kretinga d. mun.;2016;52;586;289;297
Kretinga d. mun.;2016;53;615;297;318
Kretinga d. mun.;2016;54;617;285;332
Kretinga d. mun.;2016;55;596;256;340
Kretinga d. mun.;2016;56;562;256;306
Kretinga d. mun.;2016;57;610;278;332
Kretinga d. mun.;2016;58;549;260;289
Kretinga d. mun.;2016;59;518;248;270
Kretinga d. mun.;2016;60;488;227;261
Kretinga d. mun.;2016;61;476;206;270
Kretinga d. mun.;2016;62;442;184;258
Kretinga d. mun.;2016;63;423;194;229
Kretinga d. mun.;2016;64;425;176;249
Kretinga d. mun.;2016;65;424;190;234
Kretinga d. mun.;2016;66;411;184;227
Kretinga d. mun.;2016;67;395;162;233
Kretinga d. mun.;2016;68;352;136;216
Kretinga d. mun.;2016;69;333;140;193
Kretinga d. mun.;2016;70;325;119;206
Kretinga d. mun.;2016;71;311;118;193
Kretinga d. mun.;2016;72;349;136;213
Kretinga d. mun.;2016;73;375;141;234
Kretinga d. mun.;2016;74;377;128;249
Kretinga d. mun.;2016;75;358;133;225
Kretinga d. mun.;2016;76;336;123;213
Kretinga d. mun.;2016;77;346;127;219
Kretinga d. mun.;2016;78;324;94;230
Kretinga d. mun.;2016;79;329;99;230
Kretinga d. mun.;2016;80;322;84;238
Kretinga d. mun.;2016;81;244;91;153
Kretinga d. mun.;2016;82;236;77;159
Kretinga d. mun.;2016;83;209;62;147
Kretinga d. mun.;2016;84;187;52;135
Kretinga d. mun.;2016;85;926;267;659
Kretinga d. mun.;2017;-1;38558;18035;20523
Kretinga d. mun.;2017;0;394;197;197
Kretinga d. mun.;2017;1;387;197;190
Kretinga d. mun.;2017;2;391;200;191
Kretinga d. mun.;2017;3;387;193;194
Kretinga d. mun.;2017;4;399;188;211
Kretinga d. mun.;2017;5;408;224;184
Kretinga d. mun.;2017;6;410;227;183
Kretinga d. mun.;2017;7;382;206;176
Kretinga d. mun.;2017;8;400;201;199
Kretinga d. mun.;2017;9;348;177;171
Kretinga d. mun.;2017;10;377;183;194
Kretinga d. mun.;2017;11;389;189;200
Kretinga d. mun.;2017;12;376;179;197
Kretinga d. mun.;2017;13;404;201;203
Kretinga d. mun.;2017;14;389;215;174
Kretinga d. mun.;2017;15;407;191;216
Kretinga d. mun.;2017;16;465;255;210
Kretinga d. mun.;2017;17;448;218;230
Kretinga d. mun.;2017;18;480;250;230
Kretinga d. mun.;2017;19;504;255;249
Kretinga d. mun.;2017;20;603;299;304
Kretinga d. mun.;2017;21;528;272;256
Kretinga d. mun.;2017;22;587;303;284
Kretinga d. mun.;2017;23;608;293;315
Kretinga d. mun.;2017;24;618;325;293
Kretinga d. mun.;2017;25;536;283;253
Kretinga d. mun.;2017;26;465;250;215
Kretinga d. mun.;2017;27;455;264;191
Kretinga d. mun.;2017;28;372;211;161
Kretinga d. mun.;2017;29;414;218;196
Kretinga d. mun.;2017;30;421;227;194
Kretinga d. mun.;2017;31;392;208;184
Kretinga d. mun.;2017;32;408;210;198
Kretinga d. mun.;2017;33;381;185;196
Kretinga d. mun.;2017;34;370;177;193
Kretinga d. mun.;2017;35;374;190;184
Kretinga d. mun.;2017;36;400;212;188
Kretinga d. mun.;2017;37;393;189;204
Kretinga d. mun.;2017;38;461;225;236
Kretinga d. mun.;2017;39;416;203;213
Kretinga d. mun.;2017;40;457;221;236
Kretinga d. mun.;2017;41;506;245;261
Kretinga d. mun.;2017;42;500;243;257
Kretinga d. mun.;2017;43;517;270;247
Kretinga d. mun.;2017;44;566;266;300
Kretinga d. mun.;2017;45;583;293;290
Kretinga d. mun.;2017;46;573;279;294
Kretinga d. mun.;2017;47;622;289;333
Kretinga d. mun.;2017;48;590;274;316
Kretinga d. mun.;2017;49;614;296;318
Kretinga d. mun.;2017;50;578;259;319
Kretinga d. mun.;2017;51;631;324;307
Kretinga d. mun.;2017;52;622;302;320
Kretinga d. mun.;2017;53;579;281;298
Kretinga d. mun.;2017;54;601;291;310
Kretinga d. mun.;2017;55;604;279;325
Kretinga d. mun.;2017;56;585;254;331
Kretinga d. mun.;2017;57;555;255;300
Kretinga d. mun.;2017;58;604;273;331
Kretinga d. mun.;2017;59;550;262;288
Kretinga d. mun.;2017;60;514;247;267
Kretinga d. mun.;2017;61;481;220;261
Kretinga d. mun.;2017;62;465;198;267
Kretinga d. mun.;2017;63;436;182;254
Kretinga d. mun.;2017;64;420;191;229
Kretinga d. mun.;2017;65;415;170;245
Kretinga d. mun.;2017;66;416;185;231
Kretinga d. mun.;2017;67;397;173;224
Kretinga d. mun.;2017;68;392;159;233
Kretinga d. mun.;2017;69;343;131;212
Kretinga d. mun.;2017;70;319;131;188
Kretinga d. mun.;2017;71;322;119;203
Kretinga d. mun.;2017;72;305;113;192
Kretinga d. mun.;2017;73;331;125;206
Kretinga d. mun.;2017;74;360;135;225
Kretinga d. mun.;2017;75;358;117;241
Kretinga d. mun.;2017;76;352;128;224
Kretinga d. mun.;2017;77;326;117;209
Kretinga d. mun.;2017;78;328;120;208
Kretinga d. mun.;2017;79;311;89;222
Kretinga d. mun.;2017;80;300;88;212
Kretinga d. mun.;2017;81;301;76;225
Kretinga d. mun.;2017;82;227;83;144
Kretinga d. mun.;2017;83;213;67;146
Kretinga d. mun.;2017;84;187;57;130
Kretinga d. mun.;2017;85;955;268;687
Kretinga d. mun.;2018;-1;37945;17766;20179
Kretinga d. mun.;2018;0;405;205;200
Kretinga d. mun.;2018;1;392;197;195
Kretinga d. mun.;2018;2;383;196;187
Kretinga d. mun.;2018;3;397;199;198
Kretinga d. mun.;2018;4;389;195;194
Kretinga d. mun.;2018;5;395;184;211
Kretinga d. mun.;2018;6;405;225;180
Kretinga d. mun.;2018;7;413;232;181
Kretinga d. mun.;2018;8;368;198;170
Kretinga d. mun.;2018;9;411;205;206
Kretinga d. mun.;2018;10;351;175;176
Kretinga d. mun.;2018;11;374;181;193
Kretinga d. mun.;2018;12;393;193;200
Kretinga d. mun.;2018;13;377;178;199
Kretinga d. mun.;2018;14;405;201;204
Kretinga d. mun.;2018;15;381;211;170
Kretinga d. mun.;2018;16;405;191;214
Kretinga d. mun.;2018;17;457;251;206
Kretinga d. mun.;2018;18;438;212;226
Kretinga d. mun.;2018;19;465;241;224
Kretinga d. mun.;2018;20;478;242;236
Kretinga d. mun.;2018;21;571;275;296
Kretinga d. mun.;2018;22;500;261;239
Kretinga d. mun.;2018;23;556;289;267
Kretinga d. mun.;2018;24;569;275;294
Kretinga d. mun.;2018;25;573;306;267
Kretinga d. mun.;2018;26;502;262;240
Kretinga d. mun.;2018;27;445;252;193
Kretinga d. mun.;2018;28;435;253;182
Kretinga d. mun.;2018;29;341;201;140
Kretinga d. mun.;2018;30;396;212;184
Kretinga d. mun.;2018;31;398;217;181
Kretinga d. mun.;2018;32;373;197;176
Kretinga d. mun.;2018;33;399;200;199
Kretinga d. mun.;2018;34;373;185;188
Kretinga d. mun.;2018;35;361;172;189
Kretinga d. mun.;2018;36;373;187;186
Kretinga d. mun.;2018;37;389;204;185
Kretinga d. mun.;2018;38;389;187;202
Kretinga d. mun.;2018;39;441;215;226
Kretinga d. mun.;2018;40;410;196;214
Kretinga d. mun.;2018;41;459;223;236
Kretinga d. mun.;2018;42;512;250;262
Kretinga d. mun.;2018;43;494;245;249
Kretinga d. mun.;2018;44;502;259;243
Kretinga d. mun.;2018;45;562;264;298
Kretinga d. mun.;2018;46;576;291;285
Kretinga d. mun.;2018;47;571;283;288
Kretinga d. mun.;2018;48;622;286;336
Kretinga d. mun.;2018;49;590;275;315
Kretinga d. mun.;2018;50;604;291;313
Kretinga d. mun.;2018;51;569;255;314
Kretinga d. mun.;2018;52;626;321;305
Kretinga d. mun.;2018;53;618;302;316
Kretinga d. mun.;2018;54;578;283;295
Kretinga d. mun.;2018;55;600;290;310
Kretinga d. mun.;2018;56;602;274;328
Kretinga d. mun.;2018;57;573;247;326
Kretinga d. mun.;2018;58;551;253;298
Kretinga d. mun.;2018;59;601;267;334
Kretinga d. mun.;2018;60;539;253;286
Kretinga d. mun.;2018;61;505;240;265
Kretinga d. mun.;2018;62;481;220;261
Kretinga d. mun.;2018;63;459;196;263
Kretinga d. mun.;2018;64;433;180;253
Kretinga d. mun.;2018;65;423;191;232
Kretinga d. mun.;2018;66;406;165;241
Kretinga d. mun.;2018;67;413;182;231
Kretinga d. mun.;2018;68;391;169;222
Kretinga d. mun.;2018;69;389;157;232
Kretinga d. mun.;2018;70;332;124;208
Kretinga d. mun.;2018;71;311;126;185
Kretinga d. mun.;2018;72;313;116;197
Kretinga d. mun.;2018;73;295;106;189
Kretinga d. mun.;2018;74;323;118;205
Kretinga d. mun.;2018;75;344;125;219
Kretinga d. mun.;2018;76;348;111;237
Kretinga d. mun.;2018;77;332;117;215
Kretinga d. mun.;2018;78;310;113;197
Kretinga d. mun.;2018;79;311;111;200
Kretinga d. mun.;2018;80;289;77;212
Kretinga d. mun.;2018;81;286;85;201
Kretinga d. mun.;2018;82;281;70;211
Kretinga d. mun.;2018;83;216;77;139
Kretinga d. mun.;2018;84;192;60;132
Kretinga d. mun.;2018;85;937;260;677
Kupiškis d. mun.;2001;-1;24622;11526;13096
Kupiškis d. mun.;2001;0;262;136;126
Kupiškis d. mun.;2001;1;237;121;116
Kupiškis d. mun.;2001;2;255;125;130
Kupiškis d. mun.;2001;3;241;132;109
Kupiškis d. mun.;2001;4;305;148;157
Kupiškis d. mun.;2001;5;286;155;131
Kupiškis d. mun.;2001;6;310;150;160
Kupiškis d. mun.;2001;7;373;187;186
Kupiškis d. mun.;2001;8;401;196;205
Kupiškis d. mun.;2001;9;394;204;190
Kupiškis d. mun.;2001;10;383;190;193
Kupiškis d. mun.;2001;11;424;220;204
Kupiškis d. mun.;2001;12;394;194;200
Kupiškis d. mun.;2001;13;421;205;216
Kupiškis d. mun.;2001;14;394;205;189
Kupiškis d. mun.;2001;15;403;198;205
Kupiškis d. mun.;2001;16;401;215;186
Kupiškis d. mun.;2001;17;366;193;173
Kupiškis d. mun.;2001;18;283;134;149
Kupiškis d. mun.;2001;19;203;123;80
Kupiškis d. mun.;2001;20;204;127;77
Kupiškis d. mun.;2001;21;215;116;99
Kupiškis d. mun.;2001;22;273;163;110
Kupiškis d. mun.;2001;23;206;123;83
Kupiškis d. mun.;2001;24;240;121;119
Kupiškis d. mun.;2001;25;255;112;143
Kupiškis d. mun.;2001;26;231;124;107
Kupiškis d. mun.;2001;27;253;120;133
Kupiškis d. mun.;2001;28;265;135;130
Kupiškis d. mun.;2001;29;316;154;162
Kupiškis d. mun.;2001;30;336;171;165
Kupiškis d. mun.;2001;31;343;157;186
Kupiškis d. mun.;2001;32;321;158;163
Kupiškis d. mun.;2001;33;374;179;195
Kupiškis d. mun.;2001;34;359;170;189
Kupiškis d. mun.;2001;35;345;179;166
Kupiškis d. mun.;2001;36;382;205;177
Kupiškis d. mun.;2001;37;365;167;198
Kupiškis d. mun.;2001;38;359;195;164
Kupiškis d. mun.;2001;39;415;204;211
Kupiškis d. mun.;2001;40;366;172;194
Kupiškis d. mun.;2001;41;369;191;178
Kupiškis d. mun.;2001;42;336;153;183
Kupiškis d. mun.;2001;43;337;171;166
Kupiškis d. mun.;2001;44;300;150;150
Kupiškis d. mun.;2001;45;294;134;160
Kupiškis d. mun.;2001;46;310;155;155
Kupiškis d. mun.;2001;47;268;135;133
Kupiškis d. mun.;2001;48;266;155;111
Kupiškis d. mun.;2001;49;280;140;140
Kupiškis d. mun.;2001;50;287;143;144
Kupiškis d. mun.;2001;51;277;133;144
Kupiškis d. mun.;2001;52;276;135;141
Kupiškis d. mun.;2001;53;225;119;106
Kupiškis d. mun.;2001;54;240;117;123
Kupiškis d. mun.;2001;55;269;133;136
Kupiškis d. mun.;2001;56;241;110;131
Kupiškis d. mun.;2001;57;305;130;175
Kupiškis d. mun.;2001;58;323;153;170
Kupiškis d. mun.;2001;59;315;121;194
Kupiškis d. mun.;2001;60;260;118;142
Kupiškis d. mun.;2001;61;290;120;170
Kupiškis d. mun.;2001;62;299;139;160
Kupiškis d. mun.;2001;63;300;133;167
Kupiškis d. mun.;2001;64;342;152;190
Kupiškis d. mun.;2001;65;306;139;167
Kupiškis d. mun.;2001;66;298;116;182
Kupiškis d. mun.;2001;67;265;111;154
Kupiškis d. mun.;2001;68;314;120;194
Kupiškis d. mun.;2001;69;251;92;159
Kupiškis d. mun.;2001;70;272;83;189
Kupiškis d. mun.;2001;71;234;86;148
Kupiškis d. mun.;2001;72;235;81;154
Kupiškis d. mun.;2001;73;232;91;141
Kupiškis d. mun.;2001;74;205;53;152
Kupiškis d. mun.;2001;75;209;65;144
Kupiškis d. mun.;2001;76;223;66;157
Kupiškis d. mun.;2001;77;191;57;134
Kupiškis d. mun.;2001;78;190;47;143
Kupiškis d. mun.;2001;79;188;63;125
Kupiškis d. mun.;2001;80;141;42;99
Kupiškis d. mun.;2001;81;94;32;62
Kupiškis d. mun.;2001;82;74;15;59
Kupiškis d. mun.;2001;83;67;22;45
Kupiškis d. mun.;2001;84;60;19;41
Kupiškis d. mun.;2001;85;405;103;302
Kupiškis d. mun.;2002;-1;24492;11456;13036
Kupiškis d. mun.;2002;0;236;109;127
Kupiškis d. mun.;2002;1;263;137;126
Kupiškis d. mun.;2002;2;242;124;118
Kupiškis d. mun.;2002;3;262;130;132
Kupiškis d. mun.;2002;4;241;131;110
Kupiškis d. mun.;2002;5;308;150;158
Kupiškis d. mun.;2002;6;286;155;131
Kupiškis d. mun.;2002;7;311;150;161
Kupiškis d. mun.;2002;8;373;186;187
Kupiškis d. mun.;2002;9;402;196;206
Kupiškis d. mun.;2002;10;396;205;191
Kupiškis d. mun.;2002;11;383;191;192
Kupiškis d. mun.;2002;12;420;220;200
Kupiškis d. mun.;2002;13;387;191;196
Kupiškis d. mun.;2002;14;417;203;214
Kupiškis d. mun.;2002;15;394;204;190
Kupiškis d. mun.;2002;16;399;198;201
Kupiškis d. mun.;2002;17;392;210;182
Kupiškis d. mun.;2002;18;359;188;171
Kupiškis d. mun.;2002;19;276;131;145
Kupiškis d. mun.;2002;20;202;123;79
Kupiškis d. mun.;2002;21;201;125;76
Kupiškis d. mun.;2002;22;229;117;112
Kupiškis d. mun.;2002;23;280;165;115
Kupiškis d. mun.;2002;24;198;121;77
Kupiškis d. mun.;2002;25;236;118;118
Kupiškis d. mun.;2002;26;257;113;144
Kupiškis d. mun.;2002;27;224;119;105
Kupiškis d. mun.;2002;28;249;119;130
Kupiškis d. mun.;2002;29;259;133;126
Kupiškis d. mun.;2002;30;305;150;155
Kupiškis d. mun.;2002;31;334;170;164
Kupiškis d. mun.;2002;32;339;153;186
Kupiškis d. mun.;2002;33;321;158;163
Kupiškis d. mun.;2002;34;371;176;195
Kupiškis d. mun.;2002;35;353;168;185
Kupiškis d. mun.;2002;36;339;175;164
Kupiškis d. mun.;2002;37;379;204;175
Kupiškis d. mun.;2002;38;359;165;194
Kupiškis d. mun.;2002;39;350;189;161
Kupiškis d. mun.;2002;40;413;205;208
Kupiškis d. mun.;2002;41;364;172;192
Kupiškis d. mun.;2002;42;366;190;176
Kupiškis d. mun.;2002;43;328;147;181
Kupiškis d. mun.;2002;44;333;167;166
Kupiškis d. mun.;2002;45;296;148;148
Kupiškis d. mun.;2002;46;295;134;161
Kupiškis d. mun.;2002;47;311;157;154
Kupiškis d. mun.;2002;48;261;130;131
Kupiškis d. mun.;2002;49;257;151;106
Kupiškis d. mun.;2002;50;277;137;140
Kupiškis d. mun.;2002;51;285;143;142
Kupiškis d. mun.;2002;52;275;133;142
Kupiškis d. mun.;2002;53;273;132;141
Kupiškis d. mun.;2002;54;221;117;104
Kupiškis d. mun.;2002;55;237;113;124
Kupiškis d. mun.;2002;56;260;129;131
Kupiškis d. mun.;2002;57;237;108;129
Kupiškis d. mun.;2002;58;298;124;174
Kupiškis d. mun.;2002;59;314;146;168
Kupiškis d. mun.;2002;60;316;121;195
Kupiškis d. mun.;2002;61;257;118;139
Kupiškis d. mun.;2002;62;287;117;170
Kupiškis d. mun.;2002;63;299;141;158
Kupiškis d. mun.;2002;64;296;130;166
Kupiškis d. mun.;2002;65;343;150;193
Kupiškis d. mun.;2002;66;302;136;166
Kupiškis d. mun.;2002;67;297;115;182
Kupiškis d. mun.;2002;68;265;112;153
Kupiškis d. mun.;2002;69;312;117;195
Kupiškis d. mun.;2002;70;249;91;158
Kupiškis d. mun.;2002;71;273;84;189
Kupiškis d. mun.;2002;72;228;83;145
Kupiškis d. mun.;2002;73;226;79;147
Kupiškis d. mun.;2002;74;223;85;138
Kupiškis d. mun.;2002;75;196;48;148
Kupiškis d. mun.;2002;76;196;59;137
Kupiškis d. mun.;2002;77;215;61;154
Kupiškis d. mun.;2002;78;188;57;131
Kupiškis d. mun.;2002;79;182;45;137
Kupiškis d. mun.;2002;80;179;61;118
Kupiškis d. mun.;2002;81;122;34;88
Kupiškis d. mun.;2002;82;86;28;58
Kupiškis d. mun.;2002;83;69;13;56
Kupiškis d. mun.;2002;84;65;21;44
Kupiškis d. mun.;2002;85;388;97;291
Kupiškis d. mun.;2003;-1;24240;11326;12914
Kupiškis d. mun.;2003;0;195;100;95
Kupiškis d. mun.;2003;1;233;107;126
Kupiškis d. mun.;2003;2;257;134;123
Kupiškis d. mun.;2003;3;240;122;118
Kupiškis d. mun.;2003;4;258;129;129
Kupiškis d. mun.;2003;5;241;130;111
Kupiškis d. mun.;2003;6;306;148;158
Kupiškis d. mun.;2003;7;281;153;128
Kupiškis d. mun.;2003;8;307;150;157
Kupiškis d. mun.;2003;9;369;184;185
Kupiškis d. mun.;2003;10;400;197;203
Kupiškis d. mun.;2003;11;394;203;191
Kupiškis d. mun.;2003;12;377;190;187
Kupiškis d. mun.;2003;13;414;216;198
Kupiškis d. mun.;2003;14;381;188;193
Kupiškis d. mun.;2003;15;410;202;208
Kupiškis d. mun.;2003;16;387;200;187
Kupiškis d. mun.;2003;17;394;195;199
Kupiškis d. mun.;2003;18;384;204;180
Kupiškis d. mun.;2003;19;357;184;173
Kupiškis d. mun.;2003;20;275;131;144
Kupiškis d. mun.;2003;21;205;126;79
Kupiškis d. mun.;2003;22;208;128;80
Kupiškis d. mun.;2003;23;226;115;111
Kupiškis d. mun.;2003;24;278;163;115
Kupiškis d. mun.;2003;25;203;127;76
Kupiškis d. mun.;2003;26;227;112;115
Kupiškis d. mun.;2003;27;249;111;138
Kupiškis d. mun.;2003;28;223;119;104
Kupiškis d. mun.;2003;29;242;114;128
Kupiškis d. mun.;2003;30;257;133;124
Kupiškis d. mun.;2003;31;300;146;154
Kupiškis d. mun.;2003;32;328;168;160
Kupiškis d. mun.;2003;33;332;150;182
Kupiškis d. mun.;2003;34;318;157;161
Kupiškis d. mun.;2003;35;362;170;192
Kupiškis d. mun.;2003;36;345;164;181
Kupiškis d. mun.;2003;37;331;168;163
Kupiškis d. mun.;2003;38;376;203;173
Kupiškis d. mun.;2003;39;359;167;192
Kupiškis d. mun.;2003;40;348;186;162
Kupiškis d. mun.;2003;41;415;208;207
Kupiškis d. mun.;2003;42;364;172;192
Kupiškis d. mun.;2003;43;363;189;174
Kupiškis d. mun.;2003;44;332;150;182
Kupiškis d. mun.;2003;45;331;163;168
Kupiškis d. mun.;2003;46;294;147;147
Kupiškis d. mun.;2003;47;292;132;160
Kupiškis d. mun.;2003;48;303;151;152
Kupiškis d. mun.;2003;49;259;128;131
Kupiškis d. mun.;2003;50;258;151;107
Kupiškis d. mun.;2003;51;276;137;139
Kupiškis d. mun.;2003;52;279;138;141
Kupiškis d. mun.;2003;53;273;134;139
Kupiškis d. mun.;2003;54;271;130;141
Kupiškis d. mun.;2003;55;215;113;102
Kupiškis d. mun.;2003;56;234;113;121
Kupiškis d. mun.;2003;57;258;128;130
Kupiškis d. mun.;2003;58;236;104;132
Kupiškis d. mun.;2003;59;292;118;174
Kupiškis d. mun.;2003;60;308;142;166
Kupiškis d. mun.;2003;61;310;120;190
Kupiškis d. mun.;2003;62;255;118;137
Kupiškis d. mun.;2003;63;287;119;168
Kupiškis d. mun.;2003;64;297;142;155
Kupiškis d. mun.;2003;65;293;129;164
Kupiškis d. mun.;2003;66;335;144;191
Kupiškis d. mun.;2003;67;297;133;164
Kupiškis d. mun.;2003;68;288;109;179
Kupiškis d. mun.;2003;69;263;107;156
Kupiškis d. mun.;2003;70;304;112;192
Kupiškis d. mun.;2003;71;246;87;159
Kupiškis d. mun.;2003;72;263;77;186
Kupiškis d. mun.;2003;73;224;79;145
Kupiškis d. mun.;2003;74;214;70;144
Kupiškis d. mun.;2003;75;215;82;133
Kupiškis d. mun.;2003;76;187;43;144
Kupiškis d. mun.;2003;77;184;51;133
Kupiškis d. mun.;2003;78;201;53;148
Kupiškis d. mun.;2003;79;176;50;126
Kupiškis d. mun.;2003;80;175;40;135
Kupiškis d. mun.;2003;81;162;54;108
Kupiškis d. mun.;2003;82;116;32;84
Kupiškis d. mun.;2003;83;85;28;57
Kupiškis d. mun.;2003;84;60;10;50
Kupiškis d. mun.;2003;85;373;95;278
Kupiškis d. mun.;2004;-1;23865;11165;12700
Kupiškis d. mun.;2004;0;201;102;99
Kupiškis d. mun.;2004;1;193;101;92
Kupiškis d. mun.;2004;2;228;107;121
Kupiškis d. mun.;2004;3;256;133;123
Kupiškis d. mun.;2004;4;237;119;118
Kupiškis d. mun.;2004;5;258;129;129
Kupiškis d. mun.;2004;6;240;131;109
Kupiškis d. mun.;2004;7;304;149;155
Kupiškis d. mun.;2004;8;277;148;129
Kupiškis d. mun.;2004;9;306;151;155
Kupiškis d. mun.;2004;10;368;183;185
Kupiškis d. mun.;2004;11;398;195;203
Kupiškis d. mun.;2004;12;387;197;190
Kupiškis d. mun.;2004;13;376;188;188
Kupiškis d. mun.;2004;14;411;216;195
Kupiškis d. mun.;2004;15;373;186;187
Kupiškis d. mun.;2004;16;401;198;203
Kupiškis d. mun.;2004;17;380;196;184
Kupiškis d. mun.;2004;18;382;189;193
Kupiškis d. mun.;2004;19;377;204;173
Kupiškis d. mun.;2004;20;350;181;169
Kupiškis d. mun.;2004;21;270;126;144
Kupiškis d. mun.;2004;22;204;127;77
Kupiškis d. mun.;2004;23;211;131;80
Kupiškis d. mun.;2004;24;219;113;106
Kupiškis d. mun.;2004;25;276;165;111
Kupiškis d. mun.;2004;26;194;123;71
Kupiškis d. mun.;2004;27;212;103;109
Kupiškis d. mun.;2004;28;242;109;133
Kupiškis d. mun.;2004;29;216;113;103
Kupiškis d. mun.;2004;30;234;111;123
Kupiškis d. mun.;2004;31;245;126;119
Kupiškis d. mun.;2004;32;291;141;150
Kupiškis d. mun.;2004;33;321;165;156
Kupiškis d. mun.;2004;34;325;147;178
Kupiškis d. mun.;2004;35;309;152;157
Kupiškis d. mun.;2004;36;360;169;191
Kupiškis d. mun.;2004;37;345;169;176
Kupiškis d. mun.;2004;38;327;165;162
Kupiškis d. mun.;2004;39;368;198;170
Kupiškis d. mun.;2004;40;353;168;185
Kupiškis d. mun.;2004;41;340;182;158
Kupiškis d. mun.;2004;42;403;202;201
Kupiškis d. mun.;2004;43;364;173;191
Kupiškis d. mun.;2004;44;356;183;173
Kupiškis d. mun.;2004;45;327;148;179
Kupiškis d. mun.;2004;46;324;158;166
Kupiškis d. mun.;2004;47;288;144;144
Kupiškis d. mun.;2004;48;291;134;157
Kupiškis d. mun.;2004;49;300;149;151
Kupiškis d. mun.;2004;50;256;127;129
Kupiškis d. mun.;2004;51;254;147;107
Kupiškis d. mun.;2004;52;273;137;136
Kupiškis d. mun.;2004;53;279;137;142
Kupiškis d. mun.;2004;54;259;122;137
Kupiškis d. mun.;2004;55;265;127;138
Kupiškis d. mun.;2004;56;210;109;101
Kupiškis d. mun.;2004;57;231;110;121
Kupiškis d. mun.;2004;58;256;126;130
Kupiškis d. mun.;2004;59;235;102;133
Kupiškis d. mun.;2004;60;288;113;175
Kupiškis d. mun.;2004;61;301;139;162
Kupiškis d. mun.;2004;62;304;114;190
Kupiškis d. mun.;2004;63;253;116;137
Kupiškis d. mun.;2004;64;287;120;167
Kupiškis d. mun.;2004;65;291;137;154
Kupiškis d. mun.;2004;66;291;126;165
Kupiškis d. mun.;2004;67;331;136;195
Kupiškis d. mun.;2004;68;288;127;161
Kupiškis d. mun.;2004;69;280;106;174
Kupiškis d. mun.;2004;70;249;104;145
Kupiškis d. mun.;2004;71;288;102;186
Kupiškis d. mun.;2004;72;231;79;152
Kupiškis d. mun.;2004;73;252;76;176
Kupiškis d. mun.;2004;74;211;76;135
Kupiškis d. mun.;2004;75;206;67;139
Kupiškis d. mun.;2004;76;194;73;121
Kupiškis d. mun.;2004;77;179;43;136
Kupiškis d. mun.;2004;78;178;49;129
Kupiškis d. mun.;2004;79;193;53;140
Kupiškis d. mun.;2004;80;167;42;125
Kupiškis d. mun.;2004;81;165;37;128
Kupiškis d. mun.;2004;82;146;47;99
Kupiškis d. mun.;2004;83;105;30;75
Kupiškis d. mun.;2004;84;78;26;52
Kupiškis d. mun.;2004;85;373;86;287
Kupiškis d. mun.;2005;-1;23422;10958;12464
Kupiškis d. mun.;2005;0;187;91;96
Kupiškis d. mun.;2005;1;200;103;97
Kupiškis d. mun.;2005;2;191;99;92
Kupiškis d. mun.;2005;3;227;107;120
Kupiškis d. mun.;2005;4;255;133;122
Kupiškis d. mun.;2005;5;238;119;119
Kupiškis d. mun.;2005;6;256;128;128
Kupiškis d. mun.;2005;7;239;130;109
Kupiškis d. mun.;2005;8;301;149;152
Kupiškis d. mun.;2005;9;275;147;128
Kupiškis d. mun.;2005;10;307;152;155
Kupiškis d. mun.;2005;11;365;183;182
Kupiškis d. mun.;2005;12;395;194;201
Kupiškis d. mun.;2005;13;386;197;189
Kupiškis d. mun.;2005;14;372;186;186
Kupiškis d. mun.;2005;15;405;214;191
Kupiškis d. mun.;2005;16;366;180;186
Kupiškis d. mun.;2005;17;394;194;200
Kupiškis d. mun.;2005;18;371;191;180
Kupiškis d. mun.;2005;19;369;183;186
Kupiškis d. mun.;2005;20;362;197;165
Kupiškis d. mun.;2005;21;344;179;165
Kupiškis d. mun.;2005;22;257;120;137
Kupiškis d. mun.;2005;23;203;123;80
Kupiškis d. mun.;2005;24;200;122;78
Kupiškis d. mun.;2005;25;213;111;102
Kupiškis d. mun.;2005;26;256;153;103
Kupiškis d. mun.;2005;27;175;113;62
Kupiškis d. mun.;2005;28;206;102;104
Kupiškis d. mun.;2005;29;233;105;128
Kupiškis d. mun.;2005;30;215;111;104
Kupiškis d. mun.;2005;31;228;107;121
Kupiškis d. mun.;2005;32;239;121;118
Kupiškis d. mun.;2005;33;288;140;148
Kupiškis d. mun.;2005;34;314;161;153
Kupiškis d. mun.;2005;35;316;142;174
Kupiškis d. mun.;2005;36;301;149;152
Kupiškis d. mun.;2005;37;347;159;188
Kupiškis d. mun.;2005;38;340;167;173
Kupiškis d. mun.;2005;39;323;163;160
Kupiškis d. mun.;2005;40;358;190;168
Kupiškis d. mun.;2005;41;348;164;184
Kupiškis d. mun.;2005;42;339;181;158
Kupiškis d. mun.;2005;43;395;198;197
Kupiškis d. mun.;2005;44;358;170;188
Kupiškis d. mun.;2005;45;354;182;172
Kupiškis d. mun.;2005;46;327;148;179
Kupiškis d. mun.;2005;47;312;149;163
Kupiškis d. mun.;2005;48;285;143;142
Kupiškis d. mun.;2005;49;287;130;157
Kupiškis d. mun.;2005;50;295;143;152
Kupiškis d. mun.;2005;51;248;125;123
Kupiškis d. mun.;2005;52;247;141;106
Kupiškis d. mun.;2005;53;272;137;135
Kupiškis d. mun.;2005;54;275;136;139
Kupiškis d. mun.;2005;55;258;122;136
Kupiškis d. mun.;2005;56;262;125;137
Kupiškis d. mun.;2005;57;205;107;98
Kupiškis d. mun.;2005;58;229;108;121
Kupiškis d. mun.;2005;59;249;120;129
Kupiškis d. mun.;2005;60;230;101;129
Kupiškis d. mun.;2005;61;283;111;172
Kupiškis d. mun.;2005;62;297;137;160
Kupiškis d. mun.;2005;63;304;112;192
Kupiškis d. mun.;2005;64;255;114;141
Kupiškis d. mun.;2005;65;286;119;167
Kupiškis d. mun.;2005;66;282;130;152
Kupiškis d. mun.;2005;67;286;125;161
Kupiškis d. mun.;2005;68;319;130;189
Kupiškis d. mun.;2005;69;284;122;162
Kupiškis d. mun.;2005;70;276;105;171
Kupiškis d. mun.;2005;71;234;100;134
Kupiškis d. mun.;2005;72;278;97;181
Kupiškis d. mun.;2005;73;217;71;146
Kupiškis d. mun.;2005;74;243;75;168
Kupiškis d. mun.;2005;75;203;74;129
Kupiškis d. mun.;2005;76;195;62;133
Kupiškis d. mun.;2005;77;185;67;118
Kupiškis d. mun.;2005;78;171;39;132
Kupiškis d. mun.;2005;79;165;44;121
Kupiškis d. mun.;2005;80;183;51;132
Kupiškis d. mun.;2005;81;157;40;117
Kupiškis d. mun.;2005;82;148;33;115
Kupiškis d. mun.;2005;83;127;41;86
Kupiškis d. mun.;2005;84;97;28;69
Kupiškis d. mun.;2005;85;355;86;269
Kupiškis d. mun.;2006;-1;22920;10672;12248
Kupiškis d. mun.;2006;0;193;98;95
Kupiškis d. mun.;2006;1;185;89;96
Kupiškis d. mun.;2006;2;194;101;93
Kupiškis d. mun.;2006;3;190;99;91
Kupiškis d. mun.;2006;4;224;107;117
Kupiškis d. mun.;2006;5;255;133;122
Kupiškis d. mun.;2006;6;237;119;118
Kupiškis d. mun.;2006;7;255;126;129
Kupiškis d. mun.;2006;8;236;128;108
Kupiškis d. mun.;2006;9;301;149;152
Kupiškis d. mun.;2006;10;274;148;126
Kupiškis d. mun.;2006;11;306;151;155
Kupiškis d. mun.;2006;12;362;180;182
Kupiškis d. mun.;2006;13;383;186;197
Kupiškis d. mun.;2006;14;380;196;184
Kupiškis d. mun.;2006;15;361;179;182
Kupiškis d. mun.;2006;16;390;206;184
Kupiškis d. mun.;2006;17;353;173;180
Kupiškis d. mun.;2006;18;384;187;197
Kupiškis d. mun.;2006;19;358;182;176
Kupiškis d. mun.;2006;20;351;175;176
Kupiškis d. mun.;2006;21;341;187;154
Kupiškis d. mun.;2006;22;326;170;156
Kupiškis d. mun.;2006;23;239;113;126
Kupiškis d. mun.;2006;24;182;110;72
Kupiškis d. mun.;2006;25;187;112;75
Kupiškis d. mun.;2006;26;200;102;98
Kupiškis d. mun.;2006;27;249;146;103
Kupiškis d. mun.;2006;28;163;103;60
Kupiškis d. mun.;2006;29;196;99;97
Kupiškis d. mun.;2006;30;220;100;120
Kupiškis d. mun.;2006;31;208;104;104
Kupiškis d. mun.;2006;32;219;101;118
Kupiškis d. mun.;2006;33;237;121;116
Kupiškis d. mun.;2006;34;277;136;141
Kupiškis d. mun.;2006;35;306;157;149
Kupiškis d. mun.;2006;36;306;136;170
Kupiškis d. mun.;2006;37;289;144;145
Kupiškis d. mun.;2006;38;342;156;186
Kupiškis d. mun.;2006;39;334;165;169
Kupiškis d. mun.;2006;40;318;158;160
Kupiškis d. mun.;2006;41;353;188;165
Kupiškis d. mun.;2006;42;340;159;181
Kupiškis d. mun.;2006;43;334;181;153
Kupiškis d. mun.;2006;44;394;195;199
Kupiškis d. mun.;2006;45;347;163;184
Kupiškis d. mun.;2006;46;354;183;171
Kupiškis d. mun.;2006;47;324;147;177
Kupiškis d. mun.;2006;48;309;147;162
Kupiškis d. mun.;2006;49;284;142;142
Kupiškis d. mun.;2006;50;280;126;154
Kupiškis d. mun.;2006;51;284;136;148
Kupiškis d. mun.;2006;52;248;125;123
Kupiškis d. mun.;2006;53;237;135;102
Kupiškis d. mun.;2006;54;264;131;133
Kupiškis d. mun.;2006;55;272;133;139
Kupiškis d. mun.;2006;56;254;121;133
Kupiškis d. mun.;2006;57;259;123;136
Kupiškis d. mun.;2006;58;203;106;97
Kupiškis d. mun.;2006;59;225;104;121
Kupiškis d. mun.;2006;60;244;119;125
Kupiškis d. mun.;2006;61;227;98;129
Kupiškis d. mun.;2006;62;277;108;169
Kupiškis d. mun.;2006;63;292;133;159
Kupiškis d. mun.;2006;64;302;108;194
Kupiškis d. mun.;2006;65;247;109;138
Kupiškis d. mun.;2006;66;282;116;166
Kupiškis d. mun.;2006;67;274;124;150
Kupiškis d. mun.;2006;68;281;119;162
Kupiškis d. mun.;2006;69;312;123;189
Kupiškis d. mun.;2006;70;277;117;160
Kupiškis d. mun.;2006;71;268;99;169
Kupiškis d. mun.;2006;72;228;93;135
Kupiškis d. mun.;2006;73;264;87;177
Kupiškis d. mun.;2006;74;210;66;144
Kupiškis d. mun.;2006;75;233;68;165
Kupiškis d. mun.;2006;76;190;66;124
Kupiškis d. mun.;2006;77;187;58;129
Kupiškis d. mun.;2006;78;177;63;114
Kupiškis d. mun.;2006;79;164;37;127
Kupiškis d. mun.;2006;80;156;42;114
Kupiškis d. mun.;2006;81;168;44;124
Kupiškis d. mun.;2006;82;151;36;115
Kupiškis d. mun.;2006;83;139;30;109
Kupiškis d. mun.;2006;84;118;39;79
Kupiškis d. mun.;2006;85;376;93;283
Kupiškis d. mun.;2007;-1;22509;10428;12081
Kupiškis d. mun.;2007;0;193;74;119
Kupiškis d. mun.;2007;1;190;97;93
Kupiškis d. mun.;2007;2;181;87;94
Kupiškis d. mun.;2007;3;188;97;91
Kupiškis d. mun.;2007;4;187;96;91
Kupiškis d. mun.;2007;5;222;106;116
Kupiškis d. mun.;2007;6;250;132;118
Kupiškis d. mun.;2007;7;236;118;118
Kupiškis d. mun.;2007;8;250;122;128
Kupiškis d. mun.;2007;9;236;127;109
Kupiškis d. mun.;2007;10;301;147;154
Kupiškis d. mun.;2007;11;271;146;125
Kupiškis d. mun.;2007;12;306;152;154
Kupiškis d. mun.;2007;13;359;178;181
Kupiškis d. mun.;2007;14;382;184;198
Kupiškis d. mun.;2007;15;376;194;182
Kupiškis d. mun.;2007;16;353;176;177
Kupiškis d. mun.;2007;17;382;204;178
Kupiškis d. mun.;2007;18;345;169;176
Kupiškis d. mun.;2007;19;376;183;193
Kupiškis d. mun.;2007;20;343;173;170
Kupiškis d. mun.;2007;21;339;167;172
Kupiškis d. mun.;2007;22;329;179;150
Kupiškis d. mun.;2007;23;318;164;154
Kupiškis d. mun.;2007;24;229;105;124
Kupiškis d. mun.;2007;25;174;105;69
Kupiškis d. mun.;2007;26;174;107;67
Kupiškis d. mun.;2007;27;188;98;90
Kupiškis d. mun.;2007;28;238;141;97
Kupiškis d. mun.;2007;29;157;99;58
Kupiškis d. mun.;2007;30;190;95;95
Kupiškis d. mun.;2007;31;217;97;120
Kupiškis d. mun.;2007;32;206;104;102
Kupiškis d. mun.;2007;33;217;98;119
Kupiškis d. mun.;2007;34;236;123;113
Kupiškis d. mun.;2007;35;276;135;141
Kupiškis d. mun.;2007;36;298;150;148
Kupiškis d. mun.;2007;37;308;133;175
Kupiškis d. mun.;2007;38;284;139;145
Kupiškis d. mun.;2007;39;337;152;185
Kupiškis d. mun.;2007;40;328;161;167
Kupiškis d. mun.;2007;41;314;155;159
Kupiškis d. mun.;2007;42;347;185;162
Kupiškis d. mun.;2007;43;335;156;179
Kupiškis d. mun.;2007;44;330;179;151
Kupiškis d. mun.;2007;45;380;186;194
Kupiškis d. mun.;2007;46;347;163;184
Kupiškis d. mun.;2007;47;346;177;169
Kupiškis d. mun.;2007;48;323;148;175
Kupiškis d. mun.;2007;49;304;144;160
Kupiškis d. mun.;2007;50;281;140;141
Kupiškis d. mun.;2007;51;279;125;154
Kupiškis d. mun.;2007;52;279;131;148
Kupiškis d. mun.;2007;53;241;120;121
Kupiškis d. mun.;2007;54;233;131;102
Kupiškis d. mun.;2007;55;257;128;129
Kupiškis d. mun.;2007;56;266;126;140
Kupiškis d. mun.;2007;57;250;119;131
Kupiškis d. mun.;2007;58;253;118;135
Kupiškis d. mun.;2007;59;200;104;96
Kupiškis d. mun.;2007;60;222;102;120
Kupiškis d. mun.;2007;61;244;119;125
Kupiškis d. mun.;2007;62;220;95;125
Kupiškis d. mun.;2007;63;269;105;164
Kupiškis d. mun.;2007;64;281;124;157
Kupiškis d. mun.;2007;65;295;104;191
Kupiškis d. mun.;2007;66;242;107;135
Kupiškis d. mun.;2007;67;276;110;166
Kupiškis d. mun.;2007;68;271;122;149
Kupiškis d. mun.;2007;69;276;118;158
Kupiškis d. mun.;2007;70;298;113;185
Kupiškis d. mun.;2007;71;271;115;156
Kupiškis d. mun.;2007;72;260;95;165
Kupiškis d. mun.;2007;73;219;86;133
Kupiškis d. mun.;2007;74;256;81;175
Kupiškis d. mun.;2007;75;198;63;135
Kupiškis d. mun.;2007;76;226;64;162
Kupiškis d. mun.;2007;77;178;60;118
Kupiškis d. mun.;2007;78;181;55;126
Kupiškis d. mun.;2007;79;162;55;107
Kupiškis d. mun.;2007;80;147;36;111
Kupiškis d. mun.;2007;81;155;46;109
Kupiškis d. mun.;2007;82;157;42;115
Kupiškis d. mun.;2007;83;143;30;113
Kupiškis d. mun.;2007;84;127;28;99
Kupiškis d. mun.;2007;85;400;104;296
Kupiškis d. mun.;2008;-1;22052;10171;11881
Kupiškis d. mun.;2008;0;161;71;90
Kupiškis d. mun.;2008;1;191;73;118
Kupiškis d. mun.;2008;2;190;97;93
Kupiškis d. mun.;2008;3;177;86;91
Kupiškis d. mun.;2008;4;186;93;93
Kupiškis d. mun.;2008;5;187;97;90
Kupiškis d. mun.;2008;6;220;105;115
Kupiškis d. mun.;2008;7;245;128;117
Kupiškis d. mun.;2008;8;230;114;116
Kupiškis d. mun.;2008;9;241;116;125
Kupiškis d. mun.;2008;10;233;126;107
Kupiškis d. mun.;2008;11;293;142;151
Kupiškis d. mun.;2008;12;272;146;126
Kupiškis d. mun.;2008;13;300;149;151
Kupiškis d. mun.;2008;14;357;176;181
Kupiškis d. mun.;2008;15;374;180;194
Kupiškis d. mun.;2008;16;370;188;182
Kupiškis d. mun.;2008;17;351;173;178
Kupiškis d. mun.;2008;18;376;200;176
Kupiškis d. mun.;2008;19;335;164;171
Kupiškis d. mun.;2008;20;370;181;189
Kupiškis d. mun.;2008;21;336;171;165
Kupiškis d. mun.;2008;22;327;162;165
Kupiškis d. mun.;2008;23;322;174;148
Kupiškis d. mun.;2008;24;308;156;152
Kupiškis d. mun.;2008;25;213;98;115
Kupiškis d. mun.;2008;26;164;100;64
Kupiškis d. mun.;2008;27;170;106;64
Kupiškis d. mun.;2008;28;177;92;85
Kupiškis d. mun.;2008;29;230;136;94
Kupiškis d. mun.;2008;30;155;97;58
Kupiškis d. mun.;2008;31;190;96;94
Kupiškis d. mun.;2008;32;215;96;119
Kupiškis d. mun.;2008;33;200;100;100
Kupiškis d. mun.;2008;34;209;95;114
Kupiškis d. mun.;2008;35;236;121;115
Kupiškis d. mun.;2008;36;270;132;138
Kupiškis d. mun.;2008;37;295;149;146
Kupiškis d. mun.;2008;38;306;130;176
Kupiškis d. mun.;2008;39;281;138;143
Kupiškis d. mun.;2008;40;336;150;186
Kupiškis d. mun.;2008;41;321;159;162
Kupiškis d. mun.;2008;42;308;152;156
Kupiškis d. mun.;2008;43;338;176;162
Kupiškis d. mun.;2008;44;329;151;178
Kupiškis d. mun.;2008;45;322;174;148
Kupiškis d. mun.;2008;46;374;185;189
Kupiškis d. mun.;2008;47;345;162;183
Kupiškis d. mun.;2008;48;344;178;166
Kupiškis d. mun.;2008;49;316;142;174
Kupiškis d. mun.;2008;50;298;140;158
Kupiškis d. mun.;2008;51;271;133;138
Kupiškis d. mun.;2008;52;270;118;152
Kupiškis d. mun.;2008;53;270;127;143
Kupiškis d. mun.;2008;54;234;114;120
Kupiškis d. mun.;2008;55;225;126;99
Kupiškis d. mun.;2008;56;256;127;129
Kupiškis d. mun.;2008;57;256;120;136
Kupiškis d. mun.;2008;58;243;116;127
Kupiškis d. mun.;2008;59;244;111;133
Kupiškis d. mun.;2008;60;200;101;99
Kupiškis d. mun.;2008;61;220;102;118
Kupiškis d. mun.;2008;62;237;113;124
Kupiškis d. mun.;2008;63;208;89;119
Kupiškis d. mun.;2008;64;259;100;159
Kupiškis d. mun.;2008;65;274;120;154
Kupiškis d. mun.;2008;66;293;103;190
Kupiškis d. mun.;2008;67;238;103;135
Kupiškis d. mun.;2008;68;267;105;162
Kupiškis d. mun.;2008;69;261;116;145
Kupiškis d. mun.;2008;70;264;109;155
Kupiškis d. mun.;2008;71;294;111;183
Kupiškis d. mun.;2008;72;266;109;157
Kupiškis d. mun.;2008;73;256;95;161
Kupiškis d. mun.;2008;74;208;80;128
Kupiškis d. mun.;2008;75;250;77;173
Kupiškis d. mun.;2008;76;186;60;126
Kupiškis d. mun.;2008;77;219;58;161
Kupiškis d. mun.;2008;78;169;56;113
Kupiškis d. mun.;2008;79;172;52;120
Kupiškis d. mun.;2008;80;159;51;108
Kupiškis d. mun.;2008;81;138;31;107
Kupiškis d. mun.;2008;82;138;36;102
Kupiškis d. mun.;2008;83;145;39;106
Kupiškis d. mun.;2008;84;133;30;103
Kupiškis d. mun.;2008;85;435;110;325
Kupiškis d. mun.;2009;-1;21596;9943;11653
Kupiškis d. mun.;2009;0;182;90;92
Kupiškis d. mun.;2009;1;161;72;89
Kupiškis d. mun.;2009;2;189;72;117
Kupiškis d. mun.;2009;3;185;92;93
Kupiškis d. mun.;2009;4;173;85;88
Kupiškis d. mun.;2009;5;184;91;93
Kupiškis d. mun.;2009;6;186;96;90
Kupiškis d. mun.;2009;7;213;102;111
Kupiškis d. mun.;2009;8;242;127;115
Kupiškis d. mun.;2009;9;229;113;116
Kupiškis d. mun.;2009;10;240;115;125
Kupiškis d. mun.;2009;11;229;124;105
Kupiškis d. mun.;2009;12;287;138;149
Kupiškis d. mun.;2009;13;272;145;127
Kupiškis d. mun.;2009;14;298;146;152
Kupiškis d. mun.;2009;15;355;177;178
Kupiškis d. mun.;2009;16;372;177;195
Kupiškis d. mun.;2009;17;367;189;178
Kupiškis d. mun.;2009;18;348;171;177
Kupiškis d. mun.;2009;19;371;197;174
Kupiškis d. mun.;2009;20;329;163;166
Kupiškis d. mun.;2009;21;360;177;183
Kupiškis d. mun.;2009;22;327;168;159
Kupiškis d. mun.;2009;23;324;157;167
Kupiškis d. mun.;2009;24;313;170;143
Kupiškis d. mun.;2009;25;299;153;146
Kupiškis d. mun.;2009;26;204;98;106
Kupiškis d. mun.;2009;27;151;94;57
Kupiškis d. mun.;2009;28;157;99;58
Kupiškis d. mun.;2009;29;169;89;80
Kupiškis d. mun.;2009;30;218;128;90
Kupiškis d. mun.;2009;31;151;95;56
Kupiškis d. mun.;2009;32;186;96;90
Kupiškis d. mun.;2009;33;207;95;112
Kupiškis d. mun.;2009;34;201;98;103
Kupiškis d. mun.;2009;35;205;91;114
Kupiškis d. mun.;2009;36;231;117;114
Kupiškis d. mun.;2009;37;263;129;134
Kupiškis d. mun.;2009;38;287;144;143
Kupiškis d. mun.;2009;39;302;127;175
Kupiškis d. mun.;2009;40;279;139;140
Kupiškis d. mun.;2009;41;327;145;182
Kupiškis d. mun.;2009;42;316;157;159
Kupiškis d. mun.;2009;43;306;152;154
Kupiškis d. mun.;2009;44;332;172;160
Kupiškis d. mun.;2009;45;325;150;175
Kupiškis d. mun.;2009;46;321;173;148
Kupiškis d. mun.;2009;47;372;183;189
Kupiškis d. mun.;2009;48;343;162;181
Kupiškis d. mun.;2009;49;337;173;164
Kupiškis d. mun.;2009;50;309;136;173
Kupiškis d. mun.;2009;51;290;134;156
Kupiškis d. mun.;2009;52;268;128;140
Kupiškis d. mun.;2009;53;265;117;148
Kupiškis d. mun.;2009;54;263;125;138
Kupiškis d. mun.;2009;55;227;109;118
Kupiškis d. mun.;2009;56;221;123;98
Kupiškis d. mun.;2009;57;251;122;129
Kupiškis d. mun.;2009;58;250;115;135
Kupiškis d. mun.;2009;59;234;110;124
Kupiškis d. mun.;2009;60;235;104;131
Kupiškis d. mun.;2009;61;201;100;101
Kupiškis d. mun.;2009;62;216;97;119
Kupiškis d. mun.;2009;63;224;103;121
Kupiškis d. mun.;2009;64;205;88;117
Kupiškis d. mun.;2009;65;251;94;157
Kupiškis d. mun.;2009;66;268;114;154
Kupiškis d. mun.;2009;67;284;96;188
Kupiškis d. mun.;2009;68;232;101;131
Kupiškis d. mun.;2009;69;258;100;158
Kupiškis d. mun.;2009;70;250;110;140
Kupiškis d. mun.;2009;71;255;103;152
Kupiškis d. mun.;2009;72;287;107;180
Kupiškis d. mun.;2009;73;251;101;150
Kupiškis d. mun.;2009;74;250;90;160
Kupiškis d. mun.;2009;75;195;74;121
Kupiškis d. mun.;2009;76;243;73;170
Kupiškis d. mun.;2009;77;176;55;121
Kupiškis d. mun.;2009;78;209;52;157
Kupiškis d. mun.;2009;79;158;52;106
Kupiškis d. mun.;2009;80;159;44;115
Kupiškis d. mun.;2009;81;147;44;103
Kupiškis d. mun.;2009;82;125;30;95
Kupiškis d. mun.;2009;83;123;30;93
Kupiškis d. mun.;2009;84;129;37;92
Kupiškis d. mun.;2009;85;462;112;350
Kupiškis d. mun.;2010;-1;21064;9664;11400
Kupiškis d. mun.;2010;0;164;77;87
Kupiškis d. mun.;2010;1;178;88;90
Kupiškis d. mun.;2010;2;155;69;86
Kupiškis d. mun.;2010;3;184;71;113
Kupiškis d. mun.;2010;4;185;92;93
Kupiškis d. mun.;2010;5;176;85;91
Kupiškis d. mun.;2010;6;178;87;91
Kupiškis d. mun.;2010;7;177;93;84
Kupiškis d. mun.;2010;8;213;103;110
Kupiškis d. mun.;2010;9;235;123;112
Kupiškis d. mun.;2010;10;227;112;115
Kupiškis d. mun.;2010;11;233;112;121
Kupiškis d. mun.;2010;12;230;124;106
Kupiškis d. mun.;2010;13;285;138;147
Kupiškis d. mun.;2010;14;271;145;126
Kupiškis d. mun.;2010;15;292;141;151
Kupiškis d. mun.;2010;16;352;175;177
Kupiškis d. mun.;2010;17;370;175;195
Kupiškis d. mun.;2010;18;360;183;177
Kupiškis d. mun.;2010;19;341;168;173
Kupiškis d. mun.;2010;20;364;193;171
Kupiškis d. mun.;2010;21;313;154;159
Kupiškis d. mun.;2010;22;343;167;176
Kupiškis d. mun.;2010;23;316;161;155
Kupiškis d. mun.;2010;24;315;155;160
Kupiškis d. mun.;2010;25;298;162;136
Kupiškis d. mun.;2010;26;277;144;133
Kupiškis d. mun.;2010;27;189;89;100
Kupiškis d. mun.;2010;28;131;89;42
Kupiškis d. mun.;2010;29;143;91;52
Kupiškis d. mun.;2010;30;152;79;73
Kupiškis d. mun.;2010;31;204;122;82
Kupiškis d. mun.;2010;32;147;93;54
Kupiškis d. mun.;2010;33;181;95;86
Kupiškis d. mun.;2010;34;199;90;109
Kupiškis d. mun.;2010;35;199;99;100
Kupiškis d. mun.;2010;36;198;84;114
Kupiškis d. mun.;2010;37;225;112;113
Kupiškis d. mun.;2010;38;256;124;132
Kupiškis d. mun.;2010;39;281;141;140
Kupiškis d. mun.;2010;40;295;124;171
Kupiškis d. mun.;2010;41;271;135;136
Kupiškis d. mun.;2010;42;322;143;179
Kupiškis d. mun.;2010;43;304;148;156
Kupiškis d. mun.;2010;44;301;147;154
Kupiškis d. mun.;2010;45;321;163;158
Kupiškis d. mun.;2010;46;320;149;171
Kupiškis d. mun.;2010;47;317;168;149
Kupiškis d. mun.;2010;48;367;182;185
Kupiškis d. mun.;2010;49;334;155;179
Kupiškis d. mun.;2010;50;326;164;162
Kupiškis d. mun.;2010;51;306;135;171
Kupiškis d. mun.;2010;52;287;131;156
Kupiškis d. mun.;2010;53;264;126;138
Kupiškis d. mun.;2010;54;256;112;144
Kupiškis d. mun.;2010;55;258;120;138
Kupiškis d. mun.;2010;56;224;108;116
Kupiškis d. mun.;2010;57;216;120;96
Kupiškis d. mun.;2010;58;245;117;128
Kupiškis d. mun.;2010;59;244;111;133
Kupiškis d. mun.;2010;60;232;110;122
Kupiškis d. mun.;2010;61;229;99;130
Kupiškis d. mun.;2010;62;199;98;101
Kupiškis d. mun.;2010;63;215;97;118
Kupiškis d. mun.;2010;64;214;96;118
Kupiškis d. mun.;2010;65;200;85;115
Kupiškis d. mun.;2010;66;243;87;156
Kupiškis d. mun.;2010;67;260;107;153
Kupiškis d. mun.;2010;68;275;89;186
Kupiškis d. mun.;2010;69;225;95;130
Kupiškis d. mun.;2010;70;249;95;154
Kupiškis d. mun.;2010;71;244;105;139
Kupiškis d. mun.;2010;72;244;100;144
Kupiškis d. mun.;2010;73;277;102;175
Kupiškis d. mun.;2010;74;235;90;145
Kupiškis d. mun.;2010;75;240;86;154
Kupiškis d. mun.;2010;76;190;73;117
Kupiškis d. mun.;2010;77;225;64;161
Kupiškis d. mun.;2010;78;168;51;117
Kupiškis d. mun.;2010;79;201;51;150
Kupiškis d. mun.;2010;80;150;49;101
Kupiškis d. mun.;2010;81;152;39;113
Kupiškis d. mun.;2010;82;136;41;95
Kupiškis d. mun.;2010;83;113;28;85
Kupiškis d. mun.;2010;84;109;26;83
Kupiškis d. mun.;2010;85;524;138;386
Kupiškis d. mun.;2011;-1;20355;9337;11018
Kupiškis d. mun.;2011;0;126;70;56
Kupiškis d. mun.;2011;1;147;63;84
Kupiškis d. mun.;2011;2;160;82;78
Kupiškis d. mun.;2011;3;133;63;70
Kupiškis d. mun.;2011;4;186;70;116
Kupiškis d. mun.;2011;5;167;77;90
Kupiškis d. mun.;2011;6;172;83;89
Kupiškis d. mun.;2011;7;169;87;82
Kupiškis d. mun.;2011;8;175;94;81
Kupiškis d. mun.;2011;9;222;105;117
Kupiškis d. mun.;2011;10;245;134;111
Kupiškis d. mun.;2011;11;231;114;117
Kupiškis d. mun.;2011;12;231;116;115
Kupiškis d. mun.;2011;13;211;106;105
Kupiškis d. mun.;2011;14;292;139;153
Kupiškis d. mun.;2011;15;271;145;126
Kupiškis d. mun.;2011;16;281;139;142
Kupiškis d. mun.;2011;17;348;169;179
Kupiškis d. mun.;2011;18;365;173;192
Kupiškis d. mun.;2011;19;289;158;131
Kupiškis d. mun.;2011;20;290;148;142
Kupiškis d. mun.;2011;21;293;154;139
Kupiškis d. mun.;2011;22;236;129;107
Kupiškis d. mun.;2011;23;253;133;120
Kupiškis d. mun.;2011;24;219;120;99
Kupiškis d. mun.;2011;25;225;123;102
Kupiškis d. mun.;2011;26;206;118;88
Kupiškis d. mun.;2011;27;189;102;87
Kupiškis d. mun.;2011;28;165;79;86
Kupiškis d. mun.;2011;29;151;77;74
Kupiškis d. mun.;2011;30;170;92;78
Kupiškis d. mun.;2011;31;179;79;100
Kupiškis d. mun.;2011;32;215;121;94
Kupiškis d. mun.;2011;33;176;104;72
Kupiškis d. mun.;2011;34;200;91;109
Kupiškis d. mun.;2011;35;215;93;122
Kupiškis d. mun.;2011;36;223;119;104
Kupiškis d. mun.;2011;37;211;102;109
Kupiškis d. mun.;2011;38;245;120;125
Kupiškis d. mun.;2011;39;278;130;148
Kupiškis d. mun.;2011;40;300;144;156
Kupiškis d. mun.;2011;41;309;134;175
Kupiškis d. mun.;2011;42;291;143;148
Kupiškis d. mun.;2011;43;329;156;173
Kupiškis d. mun.;2011;44;321;146;175
Kupiškis d. mun.;2011;45;329;170;159
Kupiškis d. mun.;2011;46;347;177;170
Kupiškis d. mun.;2011;47;322;145;177
Kupiškis d. mun.;2011;48;325;169;156
Kupiškis d. mun.;2011;49;376;187;189
Kupiškis d. mun.;2011;50;322;145;177
Kupiškis d. mun.;2011;51;323;169;154
Kupiškis d. mun.;2011;52;282;126;156
Kupiškis d. mun.;2011;53;295;143;152
Kupiškis d. mun.;2011;54;270;129;141
Kupiškis d. mun.;2011;55;257;117;140
Kupiškis d. mun.;2011;56;257;119;138
Kupiškis d. mun.;2011;57;216;101;115
Kupiškis d. mun.;2011;58;234;127;107
Kupiškis d. mun.;2011;59;250;119;131
Kupiškis d. mun.;2011;60;237;104;133
Kupiškis d. mun.;2011;61;233;106;127
Kupiškis d. mun.;2011;62;221;98;123
Kupiškis d. mun.;2011;63;193;94;99
Kupiškis d. mun.;2011;64;207;87;120
Kupiškis d. mun.;2011;65;214;93;121
Kupiškis d. mun.;2011;66;198;81;117
Kupiškis d. mun.;2011;67;245;88;157
Kupiškis d. mun.;2011;68;254;110;144
Kupiškis d. mun.;2011;69;268;84;184
Kupiškis d. mun.;2011;70;210;88;122
Kupiškis d. mun.;2011;71;237;88;149
Kupiškis d. mun.;2011;72;233;96;137
Kupiškis d. mun.;2011;73;230;92;138
Kupiškis d. mun.;2011;74;256;92;164
Kupiškis d. mun.;2011;75;223;86;137
Kupiškis d. mun.;2011;76;227;80;147
Kupiškis d. mun.;2011;77;184;70;114
Kupiškis d. mun.;2011;78;210;56;154
Kupiškis d. mun.;2011;79;145;42;103
Kupiškis d. mun.;2011;80;188;47;141
Kupiškis d. mun.;2011;81;147;47;100
Kupiškis d. mun.;2011;82;141;36;105
Kupiškis d. mun.;2011;83;119;36;83
Kupiškis d. mun.;2011;84;96;21;75
Kupiškis d. mun.;2011;85;524;128;396
Kupiškis d. mun.;2012;-1;19835;9084;10751
Kupiškis d. mun.;2012;0;138;70;68
Kupiškis d. mun.;2012;1;125;67;58
Kupiškis d. mun.;2012;2;143;60;83
Kupiškis d. mun.;2012;3;152;79;73
Kupiškis d. mun.;2012;4;128;61;67
Kupiškis d. mun.;2012;5;188;69;119
Kupiškis d. mun.;2012;6;164;75;89
Kupiškis d. mun.;2012;7;175;84;91
Kupiškis d. mun.;2012;8;168;86;82
Kupiškis d. mun.;2012;9;173;94;79
Kupiškis d. mun.;2012;10;223;105;118
Kupiškis d. mun.;2012;11;241;130;111
Kupiškis d. mun.;2012;12;235;116;119
Kupiškis d. mun.;2012;13;229;116;113
Kupiškis d. mun.;2012;14;211;107;104
Kupiškis d. mun.;2012;15;291;138;153
Kupiškis d. mun.;2012;16;270;146;124
Kupiškis d. mun.;2012;17;282;140;142
Kupiškis d. mun.;2012;18;345;169;176
Kupiškis d. mun.;2012;19;353;167;186
Kupiškis d. mun.;2012;20;279;152;127
Kupiškis d. mun.;2012;21;280;142;138
Kupiškis d. mun.;2012;22;273;145;128
Kupiškis d. mun.;2012;23;217;125;92
Kupiškis d. mun.;2012;24;247;134;113
Kupiškis d. mun.;2012;25;196;109;87
Kupiškis d. mun.;2012;26;193;112;81
Kupiškis d. mun.;2012;27;187;109;78
Kupiškis d. mun.;2012;28;161;89;72
Kupiškis d. mun.;2012;29;147;70;77
Kupiškis d. mun.;2012;30;144;73;71
Kupiškis d. mun.;2012;31;166;92;74
Kupiškis d. mun.;2012;32;170;73;97
Kupiškis d. mun.;2012;33;216;123;93
Kupiškis d. mun.;2012;34;169;97;72
Kupiškis d. mun.;2012;35;189;83;106
Kupiškis d. mun.;2012;36;203;89;114
Kupiškis d. mun.;2012;37;217;114;103
Kupiškis d. mun.;2012;38;205;98;107
Kupiškis d. mun.;2012;39;244;118;126
Kupiškis d. mun.;2012;40;274;128;146
Kupiškis d. mun.;2012;41;296;141;155
Kupiškis d. mun.;2012;42;306;130;176
Kupiškis d. mun.;2012;43;287;140;147
Kupiškis d. mun.;2012;44;328;156;172
Kupiškis d. mun.;2012;45;319;147;172
Kupiškis d. mun.;2012;46;321;162;159
Kupiškis d. mun.;2012;47;343;173;170
Kupiškis d. mun.;2012;48;316;139;177
Kupiškis d. mun.;2012;49;322;167;155
Kupiškis d. mun.;2012;50;372;185;187
Kupiškis d. mun.;2012;51;317;142;175
Kupiškis d. mun.;2012;52;319;167;152
Kupiškis d. mun.;2012;53;281;126;155
Kupiškis d. mun.;2012;54;291;140;151
Kupiškis d. mun.;2012;55;267;127;140
Kupiškis d. mun.;2012;56;255;116;139
Kupiškis d. mun.;2012;57;255;117;138
Kupiškis d. mun.;2012;58;207;95;112
Kupiškis d. mun.;2012;59;230;124;106
Kupiškis d. mun.;2012;60;245;115;130
Kupiškis d. mun.;2012;61;237;104;133
Kupiškis d. mun.;2012;62;231;104;127
Kupiškis d. mun.;2012;63;221;96;125
Kupiškis d. mun.;2012;64;190;94;96
Kupiškis d. mun.;2012;65;203;85;118
Kupiškis d. mun.;2012;66;205;90;115
Kupiškis d. mun.;2012;67;189;77;112
Kupiškis d. mun.;2012;68;238;84;154
Kupiškis d. mun.;2012;69;248;104;144
Kupiškis d. mun.;2012;70;259;81;178
Kupiškis d. mun.;2012;71;201;83;118
Kupiškis d. mun.;2012;72;230;85;145
Kupiškis d. mun.;2012;73;225;90;135
Kupiškis d. mun.;2012;74;214;81;133
Kupiškis d. mun.;2012;75;250;87;163
Kupiškis d. mun.;2012;76;213;80;133
Kupiškis d. mun.;2012;77;217;74;143
Kupiškis d. mun.;2012;78;172;62;110
Kupiškis d. mun.;2012;79;193;50;143
Kupiškis d. mun.;2012;80;135;40;95
Kupiškis d. mun.;2012;81;171;43;128
Kupiškis d. mun.;2012;82;147;47;100
Kupiškis d. mun.;2012;83;129;32;97
Kupiškis d. mun.;2012;84;104;30;74
Kupiškis d. mun.;2012;85;525;118;407
Kupiškis d. mun.;2013;-1;19425;8897;10528
Kupiškis d. mun.;2013;0;156;74;82
Kupiškis d. mun.;2013;1;137;69;68
Kupiškis d. mun.;2013;2;117;66;51
Kupiškis d. mun.;2013;3;144;61;83
Kupiškis d. mun.;2013;4;147;75;72
Kupiškis d. mun.;2013;5;123;60;63
Kupiškis d. mun.;2013;6;183;67;116
Kupiškis d. mun.;2013;7;163;75;88
Kupiškis d. mun.;2013;8;174;84;90
Kupiškis d. mun.;2013;9;165;83;82
Kupiškis d. mun.;2013;10;169;92;77
Kupiškis d. mun.;2013;11;223;104;119
Kupiškis d. mun.;2013;12;238;127;111
Kupiškis d. mun.;2013;13;232;113;119
Kupiškis d. mun.;2013;14;228;115;113
Kupiškis d. mun.;2013;15;210;107;103
Kupiškis d. mun.;2013;16;291;138;153
Kupiškis d. mun.;2013;17;270;146;124
Kupiškis d. mun.;2013;18;280;138;142
Kupiškis d. mun.;2013;19;339;168;171
Kupiškis d. mun.;2013;20;345;164;181
Kupiškis d. mun.;2013;21;272;150;122
Kupiškis d. mun.;2013;22;270;140;130
Kupiškis d. mun.;2013;23;258;139;119
Kupiškis d. mun.;2013;24;200;121;79
Kupiškis d. mun.;2013;25;231;130;101
Kupiškis d. mun.;2013;26;185;105;80
Kupiškis d. mun.;2013;27;193;112;81
Kupiškis d. mun.;2013;28;171;102;69
Kupiškis d. mun.;2013;29;154;87;67
Kupiškis d. mun.;2013;30;140;68;72
Kupiškis d. mun.;2013;31;134;65;69
Kupiškis d. mun.;2013;32;154;87;67
Kupiškis d. mun.;2013;33;167;68;99
Kupiškis d. mun.;2013;34;220;126;94
Kupiškis d. mun.;2013;35;165;96;69
Kupiškis d. mun.;2013;36;186;82;104
Kupiškis d. mun.;2013;37;197;88;109
Kupiškis d. mun.;2013;38;216;116;100
Kupiškis d. mun.;2013;39;202;100;102
Kupiškis d. mun.;2013;40;245;117;128
Kupiškis d. mun.;2013;41;271;128;143
Kupiškis d. mun.;2013;42;292;139;153
Kupiškis d. mun.;2013;43;303;128;175
Kupiškis d. mun.;2013;44;288;141;147
Kupiškis d. mun.;2013;45;323;151;172
Kupiškis d. mun.;2013;46;315;144;171
Kupiškis d. mun.;2013;47;313;158;155
Kupiškis d. mun.;2013;48;344;174;170
Kupiškis d. mun.;2013;49;313;137;176
Kupiškis d. mun.;2013;50;314;161;153
Kupiškis d. mun.;2013;51;367;179;188
Kupiškis d. mun.;2013;52;310;138;172
Kupiškis d. mun.;2013;53;312;163;149
Kupiškis d. mun.;2013;54;273;120;153
Kupiškis d. mun.;2013;55;292;142;150
Kupiškis d. mun.;2013;56;264;124;140
Kupiškis d. mun.;2013;57;254;115;139
Kupiškis d. mun.;2013;58;253;116;137
Kupiškis d. mun.;2013;59;203;92;111
Kupiškis d. mun.;2013;60;226;121;105
Kupiškis d. mun.;2013;61;241;112;129
Kupiškis d. mun.;2013;62;234;102;132
Kupiškis d. mun.;2013;63;223;96;127
Kupiškis d. mun.;2013;64;217;94;123
Kupiškis d. mun.;2013;65;185;88;97
Kupiškis d. mun.;2013;66;201;83;118
Kupiškis d. mun.;2013;67;199;86;113
Kupiškis d. mun.;2013;68;183;74;109
Kupiškis d. mun.;2013;69;233;81;152
Kupiškis d. mun.;2013;70;241;98;143
Kupiškis d. mun.;2013;71;252;75;177
Kupiškis d. mun.;2013;72;197;80;117
Kupiškis d. mun.;2013;73;225;81;144
Kupiškis d. mun.;2013;74;221;88;133
Kupiškis d. mun.;2013;75;199;73;126
Kupiškis d. mun.;2013;76;230;75;155
Kupiškis d. mun.;2013;77;207;77;130
Kupiškis d. mun.;2013;78;202;65;137
Kupiškis d. mun.;2013;79;161;55;106
Kupiškis d. mun.;2013;80;185;47;138
Kupiškis d. mun.;2013;81;129;40;89
Kupiškis d. mun.;2013;82;157;40;117
Kupiškis d. mun.;2013;83;137;44;93
Kupiškis d. mun.;2013;84;116;24;92
Kupiškis d. mun.;2013;85;526;123;403
Kupiškis d. mun.;2014;-1;19058;8732;10326
Kupiškis d. mun.;2014;0;170;87;83
Kupiškis d. mun.;2014;1;155;75;80
Kupiškis d. mun.;2014;2;134;65;69
Kupiškis d. mun.;2014;3;112;63;49
Kupiškis d. mun.;2014;4;139;59;80
Kupiškis d. mun.;2014;5;144;70;74
Kupiškis d. mun.;2014;6;128;63;65
Kupiškis d. mun.;2014;7;179;65;114
Kupiškis d. mun.;2014;8;161;73;88
Kupiškis d. mun.;2014;9;172;81;91
Kupiškis d. mun.;2014;10;164;85;79
Kupiškis d. mun.;2014;11;167;90;77
Kupiškis d. mun.;2014;12;222;104;118
Kupiškis d. mun.;2014;13;238;126;112
Kupiškis d. mun.;2014;14;227;111;116
Kupiškis d. mun.;2014;15;226;114;112
Kupiškis d. mun.;2014;16;209;107;102
Kupiškis d. mun.;2014;17;289;138;151
Kupiškis d. mun.;2014;18;268;147;121
Kupiškis d. mun.;2014;19;271;137;134
Kupiškis d. mun.;2014;20;330;163;167
Kupiškis d. mun.;2014;21;327;153;174
Kupiškis d. mun.;2014;22;264;146;118
Kupiškis d. mun.;2014;23;266;139;127
Kupiškis d. mun.;2014;24;247;136;111
Kupiškis d. mun.;2014;25;193;116;77
Kupiškis d. mun.;2014;26;217;123;94
Kupiškis d. mun.;2014;27;176;101;75
Kupiškis d. mun.;2014;28;179;106;73
Kupiškis d. mun.;2014;29;159;94;65
Kupiškis d. mun.;2014;30;145;88;57
Kupiškis d. mun.;2014;31;133;66;67
Kupiškis d. mun.;2014;32;129;63;66
Kupiškis d. mun.;2014;33;143;83;60
Kupiškis d. mun.;2014;34;162;66;96
Kupiškis d. mun.;2014;35;223;129;94
Kupiškis d. mun.;2014;36;165;96;69
Kupiškis d. mun.;2014;37;178;75;103
Kupiškis d. mun.;2014;38;196;89;107
Kupiškis d. mun.;2014;39;214;117;97
Kupiškis d. mun.;2014;40;200;97;103
Kupiškis d. mun.;2014;41;244;119;125
Kupiškis d. mun.;2014;42;268;127;141
Kupiškis d. mun.;2014;43;287;136;151
Kupiškis d. mun.;2014;44;301;126;175
Kupiškis d. mun.;2014;45;290;144;146
Kupiškis d. mun.;2014;46;324;152;172
Kupiškis d. mun.;2014;47;313;143;170
Kupiškis d. mun.;2014;48;310;155;155
Kupiškis d. mun.;2014;49;342;174;168
Kupiškis d. mun.;2014;50;307;138;169
Kupiškis d. mun.;2014;51;309;160;149
Kupiškis d. mun.;2014;52;362;178;184
Kupiškis d. mun.;2014;53;311;139;172
Kupiškis d. mun.;2014;54;311;162;149
Kupiškis d. mun.;2014;55;274;120;154
Kupiškis d. mun.;2014;56;287;138;149
Kupiškis d. mun.;2014;57;258;123;135
Kupiškis d. mun.;2014;58;251;113;138
Kupiškis d. mun.;2014;59;246;112;134
Kupiškis d. mun.;2014;60;197;87;110
Kupiškis d. mun.;2014;61;224;118;106
Kupiškis d. mun.;2014;62;238;108;130
Kupiškis d. mun.;2014;63;229;98;131
Kupiškis d. mun.;2014;64;216;89;127
Kupiškis d. mun.;2014;65;215;92;123
Kupiškis d. mun.;2014;66;183;86;97
Kupiškis d. mun.;2014;67;197;79;118
Kupiškis d. mun.;2014;68;197;84;113
Kupiškis d. mun.;2014;69;178;70;108
Kupiškis d. mun.;2014;70;228;79;149
Kupiškis d. mun.;2014;71;230;90;140
Kupiškis d. mun.;2014;72;246;72;174
Kupiškis d. mun.;2014;73;187;72;115
Kupiškis d. mun.;2014;74;212;74;138
Kupiškis d. mun.;2014;75;211;81;130
Kupiškis d. mun.;2014;76;192;69;123
Kupiškis d. mun.;2014;77;220;71;149
Kupiškis d. mun.;2014;78;199;71;128
Kupiškis d. mun.;2014;79;195;62;133
Kupiškis d. mun.;2014;80;150;47;103
Kupiškis d. mun.;2014;81;179;46;133
Kupiškis d. mun.;2014;82;125;38;87
Kupiškis d. mun.;2014;83;141;34;107
Kupiškis d. mun.;2014;84;122;39;83
Kupiškis d. mun.;2014;85;531;111;420
Kupiškis d. mun.;2015;-1;18678;8565;10113
Kupiškis d. mun.;2015;0;156;82;74
Kupiškis d. mun.;2015;1;169;89;80
Kupiškis d. mun.;2015;2;152;72;80
Kupiškis d. mun.;2015;3;135;66;69
Kupiškis d. mun.;2015;4;104;61;43
Kupiškis d. mun.;2015;5;138;61;77
Kupiškis d. mun.;2015;6;142;72;70
Kupiškis d. mun.;2015;7;131;62;69
Kupiškis d. mun.;2015;8;179;67;112
Kupiškis d. mun.;2015;9;161;73;88
Kupiškis d. mun.;2015;10;169;79;90
Kupiškis d. mun.;2015;11;162;85;77
Kupiškis d. mun.;2015;12;166;88;78
Kupiškis d. mun.;2015;13;222;103;119
Kupiškis d. mun.;2015;14;234;124;110
Kupiškis d. mun.;2015;15;229;112;117
Kupiškis d. mun.;2015;16;224;114;110
Kupiškis d. mun.;2015;17;210;107;103
Kupiškis d. mun.;2015;18;286;135;151
Kupiškis d. mun.;2015;19;263;145;118
Kupiškis d. mun.;2015;20;260;135;125
Kupiškis d. mun.;2015;21;330;166;164
Kupiškis d. mun.;2015;22;318;152;166
Kupiškis d. mun.;2015;23;258;142;116
Kupiškis d. mun.;2015;24;248;134;114
Kupiškis d. mun.;2015;25;239;129;110
Kupiškis d. mun.;2015;26;183;110;73
Kupiškis d. mun.;2015;27;199;109;90
Kupiškis d. mun.;2015;28;172;99;73
Kupiškis d. mun.;2015;29;164;97;67
Kupiškis d. mun.;2015;30;152;91;61
Kupiškis d. mun.;2015;31;132;82;50
Kupiškis d. mun.;2015;32;126;64;62
Kupiškis d. mun.;2015;33;117;55;62
Kupiškis d. mun.;2015;34;133;73;60
Kupiškis d. mun.;2015;35;163;65;98
Kupiškis d. mun.;2015;36;215;126;89
Kupiškis d. mun.;2015;37;158;91;67
Kupiškis d. mun.;2015;38;178;75;103
Kupiškis d. mun.;2015;39;191;87;104
Kupiškis d. mun.;2015;40;215;119;96
Kupiškis d. mun.;2015;41;200;97;103
Kupiškis d. mun.;2015;42;243;118;125
Kupiškis d. mun.;2015;43;263;122;141
Kupiškis d. mun.;2015;44;286;135;151
Kupiškis d. mun.;2015;45;298;123;175
Kupiškis d. mun.;2015;46;291;144;147
Kupiškis d. mun.;2015;47;325;153;172
Kupiškis d. mun.;2015;48;308;139;169
Kupiškis d. mun.;2015;49;304;153;151
Kupiškis d. mun.;2015;50;341;172;169
Kupiškis d. mun.;2015;51;304;133;171
Kupiškis d. mun.;2015;52;305;155;150
Kupiškis d. mun.;2015;53;361;178;183
Kupiškis d. mun.;2015;54;308;138;170
Kupiškis d. mun.;2015;55;311;162;149
Kupiškis d. mun.;2015;56;268;115;153
Kupiškis d. mun.;2015;57;283;136;147
Kupiškis d. mun.;2015;58;256;121;135
Kupiškis d. mun.;2015;59;250;113;137
Kupiškis d. mun.;2015;60;239;107;132
Kupiškis d. mun.;2015;61;194;87;107
Kupiškis d. mun.;2015;62;218;113;105
Kupiškis d. mun.;2015;63;234;105;129
Kupiškis d. mun.;2015;64;225;94;131
Kupiškis d. mun.;2015;65;208;81;127
Kupiškis d. mun.;2015;66;207;86;121
Kupiškis d. mun.;2015;67;175;80;95
Kupiškis d. mun.;2015;68;190;75;115
Kupiškis d. mun.;2015;69;189;76;113
Kupiškis d. mun.;2015;70;170;64;106
Kupiškis d. mun.;2015;71;225;78;147
Kupiškis d. mun.;2015;72;223;87;136
Kupiškis d. mun.;2015;73;244;73;171
Kupiškis d. mun.;2015;74;181;68;113
Kupiškis d. mun.;2015;75;205;72;133
Kupiškis d. mun.;2015;76;203;76;127
Kupiškis d. mun.;2015;77;181;62;119
Kupiškis d. mun.;2015;78;213;68;145
Kupiškis d. mun.;2015;79;186;68;118
Kupiškis d. mun.;2015;80;186;60;126
Kupiškis d. mun.;2015;81;141;46;95
Kupiškis d. mun.;2015;82;161;41;120
Kupiškis d. mun.;2015;83;109;36;73
Kupiškis d. mun.;2015;84;132;33;99
Kupiškis d. mun.;2015;85;551;124;427
Kupiškis d. mun.;2016;-1;18225;8342;9883
Kupiškis d. mun.;2016;0;178;80;98
Kupiškis d. mun.;2016;1;151;83;68
Kupiškis d. mun.;2016;2;169;89;80
Kupiškis d. mun.;2016;3;142;63;79
Kupiškis d. mun.;2016;4;130;63;67
Kupiškis d. mun.;2016;5;103;60;43
Kupiškis d. mun.;2016;6;140;61;79
Kupiškis d. mun.;2016;7;138;73;65
Kupiškis d. mun.;2016;8;126;58;68
Kupiškis d. mun.;2016;9;174;66;108
Kupiškis d. mun.;2016;10;162;75;87
Kupiškis d. mun.;2016;11;170;79;91
Kupiškis d. mun.;2016;12;164;85;79
Kupiškis d. mun.;2016;13;160;83;77
Kupiškis d. mun.;2016;14;221;103;118
Kupiškis d. mun.;2016;15;235;124;111
Kupiškis d. mun.;2016;16;227;111;116
Kupiškis d. mun.;2016;17;219;112;107
Kupiškis d. mun.;2016;18;207;106;101
Kupiškis d. mun.;2016;19;281;134;147
Kupiškis d. mun.;2016;20;257;143;114
Kupiškis d. mun.;2016;21;258;133;125
Kupiškis d. mun.;2016;22;315;157;158
Kupiškis d. mun.;2016;23;305;147;158
Kupiškis d. mun.;2016;24;243;133;110
Kupiškis d. mun.;2016;25;231;126;105
Kupiškis d. mun.;2016;26;218;121;97
Kupiškis d. mun.;2016;27;169;107;62
Kupiškis d. mun.;2016;28;196;104;92
Kupiškis d. mun.;2016;29;159;93;66
Kupiškis d. mun.;2016;30;154;90;64
Kupiškis d. mun.;2016;31;140;83;57
Kupiškis d. mun.;2016;32;121;78;43
Kupiškis d. mun.;2016;33;121;65;56
Kupiškis d. mun.;2016;34;111;51;60
Kupiškis d. mun.;2016;35;121;66;55
Kupiškis d. mun.;2016;36;157;63;94
Kupiškis d. mun.;2016;37;203;120;83
Kupiškis d. mun.;2016;38;160;93;67
Kupiškis d. mun.;2016;39;170;72;98
Kupiškis d. mun.;2016;40;184;84;100
Kupiškis d. mun.;2016;41;214;118;96
Kupiškis d. mun.;2016;42;199;99;100
Kupiškis d. mun.;2016;43;240;114;126
Kupiškis d. mun.;2016;44;259;120;139
Kupiškis d. mun.;2016;45;284;135;149
Kupiškis d. mun.;2016;46;291;120;171
Kupiškis d. mun.;2016;47;292;145;147
Kupiškis d. mun.;2016;48;324;155;169
Kupiškis d. mun.;2016;49;301;134;167
Kupiškis d. mun.;2016;50;300;150;150
Kupiškis d. mun.;2016;51;337;171;166
Kupiškis d. mun.;2016;52;301;130;171
Kupiškis d. mun.;2016;53;301;154;147
Kupiškis d. mun.;2016;54;352;172;180
Kupiškis d. mun.;2016;55;306;136;170
Kupiškis d. mun.;2016;56;305;158;147
Kupiškis d. mun.;2016;57;263;113;150
Kupiškis d. mun.;2016;58;282;136;146
Kupiškis d. mun.;2016;59;251;116;135
Kupiškis d. mun.;2016;60;247;112;135
Kupiškis d. mun.;2016;61;241;106;135
Kupiškis d. mun.;2016;62;190;87;103
Kupiškis d. mun.;2016;63;213;108;105
Kupiškis d. mun.;2016;64;231;103;128
Kupiškis d. mun.;2016;65;219;90;129
Kupiškis d. mun.;2016;66;202;77;125
Kupiškis d. mun.;2016;67;205;84;121
Kupiškis d. mun.;2016;68;171;76;95
Kupiškis d. mun.;2016;69;187;72;115
Kupiškis d. mun.;2016;70;183;74;109
Kupiškis d. mun.;2016;71;164;59;105
Kupiškis d. mun.;2016;72;215;72;143
Kupiškis d. mun.;2016;73;211;81;130
Kupiškis d. mun.;2016;74;226;63;163
Kupiškis d. mun.;2016;75;176;67;109
Kupiškis d. mun.;2016;76;197;64;133
Kupiškis d. mun.;2016;77;190;66;124
Kupiškis d. mun.;2016;78;170;56;114
Kupiškis d. mun.;2016;79;198;61;137
Kupiškis d. mun.;2016;80;174;63;111
Kupiškis d. mun.;2016;81;172;52;120
Kupiškis d. mun.;2016;82;133;41;92
Kupiškis d. mun.;2016;83;150;38;112
Kupiškis d. mun.;2016;84;98;30;68
Kupiškis d. mun.;2016;85;570;127;443
Kupiškis d. mun.;2017;-1;17670;8097;9573
Kupiškis d. mun.;2017;0;139;64;75
Kupiškis d. mun.;2017;1;181;85;96
Kupiškis d. mun.;2017;2;148;82;66
Kupiškis d. mun.;2017;3;160;84;76
Kupiškis d. mun.;2017;4;137;63;74
Kupiškis d. mun.;2017;5;129;63;66
Kupiškis d. mun.;2017;6;109;62;47
Kupiškis d. mun.;2017;7;134;58;76
Kupiškis d. mun.;2017;8;134;70;64
Kupiškis d. mun.;2017;9;122;56;66
Kupiškis d. mun.;2017;10;170;64;106
Kupiškis d. mun.;2017;11;158;73;85
Kupiškis d. mun.;2017;12;169;78;91
Kupiškis d. mun.;2017;13;164;84;80
Kupiškis d. mun.;2017;14;159;83;76
Kupiškis d. mun.;2017;15;217;101;116
Kupiškis d. mun.;2017;16;234;125;109
Kupiškis d. mun.;2017;17;226;112;114
Kupiškis d. mun.;2017;18;211;108;103
Kupiškis d. mun.;2017;19;199;102;97
Kupiškis d. mun.;2017;20;275;130;145
Kupiškis d. mun.;2017;21;256;142;114
Kupiškis d. mun.;2017;22;253;129;124
Kupiškis d. mun.;2017;23;299;155;144
Kupiškis d. mun.;2017;24;285;139;146
Kupiškis d. mun.;2017;25;224;121;103
Kupiškis d. mun.;2017;26;210;121;89
Kupiškis d. mun.;2017;27;187;112;75
Kupiškis d. mun.;2017;28;138;90;48
Kupiškis d. mun.;2017;29;168;92;76
Kupiškis d. mun.;2017;30;135;87;48
Kupiškis d. mun.;2017;31;128;75;53
Kupiškis d. mun.;2017;32;122;74;48
Kupiškis d. mun.;2017;33;108;75;33
Kupiškis d. mun.;2017;34;114;62;52
Kupiškis d. mun.;2017;35;109;50;59
Kupiškis d. mun.;2017;36;116;64;52
Kupiškis d. mun.;2017;37;157;63;94
Kupiškis d. mun.;2017;38;202;119;83
Kupiškis d. mun.;2017;39;153;87;66
Kupiškis d. mun.;2017;40;168;70;98
Kupiškis d. mun.;2017;41;182;84;98
Kupiškis d. mun.;2017;42;208;113;95
Kupiškis d. mun.;2017;43;197;101;96
Kupiškis d. mun.;2017;44;237;112;125
Kupiškis d. mun.;2017;45;256;116;140
Kupiškis d. mun.;2017;46;284;135;149
Kupiškis d. mun.;2017;47;292;119;173
Kupiškis d. mun.;2017;48;283;139;144
Kupiškis d. mun.;2017;49;318;151;167
Kupiškis d. mun.;2017;50;308;140;168
Kupiškis d. mun.;2017;51;300;153;147
Kupiškis d. mun.;2017;52;328;165;163
Kupiškis d. mun.;2017;53;294;127;167
Kupiškis d. mun.;2017;54;292;150;142
Kupiškis d. mun.;2017;55;344;163;181
Kupiškis d. mun.;2017;56;301;134;167
Kupiškis d. mun.;2017;57;304;156;148
Kupiškis d. mun.;2017;58;263;116;147
Kupiškis d. mun.;2017;59;274;135;139
Kupiškis d. mun.;2017;60;248;114;134
Kupiškis d. mun.;2017;61;241;108;133
Kupiškis d. mun.;2017;62;233;99;134
Kupiškis d. mun.;2017;63;188;87;101
Kupiškis d. mun.;2017;64;202;99;103
Kupiškis d. mun.;2017;65;229;100;129
Kupiškis d. mun.;2017;66;213;85;128
Kupiškis d. mun.;2017;67;193;69;124
Kupiškis d. mun.;2017;68;200;81;119
Kupiškis d. mun.;2017;69;167;74;93
Kupiškis d. mun.;2017;70;182;69;113
Kupiškis d. mun.;2017;71;178;71;107
Kupiškis d. mun.;2017;72;165;58;107
Kupiškis d. mun.;2017;73;210;68;142
Kupiškis d. mun.;2017;74;201;75;126
Kupiškis d. mun.;2017;75;216;60;156
Kupiškis d. mun.;2017;76;165;59;106
Kupiškis d. mun.;2017;77;184;57;127
Kupiškis d. mun.;2017;78;174;60;114
Kupiškis d. mun.;2017;79;161;53;108
Kupiškis d. mun.;2017;80;184;56;128
Kupiškis d. mun.;2017;81;164;57;107
Kupiškis d. mun.;2017;82;163;47;116
Kupiškis d. mun.;2017;83;128;40;88
Kupiškis d. mun.;2017;84;144;37;107
Kupiškis d. mun.;2017;85;565;131;434
Kupiškis d. mun.;2018;-1;17097;7834;9263
Kupiškis d. mun.;2018;0;136;68;68
Kupiškis d. mun.;2018;1;136;61;75
Kupiškis d. mun.;2018;2;177;81;96
Kupiškis d. mun.;2018;3;144;80;64
Kupiškis d. mun.;2018;4;159;80;79
Kupiškis d. mun.;2018;5;135;63;72
Kupiškis d. mun.;2018;6;128;62;66
Kupiškis d. mun.;2018;7;107;59;48
Kupiškis d. mun.;2018;8;128;55;73
Kupiškis d. mun.;2018;9;130;69;61
Kupiškis d. mun.;2018;10;122;56;66
Kupiškis d. mun.;2018;11;164;61;103
Kupiškis d. mun.;2018;12;157;73;84
Kupiškis d. mun.;2018;13;168;78;90
Kupiškis d. mun.;2018;14;158;84;74
Kupiškis d. mun.;2018;15;157;81;76
Kupiškis d. mun.;2018;16;219;102;117
Kupiškis d. mun.;2018;17;232;124;108
Kupiškis d. mun.;2018;18;218;107;111
Kupiškis d. mun.;2018;19;201;100;101
Kupiškis d. mun.;2018;20;193;99;94
Kupiškis d. mun.;2018;21;265;128;137
Kupiškis d. mun.;2018;22;245;140;105
Kupiškis d. mun.;2018;23;229;118;111
Kupiškis d. mun.;2018;24;282;148;134
Kupiškis d. mun.;2018;25;261;131;130
Kupiškis d. mun.;2018;26;190;110;80
Kupiškis d. mun.;2018;27;183;113;70
Kupiškis d. mun.;2018;28;164;100;64
Kupiškis d. mun.;2018;29;115;80;35
Kupiškis d. mun.;2018;30;147;83;64
Kupiškis d. mun.;2018;31;120;83;37
Kupiškis d. mun.;2018;32;116;71;45
Kupiškis d. mun.;2018;33;110;68;42
Kupiškis d. mun.;2018;34;101;67;34
Kupiškis d. mun.;2018;35;104;55;49
Kupiškis d. mun.;2018;36;103;46;57
Kupiškis d. mun.;2018;37;110;60;50
Kupiškis d. mun.;2018;38;151;61;90
Kupiškis d. mun.;2018;39;195;114;81
Kupiškis d. mun.;2018;40;148;85;63
Kupiškis d. mun.;2018;41;163;64;99
Kupiškis d. mun.;2018;42;174;80;94
Kupiškis d. mun.;2018;43;203;108;95
Kupiškis d. mun.;2018;44;191;97;94
Kupiškis d. mun.;2018;45;238;114;124
Kupiškis d. mun.;2018;46;254;115;139
Kupiškis d. mun.;2018;47;272;130;142
Kupiškis d. mun.;2018;48;285;115;170
Kupiškis d. mun.;2018;49;280;136;144
Kupiškis d. mun.;2018;50;312;150;162
Kupiškis d. mun.;2018;51;304;138;166
Kupiškis d. mun.;2018;52;299;153;146
Kupiškis d. mun.;2018;53;328;165;163
Kupiškis d. mun.;2018;54;290;124;166
Kupiškis d. mun.;2018;55;284;145;139
Kupiškis d. mun.;2018;56;337;160;177
Kupiškis d. mun.;2018;57;300;134;166
Kupiškis d. mun.;2018;58;298;153;145
Kupiškis d. mun.;2018;59;261;115;146
Kupiškis d. mun.;2018;60;270;133;137
Kupiškis d. mun.;2018;61;241;108;133
Kupiškis d. mun.;2018;62;241;109;132
Kupiškis d. mun.;2018;63;227;97;130
Kupiškis d. mun.;2018;64;186;84;102
Kupiškis d. mun.;2018;65;199;97;102
Kupiškis d. mun.;2018;66;223;96;127
Kupiškis d. mun.;2018;67;209;81;128
Kupiškis d. mun.;2018;68;186;65;121
Kupiškis d. mun.;2018;69;198;79;119
Kupiškis d. mun.;2018;70;161;69;92
Kupiškis d. mun.;2018;71;174;62;112
Kupiškis d. mun.;2018;72;175;70;105
Kupiškis d. mun.;2018;73;164;57;107
Kupiškis d. mun.;2018;74;207;65;142
Kupiškis d. mun.;2018;75;191;70;121
Kupiškis d. mun.;2018;76;212;58;154
Kupiškis d. mun.;2018;77;159;55;104
Kupiškis d. mun.;2018;78;178;53;125
Kupiškis d. mun.;2018;79;162;54;108
Kupiškis d. mun.;2018;80;154;50;104
Kupiškis d. mun.;2018;81;169;50;119
Kupiškis d. mun.;2018;82;155;51;104
Kupiškis d. mun.;2018;83;156;44;112
Kupiškis d. mun.;2018;84;117;32;85
Kupiškis d. mun.;2018;85;602;145;457
Lazdijai d. mun.;2001;-1;27182;13146;14036
Lazdijai d. mun.;2001;0;265;130;135
Lazdijai d. mun.;2001;1;253;139;114
Lazdijai d. mun.;2001;2;291;151;140
Lazdijai d. mun.;2001;3;261;147;114
Lazdijai d. mun.;2001;4;304;164;140
Lazdijai d. mun.;2001;5;318;164;154
Lazdijai d. mun.;2001;6;349;170;179
Lazdijai d. mun.;2001;7;351;180;171
Lazdijai d. mun.;2001;8;419;215;204
Lazdijai d. mun.;2001;9;416;230;186
Lazdijai d. mun.;2001;10;444;243;201
Lazdijai d. mun.;2001;11;432;228;204
Lazdijai d. mun.;2001;12;427;234;193
Lazdijai d. mun.;2001;13;437;209;228
Lazdijai d. mun.;2001;14;443;218;225
Lazdijai d. mun.;2001;15;421;216;205
Lazdijai d. mun.;2001;16;386;196;190
Lazdijai d. mun.;2001;17;388;195;193
Lazdijai d. mun.;2001;18;309;167;142
Lazdijai d. mun.;2001;19;262;153;109
Lazdijai d. mun.;2001;20;239;132;107
Lazdijai d. mun.;2001;21;255;160;95
Lazdijai d. mun.;2001;22;263;142;121
Lazdijai d. mun.;2001;23;274;138;136
Lazdijai d. mun.;2001;24;286;140;146
Lazdijai d. mun.;2001;25;307;159;148
Lazdijai d. mun.;2001;26;320;167;153
Lazdijai d. mun.;2001;27;307;172;135
Lazdijai d. mun.;2001;28;346;195;151
Lazdijai d. mun.;2001;29;325;168;157
Lazdijai d. mun.;2001;30;343;183;160
Lazdijai d. mun.;2001;31;354;197;157
Lazdijai d. mun.;2001;32;390;215;175
Lazdijai d. mun.;2001;33;396;204;192
Lazdijai d. mun.;2001;34;374;201;173
Lazdijai d. mun.;2001;35;353;183;170
Lazdijai d. mun.;2001;36;378;222;156
Lazdijai d. mun.;2001;37;375;201;174
Lazdijai d. mun.;2001;38;400;223;177
Lazdijai d. mun.;2001;39;366;188;178
Lazdijai d. mun.;2001;40;391;225;166
Lazdijai d. mun.;2001;41;352;189;163
Lazdijai d. mun.;2001;42;347;187;160
Lazdijai d. mun.;2001;43;333;193;140
Lazdijai d. mun.;2001;44;292;159;133
Lazdijai d. mun.;2001;45;282;130;152
Lazdijai d. mun.;2001;46;285;156;129
Lazdijai d. mun.;2001;47;266;140;126
Lazdijai d. mun.;2001;48;288;164;124
Lazdijai d. mun.;2001;49;257;146;111
Lazdijai d. mun.;2001;50;265;129;136
Lazdijai d. mun.;2001;51;279;154;125
Lazdijai d. mun.;2001;52;251;122;129
Lazdijai d. mun.;2001;53;208;99;109
Lazdijai d. mun.;2001;54;259;128;131
Lazdijai d. mun.;2001;55;254;129;125
Lazdijai d. mun.;2001;56;240;122;118
Lazdijai d. mun.;2001;57;309;127;182
Lazdijai d. mun.;2001;58;313;141;172
Lazdijai d. mun.;2001;59;330;146;184
Lazdijai d. mun.;2001;60;349;149;200
Lazdijai d. mun.;2001;61;287;114;173
Lazdijai d. mun.;2001;62;342;157;185
Lazdijai d. mun.;2001;63;333;157;176
Lazdijai d. mun.;2001;64;358;146;212
Lazdijai d. mun.;2001;65;406;163;243
Lazdijai d. mun.;2001;66;326;136;190
Lazdijai d. mun.;2001;67;354;148;206
Lazdijai d. mun.;2001;68;388;165;223
Lazdijai d. mun.;2001;69;364;152;212
Lazdijai d. mun.;2001;70;374;132;242
Lazdijai d. mun.;2001;71;353;124;229
Lazdijai d. mun.;2001;72;359;122;237
Lazdijai d. mun.;2001;73;323;115;208
Lazdijai d. mun.;2001;74;288;93;195
Lazdijai d. mun.;2001;75;274;79;195
Lazdijai d. mun.;2001;76;284;94;190
Lazdijai d. mun.;2001;77;273;84;189
Lazdijai d. mun.;2001;78;251;82;169
Lazdijai d. mun.;2001;79;183;72;111
Lazdijai d. mun.;2001;80;145;48;97
Lazdijai d. mun.;2001;81;124;43;81
Lazdijai d. mun.;2001;82;105;41;64
Lazdijai d. mun.;2001;83;86;19;67
Lazdijai d. mun.;2001;84;85;25;60
Lazdijai d. mun.;2001;85;540;161;379
Lazdijai d. mun.;2002;-1;26926;12983;13943
Lazdijai d. mun.;2002;0;265;128;137
Lazdijai d. mun.;2002;1;264;132;132
Lazdijai d. mun.;2002;2;254;140;114
Lazdijai d. mun.;2002;3;294;155;139
Lazdijai d. mun.;2002;4;261;146;115
Lazdijai d. mun.;2002;5;300;164;136
Lazdijai d. mun.;2002;6;316;160;156
Lazdijai d. mun.;2002;7;350;170;180
Lazdijai d. mun.;2002;8;348;178;170
Lazdijai d. mun.;2002;9;418;214;204
Lazdijai d. mun.;2002;10;416;229;187
Lazdijai d. mun.;2002;11;440;239;201
Lazdijai d. mun.;2002;12;430;226;204
Lazdijai d. mun.;2002;13;419;231;188
Lazdijai d. mun.;2002;14;430;203;227
Lazdijai d. mun.;2002;15;437;215;222
Lazdijai d. mun.;2002;16;418;215;203
Lazdijai d. mun.;2002;17;380;192;188
Lazdijai d. mun.;2002;18;374;190;184
Lazdijai d. mun.;2002;19;288;161;127
Lazdijai d. mun.;2002;20;260;152;108
Lazdijai d. mun.;2002;21;236;127;109
Lazdijai d. mun.;2002;22;254;156;98
Lazdijai d. mun.;2002;23;262;141;121
Lazdijai d. mun.;2002;24;266;130;136
Lazdijai d. mun.;2002;25;284;140;144
Lazdijai d. mun.;2002;26;301;154;147
Lazdijai d. mun.;2002;27;318;165;153
Lazdijai d. mun.;2002;28;304;168;136
Lazdijai d. mun.;2002;29;336;184;152
Lazdijai d. mun.;2002;30;317;163;154
Lazdijai d. mun.;2002;31;331;177;154
Lazdijai d. mun.;2002;32;346;190;156
Lazdijai d. mun.;2002;33;385;210;175
Lazdijai d. mun.;2002;34;387;199;188
Lazdijai d. mun.;2002;35;363;195;168
Lazdijai d. mun.;2002;36;349;181;168
Lazdijai d. mun.;2002;37;373;215;158
Lazdijai d. mun.;2002;38;369;196;173
Lazdijai d. mun.;2002;39;388;213;175
Lazdijai d. mun.;2002;40;360;185;175
Lazdijai d. mun.;2002;41;386;221;165
Lazdijai d. mun.;2002;42;351;187;164
Lazdijai d. mun.;2002;43;347;188;159
Lazdijai d. mun.;2002;44;328;190;138
Lazdijai d. mun.;2002;45;287;158;129
Lazdijai d. mun.;2002;46;279;128;151
Lazdijai d. mun.;2002;47;286;158;128
Lazdijai d. mun.;2002;48;263;137;126
Lazdijai d. mun.;2002;49;280;157;123
Lazdijai d. mun.;2002;50;256;145;111
Lazdijai d. mun.;2002;51;257;127;130
Lazdijai d. mun.;2002;52;277;151;126
Lazdijai d. mun.;2002;53;250;121;129
Lazdijai d. mun.;2002;54;205;97;108
Lazdijai d. mun.;2002;55;255;127;128
Lazdijai d. mun.;2002;56;247;125;122
Lazdijai d. mun.;2002;57;234;119;115
Lazdijai d. mun.;2002;58;305;124;181
Lazdijai d. mun.;2002;59;307;136;171
Lazdijai d. mun.;2002;60;325;142;183
Lazdijai d. mun.;2002;61;343;148;195
Lazdijai d. mun.;2002;62;286;111;175
Lazdijai d. mun.;2002;63;330;148;182
Lazdijai d. mun.;2002;64;331;156;175
Lazdijai d. mun.;2002;65;360;146;214
Lazdijai d. mun.;2002;66;406;162;244
Lazdijai d. mun.;2002;67;322;132;190
Lazdijai d. mun.;2002;68;351;144;207
Lazdijai d. mun.;2002;69;384;158;226
Lazdijai d. mun.;2002;70;360;151;209
Lazdijai d. mun.;2002;71;373;130;243
Lazdijai d. mun.;2002;72;344;119;225
Lazdijai d. mun.;2002;73;358;120;238
Lazdijai d. mun.;2002;74;329;119;210
Lazdijai d. mun.;2002;75;279;86;193
Lazdijai d. mun.;2002;76;268;79;189
Lazdijai d. mun.;2002;77;276;92;184
Lazdijai d. mun.;2002;78;258;74;184
Lazdijai d. mun.;2002;79;239;76;163
Lazdijai d. mun.;2002;80;172;65;107
Lazdijai d. mun.;2002;81;138;46;92
Lazdijai d. mun.;2002;82;116;41;75
Lazdijai d. mun.;2002;83;101;39;62
Lazdijai d. mun.;2002;84;76;16;60
Lazdijai d. mun.;2002;85;510;158;352
Lazdijai d. mun.;2003;-1;26631;12795;13836
Lazdijai d. mun.;2003;0;236;114;122
Lazdijai d. mun.;2003;1;261;126;135
Lazdijai d. mun.;2003;2;264;131;133
Lazdijai d. mun.;2003;3;248;138;110
Lazdijai d. mun.;2003;4;292;153;139
Lazdijai d. mun.;2003;5;259;144;115
Lazdijai d. mun.;2003;6;299;163;136
Lazdijai d. mun.;2003;7;313;157;156
Lazdijai d. mun.;2003;8;347;168;179
Lazdijai d. mun.;2003;9;348;177;171
Lazdijai d. mun.;2003;10;416;213;203
Lazdijai d. mun.;2003;11;412;228;184
Lazdijai d. mun.;2003;12;435;237;198
Lazdijai d. mun.;2003;13;424;223;201
Lazdijai d. mun.;2003;14;412;228;184
Lazdijai d. mun.;2003;15;424;200;224
Lazdijai d. mun.;2003;16;433;212;221
Lazdijai d. mun.;2003;17;409;210;199
Lazdijai d. mun.;2003;18;379;192;187
Lazdijai d. mun.;2003;19;369;189;180
Lazdijai d. mun.;2003;20;286;161;125
Lazdijai d. mun.;2003;21;257;150;107
Lazdijai d. mun.;2003;22;239;126;113
Lazdijai d. mun.;2003;23;260;156;104
Lazdijai d. mun.;2003;24;258;136;122
Lazdijai d. mun.;2003;25;258;129;129
Lazdijai d. mun.;2003;26;276;135;141
Lazdijai d. mun.;2003;27;294;152;142
Lazdijai d. mun.;2003;28;310;160;150
Lazdijai d. mun.;2003;29;302;166;136
Lazdijai d. mun.;2003;30;331;180;151
Lazdijai d. mun.;2003;31;314;162;152
Lazdijai d. mun.;2003;32;324;169;155
Lazdijai d. mun.;2003;33;339;184;155
Lazdijai d. mun.;2003;34;383;207;176
Lazdijai d. mun.;2003;35;383;197;186
Lazdijai d. mun.;2003;36;361;194;167
Lazdijai d. mun.;2003;37;341;176;165
Lazdijai d. mun.;2003;38;371;214;157
Lazdijai d. mun.;2003;39;370;197;173
Lazdijai d. mun.;2003;40;384;213;171
Lazdijai d. mun.;2003;41;360;185;175
Lazdijai d. mun.;2003;42;381;218;163
Lazdijai d. mun.;2003;43;347;185;162
Lazdijai d. mun.;2003;44;343;185;158
Lazdijai d. mun.;2003;45;328;190;138
Lazdijai d. mun.;2003;46;284;154;130
Lazdijai d. mun.;2003;47;277;128;149
Lazdijai d. mun.;2003;48;287;158;129
Lazdijai d. mun.;2003;49;262;136;126
Lazdijai d. mun.;2003;50;279;156;123
Lazdijai d. mun.;2003;51;253;144;109
Lazdijai d. mun.;2003;52;255;126;129
Lazdijai d. mun.;2003;53;281;152;129
Lazdijai d. mun.;2003;54;246;118;128
Lazdijai d. mun.;2003;55;200;91;109
Lazdijai d. mun.;2003;56;246;122;124
Lazdijai d. mun.;2003;57;247;123;124
Lazdijai d. mun.;2003;58;227;111;116
Lazdijai d. mun.;2003;59;301;122;179
Lazdijai d. mun.;2003;60;302;132;170
Lazdijai d. mun.;2003;61;316;135;181
Lazdijai d. mun.;2003;62;345;146;199
Lazdijai d. mun.;2003;63;283;109;174
Lazdijai d. mun.;2003;64;326;146;180
Lazdijai d. mun.;2003;65;334;158;176
Lazdijai d. mun.;2003;66;353;140;213
Lazdijai d. mun.;2003;67;397;159;238
Lazdijai d. mun.;2003;68;318;131;187
Lazdijai d. mun.;2003;69;342;138;204
Lazdijai d. mun.;2003;70;374;152;222
Lazdijai d. mun.;2003;71;352;145;207
Lazdijai d. mun.;2003;72;365;123;242
Lazdijai d. mun.;2003;73;328;109;219
Lazdijai d. mun.;2003;74;344;109;235
Lazdijai d. mun.;2003;75;310;108;202
Lazdijai d. mun.;2003;76;271;85;186
Lazdijai d. mun.;2003;77;255;71;184
Lazdijai d. mun.;2003;78;260;85;175
Lazdijai d. mun.;2003;79;246;69;177
Lazdijai d. mun.;2003;80;216;66;150
Lazdijai d. mun.;2003;81;162;57;105
Lazdijai d. mun.;2003;82;131;42;89
Lazdijai d. mun.;2003;83;107;40;67
Lazdijai d. mun.;2003;84;91;32;59
Lazdijai d. mun.;2003;85;478;137;341
Lazdijai d. mun.;2004;-1;26221;12534;13687
Lazdijai d. mun.;2004;0;213;107;106
Lazdijai d. mun.;2004;1;232;112;120
Lazdijai d. mun.;2004;2;260;126;134
Lazdijai d. mun.;2004;3;261;128;133
Lazdijai d. mun.;2004;4;248;136;112
Lazdijai d. mun.;2004;5;290;153;137
Lazdijai d. mun.;2004;6;260;144;116
Lazdijai d. mun.;2004;7;298;163;135
Lazdijai d. mun.;2004;8;316;160;156
Lazdijai d. mun.;2004;9;347;169;178
Lazdijai d. mun.;2004;10;345;177;168
Lazdijai d. mun.;2004;11;409;207;202
Lazdijai d. mun.;2004;12;406;225;181
Lazdijai d. mun.;2004;13;426;233;193
Lazdijai d. mun.;2004;14;416;217;199
Lazdijai d. mun.;2004;15;404;224;180
Lazdijai d. mun.;2004;16;419;198;221
Lazdijai d. mun.;2004;17;423;208;215
Lazdijai d. mun.;2004;18;399;205;194
Lazdijai d. mun.;2004;19;372;191;181
Lazdijai d. mun.;2004;20;368;187;181
Lazdijai d. mun.;2004;21;281;157;124
Lazdijai d. mun.;2004;22;253;152;101
Lazdijai d. mun.;2004;23;231;123;108
Lazdijai d. mun.;2004;24;262;153;109
Lazdijai d. mun.;2004;25;247;130;117
Lazdijai d. mun.;2004;26;252;123;129
Lazdijai d. mun.;2004;27;263;128;135
Lazdijai d. mun.;2004;28;282;145;137
Lazdijai d. mun.;2004;29;308;157;151
Lazdijai d. mun.;2004;30;291;162;129
Lazdijai d. mun.;2004;31;316;173;143
Lazdijai d. mun.;2004;32;305;158;147
Lazdijai d. mun.;2004;33;314;164;150
Lazdijai d. mun.;2004;34;328;176;152
Lazdijai d. mun.;2004;35;378;205;173
Lazdijai d. mun.;2004;36;380;194;186
Lazdijai d. mun.;2004;37;359;194;165
Lazdijai d. mun.;2004;38;334;174;160
Lazdijai d. mun.;2004;39;360;211;149
Lazdijai d. mun.;2004;40;369;196;173
Lazdijai d. mun.;2004;41;383;213;170
Lazdijai d. mun.;2004;42;354;181;173
Lazdijai d. mun.;2004;43;377;215;162
Lazdijai d. mun.;2004;44;349;187;162
Lazdijai d. mun.;2004;45;342;185;157
Lazdijai d. mun.;2004;46;326;189;137
Lazdijai d. mun.;2004;47;281;152;129
Lazdijai d. mun.;2004;48;271;125;146
Lazdijai d. mun.;2004;49;281;154;127
Lazdijai d. mun.;2004;50;253;127;126
Lazdijai d. mun.;2004;51;275;150;125
Lazdijai d. mun.;2004;52;250;145;105
Lazdijai d. mun.;2004;53;253;123;130
Lazdijai d. mun.;2004;54;276;149;127
Lazdijai d. mun.;2004;55;244;113;131
Lazdijai d. mun.;2004;56;199;91;108
Lazdijai d. mun.;2004;57;239;117;122
Lazdijai d. mun.;2004;58;242;119;123
Lazdijai d. mun.;2004;59;219;105;114
Lazdijai d. mun.;2004;60;294;119;175
Lazdijai d. mun.;2004;61;296;127;169
Lazdijai d. mun.;2004;62;304;127;177
Lazdijai d. mun.;2004;63;337;137;200
Lazdijai d. mun.;2004;64;282;107;175
Lazdijai d. mun.;2004;65;328;145;183
Lazdijai d. mun.;2004;66;326;148;178
Lazdijai d. mun.;2004;67;346;133;213
Lazdijai d. mun.;2004;68;391;154;237
Lazdijai d. mun.;2004;69;310;123;187
Lazdijai d. mun.;2004;70;341;136;205
Lazdijai d. mun.;2004;71;369;149;220
Lazdijai d. mun.;2004;72;342;140;202
Lazdijai d. mun.;2004;73;352;118;234
Lazdijai d. mun.;2004;74;314;98;216
Lazdijai d. mun.;2004;75;332;102;230
Lazdijai d. mun.;2004;76;299;103;196
Lazdijai d. mun.;2004;77;258;75;183
Lazdijai d. mun.;2004;78;238;66;172
Lazdijai d. mun.;2004;79;246;70;176
Lazdijai d. mun.;2004;80;230;62;168
Lazdijai d. mun.;2004;81;202;60;142
Lazdijai d. mun.;2004;82;148;49;99
Lazdijai d. mun.;2004;83;124;39;85
Lazdijai d. mun.;2004;84;100;35;65
Lazdijai d. mun.;2004;85;473;127;346
Lazdijai d. mun.;2005;-1;25694;12279;13415
Lazdijai d. mun.;2005;0;209;105;104
Lazdijai d. mun.;2005;1;203;101;102
Lazdijai d. mun.;2005;2;232;111;121
Lazdijai d. mun.;2005;3;252;124;128
Lazdijai d. mun.;2005;4;263;132;131
Lazdijai d. mun.;2005;5;245;135;110
Lazdijai d. mun.;2005;6;288;153;135
Lazdijai d. mun.;2005;7;261;144;117
Lazdijai d. mun.;2005;8;295;161;134
Lazdijai d. mun.;2005;9;314;160;154
Lazdijai d. mun.;2005;10;346;168;178
Lazdijai d. mun.;2005;11;340;175;165
Lazdijai d. mun.;2005;12;404;206;198
Lazdijai d. mun.;2005;13;399;222;177
Lazdijai d. mun.;2005;14;419;226;193
Lazdijai d. mun.;2005;15;413;216;197
Lazdijai d. mun.;2005;16;397;219;178
Lazdijai d. mun.;2005;17;414;194;220
Lazdijai d. mun.;2005;18;416;207;209
Lazdijai d. mun.;2005;19;389;201;188
Lazdijai d. mun.;2005;20;361;184;177
Lazdijai d. mun.;2005;21;361;188;173
Lazdijai d. mun.;2005;22;271;153;118
Lazdijai d. mun.;2005;23;248;149;99
Lazdijai d. mun.;2005;24;221;121;100
Lazdijai d. mun.;2005;25;239;140;99
Lazdijai d. mun.;2005;26;226;122;104
Lazdijai d. mun.;2005;27;240;115;125
Lazdijai d. mun.;2005;28;250;124;126
Lazdijai d. mun.;2005;29;275;143;132
Lazdijai d. mun.;2005;30;297;150;147
Lazdijai d. mun.;2005;31;275;150;125
Lazdijai d. mun.;2005;32;304;165;139
Lazdijai d. mun.;2005;33;298;156;142
Lazdijai d. mun.;2005;34;305;161;144
Lazdijai d. mun.;2005;35;325;172;153
Lazdijai d. mun.;2005;36;371;203;168
Lazdijai d. mun.;2005;37;372;188;184
Lazdijai d. mun.;2005;38;359;197;162
Lazdijai d. mun.;2005;39;332;170;162
Lazdijai d. mun.;2005;40;358;207;151
Lazdijai d. mun.;2005;41;364;193;171
Lazdijai d. mun.;2005;42;379;210;169
Lazdijai d. mun.;2005;43;352;178;174
Lazdijai d. mun.;2005;44;370;207;163
Lazdijai d. mun.;2005;45;342;184;158
Lazdijai d. mun.;2005;46;339;184;155
Lazdijai d. mun.;2005;47;317;182;135
Lazdijai d. mun.;2005;48;286;155;131
Lazdijai d. mun.;2005;49;268;123;145
Lazdijai d. mun.;2005;50;278;152;126
Lazdijai d. mun.;2005;51;252;128;124
Lazdijai d. mun.;2005;52;275;150;125
Lazdijai d. mun.;2005;53;244;141;103
Lazdijai d. mun.;2005;54;247;124;123
Lazdijai d. mun.;2005;55;273;148;125
Lazdijai d. mun.;2005;56;235;107;128
Lazdijai d. mun.;2005;57;195;88;107
Lazdijai d. mun.;2005;58;232;111;121
Lazdijai d. mun.;2005;59;236;115;121
Lazdijai d. mun.;2005;60;213;99;114
Lazdijai d. mun.;2005;61;287;115;172
Lazdijai d. mun.;2005;62;287;120;167
Lazdijai d. mun.;2005;63;302;126;176
Lazdijai d. mun.;2005;64;328;132;196
Lazdijai d. mun.;2005;65;273;101;172
Lazdijai d. mun.;2005;66;316;137;179
Lazdijai d. mun.;2005;67;324;145;179
Lazdijai d. mun.;2005;68;340;127;213
Lazdijai d. mun.;2005;69;383;151;232
Lazdijai d. mun.;2005;70;300;117;183
Lazdijai d. mun.;2005;71;332;133;199
Lazdijai d. mun.;2005;72;356;141;215
Lazdijai d. mun.;2005;73;327;133;194
Lazdijai d. mun.;2005;74;340;112;228
Lazdijai d. mun.;2005;75;295;89;206
Lazdijai d. mun.;2005;76;316;93;223
Lazdijai d. mun.;2005;77;287;92;195
Lazdijai d. mun.;2005;78;240;68;172
Lazdijai d. mun.;2005;79;225;62;163
Lazdijai d. mun.;2005;80;230;64;166
Lazdijai d. mun.;2005;81;216;53;163
Lazdijai d. mun.;2005;82;189;54;135
Lazdijai d. mun.;2005;83;137;44;93
Lazdijai d. mun.;2005;84;111;37;74
Lazdijai d. mun.;2005;85;469;136;333
Lazdijai d. mun.;2006;-1;24977;11872;13105
Lazdijai d. mun.;2006;0;240;105;135
Lazdijai d. mun.;2006;1;205;104;101
Lazdijai d. mun.;2006;2;201;100;101
Lazdijai d. mun.;2006;3;227;109;118
Lazdijai d. mun.;2006;4;252;123;129
Lazdijai d. mun.;2006;5;256;125;131
Lazdijai d. mun.;2006;6;241;131;110
Lazdijai d. mun.;2006;7;285;152;133
Lazdijai d. mun.;2006;8;256;142;114
Lazdijai d. mun.;2006;9;292;159;133
Lazdijai d. mun.;2006;10;311;158;153
Lazdijai d. mun.;2006;11;344;168;176
Lazdijai d. mun.;2006;12;338;174;164
Lazdijai d. mun.;2006;13;393;199;194
Lazdijai d. mun.;2006;14;391;219;172
Lazdijai d. mun.;2006;15;409;222;187
Lazdijai d. mun.;2006;16;400;208;192
Lazdijai d. mun.;2006;17;383;207;176
Lazdijai d. mun.;2006;18;400;188;212
Lazdijai d. mun.;2006;19;398;196;202
Lazdijai d. mun.;2006;20;368;189;179
Lazdijai d. mun.;2006;21;346;174;172
Lazdijai d. mun.;2006;22;341;182;159
Lazdijai d. mun.;2006;23;258;150;108
Lazdijai d. mun.;2006;24;228;140;88
Lazdijai d. mun.;2006;25;200;111;89
Lazdijai d. mun.;2006;26;218;131;87
Lazdijai d. mun.;2006;27;207;115;92
Lazdijai d. mun.;2006;28;225;110;115
Lazdijai d. mun.;2006;29;239;113;126
Lazdijai d. mun.;2006;30;259;137;122
Lazdijai d. mun.;2006;31;288;143;145
Lazdijai d. mun.;2006;32;259;144;115
Lazdijai d. mun.;2006;33;290;155;135
Lazdijai d. mun.;2006;34;282;148;134
Lazdijai d. mun.;2006;35;288;151;137
Lazdijai d. mun.;2006;36;316;166;150
Lazdijai d. mun.;2006;37;364;197;167
Lazdijai d. mun.;2006;38;365;185;180
Lazdijai d. mun.;2006;39;349;190;159
Lazdijai d. mun.;2006;40;325;164;161
Lazdijai d. mun.;2006;41;343;192;151
Lazdijai d. mun.;2006;42;359;189;170
Lazdijai d. mun.;2006;43;373;203;170
Lazdijai d. mun.;2006;44;342;172;170
Lazdijai d. mun.;2006;45;362;200;162
Lazdijai d. mun.;2006;46;334;178;156
Lazdijai d. mun.;2006;47;336;180;156
Lazdijai d. mun.;2006;48;310;178;132
Lazdijai d. mun.;2006;49;284;152;132
Lazdijai d. mun.;2006;50;263;120;143
Lazdijai d. mun.;2006;51;276;151;125
Lazdijai d. mun.;2006;52;240;118;122
Lazdijai d. mun.;2006;53;268;142;126
Lazdijai d. mun.;2006;54;240;138;102
Lazdijai d. mun.;2006;55;242;119;123
Lazdijai d. mun.;2006;56;267;143;124
Lazdijai d. mun.;2006;57;228;103;125
Lazdijai d. mun.;2006;58;188;84;104
Lazdijai d. mun.;2006;59;231;109;122
Lazdijai d. mun.;2006;60;225;107;118
Lazdijai d. mun.;2006;61;207;95;112
Lazdijai d. mun.;2006;62;277;109;168
Lazdijai d. mun.;2006;63;283;119;164
Lazdijai d. mun.;2006;64;295;120;175
Lazdijai d. mun.;2006;65;329;129;200
Lazdijai d. mun.;2006;66;266;96;170
Lazdijai d. mun.;2006;67;309;132;177
Lazdijai d. mun.;2006;68;315;140;175
Lazdijai d. mun.;2006;69;331;120;211
Lazdijai d. mun.;2006;70;376;147;229
Lazdijai d. mun.;2006;71;294;114;180
Lazdijai d. mun.;2006;72;321;130;191
Lazdijai d. mun.;2006;73;344;133;211
Lazdijai d. mun.;2006;74;320;129;191
Lazdijai d. mun.;2006;75;322;103;219
Lazdijai d. mun.;2006;76;276;80;196
Lazdijai d. mun.;2006;77;300;86;214
Lazdijai d. mun.;2006;78;274;87;187
Lazdijai d. mun.;2006;79;223;59;164
Lazdijai d. mun.;2006;80;207;56;151
Lazdijai d. mun.;2006;81;201;55;146
Lazdijai d. mun.;2006;82;201;49;152
Lazdijai d. mun.;2006;83;170;42;128
Lazdijai d. mun.;2006;84;121;38;83
Lazdijai d. mun.;2006;85;467;142;325
Lazdijai d. mun.;2007;-1;24430;11568;12862
Lazdijai d. mun.;2007;0;218;116;102
Lazdijai d. mun.;2007;1;236;102;134
Lazdijai d. mun.;2007;2;198;100;98
Lazdijai d. mun.;2007;3;198;98;100
Lazdijai d. mun.;2007;4;224;108;116
Lazdijai d. mun.;2007;5;247;119;128
Lazdijai d. mun.;2007;6;254;123;131
Lazdijai d. mun.;2007;7;241;129;112
Lazdijai d. mun.;2007;8;285;152;133
Lazdijai d. mun.;2007;9;252;139;113
Lazdijai d. mun.;2007;10;289;158;131
Lazdijai d. mun.;2007;11;313;159;154
Lazdijai d. mun.;2007;12;347;170;177
Lazdijai d. mun.;2007;13;332;171;161
Lazdijai d. mun.;2007;14;389;196;193
Lazdijai d. mun.;2007;15;387;217;170
Lazdijai d. mun.;2007;16;404;220;184
Lazdijai d. mun.;2007;17;394;207;187
Lazdijai d. mun.;2007;18;373;201;172
Lazdijai d. mun.;2007;19;388;184;204
Lazdijai d. mun.;2007;20;387;190;197
Lazdijai d. mun.;2007;21;346;179;167
Lazdijai d. mun.;2007;22;338;171;167
Lazdijai d. mun.;2007;23;326;175;151
Lazdijai d. mun.;2007;24;249;143;106
Lazdijai d. mun.;2007;25;217;130;87
Lazdijai d. mun.;2007;26;187;104;83
Lazdijai d. mun.;2007;27;207;123;84
Lazdijai d. mun.;2007;28;205;113;92
Lazdijai d. mun.;2007;29;216;106;110
Lazdijai d. mun.;2007;30;229;109;120
Lazdijai d. mun.;2007;31;251;133;118
Lazdijai d. mun.;2007;32;277;137;140
Lazdijai d. mun.;2007;33;252;137;115
Lazdijai d. mun.;2007;34;281;150;131
Lazdijai d. mun.;2007;35;279;144;135
Lazdijai d. mun.;2007;36;284;146;138
Lazdijai d. mun.;2007;37;316;167;149
Lazdijai d. mun.;2007;38;363;198;165
Lazdijai d. mun.;2007;39;358;181;177
Lazdijai d. mun.;2007;40;338;181;157
Lazdijai d. mun.;2007;41;326;165;161
Lazdijai d. mun.;2007;42;339;188;151
Lazdijai d. mun.;2007;43;356;189;167
Lazdijai d. mun.;2007;44;362;197;165
Lazdijai d. mun.;2007;45;335;170;165
Lazdijai d. mun.;2007;46;361;198;163
Lazdijai d. mun.;2007;47;338;178;160
Lazdijai d. mun.;2007;48;332;174;158
Lazdijai d. mun.;2007;49;308;176;132
Lazdijai d. mun.;2007;50;279;150;129
Lazdijai d. mun.;2007;51;264;119;145
Lazdijai d. mun.;2007;52;270;146;124
Lazdijai d. mun.;2007;53;234;113;121
Lazdijai d. mun.;2007;54;260;135;125
Lazdijai d. mun.;2007;55;228;129;99
Lazdijai d. mun.;2007;56;237;115;122
Lazdijai d. mun.;2007;57;265;141;124
Lazdijai d. mun.;2007;58;223;100;123
Lazdijai d. mun.;2007;59;182;81;101
Lazdijai d. mun.;2007;60;228;108;120
Lazdijai d. mun.;2007;61;221;104;117
Lazdijai d. mun.;2007;62;202;93;109
Lazdijai d. mun.;2007;63;271;104;167
Lazdijai d. mun.;2007;64;274;112;162
Lazdijai d. mun.;2007;65;285;115;170
Lazdijai d. mun.;2007;66;319;120;199
Lazdijai d. mun.;2007;67;259;92;167
Lazdijai d. mun.;2007;68;295;125;170
Lazdijai d. mun.;2007;69;303;132;171
Lazdijai d. mun.;2007;70;318;114;204
Lazdijai d. mun.;2007;71;363;138;225
Lazdijai d. mun.;2007;72;285;110;175
Lazdijai d. mun.;2007;73;299;116;183
Lazdijai d. mun.;2007;74;328;122;206
Lazdijai d. mun.;2007;75;301;120;181
Lazdijai d. mun.;2007;76;301;90;211
Lazdijai d. mun.;2007;77;259;68;191
Lazdijai d. mun.;2007;78;291;81;210
Lazdijai d. mun.;2007;79;263;83;180
Lazdijai d. mun.;2007;80;214;56;158
Lazdijai d. mun.;2007;81;192;49;143
Lazdijai d. mun.;2007;82;187;52;135
Lazdijai d. mun.;2007;83;180;45;135
Lazdijai d. mun.;2007;84;150;34;116
Lazdijai d. mun.;2007;85;468;135;333
Lazdijai d. mun.;2008;-1;23902;11295;12607
Lazdijai d. mun.;2008;0;200;105;95
Lazdijai d. mun.;2008;1;222;115;107
Lazdijai d. mun.;2008;2;232;99;133
Lazdijai d. mun.;2008;3;194;97;97
Lazdijai d. mun.;2008;4;196;97;99
Lazdijai d. mun.;2008;5;226;108;118
Lazdijai d. mun.;2008;6;245;118;127
Lazdijai d. mun.;2008;7;251;121;130
Lazdijai d. mun.;2008;8;239;127;112
Lazdijai d. mun.;2008;9;283;152;131
Lazdijai d. mun.;2008;10;253;139;114
Lazdijai d. mun.;2008;11;283;155;128
Lazdijai d. mun.;2008;12;311;158;153
Lazdijai d. mun.;2008;13;345;168;177
Lazdijai d. mun.;2008;14;332;171;161
Lazdijai d. mun.;2008;15;384;192;192
Lazdijai d. mun.;2008;16;381;214;167
Lazdijai d. mun.;2008;17;400;219;181
Lazdijai d. mun.;2008;18;387;203;184
Lazdijai d. mun.;2008;19;364;196;168
Lazdijai d. mun.;2008;20;382;180;202
Lazdijai d. mun.;2008;21;375;187;188
Lazdijai d. mun.;2008;22;333;171;162
Lazdijai d. mun.;2008;23;328;169;159
Lazdijai d. mun.;2008;24;316;170;146
Lazdijai d. mun.;2008;25;235;138;97
Lazdijai d. mun.;2008;26;205;121;84
Lazdijai d. mun.;2008;27;176;102;74
Lazdijai d. mun.;2008;28;195;117;78
Lazdijai d. mun.;2008;29;190;100;90
Lazdijai d. mun.;2008;30;209;102;107
Lazdijai d. mun.;2008;31;218;102;116
Lazdijai d. mun.;2008;32;238;126;112
Lazdijai d. mun.;2008;33;267;133;134
Lazdijai d. mun.;2008;34;250;135;115
Lazdijai d. mun.;2008;35;271;142;129
Lazdijai d. mun.;2008;36;272;139;133
Lazdijai d. mun.;2008;37;280;144;136
Lazdijai d. mun.;2008;38;307;162;145
Lazdijai d. mun.;2008;39;358;195;163
Lazdijai d. mun.;2008;40;359;180;179
Lazdijai d. mun.;2008;41;332;179;153
Lazdijai d. mun.;2008;42;317;160;157
Lazdijai d. mun.;2008;43;335;188;147
Lazdijai d. mun.;2008;44;342;177;165
Lazdijai d. mun.;2008;45;356;191;165
Lazdijai d. mun.;2008;46;333;169;164
Lazdijai d. mun.;2008;47;352;194;158
Lazdijai d. mun.;2008;48;331;172;159
Lazdijai d. mun.;2008;49;326;171;155
Lazdijai d. mun.;2008;50;303;173;130
Lazdijai d. mun.;2008;51;276;149;127
Lazdijai d. mun.;2008;52;262;117;145
Lazdijai d. mun.;2008;53;266;143;123
Lazdijai d. mun.;2008;54;228;107;121
Lazdijai d. mun.;2008;55;254;133;121
Lazdijai d. mun.;2008;56;225;127;98
Lazdijai d. mun.;2008;57;232;111;121
Lazdijai d. mun.;2008;58;254;131;123
Lazdijai d. mun.;2008;59;223;101;122
Lazdijai d. mun.;2008;60;178;78;100
Lazdijai d. mun.;2008;61;219;105;114
Lazdijai d. mun.;2008;62;215;101;114
Lazdijai d. mun.;2008;63;199;93;106
Lazdijai d. mun.;2008;64;267;102;165
Lazdijai d. mun.;2008;65;270;109;161
Lazdijai d. mun.;2008;66;283;115;168
Lazdijai d. mun.;2008;67;314;115;199
Lazdijai d. mun.;2008;68;254;90;164
Lazdijai d. mun.;2008;69;283;116;167
Lazdijai d. mun.;2008;70;297;127;170
Lazdijai d. mun.;2008;71;309;112;197
Lazdijai d. mun.;2008;72;348;128;220
Lazdijai d. mun.;2008;73;278;104;174
Lazdijai d. mun.;2008;74;292;113;179
Lazdijai d. mun.;2008;75;318;115;203
Lazdijai d. mun.;2008;76;291;111;180
Lazdijai d. mun.;2008;77;287;81;206
Lazdijai d. mun.;2008;78;250;64;186
Lazdijai d. mun.;2008;79;278;75;203
Lazdijai d. mun.;2008;80;252;76;176
Lazdijai d. mun.;2008;81;195;49;146
Lazdijai d. mun.;2008;82;169;39;130
Lazdijai d. mun.;2008;83;165;43;122
Lazdijai d. mun.;2008;84;156;41;115
Lazdijai d. mun.;2008;85;496;131;365
Lazdijai d. mun.;2009;-1;23507;11109;12398
Lazdijai d. mun.;2009;0;190;96;94
Lazdijai d. mun.;2009;1;199;106;93
Lazdijai d. mun.;2009;2;214;111;103
Lazdijai d. mun.;2009;3;228;99;129
Lazdijai d. mun.;2009;4;189;93;96
Lazdijai d. mun.;2009;5;191;94;97
Lazdijai d. mun.;2009;6;226;107;119
Lazdijai d. mun.;2009;7;239;116;123
Lazdijai d. mun.;2009;8;249;120;129
Lazdijai d. mun.;2009;9;242;131;111
Lazdijai d. mun.;2009;10;278;151;127
Lazdijai d. mun.;2009;11;253;140;113
Lazdijai d. mun.;2009;12;285;155;130
Lazdijai d. mun.;2009;13;310;159;151
Lazdijai d. mun.;2009;14;346;168;178
Lazdijai d. mun.;2009;15;328;169;159
Lazdijai d. mun.;2009;16;381;191;190
Lazdijai d. mun.;2009;17;384;217;167
Lazdijai d. mun.;2009;18;399;218;181
Lazdijai d. mun.;2009;19;383;202;181
Lazdijai d. mun.;2009;20;360;196;164
Lazdijai d. mun.;2009;21;380;178;202
Lazdijai d. mun.;2009;22;365;182;183
Lazdijai d. mun.;2009;23;321;163;158
Lazdijai d. mun.;2009;24;317;162;155
Lazdijai d. mun.;2009;25;299;163;136
Lazdijai d. mun.;2009;26;221;127;94
Lazdijai d. mun.;2009;27;194;115;79
Lazdijai d. mun.;2009;28;170;97;73
Lazdijai d. mun.;2009;29;185;114;71
Lazdijai d. mun.;2009;30;177;93;84
Lazdijai d. mun.;2009;31;203;97;106
Lazdijai d. mun.;2009;32;212;98;114
Lazdijai d. mun.;2009;33;230;118;112
Lazdijai d. mun.;2009;34;266;135;131
Lazdijai d. mun.;2009;35;245;136;109
Lazdijai d. mun.;2009;36;269;140;129
Lazdijai d. mun.;2009;37;271;136;135
Lazdijai d. mun.;2009;38;273;141;132
Lazdijai d. mun.;2009;39;305;158;147
Lazdijai d. mun.;2009;40;355;191;164
Lazdijai d. mun.;2009;41;352;170;182
Lazdijai d. mun.;2009;42;330;177;153
Lazdijai d. mun.;2009;43;318;160;158
Lazdijai d. mun.;2009;44;329;187;142
Lazdijai d. mun.;2009;45;335;170;165
Lazdijai d. mun.;2009;46;352;188;164
Lazdijai d. mun.;2009;47;331;167;164
Lazdijai d. mun.;2009;48;349;190;159
Lazdijai d. mun.;2009;49;333;176;157
Lazdijai d. mun.;2009;50;322;167;155
Lazdijai d. mun.;2009;51;304;175;129
Lazdijai d. mun.;2009;52;276;150;126
Lazdijai d. mun.;2009;53;253;110;143
Lazdijai d. mun.;2009;54;263;143;120
Lazdijai d. mun.;2009;55;223;100;123
Lazdijai d. mun.;2009;56;255;135;120
Lazdijai d. mun.;2009;57;220;124;96
Lazdijai d. mun.;2009;58;230;110;120
Lazdijai d. mun.;2009;59;248;128;120
Lazdijai d. mun.;2009;60;221;100;121
Lazdijai d. mun.;2009;61;177;77;100
Lazdijai d. mun.;2009;62;212;100;112
Lazdijai d. mun.;2009;63;213;100;113
Lazdijai d. mun.;2009;64;187;83;104
Lazdijai d. mun.;2009;65;262;96;166
Lazdijai d. mun.;2009;66;264;105;159
Lazdijai d. mun.;2009;67;281;115;166
Lazdijai d. mun.;2009;68;306;114;192
Lazdijai d. mun.;2009;69;251;89;162
Lazdijai d. mun.;2009;70;276;113;163
Lazdijai d. mun.;2009;71;290;124;166
Lazdijai d. mun.;2009;72;288;104;184
Lazdijai d. mun.;2009;73;335;122;213
Lazdijai d. mun.;2009;74;266;97;169
Lazdijai d. mun.;2009;75;285;110;175
Lazdijai d. mun.;2009;76;309;111;198
Lazdijai d. mun.;2009;77;281;109;172
Lazdijai d. mun.;2009;78;276;74;202
Lazdijai d. mun.;2009;79;239;59;180
Lazdijai d. mun.;2009;80;255;65;190
Lazdijai d. mun.;2009;81;234;71;163
Lazdijai d. mun.;2009;82;187;49;138
Lazdijai d. mun.;2009;83;155;36;119
Lazdijai d. mun.;2009;84;150;37;113
Lazdijai d. mun.;2009;85;552;139;413
Lazdijai d. mun.;2010;-1;23078;10913;12165
Lazdijai d. mun.;2010;0;213;109;104
Lazdijai d. mun.;2010;1;181;93;88
Lazdijai d. mun.;2010;2;194;104;90
Lazdijai d. mun.;2010;3;224;117;107
Lazdijai d. mun.;2010;4;233;100;133
Lazdijai d. mun.;2010;5;186;94;92
Lazdijai d. mun.;2010;6;188;92;96
Lazdijai d. mun.;2010;7;222;103;119
Lazdijai d. mun.;2010;8;239;116;123
Lazdijai d. mun.;2010;9;244;118;126
Lazdijai d. mun.;2010;10;240;128;112
Lazdijai d. mun.;2010;11;278;149;129
Lazdijai d. mun.;2010;12;247;135;112
Lazdijai d. mun.;2010;13;285;156;129
Lazdijai d. mun.;2010;14;310;160;150
Lazdijai d. mun.;2010;15;346;169;177
Lazdijai d. mun.;2010;16;325;168;157
Lazdijai d. mun.;2010;17;379;191;188
Lazdijai d. mun.;2010;18;381;219;162
Lazdijai d. mun.;2010;19;405;221;184
Lazdijai d. mun.;2010;20;377;199;178
Lazdijai d. mun.;2010;21;352;192;160
Lazdijai d. mun.;2010;22;367;171;196
Lazdijai d. mun.;2010;23;356;178;178
Lazdijai d. mun.;2010;24;305;155;150
Lazdijai d. mun.;2010;25;304;158;146
Lazdijai d. mun.;2010;26;277;151;126
Lazdijai d. mun.;2010;27;205;118;87
Lazdijai d. mun.;2010;28;185;108;77
Lazdijai d. mun.;2010;29;162;92;70
Lazdijai d. mun.;2010;30;173;110;63
Lazdijai d. mun.;2010;31;174;91;83
Lazdijai d. mun.;2010;32;201;97;104
Lazdijai d. mun.;2010;33;204;93;111
Lazdijai d. mun.;2010;34;227;119;108
Lazdijai d. mun.;2010;35;256;132;124
Lazdijai d. mun.;2010;36;239;135;104
Lazdijai d. mun.;2010;37;263;138;125
Lazdijai d. mun.;2010;38;272;136;136
Lazdijai d. mun.;2010;39;268;141;127
Lazdijai d. mun.;2010;40;295;150;145
Lazdijai d. mun.;2010;41;351;190;161
Lazdijai d. mun.;2010;42;348;168;180
Lazdijai d. mun.;2010;43;328;174;154
Lazdijai d. mun.;2010;44;314;160;154
Lazdijai d. mun.;2010;45;324;184;140
Lazdijai d. mun.;2010;46;329;164;165
Lazdijai d. mun.;2010;47;349;187;162
Lazdijai d. mun.;2010;48;332;169;163
Lazdijai d. mun.;2010;49;344;187;157
Lazdijai d. mun.;2010;50;328;172;156
Lazdijai d. mun.;2010;51;315;164;151
Lazdijai d. mun.;2010;52;304;175;129
Lazdijai d. mun.;2010;53;272;146;126
Lazdijai d. mun.;2010;54;252;110;142
Lazdijai d. mun.;2010;55;257;138;119
Lazdijai d. mun.;2010;56;218;100;118
Lazdijai d. mun.;2010;57;250;130;120
Lazdijai d. mun.;2010;58;215;118;97
Lazdijai d. mun.;2010;59;226;109;117
Lazdijai d. mun.;2010;60;244;125;119
Lazdijai d. mun.;2010;61;220;96;124
Lazdijai d. mun.;2010;62;173;73;100
Lazdijai d. mun.;2010;63;204;95;109
Lazdijai d. mun.;2010;64;211;97;114
Lazdijai d. mun.;2010;65;189;84;105
Lazdijai d. mun.;2010;66;253;90;163
Lazdijai d. mun.;2010;67;255;100;155
Lazdijai d. mun.;2010;68;271;107;164
Lazdijai d. mun.;2010;69;298;110;188
Lazdijai d. mun.;2010;70;242;82;160
Lazdijai d. mun.;2010;71;272;112;160
Lazdijai d. mun.;2010;72;284;119;165
Lazdijai d. mun.;2010;73;272;97;175
Lazdijai d. mun.;2010;74;326;117;209
Lazdijai d. mun.;2010;75;253;91;162
Lazdijai d. mun.;2010;76;270;101;169
Lazdijai d. mun.;2010;77;301;106;195
Lazdijai d. mun.;2010;78;257;97;160
Lazdijai d. mun.;2010;79;260;68;192
Lazdijai d. mun.;2010;80;220;53;167
Lazdijai d. mun.;2010;81;231;54;177
Lazdijai d. mun.;2010;82;215;64;151
Lazdijai d. mun.;2010;83;170;42;128
Lazdijai d. mun.;2010;84;138;30;108
Lazdijai d. mun.;2010;85;611;152;459
Lazdijai d. mun.;2011;-1;22509;10636;11873
Lazdijai d. mun.;2011;0;154;73;81
Lazdijai d. mun.;2011;1;188;101;87
Lazdijai d. mun.;2011;2;169;90;79
Lazdijai d. mun.;2011;3;160;89;71
Lazdijai d. mun.;2011;4;173;91;82
Lazdijai d. mun.;2011;5;205;95;110
Lazdijai d. mun.;2011;6;173;81;92
Lazdijai d. mun.;2011;7;186;94;92
Lazdijai d. mun.;2011;8;190;82;108
Lazdijai d. mun.;2011;9;207;103;104
Lazdijai d. mun.;2011;10;252;115;137
Lazdijai d. mun.;2011;11;233;115;118
Lazdijai d. mun.;2011;12;278;148;130
Lazdijai d. mun.;2011;13;246;139;107
Lazdijai d. mun.;2011;14;275;143;132
Lazdijai d. mun.;2011;15;300;156;144
Lazdijai d. mun.;2011;16;334;161;173
Lazdijai d. mun.;2011;17;327;171;156
Lazdijai d. mun.;2011;18;379;195;184
Lazdijai d. mun.;2011;19;342;200;142
Lazdijai d. mun.;2011;20;340;193;147
Lazdijai d. mun.;2011;21;314;175;139
Lazdijai d. mun.;2011;22;304;174;130
Lazdijai d. mun.;2011;23;279;136;143
Lazdijai d. mun.;2011;24;290;151;139
Lazdijai d. mun.;2011;25;225;129;96
Lazdijai d. mun.;2011;26;202;103;99
Lazdijai d. mun.;2011;27;197;114;83
Lazdijai d. mun.;2011;28;193;109;84
Lazdijai d. mun.;2011;29;194;101;93
Lazdijai d. mun.;2011;30;195;97;98
Lazdijai d. mun.;2011;31;199;96;103
Lazdijai d. mun.;2011;32;205;102;103
Lazdijai d. mun.;2011;33;221;106;115
Lazdijai d. mun.;2011;34;222;113;109
Lazdijai d. mun.;2011;35;254;136;118
Lazdijai d. mun.;2011;36;278;139;139
Lazdijai d. mun.;2011;37;266;149;117
Lazdijai d. mun.;2011;38;304;159;145
Lazdijai d. mun.;2011;39;298;142;156
Lazdijai d. mun.;2011;40;284;151;133
Lazdijai d. mun.;2011;41;319;160;159
Lazdijai d. mun.;2011;42;356;195;161
Lazdijai d. mun.;2011;43;365;180;185
Lazdijai d. mun.;2011;44;354;196;158
Lazdijai d. mun.;2011;45;326;164;162
Lazdijai d. mun.;2011;46;350;198;152
Lazdijai d. mun.;2011;47;348;177;171
Lazdijai d. mun.;2011;48;381;208;173
Lazdijai d. mun.;2011;49;350;177;173
Lazdijai d. mun.;2011;50;335;179;156
Lazdijai d. mun.;2011;51;342;181;161
Lazdijai d. mun.;2011;52;317;159;158
Lazdijai d. mun.;2011;53;316;177;139
Lazdijai d. mun.;2011;54;277;148;129
Lazdijai d. mun.;2011;55;259;120;139
Lazdijai d. mun.;2011;56;249;131;118
Lazdijai d. mun.;2011;57;233;110;123
Lazdijai d. mun.;2011;58;250;122;128
Lazdijai d. mun.;2011;59;233;127;106
Lazdijai d. mun.;2011;60;233;106;127
Lazdijai d. mun.;2011;61;243;126;117
Lazdijai d. mun.;2011;62;220;91;129
Lazdijai d. mun.;2011;63;185;78;107
Lazdijai d. mun.;2011;64;210;100;110
Lazdijai d. mun.;2011;65;206;92;114
Lazdijai d. mun.;2011;66;205;92;113
Lazdijai d. mun.;2011;67;251;90;161
Lazdijai d. mun.;2011;68;262;107;155
Lazdijai d. mun.;2011;69;263;106;157
Lazdijai d. mun.;2011;70;279;98;181
Lazdijai d. mun.;2011;71;226;76;150
Lazdijai d. mun.;2011;72;257;100;157
Lazdijai d. mun.;2011;73;271;108;163
Lazdijai d. mun.;2011;74;249;86;163
Lazdijai d. mun.;2011;75;294;102;192
Lazdijai d. mun.;2011;76;244;86;158
Lazdijai d. mun.;2011;77;259;96;163
Lazdijai d. mun.;2011;78;282;96;186
Lazdijai d. mun.;2011;79;234;83;151
Lazdijai d. mun.;2011;80;238;68;170
Lazdijai d. mun.;2011;81;201;48;153
Lazdijai d. mun.;2011;82;198;45;153
Lazdijai d. mun.;2011;83;195;55;140
Lazdijai d. mun.;2011;84;141;32;109
Lazdijai d. mun.;2011;85;668;143;525
Lazdijai d. mun.;2012;-1;22064;10447;11617
Lazdijai d. mun.;2012;0;191;106;85
Lazdijai d. mun.;2012;1;153;74;79
Lazdijai d. mun.;2012;2;187;101;86
Lazdijai d. mun.;2012;3;167;88;79
Lazdijai d. mun.;2012;4;159;89;70
Lazdijai d. mun.;2012;5;173;91;82
Lazdijai d. mun.;2012;6;203;96;107
Lazdijai d. mun.;2012;7;170;77;93
Lazdijai d. mun.;2012;8;184;94;90
Lazdijai d. mun.;2012;9;183;77;106
Lazdijai d. mun.;2012;10;203;101;102
Lazdijai d. mun.;2012;11;251;113;138
Lazdijai d. mun.;2012;12;226;109;117
Lazdijai d. mun.;2012;13;275;146;129
Lazdijai d. mun.;2012;14;241;136;105
Lazdijai d. mun.;2012;15;273;142;131
Lazdijai d. mun.;2012;16;295;154;141
Lazdijai d. mun.;2012;17;330;162;168
Lazdijai d. mun.;2012;18;326;170;156
Lazdijai d. mun.;2012;19;378;196;182
Lazdijai d. mun.;2012;20;336;193;143
Lazdijai d. mun.;2012;21;327;189;138
Lazdijai d. mun.;2012;22;302;172;130
Lazdijai d. mun.;2012;23;294;170;124
Lazdijai d. mun.;2012;24;266;130;136
Lazdijai d. mun.;2012;25;277;144;133
Lazdijai d. mun.;2012;26;213;124;89
Lazdijai d. mun.;2012;27;184;99;85
Lazdijai d. mun.;2012;28;186;113;73
Lazdijai d. mun.;2012;29;187;106;81
Lazdijai d. mun.;2012;30;177;92;85
Lazdijai d. mun.;2012;31;190;92;98
Lazdijai d. mun.;2012;32;194;92;102
Lazdijai d. mun.;2012;33;189;95;94
Lazdijai d. mun.;2012;34;222;108;114
Lazdijai d. mun.;2012;35;217;111;106
Lazdijai d. mun.;2012;36;243;132;111
Lazdijai d. mun.;2012;37;273;135;138
Lazdijai d. mun.;2012;38;263;149;114
Lazdijai d. mun.;2012;39;300;156;144
Lazdijai d. mun.;2012;40;289;134;155
Lazdijai d. mun.;2012;41;274;146;128
Lazdijai d. mun.;2012;42;311;154;157
Lazdijai d. mun.;2012;43;355;194;161
Lazdijai d. mun.;2012;44;364;179;185
Lazdijai d. mun.;2012;45;353;193;160
Lazdijai d. mun.;2012;46;320;161;159
Lazdijai d. mun.;2012;47;345;194;151
Lazdijai d. mun.;2012;48;343;174;169
Lazdijai d. mun.;2012;49;382;212;170
Lazdijai d. mun.;2012;50;349;174;175
Lazdijai d. mun.;2012;51;335;180;155
Lazdijai d. mun.;2012;52;343;183;160
Lazdijai d. mun.;2012;53;308;152;156
Lazdijai d. mun.;2012;54;317;179;138
Lazdijai d. mun.;2012;55;277;147;130
Lazdijai d. mun.;2012;56;265;124;141
Lazdijai d. mun.;2012;57;251;132;119
Lazdijai d. mun.;2012;58;230;110;120
Lazdijai d. mun.;2012;59;245;118;127
Lazdijai d. mun.;2012;60;232;126;106
Lazdijai d. mun.;2012;61;228;101;127
Lazdijai d. mun.;2012;62;239;124;115
Lazdijai d. mun.;2012;63;218;87;131
Lazdijai d. mun.;2012;64;180;74;106
Lazdijai d. mun.;2012;65;207;96;111
Lazdijai d. mun.;2012;66;204;91;113
Lazdijai d. mun.;2012;67;199;86;113
Lazdijai d. mun.;2012;68;250;89;161
Lazdijai d. mun.;2012;69;256;103;153
Lazdijai d. mun.;2012;70;250;98;152
Lazdijai d. mun.;2012;71;275;95;180
Lazdijai d. mun.;2012;72;218;69;149
Lazdijai d. mun.;2012;73;248;95;153
Lazdijai d. mun.;2012;74;263;103;160
Lazdijai d. mun.;2012;75;234;78;156
Lazdijai d. mun.;2012;76;280;96;184
Lazdijai d. mun.;2012;77;233;79;154
Lazdijai d. mun.;2012;78;248;92;156
Lazdijai d. mun.;2012;79;272;91;181
Lazdijai d. mun.;2012;80;224;75;149
Lazdijai d. mun.;2012;81;216;61;155
Lazdijai d. mun.;2012;82;185;41;144
Lazdijai d. mun.;2012;83;178;38;140
Lazdijai d. mun.;2012;84;172;48;124
Lazdijai d. mun.;2012;85;691;147;544
Lazdijai d. mun.;2013;-1;21639;10262;11377
Lazdijai d. mun.;2013;0;214;110;104
Lazdijai d. mun.;2013;1;184;101;83
Lazdijai d. mun.;2013;2;145;71;74
Lazdijai d. mun.;2013;3;179;93;86
Lazdijai d. mun.;2013;4;157;82;75
Lazdijai d. mun.;2013;5;157;90;67
Lazdijai d. mun.;2013;6;170;91;79
Lazdijai d. mun.;2013;7;198;93;105
Lazdijai d. mun.;2013;8;165;76;89
Lazdijai d. mun.;2013;9;183;94;89
Lazdijai d. mun.;2013;10;182;77;105
Lazdijai d. mun.;2013;11;201;99;102
Lazdijai d. mun.;2013;12;251;112;139
Lazdijai d. mun.;2013;13;227;109;118
Lazdijai d. mun.;2013;14;275;146;129
Lazdijai d. mun.;2013;15;240;136;104
Lazdijai d. mun.;2013;16;274;142;132
Lazdijai d. mun.;2013;17;295;154;141
Lazdijai d. mun.;2013;18;329;162;167
Lazdijai d. mun.;2013;19;323;167;156
Lazdijai d. mun.;2013;20;374;191;183
Lazdijai d. mun.;2013;21;325;191;134
Lazdijai d. mun.;2013;22;319;182;137
Lazdijai d. mun.;2013;23;287;166;121
Lazdijai d. mun.;2013;24;291;169;122
Lazdijai d. mun.;2013;25;253;126;127
Lazdijai d. mun.;2013;26;248;134;114
Lazdijai d. mun.;2013;27;187;112;75
Lazdijai d. mun.;2013;28;169;90;79
Lazdijai d. mun.;2013;29;176;110;66
Lazdijai d. mun.;2013;30;186;110;76
Lazdijai d. mun.;2013;31;169;88;81
Lazdijai d. mun.;2013;32;190;94;96
Lazdijai d. mun.;2013;33;188;90;98
Lazdijai d. mun.;2013;34;188;93;95
Lazdijai d. mun.;2013;35;217;104;113
Lazdijai d. mun.;2013;36;210;106;104
Lazdijai d. mun.;2013;37;238;128;110
Lazdijai d. mun.;2013;38;267;128;139
Lazdijai d. mun.;2013;39;255;142;113
Lazdijai d. mun.;2013;40;293;151;142
Lazdijai d. mun.;2013;41;291;132;159
Lazdijai d. mun.;2013;42;270;142;128
Lazdijai d. mun.;2013;43;310;152;158
Lazdijai d. mun.;2013;44;352;189;163
Lazdijai d. mun.;2013;45;354;171;183
Lazdijai d. mun.;2013;46;349;189;160
Lazdijai d. mun.;2013;47;319;160;159
Lazdijai d. mun.;2013;48;344;193;151
Lazdijai d. mun.;2013;49;341;173;168
Lazdijai d. mun.;2013;50;378;208;170
Lazdijai d. mun.;2013;51;353;177;176
Lazdijai d. mun.;2013;52;335;179;156
Lazdijai d. mun.;2013;53;341;182;159
Lazdijai d. mun.;2013;54;302;146;156
Lazdijai d. mun.;2013;55;320;179;141
Lazdijai d. mun.;2013;56;274;143;131
Lazdijai d. mun.;2013;57;262;122;140
Lazdijai d. mun.;2013;58;249;131;118
Lazdijai d. mun.;2013;59;231;111;120
Lazdijai d. mun.;2013;60;238;116;122
Lazdijai d. mun.;2013;61;229;123;106
Lazdijai d. mun.;2013;62;230;103;127
Lazdijai d. mun.;2013;63;233;119;114
Lazdijai d. mun.;2013;64;218;88;130
Lazdijai d. mun.;2013;65;182;75;107
Lazdijai d. mun.;2013;66;201;92;109
Lazdijai d. mun.;2013;67;202;89;113
Lazdijai d. mun.;2013;68;192;79;113
Lazdijai d. mun.;2013;69;238;85;153
Lazdijai d. mun.;2013;70;248;98;150
Lazdijai d. mun.;2013;71;241;91;150
Lazdijai d. mun.;2013;72;267;93;174
Lazdijai d. mun.;2013;73;212;62;150
Lazdijai d. mun.;2013;74;239;93;146
Lazdijai d. mun.;2013;75;256;98;158
Lazdijai d. mun.;2013;76;225;75;150
Lazdijai d. mun.;2013;77;272;92;180
Lazdijai d. mun.;2013;78;225;78;147
Lazdijai d. mun.;2013;79;231;83;148
Lazdijai d. mun.;2013;80;257;84;173
Lazdijai d. mun.;2013;81;206;66;140
Lazdijai d. mun.;2013;82;200;56;144
Lazdijai d. mun.;2013;83;172;41;131
Lazdijai d. mun.;2013;84;158;35;123
Lazdijai d. mun.;2013;85;713;159;554
Lazdijai d. mun.;2014;-1;21254;10099;11155
Lazdijai d. mun.;2014;0;216;103;113
Lazdijai d. mun.;2014;1;210;109;101
Lazdijai d. mun.;2014;2;181;104;77
Lazdijai d. mun.;2014;3;135;61;74
Lazdijai d. mun.;2014;4;174;91;83
Lazdijai d. mun.;2014;5;149;79;70
Lazdijai d. mun.;2014;6;152;89;63
Lazdijai d. mun.;2014;7;164;89;75
Lazdijai d. mun.;2014;8;197;93;104
Lazdijai d. mun.;2014;9;163;76;87
Lazdijai d. mun.;2014;10;182;94;88
Lazdijai d. mun.;2014;11;181;77;104
Lazdijai d. mun.;2014;12;197;98;99
Lazdijai d. mun.;2014;13;250;110;140
Lazdijai d. mun.;2014;14;231;112;119
Lazdijai d. mun.;2014;15;273;146;127
Lazdijai d. mun.;2014;16;240;134;106
Lazdijai d. mun.;2014;17;271;140;131
Lazdijai d. mun.;2014;18;292;154;138
Lazdijai d. mun.;2014;19;326;163;163
Lazdijai d. mun.;2014;20;314;165;149
Lazdijai d. mun.;2014;21;371;191;180
Lazdijai d. mun.;2014;22;321;189;132
Lazdijai d. mun.;2014;23;304;179;125
Lazdijai d. mun.;2014;24;272;157;115
Lazdijai d. mun.;2014;25;276;160;116
Lazdijai d. mun.;2014;26;237;118;119
Lazdijai d. mun.;2014;27;231;124;107
Lazdijai d. mun.;2014;28;175;110;65
Lazdijai d. mun.;2014;29;155;81;74
Lazdijai d. mun.;2014;30;169;111;58
Lazdijai d. mun.;2014;31;179;110;69
Lazdijai d. mun.;2014;32;160;83;77
Lazdijai d. mun.;2014;33;190;96;94
Lazdijai d. mun.;2014;34;181;87;94
Lazdijai d. mun.;2014;35;178;90;88
Lazdijai d. mun.;2014;36;216;104;112
Lazdijai d. mun.;2014;37;211;108;103
Lazdijai d. mun.;2014;38;230;123;107
Lazdijai d. mun.;2014;39;263;128;135
Lazdijai d. mun.;2014;40;254;142;112
Lazdijai d. mun.;2014;41;286;145;141
Lazdijai d. mun.;2014;42;288;130;158
Lazdijai d. mun.;2014;43;265;140;125
Lazdijai d. mun.;2014;44;308;148;160
Lazdijai d. mun.;2014;45;350;188;162
Lazdijai d. mun.;2014;46;354;171;183
Lazdijai d. mun.;2014;47;343;185;158
Lazdijai d. mun.;2014;48;313;157;156
Lazdijai d. mun.;2014;49;339;189;150
Lazdijai d. mun.;2014;50;339;172;167
Lazdijai d. mun.;2014;51;373;204;169
Lazdijai d. mun.;2014;52;351;174;177
Lazdijai d. mun.;2014;53;333;175;158
Lazdijai d. mun.;2014;54;341;183;158
Lazdijai d. mun.;2014;55;300;145;155
Lazdijai d. mun.;2014;56;314;171;143
Lazdijai d. mun.;2014;57;271;140;131
Lazdijai d. mun.;2014;58;263;121;142
Lazdijai d. mun.;2014;59;250;132;118
Lazdijai d. mun.;2014;60;228;108;120
Lazdijai d. mun.;2014;61;240;116;124
Lazdijai d. mun.;2014;62;225;120;105
Lazdijai d. mun.;2014;63;224;98;126
Lazdijai d. mun.;2014;64;229;116;113
Lazdijai d. mun.;2014;65;214;85;129
Lazdijai d. mun.;2014;66;179;71;108
Lazdijai d. mun.;2014;67;196;90;106
Lazdijai d. mun.;2014;68;199;89;110
Lazdijai d. mun.;2014;69;189;76;113
Lazdijai d. mun.;2014;70;233;83;150
Lazdijai d. mun.;2014;71;239;94;145
Lazdijai d. mun.;2014;72;233;82;151
Lazdijai d. mun.;2014;73;260;91;169
Lazdijai d. mun.;2014;74;206;61;145
Lazdijai d. mun.;2014;75;232;88;144
Lazdijai d. mun.;2014;76;246;96;150
Lazdijai d. mun.;2014;77;222;74;148
Lazdijai d. mun.;2014;78;262;83;179
Lazdijai d. mun.;2014;79;213;74;139
Lazdijai d. mun.;2014;80;217;77;140
Lazdijai d. mun.;2014;81;246;76;170
Lazdijai d. mun.;2014;82;190;57;133
Lazdijai d. mun.;2014;83;185;52;133
Lazdijai d. mun.;2014;84;163;37;126
Lazdijai d. mun.;2014;85;732;157;575
Lazdijai d. mun.;2015;-1;20813;9884;10929
Lazdijai d. mun.;2015;0;181;85;96
Lazdijai d. mun.;2015;1;210;101;109
Lazdijai d. mun.;2015;2;205;107;98
Lazdijai d. mun.;2015;3;173;100;73
Lazdijai d. mun.;2015;4;130;58;72
Lazdijai d. mun.;2015;5;174;90;84
Lazdijai d. mun.;2015;6;144;74;70
Lazdijai d. mun.;2015;7;150;86;64
Lazdijai d. mun.;2015;8;158;88;70
Lazdijai d. mun.;2015;9;191;90;101
Lazdijai d. mun.;2015;10;159;73;86
Lazdijai d. mun.;2015;11;180;93;87
Lazdijai d. mun.;2015;12;180;76;104
Lazdijai d. mun.;2015;13;196;98;98
Lazdijai d. mun.;2015;14;250;109;141
Lazdijai d. mun.;2015;15;233;113;120
Lazdijai d. mun.;2015;16;272;145;127
Lazdijai d. mun.;2015;17;242;135;107
Lazdijai d. mun.;2015;18;272;141;131
Lazdijai d. mun.;2015;19;285;149;136
Lazdijai d. mun.;2015;20;327;164;163
Lazdijai d. mun.;2015;21;316;164;152
Lazdijai d. mun.;2015;22;359;187;172
Lazdijai d. mun.;2015;23;316;183;133
Lazdijai d. mun.;2015;24;300;178;122
Lazdijai d. mun.;2015;25;266;153;113
Lazdijai d. mun.;2015;26;261;155;106
Lazdijai d. mun.;2015;27;213;107;106
Lazdijai d. mun.;2015;28;225;126;99
Lazdijai d. mun.;2015;29;165;108;57
Lazdijai d. mun.;2015;30;139;77;62
Lazdijai d. mun.;2015;31;170;113;57
Lazdijai d. mun.;2015;32;167;105;62
Lazdijai d. mun.;2015;33;161;80;81
Lazdijai d. mun.;2015;34;187;94;93
Lazdijai d. mun.;2015;35;169;82;87
Lazdijai d. mun.;2015;36;172;86;86
Lazdijai d. mun.;2015;37;214;105;109
Lazdijai d. mun.;2015;38;202;104;98
Lazdijai d. mun.;2015;39;228;119;109
Lazdijai d. mun.;2015;40;258;124;134
Lazdijai d. mun.;2015;41;253;141;112
Lazdijai d. mun.;2015;42;283;143;140
Lazdijai d. mun.;2015;43;283;127;156
Lazdijai d. mun.;2015;44;257;134;123
Lazdijai d. mun.;2015;45;302;146;156
Lazdijai d. mun.;2015;46;343;184;159
Lazdijai d. mun.;2015;47;352;169;183
Lazdijai d. mun.;2015;48;343;184;159
Lazdijai d. mun.;2015;49;308;153;155
Lazdijai d. mun.;2015;50;335;187;148
Lazdijai d. mun.;2015;51;335;168;167
Lazdijai d. mun.;2015;52;368;202;166
Lazdijai d. mun.;2015;53;349;173;176
Lazdijai d. mun.;2015;54;324;169;155
Lazdijai d. mun.;2015;55;338;180;158
Lazdijai d. mun.;2015;56;286;136;150
Lazdijai d. mun.;2015;57;311;166;145
Lazdijai d. mun.;2015;58;271;139;132
Lazdijai d. mun.;2015;59;259;119;140
Lazdijai d. mun.;2015;60;247;129;118
Lazdijai d. mun.;2015;61;225;104;121
Lazdijai d. mun.;2015;62;240;117;123
Lazdijai d. mun.;2015;63;220;115;105
Lazdijai d. mun.;2015;64;222;97;125
Lazdijai d. mun.;2015;65;227;114;113
Lazdijai d. mun.;2015;66;207;78;129
Lazdijai d. mun.;2015;67;176;67;109
Lazdijai d. mun.;2015;68;189;84;105
Lazdijai d. mun.;2015;69;200;90;110
Lazdijai d. mun.;2015;70;185;74;111
Lazdijai d. mun.;2015;71;228;79;149
Lazdijai d. mun.;2015;72;230;88;142
Lazdijai d. mun.;2015;73;226;80;146
Lazdijai d. mun.;2015;74;252;86;166
Lazdijai d. mun.;2015;75;197;57;140
Lazdijai d. mun.;2015;76;225;83;142
Lazdijai d. mun.;2015;77;234;90;144
Lazdijai d. mun.;2015;78;212;71;141
Lazdijai d. mun.;2015;79;248;74;174
Lazdijai d. mun.;2015;80;201;67;134
Lazdijai d. mun.;2015;81;202;70;132
Lazdijai d. mun.;2015;82;230;65;165
Lazdijai d. mun.;2015;83;170;50;120
Lazdijai d. mun.;2015;84;169;42;127
Lazdijai d. mun.;2015;85;751;168;583
Lazdijai d. mun.;2016;-1;20438;9731;10707
Lazdijai d. mun.;2016;0;186;87;99
Lazdijai d. mun.;2016;1;182;88;94
Lazdijai d. mun.;2016;2;212;103;109
Lazdijai d. mun.;2016;3;209;111;98
Lazdijai d. mun.;2016;4;173;102;71
Lazdijai d. mun.;2016;5;132;59;73
Lazdijai d. mun.;2016;6;170;89;81
Lazdijai d. mun.;2016;7;145;73;72
Lazdijai d. mun.;2016;8;149;85;64
Lazdijai d. mun.;2016;9;159;89;70
Lazdijai d. mun.;2016;10;194;91;103
Lazdijai d. mun.;2016;11;160;74;86
Lazdijai d. mun.;2016;12;180;93;87
Lazdijai d. mun.;2016;13;183;78;105
Lazdijai d. mun.;2016;14;197;102;95
Lazdijai d. mun.;2016;15;251;110;141
Lazdijai d. mun.;2016;16;235;114;121
Lazdijai d. mun.;2016;17;268;142;126
Lazdijai d. mun.;2016;18;237;133;104
Lazdijai d. mun.;2016;19;268;138;130
Lazdijai d. mun.;2016;20;280;149;131
Lazdijai d. mun.;2016;21;322;162;160
Lazdijai d. mun.;2016;22;301;158;143
Lazdijai d. mun.;2016;23;352;184;168
Lazdijai d. mun.;2016;24;303;171;132
Lazdijai d. mun.;2016;25;281;168;113
Lazdijai d. mun.;2016;26;258;150;108
Lazdijai d. mun.;2016;27;247;150;97
Lazdijai d. mun.;2016;28;206;109;97
Lazdijai d. mun.;2016;29;213;125;88
Lazdijai d. mun.;2016;30;158;107;51
Lazdijai d. mun.;2016;31;121;68;53
Lazdijai d. mun.;2016;32;158;106;52
Lazdijai d. mun.;2016;33;158;95;63
Lazdijai d. mun.;2016;34;148;74;74
Lazdijai d. mun.;2016;35;185;93;92
Lazdijai d. mun.;2016;36;169;83;86
Lazdijai d. mun.;2016;37;161;80;81
Lazdijai d. mun.;2016;38;203;98;105
Lazdijai d. mun.;2016;39;201;105;96
Lazdijai d. mun.;2016;40;218;110;108
Lazdijai d. mun.;2016;41;261;126;135
Lazdijai d. mun.;2016;42;251;139;112
Lazdijai d. mun.;2016;43;276;141;135
Lazdijai d. mun.;2016;44;282;129;153
Lazdijai d. mun.;2016;45;253;130;123
Lazdijai d. mun.;2016;46;304;147;157
Lazdijai d. mun.;2016;47;344;183;161
Lazdijai d. mun.;2016;48;347;167;180
Lazdijai d. mun.;2016;49;334;178;156
Lazdijai d. mun.;2016;50;310;156;154
Lazdijai d. mun.;2016;51;333;183;150
Lazdijai d. mun.;2016;52;330;167;163
Lazdijai d. mun.;2016;53;364;200;164
Lazdijai d. mun.;2016;54;344;171;173
Lazdijai d. mun.;2016;55;321;168;153
Lazdijai d. mun.;2016;56;333;179;154
Lazdijai d. mun.;2016;57;284;131;153
Lazdijai d. mun.;2016;58;311;166;145
Lazdijai d. mun.;2016;59;269;135;134
Lazdijai d. mun.;2016;60;255;115;140
Lazdijai d. mun.;2016;61;247;127;120
Lazdijai d. mun.;2016;62;224;104;120
Lazdijai d. mun.;2016;63;240;118;122
Lazdijai d. mun.;2016;64;217;111;106
Lazdijai d. mun.;2016;65;218;94;124
Lazdijai d. mun.;2016;66;219;109;110
Lazdijai d. mun.;2016;67;205;76;129
Lazdijai d. mun.;2016;68;171;64;107
Lazdijai d. mun.;2016;69;186;82;104
Lazdijai d. mun.;2016;70;190;82;108
Lazdijai d. mun.;2016;71;183;73;110
Lazdijai d. mun.;2016;72;224;77;147
Lazdijai d. mun.;2016;73;221;83;138
Lazdijai d. mun.;2016;74;221;79;142
Lazdijai d. mun.;2016;75;244;81;163
Lazdijai d. mun.;2016;76;187;52;135
Lazdijai d. mun.;2016;77;213;80;133
Lazdijai d. mun.;2016;78;222;81;141
Lazdijai d. mun.;2016;79;204;69;135
Lazdijai d. mun.;2016;80;240;71;169
Lazdijai d. mun.;2016;81;190;61;129
Lazdijai d. mun.;2016;82;189;65;124
Lazdijai d. mun.;2016;83;207;59;148
Lazdijai d. mun.;2016;84;155;41;114
Lazdijai d. mun.;2016;85;782;175;607
Lazdijai d. mun.;2017;-1;19821;9467;10354
Lazdijai d. mun.;2017;0;157;81;76
Lazdijai d. mun.;2017;1;178;83;95
Lazdijai d. mun.;2017;2;176;83;93
Lazdijai d. mun.;2017;3;204;101;103
Lazdijai d. mun.;2017;4;202;107;95
Lazdijai d. mun.;2017;5;175;104;71
Lazdijai d. mun.;2017;6;125;58;67
Lazdijai d. mun.;2017;7;165;88;77
Lazdijai d. mun.;2017;8;140;72;68
Lazdijai d. mun.;2017;9;149;86;63
Lazdijai d. mun.;2017;10;151;86;65
Lazdijai d. mun.;2017;11;187;89;98
Lazdijai d. mun.;2017;12;161;75;86
Lazdijai d. mun.;2017;13;176;91;85
Lazdijai d. mun.;2017;14;182;78;104
Lazdijai d. mun.;2017;15;192;98;94
Lazdijai d. mun.;2017;16;251;109;142
Lazdijai d. mun.;2017;17;225;108;117
Lazdijai d. mun.;2017;18;270;143;127
Lazdijai d. mun.;2017;19;239;132;107
Lazdijai d. mun.;2017;20;263;133;130
Lazdijai d. mun.;2017;21;269;145;124
Lazdijai d. mun.;2017;22;308;157;151
Lazdijai d. mun.;2017;23;291;155;136
Lazdijai d. mun.;2017;24;338;184;154
Lazdijai d. mun.;2017;25;280;163;117
Lazdijai d. mun.;2017;26;251;155;96
Lazdijai d. mun.;2017;27;232;138;94
Lazdijai d. mun.;2017;28;223;139;84
Lazdijai d. mun.;2017;29;187;100;87
Lazdijai d. mun.;2017;30;201;127;74
Lazdijai d. mun.;2017;31;146;96;50
Lazdijai d. mun.;2017;32;105;67;38
Lazdijai d. mun.;2017;33;147;97;50
Lazdijai d. mun.;2017;34;141;87;54
Lazdijai d. mun.;2017;35;143;75;68
Lazdijai d. mun.;2017;36;169;84;85
Lazdijai d. mun.;2017;37;159;76;83
Lazdijai d. mun.;2017;38;152;72;80
Lazdijai d. mun.;2017;39;198;97;101
Lazdijai d. mun.;2017;40;195;101;94
Lazdijai d. mun.;2017;41;208;107;101
Lazdijai d. mun.;2017;42;257;124;133
Lazdijai d. mun.;2017;43;245;134;111
Lazdijai d. mun.;2017;44;267;134;133
Lazdijai d. mun.;2017;45;276;128;148
Lazdijai d. mun.;2017;46;249;127;122
Lazdijai d. mun.;2017;47;300;146;154
Lazdijai d. mun.;2017;48;344;180;164
Lazdijai d. mun.;2017;49;349;166;183
Lazdijai d. mun.;2017;50;333;177;156
Lazdijai d. mun.;2017;51;305;152;153
Lazdijai d. mun.;2017;52;335;184;151
Lazdijai d. mun.;2017;53;326;164;162
Lazdijai d. mun.;2017;54;367;201;166
Lazdijai d. mun.;2017;55;343;169;174
Lazdijai d. mun.;2017;56;324;170;154
Lazdijai d. mun.;2017;57;330;178;152
Lazdijai d. mun.;2017;58;277;126;151
Lazdijai d. mun.;2017;59;302;159;143
Lazdijai d. mun.;2017;60;263;131;132
Lazdijai d. mun.;2017;61;248;110;138
Lazdijai d. mun.;2017;62;242;122;120
Lazdijai d. mun.;2017;63;223;102;121
Lazdijai d. mun.;2017;64;230;109;121
Lazdijai d. mun.;2017;65;213;108;105
Lazdijai d. mun.;2017;66;216;93;123
Lazdijai d. mun.;2017;67;215;104;111
Lazdijai d. mun.;2017;68;204;75;129
Lazdijai d. mun.;2017;69;172;64;108
Lazdijai d. mun.;2017;70;184;80;104
Lazdijai d. mun.;2017;71;182;75;107
Lazdijai d. mun.;2017;72;179;70;109
Lazdijai d. mun.;2017;73;217;72;145
Lazdijai d. mun.;2017;74;211;77;134
Lazdijai d. mun.;2017;75;211;73;138
Lazdijai d. mun.;2017;76;229;76;153
Lazdijai d. mun.;2017;77;178;46;132
Lazdijai d. mun.;2017;78;202;75;127
Lazdijai d. mun.;2017;79;206;77;129
Lazdijai d. mun.;2017;80;196;65;131
Lazdijai d. mun.;2017;81;226;67;159
Lazdijai d. mun.;2017;82;179;57;122
Lazdijai d. mun.;2017;83;178;59;119
Lazdijai d. mun.;2017;84;194;56;138
Lazdijai d. mun.;2017;85;783;178;605
Lazdijai d. mun.;2018;-1;19115;9151;9964
Lazdijai d. mun.;2018;0;156;94;62
Lazdijai d. mun.;2018;1;152;79;73
Lazdijai d. mun.;2018;2;163;79;84
Lazdijai d. mun.;2018;3;169;79;90
Lazdijai d. mun.;2018;4;185;89;96
Lazdijai d. mun.;2018;5;200;106;94
Lazdijai d. mun.;2018;6;175;104;71
Lazdijai d. mun.;2018;7;117;55;62
Lazdijai d. mun.;2018;8;162;87;75
Lazdijai d. mun.;2018;9;135;68;67
Lazdijai d. mun.;2018;10;148;85;63
Lazdijai d. mun.;2018;11;149;85;64
Lazdijai d. mun.;2018;12;185;88;97
Lazdijai d. mun.;2018;13;158;74;84
Lazdijai d. mun.;2018;14;179;92;87
Lazdijai d. mun.;2018;15;178;76;102
Lazdijai d. mun.;2018;16;190;96;94
Lazdijai d. mun.;2018;17;248;108;140
Lazdijai d. mun.;2018;18;218;104;114
Lazdijai d. mun.;2018;19;262;140;122
Lazdijai d. mun.;2018;20;228;124;104
Lazdijai d. mun.;2018;21;250;126;124
Lazdijai d. mun.;2018;22;242;134;108
Lazdijai d. mun.;2018;23;285;145;140
Lazdijai d. mun.;2018;24;269;147;122
Lazdijai d. mun.;2018;25;297;160;137
Lazdijai d. mun.;2018;26;251;150;101
Lazdijai d. mun.;2018;27;229;147;82
Lazdijai d. mun.;2018;28;203;119;84
Lazdijai d. mun.;2018;29;198;124;74
Lazdijai d. mun.;2018;30;168;94;74
Lazdijai d. mun.;2018;31;179;112;67
Lazdijai d. mun.;2018;32;141;94;47
Lazdijai d. mun.;2018;33;94;59;35
Lazdijai d. mun.;2018;34;133;89;44
Lazdijai d. mun.;2018;35;131;78;53
Lazdijai d. mun.;2018;36;137;73;64
Lazdijai d. mun.;2018;37;166;84;82
Lazdijai d. mun.;2018;38;152;72;80
Lazdijai d. mun.;2018;39;144;68;76
Lazdijai d. mun.;2018;40;195;96;99
Lazdijai d. mun.;2018;41;189;103;86
Lazdijai d. mun.;2018;42;199;100;99
Lazdijai d. mun.;2018;43;253;125;128
Lazdijai d. mun.;2018;44;234;131;103
Lazdijai d. mun.;2018;45;270;136;134
Lazdijai d. mun.;2018;46;275;125;150
Lazdijai d. mun.;2018;47;242;125;117
Lazdijai d. mun.;2018;48;298;143;155
Lazdijai d. mun.;2018;49;331;173;158
Lazdijai d. mun.;2018;50;341;162;179
Lazdijai d. mun.;2018;51;329;176;153
Lazdijai d. mun.;2018;52;299;147;152
Lazdijai d. mun.;2018;53;334;185;149
Lazdijai d. mun.;2018;54;317;157;160
Lazdijai d. mun.;2018;55;365;199;166
Lazdijai d. mun.;2018;56;339;166;173
Lazdijai d. mun.;2018;57;319;165;154
Lazdijai d. mun.;2018;58;331;177;154
Lazdijai d. mun.;2018;59;278;127;151
Lazdijai d. mun.;2018;60;298;155;143
Lazdijai d. mun.;2018;61;257;125;132
Lazdijai d. mun.;2018;62;245;105;140
Lazdijai d. mun.;2018;63;243;122;121
Lazdijai d. mun.;2018;64;219;99;120
Lazdijai d. mun.;2018;65;228;108;120
Lazdijai d. mun.;2018;66;210;106;104
Lazdijai d. mun.;2018;67;214;91;123
Lazdijai d. mun.;2018;68;208;101;107
Lazdijai d. mun.;2018;69;201;74;127
Lazdijai d. mun.;2018;70;164;58;106
Lazdijai d. mun.;2018;71;176;74;102
Lazdijai d. mun.;2018;72;179;73;106
Lazdijai d. mun.;2018;73;176;69;107
Lazdijai d. mun.;2018;74;214;70;144
Lazdijai d. mun.;2018;75;204;72;132
Lazdijai d. mun.;2018;76;201;67;134
Lazdijai d. mun.;2018;77;218;70;148
Lazdijai d. mun.;2018;78;175;47;128
Lazdijai d. mun.;2018;79;187;65;122
Lazdijai d. mun.;2018;80;195;70;125
Lazdijai d. mun.;2018;81;183;59;124
Lazdijai d. mun.;2018;82;213;65;148
Lazdijai d. mun.;2018;83;170;56;114
Lazdijai d. mun.;2018;84;164;53;111
Lazdijai d. mun.;2018;85;809;192;617
Marijampolė county;2001;-1;188775;90031;98744
Marijampolė county;2001;0;2025;1019;1006
Marijampolė county;2001;1;2193;1130;1063
Marijampolė county;2001;2;2304;1229;1075
Marijampolė county;2001;3;2330;1202;1128
Marijampolė county;2001;4;2334;1170;1164
Marijampolė county;2001;5;2487;1278;1209
Marijampolė county;2001;6;2549;1292;1257
Marijampolė county;2001;7;2755;1416;1339
Marijampolė county;2001;8;3097;1573;1524
Marijampolė county;2001;9;3119;1600;1519
Marijampolė county;2001;10;3229;1646;1583
Marijampolė county;2001;11;3047;1540;1507
Marijampolė county;2001;12;3187;1658;1529
Marijampolė county;2001;13;3272;1691;1581
Marijampolė county;2001;14;3391;1749;1642
Marijampolė county;2001;15;3182;1602;1580
Marijampolė county;2001;16;3060;1556;1504
Marijampolė county;2001;17;3042;1595;1447
Marijampolė county;2001;18;2563;1316;1247
Marijampolė county;2001;19;2251;1213;1038
Marijampolė county;2001;20;2185;1205;980
Marijampolė county;2001;21;2214;1194;1020
Marijampolė county;2001;22;2265;1210;1055
Marijampolė county;2001;23;2285;1175;1110
Marijampolė county;2001;24;2285;1193;1092
Marijampolė county;2001;25;2249;1175;1074
Marijampolė county;2001;26;2404;1234;1170
Marijampolė county;2001;27;2466;1226;1240
Marijampolė county;2001;28;2622;1356;1266
Marijampolė county;2001;29;2671;1348;1323
Marijampolė county;2001;30;2757;1398;1359
Marijampolė county;2001;31;2629;1321;1308
Marijampolė county;2001;32;2666;1327;1339
Marijampolė county;2001;33;2658;1332;1326
Marijampolė county;2001;34;2674;1300;1374
Marijampolė county;2001;35;2657;1327;1330
Marijampolė county;2001;36;2819;1433;1386
Marijampolė county;2001;37;2850;1454;1396
Marijampolė county;2001;38;2883;1463;1420
Marijampolė county;2001;39;3106;1592;1514
Marijampolė county;2001;40;3001;1556;1445
Marijampolė county;2001;41;2885;1457;1428
Marijampolė county;2001;42;2787;1411;1376
Marijampolė county;2001;43;2573;1298;1275
Marijampolė county;2001;44;2436;1159;1277
Marijampolė county;2001;45;2431;1181;1250
Marijampolė county;2001;46;2185;1077;1108
Marijampolė county;2001;47;2086;1037;1049
Marijampolė county;2001;48;2068;1051;1017
Marijampolė county;2001;49;2132;1063;1069
Marijampolė county;2001;50;2143;1051;1092
Marijampolė county;2001;51;2120;1047;1073
Marijampolė county;2001;52;1791;831;960
Marijampolė county;2001;53;1645;800;845
Marijampolė county;2001;54;1522;736;786
Marijampolė county;2001;55;1907;895;1012
Marijampolė county;2001;56;1448;656;792
Marijampolė county;2001;57;1959;862;1097
Marijampolė county;2001;58;2217;963;1254
Marijampolė county;2001;59;2122;923;1199
Marijampolė county;2001;60;1937;816;1121
Marijampolė county;2001;61;1780;742;1038
Marijampolė county;2001;62;1932;814;1118
Marijampolė county;2001;63;1894;792;1102
Marijampolė county;2001;64;1989;852;1137
Marijampolė county;2001;65;1916;794;1122
Marijampolė county;2001;66;1792;756;1036
Marijampolė county;2001;67;2116;863;1253
Marijampolė county;2001;68;2104;768;1336
Marijampolė county;2001;69;1857;727;1130
Marijampolė county;2001;70;2047;818;1229
Marijampolė county;2001;71;1942;720;1222
Marijampolė county;2001;72;1840;668;1172
Marijampolė county;2001;73;1514;529;985
Marijampolė county;2001;74;1367;430;937
Marijampolė county;2001;75;1306;412;894
Marijampolė county;2001;76;1183;357;826
Marijampolė county;2001;77;1068;337;731
Marijampolė county;2001;78;1044;326;718
Marijampolė county;2001;79;772;241;531
Marijampolė county;2001;80;737;240;497
Marijampolė county;2001;81;646;180;466
Marijampolė county;2001;82;515;142;373
Marijampolė county;2001;83;430;121;309
Marijampolė county;2001;84;420;117;303
Marijampolė county;2001;85;2407;677;1730
Marijampolė county;2002;-1;187281;89323;97958
Marijampolė county;2002;0;1933;990;943
Marijampolė county;2002;1;2013;1013;1000
Marijampolė county;2002;2;2179;1119;1060
Marijampolė county;2002;3;2296;1226;1070
Marijampolė county;2002;4;2322;1195;1127
Marijampolė county;2002;5;2314;1163;1151
Marijampolė county;2002;6;2486;1276;1210
Marijampolė county;2002;7;2536;1295;1241
Marijampolė county;2002;8;2757;1420;1337
Marijampolė county;2002;9;3080;1556;1524
Marijampolė county;2002;10;3100;1587;1513
Marijampolė county;2002;11;3202;1631;1571
Marijampolė county;2002;12;3009;1523;1486
Marijampolė county;2002;13;3137;1632;1505
Marijampolė county;2002;14;3237;1669;1568
Marijampolė county;2002;15;3339;1717;1622
Marijampolė county;2002;16;3150;1586;1564
Marijampolė county;2002;17;3009;1529;1480
Marijampolė county;2002;18;2995;1569;1426
Marijampolė county;2002;19;2497;1286;1211
Marijampolė county;2002;20;2209;1185;1024
Marijampolė county;2002;21;2148;1175;973
Marijampolė county;2002;22;2171;1178;993
Marijampolė county;2002;23;2250;1194;1056
Marijampolė county;2002;24;2236;1144;1092
Marijampolė county;2002;25;2254;1178;1076
Marijampolė county;2002;26;2211;1145;1066
Marijampolė county;2002;27;2362;1203;1159
Marijampolė county;2002;28;2412;1196;1216
Marijampolė county;2002;29;2566;1322;1244
Marijampolė county;2002;30;2623;1324;1299
Marijampolė county;2002;31;2708;1378;1330
Marijampolė county;2002;32;2580;1286;1294
Marijampolė county;2002;33;2621;1297;1324
Marijampolė county;2002;34;2623;1309;1314
Marijampolė county;2002;35;2643;1276;1367
Marijampolė county;2002;36;2624;1314;1310
Marijampolė county;2002;37;2778;1406;1372
Marijampolė county;2002;38;2805;1423;1382
Marijampolė county;2002;39;2824;1428;1396
Marijampolė county;2002;40;3059;1556;1503
Marijampolė county;2002;41;2976;1542;1434
Marijampolė county;2002;42;2852;1443;1409
Marijampolė county;2002;43;2760;1402;1358
Marijampolė county;2002;44;2545;1283;1262
Marijampolė county;2002;45;2396;1138;1258
Marijampolė county;2002;46;2389;1164;1225
Marijampolė county;2002;47;2174;1075;1099
Marijampolė county;2002;48;2048;1021;1027
Marijampolė county;2002;49;2032;1030;1002
Marijampolė county;2002;50;2099;1037;1062
Marijampolė county;2002;51;2099;1029;1070
Marijampolė county;2002;52;2102;1037;1065
Marijampolė county;2002;53;1772;821;951
Marijampolė county;2002;54;1609;781;828
Marijampolė county;2002;55;1497;725;772
Marijampolė county;2002;56;1859;869;990
Marijampolė county;2002;57;1426;646;780
Marijampolė county;2002;58;1919;849;1070
Marijampolė county;2002;59;2173;941;1232
Marijampolė county;2002;60;2090;906;1184
Marijampolė county;2002;61;1928;812;1116
Marijampolė county;2002;62;1780;745;1035
Marijampolė county;2002;63;1916;797;1119
Marijampolė county;2002;64;1877;784;1093
Marijampolė county;2002;65;1958;834;1124
Marijampolė county;2002;66;1875;771;1104
Marijampolė county;2002;67;1765;743;1022
Marijampolė county;2002;68;2085;844;1241
Marijampolė county;2002;69;2071;749;1322
Marijampolė county;2002;70;1816;702;1114
Marijampolė county;2002;71;2002;788;1214
Marijampolė county;2002;72;1899;701;1198
Marijampolė county;2002;73;1787;649;1138
Marijampolė county;2002;74;1457;496;961
Marijampolė county;2002;75;1323;414;909
Marijampolė county;2002;76;1259;396;863
Marijampolė county;2002;77;1113;322;791
Marijampolė county;2002;78;1016;305;711
Marijampolė county;2002;79;989;302;687
Marijampolė county;2002;80;733;232;501
Marijampolė county;2002;81;675;210;465
Marijampolė county;2002;82;574;169;405
Marijampolė county;2002;83;478;132;346
Marijampolė county;2002;84;391;113;278
Marijampolė county;2002;85;2399;675;1724
Marijampolė county;2003;-1;185970;88666;97304
Marijampolė county;2003;0;1820;919;901
Marijampolė county;2003;1;1908;979;929
Marijampolė county;2003;2;2002;1008;994
Marijampolė county;2003;3;2169;1114;1055
Marijampolė county;2003;4;2283;1217;1066
Marijampolė county;2003;5;2318;1193;1125
Marijampolė county;2003;6;2308;1163;1145
Marijampolė county;2003;7;2481;1276;1205
Marijampolė county;2003;8;2533;1295;1238
Marijampolė county;2003;9;2754;1416;1338
Marijampolė county;2003;10;3058;1549;1509
Marijampolė county;2003;11;3087;1587;1500
Marijampolė county;2003;12;3156;1609;1547
Marijampolė county;2003;13;2964;1498;1466
Marijampolė county;2003;14;3093;1604;1489
Marijampolė county;2003;15;3186;1640;1546
Marijampolė county;2003;16;3287;1690;1597
Marijampolė county;2003;17;3090;1548;1542
Marijampolė county;2003;18;2974;1510;1464
Marijampolė county;2003;19;2956;1545;1411
Marijampolė county;2003;20;2461;1265;1196
Marijampolė county;2003;21;2195;1186;1009
Marijampolė county;2003;22;2136;1181;955
Marijampolė county;2003;23;2154;1172;982
Marijampolė county;2003;24;2243;1195;1048
Marijampolė county;2003;25;2217;1140;1077
Marijampolė county;2003;26;2238;1172;1066
Marijampolė county;2003;27;2166;1122;1044
Marijampolė county;2003;28;2332;1182;1150
Marijampolė county;2003;29;2379;1177;1202
Marijampolė county;2003;30;2532;1310;1222
Marijampolė county;2003;31;2596;1314;1282
Marijampolė county;2003;32;2675;1357;1318
Marijampolė county;2003;33;2551;1273;1278
Marijampolė county;2003;34;2604;1288;1316
Marijampolė county;2003;35;2591;1295;1296
Marijampolė county;2003;36;2610;1264;1346
Marijampolė county;2003;37;2591;1295;1296
Marijampolė county;2003;38;2750;1395;1355
Marijampolė county;2003;39;2775;1408;1367
Marijampolė county;2003;40;2796;1415;1381
Marijampolė county;2003;41;3029;1540;1489
Marijampolė county;2003;42;2947;1523;1424
Marijampolė county;2003;43;2828;1429;1399
Marijampolė county;2003;44;2759;1404;1355
Marijampolė county;2003;45;2517;1266;1251
Marijampolė county;2003;46;2365;1121;1244
Marijampolė county;2003;47;2369;1153;1216
Marijampolė county;2003;48;2137;1054;1083
Marijampolė county;2003;49;2025;1007;1018
Marijampolė county;2003;50;2008;1018;990
Marijampolė county;2003;51;2064;1015;1049
Marijampolė county;2003;52;2082;1013;1069
Marijampolė county;2003;53;2096;1034;1062
Marijampolė county;2003;54;1753;806;947
Marijampolė county;2003;55;1589;767;822
Marijampolė county;2003;56;1475;716;759
Marijampolė county;2003;57;1848;859;989
Marijampolė county;2003;58;1395;624;771
Marijampolė county;2003;59;1901;837;1064
Marijampolė county;2003;60;2132;909;1223
Marijampolė county;2003;61;2064;889;1175
Marijampolė county;2003;62;1918;805;1113
Marijampolė county;2003;63;1755;729;1026
Marijampolė county;2003;64;1897;783;1114
Marijampolė county;2003;65;1862;773;1089
Marijampolė county;2003;66;1926;804;1122
Marijampolė county;2003;67;1867;764;1103
Marijampolė county;2003;68;1718;708;1010
Marijampolė county;2003;69;2034;816;1218
Marijampolė county;2003;70;2034;728;1306
Marijampolė county;2003;71;1762;669;1093
Marijampolė county;2003;72;1951;754;1197
Marijampolė county;2003;73;1820;656;1164
Marijampolė county;2003;74;1705;605;1100
Marijampolė county;2003;75;1408;467;941
Marijampolė county;2003;76;1262;390;872
Marijampolė county;2003;77;1194;361;833
Marijampolė county;2003;78;1051;284;767
Marijampolė county;2003;79;947;276;671
Marijampolė county;2003;80;915;272;643
Marijampolė county;2003;81;681;204;477
Marijampolė county;2003;82;622;184;438
Marijampolė county;2003;83;525;146;379
Marijampolė county;2003;84;433;119;314
Marijampolė county;2003;85;2281;619;1662
Marijampolė county;2004;-1;184058;87540;96518
Marijampolė county;2004;0;1835;944;891
Marijampolė county;2004;1;1816;920;896
Marijampolė county;2004;2;1887;962;925
Marijampolė county;2004;3;1997;1006;991
Marijampolė county;2004;4;2156;1109;1047
Marijampolė county;2004;5;2274;1212;1062
Marijampolė county;2004;6;2315;1193;1122
Marijampolė county;2004;7;2293;1150;1143
Marijampolė county;2004;8;2468;1269;1199
Marijampolė county;2004;9;2525;1287;1238
Marijampolė county;2004;10;2746;1407;1339
Marijampolė county;2004;11;3035;1537;1498
Marijampolė county;2004;12;3048;1562;1486
Marijampolė county;2004;13;3118;1596;1522
Marijampolė county;2004;14;2911;1476;1435
Marijampolė county;2004;15;3046;1585;1461
Marijampolė county;2004;16;3133;1618;1515
Marijampolė county;2004;17;3234;1664;1570
Marijampolė county;2004;18;3035;1523;1512
Marijampolė county;2004;19;2919;1486;1433
Marijampolė county;2004;20;2898;1515;1383
Marijampolė county;2004;21;2399;1233;1166
Marijampolė county;2004;22;2154;1165;989
Marijampolė county;2004;23;2090;1165;925
Marijampolė county;2004;24;2132;1149;983
Marijampolė county;2004;25;2196;1176;1020
Marijampolė county;2004;26;2167;1112;1055
Marijampolė county;2004;27;2167;1131;1036
Marijampolė county;2004;28;2118;1085;1033
Marijampolė county;2004;29;2293;1158;1135
Marijampolė county;2004;30;2319;1138;1181
Marijampolė county;2004;31;2484;1283;1201
Marijampolė county;2004;32;2546;1291;1255
Marijampolė county;2004;33;2643;1329;1314
Marijampolė county;2004;34;2513;1254;1259
Marijampolė county;2004;35;2568;1268;1300
Marijampolė county;2004;36;2553;1271;1282
Marijampolė county;2004;37;2572;1237;1335
Marijampolė county;2004;38;2551;1272;1279
Marijampolė county;2004;39;2715;1374;1341
Marijampolė county;2004;40;2740;1385;1355
Marijampolė county;2004;41;2757;1396;1361
Marijampolė county;2004;42;2993;1525;1468
Marijampolė county;2004;43;2906;1495;1411
Marijampolė county;2004;44;2780;1394;1386
Marijampolė county;2004;45;2745;1397;1348
Marijampolė county;2004;46;2494;1250;1244
Marijampolė county;2004;47;2339;1109;1230
Marijampolė county;2004;48;2340;1129;1211
Marijampolė county;2004;49;2112;1039;1073
Marijampolė county;2004;50;1996;990;1006
Marijampolė county;2004;51;1972;990;982
Marijampolė county;2004;52;2035;999;1036
Marijampolė county;2004;53;2052;993;1059
Marijampolė county;2004;54;2083;1031;1052
Marijampolė county;2004;55;1727;787;940
Marijampolė county;2004;56;1561;750;811
Marijampolė county;2004;57;1442;693;749
Marijampolė county;2004;58;1811;835;976
Marijampolė county;2004;59;1368;606;762
Marijampolė county;2004;60;1862;811;1051
Marijampolė county;2004;61;2090;882;1208
Marijampolė county;2004;62;2024;861;1163
Marijampolė county;2004;63;1884;781;1103
Marijampolė county;2004;64;1719;702;1017
Marijampolė county;2004;65;1876;761;1115
Marijampolė county;2004;66;1820;741;1079
Marijampolė county;2004;67;1893;778;1115
Marijampolė county;2004;68;1814;716;1098
Marijampolė county;2004;69;1667;675;992
Marijampolė county;2004;70;1982;776;1206
Marijampolė county;2004;71;1993;699;1294
Marijampolė county;2004;72;1686;629;1057
Marijampolė county;2004;73;1896;723;1173
Marijampolė county;2004;74;1745;604;1141
Marijampolė county;2004;75;1647;572;1075
Marijampolė county;2004;76;1338;425;913
Marijampolė county;2004;77;1198;359;839
Marijampolė county;2004;78;1142;340;802
Marijampolė county;2004;79;998;260;738
Marijampolė county;2004;80;866;240;626
Marijampolė county;2004;81;864;251;613
Marijampolė county;2004;82;641;187;454
Marijampolė county;2004;83;580;165;415
Marijampolė county;2004;84;465;125;340
Marijampolė county;2004;85;2246;572;1674
Marijampolė county;2005;-1;181376;86078;95298
Marijampolė county;2005;0;1713;859;854
Marijampolė county;2005;1;1809;926;883
Marijampolė county;2005;2;1804;912;892
Marijampolė county;2005;3;1868;954;914
Marijampolė county;2005;4;1966;990;976
Marijampolė county;2005;5;2135;1100;1035
Marijampolė county;2005;6;2256;1201;1055
Marijampolė county;2005;7;2299;1181;1118
Marijampolė county;2005;8;2282;1145;1137
Marijampolė county;2005;9;2444;1256;1188
Marijampolė county;2005;10;2522;1283;1239
Marijampolė county;2005;11;2733;1397;1336
Marijampolė county;2005;12;3021;1529;1492
Marijampolė county;2005;13;3028;1547;1481
Marijampolė county;2005;14;3082;1580;1502
Marijampolė county;2005;15;2860;1448;1412
Marijampolė county;2005;16;2995;1556;1439
Marijampolė county;2005;17;3073;1584;1489
Marijampolė county;2005;18;3172;1622;1550
Marijampolė county;2005;19;2966;1482;1484
Marijampolė county;2005;20;2833;1443;1390
Marijampolė county;2005;21;2807;1464;1343
Marijampolė county;2005;22;2314;1194;1120
Marijampolė county;2005;23;2077;1141;936
Marijampolė county;2005;24;2027;1140;887
Marijampolė county;2005;25;2032;1104;928
Marijampolė county;2005;26;2125;1144;981
Marijampolė county;2005;27;2092;1078;1014
Marijampolė county;2005;28;2112;1101;1011
Marijampolė county;2005;29;2067;1067;1000
Marijampolė county;2005;30;2218;1115;1103
Marijampolė county;2005;31;2269;1107;1162
Marijampolė county;2005;32;2433;1248;1185
Marijampolė county;2005;33;2488;1259;1229
Marijampolė county;2005;34;2590;1300;1290
Marijampolė county;2005;35;2466;1224;1242
Marijampolė county;2005;36;2523;1247;1276
Marijampolė county;2005;37;2499;1240;1259
Marijampolė county;2005;38;2521;1207;1314
Marijampolė county;2005;39;2527;1265;1262
Marijampolė county;2005;40;2676;1349;1327
Marijampolė county;2005;41;2694;1355;1339
Marijampolė county;2005;42;2709;1367;1342
Marijampolė county;2005;43;2953;1494;1459
Marijampolė county;2005;44;2886;1481;1405
Marijampolė county;2005;45;2748;1374;1374
Marijampolė county;2005;46;2708;1376;1332
Marijampolė county;2005;47;2459;1226;1233
Marijampolė county;2005;48;2314;1094;1220
Marijampolė county;2005;49;2306;1102;1204
Marijampolė county;2005;50;2078;1017;1061
Marijampolė county;2005;51;1953;961;992
Marijampolė county;2005;52;1939;968;971
Marijampolė county;2005;53;2001;978;1023
Marijampolė county;2005;54;2018;970;1048
Marijampolė county;2005;55;2061;1012;1049
Marijampolė county;2005;56;1708;773;935
Marijampolė county;2005;57;1534;732;802
Marijampolė county;2005;58;1425;679;746
Marijampolė county;2005;59;1775;810;965
Marijampolė county;2005;60;1342;592;750
Marijampolė county;2005;61;1831;787;1044
Marijampolė county;2005;62;2052;854;1198
Marijampolė county;2005;63;2000;837;1163
Marijampolė county;2005;64;1848;759;1089
Marijampolė county;2005;65;1678;675;1003
Marijampolė county;2005;66;1830;724;1106
Marijampolė county;2005;67;1772;712;1060
Marijampolė county;2005;68;1839;736;1103
Marijampolė county;2005;69;1751;673;1078
Marijampolė county;2005;70;1629;655;974
Marijampolė county;2005;71;1915;744;1171
Marijampolė county;2005;72;1906;648;1258
Marijampolė county;2005;73;1632;600;1032
Marijampolė county;2005;74;1813;677;1136
Marijampolė county;2005;75;1657;555;1102
Marijampolė county;2005;76;1573;527;1046
Marijampolė county;2005;77;1277;401;876
Marijampolė county;2005;78;1135;332;803
Marijampolė county;2005;79;1054;308;746
Marijampolė county;2005;80;935;239;696
Marijampolė county;2005;81;792;212;580
Marijampolė county;2005;82;785;214;571
Marijampolė county;2005;83;590;170;420
Marijampolė county;2005;84;522;142;380
Marijampolė county;2005;85;2225;547;1678
Marijampolė county;2006;-1;177439;84163;93276
Marijampolė county;2006;0;1559;818;741
Marijampolė county;2006;1;1685;846;839
Marijampolė county;2006;2;1781;908;873
Marijampolė county;2006;3;1760;891;869
Marijampolė county;2006;4;1830;937;893
Marijampolė county;2006;5;1946;981;965
Marijampolė county;2006;6;2104;1091;1013
Marijampolė county;2006;7;2233;1189;1044
Marijampolė county;2006;8;2270;1171;1099
Marijampolė county;2006;9;2259;1138;1121
Marijampolė county;2006;10;2430;1249;1181
Marijampolė county;2006;11;2502;1271;1231
Marijampolė county;2006;12;2707;1387;1320
Marijampolė county;2006;13;2961;1501;1460
Marijampolė county;2006;14;2993;1531;1462
Marijampolė county;2006;15;2999;1540;1459
Marijampolė county;2006;16;2764;1398;1366
Marijampolė county;2006;17;2924;1518;1406
Marijampolė county;2006;18;2965;1531;1434
Marijampolė county;2006;19;3007;1536;1471
Marijampolė county;2006;20;2816;1411;1405
Marijampolė county;2006;21;2666;1357;1309
Marijampolė county;2006;22;2658;1406;1252
Marijampolė county;2006;23;2204;1150;1054
Marijampolė county;2006;24;1969;1077;892
Marijampolė county;2006;25;1881;1049;832
Marijampolė county;2006;26;1930;1043;887
Marijampolė county;2006;27;2038;1092;946
Marijampolė county;2006;28;2029;1042;987
Marijampolė county;2006;29;2059;1074;985
Marijampolė county;2006;30;2012;1040;972
Marijampolė county;2006;31;2168;1093;1075
Marijampolė county;2006;32;2213;1075;1138
Marijampolė county;2006;33;2352;1203;1149
Marijampolė county;2006;34;2416;1223;1193
Marijampolė county;2006;35;2517;1254;1263
Marijampolė county;2006;36;2406;1191;1215
Marijampolė county;2006;37;2455;1209;1246
Marijampolė county;2006;38;2432;1200;1232
Marijampolė county;2006;39;2462;1173;1289
Marijampolė county;2006;40;2469;1232;1237
Marijampolė county;2006;41;2622;1318;1304
Marijampolė county;2006;42;2637;1324;1313
Marijampolė county;2006;43;2652;1337;1315
Marijampolė county;2006;44;2897;1461;1436
Marijampolė county;2006;45;2853;1469;1384
Marijampolė county;2006;46;2708;1355;1353
Marijampolė county;2006;47;2661;1344;1317
Marijampolė county;2006;48;2436;1215;1221
Marijampolė county;2006;49;2271;1068;1203
Marijampolė county;2006;50;2259;1075;1184
Marijampolė county;2006;51;2054;1005;1049
Marijampolė county;2006;52;1917;940;977
Marijampolė county;2006;53;1894;937;957
Marijampolė county;2006;54;1963;955;1008
Marijampolė county;2006;55;1982;949;1033
Marijampolė county;2006;56;2020;990;1030
Marijampolė county;2006;57;1675;754;921
Marijampolė county;2006;58;1506;715;791
Marijampolė county;2006;59;1396;665;731
Marijampolė county;2006;60;1732;793;939
Marijampolė county;2006;61;1317;576;741
Marijampolė county;2006;62;1785;761;1024
Marijampolė county;2006;63;2010;836;1174
Marijampolė county;2006;64;1952;806;1146
Marijampolė county;2006;65;1807;728;1079
Marijampolė county;2006;66;1631;646;985
Marijampolė county;2006;67;1780;692;1088
Marijampolė county;2006;68;1723;681;1042
Marijampolė county;2006;69;1786;699;1087
Marijampolė county;2006;70;1712;651;1061
Marijampolė county;2006;71;1568;611;957
Marijampolė county;2006;72;1827;686;1141
Marijampolė county;2006;73;1831;609;1222
Marijampolė county;2006;74;1572;571;1001
Marijampolė county;2006;75;1743;643;1100
Marijampolė county;2006;76;1576;511;1065
Marijampolė county;2006;77;1493;483;1010
Marijampolė county;2006;78;1208;372;836
Marijampolė county;2006;79;1058;300;758
Marijampolė county;2006;80;979;277;702
Marijampolė county;2006;81;872;222;650
Marijampolė county;2006;82;715;191;524
Marijampolė county;2006;83;715;191;524
Marijampolė county;2006;84;543;153;390
Marijampolė county;2006;85;2270;572;1698
Marijampolė county;2007;-1;174810;82795;92015
Marijampolė county;2007;0;1652;847;805
Marijampolė county;2007;1;1541;805;736
Marijampolė county;2007;2;1653;830;823
Marijampolė county;2007;3;1768;905;863
Marijampolė county;2007;4;1752;888;864
Marijampolė county;2007;5;1808;928;880
Marijampolė county;2007;6;1939;980;959
Marijampolė county;2007;7;2088;1083;1005
Marijampolė county;2007;8;2218;1181;1037
Marijampolė county;2007;9;2253;1162;1091
Marijampolė county;2007;10;2239;1123;1116
Marijampolė county;2007;11;2417;1243;1174
Marijampolė county;2007;12;2489;1272;1217
Marijampolė county;2007;13;2695;1381;1314
Marijampolė county;2007;14;2936;1494;1442
Marijampolė county;2007;15;2972;1527;1445
Marijampolė county;2007;16;2969;1526;1443
Marijampolė county;2007;17;2732;1385;1347
Marijampolė county;2007;18;2869;1487;1382
Marijampolė county;2007;19;2911;1500;1411
Marijampolė county;2007;20;2931;1498;1433
Marijampolė county;2007;21;2735;1367;1368
Marijampolė county;2007;22;2576;1306;1270
Marijampolė county;2007;23;2575;1359;1216
Marijampolė county;2007;24;2116;1103;1013
Marijampolė county;2007;25;1895;1044;851
Marijampolė county;2007;26;1811;1006;805
Marijampolė county;2007;27;1889;1019;870
Marijampolė county;2007;28;1981;1062;919
Marijampolė county;2007;29;1968;1008;960
Marijampolė county;2007;30;2008;1046;962
Marijampolė county;2007;31;1980;1015;965
Marijampolė county;2007;32;2130;1074;1056
Marijampolė county;2007;33;2176;1052;1124
Marijampolė county;2007;34;2313;1175;1138
Marijampolė county;2007;35;2368;1200;1168
Marijampolė county;2007;36;2470;1224;1246
Marijampolė county;2007;37;2366;1170;1196
Marijampolė county;2007;38;2409;1176;1233
Marijampolė county;2007;39;2395;1182;1213
Marijampolė county;2007;40;2421;1146;1275
Marijampolė county;2007;41;2421;1199;1222
Marijampolė county;2007;42;2591;1299;1292
Marijampolė county;2007;43;2593;1296;1297
Marijampolė county;2007;44;2604;1311;1293
Marijampolė county;2007;45;2851;1432;1419
Marijampolė county;2007;46;2810;1440;1370
Marijampolė county;2007;47;2660;1323;1337
Marijampolė county;2007;48;2640;1330;1310
Marijampolė county;2007;49;2410;1203;1207
Marijampolė county;2007;50;2226;1038;1188
Marijampolė county;2007;51;2210;1046;1164
Marijampolė county;2007;52;2020;977;1043
Marijampolė county;2007;53;1894;919;975
Marijampolė county;2007;54;1865;916;949
Marijampolė county;2007;55;1915;924;991
Marijampolė county;2007;56;1957;926;1031
Marijampolė county;2007;57;1983;959;1024
Marijampolė county;2007;58;1649;738;911
Marijampolė county;2007;59;1479;690;789
Marijampolė county;2007;60;1371;646;725
Marijampolė county;2007;61;1692;769;923
Marijampolė county;2007;62;1285;558;727
Marijampolė county;2007;63;1751;738;1013
Marijampolė county;2007;64;1965;806;1159
Marijampolė county;2007;65;1892;764;1128
Marijampolė county;2007;66;1770;698;1072
Marijampolė county;2007;67;1604;629;975
Marijampolė county;2007;68;1736;663;1073
Marijampolė county;2007;69;1671;653;1018
Marijampolė county;2007;70;1727;671;1056
Marijampolė county;2007;71;1660;618;1042
Marijampolė county;2007;72;1517;585;932
Marijampolė county;2007;73;1757;646;1111
Marijampolė county;2007;74;1755;562;1193
Marijampolė county;2007;75;1504;540;964
Marijampolė county;2007;76;1667;605;1062
Marijampolė county;2007;77;1495;476;1019
Marijampolė county;2007;78;1422;458;964
Marijampolė county;2007;79;1126;341;785
Marijampolė county;2007;80;987;281;706
Marijampolė county;2007;81;903;249;654
Marijampolė county;2007;82;791;192;599
Marijampolė county;2007;83;654;171;483
Marijampolė county;2007;84;625;167;458
Marijampolė county;2007;85;2291;564;1727
Marijampolė county;2008;-1;172200;81477;90723
Marijampolė county;2008;0;1528;789;739
Marijampolė county;2008;1;1633;837;796
Marijampolė county;2008;2;1532;803;729
Marijampolė county;2008;3;1643;824;819
Marijampolė county;2008;4;1753;895;858
Marijampolė county;2008;5;1733;881;852
Marijampolė county;2008;6;1791;923;868
Marijampolė county;2008;7;1923;968;955
Marijampolė county;2008;8;2066;1071;995
Marijampolė county;2008;9;2201;1172;1029
Marijampolė county;2008;10;2231;1151;1080
Marijampolė county;2008;11;2224;1113;1111
Marijampolė county;2008;12;2399;1235;1164
Marijampolė county;2008;13;2478;1262;1216
Marijampolė county;2008;14;2688;1376;1312
Marijampolė county;2008;15;2917;1482;1435
Marijampolė county;2008;16;2958;1521;1437
Marijampolė county;2008;17;2941;1512;1429
Marijampolė county;2008;18;2675;1356;1319
Marijampolė county;2008;19;2810;1455;1355
Marijampolė county;2008;20;2848;1475;1373
Marijampolė county;2008;21;2863;1461;1402
Marijampolė county;2008;22;2659;1334;1325
Marijampolė county;2008;23;2520;1281;1239
Marijampolė county;2008;24;2507;1325;1182
Marijampolė county;2008;25;2046;1066;980
Marijampolė county;2008;26;1829;1005;824
Marijampolė county;2008;27;1752;968;784
Marijampolė county;2008;28;1819;984;835
Marijampolė county;2008;29;1941;1040;901
Marijampolė county;2008;30;1931;992;939
Marijampolė county;2008;31;1952;1023;929
Marijampolė county;2008;32;1936;988;948
Marijampolė county;2008;33;2100;1058;1042
Marijampolė county;2008;34;2143;1036;1107
Marijampolė county;2008;35;2264;1141;1123
Marijampolė county;2008;36;2331;1176;1155
Marijampolė county;2008;37;2441;1203;1238
Marijampolė county;2008;38;2335;1149;1186
Marijampolė county;2008;39;2374;1154;1220
Marijampolė county;2008;40;2362;1162;1200
Marijampolė county;2008;41;2401;1133;1268
Marijampolė county;2008;42;2378;1174;1204
Marijampolė county;2008;43;2549;1281;1268
Marijampolė county;2008;44;2539;1262;1277
Marijampolė county;2008;45;2570;1286;1284
Marijampolė county;2008;46;2808;1406;1402
Marijampolė county;2008;47;2773;1412;1361
Marijampolė county;2008;48;2632;1301;1331
Marijampolė county;2008;49;2613;1312;1301
Marijampolė county;2008;50;2370;1180;1190
Marijampolė county;2008;51;2200;1024;1176
Marijampolė county;2008;52;2184;1031;1153
Marijampolė county;2008;53;1984;955;1029
Marijampolė county;2008;54;1861;893;968
Marijampolė county;2008;55;1832;897;935
Marijampolė county;2008;56;1878;905;973
Marijampolė county;2008;57;1919;907;1012
Marijampolė county;2008;58;1935;929;1006
Marijampolė county;2008;59;1615;711;904
Marijampolė county;2008;60;1445;668;777
Marijampolė county;2008;61;1337;621;716
Marijampolė county;2008;62;1653;741;912
Marijampolė county;2008;63;1258;538;720
Marijampolė county;2008;64;1696;700;996
Marijampolė county;2008;65;1907;762;1145
Marijampolė county;2008;66;1859;745;1114
Marijampolė county;2008;67;1711;669;1042
Marijampolė county;2008;68;1570;610;960
Marijampolė county;2008;69;1696;637;1059
Marijampolė county;2008;70;1617;626;991
Marijampolė county;2008;71;1684;645;1039
Marijampolė county;2008;72;1597;587;1010
Marijampolė county;2008;73;1454;545;909
Marijampolė county;2008;74;1675;602;1073
Marijampolė county;2008;75;1676;522;1154
Marijampolė county;2008;76;1424;498;926
Marijampolė county;2008;77;1589;571;1018
Marijampolė county;2008;78;1376;423;953
Marijampolė county;2008;79;1325;415;910
Marijampolė county;2008;80;1037;312;725
Marijampolė county;2008;81;920;249;671
Marijampolė county;2008;82;820;222;598
Marijampolė county;2008;83;726;175;551
Marijampolė county;2008;84;582;153;429
Marijampolė county;2008;85;2448;595;1853
Marijampolė county;2009;-1;169973;80527;89446
Marijampolė county;2009;0;1591;815;776
Marijampolė county;2009;1;1509;776;733
Marijampolė county;2009;2;1612;832;780
Marijampolė county;2009;3;1515;797;718
Marijampolė county;2009;4;1626;814;812
Marijampolė county;2009;5;1750;898;852
Marijampolė county;2009;6;1726;879;847
Marijampolė county;2009;7;1773;918;855
Marijampolė county;2009;8;1898;959;939
Marijampolė county;2009;9;2049;1068;981
Marijampolė county;2009;10;2191;1164;1027
Marijampolė county;2009;11;2211;1140;1071
Marijampolė county;2009;12;2210;1107;1103
Marijampolė county;2009;13;2391;1235;1156
Marijampolė county;2009;14;2466;1261;1205
Marijampolė county;2009;15;2676;1366;1310
Marijampolė county;2009;16;2902;1476;1426
Marijampolė county;2009;17;2940;1509;1431
Marijampolė county;2009;18;2915;1500;1415
Marijampolė county;2009;19;2643;1340;1303
Marijampolė county;2009;20;2776;1442;1334
Marijampolė county;2009;21;2795;1450;1345
Marijampolė county;2009;22;2795;1430;1365
Marijampolė county;2009;23;2588;1308;1280
Marijampolė county;2009;24;2449;1250;1199
Marijampolė county;2009;25;2446;1304;1142
Marijampolė county;2009;26;1956;1042;914
Marijampolė county;2009;27;1762;974;788
Marijampolė county;2009;28;1686;939;747
Marijampolė county;2009;29;1747;945;802
Marijampolė county;2009;30;1901;1014;887
Marijampolė county;2009;31;1886;969;917
Marijampolė county;2009;32;1913;1000;913
Marijampolė county;2009;33;1907;975;932
Marijampolė county;2009;34;2079;1051;1028
Marijampolė county;2009;35;2097;1014;1083
Marijampolė county;2009;36;2225;1125;1100
Marijampolė county;2009;37;2304;1163;1141
Marijampolė county;2009;38;2408;1186;1222
Marijampolė county;2009;39;2312;1140;1172
Marijampolė county;2009;40;2346;1140;1206
Marijampolė county;2009;41;2339;1148;1191
Marijampolė county;2009;42;2373;1121;1252
Marijampolė county;2009;43;2366;1167;1199
Marijampolė county;2009;44;2524;1266;1258
Marijampolė county;2009;45;2507;1245;1262
Marijampolė county;2009;46;2546;1268;1278
Marijampolė county;2009;47;2775;1382;1393
Marijampolė county;2009;48;2734;1387;1347
Marijampolė county;2009;49;2604;1290;1314
Marijampolė county;2009;50;2568;1282;1286
Marijampolė county;2009;51;2350;1170;1180
Marijampolė county;2009;52;2169;1005;1164
Marijampolė county;2009;53;2153;1020;1133
Marijampolė county;2009;54;1950;940;1010
Marijampolė county;2009;55;1819;868;951
Marijampolė county;2009;56;1801;876;925
Marijampolė county;2009;57;1823;870;953
Marijampolė county;2009;58;1885;887;998
Marijampolė county;2009;59;1903;907;996
Marijampolė county;2009;60;1578;685;893
Marijampolė county;2009;61;1424;656;768
Marijampolė county;2009;62;1302;601;701
Marijampolė county;2009;63;1622;718;904
Marijampolė county;2009;64;1238;522;716
Marijampolė county;2009;65;1646;666;980
Marijampolė county;2009;66;1873;738;1135
Marijampolė county;2009;67;1812;718;1094
Marijampolė county;2009;68;1672;648;1024
Marijampolė county;2009;69;1516;577;939
Marijampolė county;2009;70;1651;609;1042
Marijampolė county;2009;71;1573;605;968
Marijampolė county;2009;72;1620;612;1008
Marijampolė county;2009;73;1555;564;991
Marijampolė county;2009;74;1395;515;880
Marijampolė county;2009;75;1600;559;1041
Marijampolė county;2009;76;1606;496;1110
Marijampolė county;2009;77;1358;471;887
Marijampolė county;2009;78;1490;526;964
Marijampolė county;2009;79;1298;385;913
Marijampolė county;2009;80;1233;382;851
Marijampolė county;2009;81;967;289;678
Marijampolė county;2009;82;858;232;626
Marijampolė county;2009;83;742;193;549
Marijampolė county;2009;84;652;150;502
Marijampolė county;2009;85;2531;596;1935
Marijampolė county;2010;-1;167143;79162;87981
Marijampolė county;2010;0;1629;849;780
Marijampolė county;2010;1;1555;795;760
Marijampolė county;2010;2;1476;759;717
Marijampolė county;2010;3;1577;818;759
Marijampolė county;2010;4;1499;793;706
Marijampolė county;2010;5;1608;808;800
Marijampolė county;2010;6;1723;884;839
Marijampolė county;2010;7;1707;864;843
Marijampolė county;2010;8;1760;910;850
Marijampolė county;2010;9;1880;955;925
Marijampolė county;2010;10;2040;1061;979
Marijampolė county;2010;11;2169;1153;1016
Marijampolė county;2010;12;2202;1137;1065
Marijampolė county;2010;13;2195;1100;1095
Marijampolė county;2010;14;2388;1234;1154
Marijampolė county;2010;15;2447;1251;1196
Marijampolė county;2010;16;2660;1364;1296
Marijampolė county;2010;17;2889;1466;1423
Marijampolė county;2010;18;2925;1502;1423
Marijampolė county;2010;19;2866;1482;1384
Marijampolė county;2010;20;2588;1316;1272
Marijampolė county;2010;21;2722;1416;1306
Marijampolė county;2010;22;2716;1410;1306
Marijampolė county;2010;23;2681;1379;1302
Marijampolė county;2010;24;2483;1259;1224
Marijampolė county;2010;25;2355;1206;1149
Marijampolė county;2010;26;2337;1251;1086
Marijampolė county;2010;27;1850;988;862
Marijampolė county;2010;28;1665;919;746
Marijampolė county;2010;29;1622;908;714
Marijampolė county;2010;30;1688;912;776
Marijampolė county;2010;31;1842;984;858
Marijampolė county;2010;32;1828;940;888
Marijampolė county;2010;33;1861;971;890
Marijampolė county;2010;34;1858;945;913
Marijampolė county;2010;35;2024;1021;1003
Marijampolė county;2010;36;2059;990;1069
Marijampolė county;2010;37;2179;1097;1082
Marijampolė county;2010;38;2260;1137;1123
Marijampolė county;2010;39;2366;1160;1206
Marijampolė county;2010;40;2259;1107;1152
Marijampolė county;2010;41;2305;1113;1192
Marijampolė county;2010;42;2297;1121;1176
Marijampolė county;2010;43;2349;1108;1241
Marijampolė county;2010;44;2326;1144;1182
Marijampolė county;2010;45;2487;1247;1240
Marijampolė county;2010;46;2458;1213;1245
Marijampolė county;2010;47;2513;1249;1264
Marijampolė county;2010;48;2741;1365;1376
Marijampolė county;2010;49;2698;1367;1331
Marijampolė county;2010;50;2567;1270;1297
Marijampolė county;2010;51;2523;1257;1266
Marijampolė county;2010;52;2304;1137;1167
Marijampolė county;2010;53;2125;975;1150
Marijampolė county;2010;54;2130;998;1132
Marijampolė county;2010;55;1910;914;996
Marijampolė county;2010;56;1790;857;933
Marijampolė county;2010;57;1758;848;910
Marijampolė county;2010;58;1796;853;943
Marijampolė county;2010;59;1855;871;984
Marijampolė county;2010;60;1872;879;993
Marijampolė county;2010;61;1550;670;880
Marijampolė county;2010;62;1395;631;764
Marijampolė county;2010;63;1266;577;689
Marijampolė county;2010;64;1595;703;892
Marijampolė county;2010;65;1202;495;707
Marijampolė county;2010;66;1594;634;960
Marijampolė county;2010;67;1814;701;1113
Marijampolė county;2010;68;1772;693;1079
Marijampolė county;2010;69;1637;626;1011
Marijampolė county;2010;70;1481;563;918
Marijampolė county;2010;71;1603;588;1015
Marijampolė county;2010;72;1506;563;943
Marijampolė county;2010;73;1565;578;987
Marijampolė county;2010;74;1490;532;958
Marijampolė county;2010;75;1346;493;853
Marijampolė county;2010;76;1533;532;1001
Marijampolė county;2010;77;1540;456;1084
Marijampolė county;2010;78;1271;431;840
Marijampolė county;2010;79;1393;484;909
Marijampolė county;2010;80;1215;352;863
Marijampolė county;2010;81;1154;359;795
Marijampolė county;2010;82;886;253;633
Marijampolė county;2010;83;777;201;576
Marijampolė county;2010;84;668;167;501
Marijampolė county;2010;85;2648;593;2055
Marijampolė county;2011;-1;162205;76800;85405
Marijampolė county;2011;0;1415;722;693
Marijampolė county;2011;1;1506;782;724
Marijampolė county;2011;2;1485;766;719
Marijampolė county;2011;3;1405;727;678
Marijampolė county;2011;4;1517;782;735
Marijampolė county;2011;5;1412;754;658
Marijampolė county;2011;6;1553;800;753
Marijampolė county;2011;7;1655;840;815
Marijampolė county;2011;8;1692;868;824
Marijampolė county;2011;9;1717;877;840
Marijampolė county;2011;10;1842;927;915
Marijampolė county;2011;11;2021;1052;969
Marijampolė county;2011;12;2147;1137;1010
Marijampolė county;2011;13;2167;1122;1045
Marijampolė county;2011;14;2163;1077;1086
Marijampolė county;2011;15;2339;1208;1131
Marijampolė county;2011;16;2427;1236;1191
Marijampolė county;2011;17;2602;1328;1274
Marijampolė county;2011;18;2856;1462;1394
Marijampolė county;2011;19;2513;1311;1202
Marijampolė county;2011;20;2438;1289;1149
Marijampolė county;2011;21;2188;1168;1020
Marijampolė county;2011;22;2223;1208;1015
Marijampolė county;2011;23;2158;1153;1005
Marijampolė county;2011;24;2143;1172;971
Marijampolė county;2011;25;1919;990;929
Marijampolė county;2011;26;1827;996;831
Marijampolė county;2011;27;1817;1023;794
Marijampolė county;2011;28;1774;948;826
Marijampolė county;2011;29;1767;915;852
Marijampolė county;2011;30;1712;908;804
Marijampolė county;2011;31;1775;945;830
Marijampolė county;2011;32;1819;951;868
Marijampolė county;2011;33;1859;934;925
Marijampolė county;2011;34;1898;964;934
Marijampolė county;2011;35;1877;964;913
Marijampolė county;2011;36;1983;993;990
Marijampolė county;2011;37;2096;1017;1079
Marijampolė county;2011;38;2248;1144;1104
Marijampolė county;2011;39;2334;1167;1167
Marijampolė county;2011;40;2424;1198;1226
Marijampolė county;2011;41;2312;1158;1154
Marijampolė county;2011;42;2354;1160;1194
Marijampolė county;2011;43;2349;1172;1177
Marijampolė county;2011;44;2403;1165;1238
Marijampolė county;2011;45;2332;1130;1202
Marijampolė county;2011;46;2517;1251;1266
Marijampolė county;2011;47;2508;1251;1257
Marijampolė county;2011;48;2514;1242;1272
Marijampolė county;2011;49;2707;1319;1388
Marijampolė county;2011;50;2668;1353;1315
Marijampolė county;2011;51;2548;1265;1283
Marijampolė county;2011;52;2444;1210;1234
Marijampolė county;2011;53;2265;1117;1148
Marijampolė county;2011;54;2150;986;1164
Marijampolė county;2011;55;2141;980;1161
Marijampolė county;2011;56;1892;882;1010
Marijampolė county;2011;57;1818;847;971
Marijampolė county;2011;58;1802;865;937
Marijampolė county;2011;59;1825;838;987
Marijampolė county;2011;60;1857;858;999
Marijampolė county;2011;61;1814;832;982
Marijampolė county;2011;62;1526;645;881
Marijampolė county;2011;63;1406;633;773
Marijampolė county;2011;64;1273;564;709
Marijampolė county;2011;65;1605;705;900
Marijampolė county;2011;66;1214;487;727
Marijampolė county;2011;67;1581;606;975
Marijampolė county;2011;68;1801;674;1127
Marijampolė county;2011;69;1750;670;1080
Marijampolė county;2011;70;1616;602;1014
Marijampolė county;2011;71;1426;527;899
Marijampolė county;2011;72;1538;543;995
Marijampolė county;2011;73;1472;543;929
Marijampolė county;2011;74;1495;532;963
Marijampolė county;2011;75;1436;498;938
Marijampolė county;2011;76;1296;465;831
Marijampolė county;2011;77;1461;502;959
Marijampolė county;2011;78;1461;421;1040
Marijampolė county;2011;79;1190;393;797
Marijampolė county;2011;80;1289;435;854
Marijampolė county;2011;81;1114;317;797
Marijampolė county;2011;82;1037;304;733
Marijampolė county;2011;83;807;226;581
Marijampolė county;2011;84;698;175;523
Marijampolė county;2011;85;2780;627;2153
Marijampolė county;2012;-1;159273;75507;83766
Marijampolė county;2012;0;1585;849;736
Marijampolė county;2012;1;1393;714;679
Marijampolė county;2012;2;1493;775;718
Marijampolė county;2012;3;1447;746;701
Marijampolė county;2012;4;1378;710;668
Marijampolė county;2012;5;1504;778;726
Marijampolė county;2012;6;1386;735;651
Marijampolė county;2012;7;1542;798;744
Marijampolė county;2012;8;1641;837;804
Marijampolė county;2012;9;1675;853;822
Marijampolė county;2012;10;1715;878;837
Marijampolė county;2012;11;1823;915;908
Marijampolė county;2012;12;2006;1048;958
Marijampolė county;2012;13;2130;1130;1000
Marijampolė county;2012;14;2157;1114;1043
Marijampolė county;2012;15;2151;1074;1077
Marijampolė county;2012;16;2321;1196;1125
Marijampolė county;2012;17;2405;1225;1180
Marijampolė county;2012;18;2567;1311;1256
Marijampolė county;2012;19;2731;1413;1318
Marijampolė county;2012;20;2433;1280;1153
Marijampolė county;2012;21;2359;1248;1111
Marijampolė county;2012;22;2110;1130;980
Marijampolė county;2012;23;2077;1150;927
Marijampolė county;2012;24;2035;1110;925
Marijampolė county;2012;25;2004;1104;900
Marijampolė county;2012;26;1785;937;848
Marijampolė county;2012;27;1701;935;766
Marijampolė county;2012;28;1721;969;752
Marijampolė county;2012;29;1691;895;796
Marijampolė county;2012;30;1703;883;820
Marijampolė county;2012;31;1637;871;766
Marijampolė county;2012;32;1722;915;807
Marijampolė county;2012;33;1760;923;837
Marijampolė county;2012;34;1810;912;898
Marijampolė county;2012;35;1837;933;904
Marijampolė county;2012;36;1852;951;901
Marijampolė county;2012;37;1945;976;969
Marijampolė county;2012;38;2069;1009;1060
Marijampolė county;2012;39;2207;1115;1092
Marijampolė county;2012;40;2313;1162;1151
Marijampolė county;2012;41;2397;1189;1208
Marijampolė county;2012;42;2283;1143;1140
Marijampolė county;2012;43;2332;1149;1183
Marijampolė county;2012;44;2313;1156;1157
Marijampolė county;2012;45;2367;1147;1220
Marijampolė county;2012;46;2307;1120;1187
Marijampolė county;2012;47;2484;1234;1250
Marijampolė county;2012;48;2477;1231;1246
Marijampolė county;2012;49;2470;1211;1259
Marijampolė county;2012;50;2662;1292;1370
Marijampolė county;2012;51;2635;1329;1306
Marijampolė county;2012;52;2510;1241;1269
Marijampolė county;2012;53;2408;1190;1218
Marijampolė county;2012;54;2241;1103;1138
Marijampolė county;2012;55;2122;969;1153
Marijampolė county;2012;56;2095;945;1150
Marijampolė county;2012;57;1854;854;1000
Marijampolė county;2012;58;1783;817;966
Marijampolė county;2012;59;1786;848;938
Marijampolė county;2012;60;1800;814;986
Marijampolė county;2012;61;1820;833;987
Marijampolė county;2012;62;1770;807;963
Marijampolė county;2012;63;1505;630;875
Marijampolė county;2012;64;1386;618;768
Marijampolė county;2012;65;1249;547;702
Marijampolė county;2012;66;1570;687;883
Marijampolė county;2012;67;1177;464;713
Marijampolė county;2012;68;1553;590;963
Marijampolė county;2012;69;1743;633;1110
Marijampolė county;2012;70;1699;636;1063
Marijampolė county;2012;71;1570;582;988
Marijampolė county;2012;72;1383;507;876
Marijampolė county;2012;73;1488;521;967
Marijampolė county;2012;74;1434;521;913
Marijampolė county;2012;75;1428;493;935
Marijampolė county;2012;76;1375;459;916
Marijampolė county;2012;77;1256;444;812
Marijampolė county;2012;78;1377;464;913
Marijampolė county;2012;79;1362;388;974
Marijampolė county;2012;80;1127;364;763
Marijampolė county;2012;81;1191;394;797
Marijampolė county;2012;82;1023;285;738
Marijampolė county;2012;83;945;278;667
Marijampolė county;2012;84;734;198;536
Marijampolė county;2012;85;2961;675;2286
Marijampolė county;2013;-1;156455;74130;82325
Marijampolė county;2013;0;1580;804;776
Marijampolė county;2013;1;1569;846;723
Marijampolė county;2013;2;1359;702;657
Marijampolė county;2013;3;1461;756;705
Marijampolė county;2013;4;1412;720;692
Marijampolė county;2013;5;1345;695;650
Marijampolė county;2013;6;1479;769;710
Marijampolė county;2013;7;1362;727;635
Marijampolė county;2013;8;1532;796;736
Marijampolė county;2013;9;1630;828;802
Marijampolė county;2013;10;1647;838;809
Marijampolė county;2013;11;1680;863;817
Marijampolė county;2013;12;1796;903;893
Marijampolė county;2013;13;1994;1042;952
Marijampolė county;2013;14;2111;1121;990
Marijampolė county;2013;15;2137;1101;1036
Marijampolė county;2013;16;2130;1061;1069
Marijampolė county;2013;17;2297;1184;1113
Marijampolė county;2013;18;2372;1210;1162
Marijampolė county;2013;19;2491;1275;1216
Marijampolė county;2013;20;2670;1379;1291
Marijampolė county;2013;21;2394;1261;1133
Marijampolė county;2013;22;2280;1207;1073
Marijampolė county;2013;23;2019;1082;937
Marijampolė county;2013;24;2001;1115;886
Marijampolė county;2013;25;1945;1063;882
Marijampolė county;2013;26;1915;1075;840
Marijampolė county;2013;27;1673;885;788
Marijampolė county;2013;28;1620;892;728
Marijampolė county;2013;29;1632;924;708
Marijampolė county;2013;30;1598;852;746
Marijampolė county;2013;31;1617;844;773
Marijampolė county;2013;32;1582;834;748
Marijampolė county;2013;33;1681;892;789
Marijampolė county;2013;34;1708;903;805
Marijampolė county;2013;35;1750;883;867
Marijampolė county;2013;36;1772;891;881
Marijampolė county;2013;37;1819;937;882
Marijampolė county;2013;38;1904;956;948
Marijampolė county;2013;39;2029;992;1037
Marijampolė county;2013;40;2179;1097;1082
Marijampolė county;2013;41;2281;1143;1138
Marijampolė county;2013;42;2353;1154;1199
Marijampolė county;2013;43;2261;1130;1131
Marijampolė county;2013;44;2297;1130;1167
Marijampolė county;2013;45;2273;1138;1135
Marijampolė county;2013;46;2335;1123;1212
Marijampolė county;2013;47;2287;1110;1177
Marijampolė county;2013;48;2462;1219;1243
Marijampolė county;2013;49;2446;1208;1238
Marijampolė county;2013;50;2443;1191;1252
Marijampolė county;2013;51;2628;1265;1363
Marijampolė county;2013;52;2605;1306;1299
Marijampolė county;2013;53;2477;1224;1253
Marijampolė county;2013;54;2366;1163;1203
Marijampolė county;2013;55;2211;1086;1125
Marijampolė county;2013;56;2100;960;1140
Marijampolė county;2013;57;2058;916;1142
Marijampolė county;2013;58;1828;836;992
Marijampolė county;2013;59;1762;802;960
Marijampolė county;2013;60;1760;825;935
Marijampolė county;2013;61;1760;791;969
Marijampolė county;2013;62;1792;813;979
Marijampolė county;2013;63;1729;783;946
Marijampolė county;2013;64;1472;606;866
Marijampolė county;2013;65;1366;604;762
Marijampolė county;2013;66;1212;520;692
Marijampolė county;2013;67;1536;662;874
Marijampolė county;2013;68;1151;443;708
Marijampolė county;2013;69;1520;569;951
Marijampolė county;2013;70;1697;610;1087
Marijampolė county;2013;71;1649;602;1047
Marijampolė county;2013;72;1519;548;971
Marijampolė county;2013;73;1339;485;854
Marijampolė county;2013;74;1426;485;941
Marijampolė county;2013;75;1388;498;890
Marijampolė county;2013;76;1357;458;899
Marijampolė county;2013;77;1309;425;884
Marijampolė county;2013;78;1203;417;786
Marijampolė county;2013;79;1276;410;866
Marijampolė county;2013;80;1290;358;932
Marijampolė county;2013;81;1060;327;733
Marijampolė county;2013;82;1110;356;754
Marijampolė county;2013;83;924;256;668
Marijampolė county;2013;84;850;243;607
Marijampolė county;2013;85;3115;727;2388
Marijampolė county;2014;-1;154084;73029;81055
Marijampolė county;2014;0;1561;805;756
Marijampolė county;2014;1;1566;796;770
Marijampolė county;2014;2;1551;833;718
Marijampolė county;2014;3;1319;680;639
Marijampolė county;2014;4;1437;747;690
Marijampolė county;2014;5;1394;722;672
Marijampolė county;2014;6;1328;687;641
Marijampolė county;2014;7;1452;755;697
Marijampolė county;2014;8;1356;723;633
Marijampolė county;2014;9;1519;790;729
Marijampolė county;2014;10;1611;817;794
Marijampolė county;2014;11;1629;830;799
Marijampolė county;2014;12;1672;863;809
Marijampolė county;2014;13;1779;892;887
Marijampolė county;2014;14;1986;1035;951
Marijampolė county;2014;15;2093;1109;984
Marijampolė county;2014;16;2124;1094;1030
Marijampolė county;2014;17;2122;1051;1071
Marijampolė county;2014;18;2264;1163;1101
Marijampolė county;2014;19;2302;1177;1125
Marijampolė county;2014;20;2461;1251;1210
Marijampolė county;2014;21;2616;1354;1262
Marijampolė county;2014;22;2334;1233;1101
Marijampolė county;2014;23;2203;1181;1022
Marijampolė county;2014;24;1964;1063;901
Marijampolė county;2014;25;1930;1083;847
Marijampolė county;2014;26;1868;1030;838
Marijampolė county;2014;27;1825;1039;786
Marijampolė county;2014;28;1595;855;740
Marijampolė county;2014;29;1541;868;673
Marijampolė county;2014;30;1566;897;669
Marijampolė county;2014;31;1534;830;704
Marijampolė county;2014;32;1579;828;751
Marijampolė county;2014;33;1521;802;719
Marijampolė county;2014;34;1649;876;773
Marijampolė county;2014;35;1682;880;802
Marijampolė county;2014;36;1716;863;853
Marijampolė county;2014;37;1734;867;867
Marijampolė county;2014;38;1808;932;876
Marijampolė county;2014;39;1882;943;939
Marijampolė county;2014;40;2009;978;1031
Marijampolė county;2014;41;2139;1078;1061
Marijampolė county;2014;42;2259;1128;1131
Marijampolė county;2014;43;2323;1134;1189
Marijampolė county;2014;44;2250;1124;1126
Marijampolė county;2014;45;2260;1109;1151
Marijampolė county;2014;46;2254;1125;1129
Marijampolė county;2014;47;2308;1103;1205
Marijampolė county;2014;48;2265;1090;1175
Marijampolė county;2014;49;2447;1211;1236
Marijampolė county;2014;50;2421;1186;1235
Marijampolė county;2014;51;2427;1182;1245
Marijampolė county;2014;52;2606;1251;1355
Marijampolė county;2014;53;2573;1287;1286
Marijampolė county;2014;54;2446;1207;1239
Marijampolė county;2014;55;2343;1153;1190
Marijampolė county;2014;56;2171;1059;1112
Marijampolė county;2014;57;2073;942;1131
Marijampolė county;2014;58;2031;898;1133
Marijampolė county;2014;59;1812;820;992
Marijampolė county;2014;60;1745;787;958
Marijampolė county;2014;61;1729;801;928
Marijampolė county;2014;62;1726;768;958
Marijampolė county;2014;63;1761;791;970
Marijampolė county;2014;64;1687;754;933
Marijampolė county;2014;65;1450;592;858
Marijampolė county;2014;66;1320;569;751
Marijampolė county;2014;67;1192;503;689
Marijampolė county;2014;68;1489;628;861
Marijampolė county;2014;69;1127;422;705
Marijampolė county;2014;70;1479;537;942
Marijampolė county;2014;71;1645;577;1068
Marijampolė county;2014;72;1585;561;1024
Marijampolė county;2014;73;1458;515;943
Marijampolė county;2014;74;1290;454;836
Marijampolė county;2014;75;1385;462;923
Marijampolė county;2014;76;1326;465;861
Marijampolė county;2014;77;1309;440;869
Marijampolė county;2014;78;1238;395;843
Marijampolė county;2014;79;1121;383;738
Marijampolė county;2014;80;1183;373;810
Marijampolė county;2014;81;1211;332;879
Marijampolė county;2014;82;976;289;687
Marijampolė county;2014;83;986;311;675
Marijampolė county;2014;84;830;216;614
Marijampolė county;2014;85;3346;795;2551
Marijampolė county;2015;-1;151793;72076;79717
Marijampolė county;2015;0;1516;783;733
Marijampolė county;2015;1;1549;801;748
Marijampolė county;2015;2;1555;800;755
Marijampolė county;2015;3;1539;826;713
Marijampolė county;2015;4;1305;678;627
Marijampolė county;2015;5;1420;735;685
Marijampolė county;2015;6;1370;713;657
Marijampolė county;2015;7;1313;680;633
Marijampolė county;2015;8;1454;753;701
Marijampolė county;2015;9;1347;720;627
Marijampolė county;2015;10;1502;780;722
Marijampolė county;2015;11;1595;809;786
Marijampolė county;2015;12;1611;821;790
Marijampolė county;2015;13;1663;857;806
Marijampolė county;2015;14;1770;884;886
Marijampolė county;2015;15;1976;1032;944
Marijampolė county;2015;16;2081;1103;978
Marijampolė county;2015;17;2107;1083;1024
Marijampolė county;2015;18;2096;1040;1056
Marijampolė county;2015;19;2208;1138;1070
Marijampolė county;2015;20;2269;1169;1100
Marijampolė county;2015;21;2425;1234;1191
Marijampolė county;2015;22;2549;1330;1219
Marijampolė county;2015;23;2256;1197;1059
Marijampolė county;2015;24;2144;1157;987
Marijampolė county;2015;25;1884;1030;854
Marijampolė county;2015;26;1843;1047;796
Marijampolė county;2015;27;1769;1001;768
Marijampolė county;2015;28;1754;1015;739
Marijampolė county;2015;29;1528;831;697
Marijampolė county;2015;30;1464;831;633
Marijampolė county;2015;31;1506;870;636
Marijampolė county;2015;32;1486;810;676
Marijampolė county;2015;33;1549;825;724
Marijampolė county;2015;34;1498;784;714
Marijampolė county;2015;35;1610;849;761
Marijampolė county;2015;36;1643;859;784
Marijampolė county;2015;37;1682;841;841
Marijampolė county;2015;38;1722;863;859
Marijampolė county;2015;39;1772;910;862
Marijampolė county;2015;40;1864;937;927
Marijampolė county;2015;41;1997;968;1029
Marijampolė county;2015;42;2120;1069;1051
Marijampolė county;2015;43;2240;1117;1123
Marijampolė county;2015;44;2285;1118;1167
Marijampolė county;2015;45;2222;1113;1109
Marijampolė county;2015;46;2229;1084;1145
Marijampolė county;2015;47;2226;1108;1118
Marijampolė county;2015;48;2280;1091;1189
Marijampolė county;2015;49;2251;1080;1171
Marijampolė county;2015;50;2428;1196;1232
Marijampolė county;2015;51;2408;1185;1223
Marijampolė county;2015;52;2409;1174;1235
Marijampolė county;2015;53;2582;1230;1352
Marijampolė county;2015;54;2540;1269;1271
Marijampolė county;2015;55;2410;1182;1228
Marijampolė county;2015;56;2311;1133;1178
Marijampolė county;2015;57;2146;1040;1106
Marijampolė county;2015;58;2048;925;1123
Marijampolė county;2015;59;2000;878;1122
Marijampolė county;2015;60;1779;800;979
Marijampolė county;2015;61;1719;764;955
Marijampolė county;2015;62;1693;776;917
Marijampolė county;2015;63;1687;743;944
Marijampolė county;2015;64;1727;765;962
Marijampolė county;2015;65;1659;734;925
Marijampolė county;2015;66;1411;571;840
Marijampolė county;2015;67;1295;551;744
Marijampolė county;2015;68;1165;482;683
Marijampolė county;2015;69;1439;598;841
Marijampolė county;2015;70;1094;397;697
Marijampolė county;2015;71;1427;504;923
Marijampolė county;2015;72;1597;547;1050
Marijampolė county;2015;73;1527;523;1004
Marijampolė county;2015;74;1406;486;920
Marijampolė county;2015;75;1237;422;815
Marijampolė county;2015;76;1325;436;889
Marijampolė county;2015;77;1271;433;838
Marijampolė county;2015;78;1258;415;843
Marijampolė county;2015;79;1177;366;811
Marijampolė county;2015;80;1043;348;695
Marijampolė county;2015;81;1098;343;755
Marijampolė county;2015;82;1121;309;812
Marijampolė county;2015;83;894;258;636
Marijampolė county;2015;84;888;270;618
Marijampolė county;2015;85;3530;849;2681
Marijampolė county;2016;-1;149077;70730;78347
Marijampolė county;2016;0;1546;802;744
Marijampolė county;2016;1;1510;776;734
Marijampolė county;2016;2;1512;783;729
Marijampolė county;2016;3;1540;794;746
Marijampolė county;2016;4;1527;820;707
Marijampolė county;2016;5;1290;678;612
Marijampolė county;2016;6;1385;719;666
Marijampolė county;2016;7;1365;711;654
Marijampolė county;2016;8;1305;675;630
Marijampolė county;2016;9;1443;749;694
Marijampolė county;2016;10;1328;710;618
Marijampolė county;2016;11;1483;764;719
Marijampolė county;2016;12;1584;799;785
Marijampolė county;2016;13;1598;815;783
Marijampolė county;2016;14;1654;852;802
Marijampolė county;2016;15;1759;874;885
Marijampolė county;2016;16;1956;1021;935
Marijampolė county;2016;17;2069;1096;973
Marijampolė county;2016;18;2070;1066;1004
Marijampolė county;2016;19;2019;996;1023
Marijampolė county;2016;20;2149;1093;1056
Marijampolė county;2016;21;2210;1123;1087
Marijampolė county;2016;22;2344;1186;1158
Marijampolė county;2016;23;2439;1275;1164
Marijampolė county;2016;24;2156;1142;1014
Marijampolė county;2016;25;2051;1109;942
Marijampolė county;2016;26;1776;981;795
Marijampolė county;2016;27;1771;1020;751
Marijampolė county;2016;28;1676;958;718
Marijampolė county;2016;29;1651;964;687
Marijampolė county;2016;30;1450;786;664
Marijampolė county;2016;31;1404;787;617
Marijampolė county;2016;32;1460;840;620
Marijampolė county;2016;33;1436;780;656
Marijampolė county;2016;34;1502;788;714
Marijampolė county;2016;35;1440;751;689
Marijampolė county;2016;36;1568;831;737
Marijampolė county;2016;37;1601;840;761
Marijampolė county;2016;38;1662;825;837
Marijampolė county;2016;39;1690;844;846
Marijampolė county;2016;40;1738;883;855
Marijampolė county;2016;41;1828;921;907
Marijampolė county;2016;42;1974;958;1016
Marijampolė county;2016;43;2076;1043;1033
Marijampolė county;2016;44;2228;1104;1124
Marijampolė county;2016;45;2259;1107;1152
Marijampolė county;2016;46;2211;1107;1104
Marijampolė county;2016;47;2210;1076;1134
Marijampolė county;2016;48;2224;1111;1113
Marijampolė county;2016;49;2255;1077;1178
Marijampolė county;2016;50;2226;1064;1162
Marijampolė county;2016;51;2399;1176;1223
Marijampolė county;2016;52;2390;1179;1211
Marijampolė county;2016;53;2392;1161;1231
Marijampolė county;2016;54;2551;1205;1346
Marijampolė county;2016;55;2500;1236;1264
Marijampolė county;2016;56;2376;1160;1216
Marijampolė county;2016;57;2287;1110;1177
Marijampolė county;2016;58;2112;1016;1096
Marijampolė county;2016;59;2014;900;1114
Marijampolė county;2016;60;1975;863;1112
Marijampolė county;2016;61;1763;794;969
Marijampolė county;2016;62;1676;733;943
Marijampolė county;2016;63;1661;759;902
Marijampolė county;2016;64;1650;718;932
Marijampolė county;2016;65;1673;729;944
Marijampolė county;2016;66;1606;697;909
Marijampolė county;2016;67;1376;544;832
Marijampolė county;2016;68;1251;526;725
Marijampolė county;2016;69;1133;467;666
Marijampolė county;2016;70;1402;576;826
Marijampolė county;2016;71;1063;373;690
Marijampolė county;2016;72;1378;477;901
Marijampolė county;2016;73;1555;528;1027
Marijampolė county;2016;74;1479;504;975
Marijampolė county;2016;75;1346;456;890
Marijampolė county;2016;76;1195;393;802
Marijampolė county;2016;77;1258;409;849
Marijampolė county;2016;78;1184;389;795
Marijampolė county;2016;79;1196;382;814
Marijampolė county;2016;80;1107;335;772
Marijampolė county;2016;81;959;312;647
Marijampolė county;2016;82;1017;303;714
Marijampolė county;2016;83;1035;279;756
Marijampolė county;2016;84;808;227;581
Marijampolė county;2016;85;3702;940;2762
Marijampolė county;2017;-1;145360;68988;76372
Marijampolė county;2017;0;1478;782;696
Marijampolė county;2017;1;1504;776;728
Marijampolė county;2017;2;1468;751;717
Marijampolė county;2017;3;1471;750;721
Marijampolė county;2017;4;1512;784;728
Marijampolė county;2017;5;1499;810;689
Marijampolė county;2017;6;1276;667;609
Marijampolė county;2017;7;1351;698;653
Marijampolė county;2017;8;1344;702;642
Marijampolė county;2017;9;1286;665;621
Marijampolė county;2017;10;1414;731;683
Marijampolė county;2017;11;1295;695;600
Marijampolė county;2017;12;1464;754;710
Marijampolė county;2017;13;1568;788;780
Marijampolė county;2017;14;1580;803;777
Marijampolė county;2017;15;1636;843;793
Marijampolė county;2017;16;1735;860;875
Marijampolė county;2017;17;1929;1009;920
Marijampolė county;2017;18;2018;1063;955
Marijampolė county;2017;19;1966;1018;948
Marijampolė county;2017;20;1958;972;986
Marijampolė county;2017;21;2062;1048;1014
Marijampolė county;2017;22;2121;1083;1038
Marijampolė county;2017;23;2242;1146;1096
Marijampolė county;2017;24;2299;1206;1093
Marijampolė county;2017;25;2005;1082;923
Marijampolė county;2017;26;1898;1053;845
Marijampolė county;2017;27;1659;932;727
Marijampolė county;2017;28;1635;950;685
Marijampolė county;2017;29;1543;885;658
Marijampolė county;2017;30;1512;884;628
Marijampolė county;2017;31;1334;724;610
Marijampolė county;2017;32;1299;735;564
Marijampolė county;2017;33;1363;799;564
Marijampolė county;2017;34;1367;742;625
Marijampolė county;2017;35;1417;739;678
Marijampolė county;2017;36;1381;721;660
Marijampolė county;2017;37;1525;809;716
Marijampolė county;2017;38;1563;824;739
Marijampolė county;2017;39;1605;793;812
Marijampolė county;2017;40;1645;813;832
Marijampolė county;2017;41;1693;857;836
Marijampolė county;2017;42;1789;905;884
Marijampolė county;2017;43;1945;947;998
Marijampolė county;2017;44;2025;1010;1015
Marijampolė county;2017;45;2179;1083;1096
Marijampolė county;2017;46;2217;1085;1132
Marijampolė county;2017;47;2180;1088;1092
Marijampolė county;2017;48;2178;1065;1113
Marijampolė county;2017;49;2181;1083;1098
Marijampolė county;2017;50;2220;1059;1161
Marijampolė county;2017;51;2190;1043;1147
Marijampolė county;2017;52;2372;1162;1210
Marijampolė county;2017;53;2356;1161;1195
Marijampolė county;2017;54;2345;1146;1199
Marijampolė county;2017;55;2506;1177;1329
Marijampolė county;2017;56;2470;1214;1256
Marijampolė county;2017;57;2347;1141;1206
Marijampolė county;2017;58;2272;1099;1173
Marijampolė county;2017;59;2077;992;1085
Marijampolė county;2017;60;1986;887;1099
Marijampolė county;2017;61;1949;841;1108
Marijampolė county;2017;62;1733;776;957
Marijampolė county;2017;63;1639;711;928
Marijampolė county;2017;64;1624;732;892
Marijampolė county;2017;65;1609;691;918
Marijampolė county;2017;66;1624;701;923
Marijampolė county;2017;67;1560;667;893
Marijampolė county;2017;68;1348;527;821
Marijampolė county;2017;69;1213;498;715
Marijampolė county;2017;70;1097;450;647
Marijampolė county;2017;71;1363;552;811
Marijampolė county;2017;72;1032;350;682
Marijampolė county;2017;73;1341;453;888
Marijampolė county;2017;74;1497;499;998
Marijampolė county;2017;75;1439;489;950
Marijampolė county;2017;76;1279;423;856
Marijampolė county;2017;77;1155;372;783
Marijampolė county;2017;78;1195;372;823
Marijampolė county;2017;79;1112;353;759
Marijampolė county;2017;80;1131;346;785
Marijampolė county;2017;81;1047;314;733
Marijampolė county;2017;82;891;281;610
Marijampolė county;2017;83;951;280;671
Marijampolė county;2017;84;959;252;707
Marijampolė county;2017;85;3817;965;2852
Marijampolė county;2018;-1;141287;67148;74139
Marijampolė county;2018;0;1355;680;675
Marijampolė county;2018;1;1440;759;681
Marijampolė county;2018;2;1479;758;721
Marijampolė county;2018;3;1429;737;692
Marijampolė county;2018;4;1456;749;707
Marijampolė county;2018;5;1471;764;707
Marijampolė county;2018;6;1474;793;681
Marijampolė county;2018;7;1246;648;598
Marijampolė county;2018;8;1328;681;647
Marijampolė county;2018;9;1314;689;625
Marijampolė county;2018;10;1279;664;615
Marijampolė county;2018;11;1379;712;667
Marijampolė county;2018;12;1285;695;590
Marijampolė county;2018;13;1436;740;696
Marijampolė county;2018;14;1549;780;769
Marijampolė county;2018;15;1559;794;765
Marijampolė county;2018;16;1608;828;780
Marijampolė county;2018;17;1710;849;861
Marijampolė county;2018;18;1877;976;901
Marijampolė county;2018;19;1889;1008;881
Marijampolė county;2018;20;1868;974;894
Marijampolė county;2018;21;1834;911;923
Marijampolė county;2018;22;1907;982;925
Marijampolė county;2018;23;1947;995;952
Marijampolė county;2018;24;2056;1060;996
Marijampolė county;2018;25;2101;1126;975
Marijampolė county;2018;26;1828;994;834
Marijampolė county;2018;27;1705;981;724
Marijampolė county;2018;28;1517;880;637
Marijampolė county;2018;29;1507;902;605
Marijampolė county;2018;30;1423;808;615
Marijampolė county;2018;31;1400;831;569
Marijampolė county;2018;32;1251;673;578
Marijampolė county;2018;33;1218;692;526
Marijampolė county;2018;34;1285;750;535
Marijampolė county;2018;35;1308;709;599
Marijampolė county;2018;36;1379;720;659
Marijampolė county;2018;37;1327;700;627
Marijampolė county;2018;38;1475;774;701
Marijampolė county;2018;39;1517;793;724
Marijampolė county;2018;40;1587;787;800
Marijampolė county;2018;41;1620;803;817
Marijampolė county;2018;42;1670;845;825
Marijampolė county;2018;43;1749;884;865
Marijampolė county;2018;44;1908;929;979
Marijampolė county;2018;45;2001;1001;1000
Marijampolė county;2018;46;2138;1065;1073
Marijampolė county;2018;47;2191;1071;1120
Marijampolė county;2018;48;2146;1073;1073
Marijampolė county;2018;49;2137;1044;1093
Marijampolė county;2018;50;2171;1076;1095
Marijampolė county;2018;51;2196;1046;1150
Marijampolė county;2018;52;2168;1033;1135
Marijampolė county;2018;53;2355;1155;1200
Marijampolė county;2018;54;2316;1139;1177
Marijampolė county;2018;55;2317;1136;1181
Marijampolė county;2018;56;2471;1160;1311
Marijampolė county;2018;57;2439;1190;1249
Marijampolė county;2018;58;2323;1126;1197
Marijampolė county;2018;59;2255;1090;1165
Marijampolė county;2018;60;2045;973;1072
Marijampolė county;2018;61;1960;874;1086
Marijampolė county;2018;62;1920;813;1107
Marijampolė county;2018;63;1715;766;949
Marijampolė county;2018;64;1609;696;913
Marijampolė county;2018;65;1589;710;879
Marijampolė county;2018;66;1573;668;905
Marijampolė county;2018;67;1583;673;910
Marijampolė county;2018;68;1528;643;885
Marijampolė county;2018;69;1326;517;809
Marijampolė county;2018;70;1176;475;701
Marijampolė county;2018;71;1058;420;638
Marijampolė county;2018;72;1321;525;796
Marijampolė county;2018;73;996;329;667
Marijampolė county;2018;74;1282;417;865
Marijampolė county;2018;75;1433;464;969
Marijampolė county;2018;76;1385;460;925
Marijampolė county;2018;77;1222;393;829
Marijampolė county;2018;78;1087;343;744
Marijampolė county;2018;79;1123;343;780
Marijampolė county;2018;80;1034;327;707
Marijampolė county;2018;81;1039;307;732
Marijampolė county;2018;82;967;286;681
Marijampolė county;2018;83;823;252;571
Marijampolė county;2018;84;870;252;618
Marijampolė county;2018;85;4049;1010;3039
Marijampolė mun.;2001;-1;70910;33835;37075
Marijampolė mun.;2001;0;705;351;354
Marijampolė mun.;2001;1;811;427;384
Marijampolė mun.;2001;2;849;435;414
Marijampolė mun.;2001;3;865;460;405
Marijampolė mun.;2001;4;840;413;427
Marijampolė mun.;2001;5;903;466;437
Marijampolė mun.;2001;6;927;458;469
Marijampolė mun.;2001;7;971;502;469
Marijampolė mun.;2001;8;1145;590;555
Marijampolė mun.;2001;9;1172;604;568
Marijampolė mun.;2001;10;1214;612;602
Marijampolė mun.;2001;11;1150;582;568
Marijampolė mun.;2001;12;1205;609;596
Marijampolė mun.;2001;13;1222;626;596
Marijampolė mun.;2001;14;1294;674;620
Marijampolė mun.;2001;15;1213;610;603
Marijampolė mun.;2001;16;1195;617;578
Marijampolė mun.;2001;17;1226;655;571
Marijampolė mun.;2001;18;1007;496;511
Marijampolė mun.;2001;19;947;490;457
Marijampolė mun.;2001;20;957;490;467
Marijampolė mun.;2001;21;963;502;461
Marijampolė mun.;2001;22;938;469;469
Marijampolė mun.;2001;23;943;458;485
Marijampolė mun.;2001;24;910;470;440
Marijampolė mun.;2001;25;922;491;431
Marijampolė mun.;2001;26;975;495;480
Marijampolė mun.;2001;27;995;499;496
Marijampolė mun.;2001;28;1060;548;512
Marijampolė mun.;2001;29;1033;516;517
Marijampolė mun.;2001;30;1105;560;545
Marijampolė mun.;2001;31;1039;517;522
Marijampolė mun.;2001;32;1058;515;543
Marijampolė mun.;2001;33;1136;537;599
Marijampolė mun.;2001;34;1086;532;554
Marijampolė mun.;2001;35;1101;542;559
Marijampolė mun.;2001;36;1193;606;587
Marijampolė mun.;2001;37;1177;587;590
Marijampolė mun.;2001;38;1181;582;599
Marijampolė mun.;2001;39;1296;650;646
Marijampolė mun.;2001;40;1214;607;607
Marijampolė mun.;2001;41;1181;577;604
Marijampolė mun.;2001;42;1140;573;567
Marijampolė mun.;2001;43;998;492;506
Marijampolė mun.;2001;44;1008;469;539
Marijampolė mun.;2001;45;999;476;523
Marijampolė mun.;2001;46;872;438;434
Marijampolė mun.;2001;47;869;432;437
Marijampolė mun.;2001;48;817;404;413
Marijampolė mun.;2001;49;814;403;411
Marijampolė mun.;2001;50;805;385;420
Marijampolė mun.;2001;51;760;375;385
Marijampolė mun.;2001;52;640;314;326
Marijampolė mun.;2001;53;569;273;296
Marijampolė mun.;2001;54;558;256;302
Marijampolė mun.;2001;55;687;303;384
Marijampolė mun.;2001;56;546;245;301
Marijampolė mun.;2001;57;694;324;370
Marijampolė mun.;2001;58;761;347;414
Marijampolė mun.;2001;59;693;303;390
Marijampolė mun.;2001;60;633;273;360
Marijampolė mun.;2001;61;607;260;347
Marijampolė mun.;2001;62;646;270;376
Marijampolė mun.;2001;63;627;236;391
Marijampolė mun.;2001;64;683;299;384
Marijampolė mun.;2001;65;638;278;360
Marijampolė mun.;2001;66;572;249;323
Marijampolė mun.;2001;67;670;274;396
Marijampolė mun.;2001;68;672;235;437
Marijampolė mun.;2001;69;617;258;359
Marijampolė mun.;2001;70;642;259;383
Marijampolė mun.;2001;71;593;231;362
Marijampolė mun.;2001;72;620;230;390
Marijampolė mun.;2001;73;474;163;311
Marijampolė mun.;2001;74;425;154;271
Marijampolė mun.;2001;75;400;117;283
Marijampolė mun.;2001;76;351;105;246
Marijampolė mun.;2001;77;322;107;215
Marijampolė mun.;2001;78;342;101;241
Marijampolė mun.;2001;79;255;69;186
Marijampolė mun.;2001;80;210;66;144
Marijampolė mun.;2001;81;185;45;140
Marijampolė mun.;2001;82;180;55;125
Marijampolė mun.;2001;83;148;38;110
Marijampolė mun.;2001;84;129;35;94
Marijampolė mun.;2001;85;715;189;526
Marijampolė mun.;2002;-1;70275;33559;36716
Marijampolė mun.;2002;0;691;345;346
Marijampolė mun.;2002;1;695;347;348
Marijampolė mun.;2002;2;806;423;383
Marijampolė mun.;2002;3;846;434;412
Marijampolė mun.;2002;4;854;456;398
Marijampolė mun.;2002;5;833;410;423
Marijampolė mun.;2002;6;904;468;436
Marijampolė mun.;2002;7;921;458;463
Marijampolė mun.;2002;8;970;503;467
Marijampolė mun.;2002;9;1134;583;551
Marijampolė mun.;2002;10;1167;602;565
Marijampolė mun.;2002;11;1202;603;599
Marijampolė mun.;2002;12;1133;571;562
Marijampolė mun.;2002;13;1185;600;585
Marijampolė mun.;2002;14;1209;617;592
Marijampolė mun.;2002;15;1272;663;609
Marijampolė mun.;2002;16;1196;602;594
Marijampolė mun.;2002;17;1170;604;566
Marijampolė mun.;2002;18;1209;639;570
Marijampolė mun.;2002;19;987;483;504
Marijampolė mun.;2002;20;935;479;456
Marijampolė mun.;2002;21;923;473;450
Marijampolė mun.;2002;22;925;487;438
Marijampolė mun.;2002;23;916;457;459
Marijampolė mun.;2002;24;918;445;473
Marijampolė mun.;2002;25;893;462;431
Marijampolė mun.;2002;26;912;483;429
Marijampolė mun.;2002;27;957;482;475
Marijampolė mun.;2002;28;979;491;488
Marijampolė mun.;2002;29;1038;530;508
Marijampolė mun.;2002;30;1011;508;503
Marijampolė mun.;2002;31;1083;551;532
Marijampolė mun.;2002;32;1016;506;510
Marijampolė mun.;2002;33;1037;504;533
Marijampolė mun.;2002;34;1118;528;590
Marijampolė mun.;2002;35;1074;523;551
Marijampolė mun.;2002;36;1084;537;547
Marijampolė mun.;2002;37;1174;594;580
Marijampolė mun.;2002;38;1159;577;582
Marijampolė mun.;2002;39;1156;569;587
Marijampolė mun.;2002;40;1276;638;638
Marijampolė mun.;2002;41;1198;597;601
Marijampolė mun.;2002;42;1165;573;592
Marijampolė mun.;2002;43;1131;571;560
Marijampolė mun.;2002;44;986;485;501
Marijampolė mun.;2002;45;991;460;531
Marijampolė mun.;2002;46;973;463;510
Marijampolė mun.;2002;47;866;436;430
Marijampolė mun.;2002;48;851;425;426
Marijampolė mun.;2002;49;803;396;407
Marijampolė mun.;2002;50;803;393;410
Marijampolė mun.;2002;51;792;379;413
Marijampolė mun.;2002;52;758;376;382
Marijampolė mun.;2002;53;636;313;323
Marijampolė mun.;2002;54;558;269;289
Marijampolė mun.;2002;55;545;249;296
Marijampolė mun.;2002;56;673;298;375
Marijampolė mun.;2002;57;535;240;295
Marijampolė mun.;2002;58;688;326;362
Marijampolė mun.;2002;59;755;343;412
Marijampolė mun.;2002;60;680;296;384
Marijampolė mun.;2002;61;631;273;358
Marijampolė mun.;2002;62;608;262;346
Marijampolė mun.;2002;63;640;265;375
Marijampolė mun.;2002;64;621;235;386
Marijampolė mun.;2002;65;668;287;381
Marijampolė mun.;2002;66;622;271;351
Marijampolė mun.;2002;67;561;246;315
Marijampolė mun.;2002;68;661;269;392
Marijampolė mun.;2002;69;658;225;433
Marijampolė mun.;2002;70;605;248;357
Marijampolė mun.;2002;71;623;246;377
Marijampolė mun.;2002;72;581;226;355
Marijampolė mun.;2002;73;606;223;383
Marijampolė mun.;2002;74;455;152;303
Marijampolė mun.;2002;75;417;152;265
Marijampolė mun.;2002;76;381;111;270
Marijampolė mun.;2002;77;336;101;235
Marijampolė mun.;2002;78;313;101;212
Marijampolė mun.;2002;79;324;93;231
Marijampolė mun.;2002;80;241;68;173
Marijampolė mun.;2002;81;189;55;134
Marijampolė mun.;2002;82;169;43;126
Marijampolė mun.;2002;83;163;52;111
Marijampolė mun.;2002;84;137;35;102
Marijampolė mun.;2002;85;710;197;513
Marijampolė mun.;2003;-1;69789;33314;36475
Marijampolė mun.;2003;0;634;330;304
Marijampolė mun.;2003;1;685;341;344
Marijampolė mun.;2003;2;693;347;346
Marijampolė mun.;2003;3;801;421;380
Marijampolė mun.;2003;4;843;432;411
Marijampolė mun.;2003;5;859;461;398
Marijampolė mun.;2003;6;834;413;421
Marijampolė mun.;2003;7;903;471;432
Marijampolė mun.;2003;8;919;458;461
Marijampolė mun.;2003;9;976;503;473
Marijampolė mun.;2003;10;1128;579;549
Marijampolė mun.;2003;11;1163;603;560
Marijampolė mun.;2003;12;1184;596;588
Marijampolė mun.;2003;13;1117;562;555
Marijampolė mun.;2003;14;1170;590;580
Marijampolė mun.;2003;15;1192;607;585
Marijampolė mun.;2003;16;1248;648;600
Marijampolė mun.;2003;17;1174;589;585
Marijampolė mun.;2003;18;1156;595;561
Marijampolė mun.;2003;19;1190;630;560
Marijampolė mun.;2003;20;965;475;490
Marijampolė mun.;2003;21;916;473;443
Marijampolė mun.;2003;22;894;468;426
Marijampolė mun.;2003;23;912;487;425
Marijampolė mun.;2003;24;897;450;447
Marijampolė mun.;2003;25;913;441;472
Marijampolė mun.;2003;26;887;457;430
Marijampolė mun.;2003;27;903;475;428
Marijampolė mun.;2003;28;961;479;482
Marijampolė mun.;2003;29;966;486;480
Marijampolė mun.;2003;30;1028;529;499
Marijampolė mun.;2003;31;1007;509;498
Marijampolė mun.;2003;32;1066;540;526
Marijampolė mun.;2003;33;1008;502;506
Marijampolė mun.;2003;34;1030;500;530
Marijampolė mun.;2003;35;1101;522;579
Marijampolė mun.;2003;36;1066;521;545
Marijampolė mun.;2003;37;1066;527;539
Marijampolė mun.;2003;38;1162;588;574
Marijampolė mun.;2003;39;1147;570;577
Marijampolė mun.;2003;40;1146;567;579
Marijampolė mun.;2003;41;1260;626;634
Marijampolė mun.;2003;42;1179;582;597
Marijampolė mun.;2003;43;1143;557;586
Marijampolė mun.;2003;44;1124;569;555
Marijampolė mun.;2003;45;970;474;496
Marijampolė mun.;2003;46;977;453;524
Marijampolė mun.;2003;47;963;458;505
Marijampolė mun.;2003;48;853;429;424
Marijampolė mun.;2003;49;834;415;419
Marijampolė mun.;2003;50;795;393;402
Marijampolė mun.;2003;51;791;387;404
Marijampolė mun.;2003;52;785;373;412
Marijampolė mun.;2003;53;754;374;380
Marijampolė mun.;2003;54;627;307;320
Marijampolė mun.;2003;55;549;263;286
Marijampolė mun.;2003;56;534;245;289
Marijampolė mun.;2003;57;671;295;376
Marijampolė mun.;2003;58;525;233;292
Marijampolė mun.;2003;59;681;322;359
Marijampolė mun.;2003;60;737;332;405
Marijampolė mun.;2003;61;668;287;381
Marijampolė mun.;2003;62;632;272;360
Marijampolė mun.;2003;63;594;253;341
Marijampolė mun.;2003;64;637;262;375
Marijampolė mun.;2003;65;623;236;387
Marijampolė mun.;2003;66;654;277;377
Marijampolė mun.;2003;67;618;270;348
Marijampolė mun.;2003;68;546;234;312
Marijampolė mun.;2003;69;645;264;381
Marijampolė mun.;2003;70;649;221;428
Marijampolė mun.;2003;71;595;238;357
Marijampolė mun.;2003;72;605;232;373
Marijampolė mun.;2003;73;558;207;351
Marijampolė mun.;2003;74;582;209;373
Marijampolė mun.;2003;75;445;147;298
Marijampolė mun.;2003;76;397;140;257
Marijampolė mun.;2003;77;358;100;258
Marijampolė mun.;2003;78;316;91;225
Marijampolė mun.;2003;79;291;90;201
Marijampolė mun.;2003;80;304;84;220
Marijampolė mun.;2003;81;227;63;164
Marijampolė mun.;2003;82;168;45;123
Marijampolė mun.;2003;83;158;36;122
Marijampolė mun.;2003;84;151;46;105
Marijampolė mun.;2003;85;706;181;525
Marijampolė mun.;2004;-1;69088;32853;36235
Marijampolė mun.;2004;0;674;334;340
Marijampolė mun.;2004;1;639;332;307
Marijampolė mun.;2004;2;681;336;345
Marijampolė mun.;2004;3;693;344;349
Marijampolė mun.;2004;4;804;422;382
Marijampolė mun.;2004;5;837;427;410
Marijampolė mun.;2004;6;865;467;398
Marijampolė mun.;2004;7;833;410;423
Marijampolė mun.;2004;8;904;472;432
Marijampolė mun.;2004;9;916;456;460
Marijampolė mun.;2004;10;970;500;470
Marijampolė mun.;2004;11;1118;573;545
Marijampolė mun.;2004;12;1144;590;554
Marijampolė mun.;2004;13;1173;592;581
Marijampolė mun.;2004;14;1098;552;546
Marijampolė mun.;2004;15;1152;580;572
Marijampolė mun.;2004;16;1177;603;574
Marijampolė mun.;2004;17;1220;635;585
Marijampolė mun.;2004;18;1151;577;574
Marijampolė mun.;2004;19;1137;588;549
Marijampolė mun.;2004;20;1161;614;547
Marijampolė mun.;2004;21;936;456;480
Marijampolė mun.;2004;22;884;463;421
Marijampolė mun.;2004;23;878;463;415
Marijampolė mun.;2004;24;899;480;419
Marijampolė mun.;2004;25;864;434;430
Marijampolė mun.;2004;26;905;437;468
Marijampolė mun.;2004;27;868;444;424
Marijampolė mun.;2004;28;883;457;426
Marijampolė mun.;2004;29;950;466;484
Marijampolė mun.;2004;30;959;482;477
Marijampolė mun.;2004;31;1006;517;489
Marijampolė mun.;2004;32;984;494;490
Marijampolė mun.;2004;33;1050;525;525
Marijampolė mun.;2004;34;986;491;495
Marijampolė mun.;2004;35;1014;490;524
Marijampolė mun.;2004;36;1087;509;578
Marijampolė mun.;2004;37;1047;507;540
Marijampolė mun.;2004;38;1046;519;527
Marijampolė mun.;2004;39;1150;582;568
Marijampolė mun.;2004;40;1132;558;574
Marijampolė mun.;2004;41;1127;554;573
Marijampolė mun.;2004;42;1242;619;623
Marijampolė mun.;2004;43;1154;564;590
Marijampolė mun.;2004;44;1127;544;583
Marijampolė mun.;2004;45;1111;560;551
Marijampolė mun.;2004;46;958;465;493
Marijampolė mun.;2004;47;965;447;518
Marijampolė mun.;2004;48;949;448;501
Marijampolė mun.;2004;49;838;418;420
Marijampolė mun.;2004;50;825;409;416
Marijampolė mun.;2004;51;786;385;401
Marijampolė mun.;2004;52;771;375;396
Marijampolė mun.;2004;53;768;362;406
Marijampolė mun.;2004;54;743;369;374
Marijampolė mun.;2004;55;616;298;318
Marijampolė mun.;2004;56;541;259;282
Marijampolė mun.;2004;57;515;232;283
Marijampolė mun.;2004;58;657;289;368
Marijampolė mun.;2004;59;514;226;288
Marijampolė mun.;2004;60;667;317;350
Marijampolė mun.;2004;61;714;317;397
Marijampolė mun.;2004;62;657;278;379
Marijampolė mun.;2004;63;619;262;357
Marijampolė mun.;2004;64;580;245;335
Marijampolė mun.;2004;65;630;257;373
Marijampolė mun.;2004;66;610;226;384
Marijampolė mun.;2004;67;644;268;376
Marijampolė mun.;2004;68;596;252;344
Marijampolė mun.;2004;69;534;226;308
Marijampolė mun.;2004;70;630;250;380
Marijampolė mun.;2004;71;635;211;424
Marijampolė mun.;2004;72;568;221;347
Marijampolė mun.;2004;73;593;225;368
Marijampolė mun.;2004;74;533;191;342
Marijampolė mun.;2004;75;570;204;366
Marijampolė mun.;2004;76;420;132;288
Marijampolė mun.;2004;77;379;128;251
Marijampolė mun.;2004;78;338;93;245
Marijampolė mun.;2004;79;297;83;214
Marijampolė mun.;2004;80;271;79;192
Marijampolė mun.;2004;81;288;77;211
Marijampolė mun.;2004;82;217;58;159
Marijampolė mun.;2004;83;159;41;118
Marijampolė mun.;2004;84;134;29;105
Marijampolė mun.;2004;85;723;182;541
Marijampolė mun.;2005;-1;68023;32282;35741
Marijampolė mun.;2005;0;635;318;317
Marijampolė mun.;2005;1;657;323;334
Marijampolė mun.;2005;2;634;328;306
Marijampolė mun.;2005;3;672;331;341
Marijampolė mun.;2005;4;689;343;346
Marijampolė mun.;2005;5;795;414;381
Marijampolė mun.;2005;6;830;423;407
Marijampolė mun.;2005;7;850;456;394
Marijampolė mun.;2005;8;825;407;418
Marijampolė mun.;2005;9;896;466;430
Marijampolė mun.;2005;10;911;454;457
Marijampolė mun.;2005;11;965;496;469
Marijampolė mun.;2005;12;1110;570;540
Marijampolė mun.;2005;13;1136;586;550
Marijampolė mun.;2005;14;1155;583;572
Marijampolė mun.;2005;15;1081;542;539
Marijampolė mun.;2005;16;1134;567;567
Marijampolė mun.;2005;17;1148;586;562
Marijampolė mun.;2005;18;1201;621;580
Marijampolė mun.;2005;19;1123;563;560
Marijampolė mun.;2005;20;1107;570;537
Marijampolė mun.;2005;21;1109;584;525
Marijampolė mun.;2005;22;894;441;453
Marijampolė mun.;2005;23;852;456;396
Marijampolė mun.;2005;24;852;452;400
Marijampolė mun.;2005;25;836;462;374
Marijampolė mun.;2005;26;837;421;416
Marijampolė mun.;2005;27;881;423;458
Marijampolė mun.;2005;28;843;432;411
Marijampolė mun.;2005;29;876;455;421
Marijampolė mun.;2005;30;925;455;470
Marijampolė mun.;2005;31;939;469;470
Marijampolė mun.;2005;32;988;503;485
Marijampolė mun.;2005;33;963;481;482
Marijampolė mun.;2005;34;1029;517;512
Marijampolė mun.;2005;35;969;479;490
Marijampolė mun.;2005;36;996;477;519
Marijampolė mun.;2005;37;1063;493;570
Marijampolė mun.;2005;38;1021;493;528
Marijampolė mun.;2005;39;1032;516;516
Marijampolė mun.;2005;40;1127;570;557
Marijampolė mun.;2005;41;1115;545;570
Marijampolė mun.;2005;42;1102;538;564
Marijampolė mun.;2005;43;1222;609;613
Marijampolė mun.;2005;44;1137;553;584
Marijampolė mun.;2005;45;1108;532;576
Marijampolė mun.;2005;46;1090;551;539
Marijampolė mun.;2005;47;934;449;485
Marijampolė mun.;2005;48;954;445;509
Marijampolė mun.;2005;49;932;439;493
Marijampolė mun.;2005;50;825;412;413
Marijampolė mun.;2005;51;802;394;408
Marijampolė mun.;2005;52;775;377;398
Marijampolė mun.;2005;53;755;363;392
Marijampolė mun.;2005;54;759;356;403
Marijampolė mun.;2005;55;734;363;371
Marijampolė mun.;2005;56;601;292;309
Marijampolė mun.;2005;57;534;252;282
Marijampolė mun.;2005;58;507;227;280
Marijampolė mun.;2005;59;643;280;363
Marijampolė mun.;2005;60;501;218;283
Marijampolė mun.;2005;61;653;307;346
Marijampolė mun.;2005;62;702;311;391
Marijampolė mun.;2005;63;646;268;378
Marijampolė mun.;2005;64;607;253;354
Marijampolė mun.;2005;65;561;232;329
Marijampolė mun.;2005;66;609;243;366
Marijampolė mun.;2005;67;587;212;375
Marijampolė mun.;2005;68;626;253;373
Marijampolė mun.;2005;69;575;240;335
Marijampolė mun.;2005;70;529;224;305
Marijampolė mun.;2005;71;607;240;367
Marijampolė mun.;2005;72;612;199;413
Marijampolė mun.;2005;73;548;210;338
Marijampolė mun.;2005;74;570;216;354
Marijampolė mun.;2005;75;505;175;330
Marijampolė mun.;2005;76;542;183;359
Marijampolė mun.;2005;77;407;128;279
Marijampolė mun.;2005;78;357;116;241
Marijampolė mun.;2005;79;312;80;232
Marijampolė mun.;2005;80;285;80;205
Marijampolė mun.;2005;81;250;71;179
Marijampolė mun.;2005;82;269;70;199
Marijampolė mun.;2005;83;197;53;144
Marijampolė mun.;2005;84;136;34;102
Marijampolė mun.;2005;85;715;163;552
Marijampolė mun.;2006;-1;66757;31731;35026
Marijampolė mun.;2006;0;577;311;266
Marijampolė mun.;2006;1;623;311;312
Marijampolė mun.;2006;2;649;319;330
Marijampolė mun.;2006;3;617;320;297
Marijampolė mun.;2006;4;659;326;333
Marijampolė mun.;2006;5;675;338;337
Marijampolė mun.;2006;6;780;408;372
Marijampolė mun.;2006;7;823;420;403
Marijampolė mun.;2006;8;837;452;385
Marijampolė mun.;2006;9;815;406;409
Marijampolė mun.;2006;10;896;466;430
Marijampolė mun.;2006;11;902;450;452
Marijampolė mun.;2006;12;953;495;458
Marijampolė mun.;2006;13;1088;562;526
Marijampolė mun.;2006;14;1127;584;543
Marijampolė mun.;2006;15;1121;569;552
Marijampolė mun.;2006;16;1039;522;517
Marijampolė mun.;2006;17;1102;552;550
Marijampolė mun.;2006;18;1115;571;544
Marijampolė mun.;2006;19;1138;587;551
Marijampolė mun.;2006;20;1069;538;531
Marijampolė mun.;2006;21;1050;542;508
Marijampolė mun.;2006;22;1055;565;490
Marijampolė mun.;2006;23;852;423;429
Marijampolė mun.;2006;24;808;433;375
Marijampolė mun.;2006;25;799;419;380
Marijampolė mun.;2006;26;808;443;365
Marijampolė mun.;2006;27;807;402;405
Marijampolė mun.;2006;28;864;415;449
Marijampolė mun.;2006;29;829;427;402
Marijampolė mun.;2006;30;858;448;410
Marijampolė mun.;2006;31;911;452;459
Marijampolė mun.;2006;32;928;465;463
Marijampolė mun.;2006;33;962;487;475
Marijampolė mun.;2006;34;943;476;467
Marijampolė mun.;2006;35;1002;502;500
Marijampolė mun.;2006;36;940;464;476
Marijampolė mun.;2006;37;972;461;511
Marijampolė mun.;2006;38;1039;482;557
Marijampolė mun.;2006;39;996;481;515
Marijampolė mun.;2006;40;1011;502;509
Marijampolė mun.;2006;41;1106;558;548
Marijampolė mun.;2006;42;1092;536;556
Marijampolė mun.;2006;43;1084;531;553
Marijampolė mun.;2006;44;1200;595;605
Marijampolė mun.;2006;45;1125;554;571
Marijampolė mun.;2006;46;1091;526;565
Marijampolė mun.;2006;47;1057;531;526
Marijampolė mun.;2006;48;924;447;477
Marijampolė mun.;2006;49;934;437;497
Marijampolė mun.;2006;50;919;435;484
Marijampolė mun.;2006;51;817;408;409
Marijampolė mun.;2006;52;787;384;403
Marijampolė mun.;2006;53;755;365;390
Marijampolė mun.;2006;54;746;362;384
Marijampolė mun.;2006;55;741;345;396
Marijampolė mun.;2006;56;726;357;369
Marijampolė mun.;2006;57;586;281;305
Marijampolė mun.;2006;58;529;250;279
Marijampolė mun.;2006;59;502;228;274
Marijampolė mun.;2006;60;634;278;356
Marijampolė mun.;2006;61;493;213;280
Marijampolė mun.;2006;62;637;296;341
Marijampolė mun.;2006;63;693;307;386
Marijampolė mun.;2006;64;637;264;373
Marijampolė mun.;2006;65;594;245;349
Marijampolė mun.;2006;66;549;226;323
Marijampolė mun.;2006;67;590;232;358
Marijampolė mun.;2006;68;569;203;366
Marijampolė mun.;2006;69;609;244;365
Marijampolė mun.;2006;70;568;238;330
Marijampolė mun.;2006;71;506;205;301
Marijampolė mun.;2006;72;581;226;355
Marijampolė mun.;2006;73;588;185;403
Marijampolė mun.;2006;74;529;200;329
Marijampolė mun.;2006;75;556;211;345
Marijampolė mun.;2006;76;479;158;321
Marijampolė mun.;2006;77;517;172;345
Marijampolė mun.;2006;78;391;121;270
Marijampolė mun.;2006;79;332;103;229
Marijampolė mun.;2006;80;295;74;221
Marijampolė mun.;2006;81;272;75;197
Marijampolė mun.;2006;82;224;62;162
Marijampolė mun.;2006;83;243;61;182
Marijampolė mun.;2006;84;190;46;144
Marijampolė mun.;2006;85;721;160;561
Marijampolė mun.;2007;-1;65986;31341;34645
Marijampolė mun.;2007;0;618;322;296
Marijampolė mun.;2007;1;571;309;262
Marijampolė mun.;2007;2;602;302;300
Marijampolė mun.;2007;3;648;316;332
Marijampolė mun.;2007;4;616;320;296
Marijampolė mun.;2007;5;650;326;324
Marijampolė mun.;2007;6;678;340;338
Marijampolė mun.;2007;7;769;401;368
Marijampolė mun.;2007;8;820;419;401
Marijampolė mun.;2007;9;837;448;389
Marijampolė mun.;2007;10;804;396;408
Marijampolė mun.;2007;11;889;462;427
Marijampolė mun.;2007;12;899;450;449
Marijampolė mun.;2007;13;952;497;455
Marijampolė mun.;2007;14;1085;563;522
Marijampolė mun.;2007;15;1123;582;541
Marijampolė mun.;2007;16;1112;562;550
Marijampolė mun.;2007;17;1022;513;509
Marijampolė mun.;2007;18;1084;542;542
Marijampolė mun.;2007;19;1090;558;532
Marijampolė mun.;2007;20;1109;574;535
Marijampolė mun.;2007;21;1047;526;521
Marijampolė mun.;2007;22;1015;522;493
Marijampolė mun.;2007;23;1033;548;485
Marijampolė mun.;2007;24;834;411;423
Marijampolė mun.;2007;25;789;424;365
Marijampolė mun.;2007;26;777;407;370
Marijampolė mun.;2007;27;810;445;365
Marijampolė mun.;2007;28;791;396;395
Marijampolė mun.;2007;29;837;402;435
Marijampolė mun.;2007;30;822;424;398
Marijampolė mun.;2007;31;858;445;413
Marijampolė mun.;2007;32;902;449;453
Marijampolė mun.;2007;33;912;455;457
Marijampolė mun.;2007;34;945;472;473
Marijampolė mun.;2007;35;921;464;457
Marijampolė mun.;2007;36;986;493;493
Marijampolė mun.;2007;37;928;460;468
Marijampolė mun.;2007;38;948;445;503
Marijampolė mun.;2007;39;1022;474;548
Marijampolė mun.;2007;40;974;465;509
Marijampolė mun.;2007;41;993;491;502
Marijampolė mun.;2007;42;1092;545;547
Marijampolė mun.;2007;43;1071;524;547
Marijampolė mun.;2007;44;1064;519;545
Marijampolė mun.;2007;45;1179;582;597
Marijampolė mun.;2007;46;1108;542;566
Marijampolė mun.;2007;47;1073;516;557
Marijampolė mun.;2007;48;1040;521;519
Marijampolė mun.;2007;49;911;443;468
Marijampolė mun.;2007;50;918;426;492
Marijampolė mun.;2007;51;906;429;477
Marijampolė mun.;2007;52;803;399;404
Marijampolė mun.;2007;53;778;374;404
Marijampolė mun.;2007;54;743;357;386
Marijampolė mun.;2007;55;725;350;375
Marijampolė mun.;2007;56;731;340;391
Marijampolė mun.;2007;57;708;342;366
Marijampolė mun.;2007;58;581;278;303
Marijampolė mun.;2007;59;519;244;275
Marijampolė mun.;2007;60;490;220;270
Marijampolė mun.;2007;61;622;272;350
Marijampolė mun.;2007;62;488;211;277
Marijampolė mun.;2007;63;626;291;335
Marijampolė mun.;2007;64;684;302;382
Marijampolė mun.;2007;65;625;254;371
Marijampolė mun.;2007;66;585;237;348
Marijampolė mun.;2007;67;532;214;318
Marijampolė mun.;2007;68;580;226;354
Marijampolė mun.;2007;69;555;193;362
Marijampolė mun.;2007;70;589;236;353
Marijampolė mun.;2007;71;547;225;322
Marijampolė mun.;2007;72;494;201;293
Marijampolė mun.;2007;73;551;211;340
Marijampolė mun.;2007;74;564;167;397
Marijampolė mun.;2007;75;509;186;323
Marijampolė mun.;2007;76;534;196;338
Marijampolė mun.;2007;77;453;151;302
Marijampolė mun.;2007;78;494;166;328
Marijampolė mun.;2007;79;368;113;255
Marijampolė mun.;2007;80;311;98;213
Marijampolė mun.;2007;81;278;67;211
Marijampolė mun.;2007;82;255;67;188
Marijampolė mun.;2007;83;208;59;149
Marijampolė mun.;2007;84;210;53;157
Marijampolė mun.;2007;85;762;174;588
Marijampolė mun.;2008;-1;65110;30920;34190
Marijampolė mun.;2008;0;586;309;277
Marijampolė mun.;2008;1;608;316;292
Marijampolė mun.;2008;2;566;307;259
Marijampolė mun.;2008;3;598;297;301
Marijampolė mun.;2008;4;643;311;332
Marijampolė mun.;2008;5;615;323;292
Marijampolė mun.;2008;6;646;325;321
Marijampolė mun.;2008;7;674;338;336
Marijampolė mun.;2008;8;759;397;362
Marijampolė mun.;2008;9;808;414;394
Marijampolė mun.;2008;10;831;446;385
Marijampolė mun.;2008;11;796;391;405
Marijampolė mun.;2008;12;883;460;423
Marijampolė mun.;2008;13;896;447;449
Marijampolė mun.;2008;14;940;491;449
Marijampolė mun.;2008;15;1081;560;521
Marijampolė mun.;2008;16;1117;580;537
Marijampolė mun.;2008;17;1101;558;543
Marijampolė mun.;2008;18;997;500;497
Marijampolė mun.;2008;19;1062;530;532
Marijampolė mun.;2008;20;1072;549;523
Marijampolė mun.;2008;21;1083;557;526
Marijampolė mun.;2008;22;1021;516;505
Marijampolė mun.;2008;23;997;512;485
Marijampolė mun.;2008;24;1013;535;478
Marijampolė mun.;2008;25;814;403;411
Marijampolė mun.;2008;26;767;416;351
Marijampolė mun.;2008;27;757;395;362
Marijampolė mun.;2008;28;783;433;350
Marijampolė mun.;2008;29;786;393;393
Marijampolė mun.;2008;30;818;396;422
Marijampolė mun.;2008;31;806;417;389
Marijampolė mun.;2008;32;849;438;411
Marijampolė mun.;2008;33;887;442;445
Marijampolė mun.;2008;34;896;449;447
Marijampolė mun.;2008;35;925;460;465
Marijampolė mun.;2008;36;908;459;449
Marijampolė mun.;2008;37;979;491;488
Marijampolė mun.;2008;38;914;452;462
Marijampolė mun.;2008;39;931;435;496
Marijampolė mun.;2008;40;1005;464;541
Marijampolė mun.;2008;41;966;463;503
Marijampolė mun.;2008;42;971;475;496
Marijampolė mun.;2008;43;1077;539;538
Marijampolė mun.;2008;44;1047;511;536
Marijampolė mun.;2008;45;1046;507;539
Marijampolė mun.;2008;46;1162;574;588
Marijampolė mun.;2008;47;1087;525;562
Marijampolė mun.;2008;48;1064;513;551
Marijampolė mun.;2008;49;1031;516;515
Marijampolė mun.;2008;50;901;437;464
Marijampolė mun.;2008;51;906;419;487
Marijampolė mun.;2008;52;888;417;471
Marijampolė mun.;2008;53;785;387;398
Marijampolė mun.;2008;54;759;363;396
Marijampolė mun.;2008;55;723;345;378
Marijampolė mun.;2008;56;711;342;369
Marijampolė mun.;2008;57;711;330;381
Marijampolė mun.;2008;58;691;330;361
Marijampolė mun.;2008;59;567;267;300
Marijampolė mun.;2008;60;505;235;270
Marijampolė mun.;2008;61;477;210;267
Marijampolė mun.;2008;62;605;261;344
Marijampolė mun.;2008;63;478;204;274
Marijampolė mun.;2008;64;608;279;329
Marijampolė mun.;2008;65;660;282;378
Marijampolė mun.;2008;66;610;244;366
Marijampolė mun.;2008;67;567;227;340
Marijampolė mun.;2008;68;523;211;312
Marijampolė mun.;2008;69;566;221;345
Marijampolė mun.;2008;70;537;186;351
Marijampolė mun.;2008;71;573;224;349
Marijampolė mun.;2008;72;529;216;313
Marijampolė mun.;2008;73;476;191;285
Marijampolė mun.;2008;74;523;197;326
Marijampolė mun.;2008;75;535;150;385
Marijampolė mun.;2008;76;479;172;307
Marijampolė mun.;2008;77;511;187;324
Marijampolė mun.;2008;78;418;136;282
Marijampolė mun.;2008;79;467;150;317
Marijampolė mun.;2008;80;340;104;236
Marijampolė mun.;2008;81;296;88;208
Marijampolė mun.;2008;82;255;61;194
Marijampolė mun.;2008;83;242;65;177
Marijampolė mun.;2008;84;187;55;132
Marijampolė mun.;2008;85;832;192;640
Marijampolė mun.;2009;-1;64496;30664;33832
Marijampolė mun.;2009;0;628;331;297
Marijampolė mun.;2009;1;577;303;274
Marijampolė mun.;2009;2;598;313;285
Marijampolė mun.;2009;3;565;307;258
Marijampolė mun.;2009;4;597;296;301
Marijampolė mun.;2009;5;636;310;326
Marijampolė mun.;2009;6;620;326;294
Marijampolė mun.;2009;7;642;325;317
Marijampolė mun.;2009;8;662;336;326
Marijampolė mun.;2009;9;758;394;364
Marijampolė mun.;2009;10;808;413;395
Marijampolė mun.;2009;11;830;448;382
Marijampolė mun.;2009;12;793;389;404
Marijampolė mun.;2009;13;885;465;420
Marijampolė mun.;2009;14;896;452;444
Marijampolė mun.;2009;15;941;492;449
Marijampolė mun.;2009;16;1075;556;519
Marijampolė mun.;2009;17;1113;575;538
Marijampolė mun.;2009;18;1093;550;543
Marijampolė mun.;2009;19;985;493;492
Marijampolė mun.;2009;20;1052;525;527
Marijampolė mun.;2009;21;1060;540;520
Marijampolė mun.;2009;22;1056;542;514
Marijampolė mun.;2009;23;988;503;485
Marijampolė mun.;2009;24;974;499;475
Marijampolė mun.;2009;25;985;528;457
Marijampolė mun.;2009;26;781;393;388
Marijampolė mun.;2009;27;736;398;338
Marijampolė mun.;2009;28;745;386;359
Marijampolė mun.;2009;29;759;420;339
Marijampolė mun.;2009;30;771;383;388
Marijampolė mun.;2009;31;811;398;413
Marijampolė mun.;2009;32;791;412;379
Marijampolė mun.;2009;33;844;434;410
Marijampolė mun.;2009;34;879;440;439
Marijampolė mun.;2009;35;877;439;438
Marijampolė mun.;2009;36;901;450;451
Marijampolė mun.;2009;37;896;453;443
Marijampolė mun.;2009;38;972;487;485
Marijampolė mun.;2009;39;901;447;454
Marijampolė mun.;2009;40;921;433;488
Marijampolė mun.;2009;41;993;459;534
Marijampolė mun.;2009;42;949;454;495
Marijampolė mun.;2009;43;967;474;493
Marijampolė mun.;2009;44;1064;529;535
Marijampolė mun.;2009;45;1038;506;532
Marijampolė mun.;2009;46;1036;499;537
Marijampolė mun.;2009;47;1152;565;587
Marijampolė mun.;2009;48;1064;510;554
Marijampolė mun.;2009;49;1053;508;545
Marijampolė mun.;2009;50;1010;504;506
Marijampolė mun.;2009;51;890;432;458
Marijampolė mun.;2009;52;894;411;483
Marijampolė mun.;2009;53;871;411;460
Marijampolė mun.;2009;54;772;383;389
Marijampolė mun.;2009;55;743;351;392
Marijampolė mun.;2009;56;715;344;371
Marijampolė mun.;2009;57;694;331;363
Marijampolė mun.;2009;58;700;324;376
Marijampolė mun.;2009;59;679;322;357
Marijampolė mun.;2009;60;558;261;297
Marijampolė mun.;2009;61;497;228;269
Marijampolė mun.;2009;62;466;204;262
Marijampolė mun.;2009;63;587;249;338
Marijampolė mun.;2009;64;471;200;271
Marijampolė mun.;2009;65;587;265;322
Marijampolė mun.;2009;66;650;274;376
Marijampolė mun.;2009;67;595;237;358
Marijampolė mun.;2009;68;555;222;333
Marijampolė mun.;2009;69;510;204;306
Marijampolė mun.;2009;70;550;211;339
Marijampolė mun.;2009;71;523;184;339
Marijampolė mun.;2009;72;555;215;340
Marijampolė mun.;2009;73;522;209;313
Marijampolė mun.;2009;74;459;180;279
Marijampolė mun.;2009;75;501;188;313
Marijampolė mun.;2009;76;515;145;370
Marijampolė mun.;2009;77;459;164;295
Marijampolė mun.;2009;78;484;174;310
Marijampolė mun.;2009;79;394;121;273
Marijampolė mun.;2009;80;433;137;296
Marijampolė mun.;2009;81;325;97;228
Marijampolė mun.;2009;82;274;82;192
Marijampolė mun.;2009;83;243;56;187
Marijampolė mun.;2009;84;218;54;164
Marijampolė mun.;2009;85;879;202;677
Marijampolė mun.;2010;-1;63492;30161;33331
Marijampolė mun.;2010;0;639;341;298
Marijampolė mun.;2010;1;619;330;289
Marijampolė mun.;2010;2;567;295;272
Marijampolė mun.;2010;3;583;306;277
Marijampolė mun.;2010;4;559;304;255
Marijampolė mun.;2010;5;590;294;296
Marijampolė mun.;2010;6;625;305;320
Marijampolė mun.;2010;7;617;323;294
Marijampolė mun.;2010;8;639;323;316
Marijampolė mun.;2010;9;655;337;318
Marijampolė mun.;2010;10;753;389;364
Marijampolė mun.;2010;11;800;411;389
Marijampolė mun.;2010;12;828;445;383
Marijampolė mun.;2010;13;790;386;404
Marijampolė mun.;2010;14;887;465;422
Marijampolė mun.;2010;15;886;447;439
Marijampolė mun.;2010;16;931;487;444
Marijampolė mun.;2010;17;1067;551;516
Marijampolė mun.;2010;18;1105;572;533
Marijampolė mun.;2010;19;1071;543;528
Marijampolė mun.;2010;20;963;483;480
Marijampolė mun.;2010;21;1028;516;512
Marijampolė mun.;2010;22;1027;521;506
Marijampolė mun.;2010;23;1018;519;499
Marijampolė mun.;2010;24;951;487;464
Marijampolė mun.;2010;25;933;479;454
Marijampolė mun.;2010;26;941;503;438
Marijampolė mun.;2010;27;739;372;367
Marijampolė mun.;2010;28;707;383;324
Marijampolė mun.;2010;29;722;377;345
Marijampolė mun.;2010;30;748;412;336
Marijampolė mun.;2010;31;753;371;382
Marijampolė mun.;2010;32;783;384;399
Marijampolė mun.;2010;33;774;406;368
Marijampolė mun.;2010;34;830;421;409
Marijampolė mun.;2010;35;854;428;426
Marijampolė mun.;2010;36;856;423;433
Marijampolė mun.;2010;37;882;436;446
Marijampolė mun.;2010;38;877;441;436
Marijampolė mun.;2010;39;948;469;479
Marijampolė mun.;2010;40;875;431;444
Marijampolė mun.;2010;41;904;421;483
Marijampolė mun.;2010;42;972;447;525
Marijampolė mun.;2010;43;933;446;487
Marijampolė mun.;2010;44;947;463;484
Marijampolė mun.;2010;45;1044;516;528
Marijampolė mun.;2010;46;1022;496;526
Marijampolė mun.;2010;47;1021;490;531
Marijampolė mun.;2010;48;1129;549;580
Marijampolė mun.;2010;49;1050;502;548
Marijampolė mun.;2010;50;1033;496;537
Marijampolė mun.;2010;51;993;495;498
Marijampolė mun.;2010;52;872;419;453
Marijampolė mun.;2010;53;870;400;470
Marijampolė mun.;2010;54;858;400;458
Marijampolė mun.;2010;55;751;369;382
Marijampolė mun.;2010;56;725;344;381
Marijampolė mun.;2010;57;698;333;365
Marijampolė mun.;2010;58;685;325;360
Marijampolė mun.;2010;59;689;322;367
Marijampolė mun.;2010;60;675;316;359
Marijampolė mun.;2010;61;548;255;293
Marijampolė mun.;2010;62;489;221;268
Marijampolė mun.;2010;63;452;194;258
Marijampolė mun.;2010;64;577;243;334
Marijampolė mun.;2010;65;455;191;264
Marijampolė mun.;2010;66;570;252;318
Marijampolė mun.;2010;67;627;262;365
Marijampolė mun.;2010;68;588;230;358
Marijampolė mun.;2010;69;540;214;326
Marijampolė mun.;2010;70;496;197;299
Marijampolė mun.;2010;71;537;211;326
Marijampolė mun.;2010;72;508;175;333
Marijampolė mun.;2010;73;540;208;332
Marijampolė mun.;2010;74;505;202;303
Marijampolė mun.;2010;75;444;174;270
Marijampolė mun.;2010;76;483;175;308
Marijampolė mun.;2010;77;494;135;359
Marijampolė mun.;2010;78;435;156;279
Marijampolė mun.;2010;79;455;159;296
Marijampolė mun.;2010;80;366;107;259
Marijampolė mun.;2010;81;412;127;285
Marijampolė mun.;2010;82;298;86;212
Marijampolė mun.;2010;83;251;72;179
Marijampolė mun.;2010;84;221;49;172
Marijampolė mun.;2010;85;910;201;709
Marijampolė mun.;2011;-1;61527;29223;32304
Marijampolė mun.;2011;0;584;304;280
Marijampolė mun.;2011;1;611;328;283
Marijampolė mun.;2011;2;590;309;281
Marijampolė mun.;2011;3;565;292;273
Marijampolė mun.;2011;4;577;308;269
Marijampolė mun.;2011;5;520;285;235
Marijampolė mun.;2011;6;571;289;282
Marijampolė mun.;2011;7;611;299;312
Marijampolė mun.;2011;8;615;324;291
Marijampolė mun.;2011;9;626;324;302
Marijampolė mun.;2011;10;626;317;309
Marijampolė mun.;2011;11;723;379;344
Marijampolė mun.;2011;12;772;409;363
Marijampolė mun.;2011;13;797;412;385
Marijampolė mun.;2011;14;776;365;411
Marijampolė mun.;2011;15;876;453;423
Marijampolė mun.;2011;16;871;448;423
Marijampolė mun.;2011;17;921;469;452
Marijampolė mun.;2011;18;1073;556;517
Marijampolė mun.;2011;19;948;495;453
Marijampolė mun.;2011;20;918;471;447
Marijampolė mun.;2011;21;826;423;403
Marijampolė mun.;2011;22;875;471;404
Marijampolė mun.;2011;23;852;439;413
Marijampolė mun.;2011;24;886;468;418
Marijampolė mun.;2011;25;777;418;359
Marijampolė mun.;2011;26;783;425;358
Marijampolė mun.;2011;27;797;448;349
Marijampolė mun.;2011;28;777;417;360
Marijampolė mun.;2011;29;743;402;341
Marijampolė mun.;2011;30;728;388;340
Marijampolė mun.;2011;31;779;442;337
Marijampolė mun.;2011;32;713;355;358
Marijampolė mun.;2011;33;764;374;390
Marijampolė mun.;2011;34;764;392;372
Marijampolė mun.;2011;35;760;400;360
Marijampolė mun.;2011;36;776;389;387
Marijampolė mun.;2011;37;815;394;421
Marijampolė mun.;2011;38;845;419;426
Marijampolė mun.;2011;39;824;401;423
Marijampolė mun.;2011;40;971;491;480
Marijampolė mun.;2011;41;884;448;436
Marijampolė mun.;2011;42;919;453;466
Marijampolė mun.;2011;43;964;448;516
Marijampolė mun.;2011;44;930;448;482
Marijampolė mun.;2011;45;921;435;486
Marijampolė mun.;2011;46;1021;501;520
Marijampolė mun.;2011;47;1023;499;524
Marijampolė mun.;2011;48;986;465;521
Marijampolė mun.;2011;49;1080;510;570
Marijampolė mun.;2011;50;1047;506;541
Marijampolė mun.;2011;51;1009;487;522
Marijampolė mun.;2011;52;968;491;477
Marijampolė mun.;2011;53;874;418;456
Marijampolė mun.;2011;54;860;393;467
Marijampolė mun.;2011;55;854;387;467
Marijampolė mun.;2011;56;754;351;403
Marijampolė mun.;2011;57;703;313;390
Marijampolė mun.;2011;58;704;332;372
Marijampolė mun.;2011;59;673;305;368
Marijampolė mun.;2011;60;687;319;368
Marijampolė mun.;2011;61;669;309;360
Marijampolė mun.;2011;62;533;247;286
Marijampolė mun.;2011;63;496;226;270
Marijampolė mun.;2011;64;447;189;258
Marijampolė mun.;2011;65;583;245;338
Marijampolė mun.;2011;66;453;182;271
Marijampolė mun.;2011;67;564;237;327
Marijampolė mun.;2011;68;622;251;371
Marijampolė mun.;2011;69;574;212;362
Marijampolė mun.;2011;70;528;190;338
Marijampolė mun.;2011;71;489;187;302
Marijampolė mun.;2011;72;516;193;323
Marijampolė mun.;2011;73;509;176;333
Marijampolė mun.;2011;74;527;196;331
Marijampolė mun.;2011;75;492;192;300
Marijampolė mun.;2011;76;417;156;261
Marijampolė mun.;2011;77;473;164;309
Marijampolė mun.;2011;78;485;127;358
Marijampolė mun.;2011;79;410;144;266
Marijampolė mun.;2011;80;428;141;287
Marijampolė mun.;2011;81;363;105;258
Marijampolė mun.;2011;82;367;108;259
Marijampolė mun.;2011;83;272;69;203
Marijampolė mun.;2011;84;236;63;173
Marijampolė mun.;2011;85;987;213;774
Marijampolė mun.;2012;-1;60459;28770;31689
Marijampolė mun.;2012;0;576;308;268
Marijampolė mun.;2012;1;582;304;278
Marijampolė mun.;2012;2;603;325;278
Marijampolė mun.;2012;3;574;298;276
Marijampolė mun.;2012;4;546;282;264
Marijampolė mun.;2012;5;563;301;262
Marijampolė mun.;2012;6;511;274;237
Marijampolė mun.;2012;7;561;288;273
Marijampolė mun.;2012;8;607;303;304
Marijampolė mun.;2012;9;616;326;290
Marijampolė mun.;2012;10;631;328;303
Marijampolė mun.;2012;11;614;307;307
Marijampolė mun.;2012;12;714;378;336
Marijampolė mun.;2012;13;763;407;356
Marijampolė mun.;2012;14;790;408;382
Marijampolė mun.;2012;15;773;364;409
Marijampolė mun.;2012;16;865;447;418
Marijampolė mun.;2012;17;861;440;421
Marijampolė mun.;2012;18;906;458;448
Marijampolė mun.;2012;19;1020;537;483
Marijampolė mun.;2012;20;926;484;442
Marijampolė mun.;2012;21;893;459;434
Marijampolė mun.;2012;22;805;413;392
Marijampolė mun.;2012;23;825;456;369
Marijampolė mun.;2012;24;795;417;378
Marijampolė mun.;2012;25;841;442;399
Marijampolė mun.;2012;26;735;408;327
Marijampolė mun.;2012;27;738;399;339
Marijampolė mun.;2012;28;739;410;329
Marijampolė mun.;2012;29;749;399;350
Marijampolė mun.;2012;30;719;397;322
Marijampolė mun.;2012;31;709;378;331
Marijampolė mun.;2012;32;761;434;327
Marijampolė mun.;2012;33;690;347;343
Marijampolė mun.;2012;34;747;369;378
Marijampolė mun.;2012;35;750;389;361
Marijampolė mun.;2012;36;752;397;355
Marijampolė mun.;2012;37;763;380;383
Marijampolė mun.;2012;38;806;393;413
Marijampolė mun.;2012;39;826;405;421
Marijampolė mun.;2012;40;815;399;416
Marijampolė mun.;2012;41;962;488;474
Marijampolė mun.;2012;42;876;448;428
Marijampolė mun.;2012;43;907;447;460
Marijampolė mun.;2012;44;943;442;501
Marijampolė mun.;2012;45;918;440;478
Marijampolė mun.;2012;46;913;435;478
Marijampolė mun.;2012;47;996;491;505
Marijampolė mun.;2012;48;1016;492;524
Marijampolė mun.;2012;49;967;452;515
Marijampolė mun.;2012;50;1060;498;562
Marijampolė mun.;2012;51;1037;500;537
Marijampolė mun.;2012;52;993;483;510
Marijampolė mun.;2012;53;951;479;472
Marijampolė mun.;2012;54;868;414;454
Marijampolė mun.;2012;55;854;390;464
Marijampolė mun.;2012;56;832;375;457
Marijampolė mun.;2012;57;733;334;399
Marijampolė mun.;2012;58;693;304;389
Marijampolė mun.;2012;59;695;326;369
Marijampolė mun.;2012;60;662;296;366
Marijampolė mun.;2012;61;667;306;361
Marijampolė mun.;2012;62;657;304;353
Marijampolė mun.;2012;63;525;241;284
Marijampolė mun.;2012;64;491;220;271
Marijampolė mun.;2012;65;442;186;256
Marijampolė mun.;2012;66;574;242;332
Marijampolė mun.;2012;67;440;173;267
Marijampolė mun.;2012;68;549;226;323
Marijampolė mun.;2012;69;599;234;365
Marijampolė mun.;2012;70;562;201;361
Marijampolė mun.;2012;71;508;182;326
Marijampolė mun.;2012;72;473;181;292
Marijampolė mun.;2012;73;497;185;312
Marijampolė mun.;2012;74;498;168;330
Marijampolė mun.;2012;75;507;185;322
Marijampolė mun.;2012;76;465;175;290
Marijampolė mun.;2012;77;408;150;258
Marijampolė mun.;2012;78;456;154;302
Marijampolė mun.;2012;79;452;117;335
Marijampolė mun.;2012;80;390;136;254
Marijampolė mun.;2012;81;398;127;271
Marijampolė mun.;2012;82;334;93;241
Marijampolė mun.;2012;83;334;97;237
Marijampolė mun.;2012;84;243;60;183
Marijampolė mun.;2012;85;1054;235;819
Marijampolė mun.;2013;-1;59483;28242;31241
Marijampolė mun.;2013;0;593;304;289
Marijampolė mun.;2013;1;576;306;270
Marijampolė mun.;2013;2;577;305;272
Marijampolė mun.;2013;3;594;320;274
Marijampolė mun.;2013;4;559;291;268
Marijampolė mun.;2013;5;533;276;257
Marijampolė mun.;2013;6;565;308;257
Marijampolė mun.;2013;7;508;272;236
Marijampolė mun.;2013;8;548;284;264
Marijampolė mun.;2013;9;610;306;304
Marijampolė mun.;2013;10;604;319;285
Marijampolė mun.;2013;11;614;322;292
Marijampolė mun.;2013;12;600;300;300
Marijampolė mun.;2013;13;704;376;328
Marijampolė mun.;2013;14;759;404;355
Marijampolė mun.;2013;15;777;399;378
Marijampolė mun.;2013;16;769;362;407
Marijampolė mun.;2013;17;852;441;411
Marijampolė mun.;2013;18;846;434;412
Marijampolė mun.;2013;19;885;451;434
Marijampolė mun.;2013;20;1003;519;484
Marijampolė mun.;2013;21;917;478;439
Marijampolė mun.;2013;22;864;441;423
Marijampolė mun.;2013;23;781;399;382
Marijampolė mun.;2013;24;803;438;365
Marijampolė mun.;2013;25;762;399;363
Marijampolė mun.;2013;26;815;440;375
Marijampolė mun.;2013;27;690;386;304
Marijampolė mun.;2013;28;712;380;332
Marijampolė mun.;2013;29;716;398;318
Marijampolė mun.;2013;30;712;382;330
Marijampolė mun.;2013;31;688;383;305
Marijampolė mun.;2013;32;694;366;328
Marijampolė mun.;2013;33;749;427;322
Marijampolė mun.;2013;34;673;338;335
Marijampolė mun.;2013;35;725;358;367
Marijampolė mun.;2013;36;713;364;349
Marijampolė mun.;2013;37;743;393;350
Marijampolė mun.;2013;38;744;366;378
Marijampolė mun.;2013;39;792;389;403
Marijampolė mun.;2013;40;815;399;416
Marijampolė mun.;2013;41;796;389;407
Marijampolė mun.;2013;42;942;471;471
Marijampolė mun.;2013;43;862;441;421
Marijampolė mun.;2013;44;895;440;455
Marijampolė mun.;2013;45;919;432;487
Marijampolė mun.;2013;46;908;430;478
Marijampolė mun.;2013;47;903;431;472
Marijampolė mun.;2013;48;982;480;502
Marijampolė mun.;2013;49;996;477;519
Marijampolė mun.;2013;50;943;438;505
Marijampolė mun.;2013;51;1038;482;556
Marijampolė mun.;2013;52;1033;496;537
Marijampolė mun.;2013;53;971;470;501
Marijampolė mun.;2013;54;935;467;468
Marijampolė mun.;2013;55;849;403;446
Marijampolė mun.;2013;56;842;384;458
Marijampolė mun.;2013;57;821;368;453
Marijampolė mun.;2013;58;729;331;398
Marijampolė mun.;2013;59;682;295;387
Marijampolė mun.;2013;60;682;313;369
Marijampolė mun.;2013;61;641;283;358
Marijampolė mun.;2013;62;658;301;357
Marijampolė mun.;2013;63;641;295;346
Marijampolė mun.;2013;64;511;232;279
Marijampolė mun.;2013;65;483;215;268
Marijampolė mun.;2013;66;429;174;255
Marijampolė mun.;2013;67;554;227;327
Marijampolė mun.;2013;68;434;163;271
Marijampolė mun.;2013;69;533;215;318
Marijampolė mun.;2013;70;582;229;353
Marijampolė mun.;2013;71;543;186;357
Marijampolė mun.;2013;72;499;177;322
Marijampolė mun.;2013;73;464;177;287
Marijampolė mun.;2013;74;483;176;307
Marijampolė mun.;2013;75;478;161;317
Marijampolė mun.;2013;76;484;172;312
Marijampolė mun.;2013;77;443;164;279
Marijampolė mun.;2013;78;388;139;249
Marijampolė mun.;2013;79;424;134;290
Marijampolė mun.;2013;80;433;107;326
Marijampolė mun.;2013;81;369;125;244
Marijampolė mun.;2013;82;377;115;262
Marijampolė mun.;2013;83;309;85;224
Marijampolė mun.;2013;84;303;89;214
Marijampolė mun.;2013;85;1108;240;868
Marijampolė mun.;2014;-1;58695;27823;30872
Marijampolė mun.;2014;0;588;293;295
Marijampolė mun.;2014;1;593;304;289
Marijampolė mun.;2014;2;573;300;273
Marijampolė mun.;2014;3;575;301;274
Marijampolė mun.;2014;4;574;309;265
Marijampolė mun.;2014;5;551;292;259
Marijampolė mun.;2014;6;525;271;254
Marijampolė mun.;2014;7;556;304;252
Marijampolė mun.;2014;8;504;273;231
Marijampolė mun.;2014;9;538;278;260
Marijampolė mun.;2014;10;603;300;303
Marijampolė mun.;2014;11;595;311;284
Marijampolė mun.;2014;12;616;325;291
Marijampolė mun.;2014;13;596;296;300
Marijampolė mun.;2014;14;701;375;326
Marijampolė mun.;2014;15;752;398;354
Marijampolė mun.;2014;16;771;397;374
Marijampolė mun.;2014;17;767;357;410
Marijampolė mun.;2014;18;836;431;405
Marijampolė mun.;2014;19;814;413;401
Marijampolė mun.;2014;20;868;436;432
Marijampolė mun.;2014;21;975;505;470
Marijampolė mun.;2014;22;886;458;428
Marijampolė mun.;2014;23;849;434;415
Marijampolė mun.;2014;24;766;390;376
Marijampolė mun.;2014;25;785;424;361
Marijampolė mun.;2014;26;745;391;354
Marijampolė mun.;2014;27;782;433;349
Marijampolė mun.;2014;28;661;372;289
Marijampolė mun.;2014;29;696;379;317
Marijampolė mun.;2014;30;698;396;302
Marijampolė mun.;2014;31;694;379;315
Marijampolė mun.;2014;32;661;370;291
Marijampolė mun.;2014;33;672;357;315
Marijampolė mun.;2014;34;733;417;316
Marijampolė mun.;2014;35;655;326;329
Marijampolė mun.;2014;36;707;347;360
Marijampolė mun.;2014;37;706;360;346
Marijampolė mun.;2014;38;736;389;347
Marijampolė mun.;2014;39;741;365;376
Marijampolė mun.;2014;40;784;384;400
Marijampolė mun.;2014;41;804;394;410
Marijampolė mun.;2014;42;788;384;404
Marijampolė mun.;2014;43;927;462;465
Marijampolė mun.;2014;44;860;438;422
Marijampolė mun.;2014;45;879;429;450
Marijampolė mun.;2014;46;911;426;485
Marijampolė mun.;2014;47;899;425;474
Marijampolė mun.;2014;48;893;422;471
Marijampolė mun.;2014;49;973;477;496
Marijampolė mun.;2014;50;986;470;516
Marijampolė mun.;2014;51;935;432;503
Marijampolė mun.;2014;52;1036;481;555
Marijampolė mun.;2014;53;1020;491;529
Marijampolė mun.;2014;54;962;461;501
Marijampolė mun.;2014;55;917;458;459
Marijampolė mun.;2014;56;839;395;444
Marijampolė mun.;2014;57;830;377;453
Marijampolė mun.;2014;58;810;362;448
Marijampolė mun.;2014;59;724;324;400
Marijampolė mun.;2014;60;668;285;383
Marijampolė mun.;2014;61;671;303;368
Marijampolė mun.;2014;62;629;277;352
Marijampolė mun.;2014;63;641;292;349
Marijampolė mun.;2014;64;626;285;341
Marijampolė mun.;2014;65;506;227;279
Marijampolė mun.;2014;66;468;206;262
Marijampolė mun.;2014;67;421;168;253
Marijampolė mun.;2014;68;537;212;325
Marijampolė mun.;2014;69;422;151;271
Marijampolė mun.;2014;70;525;209;316
Marijampolė mun.;2014;71;566;221;345
Marijampolė mun.;2014;72;527;171;356
Marijampolė mun.;2014;73;475;162;313
Marijampolė mun.;2014;74;451;168;283
Marijampolė mun.;2014;75;477;169;308
Marijampolė mun.;2014;76;468;155;313
Marijampolė mun.;2014;77;472;169;303
Marijampolė mun.;2014;78;420;152;268
Marijampolė mun.;2014;79;358;130;228
Marijampolė mun.;2014;80;394;122;272
Marijampolė mun.;2014;81;403;95;308
Marijampolė mun.;2014;82;332;109;223
Marijampolė mun.;2014;83;335;98;237
Marijampolė mun.;2014;84;278;68;210
Marijampolė mun.;2014;85;1204;271;933
Marijampolė mun.;2015;-1;58027;27533;30494
Marijampolė mun.;2015;0;603;313;290
Marijampolė mun.;2015;1;591;296;295
Marijampolė mun.;2015;2;599;307;292
Marijampolė mun.;2015;3;564;294;270
Marijampolė mun.;2015;4;578;302;276
Marijampolė mun.;2015;5;574;306;268
Marijampolė mun.;2015;6;546;295;251
Marijampolė mun.;2015;7;521;268;253
Marijampolė mun.;2015;8;553;303;250
Marijampolė mun.;2015;9;498;269;229
Marijampolė mun.;2015;10;536;277;259
Marijampolė mun.;2015;11;590;291;299
Marijampolė mun.;2015;12;591;308;283
Marijampolė mun.;2015;13;615;325;290
Marijampolė mun.;2015;14;592;295;297
Marijampolė mun.;2015;15;694;373;321
Marijampolė mun.;2015;16;746;396;350
Marijampolė mun.;2015;17;761;389;372
Marijampolė mun.;2015;18;750;350;400
Marijampolė mun.;2015;19;814;417;397
Marijampolė mun.;2015;20;802;410;392
Marijampolė mun.;2015;21;864;432;432
Marijampolė mun.;2015;22;957;502;455
Marijampolė mun.;2015;23;859;448;411
Marijampolė mun.;2015;24;834;420;414
Marijampolė mun.;2015;25;741;375;366
Marijampolė mun.;2015;26;754;411;343
Marijampolė mun.;2015;27;713;385;328
Marijampolė mun.;2015;28;762;429;333
Marijampolė mun.;2015;29;637;368;269
Marijampolė mun.;2015;30;678;363;315
Marijampolė mun.;2015;31;686;392;294
Marijampolė mun.;2015;32;690;379;311
Marijampolė mun.;2015;33;652;371;281
Marijampolė mun.;2015;34;666;354;312
Marijampolė mun.;2015;35;731;419;312
Marijampolė mun.;2015;36;641;324;317
Marijampolė mun.;2015;37;693;341;352
Marijampolė mun.;2015;38;703;359;344
Marijampolė mun.;2015;39;726;385;341
Marijampolė mun.;2015;40;733;357;376
Marijampolė mun.;2015;41;772;374;398
Marijampolė mun.;2015;42;790;391;399
Marijampolė mun.;2015;43;786;386;400
Marijampolė mun.;2015;44;916;458;458
Marijampolė mun.;2015;45;849;428;421
Marijampolė mun.;2015;46;876;424;452
Marijampolė mun.;2015;47;898;419;479
Marijampolė mun.;2015;48;880;416;464
Marijampolė mun.;2015;49;886;419;467
Marijampolė mun.;2015;50;970;470;500
Marijampolė mun.;2015;51;974;466;508
Marijampolė mun.;2015;52;927;430;497
Marijampolė mun.;2015;53;1034;478;556
Marijampolė mun.;2015;54;1001;480;521
Marijampolė mun.;2015;55;940;449;491
Marijampolė mun.;2015;56;901;448;453
Marijampolė mun.;2015;57;834;387;447
Marijampolė mun.;2015;58;813;367;446
Marijampolė mun.;2015;59;798;358;440
Marijampolė mun.;2015;60;712;314;398
Marijampolė mun.;2015;61;656;275;381
Marijampolė mun.;2015;62;656;290;366
Marijampolė mun.;2015;63;622;271;351
Marijampolė mun.;2015;64;626;284;342
Marijampolė mun.;2015;65;615;277;338
Marijampolė mun.;2015;66;489;220;269
Marijampolė mun.;2015;67;454;193;261
Marijampolė mun.;2015;68;408;160;248
Marijampolė mun.;2015;69;519;203;316
Marijampolė mun.;2015;70;409;141;268
Marijampolė mun.;2015;71;501;190;311
Marijampolė mun.;2015;72;551;208;343
Marijampolė mun.;2015;73;511;161;350
Marijampolė mun.;2015;74;452;153;299
Marijampolė mun.;2015;75;434;155;279
Marijampolė mun.;2015;76;460;165;295
Marijampolė mun.;2015;77;461;147;314
Marijampolė mun.;2015;78;459;161;298
Marijampolė mun.;2015;79;396;136;260
Marijampolė mun.;2015;80;334;118;216
Marijampolė mun.;2015;81;368;115;253
Marijampolė mun.;2015;82;380;90;290
Marijampolė mun.;2015;83;300;95;205
Marijampolė mun.;2015;84;300;87;213
Marijampolė mun.;2015;85;1271;278;993
Marijampolė mun.;2016;-1;57103;27026;30077
Marijampolė mun.;2016;0;578;298;280
Marijampolė mun.;2016;1;614;316;298
Marijampolė mun.;2016;2;580;293;287
Marijampolė mun.;2016;3;601;314;287
Marijampolė mun.;2016;4;560;289;271
Marijampolė mun.;2016;5;574;303;271
Marijampolė mun.;2016;6;566;304;262
Marijampolė mun.;2016;7;545;297;248
Marijampolė mun.;2016;8;515;262;253
Marijampolė mun.;2016;9;549;300;249
Marijampolė mun.;2016;10;501;272;229
Marijampolė mun.;2016;11;523;265;258
Marijampolė mun.;2016;12;584;285;299
Marijampolė mun.;2016;13;584;303;281
Marijampolė mun.;2016;14;603;316;287
Marijampolė mun.;2016;15;585;290;295
Marijampolė mun.;2016;16;675;363;312
Marijampolė mun.;2016;17;739;392;347
Marijampolė mun.;2016;18;741;381;360
Marijampolė mun.;2016;19;701;323;378
Marijampolė mun.;2016;20;788;399;389
Marijampolė mun.;2016;21;790;400;390
Marijampolė mun.;2016;22;831;410;421
Marijampolė mun.;2016;23;905;474;431
Marijampolė mun.;2016;24;819;416;403
Marijampolė mun.;2016;25;797;402;395
Marijampolė mun.;2016;26;703;359;344
Marijampolė mun.;2016;27;738;400;338
Marijampolė mun.;2016;28;693;371;322
Marijampolė mun.;2016;29;731;413;318
Marijampolė mun.;2016;30;614;349;265
Marijampolė mun.;2016;31;650;344;306
Marijampolė mun.;2016;32;670;387;283
Marijampolė mun.;2016;33;680;373;307
Marijampolė mun.;2016;34;645;361;284
Marijampolė mun.;2016;35;634;338;296
Marijampolė mun.;2016;36;721;416;305
Marijampolė mun.;2016;37;622;317;305
Marijampolė mun.;2016;38;675;332;343
Marijampolė mun.;2016;39;695;360;335
Marijampolė mun.;2016;40;711;376;335
Marijampolė mun.;2016;41;716;346;370
Marijampolė mun.;2016;42;769;370;399
Marijampolė mun.;2016;43;771;377;394
Marijampolė mun.;2016;44;780;377;403
Marijampolė mun.;2016;45;903;453;450
Marijampolė mun.;2016;46;841;423;418
Marijampolė mun.;2016;47;877;426;451
Marijampolė mun.;2016;48;899;421;478
Marijampolė mun.;2016;49;866;407;459
Marijampolė mun.;2016;50;868;405;463
Marijampolė mun.;2016;51;948;457;491
Marijampolė mun.;2016;52;970;462;508
Marijampolė mun.;2016;53;916;421;495
Marijampolė mun.;2016;54;1026;472;554
Marijampolė mun.;2016;55;984;466;518
Marijampolė mun.;2016;56;920;438;482
Marijampolė mun.;2016;57;892;437;455
Marijampolė mun.;2016;58;824;384;440
Marijampolė mun.;2016;59;803;358;445
Marijampolė mun.;2016;60;788;351;437
Marijampolė mun.;2016;61;705;311;394
Marijampolė mun.;2016;62;643;269;374
Marijampolė mun.;2016;63;642;281;361
Marijampolė mun.;2016;64;621;270;351
Marijampolė mun.;2016;65;610;271;339
Marijampolė mun.;2016;66;596;263;333
Marijampolė mun.;2016;67;480;213;267
Marijampolė mun.;2016;68;439;186;253
Marijampolė mun.;2016;69;401;156;245
Marijampolė mun.;2016;70;507;197;310
Marijampolė mun.;2016;71;398;131;267
Marijampolė mun.;2016;72;480;178;302
Marijampolė mun.;2016;73;537;199;338
Marijampolė mun.;2016;74;497;156;341
Marijampolė mun.;2016;75;437;146;291
Marijampolė mun.;2016;76;425;147;278
Marijampolė mun.;2016;77;436;153;283
Marijampolė mun.;2016;78;429;132;297
Marijampolė mun.;2016;79;440;150;290
Marijampolė mun.;2016;80;375;125;250
Marijampolė mun.;2016;81;305;105;200
Marijampolė mun.;2016;82;352;107;245
Marijampolė mun.;2016;83;352;81;271
Marijampolė mun.;2016;84;271;80;191
Marijampolė mun.;2016;85;1334;305;1029
Marijampolė mun.;2017;-1;55757;26377;29380
Marijampolė mun.;2017;0;583;301;282
Marijampolė mun.;2017;1;562;285;277
Marijampolė mun.;2017;2;604;311;293
Marijampolė mun.;2017;3;569;279;290
Marijampolė mun.;2017;4;583;304;279
Marijampolė mun.;2017;5;545;281;264
Marijampolė mun.;2017;6;567;298;269
Marijampolė mun.;2017;7;549;294;255
Marijampolė mun.;2017;8;537;288;249
Marijampolė mun.;2017;9;508;257;251
Marijampolė mun.;2017;10;530;289;241
Marijampolė mun.;2017;11;487;266;221
Marijampolė mun.;2017;12;522;267;255
Marijampolė mun.;2017;13;579;281;298
Marijampolė mun.;2017;14;580;299;281
Marijampolė mun.;2017;15;601;313;288
Marijampolė mun.;2017;16;575;288;287
Marijampolė mun.;2017;17;662;356;306
Marijampolė mun.;2017;18;711;376;335
Marijampolė mun.;2017;19;690;353;337
Marijampolė mun.;2017;20;681;328;353
Marijampolė mun.;2017;21;766;389;377
Marijampolė mun.;2017;22;777;387;390
Marijampolė mun.;2017;23;788;392;396
Marijampolė mun.;2017;24;851;448;403
Marijampolė mun.;2017;25;757;389;368
Marijampolė mun.;2017;26;736;384;352
Marijampolė mun.;2017;27;658;336;322
Marijampolė mun.;2017;28;687;376;311
Marijampolė mun.;2017;29;656;347;309
Marijampolė mun.;2017;30;670;374;296
Marijampolė mun.;2017;31;586;333;253
Marijampolė mun.;2017;32;605;327;278
Marijampolė mun.;2017;33;624;372;252
Marijampolė mun.;2017;34;638;351;287
Marijampolė mun.;2017;35;610;338;272
Marijampolė mun.;2017;36;613;329;284
Marijampolė mun.;2017;37;708;407;301
Marijampolė mun.;2017;38;614;311;303
Marijampolė mun.;2017;39;659;325;334
Marijampolė mun.;2017;40;676;348;328
Marijampolė mun.;2017;41;687;365;322
Marijampolė mun.;2017;42;699;336;363
Marijampolė mun.;2017;43;759;366;393
Marijampolė mun.;2017;44;762;379;383
Marijampolė mun.;2017;45;763;375;388
Marijampolė mun.;2017;46;890;445;445
Marijampolė mun.;2017;47;824;410;414
Marijampolė mun.;2017;48;864;421;443
Marijampolė mun.;2017;49;883;412;471
Marijampolė mun.;2017;50;856;402;454
Marijampolė mun.;2017;51;851;394;457
Marijampolė mun.;2017;52;940;452;488
Marijampolė mun.;2017;53;950;454;496
Marijampolė mun.;2017;54;891;411;480
Marijampolė mun.;2017;55;1002;460;542
Marijampolė mun.;2017;56;968;453;515
Marijampolė mun.;2017;57;908;432;476
Marijampolė mun.;2017;58;886;435;451
Marijampolė mun.;2017;59;807;375;432
Marijampolė mun.;2017;60;787;352;435
Marijampolė mun.;2017;61;770;336;434
Marijampolė mun.;2017;62;692;306;386
Marijampolė mun.;2017;63;631;260;371
Marijampolė mun.;2017;64;631;269;362
Marijampolė mun.;2017;65;604;259;345
Marijampolė mun.;2017;66;592;263;329
Marijampolė mun.;2017;67;577;251;326
Marijampolė mun.;2017;68;470;207;263
Marijampolė mun.;2017;69;433;182;251
Marijampolė mun.;2017;70;394;153;241
Marijampolė mun.;2017;71;494;189;305
Marijampolė mun.;2017;72;393;128;265
Marijampolė mun.;2017;73;468;169;299
Marijampolė mun.;2017;74;519;187;332
Marijampolė mun.;2017;75;483;151;332
Marijampolė mun.;2017;76;419;136;283
Marijampolė mun.;2017;77;408;139;269
Marijampolė mun.;2017;78;415;141;274
Marijampolė mun.;2017;79;402;118;284
Marijampolė mun.;2017;80;412;134;278
Marijampolė mun.;2017;81;355;113;242
Marijampolė mun.;2017;82;285;96;189
Marijampolė mun.;2017;83;329;99;230
Marijampolė mun.;2017;84;322;70;252
Marijampolė mun.;2017;85;1378;315;1063
Marijampolė mun.;2018;-1;54600;25903;28697
Marijampolė mun.;2018;0;542;279;263
Marijampolė mun.;2018;1;590;302;288
Marijampolė mun.;2018;2;559;281;278
Marijampolė mun.;2018;3;594;307;287
Marijampolė mun.;2018;4;566;278;288
Marijampolė mun.;2018;5;565;293;272
Marijampolė mun.;2018;6;538;277;261
Marijampolė mun.;2018;7;563;293;270
Marijampolė mun.;2018;8;541;291;250
Marijampolė mun.;2018;9;530;281;249
Marijampolė mun.;2018;10;507;259;248
Marijampolė mun.;2018;11;522;283;239
Marijampolė mun.;2018;12;479;263;216
Marijampolė mun.;2018;13;510;262;248
Marijampolė mun.;2018;14;570;277;293
Marijampolė mun.;2018;15;567;297;270
Marijampolė mun.;2018;16;589;307;282
Marijampolė mun.;2018;17;568;281;287
Marijampolė mun.;2018;18;646;344;302
Marijampolė mun.;2018;19;653;350;303
Marijampolė mun.;2018;20;648;331;317
Marijampolė mun.;2018;21;628;303;325
Marijampolė mun.;2018;22;716;366;350
Marijampolė mun.;2018;23;715;351;364
Marijampolė mun.;2018;24;725;361;364
Marijampolė mun.;2018;25;802;429;373
Marijampolė mun.;2018;26;706;357;349
Marijampolė mun.;2018;27;682;367;315
Marijampolė mun.;2018;28;625;327;298
Marijampolė mun.;2018;29;656;375;281
Marijampolė mun.;2018;30;638;328;310
Marijampolė mun.;2018;31;642;367;275
Marijampolė mun.;2018;32;570;323;247
Marijampolė mun.;2018;33;578;314;264
Marijampolė mun.;2018;34;605;365;240
Marijampolė mun.;2018;35;619;343;276
Marijampolė mun.;2018;36;605;342;263
Marijampolė mun.;2018;37;600;329;271
Marijampolė mun.;2018;38;701;403;298
Marijampolė mun.;2018;39;591;301;290
Marijampolė mun.;2018;40;661;332;329
Marijampolė mun.;2018;41;668;345;323
Marijampolė mun.;2018;42;682;363;319
Marijampolė mun.;2018;43;685;332;353
Marijampolė mun.;2018;44;746;359;387
Marijampolė mun.;2018;45;760;379;381
Marijampolė mun.;2018;46;754;369;385
Marijampolė mun.;2018;47;881;444;437
Marijampolė mun.;2018;48;814;407;407
Marijampolė mun.;2018;49;839;406;433
Marijampolė mun.;2018;50;876;410;466
Marijampolė mun.;2018;51;849;399;450
Marijampolė mun.;2018;52;846;393;453
Marijampolė mun.;2018;53;932;450;482
Marijampolė mun.;2018;54;928;445;483
Marijampolė mun.;2018;55;883;411;472
Marijampolė mun.;2018;56;983;449;534
Marijampolė mun.;2018;57;957;445;512
Marijampolė mun.;2018;58;900;428;472
Marijampolė mun.;2018;59;881;429;452
Marijampolė mun.;2018;60;796;369;427
Marijampolė mun.;2018;61;776;346;430
Marijampolė mun.;2018;62;760;325;435
Marijampolė mun.;2018;63;680;301;379
Marijampolė mun.;2018;64;623;258;365
Marijampolė mun.;2018;65;619;263;356
Marijampolė mun.;2018;66;594;251;343
Marijampolė mun.;2018;67;582;256;326
Marijampolė mun.;2018;68;565;242;323
Marijampolė mun.;2018;69;464;204;260
Marijampolė mun.;2018;70;418;172;246
Marijampolė mun.;2018;71;381;143;238
Marijampolė mun.;2018;72;480;180;300
Marijampolė mun.;2018;73;383;119;264
Marijampolė mun.;2018;74;445;159;286
Marijampolė mun.;2018;75;501;177;324
Marijampolė mun.;2018;76;467;144;323
Marijampolė mun.;2018;77;400;124;276
Marijampolė mun.;2018;78;385;129;256
Marijampolė mun.;2018;79;382;128;254
Marijampolė mun.;2018;80;376;111;265
Marijampolė mun.;2018;81;377;116;261
Marijampolė mun.;2018;82;330;109;221
Marijampolė mun.;2018;83;266;87;179
Marijampolė mun.;2018;84;298;88;210
Marijampolė mun.;2018;85;1476;320;1156
Mažeikiai d. mun.;2001;-1;67295;31880;35415
Mažeikiai d. mun.;2001;0;772;385;387
Mažeikiai d. mun.;2001;1;843;458;385
Mažeikiai d. mun.;2001;2;849;436;413
Mažeikiai d. mun.;2001;3;824;437;387
Mažeikiai d. mun.;2001;4;880;473;407
Mažeikiai d. mun.;2001;5;952;472;480
Mažeikiai d. mun.;2001;6;931;459;472
Mažeikiai d. mun.;2001;7;1046;544;502
Mažeikiai d. mun.;2001;8;1275;633;642
Mažeikiai d. mun.;2001;9;1163;566;597
Mažeikiai d. mun.;2001;10;1156;626;530
Mažeikiai d. mun.;2001;11;1198;598;600
Mažeikiai d. mun.;2001;12;1175;587;588
Mažeikiai d. mun.;2001;13;1170;607;563
Mažeikiai d. mun.;2001;14;1213;626;587
Mažeikiai d. mun.;2001;15;1223;643;580
Mažeikiai d. mun.;2001;16;1252;637;615
Mažeikiai d. mun.;2001;17;1214;607;607
Mažeikiai d. mun.;2001;18;976;523;453
Mažeikiai d. mun.;2001;19;846;499;347
Mažeikiai d. mun.;2001;20;849;441;408
Mažeikiai d. mun.;2001;21;883;482;401
Mažeikiai d. mun.;2001;22;915;480;435
Mažeikiai d. mun.;2001;23;961;493;468
Mažeikiai d. mun.;2001;24;931;482;449
Mažeikiai d. mun.;2001;25;939;443;496
Mažeikiai d. mun.;2001;26;949;450;499
Mažeikiai d. mun.;2001;27;954;458;496
Mažeikiai d. mun.;2001;28;976;497;479
Mažeikiai d. mun.;2001;29;1033;503;530
Mažeikiai d. mun.;2001;30;1077;524;553
Mažeikiai d. mun.;2001;31;1010;510;500
Mažeikiai d. mun.;2001;32;948;437;511
Mažeikiai d. mun.;2001;33;996;482;514
Mažeikiai d. mun.;2001;34;996;494;502
Mažeikiai d. mun.;2001;35;980;467;513
Mažeikiai d. mun.;2001;36;1053;523;530
Mažeikiai d. mun.;2001;37;1077;500;577
Mažeikiai d. mun.;2001;38;1153;592;561
Mažeikiai d. mun.;2001;39;1228;590;638
Mažeikiai d. mun.;2001;40;1138;551;587
Mažeikiai d. mun.;2001;41;1138;525;613
Mažeikiai d. mun.;2001;42;1095;489;606
Mažeikiai d. mun.;2001;43;1009;492;517
Mažeikiai d. mun.;2001;44;958;451;507
Mažeikiai d. mun.;2001;45;963;458;505
Mažeikiai d. mun.;2001;46;808;373;435
Mažeikiai d. mun.;2001;47;807;398;409
Mažeikiai d. mun.;2001;48;820;385;435
Mažeikiai d. mun.;2001;49;781;356;425
Mažeikiai d. mun.;2001;50;813;410;403
Mažeikiai d. mun.;2001;51;762;358;404
Mažeikiai d. mun.;2001;52;708;332;376
Mažeikiai d. mun.;2001;53;628;285;343
Mažeikiai d. mun.;2001;54;598;258;340
Mažeikiai d. mun.;2001;55;640;271;369
Mažeikiai d. mun.;2001;56;513;202;311
Mažeikiai d. mun.;2001;57;575;249;326
Mažeikiai d. mun.;2001;58;622;280;342
Mažeikiai d. mun.;2001;59;651;286;365
Mažeikiai d. mun.;2001;60;533;233;300
Mažeikiai d. mun.;2001;61;497;191;306
Mažeikiai d. mun.;2001;62;527;233;294
Mažeikiai d. mun.;2001;63;520;209;311
Mažeikiai d. mun.;2001;64;585;249;336
Mažeikiai d. mun.;2001;65;557;216;341
Mažeikiai d. mun.;2001;66;479;193;286
Mažeikiai d. mun.;2001;67;513;197;316
Mažeikiai d. mun.;2001;68;523;203;320
Mažeikiai d. mun.;2001;69;495;181;314
Mažeikiai d. mun.;2001;70;467;176;291
Mažeikiai d. mun.;2001;71;438;162;276
Mažeikiai d. mun.;2001;72;501;173;328
Mažeikiai d. mun.;2001;73;431;138;293
Mažeikiai d. mun.;2001;74;380;116;264
Mažeikiai d. mun.;2001;75;399;138;261
Mažeikiai d. mun.;2001;76;384;118;266
Mažeikiai d. mun.;2001;77;328;115;213
Mažeikiai d. mun.;2001;78;294;100;194
Mažeikiai d. mun.;2001;79;239;69;170
Mažeikiai d. mun.;2001;80;171;59;112
Mažeikiai d. mun.;2001;81;164;51;113
Mažeikiai d. mun.;2001;82;126;38;88
Mažeikiai d. mun.;2001;83;94;27;67
Mažeikiai d. mun.;2001;84;106;31;75
Mažeikiai d. mun.;2001;85;651;191;460
Mažeikiai d. mun.;2002;-1;66799;31589;35210
Mažeikiai d. mun.;2002;0;679;349;330
Mažeikiai d. mun.;2002;1;756;376;380
Mažeikiai d. mun.;2002;2;844;458;386
Mažeikiai d. mun.;2002;3;836;430;406
Mažeikiai d. mun.;2002;4;822;435;387
Mažeikiai d. mun.;2002;5;881;472;409
Mažeikiai d. mun.;2002;6;949;474;475
Mažeikiai d. mun.;2002;7;928;458;470
Mažeikiai d. mun.;2002;8;1037;538;499
Mažeikiai d. mun.;2002;9;1268;626;642
Mažeikiai d. mun.;2002;10;1164;565;599
Mažeikiai d. mun.;2002;11;1147;621;526
Mažeikiai d. mun.;2002;12;1191;596;595
Mažeikiai d. mun.;2002;13;1150;575;575
Mažeikiai d. mun.;2002;14;1150;593;557
Mažeikiai d. mun.;2002;15;1194;617;577
Mažeikiai d. mun.;2002;16;1211;638;573
Mažeikiai d. mun.;2002;17;1239;628;611
Mažeikiai d. mun.;2002;18;1178;588;590
Mažeikiai d. mun.;2002;19;953;505;448
Mažeikiai d. mun.;2002;20;831;488;343
Mažeikiai d. mun.;2002;21;837;432;405
Mažeikiai d. mun.;2002;22;883;472;411
Mažeikiai d. mun.;2002;23;897;468;429
Mažeikiai d. mun.;2002;24;956;495;461
Mažeikiai d. mun.;2002;25;928;480;448
Mažeikiai d. mun.;2002;26;926;437;489
Mažeikiai d. mun.;2002;27;934;440;494
Mažeikiai d. mun.;2002;28;942;450;492
Mažeikiai d. mun.;2002;29;963;487;476
Mažeikiai d. mun.;2002;30;1020;495;525
Mažeikiai d. mun.;2002;31;1064;514;550
Mažeikiai d. mun.;2002;32;992;499;493
Mažeikiai d. mun.;2002;33;937;432;505
Mažeikiai d. mun.;2002;34;985;473;512
Mažeikiai d. mun.;2002;35;984;487;497
Mažeikiai d. mun.;2002;36;968;460;508
Mažeikiai d. mun.;2002;37;1035;511;524
Mažeikiai d. mun.;2002;38;1059;489;570
Mažeikiai d. mun.;2002;39;1135;581;554
Mažeikiai d. mun.;2002;40;1202;573;629
Mažeikiai d. mun.;2002;41;1124;542;582
Mažeikiai d. mun.;2002;42;1125;521;604
Mažeikiai d. mun.;2002;43;1084;487;597
Mažeikiai d. mun.;2002;44;991;483;508
Mažeikiai d. mun.;2002;45;940;444;496
Mažeikiai d. mun.;2002;46;942;443;499
Mažeikiai d. mun.;2002;47;798;368;430
Mažeikiai d. mun.;2002;48;789;389;400
Mažeikiai d. mun.;2002;49;796;375;421
Mažeikiai d. mun.;2002;50;766;345;421
Mažeikiai d. mun.;2002;51;801;400;401
Mažeikiai d. mun.;2002;52;750;349;401
Mažeikiai d. mun.;2002;53;701;329;372
Mažeikiai d. mun.;2002;54;608;274;334
Mažeikiai d. mun.;2002;55;579;248;331
Mažeikiai d. mun.;2002;56;621;264;357
Mažeikiai d. mun.;2002;57;498;195;303
Mažeikiai d. mun.;2002;58;556;237;319
Mažeikiai d. mun.;2002;59;605;272;333
Mažeikiai d. mun.;2002;60;642;280;362
Mažeikiai d. mun.;2002;61;532;233;299
Mažeikiai d. mun.;2002;62;491;187;304
Mažeikiai d. mun.;2002;63;521;231;290
Mažeikiai d. mun.;2002;64;512;202;310
Mažeikiai d. mun.;2002;65;580;245;335
Mažeikiai d. mun.;2002;66;549;209;340
Mažeikiai d. mun.;2002;67;471;188;283
Mažeikiai d. mun.;2002;68;501;188;313
Mažeikiai d. mun.;2002;69;506;190;316
Mažeikiai d. mun.;2002;70;483;174;309
Mažeikiai d. mun.;2002;71;452;171;281
Mažeikiai d. mun.;2002;72;435;158;277
Mažeikiai d. mun.;2002;73;493;172;321
Mažeikiai d. mun.;2002;74;417;129;288
Mažeikiai d. mun.;2002;75;366;110;256
Mažeikiai d. mun.;2002;76;384;132;252
Mažeikiai d. mun.;2002;77;367;111;256
Mažeikiai d. mun.;2002;78;315;105;210
Mažeikiai d. mun.;2002;79;272;87;185
Mažeikiai d. mun.;2002;80;232;63;169
Mažeikiai d. mun.;2002;81;164;54;110
Mažeikiai d. mun.;2002;82;154;51;103
Mažeikiai d. mun.;2002;83;115;35;80
Mažeikiai d. mun.;2002;84;83;24;59
Mažeikiai d. mun.;2002;85;633;190;443
Mažeikiai d. mun.;2003;-1;66469;31436;35033
Mažeikiai d. mun.;2003;0;642;335;307
Mažeikiai d. mun.;2003;1;667;341;326
Mažeikiai d. mun.;2003;2;743;366;377
Mažeikiai d. mun.;2003;3;837;455;382
Mažeikiai d. mun.;2003;4;832;427;405
Mažeikiai d. mun.;2003;5;814;432;382
Mažeikiai d. mun.;2003;6;870;467;403
Mažeikiai d. mun.;2003;7;941;472;469
Mažeikiai d. mun.;2003;8;924;455;469
Mažeikiai d. mun.;2003;9;1037;537;500
Mažeikiai d. mun.;2003;10;1255;622;633
Mažeikiai d. mun.;2003;11;1154;563;591
Mažeikiai d. mun.;2003;12;1127;612;515
Mažeikiai d. mun.;2003;13;1165;582;583
Mažeikiai d. mun.;2003;14;1135;567;568
Mažeikiai d. mun.;2003;15;1130;580;550
Mažeikiai d. mun.;2003;16;1173;605;568
Mažeikiai d. mun.;2003;17;1190;625;565
Mažeikiai d. mun.;2003;18;1228;624;604
Mažeikiai d. mun.;2003;19;1161;584;577
Mažeikiai d. mun.;2003;20;943;501;442
Mažeikiai d. mun.;2003;21;832;484;348
Mažeikiai d. mun.;2003;22;835;424;411
Mažeikiai d. mun.;2003;23;879;471;408
Mažeikiai d. mun.;2003;24;904;468;436
Mažeikiai d. mun.;2003;25;958;497;461
Mažeikiai d. mun.;2003;26;934;485;449
Mažeikiai d. mun.;2003;27;911;427;484
Mažeikiai d. mun.;2003;28;933;442;491
Mažeikiai d. mun.;2003;29;947;453;494
Mažeikiai d. mun.;2003;30;951;478;473
Mažeikiai d. mun.;2003;31;1009;488;521
Mažeikiai d. mun.;2003;32;1059;512;547
Mažeikiai d. mun.;2003;33;988;500;488
Mažeikiai d. mun.;2003;34;921;430;491
Mažeikiai d. mun.;2003;35;972;464;508
Mažeikiai d. mun.;2003;36;975;481;494
Mažeikiai d. mun.;2003;37;963;459;504
Mažeikiai d. mun.;2003;38;1024;506;518
Mažeikiai d. mun.;2003;39;1051;484;567
Mažeikiai d. mun.;2003;40;1127;573;554
Mažeikiai d. mun.;2003;41;1190;569;621
Mažeikiai d. mun.;2003;42;1117;538;579
Mažeikiai d. mun.;2003;43;1115;518;597
Mažeikiai d. mun.;2003;44;1084;493;591
Mažeikiai d. mun.;2003;45;979;477;502
Mažeikiai d. mun.;2003;46;934;442;492
Mažeikiai d. mun.;2003;47;919;434;485
Mažeikiai d. mun.;2003;48;785;363;422
Mažeikiai d. mun.;2003;49;780;381;399
Mažeikiai d. mun.;2003;50;794;376;418
Mažeikiai d. mun.;2003;51;758;344;414
Mažeikiai d. mun.;2003;52;786;393;393
Mažeikiai d. mun.;2003;53;749;351;398
Mažeikiai d. mun.;2003;54;690;319;371
Mažeikiai d. mun.;2003;55;599;267;332
Mažeikiai d. mun.;2003;56;565;239;326
Mažeikiai d. mun.;2003;57;613;256;357
Mažeikiai d. mun.;2003;58;491;192;299
Mažeikiai d. mun.;2003;59;547;230;317
Mažeikiai d. mun.;2003;60;585;260;325
Mažeikiai d. mun.;2003;61;630;273;357
Mažeikiai d. mun.;2003;62;518;224;294
Mažeikiai d. mun.;2003;63;483;180;303
Mažeikiai d. mun.;2003;64;510;225;285
Mažeikiai d. mun.;2003;65;514;201;313
Mažeikiai d. mun.;2003;66;578;245;333
Mažeikiai d. mun.;2003;67;545;209;336
Mažeikiai d. mun.;2003;68;462;179;283
Mažeikiai d. mun.;2003;69;489;180;309
Mažeikiai d. mun.;2003;70;498;186;312
Mažeikiai d. mun.;2003;71;472;165;307
Mažeikiai d. mun.;2003;72;446;163;283
Mažeikiai d. mun.;2003;73;415;149;266
Mažeikiai d. mun.;2003;74;478;161;317
Mažeikiai d. mun.;2003;75;397;119;278
Mažeikiai d. mun.;2003;76;349;102;247
Mažeikiai d. mun.;2003;77;369;124;245
Mažeikiai d. mun.;2003;78;344;103;241
Mažeikiai d. mun.;2003;79;301;97;204
Mažeikiai d. mun.;2003;80;254;79;175
Mažeikiai d. mun.;2003;81;218;57;161
Mažeikiai d. mun.;2003;82;146;43;103
Mažeikiai d. mun.;2003;83;141;47;94
Mažeikiai d. mun.;2003;84;105;30;75
Mažeikiai d. mun.;2003;85;586;175;411
Mažeikiai d. mun.;2004;-1;65831;31078;34753
Mažeikiai d. mun.;2004;0;637;326;311
Mažeikiai d. mun.;2004;1;635;331;304
Mažeikiai d. mun.;2004;2;663;338;325
Mažeikiai d. mun.;2004;3;739;366;373
Mažeikiai d. mun.;2004;4;829;448;381
Mažeikiai d. mun.;2004;5;819;423;396
Mažeikiai d. mun.;2004;6;812;432;380
Mažeikiai d. mun.;2004;7;866;464;402
Mažeikiai d. mun.;2004;8;936;468;468
Mažeikiai d. mun.;2004;9;917;451;466
Mažeikiai d. mun.;2004;10;1028;536;492
Mažeikiai d. mun.;2004;11;1238;613;625
Mažeikiai d. mun.;2004;12;1140;557;583
Mažeikiai d. mun.;2004;13;1106;606;500
Mažeikiai d. mun.;2004;14;1145;575;570
Mažeikiai d. mun.;2004;15;1116;562;554
Mažeikiai d. mun.;2004;16;1114;573;541
Mažeikiai d. mun.;2004;17;1160;601;559
Mažeikiai d. mun.;2004;18;1167;615;552
Mažeikiai d. mun.;2004;19;1199;613;586
Mažeikiai d. mun.;2004;20;1134;573;561
Mažeikiai d. mun.;2004;21;920;489;431
Mažeikiai d. mun.;2004;22;825;478;347
Mažeikiai d. mun.;2004;23;821;419;402
Mažeikiai d. mun.;2004;24;871;455;416
Mažeikiai d. mun.;2004;25;892;452;440
Mažeikiai d. mun.;2004;26;936;485;451
Mažeikiai d. mun.;2004;27;924;474;450
Mažeikiai d. mun.;2004;28;898;419;479
Mažeikiai d. mun.;2004;29;928;439;489
Mažeikiai d. mun.;2004;30;930;441;489
Mažeikiai d. mun.;2004;31;934;469;465
Mažeikiai d. mun.;2004;32;983;476;507
Mažeikiai d. mun.;2004;33;1054;511;543
Mažeikiai d. mun.;2004;34;974;493;481
Mažeikiai d. mun.;2004;35;913;425;488
Mažeikiai d. mun.;2004;36;961;456;505
Mažeikiai d. mun.;2004;37;962;475;487
Mažeikiai d. mun.;2004;38;944;446;498
Mažeikiai d. mun.;2004;39;1007;501;506
Mažeikiai d. mun.;2004;40;1027;474;553
Mažeikiai d. mun.;2004;41;1103;560;543
Mažeikiai d. mun.;2004;42;1181;564;617
Mažeikiai d. mun.;2004;43;1103;529;574
Mažeikiai d. mun.;2004;44;1088;499;589
Mažeikiai d. mun.;2004;45;1075;493;582
Mažeikiai d. mun.;2004;46;958;462;496
Mažeikiai d. mun.;2004;47;917;433;484
Mažeikiai d. mun.;2004;48;904;424;480
Mažeikiai d. mun.;2004;49;772;358;414
Mažeikiai d. mun.;2004;50;763;370;393
Mažeikiai d. mun.;2004;51;782;369;413
Mažeikiai d. mun.;2004;52;744;336;408
Mažeikiai d. mun.;2004;53;764;380;384
Mažeikiai d. mun.;2004;54;738;345;393
Mažeikiai d. mun.;2004;55;678;315;363
Mažeikiai d. mun.;2004;56;588;259;329
Mažeikiai d. mun.;2004;57;548;227;321
Mažeikiai d. mun.;2004;58;599;247;352
Mažeikiai d. mun.;2004;59;480;185;295
Mažeikiai d. mun.;2004;60;532;222;310
Mažeikiai d. mun.;2004;61;569;248;321
Mažeikiai d. mun.;2004;62;622;267;355
Mažeikiai d. mun.;2004;63;513;219;294
Mažeikiai d. mun.;2004;64;482;178;304
Mažeikiai d. mun.;2004;65;511;222;289
Mažeikiai d. mun.;2004;66;513;195;318
Mažeikiai d. mun.;2004;67;572;238;334
Mažeikiai d. mun.;2004;68;530;199;331
Mažeikiai d. mun.;2004;69;456;173;283
Mažeikiai d. mun.;2004;70;474;172;302
Mažeikiai d. mun.;2004;71;477;173;304
Mažeikiai d. mun.;2004;72;464;161;303
Mažeikiai d. mun.;2004;73;426;150;276
Mažeikiai d. mun.;2004;74;397;142;255
Mažeikiai d. mun.;2004;75;462;150;312
Mažeikiai d. mun.;2004;76;372;108;264
Mažeikiai d. mun.;2004;77;334;98;236
Mažeikiai d. mun.;2004;78;352;116;236
Mažeikiai d. mun.;2004;79;323;89;234
Mažeikiai d. mun.;2004;80;283;87;196
Mažeikiai d. mun.;2004;81;233;65;168
Mažeikiai d. mun.;2004;82;197;53;144
Mažeikiai d. mun.;2004;83;139;40;99
Mažeikiai d. mun.;2004;84;129;41;88
Mažeikiai d. mun.;2004;85;580;169;411
Mažeikiai d. mun.;2005;-1;64882;30629;34253
Mažeikiai d. mun.;2005;0;647;321;326
Mažeikiai d. mun.;2005;1;631;327;304
Mažeikiai d. mun.;2005;2;628;327;301
Mažeikiai d. mun.;2005;3;658;337;321
Mažeikiai d. mun.;2005;4;726;361;365
Mažeikiai d. mun.;2005;5;824;445;379
Mažeikiai d. mun.;2005;6;806;417;389
Mažeikiai d. mun.;2005;7;802;425;377
Mažeikiai d. mun.;2005;8;862;461;401
Mažeikiai d. mun.;2005;9;933;468;465
Mažeikiai d. mun.;2005;10;908;448;460
Mažeikiai d. mun.;2005;11;1018;533;485
Mažeikiai d. mun.;2005;12;1229;611;618
Mažeikiai d. mun.;2005;13;1126;552;574
Mažeikiai d. mun.;2005;14;1091;601;490
Mažeikiai d. mun.;2005;15;1130;566;564
Mažeikiai d. mun.;2005;16;1096;555;541
Mažeikiai d. mun.;2005;17;1090;561;529
Mažeikiai d. mun.;2005;18;1122;581;541
Mažeikiai d. mun.;2005;19;1123;590;533
Mažeikiai d. mun.;2005;20;1152;591;561
Mažeikiai d. mun.;2005;21;1092;557;535
Mažeikiai d. mun.;2005;22;884;470;414
Mažeikiai d. mun.;2005;23;779;456;323
Mažeikiai d. mun.;2005;24;808;420;388
Mažeikiai d. mun.;2005;25;837;440;397
Mažeikiai d. mun.;2005;26;869;446;423
Mažeikiai d. mun.;2005;27;908;478;430
Mažeikiai d. mun.;2005;28;905;467;438
Mažeikiai d. mun.;2005;29;889;417;472
Mažeikiai d. mun.;2005;30;916;431;485
Mažeikiai d. mun.;2005;31;909;431;478
Mažeikiai d. mun.;2005;32;910;452;458
Mažeikiai d. mun.;2005;33;970;471;499
Mažeikiai d. mun.;2005;34;1025;496;529
Mažeikiai d. mun.;2005;35;955;482;473
Mažeikiai d. mun.;2005;36;886;409;477
Mažeikiai d. mun.;2005;37;946;451;495
Mažeikiai d. mun.;2005;38;952;470;482
Mažeikiai d. mun.;2005;39;923;430;493
Mažeikiai d. mun.;2005;40;983;485;498
Mažeikiai d. mun.;2005;41;999;458;541
Mažeikiai d. mun.;2005;42;1082;551;531
Mažeikiai d. mun.;2005;43;1156;548;608
Mažeikiai d. mun.;2005;44;1086;520;566
Mažeikiai d. mun.;2005;45;1068;492;576
Mažeikiai d. mun.;2005;46;1066;489;577
Mažeikiai d. mun.;2005;47;939;454;485
Mažeikiai d. mun.;2005;48;903;425;478
Mažeikiai d. mun.;2005;49;887;415;472
Mažeikiai d. mun.;2005;50;757;348;409
Mažeikiai d. mun.;2005;51;749;363;386
Mažeikiai d. mun.;2005;52;762;355;407
Mažeikiai d. mun.;2005;53;732;329;403
Mažeikiai d. mun.;2005;54;759;375;384
Mažeikiai d. mun.;2005;55;724;332;392
Mažeikiai d. mun.;2005;56;673;308;365
Mažeikiai d. mun.;2005;57;575;249;326
Mažeikiai d. mun.;2005;58;542;224;318
Mažeikiai d. mun.;2005;59;587;241;346
Mažeikiai d. mun.;2005;60;472;181;291
Mažeikiai d. mun.;2005;61;517;218;299
Mažeikiai d. mun.;2005;62;557;241;316
Mažeikiai d. mun.;2005;63;603;257;346
Mažeikiai d. mun.;2005;64;492;206;286
Mažeikiai d. mun.;2005;65;478;173;305
Mažeikiai d. mun.;2005;66;493;214;279
Mažeikiai d. mun.;2005;67;502;187;315
Mažeikiai d. mun.;2005;68;550;224;326
Mažeikiai d. mun.;2005;69;513;192;321
Mažeikiai d. mun.;2005;70;438;161;277
Mažeikiai d. mun.;2005;71;457;161;296
Mažeikiai d. mun.;2005;72;455;159;296
Mažeikiai d. mun.;2005;73;446;156;290
Mažeikiai d. mun.;2005;74;414;145;269
Mažeikiai d. mun.;2005;75;378;133;245
Mažeikiai d. mun.;2005;76;441;139;302
Mažeikiai d. mun.;2005;77;350;96;254
Mažeikiai d. mun.;2005;78;314;86;228
Mažeikiai d. mun.;2005;79;321;105;216
Mažeikiai d. mun.;2005;80;308;84;224
Mažeikiai d. mun.;2005;81;276;88;188
Mažeikiai d. mun.;2005;82;221;63;158
Mažeikiai d. mun.;2005;83;173;45;128
Mažeikiai d. mun.;2005;84;127;36;91
Mažeikiai d. mun.;2005;85;592;166;426
Mažeikiai d. mun.;2006;-1;63564;29962;33602
Mažeikiai d. mun.;2006;0;598;324;274
Mažeikiai d. mun.;2006;1;633;314;319
Mažeikiai d. mun.;2006;2;617;318;299
Mažeikiai d. mun.;2006;3;617;323;294
Mažeikiai d. mun.;2006;4;645;331;314
Mažeikiai d. mun.;2006;5;716;359;357
Mažeikiai d. mun.;2006;6;815;444;371
Mažeikiai d. mun.;2006;7;796;413;383
Mažeikiai d. mun.;2006;8;793;419;374
Mažeikiai d. mun.;2006;9;854;458;396
Mažeikiai d. mun.;2006;10;922;460;462
Mažeikiai d. mun.;2006;11;898;442;456
Mažeikiai d. mun.;2006;12;1014;531;483
Mažeikiai d. mun.;2006;13;1206;597;609
Mažeikiai d. mun.;2006;14;1108;541;567
Mažeikiai d. mun.;2006;15;1058;583;475
Mažeikiai d. mun.;2006;16;1090;544;546
Mažeikiai d. mun.;2006;17;1063;537;526
Mažeikiai d. mun.;2006;18;1053;540;513
Mažeikiai d. mun.;2006;19;1067;550;517
Mažeikiai d. mun.;2006;20;1066;561;505
Mažeikiai d. mun.;2006;21;1067;550;517
Mažeikiai d. mun.;2006;22;1025;529;496
Mažeikiai d. mun.;2006;23;843;450;393
Mažeikiai d. mun.;2006;24;730;432;298
Mažeikiai d. mun.;2006;25;750;392;358
Mažeikiai d. mun.;2006;26;787;414;373
Mažeikiai d. mun.;2006;27;839;424;415
Mažeikiai d. mun.;2006;28;880;461;419
Mažeikiai d. mun.;2006;29;881;451;430
Mažeikiai d. mun.;2006;30;885;413;472
Mažeikiai d. mun.;2006;31;887;421;466
Mažeikiai d. mun.;2006;32;888;421;467
Mažeikiai d. mun.;2006;33;895;445;450
Mažeikiai d. mun.;2006;34;944;456;488
Mažeikiai d. mun.;2006;35;996;482;514
Mažeikiai d. mun.;2006;36;934;470;464
Mažeikiai d. mun.;2006;37;864;394;470
Mažeikiai d. mun.;2006;38;929;443;486
Mažeikiai d. mun.;2006;39;928;457;471
Mažeikiai d. mun.;2006;40;902;419;483
Mažeikiai d. mun.;2006;41;963;474;489
Mažeikiai d. mun.;2006;42;974;442;532
Mažeikiai d. mun.;2006;43;1066;543;523
Mažeikiai d. mun.;2006;44;1136;536;600
Mažeikiai d. mun.;2006;45;1066;512;554
Mažeikiai d. mun.;2006;46;1045;475;570
Mažeikiai d. mun.;2006;47;1058;485;573
Mažeikiai d. mun.;2006;48;918;441;477
Mažeikiai d. mun.;2006;49;888;414;474
Mažeikiai d. mun.;2006;50;875;407;468
Mažeikiai d. mun.;2006;51;752;346;406
Mažeikiai d. mun.;2006;52;736;356;380
Mažeikiai d. mun.;2006;53;756;351;405
Mažeikiai d. mun.;2006;54;726;334;392
Mažeikiai d. mun.;2006;55;752;370;382
Mažeikiai d. mun.;2006;56;705;321;384
Mažeikiai d. mun.;2006;57;666;301;365
Mažeikiai d. mun.;2006;58;568;250;318
Mažeikiai d. mun.;2006;59;531;219;312
Mažeikiai d. mun.;2006;60;582;236;346
Mažeikiai d. mun.;2006;61;463;175;288
Mažeikiai d. mun.;2006;62;502;205;297
Mažeikiai d. mun.;2006;63;535;221;314
Mažeikiai d. mun.;2006;64;586;243;343
Mažeikiai d. mun.;2006;65;474;193;281
Mažeikiai d. mun.;2006;66;470;171;299
Mažeikiai d. mun.;2006;67;479;202;277
Mažeikiai d. mun.;2006;68;492;178;314
Mažeikiai d. mun.;2006;69;530;215;315
Mažeikiai d. mun.;2006;70;492;174;318
Mažeikiai d. mun.;2006;71;421;153;268
Mažeikiai d. mun.;2006;72;442;151;291
Mažeikiai d. mun.;2006;73;446;157;289
Mažeikiai d. mun.;2006;74;425;144;281
Mažeikiai d. mun.;2006;75;399;134;265
Mažeikiai d. mun.;2006;76;361;130;231
Mažeikiai d. mun.;2006;77;419;131;288
Mažeikiai d. mun.;2006;78;318;79;239
Mažeikiai d. mun.;2006;79;299;75;224
Mažeikiai d. mun.;2006;80;303;98;205
Mažeikiai d. mun.;2006;81;273;73;200
Mažeikiai d. mun.;2006;82;248;78;170
Mažeikiai d. mun.;2006;83;196;53;143
Mažeikiai d. mun.;2006;84;150;41;109
Mažeikiai d. mun.;2006;85;595;162;433
Mažeikiai d. mun.;2007;-1;62750;29500;33250
Mažeikiai d. mun.;2007;0;616;289;327
Mažeikiai d. mun.;2007;1;591;319;272
Mažeikiai d. mun.;2007;2;624;311;313
Mažeikiai d. mun.;2007;3;613;316;297
Mažeikiai d. mun.;2007;4;607;317;290
Mažeikiai d. mun.;2007;5;634;325;309
Mažeikiai d. mun.;2007;6;709;360;349
Mažeikiai d. mun.;2007;7;811;442;369
Mažeikiai d. mun.;2007;8;788;405;383
Mažeikiai d. mun.;2007;9;783;414;369
Mažeikiai d. mun.;2007;10;850;458;392
Mažeikiai d. mun.;2007;11;925;461;464
Mažeikiai d. mun.;2007;12;895;444;451
Mažeikiai d. mun.;2007;13;1011;530;481
Mažeikiai d. mun.;2007;14;1195;593;602
Mažeikiai d. mun.;2007;15;1097;538;559
Mažeikiai d. mun.;2007;16;1048;579;469
Mažeikiai d. mun.;2007;17;1075;538;537
Mažeikiai d. mun.;2007;18;1044;525;519
Mažeikiai d. mun.;2007;19;1032;527;505
Mažeikiai d. mun.;2007;20;1033;538;495
Mažeikiai d. mun.;2007;21;1033;541;492
Mažeikiai d. mun.;2007;22;1031;529;502
Mažeikiai d. mun.;2007;23;985;511;474
Mažeikiai d. mun.;2007;24;822;437;385
Mažeikiai d. mun.;2007;25;693;415;278
Mažeikiai d. mun.;2007;26;725;377;348
Mažeikiai d. mun.;2007;27;773;402;371
Mažeikiai d. mun.;2007;28;828;416;412
Mažeikiai d. mun.;2007;29;856;448;408
Mažeikiai d. mun.;2007;30;865;435;430
Mažeikiai d. mun.;2007;31;874;409;465
Mažeikiai d. mun.;2007;32;872;411;461
Mažeikiai d. mun.;2007;33;888;422;466
Mažeikiai d. mun.;2007;34;882;436;446
Mažeikiai d. mun.;2007;35;932;453;479
Mažeikiai d. mun.;2007;36;975;470;505
Mažeikiai d. mun.;2007;37;925;464;461
Mažeikiai d. mun.;2007;38;846;381;465
Mažeikiai d. mun.;2007;39;907;429;478
Mažeikiai d. mun.;2007;40;916;452;464
Mažeikiai d. mun.;2007;41;894;415;479
Mažeikiai d. mun.;2007;42;947;462;485
Mažeikiai d. mun.;2007;43;959;438;521
Mažeikiai d. mun.;2007;44;1040;522;518
Mažeikiai d. mun.;2007;45;1113;527;586
Mažeikiai d. mun.;2007;46;1062;509;553
Mažeikiai d. mun.;2007;47;1027;471;556
Mažeikiai d. mun.;2007;48;1040;472;568
Mažeikiai d. mun.;2007;49;907;433;474
Mažeikiai d. mun.;2007;50;868;406;462
Mažeikiai d. mun.;2007;51;863;399;464
Mažeikiai d. mun.;2007;52;740;336;404
Mažeikiai d. mun.;2007;53;717;344;373
Mažeikiai d. mun.;2007;54;744;345;399
Mažeikiai d. mun.;2007;55;701;314;387
Mažeikiai d. mun.;2007;56;739;361;378
Mažeikiai d. mun.;2007;57;689;312;377
Mažeikiai d. mun.;2007;58;657;296;361
Mažeikiai d. mun.;2007;59;551;236;315
Mažeikiai d. mun.;2007;60;520;213;307
Mažeikiai d. mun.;2007;61;564;224;340
Mažeikiai d. mun.;2007;62;455;170;285
Mažeikiai d. mun.;2007;63;483;192;291
Mažeikiai d. mun.;2007;64;517;207;310
Mažeikiai d. mun.;2007;65;565;229;336
Mažeikiai d. mun.;2007;66;455;186;269
Mažeikiai d. mun.;2007;67;459;164;295
Mažeikiai d. mun.;2007;68;465;195;270
Mažeikiai d. mun.;2007;69;472;164;308
Mažeikiai d. mun.;2007;70;516;205;311
Mažeikiai d. mun.;2007;71;482;170;312
Mažeikiai d. mun.;2007;72;412;146;266
Mažeikiai d. mun.;2007;73;425;141;284
Mažeikiai d. mun.;2007;74;431;153;278
Mažeikiai d. mun.;2007;75;408;138;270
Mažeikiai d. mun.;2007;76;380;128;252
Mažeikiai d. mun.;2007;77;340;116;224
Mažeikiai d. mun.;2007;78;398;121;277
Mažeikiai d. mun.;2007;79;301;70;231
Mažeikiai d. mun.;2007;80;280;71;209
Mažeikiai d. mun.;2007;81;272;84;188
Mažeikiai d. mun.;2007;82;252;64;188
Mažeikiai d. mun.;2007;83;229;71;158
Mažeikiai d. mun.;2007;84;180;47;133
Mažeikiai d. mun.;2007;85;622;166;456
Mažeikiai d. mun.;2008;-1;61932;29065;32867
Mažeikiai d. mun.;2008;0;608;302;306
Mažeikiai d. mun.;2008;1;615;291;324
Mažeikiai d. mun.;2008;2;587;313;274
Mažeikiai d. mun.;2008;3;626;311;315
Mažeikiai d. mun.;2008;4;607;314;293
Mažeikiai d. mun.;2008;5;600;316;284
Mažeikiai d. mun.;2008;6;627;325;302
Mažeikiai d. mun.;2008;7;696;350;346
Mažeikiai d. mun.;2008;8;801;434;367
Mažeikiai d. mun.;2008;9;789;408;381
Mažeikiai d. mun.;2008;10;773;410;363
Mažeikiai d. mun.;2008;11;848;458;390
Mažeikiai d. mun.;2008;12;912;451;461
Mažeikiai d. mun.;2008;13;886;440;446
Mažeikiai d. mun.;2008;14;1006;532;474
Mažeikiai d. mun.;2008;15;1188;593;595
Mažeikiai d. mun.;2008;16;1084;530;554
Mažeikiai d. mun.;2008;17;1032;570;462
Mažeikiai d. mun.;2008;18;1055;528;527
Mažeikiai d. mun.;2008;19;1024;515;509
Mažeikiai d. mun.;2008;20;1005;513;492
Mažeikiai d. mun.;2008;21;1005;523;482
Mažeikiai d. mun.;2008;22;1004;525;479
Mažeikiai d. mun.;2008;23;1006;522;484
Mažeikiai d. mun.;2008;24;954;491;463
Mažeikiai d. mun.;2008;25;795;424;371
Mažeikiai d. mun.;2008;26;664;399;265
Mažeikiai d. mun.;2008;27;704;368;336
Mažeikiai d. mun.;2008;28;761;395;366
Mažeikiai d. mun.;2008;29;825;423;402
Mažeikiai d. mun.;2008;30;844;447;397
Mažeikiai d. mun.;2008;31;847;426;421
Mažeikiai d. mun.;2008;32;856;399;457
Mažeikiai d. mun.;2008;33;866;405;461
Mažeikiai d. mun.;2008;34;872;411;461
Mažeikiai d. mun.;2008;35;876;434;442
Mažeikiai d. mun.;2008;36;904;433;471
Mažeikiai d. mun.;2008;37;959;459;500
Mažeikiai d. mun.;2008;38;916;458;458
Mažeikiai d. mun.;2008;39;833;375;458
Mažeikiai d. mun.;2008;40;895;420;475
Mažeikiai d. mun.;2008;41;919;457;462
Mažeikiai d. mun.;2008;42;879;408;471
Mažeikiai d. mun.;2008;43;923;446;477
Mažeikiai d. mun.;2008;44;935;424;511
Mažeikiai d. mun.;2008;45;1019;505;514
Mažeikiai d. mun.;2008;46;1087;512;575
Mažeikiai d. mun.;2008;47;1038;496;542
Mažeikiai d. mun.;2008;48;1009;456;553
Mažeikiai d. mun.;2008;49;1027;466;561
Mažeikiai d. mun.;2008;50;895;424;471
Mažeikiai d. mun.;2008;51;853;392;461
Mažeikiai d. mun.;2008;52;847;388;459
Mažeikiai d. mun.;2008;53;725;328;397
Mažeikiai d. mun.;2008;54;713;342;371
Mažeikiai d. mun.;2008;55;720;329;391
Mažeikiai d. mun.;2008;56;681;299;382
Mažeikiai d. mun.;2008;57;724;351;373
Mažeikiai d. mun.;2008;58;679;306;373
Mažeikiai d. mun.;2008;59;642;285;357
Mažeikiai d. mun.;2008;60;537;225;312
Mažeikiai d. mun.;2008;61;508;204;304
Mažeikiai d. mun.;2008;62;548;218;330
Mažeikiai d. mun.;2008;63;438;160;278
Mažeikiai d. mun.;2008;64;466;181;285
Mažeikiai d. mun.;2008;65;501;195;306
Mažeikiai d. mun.;2008;66;541;213;328
Mažeikiai d. mun.;2008;67;442;177;265
Mažeikiai d. mun.;2008;68;452;159;293
Mažeikiai d. mun.;2008;69;453;185;268
Mažeikiai d. mun.;2008;70;465;160;305
Mažeikiai d. mun.;2008;71;497;192;305
Mažeikiai d. mun.;2008;72;465;162;303
Mažeikiai d. mun.;2008;73;399;142;257
Mažeikiai d. mun.;2008;74;398;126;272
Mažeikiai d. mun.;2008;75;416;146;270
Mažeikiai d. mun.;2008;76;390;129;261
Mažeikiai d. mun.;2008;77;368;124;244
Mažeikiai d. mun.;2008;78;321;106;215
Mažeikiai d. mun.;2008;79;375;117;258
Mažeikiai d. mun.;2008;80;276;64;212
Mažeikiai d. mun.;2008;81;261;64;197
Mažeikiai d. mun.;2008;82;247;75;172
Mažeikiai d. mun.;2008;83;230;58;172
Mažeikiai d. mun.;2008;84;201;55;146
Mažeikiai d. mun.;2008;85;667;173;494
Mažeikiai d. mun.;2009;-1;61443;28848;32595
Mažeikiai d. mun.;2009;0;687;388;299
Mažeikiai d. mun.;2009;1;598;296;302
Mažeikiai d. mun.;2009;2;615;291;324
Mažeikiai d. mun.;2009;3;585;312;273
Mažeikiai d. mun.;2009;4;623;309;314
Mažeikiai d. mun.;2009;5;603;313;290
Mažeikiai d. mun.;2009;6;600;316;284
Mažeikiai d. mun.;2009;7;625;321;304
Mažeikiai d. mun.;2009;8;690;349;341
Mažeikiai d. mun.;2009;9;795;429;366
Mažeikiai d. mun.;2009;10;788;406;382
Mažeikiai d. mun.;2009;11;771;407;364
Mažeikiai d. mun.;2009;12;843;458;385
Mažeikiai d. mun.;2009;13;907;450;457
Mažeikiai d. mun.;2009;14;880;439;441
Mažeikiai d. mun.;2009;15;997;527;470
Mažeikiai d. mun.;2009;16;1178;587;591
Mažeikiai d. mun.;2009;17;1072;526;546
Mažeikiai d. mun.;2009;18;1017;563;454
Mažeikiai d. mun.;2009;19;1041;521;520
Mažeikiai d. mun.;2009;20;1009;506;503
Mažeikiai d. mun.;2009;21;989;503;486
Mažeikiai d. mun.;2009;22;988;515;473
Mažeikiai d. mun.;2009;23;977;513;464
Mažeikiai d. mun.;2009;24;993;516;477
Mažeikiai d. mun.;2009;25;932;476;456
Mažeikiai d. mun.;2009;26;776;417;359
Mažeikiai d. mun.;2009;27;630;382;248
Mažeikiai d. mun.;2009;28;692;372;320
Mažeikiai d. mun.;2009;29;752;389;363
Mažeikiai d. mun.;2009;30;802;407;395
Mažeikiai d. mun.;2009;31;827;434;393
Mažeikiai d. mun.;2009;32;838;422;416
Mažeikiai d. mun.;2009;33;850;392;458
Mažeikiai d. mun.;2009;34;857;401;456
Mažeikiai d. mun.;2009;35;855;398;457
Mažeikiai d. mun.;2009;36;871;432;439
Mažeikiai d. mun.;2009;37;896;426;470
Mažeikiai d. mun.;2009;38;939;446;493
Mažeikiai d. mun.;2009;39;909;456;453
Mažeikiai d. mun.;2009;40;830;374;456
Mažeikiai d. mun.;2009;41;886;415;471
Mažeikiai d. mun.;2009;42;907;451;456
Mažeikiai d. mun.;2009;43;868;401;467
Mažeikiai d. mun.;2009;44;919;444;475
Mažeikiai d. mun.;2009;45;921;416;505
Mažeikiai d. mun.;2009;46;1007;501;506
Mažeikiai d. mun.;2009;47;1072;503;569
Mažeikiai d. mun.;2009;48;1025;488;537
Mažeikiai d. mun.;2009;49;994;444;550
Mažeikiai d. mun.;2009;50;1014;458;556
Mažeikiai d. mun.;2009;51;873;406;467
Mažeikiai d. mun.;2009;52;840;383;457
Mažeikiai d. mun.;2009;53;837;382;455
Mažeikiai d. mun.;2009;54;705;317;388
Mažeikiai d. mun.;2009;55;706;341;365
Mažeikiai d. mun.;2009;56;706;321;385
Mažeikiai d. mun.;2009;57;671;290;381
Mažeikiai d. mun.;2009;58;714;345;369
Mažeikiai d. mun.;2009;59;665;299;366
Mažeikiai d. mun.;2009;60;624;273;351
Mažeikiai d. mun.;2009;61;533;222;311
Mažeikiai d. mun.;2009;62;493;194;299
Mažeikiai d. mun.;2009;63;536;210;326
Mažeikiai d. mun.;2009;64;436;160;276
Mažeikiai d. mun.;2009;65;458;175;283
Mažeikiai d. mun.;2009;66;483;184;299
Mažeikiai d. mun.;2009;67;528;207;321
Mažeikiai d. mun.;2009;68;433;171;262
Mažeikiai d. mun.;2009;69;446;154;292
Mažeikiai d. mun.;2009;70;433;170;263
Mažeikiai d. mun.;2009;71;455;156;299
Mažeikiai d. mun.;2009;72;478;181;297
Mažeikiai d. mun.;2009;73;447;155;292
Mažeikiai d. mun.;2009;74;382;131;251
Mažeikiai d. mun.;2009;75;386;121;265
Mažeikiai d. mun.;2009;76;396;136;260
Mažeikiai d. mun.;2009;77;376;123;253
Mažeikiai d. mun.;2009;78;351;117;234
Mažeikiai d. mun.;2009;79;305;101;204
Mažeikiai d. mun.;2009;80;340;106;234
Mažeikiai d. mun.;2009;81;258;56;202
Mažeikiai d. mun.;2009;82;233;56;177
Mažeikiai d. mun.;2009;83;224;65;159
Mažeikiai d. mun.;2009;84;209;49;160
Mažeikiai d. mun.;2009;85;743;185;558
Mažeikiai d. mun.;2010;-1;60471;28370;32101
Mažeikiai d. mun.;2010;0;620;328;292
Mažeikiai d. mun.;2010;1;674;381;293
Mažeikiai d. mun.;2010;2;582;288;294
Mažeikiai d. mun.;2010;3;608;291;317
Mažeikiai d. mun.;2010;4;580;308;272
Mažeikiai d. mun.;2010;5;615;306;309
Mažeikiai d. mun.;2010;6;599;311;288
Mažeikiai d. mun.;2010;7;592;311;281
Mažeikiai d. mun.;2010;8;614;316;298
Mažeikiai d. mun.;2010;9;687;346;341
Mažeikiai d. mun.;2010;10;785;423;362
Mažeikiai d. mun.;2010;11;780;401;379
Mažeikiai d. mun.;2010;12;769;405;364
Mažeikiai d. mun.;2010;13;840;452;388
Mažeikiai d. mun.;2010;14;906;451;455
Mažeikiai d. mun.;2010;15;875;435;440
Mažeikiai d. mun.;2010;16;995;522;473
Mažeikiai d. mun.;2010;17;1172;584;588
Mažeikiai d. mun.;2010;18;1056;520;536
Mažeikiai d. mun.;2010;19;1003;552;451
Mažeikiai d. mun.;2010;20;1012;512;500
Mažeikiai d. mun.;2010;21;977;488;489
Mažeikiai d. mun.;2010;22;941;486;455
Mažeikiai d. mun.;2010;23;947;493;454
Mažeikiai d. mun.;2010;24;930;491;439
Mažeikiai d. mun.;2010;25;944;492;452
Mažeikiai d. mun.;2010;26;894;457;437
Mažeikiai d. mun.;2010;27;737;394;343
Mažeikiai d. mun.;2010;28;596;360;236
Mažeikiai d. mun.;2010;29;663;361;302
Mažeikiai d. mun.;2010;30;731;376;355
Mažeikiai d. mun.;2010;31;779;399;380
Mažeikiai d. mun.;2010;32;810;428;382
Mažeikiai d. mun.;2010;33;819;410;409
Mažeikiai d. mun.;2010;34;824;376;448
Mažeikiai d. mun.;2010;35;836;387;449
Mažeikiai d. mun.;2010;36;833;388;445
Mažeikiai d. mun.;2010;37;852;415;437
Mažeikiai d. mun.;2010;38;881;415;466
Mažeikiai d. mun.;2010;39;930;441;489
Mažeikiai d. mun.;2010;40;890;442;448
Mažeikiai d. mun.;2010;41;813;363;450
Mažeikiai d. mun.;2010;42;873;404;469
Mažeikiai d. mun.;2010;43;890;439;451
Mažeikiai d. mun.;2010;44;856;394;462
Mažeikiai d. mun.;2010;45;881;416;465
Mažeikiai d. mun.;2010;46;904;406;498
Mažeikiai d. mun.;2010;47;993;493;500
Mažeikiai d. mun.;2010;48;1061;497;564
Mažeikiai d. mun.;2010;49;1008;479;529
Mažeikiai d. mun.;2010;50;986;439;547
Mažeikiai d. mun.;2010;51;999;453;546
Mažeikiai d. mun.;2010;52;858;397;461
Mažeikiai d. mun.;2010;53;825;373;452
Mažeikiai d. mun.;2010;54;820;371;449
Mažeikiai d. mun.;2010;55;692;310;382
Mažeikiai d. mun.;2010;56;683;327;356
Mažeikiai d. mun.;2010;57;693;310;383
Mažeikiai d. mun.;2010;58;660;286;374
Mažeikiai d. mun.;2010;59;702;337;365
Mažeikiai d. mun.;2010;60;651;292;359
Mažeikiai d. mun.;2010;61;608;265;343
Mažeikiai d. mun.;2010;62;517;209;308
Mažeikiai d. mun.;2010;63;483;188;295
Mažeikiai d. mun.;2010;64;520;200;320
Mažeikiai d. mun.;2010;65;424;151;273
Mažeikiai d. mun.;2010;66;448;168;280
Mažeikiai d. mun.;2010;67;468;177;291
Mažeikiai d. mun.;2010;68;511;200;311
Mažeikiai d. mun.;2010;69;423;162;261
Mažeikiai d. mun.;2010;70;433;147;286
Mažeikiai d. mun.;2010;71;422;166;256
Mažeikiai d. mun.;2010;72;435;146;289
Mažeikiai d. mun.;2010;73;466;175;291
Mažeikiai d. mun.;2010;74;432;148;284
Mažeikiai d. mun.;2010;75;365;124;241
Mažeikiai d. mun.;2010;76;368;114;254
Mažeikiai d. mun.;2010;77;377;125;252
Mažeikiai d. mun.;2010;78;356;113;243
Mažeikiai d. mun.;2010;79;333;114;219
Mažeikiai d. mun.;2010;80;293;94;199
Mažeikiai d. mun.;2010;81;312;90;222
Mažeikiai d. mun.;2010;82;238;51;187
Mažeikiai d. mun.;2010;83;215;52;163
Mažeikiai d. mun.;2010;84;203;57;146
Mažeikiai d. mun.;2010;85;795;206;589
Mažeikiai d. mun.;2011;-1;58431;27364;31067
Mažeikiai d. mun.;2011;0;577;300;277
Mažeikiai d. mun.;2011;1;590;309;281
Mažeikiai d. mun.;2011;2;638;356;282
Mažeikiai d. mun.;2011;3;553;271;282
Mažeikiai d. mun.;2011;4;580;276;304
Mažeikiai d. mun.;2011;5;557;297;260
Mažeikiai d. mun.;2011;6;605;291;314
Mažeikiai d. mun.;2011;7;581;300;281
Mažeikiai d. mun.;2011;8;595;307;288
Mažeikiai d. mun.;2011;9;601;314;287
Mažeikiai d. mun.;2011;10;690;352;338
Mažeikiai d. mun.;2011;11;777;410;367
Mažeikiai d. mun.;2011;12;773;405;368
Mažeikiai d. mun.;2011;13;748;388;360
Mažeikiai d. mun.;2011;14;834;445;389
Mažeikiai d. mun.;2011;15;889;434;455
Mažeikiai d. mun.;2011;16;863;432;431
Mažeikiai d. mun.;2011;17;1001;521;480
Mažeikiai d. mun.;2011;18;1129;564;565
Mažeikiai d. mun.;2011;19;868;448;420
Mažeikiai d. mun.;2011;20;834;462;372
Mažeikiai d. mun.;2011;21;785;412;373
Mažeikiai d. mun.;2011;22;761;398;363
Mažeikiai d. mun.;2011;23;761;412;349
Mažeikiai d. mun.;2011;24;747;397;350
Mažeikiai d. mun.;2011;25;681;354;327
Mažeikiai d. mun.;2011;26;692;367;325
Mažeikiai d. mun.;2011;27;650;358;292
Mažeikiai d. mun.;2011;28;651;335;316
Mažeikiai d. mun.;2011;29;617;333;284
Mažeikiai d. mun.;2011;30;663;318;345
Mažeikiai d. mun.;2011;31;687;342;345
Mažeikiai d. mun.;2011;32;690;327;363
Mažeikiai d. mun.;2011;33;714;367;347
Mažeikiai d. mun.;2011;34;783;388;395
Mažeikiai d. mun.;2011;35;761;353;408
Mažeikiai d. mun.;2011;36;834;384;450
Mažeikiai d. mun.;2011;37;833;392;441
Mažeikiai d. mun.;2011;38;856;423;433
Mažeikiai d. mun.;2011;39;916;449;467
Mažeikiai d. mun.;2011;40;931;446;485
Mažeikiai d. mun.;2011;41;888;437;451
Mažeikiai d. mun.;2011;42;859;391;468
Mažeikiai d. mun.;2011;43;879;403;476
Mažeikiai d. mun.;2011;44;904;440;464
Mažeikiai d. mun.;2011;45;839;393;446
Mažeikiai d. mun.;2011;46;909;423;486
Mažeikiai d. mun.;2011;47;908;413;495
Mažeikiai d. mun.;2011;48;990;491;499
Mažeikiai d. mun.;2011;49;1041;491;550
Mažeikiai d. mun.;2011;50;1010;474;536
Mažeikiai d. mun.;2011;51;988;442;546
Mažeikiai d. mun.;2011;52;1001;448;553
Mažeikiai d. mun.;2011;53;884;420;464
Mažeikiai d. mun.;2011;54;814;372;442
Mažeikiai d. mun.;2011;55;853;401;452
Mažeikiai d. mun.;2011;56;694;319;375
Mažeikiai d. mun.;2011;57;677;324;353
Mažeikiai d. mun.;2011;58;713;332;381
Mažeikiai d. mun.;2011;59;671;294;377
Mažeikiai d. mun.;2011;60;690;326;364
Mažeikiai d. mun.;2011;61;660;290;370
Mažeikiai d. mun.;2011;62;644;284;360
Mažeikiai d. mun.;2011;63;531;222;309
Mažeikiai d. mun.;2011;64;502;208;294
Mažeikiai d. mun.;2011;65;536;211;325
Mažeikiai d. mun.;2011;66;437;157;280
Mažeikiai d. mun.;2011;67;464;181;283
Mažeikiai d. mun.;2011;68;497;189;308
Mažeikiai d. mun.;2011;69;524;209;315
Mažeikiai d. mun.;2011;70;439;168;271
Mažeikiai d. mun.;2011;71;438;150;288
Mažeikiai d. mun.;2011;72;405;159;246
Mažeikiai d. mun.;2011;73;423;140;283
Mažeikiai d. mun.;2011;74;457;169;288
Mažeikiai d. mun.;2011;75;430;142;288
Mažeikiai d. mun.;2011;76;345;114;231
Mažeikiai d. mun.;2011;77;353;112;241
Mažeikiai d. mun.;2011;78;366;122;244
Mažeikiai d. mun.;2011;79;342;103;239
Mažeikiai d. mun.;2011;80;313;96;217
Mažeikiai d. mun.;2011;81;274;85;189
Mažeikiai d. mun.;2011;82;280;79;201
Mažeikiai d. mun.;2011;83;245;54;191
Mažeikiai d. mun.;2011;84;191;47;144
Mažeikiai d. mun.;2011;85;827;202;625
Mažeikiai d. mun.;2012;-1;57457;26874;30583
Mažeikiai d. mun.;2012;0;654;341;313
Mažeikiai d. mun.;2012;1;579;302;277
Mažeikiai d. mun.;2012;2;581;302;279
Mažeikiai d. mun.;2012;3;617;344;273
Mažeikiai d. mun.;2012;4;543;264;279
Mažeikiai d. mun.;2012;5;576;275;301
Mažeikiai d. mun.;2012;6;549;291;258
Mažeikiai d. mun.;2012;7;603;290;313
Mažeikiai d. mun.;2012;8;576;301;275
Mažeikiai d. mun.;2012;9;591;305;286
Mažeikiai d. mun.;2012;10;606;314;292
Mažeikiai d. mun.;2012;11;677;344;333
Mažeikiai d. mun.;2012;12;766;402;364
Mažeikiai d. mun.;2012;13;766;400;366
Mažeikiai d. mun.;2012;14;736;376;360
Mažeikiai d. mun.;2012;15;823;441;382
Mažeikiai d. mun.;2012;16;878;432;446
Mažeikiai d. mun.;2012;17;853;426;427
Mažeikiai d. mun.;2012;18;993;515;478
Mažeikiai d. mun.;2012;19;1081;544;537
Mažeikiai d. mun.;2012;20;841;435;406
Mažeikiai d. mun.;2012;21;815;453;362
Mažeikiai d. mun.;2012;22;749;391;358
Mažeikiai d. mun.;2012;23;710;383;327
Mažeikiai d. mun.;2012;24;714;396;318
Mažeikiai d. mun.;2012;25;693;372;321
Mažeikiai d. mun.;2012;26;632;320;312
Mažeikiai d. mun.;2012;27;647;341;306
Mažeikiai d. mun.;2012;28;602;335;267
Mažeikiai d. mun.;2012;29;622;317;305
Mažeikiai d. mun.;2012;30;591;320;271
Mažeikiai d. mun.;2012;31;642;301;341
Mažeikiai d. mun.;2012;32;650;326;324
Mažeikiai d. mun.;2012;33;667;313;354
Mažeikiai d. mun.;2012;34;696;352;344
Mažeikiai d. mun.;2012;35;750;373;377
Mažeikiai d. mun.;2012;36;741;349;392
Mažeikiai d. mun.;2012;37;819;377;442
Mažeikiai d. mun.;2012;38;818;382;436
Mažeikiai d. mun.;2012;39;839;410;429
Mažeikiai d. mun.;2012;40;904;450;454
Mažeikiai d. mun.;2012;41;917;439;478
Mažeikiai d. mun.;2012;42;870;427;443
Mažeikiai d. mun.;2012;43;837;380;457
Mažeikiai d. mun.;2012;44;869;398;471
Mažeikiai d. mun.;2012;45;888;432;456
Mažeikiai d. mun.;2012;46;821;381;440
Mažeikiai d. mun.;2012;47;905;421;484
Mažeikiai d. mun.;2012;48;902;412;490
Mažeikiai d. mun.;2012;49;986;491;495
Mažeikiai d. mun.;2012;50;1022;482;540
Mažeikiai d. mun.;2012;51;993;464;529
Mažeikiai d. mun.;2012;52;965;426;539
Mažeikiai d. mun.;2012;53;985;437;548
Mažeikiai d. mun.;2012;54;881;417;464
Mažeikiai d. mun.;2012;55;796;359;437
Mažeikiai d. mun.;2012;56;839;394;445
Mažeikiai d. mun.;2012;57;690;317;373
Mažeikiai d. mun.;2012;58;664;315;349
Mažeikiai d. mun.;2012;59;701;323;378
Mažeikiai d. mun.;2012;60;659;282;377
Mažeikiai d. mun.;2012;61;675;312;363
Mažeikiai d. mun.;2012;62;646;280;366
Mažeikiai d. mun.;2012;63;631;273;358
Mažeikiai d. mun.;2012;64;517;212;305
Mažeikiai d. mun.;2012;65;496;206;290
Mažeikiai d. mun.;2012;66;527;207;320
Mažeikiai d. mun.;2012;67;427;150;277
Mažeikiai d. mun.;2012;68;451;175;276
Mažeikiai d. mun.;2012;69;484;182;302
Mažeikiai d. mun.;2012;70;510;201;309
Mažeikiai d. mun.;2012;71;428;163;265
Mažeikiai d. mun.;2012;72;423;143;280
Mažeikiai d. mun.;2012;73;388;145;243
Mažeikiai d. mun.;2012;74;406;132;274
Mažeikiai d. mun.;2012;75;436;154;282
Mažeikiai d. mun.;2012;76;416;134;282
Mažeikiai d. mun.;2012;77;329;107;222
Mažeikiai d. mun.;2012;78;330;101;229
Mažeikiai d. mun.;2012;79;345;113;232
Mažeikiai d. mun.;2012;80;317;88;229
Mažeikiai d. mun.;2012;81;296;88;208
Mažeikiai d. mun.;2012;82;254;78;176
Mažeikiai d. mun.;2012;83;252;69;183
Mažeikiai d. mun.;2012;84;230;51;179
Mažeikiai d. mun.;2012;85;863;208;655
Mažeikiai d. mun.;2013;-1;56773;26564;30209
Mažeikiai d. mun.;2013;0;650;331;319
Mažeikiai d. mun.;2013;1;647;333;314
Mažeikiai d. mun.;2013;2;576;296;280
Mažeikiai d. mun.;2013;3;574;299;275
Mažeikiai d. mun.;2013;4;609;345;264
Mažeikiai d. mun.;2013;5;538;258;280
Mažeikiai d. mun.;2013;6;566;267;299
Mažeikiai d. mun.;2013;7;542;289;253
Mažeikiai d. mun.;2013;8;590;284;306
Mažeikiai d. mun.;2013;9;574;298;276
Mažeikiai d. mun.;2013;10;585;302;283
Mažeikiai d. mun.;2013;11;591;307;284
Mažeikiai d. mun.;2013;12;672;341;331
Mažeikiai d. mun.;2013;13;766;401;365
Mažeikiai d. mun.;2013;14;767;399;368
Mažeikiai d. mun.;2013;15;727;371;356
Mažeikiai d. mun.;2013;16;817;438;379
Mažeikiai d. mun.;2013;17;868;429;439
Mažeikiai d. mun.;2013;18;836;417;419
Mažeikiai d. mun.;2013;19;955;500;455
Mažeikiai d. mun.;2013;20;1063;538;525
Mažeikiai d. mun.;2013;21;832;420;412
Mažeikiai d. mun.;2013;22;781;439;342
Mažeikiai d. mun.;2013;23;722;383;339
Mažeikiai d. mun.;2013;24;684;372;312
Mažeikiai d. mun.;2013;25;693;385;308
Mažeikiai d. mun.;2013;26;667;363;304
Mažeikiai d. mun.;2013;27;612;316;296
Mažeikiai d. mun.;2013;28;609;329;280
Mažeikiai d. mun.;2013;29;570;313;257
Mažeikiai d. mun.;2013;30;580;297;283
Mažeikiai d. mun.;2013;31;579;307;272
Mažeikiai d. mun.;2013;32;630;300;330
Mažeikiai d. mun.;2013;33;637;317;320
Mažeikiai d. mun.;2013;34;651;306;345
Mažeikiai d. mun.;2013;35;676;345;331
Mažeikiai d. mun.;2013;36;735;364;371
Mažeikiai d. mun.;2013;37;722;339;383
Mažeikiai d. mun.;2013;38;816;373;443
Mažeikiai d. mun.;2013;39;820;385;435
Mažeikiai d. mun.;2013;40;826;403;423
Mažeikiai d. mun.;2013;41;903;448;455
Mažeikiai d. mun.;2013;42;910;434;476
Mažeikiai d. mun.;2013;43;852;421;431
Mažeikiai d. mun.;2013;44;831;374;457
Mažeikiai d. mun.;2013;45;859;394;465
Mažeikiai d. mun.;2013;46;874;425;449
Mažeikiai d. mun.;2013;47;813;377;436
Mažeikiai d. mun.;2013;48;889;412;477
Mažeikiai d. mun.;2013;49;890;404;486
Mažeikiai d. mun.;2013;50;979;489;490
Mažeikiai d. mun.;2013;51;1023;488;535
Mažeikiai d. mun.;2013;52;989;465;524
Mažeikiai d. mun.;2013;53;954;420;534
Mažeikiai d. mun.;2013;54;965;423;542
Mažeikiai d. mun.;2013;55;875;415;460
Mažeikiai d. mun.;2013;56;777;348;429
Mažeikiai d. mun.;2013;57;825;386;439
Mažeikiai d. mun.;2013;58;672;304;368
Mažeikiai d. mun.;2013;59;656;309;347
Mažeikiai d. mun.;2013;60;693;317;376
Mažeikiai d. mun.;2013;61;651;278;373
Mažeikiai d. mun.;2013;62;664;304;360
Mažeikiai d. mun.;2013;63;635;273;362
Mažeikiai d. mun.;2013;64;621;266;355
Mažeikiai d. mun.;2013;65;509;207;302
Mažeikiai d. mun.;2013;66;486;200;286
Mažeikiai d. mun.;2013;67;508;198;310
Mažeikiai d. mun.;2013;68;409;139;270
Mažeikiai d. mun.;2013;69;439;167;272
Mažeikiai d. mun.;2013;70;473;176;297
Mažeikiai d. mun.;2013;71;488;187;301
Mažeikiai d. mun.;2013;72;419;157;262
Mažeikiai d. mun.;2013;73;414;140;274
Mažeikiai d. mun.;2013;74;377;141;236
Mažeikiai d. mun.;2013;75;391;125;266
Mažeikiai d. mun.;2013;76;417;144;273
Mažeikiai d. mun.;2013;77;393;123;270
Mažeikiai d. mun.;2013;78;313;100;213
Mažeikiai d. mun.;2013;79;318;91;227
Mažeikiai d. mun.;2013;80;322;104;218
Mažeikiai d. mun.;2013;81;292;75;217
Mažeikiai d. mun.;2013;82;275;81;194
Mažeikiai d. mun.;2013;83;229;69;160
Mažeikiai d. mun.;2013;84;227;59;168
Mažeikiai d. mun.;2013;85;919;208;711
Mažeikiai d. mun.;2014;-1;56119;26238;29881
Mažeikiai d. mun.;2014;0;597;307;290
Mažeikiai d. mun.;2014;1;660;338;322
Mažeikiai d. mun.;2014;2;635;323;312
Mažeikiai d. mun.;2014;3;570;294;276
Mažeikiai d. mun.;2014;4;577;299;278
Mažeikiai d. mun.;2014;5;614;350;264
Mažeikiai d. mun.;2014;6;535;259;276
Mažeikiai d. mun.;2014;7;560;268;292
Mažeikiai d. mun.;2014;8;534;285;249
Mažeikiai d. mun.;2014;9;591;285;306
Mažeikiai d. mun.;2014;10;566;293;273
Mažeikiai d. mun.;2014;11;579;301;278
Mažeikiai d. mun.;2014;12;583;302;281
Mažeikiai d. mun.;2014;13;667;337;330
Mažeikiai d. mun.;2014;14;759;397;362
Mažeikiai d. mun.;2014;15;764;396;368
Mažeikiai d. mun.;2014;16;722;368;354
Mažeikiai d. mun.;2014;17;815;436;379
Mažeikiai d. mun.;2014;18;862;426;436
Mažeikiai d. mun.;2014;19;819;411;408
Mažeikiai d. mun.;2014;20;925;483;442
Mažeikiai d. mun.;2014;21;1017;517;500
Mažeikiai d. mun.;2014;22;799;411;388
Mažeikiai d. mun.;2014;23;739;418;321
Mažeikiai d. mun.;2014;24;692;376;316
Mažeikiai d. mun.;2014;25;667;362;305
Mažeikiai d. mun.;2014;26;672;379;293
Mažeikiai d. mun.;2014;27;631;340;291
Mažeikiai d. mun.;2014;28;606;310;296
Mažeikiai d. mun.;2014;29;592;317;275
Mažeikiai d. mun.;2014;30;551;300;251
Mažeikiai d. mun.;2014;31;590;304;286
Mažeikiai d. mun.;2014;32;580;303;277
Mažeikiai d. mun.;2014;33;613;288;325
Mažeikiai d. mun.;2014;34;638;320;318
Mažeikiai d. mun.;2014;35;630;300;330
Mažeikiai d. mun.;2014;36;664;338;326
Mažeikiai d. mun.;2014;37;719;350;369
Mažeikiai d. mun.;2014;38;716;337;379
Mažeikiai d. mun.;2014;39;801;364;437
Mažeikiai d. mun.;2014;40;813;380;433
Mažeikiai d. mun.;2014;41;808;390;418
Mažeikiai d. mun.;2014;42;900;449;451
Mažeikiai d. mun.;2014;43;899;427;472
Mažeikiai d. mun.;2014;44;834;409;425
Mažeikiai d. mun.;2014;45;826;370;456
Mažeikiai d. mun.;2014;46;853;389;464
Mažeikiai d. mun.;2014;47;870;423;447
Mažeikiai d. mun.;2014;48;806;372;434
Mažeikiai d. mun.;2014;49;891;412;479
Mažeikiai d. mun.;2014;50;883;403;480
Mažeikiai d. mun.;2014;51;957;477;480
Mažeikiai d. mun.;2014;52;1014;484;530
Mažeikiai d. mun.;2014;53;969;454;515
Mažeikiai d. mun.;2014;54;941;415;526
Mažeikiai d. mun.;2014;55;947;410;537
Mažeikiai d. mun.;2014;56;860;406;454
Mažeikiai d. mun.;2014;57;762;337;425
Mažeikiai d. mun.;2014;58;812;375;437
Mažeikiai d. mun.;2014;59;663;297;366
Mažeikiai d. mun.;2014;60;653;307;346
Mažeikiai d. mun.;2014;61;683;309;374
Mažeikiai d. mun.;2014;62;637;269;368
Mažeikiai d. mun.;2014;63;651;296;355
Mažeikiai d. mun.;2014;64;625;264;361
Mažeikiai d. mun.;2014;65;608;257;351
Mažeikiai d. mun.;2014;66;500;199;301
Mažeikiai d. mun.;2014;67;475;194;281
Mažeikiai d. mun.;2014;68;492;186;306
Mažeikiai d. mun.;2014;69;403;134;269
Mažeikiai d. mun.;2014;70;421;159;262
Mažeikiai d. mun.;2014;71;455;165;290
Mažeikiai d. mun.;2014;72;473;178;295
Mažeikiai d. mun.;2014;73;409;148;261
Mažeikiai d. mun.;2014;74;396;131;265
Mažeikiai d. mun.;2014;75;359;133;226
Mažeikiai d. mun.;2014;76;378;116;262
Mažeikiai d. mun.;2014;77;390;135;255
Mažeikiai d. mun.;2014;78;367;112;255
Mažeikiai d. mun.;2014;79;297;91;206
Mažeikiai d. mun.;2014;80;296;81;215
Mažeikiai d. mun.;2014;81;295;94;201
Mažeikiai d. mun.;2014;82;267;64;203
Mažeikiai d. mun.;2014;83;245;67;178
Mažeikiai d. mun.;2014;84;207;59;148
Mažeikiai d. mun.;2014;85;978;219;759
Mažeikiai d. mun.;2015;-1;55441;25955;29486
Mažeikiai d. mun.;2015;0;572;285;287
Mažeikiai d. mun.;2015;1;598;306;292
Mažeikiai d. mun.;2015;2;661;337;324
Mažeikiai d. mun.;2015;3;634;325;309
Mažeikiai d. mun.;2015;4;571;297;274
Mažeikiai d. mun.;2015;5;569;292;277
Mažeikiai d. mun.;2015;6;603;348;255
Mažeikiai d. mun.;2015;7;533;256;277
Mažeikiai d. mun.;2015;8;568;270;298
Mažeikiai d. mun.;2015;9;530;286;244
Mažeikiai d. mun.;2015;10;587;285;302
Mažeikiai d. mun.;2015;11;556;287;269
Mažeikiai d. mun.;2015;12;578;299;279
Mažeikiai d. mun.;2015;13;583;304;279
Mažeikiai d. mun.;2015;14;657;335;322
Mažeikiai d. mun.;2015;15;755;396;359
Mažeikiai d. mun.;2015;16;758;395;363
Mažeikiai d. mun.;2015;17;715;363;352
Mažeikiai d. mun.;2015;18;798;430;368
Mažeikiai d. mun.;2015;19;838;413;425
Mažeikiai d. mun.;2015;20;797;404;393
Mažeikiai d. mun.;2015;21;912;472;440
Mažeikiai d. mun.;2015;22;982;494;488
Mažeikiai d. mun.;2015;23;758;400;358
Mažeikiai d. mun.;2015;24;693;396;297
Mažeikiai d. mun.;2015;25;640;358;282
Mažeikiai d. mun.;2015;26;647;350;297
Mažeikiai d. mun.;2015;27;639;365;274
Mažeikiai d. mun.;2015;28;621;337;284
Mažeikiai d. mun.;2015;29;593;302;291
Mažeikiai d. mun.;2015;30;569;299;270
Mažeikiai d. mun.;2015;31;533;296;237
Mažeikiai d. mun.;2015;32;571;295;276
Mažeikiai d. mun.;2015;33;583;308;275
Mažeikiai d. mun.;2015;34;618;295;323
Mažeikiai d. mun.;2015;35;628;312;316
Mažeikiai d. mun.;2015;36;621;294;327
Mažeikiai d. mun.;2015;37;659;334;325
Mažeikiai d. mun.;2015;38;712;346;366
Mažeikiai d. mun.;2015;39;708;330;378
Mažeikiai d. mun.;2015;40;792;359;433
Mažeikiai d. mun.;2015;41;815;381;434
Mažeikiai d. mun.;2015;42;803;386;417
Mažeikiai d. mun.;2015;43;897;452;445
Mažeikiai d. mun.;2015;44;897;430;467
Mažeikiai d. mun.;2015;45;826;404;422
Mažeikiai d. mun.;2015;46;826;375;451
Mažeikiai d. mun.;2015;47;844;385;459
Mažeikiai d. mun.;2015;48;864;418;446
Mažeikiai d. mun.;2015;49;803;373;430
Mažeikiai d. mun.;2015;50;883;406;477
Mažeikiai d. mun.;2015;51;874;397;477
Mažeikiai d. mun.;2015;52;940;469;471
Mažeikiai d. mun.;2015;53;995;470;525
Mažeikiai d. mun.;2015;54;961;448;513
Mažeikiai d. mun.;2015;55;935;412;523
Mažeikiai d. mun.;2015;56;941;407;534
Mažeikiai d. mun.;2015;57;855;401;454
Mažeikiai d. mun.;2015;58;753;331;422
Mažeikiai d. mun.;2015;59;800;369;431
Mažeikiai d. mun.;2015;60;650;288;362
Mažeikiai d. mun.;2015;61;642;303;339
Mažeikiai d. mun.;2015;62;674;306;368
Mažeikiai d. mun.;2015;63;623;261;362
Mažeikiai d. mun.;2015;64;637;281;356
Mažeikiai d. mun.;2015;65;608;252;356
Mažeikiai d. mun.;2015;66;598;248;350
Mažeikiai d. mun.;2015;67;490;192;298
Mažeikiai d. mun.;2015;68;457;184;273
Mažeikiai d. mun.;2015;69;482;177;305
Mažeikiai d. mun.;2015;70;388;126;262
Mažeikiai d. mun.;2015;71;411;152;259
Mažeikiai d. mun.;2015;72;440;158;282
Mažeikiai d. mun.;2015;73;450;167;283
Mažeikiai d. mun.;2015;74;390;141;249
Mažeikiai d. mun.;2015;75;379;122;257
Mažeikiai d. mun.;2015;76;337;121;216
Mažeikiai d. mun.;2015;77;361;111;250
Mažeikiai d. mun.;2015;78;362;115;247
Mažeikiai d. mun.;2015;79;344;102;242
Mažeikiai d. mun.;2015;80;281;84;197
Mažeikiai d. mun.;2015;81;275;75;200
Mažeikiai d. mun.;2015;82;263;80;183
Mažeikiai d. mun.;2015;83;241;54;187
Mažeikiai d. mun.;2015;84;225;58;167
Mažeikiai d. mun.;2015;85;981;228;753
Mažeikiai d. mun.;2016;-1;54773;25623;29150
Mažeikiai d. mun.;2016;0;621;301;320
Mažeikiai d. mun.;2016;1;574;283;291
Mažeikiai d. mun.;2016;2;599;306;293
Mažeikiai d. mun.;2016;3;649;330;319
Mažeikiai d. mun.;2016;4;635;328;307
Mažeikiai d. mun.;2016;5;568;297;271
Mažeikiai d. mun.;2016;6;566;292;274
Mažeikiai d. mun.;2016;7;599;344;255
Mažeikiai d. mun.;2016;8;533;255;278
Mažeikiai d. mun.;2016;9;559;268;291
Mažeikiai d. mun.;2016;10;527;285;242
Mažeikiai d. mun.;2016;11;580;277;303
Mažeikiai d. mun.;2016;12;547;284;263
Mažeikiai d. mun.;2016;13;573;296;277
Mažeikiai d. mun.;2016;14;574;301;273
Mažeikiai d. mun.;2016;15;651;333;318
Mažeikiai d. mun.;2016;16;751;394;357
Mažeikiai d. mun.;2016;17;761;398;363
Mažeikiai d. mun.;2016;18;709;361;348
Mažeikiai d. mun.;2016;19;786;426;360
Mažeikiai d. mun.;2016;20;817;403;414
Mažeikiai d. mun.;2016;21;777;392;385
Mažeikiai d. mun.;2016;22;878;457;421
Mažeikiai d. mun.;2016;23;944;489;455
Mažeikiai d. mun.;2016;24;723;380;343
Mažeikiai d. mun.;2016;25;666;373;293
Mažeikiai d. mun.;2016;26;593;339;254
Mažeikiai d. mun.;2016;27;619;337;282
Mažeikiai d. mun.;2016;28;614;343;271
Mažeikiai d. mun.;2016;29;592;325;267
Mažeikiai d. mun.;2016;30;573;290;283
Mažeikiai d. mun.;2016;31;553;292;261
Mažeikiai d. mun.;2016;32;518;289;229
Mažeikiai d. mun.;2016;33;559;287;272
Mažeikiai d. mun.;2016;34;576;306;270
Mažeikiai d. mun.;2016;35;598;280;318
Mažeikiai d. mun.;2016;36;617;305;312
Mažeikiai d. mun.;2016;37;620;295;325
Mažeikiai d. mun.;2016;38;639;324;315
Mažeikiai d. mun.;2016;39;705;345;360
Mažeikiai d. mun.;2016;40;713;333;380
Mažeikiai d. mun.;2016;41;787;356;431
Mažeikiai d. mun.;2016;42;794;371;423
Mažeikiai d. mun.;2016;43;794;379;415
Mažeikiai d. mun.;2016;44;884;446;438
Mažeikiai d. mun.;2016;45;877;419;458
Mažeikiai d. mun.;2016;46;817;402;415
Mažeikiai d. mun.;2016;47;816;368;448
Mažeikiai d. mun.;2016;48;837;381;456
Mažeikiai d. mun.;2016;49;860;416;444
Mažeikiai d. mun.;2016;50;800;369;431
Mažeikiai d. mun.;2016;51;870;399;471
Mažeikiai d. mun.;2016;52;870;396;474
Mažeikiai d. mun.;2016;53;927;457;470
Mažeikiai d. mun.;2016;54;984;463;521
Mažeikiai d. mun.;2016;55;947;439;508
Mažeikiai d. mun.;2016;56;919;405;514
Mažeikiai d. mun.;2016;57;936;402;534
Mažeikiai d. mun.;2016;58;847;398;449
Mažeikiai d. mun.;2016;59;743;325;418
Mažeikiai d. mun.;2016;60;790;365;425
Mažeikiai d. mun.;2016;61;644;282;362
Mažeikiai d. mun.;2016;62;631;294;337
Mažeikiai d. mun.;2016;63;662;298;364
Mažeikiai d. mun.;2016;64;613;253;360
Mažeikiai d. mun.;2016;65;622;271;351
Mažeikiai d. mun.;2016;66;596;244;352
Mažeikiai d. mun.;2016;67;579;235;344
Mažeikiai d. mun.;2016;68;479;186;293
Mažeikiai d. mun.;2016;69;443;175;268
Mažeikiai d. mun.;2016;70;469;169;300
Mažeikiai d. mun.;2016;71;382;118;264
Mažeikiai d. mun.;2016;72;402;144;258
Mažeikiai d. mun.;2016;73;417;141;276
Mažeikiai d. mun.;2016;74;438;163;275
Mažeikiai d. mun.;2016;75;375;132;243
Mažeikiai d. mun.;2016;76;362;111;251
Mažeikiai d. mun.;2016;77;322;116;206
Mažeikiai d. mun.;2016;78;340;102;238
Mažeikiai d. mun.;2016;79;339;105;234
Mažeikiai d. mun.;2016;80;321;94;227
Mažeikiai d. mun.;2016;81;267;77;190
Mažeikiai d. mun.;2016;82;250;65;185
Mažeikiai d. mun.;2016;83;236;68;168
Mažeikiai d. mun.;2016;84;216;46;170
Mažeikiai d. mun.;2016;85;1013;235;778
Mažeikiai d. mun.;2017;-1;53380;24940;28440
Mažeikiai d. mun.;2017;0;565;288;277
Mažeikiai d. mun.;2017;1;620;295;325
Mažeikiai d. mun.;2017;2;559;278;281
Mažeikiai d. mun.;2017;3;584;299;285
Mažeikiai d. mun.;2017;4;634;323;311
Mažeikiai d. mun.;2017;5;622;319;303
Mažeikiai d. mun.;2017;6;558;293;265
Mažeikiai d. mun.;2017;7;549;283;266
Mažeikiai d. mun.;2017;8;583;336;247
Mažeikiai d. mun.;2017;9;529;253;276
Mažeikiai d. mun.;2017;10;542;261;281
Mažeikiai d. mun.;2017;11;513;277;236
Mažeikiai d. mun.;2017;12;566;272;294
Mažeikiai d. mun.;2017;13;534;273;261
Mažeikiai d. mun.;2017;14;554;285;269
Mažeikiai d. mun.;2017;15;564;296;268
Mažeikiai d. mun.;2017;16;639;325;314
Mažeikiai d. mun.;2017;17;744;392;352
Mažeikiai d. mun.;2017;18;751;391;360
Mažeikiai d. mun.;2017;19;666;340;326
Mažeikiai d. mun.;2017;20;761;417;344
Mažeikiai d. mun.;2017;21;780;387;393
Mažeikiai d. mun.;2017;22;739;377;362
Mažeikiai d. mun.;2017;23;821;425;396
Mažeikiai d. mun.;2017;24;877;465;412
Mažeikiai d. mun.;2017;25;673;357;316
Mažeikiai d. mun.;2017;26;606;349;257
Mažeikiai d. mun.;2017;27;536;312;224
Mažeikiai d. mun.;2017;28;569;310;259
Mažeikiai d. mun.;2017;29;553;320;233
Mažeikiai d. mun.;2017;30;545;295;250
Mažeikiai d. mun.;2017;31;525;262;263
Mažeikiai d. mun.;2017;32;515;271;244
Mažeikiai d. mun.;2017;33;463;257;206
Mažeikiai d. mun.;2017;34;519;265;254
Mažeikiai d. mun.;2017;35;549;287;262
Mažeikiai d. mun.;2017;36;587;276;311
Mažeikiai d. mun.;2017;37;593;289;304
Mažeikiai d. mun.;2017;38;592;281;311
Mažeikiai d. mun.;2017;39;622;318;304
Mažeikiai d. mun.;2017;40;683;341;342
Mažeikiai d. mun.;2017;41;694;321;373
Mažeikiai d. mun.;2017;42;779;355;424
Mažeikiai d. mun.;2017;43;779;362;417
Mažeikiai d. mun.;2017;44;780;370;410
Mažeikiai d. mun.;2017;45;867;439;428
Mažeikiai d. mun.;2017;46;855;408;447
Mažeikiai d. mun.;2017;47;802;395;407
Mažeikiai d. mun.;2017;48;806;366;440
Mažeikiai d. mun.;2017;49;825;375;450
Mažeikiai d. mun.;2017;50;846;409;437
Mažeikiai d. mun.;2017;51;780;361;419
Mažeikiai d. mun.;2017;52;864;399;465
Mažeikiai d. mun.;2017;53;856;390;466
Mažeikiai d. mun.;2017;54;916;450;466
Mažeikiai d. mun.;2017;55;962;452;510
Mažeikiai d. mun.;2017;56;931;426;505
Mažeikiai d. mun.;2017;57;901;393;508
Mažeikiai d. mun.;2017;58;926;398;528
Mažeikiai d. mun.;2017;59;837;391;446
Mažeikiai d. mun.;2017;60;729;314;415
Mažeikiai d. mun.;2017;61;775;355;420
Mažeikiai d. mun.;2017;62;632;271;361
Mažeikiai d. mun.;2017;63;615;280;335
Mažeikiai d. mun.;2017;64;645;283;362
Mažeikiai d. mun.;2017;65;594;243;351
Mažeikiai d. mun.;2017;66;615;265;350
Mažeikiai d. mun.;2017;67;584;236;348
Mažeikiai d. mun.;2017;68;566;225;341
Mažeikiai d. mun.;2017;69;464;177;287
Mažeikiai d. mun.;2017;70;436;170;266
Mažeikiai d. mun.;2017;71;456;161;295
Mažeikiai d. mun.;2017;72;369;111;258
Mažeikiai d. mun.;2017;73;392;134;258
Mažeikiai d. mun.;2017;74;406;136;270
Mažeikiai d. mun.;2017;75;426;154;272
Mažeikiai d. mun.;2017;76;370;128;242
Mažeikiai d. mun.;2017;77;350;104;246
Mažeikiai d. mun.;2017;78;297;107;190
Mažeikiai d. mun.;2017;79;322;92;230
Mažeikiai d. mun.;2017;80;319;94;225
Mažeikiai d. mun.;2017;81;305;86;219
Mažeikiai d. mun.;2017;82;248;68;180
Mažeikiai d. mun.;2017;83;232;60;172
Mažeikiai d. mun.;2017;84;212;60;152
Mažeikiai d. mun.;2017;85;1031;226;805
Mažeikiai d. mun.;2018;-1;52208;24352;27856
Mažeikiai d. mun.;2018;0;511;262;249
Mažeikiai d. mun.;2018;1;556;285;271
Mažeikiai d. mun.;2018;2;607;294;313
Mažeikiai d. mun.;2018;3;566;286;280
Mažeikiai d. mun.;2018;4;583;295;288
Mažeikiai d. mun.;2018;5;627;318;309
Mažeikiai d. mun.;2018;6;609;315;294
Mažeikiai d. mun.;2018;7;552;290;262
Mažeikiai d. mun.;2018;8;548;284;264
Mažeikiai d. mun.;2018;9;575;334;241
Mažeikiai d. mun.;2018;10;522;251;271
Mažeikiai d. mun.;2018;11;534;256;278
Mažeikiai d. mun.;2018;12;507;276;231
Mažeikiai d. mun.;2018;13;559;272;287
Mažeikiai d. mun.;2018;14;533;272;261
Mažeikiai d. mun.;2018;15;548;281;267
Mažeikiai d. mun.;2018;16;555;291;264
Mažeikiai d. mun.;2018;17;638;323;315
Mažeikiai d. mun.;2018;18;725;381;344
Mažeikiai d. mun.;2018;19;699;368;331
Mažeikiai d. mun.;2018;20;624;312;312
Mažeikiai d. mun.;2018;21;734;404;330
Mažeikiai d. mun.;2018;22;717;361;356
Mažeikiai d. mun.;2018;23;676;343;333
Mažeikiai d. mun.;2018;24;757;396;361
Mažeikiai d. mun.;2018;25;821;445;376
Mažeikiai d. mun.;2018;26;612;326;286
Mažeikiai d. mun.;2018;27;539;316;223
Mažeikiai d. mun.;2018;28;495;296;199
Mažeikiai d. mun.;2018;29;530;282;248
Mažeikiai d. mun.;2018;30;509;292;217
Mažeikiai d. mun.;2018;31;530;288;242
Mažeikiai d. mun.;2018;32;512;248;264
Mažeikiai d. mun.;2018;33;495;260;235
Mažeikiai d. mun.;2018;34;447;244;203
Mažeikiai d. mun.;2018;35;490;250;240
Mažeikiai d. mun.;2018;36;535;285;250
Mažeikiai d. mun.;2018;37;575;267;308
Mažeikiai d. mun.;2018;38;568;275;293
Mažeikiai d. mun.;2018;39;578;278;300
Mažeikiai d. mun.;2018;40;604;304;300
Mažeikiai d. mun.;2018;41;667;337;330
Mažeikiai d. mun.;2018;42;687;320;367
Mažeikiai d. mun.;2018;43;765;348;417
Mažeikiai d. mun.;2018;44;772;356;416
Mažeikiai d. mun.;2018;45;772;366;406
Mažeikiai d. mun.;2018;46;849;428;421
Mažeikiai d. mun.;2018;47;848;406;442
Mažeikiai d. mun.;2018;48;789;386;403
Mažeikiai d. mun.;2018;49;789;354;435
Mažeikiai d. mun.;2018;50;818;370;448
Mažeikiai d. mun.;2018;51;841;406;435
Mažeikiai d. mun.;2018;52;767;353;414
Mažeikiai d. mun.;2018;53;858;396;462
Mažeikiai d. mun.;2018;54;841;377;464
Mažeikiai d. mun.;2018;55;899;440;459
Mažeikiai d. mun.;2018;56;951;446;505
Mažeikiai d. mun.;2018;57;919;415;504
Mažeikiai d. mun.;2018;58;888;384;504
Mažeikiai d. mun.;2018;59;911;391;520
Mažeikiai d. mun.;2018;60;820;384;436
Mažeikiai d. mun.;2018;61;722;310;412
Mažeikiai d. mun.;2018;62;775;356;419
Mažeikiai d. mun.;2018;63;625;265;360
Mažeikiai d. mun.;2018;64;596;268;328
Mažeikiai d. mun.;2018;65;634;273;361
Mažeikiai d. mun.;2018;66;583;237;346
Mažeikiai d. mun.;2018;67;603;258;345
Mažeikiai d. mun.;2018;68;561;219;342
Mažeikiai d. mun.;2018;69;557;216;341
Mažeikiai d. mun.;2018;70;451;172;279
Mažeikiai d. mun.;2018;71;425;164;261
Mažeikiai d. mun.;2018;72;452;155;297
Mažeikiai d. mun.;2018;73;357;102;255
Mažeikiai d. mun.;2018;74;376;123;253
Mažeikiai d. mun.;2018;75;392;128;264
Mažeikiai d. mun.;2018;76;404;143;261
Mažeikiai d. mun.;2018;77;349;117;232
Mažeikiai d. mun.;2018;78;337;98;239
Mažeikiai d. mun.;2018;79;276;94;182
Mažeikiai d. mun.;2018;80;305;86;219
Mažeikiai d. mun.;2018;81;301;81;220
Mažeikiai d. mun.;2018;82;289;77;212
Mažeikiai d. mun.;2018;83;221;59;162
Mažeikiai d. mun.;2018;84;211;51;160
Mažeikiai d. mun.;2018;85;1053;231;822
Molėtai d. mun.;2001;-1;25449;12259;13190
Molėtai d. mun.;2001;0;224;116;108
Molėtai d. mun.;2001;1;241;123;118
Molėtai d. mun.;2001;2;242;129;113
Molėtai d. mun.;2001;3;257;127;130
Molėtai d. mun.;2001;4;278;146;132
Molėtai d. mun.;2001;5;263;143;120
Molėtai d. mun.;2001;6;333;167;166
Molėtai d. mun.;2001;7;327;165;162
Molėtai d. mun.;2001;8;382;210;172
Molėtai d. mun.;2001;9;378;196;182
Molėtai d. mun.;2001;10;357;198;159
Molėtai d. mun.;2001;11;363;201;162
Molėtai d. mun.;2001;12;364;192;172
Molėtai d. mun.;2001;13;386;200;186
Molėtai d. mun.;2001;14;383;201;182
Molėtai d. mun.;2001;15;351;171;180
Molėtai d. mun.;2001;16;354;189;165
Molėtai d. mun.;2001;17;381;219;162
Molėtai d. mun.;2001;18;339;182;157
Molėtai d. mun.;2001;19;307;176;131
Molėtai d. mun.;2001;20;259;147;112
Molėtai d. mun.;2001;21;266;150;116
Molėtai d. mun.;2001;22;283;145;138
Molėtai d. mun.;2001;23;277;156;121
Molėtai d. mun.;2001;24;297;161;136
Molėtai d. mun.;2001;25;308;157;151
Molėtai d. mun.;2001;26;286;142;144
Molėtai d. mun.;2001;27;293;167;126
Molėtai d. mun.;2001;28;281;150;131
Molėtai d. mun.;2001;29;296;161;135
Molėtai d. mun.;2001;30;320;179;141
Molėtai d. mun.;2001;31;308;163;145
Molėtai d. mun.;2001;32;362;184;178
Molėtai d. mun.;2001;33;329;180;149
Molėtai d. mun.;2001;34;328;166;162
Molėtai d. mun.;2001;35;336;174;162
Molėtai d. mun.;2001;36;333;185;148
Molėtai d. mun.;2001;37;322;190;132
Molėtai d. mun.;2001;38;362;204;158
Molėtai d. mun.;2001;39;357;180;177
Molėtai d. mun.;2001;40;342;192;150
Molėtai d. mun.;2001;41;330;176;154
Molėtai d. mun.;2001;42;348;177;171
Molėtai d. mun.;2001;43;295;150;145
Molėtai d. mun.;2001;44;280;155;125
Molėtai d. mun.;2001;45;324;149;175
Molėtai d. mun.;2001;46;263;136;127
Molėtai d. mun.;2001;47;253;126;127
Molėtai d. mun.;2001;48;323;182;141
Molėtai d. mun.;2001;49;280;138;142
Molėtai d. mun.;2001;50;289;150;139
Molėtai d. mun.;2001;51;324;186;138
Molėtai d. mun.;2001;52;269;140;129
Molėtai d. mun.;2001;53;284;126;158
Molėtai d. mun.;2001;54;261;118;143
Molėtai d. mun.;2001;55;288;144;144
Molėtai d. mun.;2001;56;212;99;113
Molėtai d. mun.;2001;57;325;155;170
Molėtai d. mun.;2001;58;371;171;200
Molėtai d. mun.;2001;59;327;141;186
Molėtai d. mun.;2001;60;331;143;188
Molėtai d. mun.;2001;61;308;144;164
Molėtai d. mun.;2001;62;321;152;169
Molėtai d. mun.;2001;63;313;126;187
Molėtai d. mun.;2001;64;345;143;202
Molėtai d. mun.;2001;65;313;129;184
Molėtai d. mun.;2001;66;292;118;174
Molėtai d. mun.;2001;67;325;115;210
Molėtai d. mun.;2001;68;303;107;196
Molėtai d. mun.;2001;69;326;119;207
Molėtai d. mun.;2001;70;348;115;233
Molėtai d. mun.;2001;71;277;102;175
Molėtai d. mun.;2001;72;270;84;186
Molėtai d. mun.;2001;73;298;114;184
Molėtai d. mun.;2001;74;288;94;194
Molėtai d. mun.;2001;75;257;86;171
Molėtai d. mun.;2001;76;261;91;170
Molėtai d. mun.;2001;77;246;73;173
Molėtai d. mun.;2001;78;199;46;153
Molėtai d. mun.;2001;79;194;60;134
Molėtai d. mun.;2001;80;164;48;116
Molėtai d. mun.;2001;81;122;40;82
Molėtai d. mun.;2001;82;77;26;51
Molėtai d. mun.;2001;83;71;25;46
Molėtai d. mun.;2001;84;66;15;51
Molėtai d. mun.;2001;85;433;141;292
Molėtai d. mun.;2002;-1;25114;12094;13020
Molėtai d. mun.;2002;0;222;114;108
Molėtai d. mun.;2002;1;222;114;108
Molėtai d. mun.;2002;2;241;123;118
Molėtai d. mun.;2002;3;239;129;110
Molėtai d. mun.;2002;4;255;125;130
Molėtai d. mun.;2002;5;272;142;130
Molėtai d. mun.;2002;6;261;142;119
Molėtai d. mun.;2002;7;332;168;164
Molėtai d. mun.;2002;8;329;167;162
Molėtai d. mun.;2002;9;378;206;172
Molėtai d. mun.;2002;10;376;195;181
Molėtai d. mun.;2002;11;352;195;157
Molėtai d. mun.;2002;12;358;198;160
Molėtai d. mun.;2002;13;359;189;170
Molėtai d. mun.;2002;14;385;199;186
Molėtai d. mun.;2002;15;383;200;183
Molėtai d. mun.;2002;16;345;168;177
Molėtai d. mun.;2002;17;345;183;162
Molėtai d. mun.;2002;18;375;213;162
Molėtai d. mun.;2002;19;325;175;150
Molėtai d. mun.;2002;20;302;173;129
Molėtai d. mun.;2002;21;262;148;114
Molėtai d. mun.;2002;22;267;147;120
Molėtai d. mun.;2002;23;275;140;135
Molėtai d. mun.;2002;24;265;151;114
Molėtai d. mun.;2002;25;297;163;134
Molėtai d. mun.;2002;26;302;151;151
Molėtai d. mun.;2002;27;280;140;140
Molėtai d. mun.;2002;28;292;168;124
Molėtai d. mun.;2002;29;277;146;131
Molėtai d. mun.;2002;30;288;154;134
Molėtai d. mun.;2002;31;314;176;138
Molėtai d. mun.;2002;32;303;160;143
Molėtai d. mun.;2002;33;351;175;176
Molėtai d. mun.;2002;34;322;177;145
Molėtai d. mun.;2002;35;321;161;160
Molėtai d. mun.;2002;36;328;169;159
Molėtai d. mun.;2002;37;326;180;146
Molėtai d. mun.;2002;38;312;185;127
Molėtai d. mun.;2002;39;353;199;154
Molėtai d. mun.;2002;40;352;177;175
Molėtai d. mun.;2002;41;338;191;147
Molėtai d. mun.;2002;42;322;171;151
Molėtai d. mun.;2002;43;342;173;169
Molėtai d. mun.;2002;44;292;151;141
Molėtai d. mun.;2002;45;273;151;122
Molėtai d. mun.;2002;46;319;145;174
Molėtai d. mun.;2002;47;263;137;126
Molėtai d. mun.;2002;48;250;124;126
Molėtai d. mun.;2002;49;321;180;141
Molėtai d. mun.;2002;50;276;135;141
Molėtai d. mun.;2002;51;283;146;137
Molėtai d. mun.;2002;52;323;183;140
Molėtai d. mun.;2002;53;269;140;129
Molėtai d. mun.;2002;54;277;124;153
Molėtai d. mun.;2002;55;253;115;138
Molėtai d. mun.;2002;56;278;140;138
Molėtai d. mun.;2002;57;208;96;112
Molėtai d. mun.;2002;58;315;148;167
Molėtai d. mun.;2002;59;356;160;196
Molėtai d. mun.;2002;60;321;142;179
Molėtai d. mun.;2002;61;331;142;189
Molėtai d. mun.;2002;62;305;145;160
Molėtai d. mun.;2002;63;317;150;167
Molėtai d. mun.;2002;64;306;123;183
Molėtai d. mun.;2002;65;345;144;201
Molėtai d. mun.;2002;66;306;128;178
Molėtai d. mun.;2002;67;286;115;171
Molėtai d. mun.;2002;68;319;112;207
Molėtai d. mun.;2002;69;300;106;194
Molėtai d. mun.;2002;70;320;116;204
Molėtai d. mun.;2002;71;342;113;229
Molėtai d. mun.;2002;72;270;96;174
Molėtai d. mun.;2002;73;261;83;178
Molėtai d. mun.;2002;74;292;109;183
Molėtai d. mun.;2002;75;273;88;185
Molėtai d. mun.;2002;76;246;79;167
Molėtai d. mun.;2002;77;243;80;163
Molėtai d. mun.;2002;78;234;70;164
Molėtai d. mun.;2002;79;188;42;146
Molėtai d. mun.;2002;80;180;54;126
Molėtai d. mun.;2002;81;155;45;110
Molėtai d. mun.;2002;82;114;39;75
Molėtai d. mun.;2002;83;67;23;44
Molėtai d. mun.;2002;84;67;25;42
Molėtai d. mun.;2002;85;425;130;295
Molėtai d. mun.;2003;-1;24789;11922;12867
Molėtai d. mun.;2003;0;192;84;108
Molėtai d. mun.;2003;1;220;113;107
Molėtai d. mun.;2003;2;216;110;106
Molėtai d. mun.;2003;3;236;121;115
Molėtai d. mun.;2003;4;235;128;107
Molėtai d. mun.;2003;5;252;125;127
Molėtai d. mun.;2003;6;271;141;130
Molėtai d. mun.;2003;7;255;138;117
Molėtai d. mun.;2003;8;330;166;164
Molėtai d. mun.;2003;9;324;163;161
Molėtai d. mun.;2003;10;372;205;167
Molėtai d. mun.;2003;11;372;193;179
Molėtai d. mun.;2003;12;345;192;153
Molėtai d. mun.;2003;13;354;195;159
Molėtai d. mun.;2003;14;355;186;169
Molėtai d. mun.;2003;15;378;194;184
Molėtai d. mun.;2003;16;376;197;179
Molėtai d. mun.;2003;17;340;166;174
Molėtai d. mun.;2003;18;342;184;158
Molėtai d. mun.;2003;19;376;215;161
Molėtai d. mun.;2003;20;318;175;143
Molėtai d. mun.;2003;21;305;173;132
Molėtai d. mun.;2003;22;258;143;115
Molėtai d. mun.;2003;23;265;148;117
Molėtai d. mun.;2003;24;271;140;131
Molėtai d. mun.;2003;25;263;148;115
Molėtai d. mun.;2003;26;286;161;125
Molėtai d. mun.;2003;27;299;150;149
Molėtai d. mun.;2003;28;276;140;136
Molėtai d. mun.;2003;29;283;162;121
Molėtai d. mun.;2003;30;270;141;129
Molėtai d. mun.;2003;31;280;149;131
Molėtai d. mun.;2003;32;308;169;139
Molėtai d. mun.;2003;33;303;160;143
Molėtai d. mun.;2003;34;345;174;171
Molėtai d. mun.;2003;35;317;174;143
Molėtai d. mun.;2003;36;319;160;159
Molėtai d. mun.;2003;37;320;165;155
Molėtai d. mun.;2003;38;324;179;145
Molėtai d. mun.;2003;39;308;181;127
Molėtai d. mun.;2003;40;350;196;154
Molėtai d. mun.;2003;41;354;177;177
Molėtai d. mun.;2003;42;337;190;147
Molėtai d. mun.;2003;43;316;167;149
Molėtai d. mun.;2003;44;342;175;167
Molėtai d. mun.;2003;45;290;149;141
Molėtai d. mun.;2003;46;271;152;119
Molėtai d. mun.;2003;47;315;143;172
Molėtai d. mun.;2003;48;258;134;124
Molėtai d. mun.;2003;49;248;122;126
Molėtai d. mun.;2003;50;315;175;140
Molėtai d. mun.;2003;51;274;133;141
Molėtai d. mun.;2003;52;283;147;136
Molėtai d. mun.;2003;53;320;184;136
Molėtai d. mun.;2003;54;267;136;131
Molėtai d. mun.;2003;55;277;124;153
Molėtai d. mun.;2003;56;257;119;138
Molėtai d. mun.;2003;57;271;136;135
Molėtai d. mun.;2003;58;203;93;110
Molėtai d. mun.;2003;59;308;141;167
Molėtai d. mun.;2003;60;348;158;190
Molėtai d. mun.;2003;61;320;141;179
Molėtai d. mun.;2003;62;331;141;190
Molėtai d. mun.;2003;63;302;142;160
Molėtai d. mun.;2003;64;316;150;166
Molėtai d. mun.;2003;65;304;120;184
Molėtai d. mun.;2003;66;345;143;202
Molėtai d. mun.;2003;67;302;125;177
Molėtai d. mun.;2003;68;283;112;171
Molėtai d. mun.;2003;69;312;107;205
Molėtai d. mun.;2003;70;298;105;193
Molėtai d. mun.;2003;71;309;111;198
Molėtai d. mun.;2003;72;326;107;219
Molėtai d. mun.;2003;73;254;90;164
Molėtai d. mun.;2003;74;253;79;174
Molėtai d. mun.;2003;75;285;108;177
Molėtai d. mun.;2003;76;266;82;184
Molėtai d. mun.;2003;77;236;74;162
Molėtai d. mun.;2003;78;229;72;157
Molėtai d. mun.;2003;79;221;61;160
Molėtai d. mun.;2003;80;170;33;137
Molėtai d. mun.;2003;81;171;50;121
Molėtai d. mun.;2003;82;145;40;105
Molėtai d. mun.;2003;83;102;33;69
Molėtai d. mun.;2003;84;61;19;42
Molėtai d. mun.;2003;85;385;118;267
Molėtai d. mun.;2004;-1;24268;11657;12611
Molėtai d. mun.;2004;0;169;89;80
Molėtai d. mun.;2004;1;188;83;105
Molėtai d. mun.;2004;2;216;110;106
Molėtai d. mun.;2004;3;214;108;106
Molėtai d. mun.;2004;4;236;121;115
Molėtai d. mun.;2004;5;232;126;106
Molėtai d. mun.;2004;6;248;124;124
Molėtai d. mun.;2004;7;267;140;127
Molėtai d. mun.;2004;8;255;137;118
Molėtai d. mun.;2004;9;325;164;161
Molėtai d. mun.;2004;10;322;162;160
Molėtai d. mun.;2004;11;364;201;163
Molėtai d. mun.;2004;12;365;190;175
Molėtai d. mun.;2004;13;340;189;151
Molėtai d. mun.;2004;14;346;191;155
Molėtai d. mun.;2004;15;350;184;166
Molėtai d. mun.;2004;16;371;191;180
Molėtai d. mun.;2004;17;370;194;176
Molėtai d. mun.;2004;18;332;164;168
Molėtai d. mun.;2004;19;331;178;153
Molėtai d. mun.;2004;20;368;210;158
Molėtai d. mun.;2004;21;309;171;138
Molėtai d. mun.;2004;22;293;167;126
Molėtai d. mun.;2004;23;247;136;111
Molėtai d. mun.;2004;24;257;143;114
Molėtai d. mun.;2004;25;253;128;125
Molėtai d. mun.;2004;26;251;143;108
Molėtai d. mun.;2004;27;275;153;122
Molėtai d. mun.;2004;28;286;145;141
Molėtai d. mun.;2004;29;266;135;131
Molėtai d. mun.;2004;30;271;160;111
Molėtai d. mun.;2004;31;268;139;129
Molėtai d. mun.;2004;32;267;141;126
Molėtai d. mun.;2004;33;304;169;135
Molėtai d. mun.;2004;34;300;155;145
Molėtai d. mun.;2004;35;340;174;166
Molėtai d. mun.;2004;36;310;169;141
Molėtai d. mun.;2004;37;315;158;157
Molėtai d. mun.;2004;38;311;160;151
Molėtai d. mun.;2004;39;317;176;141
Molėtai d. mun.;2004;40;306;180;126
Molėtai d. mun.;2004;41;346;191;155
Molėtai d. mun.;2004;42;353;178;175
Molėtai d. mun.;2004;43;335;187;148
Molėtai d. mun.;2004;44;312;165;147
Molėtai d. mun.;2004;45;339;170;169
Molėtai d. mun.;2004;46;287;150;137
Molėtai d. mun.;2004;47;267;148;119
Molėtai d. mun.;2004;48;312;140;172
Molėtai d. mun.;2004;49;255;130;125
Molėtai d. mun.;2004;50;244;120;124
Molėtai d. mun.;2004;51;314;178;136
Molėtai d. mun.;2004;52;267;131;136
Molėtai d. mun.;2004;53;279;145;134
Molėtai d. mun.;2004;54;318;183;135
Molėtai d. mun.;2004;55;262;136;126
Molėtai d. mun.;2004;56;273;121;152
Molėtai d. mun.;2004;57;254;117;137
Molėtai d. mun.;2004;58;266;132;134
Molėtai d. mun.;2004;59;198;87;111
Molėtai d. mun.;2004;60;298;131;167
Molėtai d. mun.;2004;61;342;154;188
Molėtai d. mun.;2004;62;310;133;177
Molėtai d. mun.;2004;63;321;133;188
Molėtai d. mun.;2004;64;296;138;158
Molėtai d. mun.;2004;65;309;142;167
Molėtai d. mun.;2004;66;298;114;184
Molėtai d. mun.;2004;67;339;138;201
Molėtai d. mun.;2004;68;298;122;176
Molėtai d. mun.;2004;69;272;105;167
Molėtai d. mun.;2004;70;297;101;196
Molėtai d. mun.;2004;71;290;102;188
Molėtai d. mun.;2004;72;296;106;190
Molėtai d. mun.;2004;73;314;99;215
Molėtai d. mun.;2004;74;244;82;162
Molėtai d. mun.;2004;75;246;79;167
Molėtai d. mun.;2004;76;272;103;169
Molėtai d. mun.;2004;77;251;76;175
Molėtai d. mun.;2004;78;226;69;157
Molėtai d. mun.;2004;79;217;68;149
Molėtai d. mun.;2004;80;206;56;150
Molėtai d. mun.;2004;81;153;29;124
Molėtai d. mun.;2004;82;154;43;111
Molėtai d. mun.;2004;83;128;31;97
Molėtai d. mun.;2004;84;88;29;59
Molėtai d. mun.;2004;85;367;107;260
Molėtai d. mun.;2005;-1;23817;11421;12396
Molėtai d. mun.;2005;0;186;85;101
Molėtai d. mun.;2005;1;165;89;76
Molėtai d. mun.;2005;2;185;81;104
Molėtai d. mun.;2005;3;217;111;106
Molėtai d. mun.;2005;4;212;107;105
Molėtai d. mun.;2005;5;231;120;111
Molėtai d. mun.;2005;6;227;123;104
Molėtai d. mun.;2005;7;245;122;123
Molėtai d. mun.;2005;8;265;139;126
Molėtai d. mun.;2005;9;250;135;115
Molėtai d. mun.;2005;10;320;163;157
Molėtai d. mun.;2005;11;319;160;159
Molėtai d. mun.;2005;12;359;198;161
Molėtai d. mun.;2005;13;363;190;173
Molėtai d. mun.;2005;14;336;187;149
Molėtai d. mun.;2005;15;342;188;154
Molėtai d. mun.;2005;16;343;182;161
Molėtai d. mun.;2005;17;361;186;175
Molėtai d. mun.;2005;18;362;190;172
Molėtai d. mun.;2005;19;322;160;162
Molėtai d. mun.;2005;20;327;176;151
Molėtai d. mun.;2005;21;359;203;156
Molėtai d. mun.;2005;22;290;164;126
Molėtai d. mun.;2005;23;291;168;123
Molėtai d. mun.;2005;24;233;128;105
Molėtai d. mun.;2005;25;251;141;110
Molėtai d. mun.;2005;26;239;120;119
Molėtai d. mun.;2005;27;240;139;101
Molėtai d. mun.;2005;28;265;150;115
Molėtai d. mun.;2005;29;279;142;137
Molėtai d. mun.;2005;30;260;133;127
Molėtai d. mun.;2005;31;259;152;107
Molėtai d. mun.;2005;32;262;135;127
Molėtai d. mun.;2005;33;256;133;123
Molėtai d. mun.;2005;34;302;168;134
Molėtai d. mun.;2005;35;296;155;141
Molėtai d. mun.;2005;36;336;167;169
Molėtai d. mun.;2005;37;307;165;142
Molėtai d. mun.;2005;38;307;154;153
Molėtai d. mun.;2005;39;304;158;146
Molėtai d. mun.;2005;40;313;172;141
Molėtai d. mun.;2005;41;303;179;124
Molėtai d. mun.;2005;42;339;186;153
Molėtai d. mun.;2005;43;350;173;177
Molėtai d. mun.;2005;44;327;183;144
Molėtai d. mun.;2005;45;310;164;146
Molėtai d. mun.;2005;46;338;169;169
Molėtai d. mun.;2005;47;286;149;137
Molėtai d. mun.;2005;48;265;148;117
Molėtai d. mun.;2005;49;308;138;170
Molėtai d. mun.;2005;50;256;130;126
Molėtai d. mun.;2005;51;240;116;124
Molėtai d. mun.;2005;52;305;172;133
Molėtai d. mun.;2005;53;265;129;136
Molėtai d. mun.;2005;54;277;142;135
Molėtai d. mun.;2005;55;318;182;136
Molėtai d. mun.;2005;56;253;133;120
Molėtai d. mun.;2005;57;271;119;152
Molėtai d. mun.;2005;58;249;113;136
Molėtai d. mun.;2005;59;266;131;135
Molėtai d. mun.;2005;60;192;83;109
Molėtai d. mun.;2005;61;292;127;165
Molėtai d. mun.;2005;62;337;149;188
Molėtai d. mun.;2005;63;308;128;180
Molėtai d. mun.;2005;64;314;128;186
Molėtai d. mun.;2005;65;285;130;155
Molėtai d. mun.;2005;66;303;137;166
Molėtai d. mun.;2005;67;290;109;181
Molėtai d. mun.;2005;68;330;133;197
Molėtai d. mun.;2005;69;298;120;178
Molėtai d. mun.;2005;70;266;102;164
Molėtai d. mun.;2005;71;287;93;194
Molėtai d. mun.;2005;72;279;94;185
Molėtai d. mun.;2005;73;285;104;181
Molėtai d. mun.;2005;74;299;92;207
Molėtai d. mun.;2005;75;236;80;156
Molėtai d. mun.;2005;76;237;74;163
Molėtai d. mun.;2005;77;255;91;164
Molėtai d. mun.;2005;78;240;72;168
Molėtai d. mun.;2005;79;213;67;146
Molėtai d. mun.;2005;80;202;60;142
Molėtai d. mun.;2005;81;196;52;144
Molėtai d. mun.;2005;82;144;28;116
Molėtai d. mun.;2005;83;139;38;101
Molėtai d. mun.;2005;84;119;32;87
Molėtai d. mun.;2005;85;359;103;256
Molėtai d. mun.;2006;-1;23128;11043;12085
Molėtai d. mun.;2006;0;188;99;89
Molėtai d. mun.;2006;1;185;83;102
Molėtai d. mun.;2006;2;159;86;73
Molėtai d. mun.;2006;3;181;79;102
Molėtai d. mun.;2006;4;211;108;103
Molėtai d. mun.;2006;5;207;105;102
Molėtai d. mun.;2006;6;226;118;108
Molėtai d. mun.;2006;7;224;121;103
Molėtai d. mun.;2006;8;239;118;121
Molėtai d. mun.;2006;9;263;137;126
Molėtai d. mun.;2006;10;250;135;115
Molėtai d. mun.;2006;11;317;162;155
Molėtai d. mun.;2006;12;318;159;159
Molėtai d. mun.;2006;13;351;192;159
Molėtai d. mun.;2006;14;358;187;171
Molėtai d. mun.;2006;15;330;181;149
Molėtai d. mun.;2006;16;331;180;151
Molėtai d. mun.;2006;17;329;172;157
Molėtai d. mun.;2006;18;348;179;169
Molėtai d. mun.;2006;19;345;179;166
Molėtai d. mun.;2006;20;304;152;152
Molėtai d. mun.;2006;21;313;168;145
Molėtai d. mun.;2006;22;340;193;147
Molėtai d. mun.;2006;23;275;155;120
Molėtai d. mun.;2006;24;271;159;112
Molėtai d. mun.;2006;25;220;121;99
Molėtai d. mun.;2006;26;233;133;100
Molėtai d. mun.;2006;27;227;112;115
Molėtai d. mun.;2006;28;226;135;91
Molėtai d. mun.;2006;29;248;142;106
Molėtai d. mun.;2006;30;271;135;136
Molėtai d. mun.;2006;31;247;126;121
Molėtai d. mun.;2006;32;248;147;101
Molėtai d. mun.;2006;33;247;127;120
Molėtai d. mun.;2006;34;243;127;116
Molėtai d. mun.;2006;35;295;162;133
Molėtai d. mun.;2006;36;291;152;139
Molėtai d. mun.;2006;37;334;164;170
Molėtai d. mun.;2006;38;298;160;138
Molėtai d. mun.;2006;39;302;148;154
Molėtai d. mun.;2006;40;299;155;144
Molėtai d. mun.;2006;41;305;167;138
Molėtai d. mun.;2006;42;297;174;123
Molėtai d. mun.;2006;43;329;182;147
Molėtai d. mun.;2006;44;344;169;175
Molėtai d. mun.;2006;45;324;178;146
Molėtai d. mun.;2006;46;304;159;145
Molėtai d. mun.;2006;47;329;165;164
Molėtai d. mun.;2006;48;283;147;136
Molėtai d. mun.;2006;49;263;147;116
Molėtai d. mun.;2006;50;304;135;169
Molėtai d. mun.;2006;51;251;129;122
Molėtai d. mun.;2006;52;233;112;121
Molėtai d. mun.;2006;53;298;166;132
Molėtai d. mun.;2006;54;256;123;133
Molėtai d. mun.;2006;55;266;134;132
Molėtai d. mun.;2006;56;309;177;132
Molėtai d. mun.;2006;57;253;131;122
Molėtai d. mun.;2006;58;269;114;155
Molėtai d. mun.;2006;59;241;108;133
Molėtai d. mun.;2006;60;253;124;129
Molėtai d. mun.;2006;61;181;75;106
Molėtai d. mun.;2006;62;283;122;161
Molėtai d. mun.;2006;63;322;134;188
Molėtai d. mun.;2006;64;303;124;179
Molėtai d. mun.;2006;65;308;122;186
Molėtai d. mun.;2006;66;270;122;148
Molėtai d. mun.;2006;67;295;132;163
Molėtai d. mun.;2006;68;283;105;178
Molėtai d. mun.;2006;69;318;125;193
Molėtai d. mun.;2006;70;290;114;176
Molėtai d. mun.;2006;71;252;98;154
Molėtai d. mun.;2006;72;275;86;189
Molėtai d. mun.;2006;73;272;92;180
Molėtai d. mun.;2006;74;273;94;179
Molėtai d. mun.;2006;75;284;88;196
Molėtai d. mun.;2006;76;229;76;153
Molėtai d. mun.;2006;77;221;68;153
Molėtai d. mun.;2006;78;240;85;155
Molėtai d. mun.;2006;79;228;66;162
Molėtai d. mun.;2006;80;200;58;142
Molėtai d. mun.;2006;81;183;56;127
Molėtai d. mun.;2006;82;170;48;122
Molėtai d. mun.;2006;83;137;25;112
Molėtai d. mun.;2006;84;114;28;86
Molėtai d. mun.;2006;85;394;106;288
Molėtai d. mun.;2007;-1;22671;10816;11855
Molėtai d. mun.;2007;0;166;84;82
Molėtai d. mun.;2007;1;185;98;87
Molėtai d. mun.;2007;2;185;82;103
Molėtai d. mun.;2007;3;159;86;73
Molėtai d. mun.;2007;4;180;80;100
Molėtai d. mun.;2007;5;208;106;102
Molėtai d. mun.;2007;6;203;102;101
Molėtai d. mun.;2007;7;229;120;109
Molėtai d. mun.;2007;8;225;122;103
Molėtai d. mun.;2007;9;238;116;122
Molėtai d. mun.;2007;10;265;138;127
Molėtai d. mun.;2007;11;248;133;115
Molėtai d. mun.;2007;12;316;163;153
Molėtai d. mun.;2007;13;315;159;156
Molėtai d. mun.;2007;14;350;193;157
Molėtai d. mun.;2007;15;356;187;169
Molėtai d. mun.;2007;16;323;179;144
Molėtai d. mun.;2007;17;333;182;151
Molėtai d. mun.;2007;18;324;168;156
Molėtai d. mun.;2007;19;344;178;166
Molėtai d. mun.;2007;20;338;174;164
Molėtai d. mun.;2007;21;295;146;149
Molėtai d. mun.;2007;22;307;163;144
Molėtai d. mun.;2007;23;334;191;143
Molėtai d. mun.;2007;24;267;151;116
Molėtai d. mun.;2007;25;256;146;110
Molėtai d. mun.;2007;26;208;115;93
Molėtai d. mun.;2007;27;227;130;97
Molėtai d. mun.;2007;28;213;108;105
Molėtai d. mun.;2007;29;218;129;89
Molėtai d. mun.;2007;30;252;144;108
Molėtai d. mun.;2007;31;267;135;132
Molėtai d. mun.;2007;32;243;123;120
Molėtai d. mun.;2007;33;248;149;99
Molėtai d. mun.;2007;34;244;125;119
Molėtai d. mun.;2007;35;241;127;114
Molėtai d. mun.;2007;36;291;160;131
Molėtai d. mun.;2007;37;288;151;137
Molėtai d. mun.;2007;38;327;161;166
Molėtai d. mun.;2007;39;297;160;137
Molėtai d. mun.;2007;40;296;140;156
Molėtai d. mun.;2007;41;297;153;144
Molėtai d. mun.;2007;42;300;164;136
Molėtai d. mun.;2007;43;294;170;124
Molėtai d. mun.;2007;44;324;178;146
Molėtai d. mun.;2007;45;339;166;173
Molėtai d. mun.;2007;46;326;181;145
Molėtai d. mun.;2007;47;300;156;144
Molėtai d. mun.;2007;48;328;164;164
Molėtai d. mun.;2007;49;278;141;137
Molėtai d. mun.;2007;50;261;145;116
Molėtai d. mun.;2007;51;301;133;168
Molėtai d. mun.;2007;52;244;125;119
Molėtai d. mun.;2007;53;233;112;121
Molėtai d. mun.;2007;54;298;165;133
Molėtai d. mun.;2007;55;248;117;131
Molėtai d. mun.;2007;56;258;130;128
Molėtai d. mun.;2007;57;298;168;130
Molėtai d. mun.;2007;58;253;131;122
Molėtai d. mun.;2007;59;262;109;153
Molėtai d. mun.;2007;60;231;103;128
Molėtai d. mun.;2007;61;250;121;129
Molėtai d. mun.;2007;62;178;72;106
Molėtai d. mun.;2007;63;280;120;160
Molėtai d. mun.;2007;64;318;129;189
Molėtai d. mun.;2007;65;287;119;168
Molėtai d. mun.;2007;66;300;117;183
Molėtai d. mun.;2007;67;263;116;147
Molėtai d. mun.;2007;68;289;129;160
Molėtai d. mun.;2007;69;275;99;176
Molėtai d. mun.;2007;70;301;115;186
Molėtai d. mun.;2007;71;278;107;171
Molėtai d. mun.;2007;72;245;94;151
Molėtai d. mun.;2007;73;266;84;182
Molėtai d. mun.;2007;74;257;81;176
Molėtai d. mun.;2007;75;262;88;174
Molėtai d. mun.;2007;76;271;81;190
Molėtai d. mun.;2007;77;215;67;148
Molėtai d. mun.;2007;78;202;58;144
Molėtai d. mun.;2007;79;215;77;138
Molėtai d. mun.;2007;80;212;61;151
Molėtai d. mun.;2007;81;176;51;125
Molėtai d. mun.;2007;82;158;47;111
Molėtai d. mun.;2007;83;155;43;112
Molėtai d. mun.;2007;84;116;23;93
Molėtai d. mun.;2007;85;420;102;318
Molėtai d. mun.;2008;-1;22221;10599;11622
Molėtai d. mun.;2008;0;150;81;69
Molėtai d. mun.;2008;1;166;83;83
Molėtai d. mun.;2008;2;183;96;87
Molėtai d. mun.;2008;3;183;79;104
Molėtai d. mun.;2008;4;161;89;72
Molėtai d. mun.;2008;5;180;81;99
Molėtai d. mun.;2008;6;207;105;102
Molėtai d. mun.;2008;7;205;100;105
Molėtai d. mun.;2008;8;231;121;110
Molėtai d. mun.;2008;9;225;122;103
Molėtai d. mun.;2008;10;237;116;121
Molėtai d. mun.;2008;11;264;137;127
Molėtai d. mun.;2008;12;248;133;115
Molėtai d. mun.;2008;13;318;165;153
Molėtai d. mun.;2008;14;314;159;155
Molėtai d. mun.;2008;15;352;193;159
Molėtai d. mun.;2008;16;355;186;169
Molėtai d. mun.;2008;17;323;180;143
Molėtai d. mun.;2008;18;327;177;150
Molėtai d. mun.;2008;19;320;165;155
Molėtai d. mun.;2008;20;338;174;164
Molėtai d. mun.;2008;21;331;171;160
Molėtai d. mun.;2008;22;288;142;146
Molėtai d. mun.;2008;23;300;158;142
Molėtai d. mun.;2008;24;318;184;134
Molėtai d. mun.;2008;25;255;141;114
Molėtai d. mun.;2008;26;248;143;105
Molėtai d. mun.;2008;27;200;111;89
Molėtai d. mun.;2008;28;217;124;93
Molėtai d. mun.;2008;29;204;100;104
Molėtai d. mun.;2008;30;211;125;86
Molėtai d. mun.;2008;31;254;142;112
Molėtai d. mun.;2008;32;263;133;130
Molėtai d. mun.;2008;33;235;121;114
Molėtai d. mun.;2008;34;244;147;97
Molėtai d. mun.;2008;35;243;126;117
Molėtai d. mun.;2008;36;238;128;110
Molėtai d. mun.;2008;37;288;157;131
Molėtai d. mun.;2008;38;286;151;135
Molėtai d. mun.;2008;39;319;155;164
Molėtai d. mun.;2008;40;293;157;136
Molėtai d. mun.;2008;41;293;139;154
Molėtai d. mun.;2008;42;293;151;142
Molėtai d. mun.;2008;43;297;162;135
Molėtai d. mun.;2008;44;289;166;123
Molėtai d. mun.;2008;45;320;179;141
Molėtai d. mun.;2008;46;336;164;172
Molėtai d. mun.;2008;47;322;178;144
Molėtai d. mun.;2008;48;297;154;143
Molėtai d. mun.;2008;49;324;162;162
Molėtai d. mun.;2008;50;276;141;135
Molėtai d. mun.;2008;51;259;143;116
Molėtai d. mun.;2008;52;291;128;163
Molėtai d. mun.;2008;53;242;122;120
Molėtai d. mun.;2008;54;230;110;120
Molėtai d. mun.;2008;55;292;159;133
Molėtai d. mun.;2008;56;247;116;131
Molėtai d. mun.;2008;57;253;127;126
Molėtai d. mun.;2008;58;284;156;128
Molėtai d. mun.;2008;59;256;133;123
Molėtai d. mun.;2008;60;253;104;149
Molėtai d. mun.;2008;61;227;101;126
Molėtai d. mun.;2008;62;245;118;127
Molėtai d. mun.;2008;63;171;67;104
Molėtai d. mun.;2008;64;270;115;155
Molėtai d. mun.;2008;65;309;123;186
Molėtai d. mun.;2008;66;273;106;167
Molėtai d. mun.;2008;67;293;113;180
Molėtai d. mun.;2008;68;252;109;143
Molėtai d. mun.;2008;69;280;129;151
Molėtai d. mun.;2008;70;265;93;172
Molėtai d. mun.;2008;71;293;111;182
Molėtai d. mun.;2008;72;268;102;166
Molėtai d. mun.;2008;73;234;86;148
Molėtai d. mun.;2008;74;260;80;180
Molėtai d. mun.;2008;75;248;79;169
Molėtai d. mun.;2008;76;241;78;163
Molėtai d. mun.;2008;77;257;76;181
Molėtai d. mun.;2008;78;206;63;143
Molėtai d. mun.;2008;79;189;54;135
Molėtai d. mun.;2008;80;198;68;130
Molėtai d. mun.;2008;81;202;55;147
Molėtai d. mun.;2008;82;161;44;117
Molėtai d. mun.;2008;83;138;39;99
Molėtai d. mun.;2008;84;135;38;97
Molėtai d. mun.;2008;85;430;100;330
Molėtai d. mun.;2009;-1;21751;10378;11373
Molėtai d. mun.;2009;0;149;79;70
Molėtai d. mun.;2009;1;150;80;70
Molėtai d. mun.;2009;2;163;81;82
Molėtai d. mun.;2009;3;181;96;85
Molėtai d. mun.;2009;4;175;76;99
Molėtai d. mun.;2009;5;158;88;70
Molėtai d. mun.;2009;6;179;81;98
Molėtai d. mun.;2009;7;205;102;103
Molėtai d. mun.;2009;8;203;100;103
Molėtai d. mun.;2009;9;227;119;108
Molėtai d. mun.;2009;10;224;122;102
Molėtai d. mun.;2009;11;236;117;119
Molėtai d. mun.;2009;12;263;135;128
Molėtai d. mun.;2009;13;247;132;115
Molėtai d. mun.;2009;14;319;164;155
Molėtai d. mun.;2009;15;312;156;156
Molėtai d. mun.;2009;16;344;188;156
Molėtai d. mun.;2009;17;351;185;166
Molėtai d. mun.;2009;18;321;179;142
Molėtai d. mun.;2009;19;325;176;149
Molėtai d. mun.;2009;20;317;163;154
Molėtai d. mun.;2009;21;331;170;161
Molėtai d. mun.;2009;22;324;167;157
Molėtai d. mun.;2009;23;285;141;144
Molėtai d. mun.;2009;24;296;157;139
Molėtai d. mun.;2009;25;307;180;127
Molėtai d. mun.;2009;26;244;138;106
Molėtai d. mun.;2009;27;242;140;102
Molėtai d. mun.;2009;28;196;110;86
Molėtai d. mun.;2009;29;208;118;90
Molėtai d. mun.;2009;30;195;95;100
Molėtai d. mun.;2009;31;207;125;82
Molėtai d. mun.;2009;32;243;140;103
Molėtai d. mun.;2009;33;258;131;127
Molėtai d. mun.;2009;34;230;116;114
Molėtai d. mun.;2009;35;242;147;95
Molėtai d. mun.;2009;36;240;126;114
Molėtai d. mun.;2009;37;228;122;106
Molėtai d. mun.;2009;38;284;157;127
Molėtai d. mun.;2009;39;284;150;134
Molėtai d. mun.;2009;40;316;155;161
Molėtai d. mun.;2009;41;291;155;136
Molėtai d. mun.;2009;42;291;137;154
Molėtai d. mun.;2009;43;290;152;138
Molėtai d. mun.;2009;44;295;160;135
Molėtai d. mun.;2009;45;281;159;122
Molėtai d. mun.;2009;46;318;179;139
Molėtai d. mun.;2009;47;332;160;172
Molėtai d. mun.;2009;48;315;172;143
Molėtai d. mun.;2009;49;294;153;141
Molėtai d. mun.;2009;50;318;157;161
Molėtai d. mun.;2009;51;271;137;134
Molėtai d. mun.;2009;52;253;138;115
Molėtai d. mun.;2009;53;283;122;161
Molėtai d. mun.;2009;54;237;118;119
Molėtai d. mun.;2009;55;227;110;117
Molėtai d. mun.;2009;56;288;156;132
Molėtai d. mun.;2009;57;240;115;125
Molėtai d. mun.;2009;58;246;123;123
Molėtai d. mun.;2009;59;276;151;125
Molėtai d. mun.;2009;60;248;127;121
Molėtai d. mun.;2009;61;243;96;147
Molėtai d. mun.;2009;62;216;92;124
Molėtai d. mun.;2009;63;245;118;127
Molėtai d. mun.;2009;64;167;63;104
Molėtai d. mun.;2009;65;264;109;155
Molėtai d. mun.;2009;66;295;116;179
Molėtai d. mun.;2009;67;263;97;166
Molėtai d. mun.;2009;68;284;108;176
Molėtai d. mun.;2009;69;240;103;137
Molėtai d. mun.;2009;70;274;127;147
Molėtai d. mun.;2009;71;256;87;169
Molėtai d. mun.;2009;72;282;106;176
Molėtai d. mun.;2009;73;252;95;157
Molėtai d. mun.;2009;74;225;81;144
Molėtai d. mun.;2009;75;254;77;177
Molėtai d. mun.;2009;76;237;74;163
Molėtai d. mun.;2009;77;231;74;157
Molėtai d. mun.;2009;78;247;71;176
Molėtai d. mun.;2009;79;189;56;133
Molėtai d. mun.;2009;80;173;49;124
Molėtai d. mun.;2009;81;185;60;125
Molėtai d. mun.;2009;82;185;50;135
Molėtai d. mun.;2009;83;144;37;107
Molėtai d. mun.;2009;84;126;37;89
Molėtai d. mun.;2009;85;471;110;361
Molėtai d. mun.;2010;-1;21238;10108;11130
Molėtai d. mun.;2010;0;176;81;95
Molėtai d. mun.;2010;1;148;78;70
Molėtai d. mun.;2010;2;146;77;69
Molėtai d. mun.;2010;3;161;81;80
Molėtai d. mun.;2010;4;180;98;82
Molėtai d. mun.;2010;5;171;74;97
Molėtai d. mun.;2010;6;156;86;70
Molėtai d. mun.;2010;7;172;77;95
Molėtai d. mun.;2010;8;200;100;100
Molėtai d. mun.;2010;9;199;97;102
Molėtai d. mun.;2010;10;226;117;109
Molėtai d. mun.;2010;11;224;122;102
Molėtai d. mun.;2010;12;234;116;118
Molėtai d. mun.;2010;13;259;131;128
Molėtai d. mun.;2010;14;244;129;115
Molėtai d. mun.;2010;15;314;163;151
Molėtai d. mun.;2010;16;309;154;155
Molėtai d. mun.;2010;17;339;186;153
Molėtai d. mun.;2010;18;347;184;163
Molėtai d. mun.;2010;19;314;175;139
Molėtai d. mun.;2010;20;322;170;152
Molėtai d. mun.;2010;21;309;160;149
Molėtai d. mun.;2010;22;317;163;154
Molėtai d. mun.;2010;23;311;160;151
Molėtai d. mun.;2010;24;270;134;136
Molėtai d. mun.;2010;25;283;149;134
Molėtai d. mun.;2010;26;292;175;117
Molėtai d. mun.;2010;27;234;132;102
Molėtai d. mun.;2010;28;227;132;95
Molėtai d. mun.;2010;29;191;108;83
Molėtai d. mun.;2010;30;202;115;87
Molėtai d. mun.;2010;31;183;90;93
Molėtai d. mun.;2010;32;204;124;80
Molėtai d. mun.;2010;33;239;138;101
Molėtai d. mun.;2010;34;246;124;122
Molėtai d. mun.;2010;35;218;111;107
Molėtai d. mun.;2010;36;237;143;94
Molėtai d. mun.;2010;37;234;124;110
Molėtai d. mun.;2010;38;226;121;105
Molėtai d. mun.;2010;39;279;152;127
Molėtai d. mun.;2010;40;279;145;134
Molėtai d. mun.;2010;41;311;152;159
Molėtai d. mun.;2010;42;285;153;132
Molėtai d. mun.;2010;43;285;134;151
Molėtai d. mun.;2010;44;289;152;137
Molėtai d. mun.;2010;45;292;159;133
Molėtai d. mun.;2010;46;274;153;121
Molėtai d. mun.;2010;47;308;175;133
Molėtai d. mun.;2010;48;330;159;171
Molėtai d. mun.;2010;49;311;170;141
Molėtai d. mun.;2010;50;290;149;141
Molėtai d. mun.;2010;51;315;154;161
Molėtai d. mun.;2010;52;270;138;132
Molėtai d. mun.;2010;53;253;137;116
Molėtai d. mun.;2010;54;277;119;158
Molėtai d. mun.;2010;55;234;117;117
Molėtai d. mun.;2010;56;224;108;116
Molėtai d. mun.;2010;57;283;153;130
Molėtai d. mun.;2010;58;232;109;123
Molėtai d. mun.;2010;59;242;120;122
Molėtai d. mun.;2010;60;275;149;126
Molėtai d. mun.;2010;61;241;123;118
Molėtai d. mun.;2010;62;236;92;144
Molėtai d. mun.;2010;63;211;88;123
Molėtai d. mun.;2010;64;235;111;124
Molėtai d. mun.;2010;65;158;59;99
Molėtai d. mun.;2010;66;257;101;156
Molėtai d. mun.;2010;67;285;110;175
Molėtai d. mun.;2010;68;258;93;165
Molėtai d. mun.;2010;69;274;104;170
Molėtai d. mun.;2010;70;231;97;134
Molėtai d. mun.;2010;71;263;121;142
Molėtai d. mun.;2010;72;246;82;164
Molėtai d. mun.;2010;73;275;101;174
Molėtai d. mun.;2010;74;238;85;153
Molėtai d. mun.;2010;75;213;74;139
Molėtai d. mun.;2010;76;246;73;173
Molėtai d. mun.;2010;77;222;67;155
Molėtai d. mun.;2010;78;219;70;149
Molėtai d. mun.;2010;79;235;67;168
Molėtai d. mun.;2010;80;173;50;123
Molėtai d. mun.;2010;81;163;43;120
Molėtai d. mun.;2010;82;169;51;118
Molėtai d. mun.;2010;83;163;43;120
Molėtai d. mun.;2010;84;128;31;97
Molėtai d. mun.;2010;85;497;116;381
Molėtai d. mun.;2011;-1;20751;9899;10852
Molėtai d. mun.;2011;0;149;82;67
Molėtai d. mun.;2011;1;157;80;77
Molėtai d. mun.;2011;2;140;78;62
Molėtai d. mun.;2011;3;118;64;54
Molėtai d. mun.;2011;4;149;71;78
Molėtai d. mun.;2011;5;167;93;74
Molėtai d. mun.;2011;6;158;69;89
Molėtai d. mun.;2011;7;147;80;67
Molėtai d. mun.;2011;8;163;66;97
Molėtai d. mun.;2011;9;181;88;93
Molėtai d. mun.;2011;10;208;111;97
Molėtai d. mun.;2011;11;224;116;108
Molėtai d. mun.;2011;12;223;121;102
Molėtai d. mun.;2011;13;234;124;110
Molėtai d. mun.;2011;14;270;139;131
Molėtai d. mun.;2011;15;260;139;121
Molėtai d. mun.;2011;16;323;165;158
Molėtai d. mun.;2011;17;315;163;152
Molėtai d. mun.;2011;18;355;195;160
Molėtai d. mun.;2011;19;307;167;140
Molėtai d. mun.;2011;20;256;146;110
Molėtai d. mun.;2011;21;263;148;115
Molėtai d. mun.;2011;22;263;143;120
Molėtai d. mun.;2011;23;265;153;112
Molėtai d. mun.;2011;24;250;136;114
Molėtai d. mun.;2011;25;203;106;97
Molėtai d. mun.;2011;26;209;115;94
Molėtai d. mun.;2011;27;198;119;79
Molėtai d. mun.;2011;28;180;103;77
Molėtai d. mun.;2011;29;199;111;88
Molėtai d. mun.;2011;30;182;98;84
Molėtai d. mun.;2011;31;197;99;98
Molėtai d. mun.;2011;32;207;101;106
Molėtai d. mun.;2011;33;210;120;90
Molėtai d. mun.;2011;34;257;142;115
Molėtai d. mun.;2011;35;277;139;138
Molėtai d. mun.;2011;36;251;120;131
Molėtai d. mun.;2011;37;268;155;113
Molėtai d. mun.;2011;38;275;143;132
Molėtai d. mun.;2011;39;265;134;131
Molėtai d. mun.;2011;40;299;163;136
Molėtai d. mun.;2011;41;299;164;135
Molėtai d. mun.;2011;42;341;170;171
Molėtai d. mun.;2011;43;307;166;141
Molėtai d. mun.;2011;44;315;159;156
Molėtai d. mun.;2011;45;313;161;152
Molėtai d. mun.;2011;46;304;171;133
Molėtai d. mun.;2011;47;292;165;127
Molėtai d. mun.;2011;48;314;171;143
Molėtai d. mun.;2011;49;332;159;173
Molėtai d. mun.;2011;50;308;167;141
Molėtai d. mun.;2011;51;305;152;153
Molėtai d. mun.;2011;52;300;150;150
Molėtai d. mun.;2011;53;259;125;134
Molėtai d. mun.;2011;54;261;140;121
Molėtai d. mun.;2011;55;279;122;157
Molėtai d. mun.;2011;56;230;106;124
Molėtai d. mun.;2011;57;231;116;115
Molėtai d. mun.;2011;58;289;153;136
Molėtai d. mun.;2011;59;239;113;126
Molėtai d. mun.;2011;60;251;123;128
Molėtai d. mun.;2011;61;270;140;130
Molėtai d. mun.;2011;62;227;106;121
Molėtai d. mun.;2011;63;244;97;147
Molėtai d. mun.;2011;64;201;83;118
Molėtai d. mun.;2011;65;232;105;127
Molėtai d. mun.;2011;66;180;73;107
Molėtai d. mun.;2011;67;259;102;157
Molėtai d. mun.;2011;68;282;111;171
Molėtai d. mun.;2011;69;256;96;160
Molėtai d. mun.;2011;70;267;100;167
Molėtai d. mun.;2011;71;223;92;131
Molėtai d. mun.;2011;72;261;117;144
Molėtai d. mun.;2011;73;239;80;159
Molėtai d. mun.;2011;74;262;92;170
Molėtai d. mun.;2011;75;221;73;148
Molėtai d. mun.;2011;76;203;67;136
Molėtai d. mun.;2011;77;220;63;157
Molėtai d. mun.;2011;78;201;55;146
Molėtai d. mun.;2011;79;207;65;142
Molėtai d. mun.;2011;80;208;56;152
Molėtai d. mun.;2011;81;152;43;109
Molėtai d. mun.;2011;82;145;37;108
Molėtai d. mun.;2011;83;154;44;110
Molėtai d. mun.;2011;84;132;39;93
Molėtai d. mun.;2011;85;514;105;409
Molėtai d. mun.;2012;-1;20390;9737;10653
Molėtai d. mun.;2012;0;167;84;83
Molėtai d. mun.;2012;1;146;79;67
Molėtai d. mun.;2012;2;159;83;76
Molėtai d. mun.;2012;3;139;78;61
Molėtai d. mun.;2012;4;119;67;52
Molėtai d. mun.;2012;5;144;69;75
Molėtai d. mun.;2012;6;167;94;73
Molėtai d. mun.;2012;7;157;69;88
Molėtai d. mun.;2012;8;147;81;66
Molėtai d. mun.;2012;9;164;65;99
Molėtai d. mun.;2012;10;179;87;92
Molėtai d. mun.;2012;11;207;110;97
Molėtai d. mun.;2012;12;221;114;107
Molėtai d. mun.;2012;13;222;122;100
Molėtai d. mun.;2012;14;235;126;109
Molėtai d. mun.;2012;15;269;138;131
Molėtai d. mun.;2012;16;262;140;122
Molėtai d. mun.;2012;17;324;166;158
Molėtai d. mun.;2012;18;317;164;153
Molėtai d. mun.;2012;19;348;194;154
Molėtai d. mun.;2012;20;307;166;141
Molėtai d. mun.;2012;21;252;143;109
Molėtai d. mun.;2012;22;258;147;111
Molėtai d. mun.;2012;23;255;141;114
Molėtai d. mun.;2012;24;254;148;106
Molėtai d. mun.;2012;25;243;134;109
Molėtai d. mun.;2012;26;195;104;91
Molėtai d. mun.;2012;27;195;109;86
Molėtai d. mun.;2012;28;185;113;72
Molėtai d. mun.;2012;29;163;95;68
Molėtai d. mun.;2012;30;192;107;85
Molėtai d. mun.;2012;31;176;94;82
Molėtai d. mun.;2012;32;185;93;92
Molėtai d. mun.;2012;33;201;100;101
Molėtai d. mun.;2012;34;211;120;91
Molėtai d. mun.;2012;35;245;133;112
Molėtai d. mun.;2012;36;270;133;137
Molėtai d. mun.;2012;37;245;117;128
Molėtai d. mun.;2012;38;262;152;110
Molėtai d. mun.;2012;39;274;139;135
Molėtai d. mun.;2012;40;263;131;132
Molėtai d. mun.;2012;41;296;162;134
Molėtai d. mun.;2012;42;298;162;136
Molėtai d. mun.;2012;43;340;168;172
Molėtai d. mun.;2012;44;306;165;141
Molėtai d. mun.;2012;45;309;158;151
Molėtai d. mun.;2012;46;310;158;152
Molėtai d. mun.;2012;47;302;169;133
Molėtai d. mun.;2012;48;288;161;127
Molėtai d. mun.;2012;49;311;169;142
Molėtai d. mun.;2012;50;330;160;170
Molėtai d. mun.;2012;51;306;166;140
Molėtai d. mun.;2012;52;299;147;152
Molėtai d. mun.;2012;53;298;150;148
Molėtai d. mun.;2012;54;258;123;135
Molėtai d. mun.;2012;55;254;134;120
Molėtai d. mun.;2012;56;276;120;156
Molėtai d. mun.;2012;57;226;102;124
Molėtai d. mun.;2012;58;230;115;115
Molėtai d. mun.;2012;59;287;152;135
Molėtai d. mun.;2012;60;234;109;125
Molėtai d. mun.;2012;61;251;121;130
Molėtai d. mun.;2012;62;265;137;128
Molėtai d. mun.;2012;63;222;100;122
Molėtai d. mun.;2012;64;227;89;138
Molėtai d. mun.;2012;65;195;76;119
Molėtai d. mun.;2012;66;224;98;126
Molėtai d. mun.;2012;67;177;72;105
Molėtai d. mun.;2012;68;255;101;154
Molėtai d. mun.;2012;69;277;107;170
Molėtai d. mun.;2012;70;246;89;157
Molėtai d. mun.;2012;71;258;95;163
Molėtai d. mun.;2012;72;216;88;128
Molėtai d. mun.;2012;73;256;115;141
Molėtai d. mun.;2012;74;233;77;156
Molėtai d. mun.;2012;75;256;89;167
Molėtai d. mun.;2012;76;215;70;145
Molėtai d. mun.;2012;77;196;64;132
Molėtai d. mun.;2012;78;212;58;154
Molėtai d. mun.;2012;79;191;49;142
Molėtai d. mun.;2012;80;191;59;132
Molėtai d. mun.;2012;81;193;50;143
Molėtai d. mun.;2012;82;134;40;94
Molėtai d. mun.;2012;83;139;35;104
Molėtai d. mun.;2012;84;133;39;94
Molėtai d. mun.;2012;85;546;120;426
Molėtai d. mun.;2013;-1;20032;9556;10476
Molėtai d. mun.;2013;0;137;69;68
Molėtai d. mun.;2013;1;161;81;80
Molėtai d. mun.;2013;2;135;75;60
Molėtai d. mun.;2013;3;149;75;74
Molėtai d. mun.;2013;4;137;74;63
Molėtai d. mun.;2013;5;120;69;51
Molėtai d. mun.;2013;6;144;69;75
Molėtai d. mun.;2013;7;169;97;72
Molėtai d. mun.;2013;8;159;68;91
Molėtai d. mun.;2013;9;147;82;65
Molėtai d. mun.;2013;10;163;62;101
Molėtai d. mun.;2013;11;179;86;93
Molėtai d. mun.;2013;12;208;110;98
Molėtai d. mun.;2013;13;219;112;107
Molėtai d. mun.;2013;14;222;122;100
Molėtai d. mun.;2013;15;236;127;109
Molėtai d. mun.;2013;16;267;137;130
Molėtai d. mun.;2013;17;259;138;121
Molėtai d. mun.;2013;18;323;166;157
Molėtai d. mun.;2013;19;315;164;151
Molėtai d. mun.;2013;20;342;193;149
Molėtai d. mun.;2013;21;307;169;138
Molėtai d. mun.;2013;22;248;141;107
Molėtai d. mun.;2013;23;245;145;100
Molėtai d. mun.;2013;24;247;142;105
Molėtai d. mun.;2013;25;246;145;101
Molėtai d. mun.;2013;26;234;128;106
Molėtai d. mun.;2013;27;174;93;81
Molėtai d. mun.;2013;28;191;103;88
Molėtai d. mun.;2013;29;168;107;61
Molėtai d. mun.;2013;30;151;91;60
Molėtai d. mun.;2013;31;189;105;84
Molėtai d. mun.;2013;32;176;94;82
Molėtai d. mun.;2013;33;177;85;92
Molėtai d. mun.;2013;34;199;100;99
Molėtai d. mun.;2013;35;208;118;90
Molėtai d. mun.;2013;36;244;132;112
Molėtai d. mun.;2013;37;260;128;132
Molėtai d. mun.;2013;38;244;114;130
Molėtai d. mun.;2013;39;261;149;112
Molėtai d. mun.;2013;40;275;141;134
Molėtai d. mun.;2013;41;261;128;133
Molėtai d. mun.;2013;42;294;160;134
Molėtai d. mun.;2013;43;296;161;135
Molėtai d. mun.;2013;44;341;168;173
Molėtai d. mun.;2013;45;306;165;141
Molėtai d. mun.;2013;46;308;156;152
Molėtai d. mun.;2013;47;322;165;157
Molėtai d. mun.;2013;48;298;165;133
Molėtai d. mun.;2013;49;291;163;128
Molėtai d. mun.;2013;50;312;168;144
Molėtai d. mun.;2013;51;321;153;168
Molėtai d. mun.;2013;52;307;166;141
Molėtai d. mun.;2013;53;301;148;153
Molėtai d. mun.;2013;54;295;146;149
Molėtai d. mun.;2013;55;254;121;133
Molėtai d. mun.;2013;56;249;129;120
Molėtai d. mun.;2013;57;274;120;154
Molėtai d. mun.;2013;58;221;99;122
Molėtai d. mun.;2013;59;227;113;114
Molėtai d. mun.;2013;60;278;145;133
Molėtai d. mun.;2013;61;230;105;125
Molėtai d. mun.;2013;62;242;115;127
Molėtai d. mun.;2013;63;267;138;129
Molėtai d. mun.;2013;64;218;96;122
Molėtai d. mun.;2013;65;225;89;136
Molėtai d. mun.;2013;66;188;71;117
Molėtai d. mun.;2013;67;220;95;125
Molėtai d. mun.;2013;68;169;65;104
Molėtai d. mun.;2013;69;254;99;155
Molėtai d. mun.;2013;70;268;102;166
Molėtai d. mun.;2013;71;239;86;153
Molėtai d. mun.;2013;72;248;91;157
Molėtai d. mun.;2013;73;213;87;126
Molėtai d. mun.;2013;74;248;110;138
Molėtai d. mun.;2013;75;228;75;153
Molėtai d. mun.;2013;76;247;83;164
Molėtai d. mun.;2013;77;204;63;141
Molėtai d. mun.;2013;78;181;58;123
Molėtai d. mun.;2013;79;196;52;144
Molėtai d. mun.;2013;80;179;44;135
Molėtai d. mun.;2013;81;180;55;125
Molėtai d. mun.;2013;82;178;40;138
Molėtai d. mun.;2013;83;122;35;87
Molėtai d. mun.;2013;84;129;31;98
Molėtai d. mun.;2013;85;568;126;442
Molėtai d. mun.;2014;-1;19582;9341;10241
Molėtai d. mun.;2014;0;133;55;78
Molėtai d. mun.;2014;1;133;68;65
Molėtai d. mun.;2014;2;149;75;74
Molėtai d. mun.;2014;3;133;73;60
Molėtai d. mun.;2014;4;146;73;73
Molėtai d. mun.;2014;5;136;75;61
Molėtai d. mun.;2014;6;111;62;49
Molėtai d. mun.;2014;7;138;70;68
Molėtai d. mun.;2014;8;166;95;71
Molėtai d. mun.;2014;9;156;67;89
Molėtai d. mun.;2014;10;145;81;64
Molėtai d. mun.;2014;11;159;60;99
Molėtai d. mun.;2014;12;178;88;90
Molėtai d. mun.;2014;13;209;110;99
Molėtai d. mun.;2014;14;216;112;104
Molėtai d. mun.;2014;15;219;122;97
Molėtai d. mun.;2014;16;236;127;109
Molėtai d. mun.;2014;17;266;136;130
Molėtai d. mun.;2014;18;260;139;121
Molėtai d. mun.;2014;19;317;161;156
Molėtai d. mun.;2014;20;314;161;153
Molėtai d. mun.;2014;21;336;189;147
Molėtai d. mun.;2014;22;292;162;130
Molėtai d. mun.;2014;23;236;132;104
Molėtai d. mun.;2014;24;237;143;94
Molėtai d. mun.;2014;25;244;141;103
Molėtai d. mun.;2014;26;233;140;93
Molėtai d. mun.;2014;27;226;131;95
Molėtai d. mun.;2014;28;159;86;73
Molėtai d. mun.;2014;29;189;103;86
Molėtai d. mun.;2014;30;160;104;56
Molėtai d. mun.;2014;31;142;85;57
Molėtai d. mun.;2014;32;179;102;77
Molėtai d. mun.;2014;33;171;93;78
Molėtai d. mun.;2014;34;171;84;87
Molėtai d. mun.;2014;35;189;98;91
Molėtai d. mun.;2014;36;201;116;85
Molėtai d. mun.;2014;37;242;128;114
Molėtai d. mun.;2014;38;256;128;128
Molėtai d. mun.;2014;39;239;111;128
Molėtai d. mun.;2014;40;256;145;111
Molėtai d. mun.;2014;41;272;139;133
Molėtai d. mun.;2014;42;261;128;133
Molėtai d. mun.;2014;43;292;157;135
Molėtai d. mun.;2014;44;291;158;133
Molėtai d. mun.;2014;45;342;168;174
Molėtai d. mun.;2014;46;302;161;141
Molėtai d. mun.;2014;47;309;157;152
Molėtai d. mun.;2014;48;319;165;154
Molėtai d. mun.;2014;49;294;162;132
Molėtai d. mun.;2014;50;287;160;127
Molėtai d. mun.;2014;51;311;164;147
Molėtai d. mun.;2014;52;324;155;169
Molėtai d. mun.;2014;53;306;165;141
Molėtai d. mun.;2014;54;301;148;153
Molėtai d. mun.;2014;55;292;145;147
Molėtai d. mun.;2014;56;253;118;135
Molėtai d. mun.;2014;57;245;127;118
Molėtai d. mun.;2014;58;273;121;152
Molėtai d. mun.;2014;59;216;95;121
Molėtai d. mun.;2014;60;226;111;115
Molėtai d. mun.;2014;61;271;139;132
Molėtai d. mun.;2014;62;224;100;124
Molėtai d. mun.;2014;63;239;113;126
Molėtai d. mun.;2014;64;260;131;129
Molėtai d. mun.;2014;65;212;93;119
Molėtai d. mun.;2014;66;220;86;134
Molėtai d. mun.;2014;67;183;68;115
Molėtai d. mun.;2014;68;213;91;122
Molėtai d. mun.;2014;69;162;62;100
Molėtai d. mun.;2014;70;246;95;151
Molėtai d. mun.;2014;71;258;95;163
Molėtai d. mun.;2014;72;229;81;148
Molėtai d. mun.;2014;73;239;87;152
Molėtai d. mun.;2014;74;208;84;124
Molėtai d. mun.;2014;75;238;103;135
Molėtai d. mun.;2014;76;222;71;151
Molėtai d. mun.;2014;77;239;78;161
Molėtai d. mun.;2014;78;198;61;137
Molėtai d. mun.;2014;79;168;53;115
Molėtai d. mun.;2014;80;180;46;134
Molėtai d. mun.;2014;81;156;35;121
Molėtai d. mun.;2014;82;175;50;125
Molėtai d. mun.;2014;83;158;30;128
Molėtai d. mun.;2014;84;112;31;81
Molėtai d. mun.;2014;85;578;123;455
Molėtai d. mun.;2015;-1;19233;9193;10040
Molėtai d. mun.;2015;0;142;74;68
Molėtai d. mun.;2015;1;137;56;81
Molėtai d. mun.;2015;2;133;67;66
Molėtai d. mun.;2015;3;146;75;71
Molėtai d. mun.;2015;4;127;68;59
Molėtai d. mun.;2015;5;149;74;75
Molėtai d. mun.;2015;6;133;76;57
Molėtai d. mun.;2015;7;105;59;46
Molėtai d. mun.;2015;8;142;70;72
Molėtai d. mun.;2015;9;163;92;71
Molėtai d. mun.;2015;10;154;66;88
Molėtai d. mun.;2015;11;142;79;63
Molėtai d. mun.;2015;12;159;60;99
Molėtai d. mun.;2015;13;178;87;91
Molėtai d. mun.;2015;14;208;111;97
Molėtai d. mun.;2015;15;215;111;104
Molėtai d. mun.;2015;16;219;123;96
Molėtai d. mun.;2015;17;236;126;110
Molėtai d. mun.;2015;18;265;134;131
Molėtai d. mun.;2015;19;255;138;117
Molėtai d. mun.;2015;20;315;160;155
Molėtai d. mun.;2015;21;314;164;150
Molėtai d. mun.;2015;22;337;188;149
Molėtai d. mun.;2015;23;285;157;128
Molėtai d. mun.;2015;24;221;124;97
Molėtai d. mun.;2015;25;224;140;84
Molėtai d. mun.;2015;26;234;140;94
Molėtai d. mun.;2015;27;219;140;79
Molėtai d. mun.;2015;28;218;128;90
Molėtai d. mun.;2015;29;155;86;69
Molėtai d. mun.;2015;30;173;97;76
Molėtai d. mun.;2015;31;150;94;56
Molėtai d. mun.;2015;32;142;85;57
Molėtai d. mun.;2015;33;173;99;74
Molėtai d. mun.;2015;34;174;97;77
Molėtai d. mun.;2015;35;162;80;82
Molėtai d. mun.;2015;36;182;94;88
Molėtai d. mun.;2015;37;206;119;87
Molėtai d. mun.;2015;38;244;130;114
Molėtai d. mun.;2015;39;255;127;128
Molėtai d. mun.;2015;40;242;113;129
Molėtai d. mun.;2015;41;254;144;110
Molėtai d. mun.;2015;42;272;141;131
Molėtai d. mun.;2015;43;262;128;134
Molėtai d. mun.;2015;44;290;154;136
Molėtai d. mun.;2015;45;287;155;132
Molėtai d. mun.;2015;46;343;166;177
Molėtai d. mun.;2015;47;300;160;140
Molėtai d. mun.;2015;48;309;154;155
Molėtai d. mun.;2015;49;318;163;155
Molėtai d. mun.;2015;50;294;160;134
Molėtai d. mun.;2015;51;288;161;127
Molėtai d. mun.;2015;52;307;160;147
Molėtai d. mun.;2015;53;317;151;166
Molėtai d. mun.;2015;54;302;161;141
Molėtai d. mun.;2015;55;297;147;150
Molėtai d. mun.;2015;56;291;144;147
Molėtai d. mun.;2015;57;255;120;135
Molėtai d. mun.;2015;58;242;123;119
Molėtai d. mun.;2015;59;276;123;153
Molėtai d. mun.;2015;60;210;91;119
Molėtai d. mun.;2015;61;222;108;114
Molėtai d. mun.;2015;62;261;132;129
Molėtai d. mun.;2015;63;213;91;122
Molėtai d. mun.;2015;64;234;109;125
Molėtai d. mun.;2015;65;256;127;129
Molėtai d. mun.;2015;66;204;86;118
Molėtai d. mun.;2015;67;215;83;132
Molėtai d. mun.;2015;68;178;66;112
Molėtai d. mun.;2015;69;206;86;120
Molėtai d. mun.;2015;70;161;62;99
Molėtai d. mun.;2015;71;235;88;147
Molėtai d. mun.;2015;72;250;90;160
Molėtai d. mun.;2015;73;218;75;143
Molėtai d. mun.;2015;74;228;81;147
Molėtai d. mun.;2015;75;203;81;122
Molėtai d. mun.;2015;76;229;96;133
Molėtai d. mun.;2015;77;218;68;150
Molėtai d. mun.;2015;78;231;72;159
Molėtai d. mun.;2015;79;188;56;132
Molėtai d. mun.;2015;80;150;48;102
Molėtai d. mun.;2015;81;167;41;126
Molėtai d. mun.;2015;82;144;34;110
Molėtai d. mun.;2015;83;159;44;115
Molėtai d. mun.;2015;84;144;26;118
Molėtai d. mun.;2015;85;572;129;443
Molėtai d. mun.;2016;-1;18877;9051;9826
Molėtai d. mun.;2016;0;161;79;82
Molėtai d. mun.;2016;1;140;75;65
Molėtai d. mun.;2016;2;135;56;79
Molėtai d. mun.;2016;3;127;62;65
Molėtai d. mun.;2016;4;146;73;73
Molėtai d. mun.;2016;5;125;66;59
Molėtai d. mun.;2016;6;146;73;73
Molėtai d. mun.;2016;7;133;77;56
Molėtai d. mun.;2016;8;107;61;46
Molėtai d. mun.;2016;9;140;68;72
Molėtai d. mun.;2016;10;163;91;72
Molėtai d. mun.;2016;11;156;68;88
Molėtai d. mun.;2016;12;143;80;63
Molėtai d. mun.;2016;13;162;62;100
Molėtai d. mun.;2016;14;177;86;91
Molėtai d. mun.;2016;15;206;111;95
Molėtai d. mun.;2016;16;216;112;104
Molėtai d. mun.;2016;17;218;122;96
Molėtai d. mun.;2016;18;237;127;110
Molėtai d. mun.;2016;19;261;132;129
Molėtai d. mun.;2016;20;252;136;116
Molėtai d. mun.;2016;21;318;165;153
Molėtai d. mun.;2016;22;308;163;145
Molėtai d. mun.;2016;23;328;182;146
Molėtai d. mun.;2016;24;273;154;119
Molėtai d. mun.;2016;25;210;123;87
Molėtai d. mun.;2016;26;207;131;76
Molėtai d. mun.;2016;27;215;132;83
Molėtai d. mun.;2016;28;200;130;70
Molėtai d. mun.;2016;29;203;118;85
Molėtai d. mun.;2016;30;152;90;62
Molėtai d. mun.;2016;31;163;92;71
Molėtai d. mun.;2016;32;133;80;53
Molėtai d. mun.;2016;33;141;84;57
Molėtai d. mun.;2016;34;173;99;74
Molėtai d. mun.;2016;35;166;95;71
Molėtai d. mun.;2016;36;156;75;81
Molėtai d. mun.;2016;37;176;90;86
Molėtai d. mun.;2016;38;202;119;83
Molėtai d. mun.;2016;39;238;124;114
Molėtai d. mun.;2016;40;251;124;127
Molėtai d. mun.;2016;41;240;114;126
Molėtai d. mun.;2016;42;257;147;110
Molėtai d. mun.;2016;43;271;140;131
Molėtai d. mun.;2016;44;258;122;136
Molėtai d. mun.;2016;45;291;157;134
Molėtai d. mun.;2016;46;287;155;132
Molėtai d. mun.;2016;47;339;163;176
Molėtai d. mun.;2016;48;301;161;140
Molėtai d. mun.;2016;49;312;159;153
Molėtai d. mun.;2016;50;316;164;152
Molėtai d. mun.;2016;51;295;161;134
Molėtai d. mun.;2016;52;281;154;127
Molėtai d. mun.;2016;53;304;156;148
Molėtai d. mun.;2016;54;310;144;166
Molėtai d. mun.;2016;55;298;159;139
Molėtai d. mun.;2016;56;296;148;148
Molėtai d. mun.;2016;57;284;141;143
Molėtai d. mun.;2016;58;255;120;135
Molėtai d. mun.;2016;59;242;124;118
Molėtai d. mun.;2016;60;275;121;154
Molėtai d. mun.;2016;61;207;89;118
Molėtai d. mun.;2016;62;223;109;114
Molėtai d. mun.;2016;63;259;128;131
Molėtai d. mun.;2016;64;212;90;122
Molėtai d. mun.;2016;65;231;108;123
Molėtai d. mun.;2016;66;250;123;127
Molėtai d. mun.;2016;67;198;81;117
Molėtai d. mun.;2016;68;206;79;127
Molėtai d. mun.;2016;69;171;62;109
Molėtai d. mun.;2016;70;196;80;116
Molėtai d. mun.;2016;71;160;63;97
Molėtai d. mun.;2016;72;228;84;144
Molėtai d. mun.;2016;73;244;85;159
Molėtai d. mun.;2016;74;214;74;140
Molėtai d. mun.;2016;75;220;77;143
Molėtai d. mun.;2016;76;197;77;120
Molėtai d. mun.;2016;77;219;92;127
Molėtai d. mun.;2016;78;205;62;143
Molėtai d. mun.;2016;79;214;64;150
Molėtai d. mun.;2016;80;181;53;128
Molėtai d. mun.;2016;81;141;45;96
Molėtai d. mun.;2016;82;151;35;116
Molėtai d. mun.;2016;83;133;30;103
Molėtai d. mun.;2016;84;144;37;107
Molėtai d. mun.;2016;85;597;127;470
Molėtai d. mun.;2017;-1;18407;8829;9578
Molėtai d. mun.;2017;0;127;65;62
Molėtai d. mun.;2017;1;164;81;83
Molėtai d. mun.;2017;2;142;76;66
Molėtai d. mun.;2017;3;137;58;79
Molėtai d. mun.;2017;4;122;61;61
Molėtai d. mun.;2017;5;142;72;70
Molėtai d. mun.;2017;6;121;62;59
Molėtai d. mun.;2017;7;147;73;74
Molėtai d. mun.;2017;8;132;75;57
Molėtai d. mun.;2017;9;111;63;48
Molėtai d. mun.;2017;10;141;67;74
Molėtai d. mun.;2017;11;158;88;70
Molėtai d. mun.;2017;12;153;67;86
Molėtai d. mun.;2017;13;145;81;64
Molėtai d. mun.;2017;14;161;61;100
Molėtai d. mun.;2017;15;172;84;88
Molėtai d. mun.;2017;16;209;111;98
Molėtai d. mun.;2017;17;208;108;100
Molėtai d. mun.;2017;18;215;121;94
Molėtai d. mun.;2017;19;229;124;105
Molėtai d. mun.;2017;20;251;126;125
Molėtai d. mun.;2017;21;244;132;112
Molėtai d. mun.;2017;22;314;165;149
Molėtai d. mun.;2017;23;284;152;132
Molėtai d. mun.;2017;24;319;181;138
Molėtai d. mun.;2017;25;258;148;110
Molėtai d. mun.;2017;26;201;123;78
Molėtai d. mun.;2017;27;190;123;67
Molėtai d. mun.;2017;28;206;131;75
Molėtai d. mun.;2017;29;184;122;62
Molėtai d. mun.;2017;30;196;114;82
Molėtai d. mun.;2017;31;148;87;61
Molėtai d. mun.;2017;32;151;86;65
Molėtai d. mun.;2017;33;122;75;47
Molėtai d. mun.;2017;34;133;76;57
Molėtai d. mun.;2017;35;165;89;76
Molėtai d. mun.;2017;36;161;89;72
Molėtai d. mun.;2017;37;158;74;84
Molėtai d. mun.;2017;38;177;91;86
Molėtai d. mun.;2017;39;199;119;80
Molėtai d. mun.;2017;40;231;121;110
Molėtai d. mun.;2017;41;249;122;127
Molėtai d. mun.;2017;42;232;110;122
Molėtai d. mun.;2017;43;252;148;104
Molėtai d. mun.;2017;44;266;138;128
Molėtai d. mun.;2017;45;253;122;131
Molėtai d. mun.;2017;46;289;157;132
Molėtai d. mun.;2017;47;282;152;130
Molėtai d. mun.;2017;48;336;161;175
Molėtai d. mun.;2017;49;296;157;139
Molėtai d. mun.;2017;50;311;159;152
Molėtai d. mun.;2017;51;313;163;150
Molėtai d. mun.;2017;52;288;158;130
Molėtai d. mun.;2017;53;278;153;125
Molėtai d. mun.;2017;54;301;153;148
Molėtai d. mun.;2017;55;309;141;168
Molėtai d. mun.;2017;56;290;152;138
Molėtai d. mun.;2017;57;294;146;148
Molėtai d. mun.;2017;58;286;138;148
Molėtai d. mun.;2017;59;250;116;134
Molėtai d. mun.;2017;60;243;127;116
Molėtai d. mun.;2017;61;273;117;156
Molėtai d. mun.;2017;62;202;85;117
Molėtai d. mun.;2017;63;221;107;114
Molėtai d. mun.;2017;64;256;126;130
Molėtai d. mun.;2017;65;208;84;124
Molėtai d. mun.;2017;66;228;106;122
Molėtai d. mun.;2017;67;246;120;126
Molėtai d. mun.;2017;68;193;78;115
Molėtai d. mun.;2017;69;196;76;120
Molėtai d. mun.;2017;70;167;58;109
Molėtai d. mun.;2017;71;186;76;110
Molėtai d. mun.;2017;72;151;56;95
Molėtai d. mun.;2017;73;212;75;137
Molėtai d. mun.;2017;74;237;79;158
Molėtai d. mun.;2017;75;204;68;136
Molėtai d. mun.;2017;76;212;74;138
Molėtai d. mun.;2017;77;188;72;116
Molėtai d. mun.;2017;78;205;85;120
Molėtai d. mun.;2017;79;196;55;141
Molėtai d. mun.;2017;80;195;57;138
Molėtai d. mun.;2017;81;163;45;118
Molėtai d. mun.;2017;82;131;39;92
Molėtai d. mun.;2017;83;142;31;111
Molėtai d. mun.;2017;84;125;29;96
Molėtai d. mun.;2017;85;624;136;488
Molėtai d. mun.;2018;-1;17856;8578;9278
Molėtai d. mun.;2018;0;125;72;53
Molėtai d. mun.;2018;1;125;65;60
Molėtai d. mun.;2018;2;158;78;80
Molėtai d. mun.;2018;3;141;76;65
Molėtai d. mun.;2018;4;138;61;77
Molėtai d. mun.;2018;5;125;62;63
Molėtai d. mun.;2018;6;141;72;69
Molėtai d. mun.;2018;7;129;67;62
Molėtai d. mun.;2018;8;144;73;71
Molėtai d. mun.;2018;9;127;70;57
Molėtai d. mun.;2018;10;110;63;47
Molėtai d. mun.;2018;11;142;66;76
Molėtai d. mun.;2018;12;155;85;70
Molėtai d. mun.;2018;13;152;68;84
Molėtai d. mun.;2018;14;144;80;64
Molėtai d. mun.;2018;15;159;60;99
Molėtai d. mun.;2018;16;172;84;88
Molėtai d. mun.;2018;17;205;107;98
Molėtai d. mun.;2018;18;202;103;99
Molėtai d. mun.;2018;19;211;120;91
Molėtai d. mun.;2018;20;222;121;101
Molėtai d. mun.;2018;21;251;125;126
Molėtai d. mun.;2018;22;225;120;105
Molėtai d. mun.;2018;23;300;158;142
Molėtai d. mun.;2018;24;267;147;120
Molėtai d. mun.;2018;25;302;171;131
Molėtai d. mun.;2018;26;237;136;101
Molėtai d. mun.;2018;27;188;118;70
Molėtai d. mun.;2018;28;174;117;57
Molėtai d. mun.;2018;29;184;118;66
Molėtai d. mun.;2018;30;171;119;52
Molėtai d. mun.;2018;31;174;100;74
Molėtai d. mun.;2018;32;135;77;58
Molėtai d. mun.;2018;33;140;83;57
Molėtai d. mun.;2018;34;112;70;42
Molėtai d. mun.;2018;35;125;66;59
Molėtai d. mun.;2018;36;154;85;69
Molėtai d. mun.;2018;37;147;79;68
Molėtai d. mun.;2018;38;148;71;77
Molėtai d. mun.;2018;39;171;86;85
Molėtai d. mun.;2018;40;197;117;80
Molėtai d. mun.;2018;41;226;118;108
Molėtai d. mun.;2018;42;242;124;118
Molėtai d. mun.;2018;43;231;108;123
Molėtai d. mun.;2018;44;252;149;103
Molėtai d. mun.;2018;45;263;133;130
Molėtai d. mun.;2018;46;255;124;131
Molėtai d. mun.;2018;47;287;156;131
Molėtai d. mun.;2018;48;280;152;128
Molėtai d. mun.;2018;49;332;158;174
Molėtai d. mun.;2018;50;294;156;138
Molėtai d. mun.;2018;51;309;157;152
Molėtai d. mun.;2018;52;304;157;147
Molėtai d. mun.;2018;53;283;154;129
Molėtai d. mun.;2018;54;277;152;125
Molėtai d. mun.;2018;55;299;154;145
Molėtai d. mun.;2018;56;308;140;168
Molėtai d. mun.;2018;57;288;150;138
Molėtai d. mun.;2018;58;294;146;148
Molėtai d. mun.;2018;59;276;132;144
Molėtai d. mun.;2018;60;250;115;135
Molėtai d. mun.;2018;61;241;125;116
Molėtai d. mun.;2018;62;267;112;155
Molėtai d. mun.;2018;63;199;82;117
Molėtai d. mun.;2018;64;219;105;114
Molėtai d. mun.;2018;65;250;121;129
Molėtai d. mun.;2018;66;205;83;122
Molėtai d. mun.;2018;67;226;105;121
Molėtai d. mun.;2018;68;238;115;123
Molėtai d. mun.;2018;69;185;72;113
Molėtai d. mun.;2018;70;192;73;119
Molėtai d. mun.;2018;71;161;53;108
Molėtai d. mun.;2018;72;181;72;109
Molėtai d. mun.;2018;73;144;53;91
Molėtai d. mun.;2018;74;203;70;133
Molėtai d. mun.;2018;75;228;75;153
Molėtai d. mun.;2018;76;197;64;133
Molėtai d. mun.;2018;77;201;67;134
Molėtai d. mun.;2018;78;176;64;112
Molėtai d. mun.;2018;79;197;81;116
Molėtai d. mun.;2018;80;183;49;134
Molėtai d. mun.;2018;81;178;50;128
Molėtai d. mun.;2018;82;149;41;108
Molėtai d. mun.;2018;83;125;35;90
Molėtai d. mun.;2018;84;126;23;103
Molėtai d. mun.;2018;85;606;137;469
Neringa mun.;2001;-1;2399;1138;1261
Neringa mun.;2001;0;19;13;6
Neringa mun.;2001;1;25;12;13
Neringa mun.;2001;2;29;16;13
Neringa mun.;2001;3;20;8;12
Neringa mun.;2001;4;32;21;11
Neringa mun.;2001;5;38;16;22
Neringa mun.;2001;6;34;22;12
Neringa mun.;2001;7;30;18;12
Neringa mun.;2001;8;35;15;20
Neringa mun.;2001;9;41;22;19
Neringa mun.;2001;10;39;15;24
Neringa mun.;2001;11;40;20;20
Neringa mun.;2001;12;27;13;14
Neringa mun.;2001;13;43;26;17
Neringa mun.;2001;14;45;25;20
Neringa mun.;2001;15;42;19;23
Neringa mun.;2001;16;33;19;14
Neringa mun.;2001;17;44;24;20
Neringa mun.;2001;18;27;20;7
Neringa mun.;2001;19;17;6;11
Neringa mun.;2001;20;33;17;16
Neringa mun.;2001;21;25;16;9
Neringa mun.;2001;22;36;22;14
Neringa mun.;2001;23;33;17;16
Neringa mun.;2001;24;26;17;9
Neringa mun.;2001;25;22;11;11
Neringa mun.;2001;26;24;15;9
Neringa mun.;2001;27;37;17;20
Neringa mun.;2001;28;38;18;20
Neringa mun.;2001;29;36;19;17
Neringa mun.;2001;30;38;17;21
Neringa mun.;2001;31;40;19;21
Neringa mun.;2001;32;36;20;16
Neringa mun.;2001;33;33;12;21
Neringa mun.;2001;34;36;13;23
Neringa mun.;2001;35;43;26;17
Neringa mun.;2001;36;24;13;11
Neringa mun.;2001;37;36;12;24
Neringa mun.;2001;38;41;20;21
Neringa mun.;2001;39;56;26;30
Neringa mun.;2001;40;43;17;26
Neringa mun.;2001;41;42;21;21
Neringa mun.;2001;42;40;23;17
Neringa mun.;2001;43;41;22;19
Neringa mun.;2001;44;36;12;24
Neringa mun.;2001;45;37;19;18
Neringa mun.;2001;46;29;8;21
Neringa mun.;2001;47;32;15;17
Neringa mun.;2001;48;32;16;16
Neringa mun.;2001;49;43;22;21
Neringa mun.;2001;50;37;18;19
Neringa mun.;2001;51;35;19;16
Neringa mun.;2001;52;22;10;12
Neringa mun.;2001;53;27;12;15
Neringa mun.;2001;54;23;9;14
Neringa mun.;2001;55;19;10;9
Neringa mun.;2001;56;26;12;14
Neringa mun.;2001;57;19;6;13
Neringa mun.;2001;58;33;15;18
Neringa mun.;2001;59;20;7;13
Neringa mun.;2001;60;26;10;16
Neringa mun.;2001;61;26;14;12
Neringa mun.;2001;62;26;16;10
Neringa mun.;2001;63;22;7;15
Neringa mun.;2001;64;14;5;9
Neringa mun.;2001;65;29;11;18
Neringa mun.;2001;66;24;11;13
Neringa mun.;2001;67;17;8;9
Neringa mun.;2001;68;22;9;13
Neringa mun.;2001;69;29;12;17
Neringa mun.;2001;70;23;6;17
Neringa mun.;2001;71;11;4;7
Neringa mun.;2001;72;21;8;13
Neringa mun.;2001;73;22;4;18
Neringa mun.;2001;74;11;4;7
Neringa mun.;2001;75;15;2;13
Neringa mun.;2001;76;8;1;7
Neringa mun.;2001;77;9;4;5
Neringa mun.;2001;78;8;2;6
Neringa mun.;2001;79;8;3;5
Neringa mun.;2001;80;6;1;5
Neringa mun.;2001;81;4;0;4
Neringa mun.;2001;82;5;0;5
Neringa mun.;2001;83;0;0;0
Neringa mun.;2001;84;3;0;3
Neringa mun.;2001;85;21;6;15
Neringa mun.;2002;-1;2202;1011;1191
Neringa mun.;2002;0;12;6;6
Neringa mun.;2002;1;18;12;6
Neringa mun.;2002;2;22;11;11
Neringa mun.;2002;3;26;14;12
Neringa mun.;2002;4;17;7;10
Neringa mun.;2002;5;30;20;10
Neringa mun.;2002;6;36;14;22
Neringa mun.;2002;7;31;20;11
Neringa mun.;2002;8;27;16;11
Neringa mun.;2002;9;32;13;19
Neringa mun.;2002;10;39;20;19
Neringa mun.;2002;11;36;13;23
Neringa mun.;2002;12;38;19;19
Neringa mun.;2002;13;25;12;13
Neringa mun.;2002;14;39;23;16
Neringa mun.;2002;15;41;22;19
Neringa mun.;2002;16;39;17;22
Neringa mun.;2002;17;30;17;13
Neringa mun.;2002;18;41;21;20
Neringa mun.;2002;19;24;17;7
Neringa mun.;2002;20;14;4;10
Neringa mun.;2002;21;30;16;14
Neringa mun.;2002;22;21;12;9
Neringa mun.;2002;23;33;20;13
Neringa mun.;2002;24;32;17;15
Neringa mun.;2002;25;23;15;8
Neringa mun.;2002;26;20;10;10
Neringa mun.;2002;27;22;14;8
Neringa mun.;2002;28;34;15;19
Neringa mun.;2002;29;34;15;19
Neringa mun.;2002;30;34;18;16
Neringa mun.;2002;31;35;14;21
Neringa mun.;2002;32;37;17;20
Neringa mun.;2002;33;33;18;15
Neringa mun.;2002;34;31;11;20
Neringa mun.;2002;35;34;12;22
Neringa mun.;2002;36;42;24;18
Neringa mun.;2002;37;22;12;10
Neringa mun.;2002;38;34;11;23
Neringa mun.;2002;39;37;17;20
Neringa mun.;2002;40;51;23;28
Neringa mun.;2002;41;40;15;25
Neringa mun.;2002;42;37;18;19
Neringa mun.;2002;43;37;21;16
Neringa mun.;2002;44;38;20;18
Neringa mun.;2002;45;35;12;23
Neringa mun.;2002;46;35;18;17
Neringa mun.;2002;47;27;7;20
Neringa mun.;2002;48;29;13;16
Neringa mun.;2002;49;29;14;15
Neringa mun.;2002;50;38;18;20
Neringa mun.;2002;51;34;16;18
Neringa mun.;2002;52;32;17;15
Neringa mun.;2002;53;19;8;11
Neringa mun.;2002;54;25;11;14
Neringa mun.;2002;55;21;8;13
Neringa mun.;2002;56;17;9;8
Neringa mun.;2002;57;23;11;12
Neringa mun.;2002;58;16;4;12
Neringa mun.;2002;59;28;12;16
Neringa mun.;2002;60;19;7;12
Neringa mun.;2002;61;24;9;15
Neringa mun.;2002;62;26;14;12
Neringa mun.;2002;63;25;15;10
Neringa mun.;2002;64;20;6;14
Neringa mun.;2002;65;14;5;9
Neringa mun.;2002;66;26;9;17
Neringa mun.;2002;67;21;9;12
Neringa mun.;2002;68;17;7;10
Neringa mun.;2002;69;18;7;11
Neringa mun.;2002;70;25;8;17
Neringa mun.;2002;71;20;5;15
Neringa mun.;2002;72;9;2;7
Neringa mun.;2002;73;19;7;12
Neringa mun.;2002;74;20;3;17
Neringa mun.;2002;75;9;3;6
Neringa mun.;2002;76;12;2;10
Neringa mun.;2002;77;8;1;7
Neringa mun.;2002;78;9;4;5
Neringa mun.;2002;79;8;2;6
Neringa mun.;2002;80;7;2;5
Neringa mun.;2002;81;6;1;5
Neringa mun.;2002;82;4;0;4
Neringa mun.;2002;83;4;0;4
Neringa mun.;2002;84;0;0;0
Neringa mun.;2002;85;16;2;14
Neringa mun.;2003;-1;2160;993;1167
Neringa mun.;2003;0;18;10;8
Neringa mun.;2003;1;15;9;6
Neringa mun.;2003;2;17;11;6
Neringa mun.;2003;3;22;10;12
Neringa mun.;2003;4;26;14;12
Neringa mun.;2003;5;18;8;10
Neringa mun.;2003;6;31;21;10
Neringa mun.;2003;7;34;13;21
Neringa mun.;2003;8;29;19;10
Neringa mun.;2003;9;27;16;11
Neringa mun.;2003;10;31;13;18
Neringa mun.;2003;11;37;19;18
Neringa mun.;2003;12;37;14;23
Neringa mun.;2003;13;36;18;18
Neringa mun.;2003;14;25;11;14
Neringa mun.;2003;15;37;22;15
Neringa mun.;2003;16;40;22;18
Neringa mun.;2003;17;37;16;21
Neringa mun.;2003;18;29;16;13
Neringa mun.;2003;19;38;21;17
Neringa mun.;2003;20;22;16;6
Neringa mun.;2003;21;14;4;10
Neringa mun.;2003;22;30;15;15
Neringa mun.;2003;23;21;12;9
Neringa mun.;2003;24;34;20;14
Neringa mun.;2003;25;32;16;16
Neringa mun.;2003;26;26;15;11
Neringa mun.;2003;27;20;9;11
Neringa mun.;2003;28;20;13;7
Neringa mun.;2003;29;35;15;20
Neringa mun.;2003;30;33;15;18
Neringa mun.;2003;31;32;17;15
Neringa mun.;2003;32;37;15;22
Neringa mun.;2003;33;35;16;19
Neringa mun.;2003;34;33;17;16
Neringa mun.;2003;35;29;10;19
Neringa mun.;2003;36;33;11;22
Neringa mun.;2003;37;41;23;18
Neringa mun.;2003;38;22;12;10
Neringa mun.;2003;39;32;10;22
Neringa mun.;2003;40;35;16;19
Neringa mun.;2003;41;49;22;27
Neringa mun.;2003;42;39;14;25
Neringa mun.;2003;43;37;18;19
Neringa mun.;2003;44;36;20;16
Neringa mun.;2003;45;36;19;17
Neringa mun.;2003;46;33;11;22
Neringa mun.;2003;47;33;17;16
Neringa mun.;2003;48;29;9;20
Neringa mun.;2003;49;29;13;16
Neringa mun.;2003;50;30;14;16
Neringa mun.;2003;51;35;16;19
Neringa mun.;2003;52;32;16;16
Neringa mun.;2003;53;30;16;14
Neringa mun.;2003;54;19;8;11
Neringa mun.;2003;55;25;11;14
Neringa mun.;2003;56;21;8;13
Neringa mun.;2003;57;17;9;8
Neringa mun.;2003;58;22;10;12
Neringa mun.;2003;59;17;4;13
Neringa mun.;2003;60;27;11;16
Neringa mun.;2003;61;18;6;12
Neringa mun.;2003;62;24;9;15
Neringa mun.;2003;63;24;14;10
Neringa mun.;2003;64;27;17;10
Neringa mun.;2003;65;22;6;16
Neringa mun.;2003;66;11;4;7
Neringa mun.;2003;67;26;9;17
Neringa mun.;2003;68;21;9;12
Neringa mun.;2003;69;15;7;8
Neringa mun.;2003;70;17;7;10
Neringa mun.;2003;71;22;8;14
Neringa mun.;2003;72;19;4;15
Neringa mun.;2003;73;8;2;6
Neringa mun.;2003;74;17;7;10
Neringa mun.;2003;75;18;3;15
Neringa mun.;2003;76;8;2;6
Neringa mun.;2003;77;11;2;9
Neringa mun.;2003;78;8;1;7
Neringa mun.;2003;79;8;4;4
Neringa mun.;2003;80;6;1;5
Neringa mun.;2003;81;7;2;5
Neringa mun.;2003;82;6;1;5
Neringa mun.;2003;83;4;0;4
Neringa mun.;2003;84;4;0;4
Neringa mun.;2003;85;13;2;11
Neringa mun.;2004;-1;2244;1056;1188
Neringa mun.;2004;0;14;7;7
Neringa mun.;2004;1;19;11;8
Neringa mun.;2004;2;16;9;7
Neringa mun.;2004;3;17;12;5
Neringa mun.;2004;4;23;11;12
Neringa mun.;2004;5;26;14;12
Neringa mun.;2004;6;18;7;11
Neringa mun.;2004;7;30;20;10
Neringa mun.;2004;8;33;12;21
Neringa mun.;2004;9;29;19;10
Neringa mun.;2004;10;28;16;12
Neringa mun.;2004;11;29;12;17
Neringa mun.;2004;12;36;19;17
Neringa mun.;2004;13;36;13;23
Neringa mun.;2004;14;36;18;18
Neringa mun.;2004;15;24;10;14
Neringa mun.;2004;16;34;20;14
Neringa mun.;2004;17;37;21;16
Neringa mun.;2004;18;33;15;18
Neringa mun.;2004;19;27;15;12
Neringa mun.;2004;20;38;21;17
Neringa mun.;2004;21;23;14;9
Neringa mun.;2004;22;20;6;14
Neringa mun.;2004;23;32;17;15
Neringa mun.;2004;24;21;11;10
Neringa mun.;2004;25;34;21;13
Neringa mun.;2004;26;35;18;17
Neringa mun.;2004;27;26;16;10
Neringa mun.;2004;28;26;13;13
Neringa mun.;2004;29;22;15;7
Neringa mun.;2004;30;37;18;19
Neringa mun.;2004;31;35;17;18
Neringa mun.;2004;32;37;19;18
Neringa mun.;2004;33;37;16;21
Neringa mun.;2004;34;36;16;20
Neringa mun.;2004;35;32;18;14
Neringa mun.;2004;36;31;11;20
Neringa mun.;2004;37;37;12;25
Neringa mun.;2004;38;47;27;20
Neringa mun.;2004;39;28;15;13
Neringa mun.;2004;40;32;13;19
Neringa mun.;2004;41;45;21;24
Neringa mun.;2004;42;56;25;31
Neringa mun.;2004;43;45;18;27
Neringa mun.;2004;44;41;21;20
Neringa mun.;2004;45;41;25;16
Neringa mun.;2004;46;40;22;18
Neringa mun.;2004;47;33;12;21
Neringa mun.;2004;48;35;19;16
Neringa mun.;2004;49;32;11;21
Neringa mun.;2004;50;28;12;16
Neringa mun.;2004;51;32;16;16
Neringa mun.;2004;52;38;17;21
Neringa mun.;2004;53;35;19;16
Neringa mun.;2004;54;30;17;13
Neringa mun.;2004;55;19;8;11
Neringa mun.;2004;56;25;10;15
Neringa mun.;2004;57;19;7;12
Neringa mun.;2004;58;16;9;7
Neringa mun.;2004;59;23;9;14
Neringa mun.;2004;60;18;6;12
Neringa mun.;2004;61;27;12;15
Neringa mun.;2004;62;21;9;12
Neringa mun.;2004;63;23;9;14
Neringa mun.;2004;64;24;15;9
Neringa mun.;2004;65;19;11;8
Neringa mun.;2004;66;20;6;14
Neringa mun.;2004;67;9;3;6
Neringa mun.;2004;68;26;10;16
Neringa mun.;2004;69;21;8;13
Neringa mun.;2004;70;17;8;9
Neringa mun.;2004;71;17;7;10
Neringa mun.;2004;72;23;9;14
Neringa mun.;2004;73;20;4;16
Neringa mun.;2004;74;5;0;5
Neringa mun.;2004;75;18;8;10
Neringa mun.;2004;76;18;3;15
Neringa mun.;2004;77;8;2;6
Neringa mun.;2004;78;11;3;8
Neringa mun.;2004;79;7;1;6
Neringa mun.;2004;80;8;3;5
Neringa mun.;2004;81;6;1;5
Neringa mun.;2004;82;7;2;5
Neringa mun.;2004;83;6;1;5
Neringa mun.;2004;84;5;0;5
Neringa mun.;2004;85;16;2;14
Neringa mun.;2005;-1;2316;1109;1207
Neringa mun.;2005;0;21;7;14
Neringa mun.;2005;1;14;7;7
Neringa mun.;2005;2;17;9;8
Neringa mun.;2005;3;15;7;8
Neringa mun.;2005;4;19;13;6
Neringa mun.;2005;5;21;11;10
Neringa mun.;2005;6;26;15;11
Neringa mun.;2005;7;17;7;10
Neringa mun.;2005;8;29;20;9
Neringa mun.;2005;9;35;13;22
Neringa mun.;2005;10;28;18;10
Neringa mun.;2005;11;26;15;11
Neringa mun.;2005;12;29;12;17
Neringa mun.;2005;13;34;18;16
Neringa mun.;2005;14;34;12;22
Neringa mun.;2005;15;36;18;18
Neringa mun.;2005;16;23;9;14
Neringa mun.;2005;17;32;19;13
Neringa mun.;2005;18;38;22;16
Neringa mun.;2005;19;34;16;18
Neringa mun.;2005;20;29;16;13
Neringa mun.;2005;21;36;20;16
Neringa mun.;2005;22;22;13;9
Neringa mun.;2005;23;20;6;14
Neringa mun.;2005;24;32;17;15
Neringa mun.;2005;25;23;13;10
Neringa mun.;2005;26;34;20;14
Neringa mun.;2005;27;38;18;20
Neringa mun.;2005;28;24;16;8
Neringa mun.;2005;29;26;14;12
Neringa mun.;2005;30;31;21;10
Neringa mun.;2005;31;40;20;20
Neringa mun.;2005;32;39;20;19
Neringa mun.;2005;33;37;19;18
Neringa mun.;2005;34;42;20;22
Neringa mun.;2005;35;41;19;22
Neringa mun.;2005;36;39;21;18
Neringa mun.;2005;37;29;12;17
Neringa mun.;2005;38;40;14;26
Neringa mun.;2005;39;50;29;21
Neringa mun.;2005;40;32;16;16
Neringa mun.;2005;41;37;18;19
Neringa mun.;2005;42;44;19;25
Neringa mun.;2005;43;58;28;30
Neringa mun.;2005;44;48;21;27
Neringa mun.;2005;45;42;22;20
Neringa mun.;2005;46;43;27;16
Neringa mun.;2005;47;44;25;19
Neringa mun.;2005;48;36;15;21
Neringa mun.;2005;49;39;21;18
Neringa mun.;2005;50;32;11;21
Neringa mun.;2005;51;31;14;17
Neringa mun.;2005;52;34;19;15
Neringa mun.;2005;53;42;19;23
Neringa mun.;2005;54;36;20;16
Neringa mun.;2005;55;30;17;13
Neringa mun.;2005;56;23;10;13
Neringa mun.;2005;57;26;10;16
Neringa mun.;2005;58;18;6;12
Neringa mun.;2005;59;19;11;8
Neringa mun.;2005;60;24;10;14
Neringa mun.;2005;61;19;6;13
Neringa mun.;2005;62;25;11;14
Neringa mun.;2005;63;23;10;13
Neringa mun.;2005;64;25;11;14
Neringa mun.;2005;65;22;14;8
Neringa mun.;2005;66;19;10;9
Neringa mun.;2005;67;19;7;12
Neringa mun.;2005;68;9;3;6
Neringa mun.;2005;69;26;10;16
Neringa mun.;2005;70;19;7;12
Neringa mun.;2005;71;16;7;9
Neringa mun.;2005;72;17;7;10
Neringa mun.;2005;73;21;8;13
Neringa mun.;2005;74;18;4;14
Neringa mun.;2005;75;4;0;4
Neringa mun.;2005;76;16;6;10
Neringa mun.;2005;77;16;2;14
Neringa mun.;2005;78;7;2;5
Neringa mun.;2005;79;10;2;8
Neringa mun.;2005;80;6;1;5
Neringa mun.;2005;81;7;2;5
Neringa mun.;2005;82;6;1;5
Neringa mun.;2005;83;6;1;5
Neringa mun.;2005;84;5;1;4
Neringa mun.;2005;85;17;1;16
Neringa mun.;2006;-1;2230;1039;1191
Neringa mun.;2006;0;22;9;13
Neringa mun.;2006;1;21;7;14
Neringa mun.;2006;2;14;6;8
Neringa mun.;2006;3;15;7;8
Neringa mun.;2006;4;14;7;7
Neringa mun.;2006;5;18;12;6
Neringa mun.;2006;6;18;9;9
Neringa mun.;2006;7;24;13;11
Neringa mun.;2006;8;17;6;11
Neringa mun.;2006;9;26;17;9
Neringa mun.;2006;10;31;10;21
Neringa mun.;2006;11;25;15;10
Neringa mun.;2006;12;25;14;11
Neringa mun.;2006;13;26;10;16
Neringa mun.;2006;14;32;16;16
Neringa mun.;2006;15;32;11;21
Neringa mun.;2006;16;33;16;17
Neringa mun.;2006;17;24;10;14
Neringa mun.;2006;18;28;15;13
Neringa mun.;2006;19;34;18;16
Neringa mun.;2006;20;31;14;17
Neringa mun.;2006;21;28;16;12
Neringa mun.;2006;22;35;19;16
Neringa mun.;2006;23;20;12;8
Neringa mun.;2006;24;16;4;12
Neringa mun.;2006;25;32;18;14
Neringa mun.;2006;26;27;17;10
Neringa mun.;2006;27;36;20;16
Neringa mun.;2006;28;37;15;22
Neringa mun.;2006;29;31;18;13
Neringa mun.;2006;30;33;18;15
Neringa mun.;2006;31;33;21;12
Neringa mun.;2006;32;38;19;19
Neringa mun.;2006;33;36;19;17
Neringa mun.;2006;34;37;17;20
Neringa mun.;2006;35;40;19;21
Neringa mun.;2006;36;38;17;21
Neringa mun.;2006;37;35;19;16
Neringa mun.;2006;38;31;14;17
Neringa mun.;2006;39;38;13;25
Neringa mun.;2006;40;49;28;21
Neringa mun.;2006;41;33;17;16
Neringa mun.;2006;42;34;17;17
Neringa mun.;2006;43;43;19;24
Neringa mun.;2006;44;56;26;30
Neringa mun.;2006;45;48;19;29
Neringa mun.;2006;46;42;18;24
Neringa mun.;2006;47;41;25;16
Neringa mun.;2006;48;45;24;21
Neringa mun.;2006;49;36;16;20
Neringa mun.;2006;50;39;21;18
Neringa mun.;2006;51;30;10;20
Neringa mun.;2006;52;32;14;18
Neringa mun.;2006;53;32;16;16
Neringa mun.;2006;54;38;17;21
Neringa mun.;2006;55;33;18;15
Neringa mun.;2006;56;28;16;12
Neringa mun.;2006;57;22;11;11
Neringa mun.;2006;58;24;8;16
Neringa mun.;2006;59;17;6;11
Neringa mun.;2006;60;14;8;6
Neringa mun.;2006;61;22;10;12
Neringa mun.;2006;62;19;6;13
Neringa mun.;2006;63;26;12;14
Neringa mun.;2006;64;23;11;12
Neringa mun.;2006;65;21;8;13
Neringa mun.;2006;66;20;12;8
Neringa mun.;2006;67;18;10;8
Neringa mun.;2006;68;19;7;12
Neringa mun.;2006;69;9;3;6
Neringa mun.;2006;70;24;9;15
Neringa mun.;2006;71;18;6;12
Neringa mun.;2006;72;14;6;8
Neringa mun.;2006;73;15;6;9
Neringa mun.;2006;74;20;7;13
Neringa mun.;2006;75;14;1;13
Neringa mun.;2006;76;3;0;3
Neringa mun.;2006;77;12;4;8
Neringa mun.;2006;78;17;3;14
Neringa mun.;2006;79;6;1;5
Neringa mun.;2006;80;8;1;7
Neringa mun.;2006;81;6;1;5
Neringa mun.;2006;82;6;2;4
Neringa mun.;2006;83;5;1;4
Neringa mun.;2006;84;4;1;3
Neringa mun.;2006;85;14;0;14
Neringa mun.;2007;-1;2204;1020;1184
Neringa mun.;2007;0;17;6;11
Neringa mun.;2007;1;22;8;14
Neringa mun.;2007;2;19;6;13
Neringa mun.;2007;3;13;5;8
Neringa mun.;2007;4;15;7;8
Neringa mun.;2007;5;12;6;6
Neringa mun.;2007;6;17;12;5
Neringa mun.;2007;7;19;9;10
Neringa mun.;2007;8;24;13;11
Neringa mun.;2007;9;14;5;9
Neringa mun.;2007;10;25;16;9
Neringa mun.;2007;11;31;11;20
Neringa mun.;2007;12;25;15;10
Neringa mun.;2007;13;23;13;10
Neringa mun.;2007;14;26;10;16
Neringa mun.;2007;15;33;16;17
Neringa mun.;2007;16;32;10;22
Neringa mun.;2007;17;33;15;18
Neringa mun.;2007;18;22;9;13
Neringa mun.;2007;19;27;15;12
Neringa mun.;2007;20;31;17;14
Neringa mun.;2007;21;33;15;18
Neringa mun.;2007;22;27;15;12
Neringa mun.;2007;23;34;18;16
Neringa mun.;2007;24;21;11;10
Neringa mun.;2007;25;18;7;11
Neringa mun.;2007;26;29;16;13
Neringa mun.;2007;27;26;16;10
Neringa mun.;2007;28;38;21;17
Neringa mun.;2007;29;39;17;22
Neringa mun.;2007;30;34;19;15
Neringa mun.;2007;31;35;18;17
Neringa mun.;2007;32;36;23;13
Neringa mun.;2007;33;40;19;21
Neringa mun.;2007;34;39;19;20
Neringa mun.;2007;35;38;18;20
Neringa mun.;2007;36;34;16;18
Neringa mun.;2007;37;36;16;20
Neringa mun.;2007;38;32;17;15
Neringa mun.;2007;39;30;14;16
Neringa mun.;2007;40;38;13;25
Neringa mun.;2007;41;47;27;20
Neringa mun.;2007;42;33;17;16
Neringa mun.;2007;43;35;18;17
Neringa mun.;2007;44;43;19;24
Neringa mun.;2007;45;53;24;29
Neringa mun.;2007;46;46;19;27
Neringa mun.;2007;47;42;18;24
Neringa mun.;2007;48;43;27;16
Neringa mun.;2007;49;48;25;23
Neringa mun.;2007;50;35;15;20
Neringa mun.;2007;51;37;20;17
Neringa mun.;2007;52;31;11;20
Neringa mun.;2007;53;29;11;18
Neringa mun.;2007;54;33;16;17
Neringa mun.;2007;55;37;17;20
Neringa mun.;2007;56;35;19;16
Neringa mun.;2007;57;26;14;12
Neringa mun.;2007;58;20;8;12
Neringa mun.;2007;59;24;8;16
Neringa mun.;2007;60;16;5;11
Neringa mun.;2007;61;14;9;5
Neringa mun.;2007;62;20;9;11
Neringa mun.;2007;63;18;6;12
Neringa mun.;2007;64;25;11;14
Neringa mun.;2007;65;22;10;12
Neringa mun.;2007;66;21;8;13
Neringa mun.;2007;67;18;12;6
Neringa mun.;2007;68;17;10;7
Neringa mun.;2007;69;17;6;11
Neringa mun.;2007;70;9;3;6
Neringa mun.;2007;71;23;8;15
Neringa mun.;2007;72;15;5;10
Neringa mun.;2007;73;16;7;9
Neringa mun.;2007;74;15;6;9
Neringa mun.;2007;75;19;7;12
Neringa mun.;2007;76;13;1;12
Neringa mun.;2007;77;3;0;3
Neringa mun.;2007;78;10;3;7
Neringa mun.;2007;79;16;3;13
Neringa mun.;2007;80;5;1;4
Neringa mun.;2007;81;10;3;7
Neringa mun.;2007;82;4;0;4
Neringa mun.;2007;83;4;1;3
Neringa mun.;2007;84;5;1;4
Neringa mun.;2007;85;15;0;15
Neringa mun.;2008;-1;2300;1075;1225
Neringa mun.;2008;0;26;13;13
Neringa mun.;2008;1;19;7;12
Neringa mun.;2008;2;22;9;13
Neringa mun.;2008;3;19;7;12
Neringa mun.;2008;4;13;6;7
Neringa mun.;2008;5;16;8;8
Neringa mun.;2008;6;12;6;6
Neringa mun.;2008;7;18;13;5
Neringa mun.;2008;8;19;8;11
Neringa mun.;2008;9;22;12;10
Neringa mun.;2008;10;16;6;10
Neringa mun.;2008;11;27;16;11
Neringa mun.;2008;12;33;12;21
Neringa mun.;2008;13;24;14;10
Neringa mun.;2008;14;27;15;12
Neringa mun.;2008;15;27;11;16
Neringa mun.;2008;16;32;16;16
Neringa mun.;2008;17;34;11;23
Neringa mun.;2008;18;35;17;18
Neringa mun.;2008;19;23;8;15
Neringa mun.;2008;20;27;15;12
Neringa mun.;2008;21;32;16;16
Neringa mun.;2008;22;31;13;18
Neringa mun.;2008;23;29;15;14
Neringa mun.;2008;24;36;19;17
Neringa mun.;2008;25;25;11;14
Neringa mun.;2008;26;19;7;12
Neringa mun.;2008;27;30;17;13
Neringa mun.;2008;28;26;17;9
Neringa mun.;2008;29;44;22;22
Neringa mun.;2008;30;43;19;24
Neringa mun.;2008;31;37;21;16
Neringa mun.;2008;32;34;18;16
Neringa mun.;2008;33;41;23;18
Neringa mun.;2008;34;43;23;20
Neringa mun.;2008;35;44;22;22
Neringa mun.;2008;36;40;22;18
Neringa mun.;2008;37;37;17;20
Neringa mun.;2008;38;39;18;21
Neringa mun.;2008;39;36;21;15
Neringa mun.;2008;40;38;17;21
Neringa mun.;2008;41;39;13;26
Neringa mun.;2008;42;49;28;21
Neringa mun.;2008;43;35;19;16
Neringa mun.;2008;44;35;19;16
Neringa mun.;2008;45;44;20;24
Neringa mun.;2008;46;54;26;28
Neringa mun.;2008;47;50;20;30
Neringa mun.;2008;48;45;20;25
Neringa mun.;2008;49;44;26;18
Neringa mun.;2008;50;47;24;23
Neringa mun.;2008;51;36;15;21
Neringa mun.;2008;52;37;19;18
Neringa mun.;2008;53;33;12;21
Neringa mun.;2008;54;30;11;19
Neringa mun.;2008;55;31;15;16
Neringa mun.;2008;56;35;16;19
Neringa mun.;2008;57;34;18;16
Neringa mun.;2008;58;27;15;12
Neringa mun.;2008;59;19;9;10
Neringa mun.;2008;60;25;9;16
Neringa mun.;2008;61;16;5;11
Neringa mun.;2008;62;17;12;5
Neringa mun.;2008;63;20;10;10
Neringa mun.;2008;64;18;7;11
Neringa mun.;2008;65;24;11;13
Neringa mun.;2008;66;22;10;12
Neringa mun.;2008;67;20;7;13
Neringa mun.;2008;68;19;12;7
Neringa mun.;2008;69;14;8;6
Neringa mun.;2008;70;16;6;10
Neringa mun.;2008;71;10;4;6
Neringa mun.;2008;72;21;7;14
Neringa mun.;2008;73;14;5;9
Neringa mun.;2008;74;13;5;8
Neringa mun.;2008;75;14;5;9
Neringa mun.;2008;76;18;6;12
Neringa mun.;2008;77;12;1;11
Neringa mun.;2008;78;3;0;3
Neringa mun.;2008;79;9;3;6
Neringa mun.;2008;80;15;3;12
Neringa mun.;2008;81;5;1;4
Neringa mun.;2008;82;10;3;7
Neringa mun.;2008;83;4;0;4
Neringa mun.;2008;84;4;1;3
Neringa mun.;2008;85;18;1;17
Neringa mun.;2009;-1;2477;1192;1285
Neringa mun.;2009;0;21;8;13
Neringa mun.;2009;1;26;13;13
Neringa mun.;2009;2;22;9;13
Neringa mun.;2009;3;23;11;12
Neringa mun.;2009;4;19;8;11
Neringa mun.;2009;5;13;6;7
Neringa mun.;2009;6;17;9;8
Neringa mun.;2009;7;13;7;6
Neringa mun.;2009;8;19;13;6
Neringa mun.;2009;9;23;9;14
Neringa mun.;2009;10;22;13;9
Neringa mun.;2009;11;18;9;9
Neringa mun.;2009;12;29;18;11
Neringa mun.;2009;13;34;13;21
Neringa mun.;2009;14;23;13;10
Neringa mun.;2009;15;29;16;13
Neringa mun.;2009;16;31;13;18
Neringa mun.;2009;17;35;17;18
Neringa mun.;2009;18;35;12;23
Neringa mun.;2009;19;38;18;20
Neringa mun.;2009;20;25;10;15
Neringa mun.;2009;21;27;15;12
Neringa mun.;2009;22;34;17;17
Neringa mun.;2009;23;35;15;20
Neringa mun.;2009;24;31;15;16
Neringa mun.;2009;25;43;21;22
Neringa mun.;2009;26;27;13;14
Neringa mun.;2009;27;20;8;12
Neringa mun.;2009;28;35;20;15
Neringa mun.;2009;29;31;20;11
Neringa mun.;2009;30;47;23;24
Neringa mun.;2009;31;47;20;27
Neringa mun.;2009;32;45;27;18
Neringa mun.;2009;33;34;18;16
Neringa mun.;2009;34;45;27;18
Neringa mun.;2009;35;46;25;21
Neringa mun.;2009;36;47;25;22
Neringa mun.;2009;37;46;29;17
Neringa mun.;2009;38;43;20;23
Neringa mun.;2009;39;38;18;20
Neringa mun.;2009;40;40;24;16
Neringa mun.;2009;41;41;19;22
Neringa mun.;2009;42;42;14;28
Neringa mun.;2009;43;51;31;20
Neringa mun.;2009;44;39;21;18
Neringa mun.;2009;45;41;24;17
Neringa mun.;2009;46;46;21;25
Neringa mun.;2009;47;56;26;30
Neringa mun.;2009;48;56;22;34
Neringa mun.;2009;49;49;22;27
Neringa mun.;2009;50;50;31;19
Neringa mun.;2009;51;49;24;25
Neringa mun.;2009;52;37;16;21
Neringa mun.;2009;53;41;22;19
Neringa mun.;2009;54;38;15;23
Neringa mun.;2009;55;33;12;21
Neringa mun.;2009;56;32;16;16
Neringa mun.;2009;57;35;17;18
Neringa mun.;2009;58;35;19;16
Neringa mun.;2009;59;29;17;12
Neringa mun.;2009;60;20;9;11
Neringa mun.;2009;61;27;10;17
Neringa mun.;2009;62;18;6;12
Neringa mun.;2009;63;18;13;5
Neringa mun.;2009;64;22;11;11
Neringa mun.;2009;65;18;7;11
Neringa mun.;2009;66;26;13;13
Neringa mun.;2009;67;21;10;11
Neringa mun.;2009;68;21;8;13
Neringa mun.;2009;69;20;13;7
Neringa mun.;2009;70;15;9;6
Neringa mun.;2009;71;16;6;10
Neringa mun.;2009;72;9;3;6
Neringa mun.;2009;73;20;7;13
Neringa mun.;2009;74;14;5;9
Neringa mun.;2009;75;14;5;9
Neringa mun.;2009;76;15;6;9
Neringa mun.;2009;77;17;5;12
Neringa mun.;2009;78;11;1;10
Neringa mun.;2009;79;3;0;3
Neringa mun.;2009;80;9;3;6
Neringa mun.;2009;81;13;3;10
Neringa mun.;2009;82;4;1;3
Neringa mun.;2009;83;7;3;4
Neringa mun.;2009;84;3;0;3
Neringa mun.;2009;85;20;1;19
Neringa mun.;2010;-1;2403;1133;1270
Neringa mun.;2010;0;21;10;11
Neringa mun.;2010;1;20;7;13
Neringa mun.;2010;2;25;13;12
Neringa mun.;2010;3;19;8;11
Neringa mun.;2010;4;25;11;14
Neringa mun.;2010;5;18;7;11
Neringa mun.;2010;6;13;5;8
Neringa mun.;2010;7;17;10;7
Neringa mun.;2010;8;12;7;5
Neringa mun.;2010;9;20;13;7
Neringa mun.;2010;10;22;9;13
Neringa mun.;2010;11;21;11;10
Neringa mun.;2010;12;16;8;8
Neringa mun.;2010;13;27;17;10
Neringa mun.;2010;14;34;13;21
Neringa mun.;2010;15;23;13;10
Neringa mun.;2010;16;29;16;13
Neringa mun.;2010;17;29;12;17
Neringa mun.;2010;18;34;16;18
Neringa mun.;2010;19;32;12;20
Neringa mun.;2010;20;38;18;20
Neringa mun.;2010;21;20;8;12
Neringa mun.;2010;22;27;15;12
Neringa mun.;2010;23;34;16;18
Neringa mun.;2010;24;34;14;20
Neringa mun.;2010;25;33;15;18
Neringa mun.;2010;26;41;21;20
Neringa mun.;2010;27;31;15;16
Neringa mun.;2010;28;20;8;12
Neringa mun.;2010;29;34;20;14
Neringa mun.;2010;30;32;20;12
Neringa mun.;2010;31;45;24;21
Neringa mun.;2010;32;45;18;27
Neringa mun.;2010;33;45;26;19
Neringa mun.;2010;34;29;14;15
Neringa mun.;2010;35;42;24;18
Neringa mun.;2010;36;46;24;22
Neringa mun.;2010;37;46;25;21
Neringa mun.;2010;38;48;30;18
Neringa mun.;2010;39;41;20;21
Neringa mun.;2010;40;36;15;21
Neringa mun.;2010;41;38;22;16
Neringa mun.;2010;42;40;18;22
Neringa mun.;2010;43;39;12;27
Neringa mun.;2010;44;50;30;20
Neringa mun.;2010;45;36;18;18
Neringa mun.;2010;46;38;22;16
Neringa mun.;2010;47;46;20;26
Neringa mun.;2010;48;54;23;31
Neringa mun.;2010;49;56;22;34
Neringa mun.;2010;50;48;21;27
Neringa mun.;2010;51;46;28;18
Neringa mun.;2010;52;45;19;26
Neringa mun.;2010;53;35;16;19
Neringa mun.;2010;54;38;20;18
Neringa mun.;2010;55;38;14;24
Neringa mun.;2010;56;32;13;19
Neringa mun.;2010;57;30;15;15
Neringa mun.;2010;58;36;18;18
Neringa mun.;2010;59;32;17;15
Neringa mun.;2010;60;26;15;11
Neringa mun.;2010;61;19;8;11
Neringa mun.;2010;62;26;9;17
Neringa mun.;2010;63;17;6;11
Neringa mun.;2010;64;17;11;6
Neringa mun.;2010;65;21;11;10
Neringa mun.;2010;66;17;7;10
Neringa mun.;2010;67;24;12;12
Neringa mun.;2010;68;19;9;10
Neringa mun.;2010;69;21;8;13
Neringa mun.;2010;70;18;10;8
Neringa mun.;2010;71;16;9;7
Neringa mun.;2010;72;15;5;10
Neringa mun.;2010;73;8;3;5
Neringa mun.;2010;74;18;5;13
Neringa mun.;2010;75;12;4;8
Neringa mun.;2010;76;10;3;7
Neringa mun.;2010;77;14;5;9
Neringa mun.;2010;78;16;5;11
Neringa mun.;2010;79;10;1;9
Neringa mun.;2010;80;2;0;2
Neringa mun.;2010;81;10;4;6
Neringa mun.;2010;82;12;3;9
Neringa mun.;2010;83;4;1;3
Neringa mun.;2010;84;6;2;4
Neringa mun.;2010;85;24;1;23
Neringa mun.;2011;-1;2564;1260;1304
Neringa mun.;2011;0;25;16;9
Neringa mun.;2011;1;24;15;9
Neringa mun.;2011;2;15;6;9
Neringa mun.;2011;3;27;17;10
Neringa mun.;2011;4;23;9;14
Neringa mun.;2011;5;21;12;9
Neringa mun.;2011;6;24;10;14
Neringa mun.;2011;7;14;9;5
Neringa mun.;2011;8;27;16;11
Neringa mun.;2011;9;24;16;8
Neringa mun.;2011;10;22;15;7
Neringa mun.;2011;11;26;13;13
Neringa mun.;2011;12;28;14;14
Neringa mun.;2011;13;23;12;11
Neringa mun.;2011;14;38;23;15
Neringa mun.;2011;15;46;21;25
Neringa mun.;2011;16;32;18;14
Neringa mun.;2011;17;29;20;9
Neringa mun.;2011;18;31;12;19
Neringa mun.;2011;19;34;21;13
Neringa mun.;2011;20;34;13;21
Neringa mun.;2011;21;28;13;15
Neringa mun.;2011;22;21;10;11
Neringa mun.;2011;23;39;22;17
Neringa mun.;2011;24;32;16;16
Neringa mun.;2011;25;34;16;18
Neringa mun.;2011;26;28;14;14
Neringa mun.;2011;27;36;18;18
Neringa mun.;2011;28;35;16;19
Neringa mun.;2011;29;34;17;17
Neringa mun.;2011;30;42;28;14
Neringa mun.;2011;31;32;18;14
Neringa mun.;2011;32;39;20;19
Neringa mun.;2011;33;51;25;26
Neringa mun.;2011;34;27;14;13
Neringa mun.;2011;35;28;14;14
Neringa mun.;2011;36;37;24;13
Neringa mun.;2011;37;38;18;20
Neringa mun.;2011;38;39;20;19
Neringa mun.;2011;39;39;25;14
Neringa mun.;2011;40;38;21;17
Neringa mun.;2011;41;47;22;25
Neringa mun.;2011;42;37;23;14
Neringa mun.;2011;43;39;18;21
Neringa mun.;2011;44;37;10;27
Neringa mun.;2011;45;58;37;21
Neringa mun.;2011;46;29;18;11
Neringa mun.;2011;47;46;24;22
Neringa mun.;2011;48;52;29;23
Neringa mun.;2011;49;58;28;30
Neringa mun.;2011;50;56;25;31
Neringa mun.;2011;51;48;22;26
Neringa mun.;2011;52;45;28;17
Neringa mun.;2011;53;43;14;29
Neringa mun.;2011;54;30;13;17
Neringa mun.;2011;55;42;22;20
Neringa mun.;2011;56;31;9;22
Neringa mun.;2011;57;33;12;21
Neringa mun.;2011;58;29;12;17
Neringa mun.;2011;59;43;22;21
Neringa mun.;2011;60;41;17;24
Neringa mun.;2011;61;34;18;16
Neringa mun.;2011;62;20;7;13
Neringa mun.;2011;63;28;8;20
Neringa mun.;2011;64;22;9;13
Neringa mun.;2011;65;17;11;6
Neringa mun.;2011;66;24;10;14
Neringa mun.;2011;67;17;6;11
Neringa mun.;2011;68;27;13;14
Neringa mun.;2011;69;22;9;13
Neringa mun.;2011;70;25;11;14
Neringa mun.;2011;71;20;11;9
Neringa mun.;2011;72;17;10;7
Neringa mun.;2011;73;20;6;14
Neringa mun.;2011;74;10;3;7
Neringa mun.;2011;75;23;8;15
Neringa mun.;2011;76;14;4;10
Neringa mun.;2011;77;13;5;8
Neringa mun.;2011;78;17;7;10
Neringa mun.;2011;79;18;6;12
Neringa mun.;2011;80;12;2;10
Neringa mun.;2011;81;3;1;2
Neringa mun.;2011;82;12;5;7
Neringa mun.;2011;83;12;2;10
Neringa mun.;2011;84;5;1;4
Neringa mun.;2011;85;24;5;19
Neringa mun.;2012;-1;2641;1302;1339
Neringa mun.;2012;0;49;26;23
Neringa mun.;2012;1;25;15;10
Neringa mun.;2012;2;22;15;7
Neringa mun.;2012;3;15;5;10
Neringa mun.;2012;4;27;15;12
Neringa mun.;2012;5;24;10;14
Neringa mun.;2012;6;27;16;11
Neringa mun.;2012;7;23;11;12
Neringa mun.;2012;8;17;11;6
Neringa mun.;2012;9;27;16;11
Neringa mun.;2012;10;22;14;8
Neringa mun.;2012;11;22;14;8
Neringa mun.;2012;12;25;12;13
Neringa mun.;2012;13;27;14;13
Neringa mun.;2012;14;24;12;12
Neringa mun.;2012;15;35;22;13
Neringa mun.;2012;16;43;21;22
Neringa mun.;2012;17;34;20;14
Neringa mun.;2012;18;30;20;10
Neringa mun.;2012;19;30;11;19
Neringa mun.;2012;20;39;23;16
Neringa mun.;2012;21;33;12;21
Neringa mun.;2012;22;30;15;15
Neringa mun.;2012;23;25;13;12
Neringa mun.;2012;24;41;22;19
Neringa mun.;2012;25;38;23;15
Neringa mun.;2012;26;38;21;17
Neringa mun.;2012;27;32;14;18
Neringa mun.;2012;28;32;17;15
Neringa mun.;2012;29;40;19;21
Neringa mun.;2012;30;36;16;20
Neringa mun.;2012;31;39;25;14
Neringa mun.;2012;32;31;16;15
Neringa mun.;2012;33;39;19;20
Neringa mun.;2012;34;54;26;28
Neringa mun.;2012;35;29;14;15
Neringa mun.;2012;36;33;18;15
Neringa mun.;2012;37;39;24;15
Neringa mun.;2012;38;31;15;16
Neringa mun.;2012;39;39;21;18
Neringa mun.;2012;40;41;28;13
Neringa mun.;2012;41;36;21;15
Neringa mun.;2012;42;48;26;22
Neringa mun.;2012;43;39;25;14
Neringa mun.;2012;44;39;13;26
Neringa mun.;2012;45;36;11;25
Neringa mun.;2012;46;58;36;22
Neringa mun.;2012;47;32;19;13
Neringa mun.;2012;48;46;25;21
Neringa mun.;2012;49;58;31;27
Neringa mun.;2012;50;62;32;30
Neringa mun.;2012;51;56;26;30
Neringa mun.;2012;52;49;21;28
Neringa mun.;2012;53;46;29;17
Neringa mun.;2012;54;43;14;29
Neringa mun.;2012;55;34;14;20
Neringa mun.;2012;56;41;21;20
Neringa mun.;2012;57;29;8;21
Neringa mun.;2012;58;33;13;20
Neringa mun.;2012;59;29;12;17
Neringa mun.;2012;60;45;23;22
Neringa mun.;2012;61;39;15;24
Neringa mun.;2012;62;34;17;17
Neringa mun.;2012;63;20;7;13
Neringa mun.;2012;64;29;8;21
Neringa mun.;2012;65;21;7;14
Neringa mun.;2012;66;17;11;6
Neringa mun.;2012;67;22;10;12
Neringa mun.;2012;68;16;5;11
Neringa mun.;2012;69;28;13;15
Neringa mun.;2012;70;19;7;12
Neringa mun.;2012;71;26;12;14
Neringa mun.;2012;72;20;11;9
Neringa mun.;2012;73;20;12;8
Neringa mun.;2012;74;19;6;13
Neringa mun.;2012;75;9;2;7
Neringa mun.;2012;76;23;8;15
Neringa mun.;2012;77;14;4;10
Neringa mun.;2012;78;11;5;6
Neringa mun.;2012;79;16;6;10
Neringa mun.;2012;80;14;3;11
Neringa mun.;2012;81;11;2;9
Neringa mun.;2012;82;3;1;2
Neringa mun.;2012;83;10;4;6
Neringa mun.;2012;84;10;2;8
Neringa mun.;2012;85;24;3;21
Neringa mun.;2013;-1;2719;1351;1368
Neringa mun.;2013;0;40;20;20
Neringa mun.;2013;1;49;25;24
Neringa mun.;2013;2;23;13;10
Neringa mun.;2013;3;22;17;5
Neringa mun.;2013;4;16;6;10
Neringa mun.;2013;5;25;14;11
Neringa mun.;2013;6;22;9;13
Neringa mun.;2013;7;20;11;9
Neringa mun.;2013;8;24;13;11
Neringa mun.;2013;9;20;13;7
Neringa mun.;2013;10;28;16;12
Neringa mun.;2013;11;22;15;7
Neringa mun.;2013;12;21;13;8
Neringa mun.;2013;13;27;14;13
Neringa mun.;2013;14;25;13;12
Neringa mun.;2013;15;22;10;12
Neringa mun.;2013;16;35;23;12
Neringa mun.;2013;17;45;22;23
Neringa mun.;2013;18;35;21;14
Neringa mun.;2013;19;30;19;11
Neringa mun.;2013;20;31;12;19
Neringa mun.;2013;21;41;25;16
Neringa mun.;2013;22;33;11;22
Neringa mun.;2013;23;31;16;15
Neringa mun.;2013;24;30;17;13
Neringa mun.;2013;25;41;24;17
Neringa mun.;2013;26;41;23;18
Neringa mun.;2013;27;40;21;19
Neringa mun.;2013;28;34;17;17
Neringa mun.;2013;29;36;22;14
Neringa mun.;2013;30;43;22;21
Neringa mun.;2013;31;36;15;21
Neringa mun.;2013;32;40;25;15
Neringa mun.;2013;33;36;18;18
Neringa mun.;2013;34;43;23;20
Neringa mun.;2013;35;53;25;28
Neringa mun.;2013;36;33;15;18
Neringa mun.;2013;37;32;17;15
Neringa mun.;2013;38;41;25;16
Neringa mun.;2013;39;38;19;19
Neringa mun.;2013;40;33;16;17
Neringa mun.;2013;41;36;25;11
Neringa mun.;2013;42;39;22;17
Neringa mun.;2013;43;50;28;22
Neringa mun.;2013;44;41;26;15
Neringa mun.;2013;45;45;16;29
Neringa mun.;2013;46;35;11;24
Neringa mun.;2013;47;59;34;25
Neringa mun.;2013;48;35;20;15
Neringa mun.;2013;49;49;27;22
Neringa mun.;2013;50;64;35;29
Neringa mun.;2013;51;65;34;31
Neringa mun.;2013;52;57;27;30
Neringa mun.;2013;53;49;21;28
Neringa mun.;2013;54;45;29;16
Neringa mun.;2013;55;45;15;30
Neringa mun.;2013;56;36;15;21
Neringa mun.;2013;57;43;23;20
Neringa mun.;2013;58;30;9;21
Neringa mun.;2013;59;35;14;21
Neringa mun.;2013;60;28;12;16
Neringa mun.;2013;61;45;23;22
Neringa mun.;2013;62;38;13;25
Neringa mun.;2013;63;35;18;17
Neringa mun.;2013;64;21;7;14
Neringa mun.;2013;65;29;7;22
Neringa mun.;2013;66;21;7;14
Neringa mun.;2013;67;16;10;6
Neringa mun.;2013;68;22;10;12
Neringa mun.;2013;69;13;4;9
Neringa mun.;2013;70;26;13;13
Neringa mun.;2013;71;21;9;12
Neringa mun.;2013;72;26;11;15
Neringa mun.;2013;73;18;10;8
Neringa mun.;2013;74;16;10;6
Neringa mun.;2013;75;18;6;12
Neringa mun.;2013;76;7;1;6
Neringa mun.;2013;77;21;8;13
Neringa mun.;2013;78;14;4;10
Neringa mun.;2013;79;10;4;6
Neringa mun.;2013;80;15;5;10
Neringa mun.;2013;81;14;3;11
Neringa mun.;2013;82;11;2;9
Neringa mun.;2013;83;4;1;3
Neringa mun.;2013;84;8;3;5
Neringa mun.;2013;85;27;4;23
Neringa mun.;2014;-1;2752;1367;1385
Neringa mun.;2014;0;42;22;20
Neringa mun.;2014;1;38;19;19
Neringa mun.;2014;2;44;22;22
Neringa mun.;2014;3;23;11;12
Neringa mun.;2014;4;24;19;5
Neringa mun.;2014;5;16;6;10
Neringa mun.;2014;6;22;11;11
Neringa mun.;2014;7;20;9;11
Neringa mun.;2014;8;19;9;10
Neringa mun.;2014;9;21;10;11
Neringa mun.;2014;10;19;13;6
Neringa mun.;2014;11;30;16;14
Neringa mun.;2014;12;23;16;7
Neringa mun.;2014;13;20;12;8
Neringa mun.;2014;14;28;14;14
Neringa mun.;2014;15;23;13;10
Neringa mun.;2014;16;24;11;13
Neringa mun.;2014;17;34;22;12
Neringa mun.;2014;18;47;21;26
Neringa mun.;2014;19;35;21;14
Neringa mun.;2014;20;30;18;12
Neringa mun.;2014;21;33;12;21
Neringa mun.;2014;22;43;26;17
Neringa mun.;2014;23;36;13;23
Neringa mun.;2014;24;34;17;17
Neringa mun.;2014;25;32;17;15
Neringa mun.;2014;26;44;25;19
Neringa mun.;2014;27;42;23;19
Neringa mun.;2014;28;40;20;20
Neringa mun.;2014;29;32;17;15
Neringa mun.;2014;30;37;24;13
Neringa mun.;2014;31;41;24;17
Neringa mun.;2014;32;37;20;17
Neringa mun.;2014;33;39;24;15
Neringa mun.;2014;34;32;16;16
Neringa mun.;2014;35;42;23;19
Neringa mun.;2014;36;53;24;29
Neringa mun.;2014;37;39;18;21
Neringa mun.;2014;38;33;17;16
Neringa mun.;2014;39;40;25;15
Neringa mun.;2014;40;36;19;17
Neringa mun.;2014;41;36;19;17
Neringa mun.;2014;42;35;24;11
Neringa mun.;2014;43;44;25;19
Neringa mun.;2014;44;49;27;22
Neringa mun.;2014;45;42;25;17
Neringa mun.;2014;46;45;17;28
Neringa mun.;2014;47;35;12;23
Neringa mun.;2014;48;57;31;26
Neringa mun.;2014;49;38;23;15
Neringa mun.;2014;50;46;24;22
Neringa mun.;2014;51;62;33;29
Neringa mun.;2014;52;63;32;31
Neringa mun.;2014;53;57;28;29
Neringa mun.;2014;54;48;22;26
Neringa mun.;2014;55;46;30;16
Neringa mun.;2014;56;43;15;28
Neringa mun.;2014;57;37;14;23
Neringa mun.;2014;58;42;22;20
Neringa mun.;2014;59;30;9;21
Neringa mun.;2014;60;34;13;21
Neringa mun.;2014;61;31;14;17
Neringa mun.;2014;62;45;24;21
Neringa mun.;2014;63;41;16;25
Neringa mun.;2014;64;36;18;18
Neringa mun.;2014;65;20;6;14
Neringa mun.;2014;66;31;8;23
Neringa mun.;2014;67;23;9;14
Neringa mun.;2014;68;15;9;6
Neringa mun.;2014;69;22;10;12
Neringa mun.;2014;70;13;4;9
Neringa mun.;2014;71;27;14;13
Neringa mun.;2014;72;20;8;12
Neringa mun.;2014;73;24;10;14
Neringa mun.;2014;74;18;10;8
Neringa mun.;2014;75;14;9;5
Neringa mun.;2014;76;17;5;12
Neringa mun.;2014;77;6;0;6
Neringa mun.;2014;78;20;8;12
Neringa mun.;2014;79;12;2;10
Neringa mun.;2014;80;10;4;6
Neringa mun.;2014;81;15;5;10
Neringa mun.;2014;82;13;3;10
Neringa mun.;2014;83;9;1;8
Neringa mun.;2014;84;3;0;3
Neringa mun.;2014;85;31;6;25
Neringa mun.;2015;-1;2879;1427;1452
Neringa mun.;2015;0;48;32;16
Neringa mun.;2015;1;41;19;22
Neringa mun.;2015;2;33;15;18
Neringa mun.;2015;3;43;23;20
Neringa mun.;2015;4;20;7;13
Neringa mun.;2015;5;24;19;5
Neringa mun.;2015;6;16;7;9
Neringa mun.;2015;7;23;11;12
Neringa mun.;2015;8;21;8;13
Neringa mun.;2015;9;19;8;11
Neringa mun.;2015;10;22;11;11
Neringa mun.;2015;11;17;13;4
Neringa mun.;2015;12;32;18;14
Neringa mun.;2015;13;25;16;9
Neringa mun.;2015;14;19;12;7
Neringa mun.;2015;15;26;11;15
Neringa mun.;2015;16;25;13;12
Neringa mun.;2015;17;25;12;13
Neringa mun.;2015;18;37;22;15
Neringa mun.;2015;19;51;25;26
Neringa mun.;2015;20;39;23;16
Neringa mun.;2015;21;30;19;11
Neringa mun.;2015;22;36;13;23
Neringa mun.;2015;23;43;26;17
Neringa mun.;2015;24;43;16;27
Neringa mun.;2015;25;38;17;21
Neringa mun.;2015;26;34;17;17
Neringa mun.;2015;27;45;28;17
Neringa mun.;2015;28;40;24;16
Neringa mun.;2015;29;43;21;22
Neringa mun.;2015;30;35;18;17
Neringa mun.;2015;31;47;29;18
Neringa mun.;2015;32;42;25;17
Neringa mun.;2015;33;43;23;20
Neringa mun.;2015;34;44;24;20
Neringa mun.;2015;35;36;20;16
Neringa mun.;2015;36;49;28;21
Neringa mun.;2015;37;54;24;30
Neringa mun.;2015;38;41;21;20
Neringa mun.;2015;39;38;21;17
Neringa mun.;2015;40;41;26;15
Neringa mun.;2015;41;39;21;18
Neringa mun.;2015;42;39;19;20
Neringa mun.;2015;43;36;23;13
Neringa mun.;2015;44;45;24;21
Neringa mun.;2015;45;48;28;20
Neringa mun.;2015;46;41;23;18
Neringa mun.;2015;47;48;20;28
Neringa mun.;2015;48;40;12;28
Neringa mun.;2015;49;65;37;28
Neringa mun.;2015;50;40;25;15
Neringa mun.;2015;51;47;22;25
Neringa mun.;2015;52;64;32;32
Neringa mun.;2015;53;64;31;33
Neringa mun.;2015;54;59;29;30
Neringa mun.;2015;55;46;20;26
Neringa mun.;2015;56;46;30;16
Neringa mun.;2015;57;45;16;29
Neringa mun.;2015;58;41;16;25
Neringa mun.;2015;59;44;22;22
Neringa mun.;2015;60;34;11;23
Neringa mun.;2015;61;34;14;20
Neringa mun.;2015;62;33;14;19
Neringa mun.;2015;63;43;23;20
Neringa mun.;2015;64;42;16;26
Neringa mun.;2015;65;32;15;17
Neringa mun.;2015;66;21;7;14
Neringa mun.;2015;67;32;9;23
Neringa mun.;2015;68;21;7;14
Neringa mun.;2015;69;16;9;7
Neringa mun.;2015;70;21;10;11
Neringa mun.;2015;71;11;3;8
Neringa mun.;2015;72;24;11;13
Neringa mun.;2015;73;20;8;12
Neringa mun.;2015;74;24;10;14
Neringa mun.;2015;75;17;9;8
Neringa mun.;2015;76;14;9;5
Neringa mun.;2015;77;16;4;12
Neringa mun.;2015;78;6;0;6
Neringa mun.;2015;79;18;7;11
Neringa mun.;2015;80;11;2;9
Neringa mun.;2015;81;10;4;6
Neringa mun.;2015;82;14;4;10
Neringa mun.;2015;83;11;2;9
Neringa mun.;2015;84;7;0;7
Neringa mun.;2015;85;22;4;18
Neringa mun.;2016;-1;3020;1493;1527
Neringa mun.;2016;0;57;28;29
Neringa mun.;2016;1;47;29;18
Neringa mun.;2016;2;39;19;20
Neringa mun.;2016;3;30;14;16
Neringa mun.;2016;4;42;19;23
Neringa mun.;2016;5;22;8;14
Neringa mun.;2016;6;18;18;0
Neringa mun.;2016;7;14;6;8
Neringa mun.;2016;8;24;12;12
Neringa mun.;2016;9;22;10;12
Neringa mun.;2016;10;19;8;11
Neringa mun.;2016;11;24;11;13
Neringa mun.;2016;12;19;13;6
Neringa mun.;2016;13;38;22;16
Neringa mun.;2016;14;26;17;9
Neringa mun.;2016;15;17;11;6
Neringa mun.;2016;16;27;12;15
Neringa mun.;2016;17;28;15;13
Neringa mun.;2016;18;28;14;14
Neringa mun.;2016;19;41;23;18
Neringa mun.;2016;20;55;27;28
Neringa mun.;2016;21;39;23;16
Neringa mun.;2016;22;29;19;10
Neringa mun.;2016;23;35;13;22
Neringa mun.;2016;24;41;23;18
Neringa mun.;2016;25;43;15;28
Neringa mun.;2016;26;41;19;22
Neringa mun.;2016;27;36;17;19
Neringa mun.;2016;28;52;31;21
Neringa mun.;2016;29;40;25;15
Neringa mun.;2016;30;47;23;24
Neringa mun.;2016;31;41;18;23
Neringa mun.;2016;32;53;33;20
Neringa mun.;2016;33;50;27;23
Neringa mun.;2016;34;44;24;20
Neringa mun.;2016;35;42;22;20
Neringa mun.;2016;36;39;23;16
Neringa mun.;2016;37;49;26;23
Neringa mun.;2016;38;60;28;32
Neringa mun.;2016;39;43;20;23
Neringa mun.;2016;40;47;28;19
Neringa mun.;2016;41;43;25;18
Neringa mun.;2016;42;37;19;18
Neringa mun.;2016;43;41;21;20
Neringa mun.;2016;44;35;26;9
Neringa mun.;2016;45;43;24;19
Neringa mun.;2016;46;52;30;22
Neringa mun.;2016;47;43;25;18
Neringa mun.;2016;48;52;24;28
Neringa mun.;2016;49;42;12;30
Neringa mun.;2016;50;63;34;29
Neringa mun.;2016;51;44;27;17
Neringa mun.;2016;52;52;25;27
Neringa mun.;2016;53;63;31;32
Neringa mun.;2016;54;67;32;35
Neringa mun.;2016;55;60;29;31
Neringa mun.;2016;56;47;20;27
Neringa mun.;2016;57;50;33;17
Neringa mun.;2016;58;46;18;28
Neringa mun.;2016;59;39;14;25
Neringa mun.;2016;60;46;22;24
Neringa mun.;2016;61;34;12;22
Neringa mun.;2016;62;34;13;21
Neringa mun.;2016;63;35;14;21
Neringa mun.;2016;64;44;24;20
Neringa mun.;2016;65;40;15;25
Neringa mun.;2016;66;33;16;17
Neringa mun.;2016;67;21;7;14
Neringa mun.;2016;68;31;9;22
Neringa mun.;2016;69;22;7;15
Neringa mun.;2016;70;16;9;7
Neringa mun.;2016;71;21;10;11
Neringa mun.;2016;72;12;3;9
Neringa mun.;2016;73;22;11;11
Neringa mun.;2016;74;19;8;11
Neringa mun.;2016;75;23;9;14
Neringa mun.;2016;76;16;9;7
Neringa mun.;2016;77;12;7;5
Neringa mun.;2016;78;16;3;13
Neringa mun.;2016;79;7;0;7
Neringa mun.;2016;80;18;7;11
Neringa mun.;2016;81;10;2;8
Neringa mun.;2016;82;10;4;6
Neringa mun.;2016;83;13;4;9
Neringa mun.;2016;84;11;2;9
Neringa mun.;2016;85;27;4;23
Neringa mun.;2017;-1;3097;1545;1552
Neringa mun.;2017;0;46;23;23
Neringa mun.;2017;1;54;27;27
Neringa mun.;2017;2;42;24;18
Neringa mun.;2017;3;37;16;21
Neringa mun.;2017;4;29;13;16
Neringa mun.;2017;5;40;17;23
Neringa mun.;2017;6;18;6;12
Neringa mun.;2017;7;20;20;0
Neringa mun.;2017;8;16;9;7
Neringa mun.;2017;9;28;16;12
Neringa mun.;2017;10;20;9;11
Neringa mun.;2017;11;18;8;10
Neringa mun.;2017;12;26;12;14
Neringa mun.;2017;13;21;13;8
Neringa mun.;2017;14;39;22;17
Neringa mun.;2017;15;23;16;7
Neringa mun.;2017;16;17;12;5
Neringa mun.;2017;17;26;11;15
Neringa mun.;2017;18;31;17;14
Neringa mun.;2017;19;26;13;13
Neringa mun.;2017;20;43;24;19
Neringa mun.;2017;21;51;26;25
Neringa mun.;2017;22;43;25;18
Neringa mun.;2017;23;26;19;7
Neringa mun.;2017;24;36;15;21
Neringa mun.;2017;25;40;23;17
Neringa mun.;2017;26;42;16;26
Neringa mun.;2017;27;44;20;24
Neringa mun.;2017;28;42;22;20
Neringa mun.;2017;29;58;33;25
Neringa mun.;2017;30;38;24;14
Neringa mun.;2017;31;48;24;24
Neringa mun.;2017;32;31;14;17
Neringa mun.;2017;33;52;33;19
Neringa mun.;2017;34;53;32;21
Neringa mun.;2017;35;47;27;20
Neringa mun.;2017;36;42;24;18
Neringa mun.;2017;37;40;23;17
Neringa mun.;2017;38;55;28;27
Neringa mun.;2017;39;55;27;28
Neringa mun.;2017;40;47;20;27
Neringa mun.;2017;41;47;27;20
Neringa mun.;2017;42;48;29;19
Neringa mun.;2017;43;47;25;22
Neringa mun.;2017;44;42;23;19
Neringa mun.;2017;45;38;24;14
Neringa mun.;2017;46;44;25;19
Neringa mun.;2017;47;56;32;24
Neringa mun.;2017;48;47;26;21
Neringa mun.;2017;49;55;27;28
Neringa mun.;2017;50;48;18;30
Neringa mun.;2017;51;64;34;30
Neringa mun.;2017;52;46;28;18
Neringa mun.;2017;53;51;25;26
Neringa mun.;2017;54;61;29;32
Neringa mun.;2017;55;68;33;35
Neringa mun.;2017;56;60;27;33
Neringa mun.;2017;57;50;22;28
Neringa mun.;2017;58;50;32;18
Neringa mun.;2017;59;45;18;27
Neringa mun.;2017;60;45;18;27
Neringa mun.;2017;61;45;22;23
Neringa mun.;2017;62;32;11;21
Neringa mun.;2017;63;34;13;21
Neringa mun.;2017;64;34;14;20
Neringa mun.;2017;65;44;24;20
Neringa mun.;2017;66;39;15;24
Neringa mun.;2017;67;33;16;17
Neringa mun.;2017;68;21;7;14
Neringa mun.;2017;69;32;9;23
Neringa mun.;2017;70;21;6;15
Neringa mun.;2017;71;16;8;8
Neringa mun.;2017;72;21;10;11
Neringa mun.;2017;73;12;3;9
Neringa mun.;2017;74;23;12;11
Neringa mun.;2017;75;17;6;11
Neringa mun.;2017;76;21;8;13
Neringa mun.;2017;77;14;7;7
Neringa mun.;2017;78;12;7;5
Neringa mun.;2017;79;17;3;14
Neringa mun.;2017;80;7;0;7
Neringa mun.;2017;81;17;7;10
Neringa mun.;2017;82;9;1;8
Neringa mun.;2017;83;9;4;5
Neringa mun.;2017;84;15;5;10
Neringa mun.;2017;85;30;2;28
Neringa mun.;2018;-1;3224;1621;1603
Neringa mun.;2018;0;38;12;26
Neringa mun.;2018;1;45;23;22
Neringa mun.;2018;2;47;24;23
Neringa mun.;2018;3;39;21;18
Neringa mun.;2018;4;36;15;21
Neringa mun.;2018;5;30;14;16
Neringa mun.;2018;6;41;16;25
Neringa mun.;2018;7;19;8;11
Neringa mun.;2018;8;23;21;2
Neringa mun.;2018;9;16;8;8
Neringa mun.;2018;10;30;16;14
Neringa mun.;2018;11;25;11;14
Neringa mun.;2018;12;20;10;10
Neringa mun.;2018;13;31;13;18
Neringa mun.;2018;14;21;13;8
Neringa mun.;2018;15;40;22;18
Neringa mun.;2018;16;26;18;8
Neringa mun.;2018;17;18;12;6
Neringa mun.;2018;18;29;14;15
Neringa mun.;2018;19;36;22;14
Neringa mun.;2018;20;27;14;13
Neringa mun.;2018;21;40;23;17
Neringa mun.;2018;22;51;25;26
Neringa mun.;2018;23;37;22;15
Neringa mun.;2018;24;20;15;5
Neringa mun.;2018;25;36;13;23
Neringa mun.;2018;26;42;25;17
Neringa mun.;2018;27;42;17;25
Neringa mun.;2018;28;47;23;24
Neringa mun.;2018;29;41;22;19
Neringa mun.;2018;30;60;32;28
Neringa mun.;2018;31;39;24;15
Neringa mun.;2018;32;54;29;25
Neringa mun.;2018;33;45;20;25
Neringa mun.;2018;34;49;32;17
Neringa mun.;2018;35;56;35;21
Neringa mun.;2018;36;47;29;18
Neringa mun.;2018;37;49;29;20
Neringa mun.;2018;38;43;23;20
Neringa mun.;2018;39;59;32;27
Neringa mun.;2018;40;63;32;31
Neringa mun.;2018;41;50;27;23
Neringa mun.;2018;42;49;29;20
Neringa mun.;2018;43;51;31;20
Neringa mun.;2018;44;53;29;24
Neringa mun.;2018;45;46;25;21
Neringa mun.;2018;46;41;27;14
Neringa mun.;2018;47;45;25;20
Neringa mun.;2018;48;60;35;25
Neringa mun.;2018;49;50;29;21
Neringa mun.;2018;50;60;32;28
Neringa mun.;2018;51;50;18;32
Neringa mun.;2018;52;66;35;31
Neringa mun.;2018;53;50;30;20
Neringa mun.;2018;54;54;27;27
Neringa mun.;2018;55;63;31;32
Neringa mun.;2018;56;68;30;38
Neringa mun.;2018;57;63;29;34
Neringa mun.;2018;58;52;24;28
Neringa mun.;2018;59;48;30;18
Neringa mun.;2018;60;46;18;28
Neringa mun.;2018;61;45;18;27
Neringa mun.;2018;62;48;21;27
Neringa mun.;2018;63;32;11;21
Neringa mun.;2018;64;36;14;22
Neringa mun.;2018;65;35;14;21
Neringa mun.;2018;66;46;25;21
Neringa mun.;2018;67;38;16;22
Neringa mun.;2018;68;31;15;16
Neringa mun.;2018;69;18;6;12
Neringa mun.;2018;70;31;10;21
Neringa mun.;2018;71;23;7;16
Neringa mun.;2018;72;13;6;7
Neringa mun.;2018;73;21;10;11
Neringa mun.;2018;74;12;4;8
Neringa mun.;2018;75;23;12;11
Neringa mun.;2018;76;16;5;11
Neringa mun.;2018;77;20;7;13
Neringa mun.;2018;78;14;7;7
Neringa mun.;2018;79;11;7;4
Neringa mun.;2018;80;15;2;13
Neringa mun.;2018;81;6;0;6
Neringa mun.;2018;82;17;7;10
Neringa mun.;2018;83;7;0;7
Neringa mun.;2018;84;7;2;5
Neringa mun.;2018;85;37;5;32
Pagėgiai mun.;2001;-1;12212;5856;6356
Pagėgiai mun.;2001;0;167;67;100
Pagėgiai mun.;2001;1;146;78;68
Pagėgiai mun.;2001;2;178;93;85
Pagėgiai mun.;2001;3;155;80;75
Pagėgiai mun.;2001;4;136;62;74
Pagėgiai mun.;2001;5;157;80;77
Pagėgiai mun.;2001;6;176;100;76
Pagėgiai mun.;2001;7;191;100;91
Pagėgiai mun.;2001;8;217;102;115
Pagėgiai mun.;2001;9;237;112;125
Pagėgiai mun.;2001;10;223;107;116
Pagėgiai mun.;2001;11;197;117;80
Pagėgiai mun.;2001;12;205;101;104
Pagėgiai mun.;2001;13;228;126;102
Pagėgiai mun.;2001;14;242;133;109
Pagėgiai mun.;2001;15;256;130;126
Pagėgiai mun.;2001;16;223;107;116
Pagėgiai mun.;2001;17;203;107;96
Pagėgiai mun.;2001;18;162;77;85
Pagėgiai mun.;2001;19;160;94;66
Pagėgiai mun.;2001;20;155;80;75
Pagėgiai mun.;2001;21;152;94;58
Pagėgiai mun.;2001;22;168;89;79
Pagėgiai mun.;2001;23;159;84;75
Pagėgiai mun.;2001;24;146;65;81
Pagėgiai mun.;2001;25;134;67;67
Pagėgiai mun.;2001;26;136;88;48
Pagėgiai mun.;2001;27;154;83;71
Pagėgiai mun.;2001;28;163;76;87
Pagėgiai mun.;2001;29;187;94;93
Pagėgiai mun.;2001;30;157;83;74
Pagėgiai mun.;2001;31;162;91;71
Pagėgiai mun.;2001;32;144;81;63
Pagėgiai mun.;2001;33;171;87;84
Pagėgiai mun.;2001;34;142;70;72
Pagėgiai mun.;2001;35;157;82;75
Pagėgiai mun.;2001;36;149;76;73
Pagėgiai mun.;2001;37;166;82;84
Pagėgiai mun.;2001;38;174;88;86
Pagėgiai mun.;2001;39;202;116;86
Pagėgiai mun.;2001;40;202;111;91
Pagėgiai mun.;2001;41;163;81;82
Pagėgiai mun.;2001;42;186;97;89
Pagėgiai mun.;2001;43;150;73;77
Pagėgiai mun.;2001;44;174;88;86
Pagėgiai mun.;2001;45;132;74;58
Pagėgiai mun.;2001;46;144;70;74
Pagėgiai mun.;2001;47;130;71;59
Pagėgiai mun.;2001;48;113;63;50
Pagėgiai mun.;2001;49;125;64;61
Pagėgiai mun.;2001;50;121;68;53
Pagėgiai mun.;2001;51;131;62;69
Pagėgiai mun.;2001;52;137;58;79
Pagėgiai mun.;2001;53;88;45;43
Pagėgiai mun.;2001;54;114;54;60
Pagėgiai mun.;2001;55;100;44;56
Pagėgiai mun.;2001;56;106;43;63
Pagėgiai mun.;2001;57;117;51;66
Pagėgiai mun.;2001;58;134;57;77
Pagėgiai mun.;2001;59;165;69;96
Pagėgiai mun.;2001;60;128;54;74
Pagėgiai mun.;2001;61;123;44;79
Pagėgiai mun.;2001;62;120;45;75
Pagėgiai mun.;2001;63;130;52;78
Pagėgiai mun.;2001;64;142;64;78
Pagėgiai mun.;2001;65;159;52;107
Pagėgiai mun.;2001;66;125;52;73
Pagėgiai mun.;2001;67;129;43;86
Pagėgiai mun.;2001;68;149;47;102
Pagėgiai mun.;2001;69;132;59;73
Pagėgiai mun.;2001;70;112;38;74
Pagėgiai mun.;2001;71;113;42;71
Pagėgiai mun.;2001;72;110;43;67
Pagėgiai mun.;2001;73;106;30;76
Pagėgiai mun.;2001;74;96;36;60
Pagėgiai mun.;2001;75;87;32;55
Pagėgiai mun.;2001;76;52;15;37
Pagėgiai mun.;2001;77;75;23;52
Pagėgiai mun.;2001;78;53;12;41
Pagėgiai mun.;2001;79;54;18;36
Pagėgiai mun.;2001;80;49;17;32
Pagėgiai mun.;2001;81;35;10;25
Pagėgiai mun.;2001;82;34;7;27
Pagėgiai mun.;2001;83;18;4;14
Pagėgiai mun.;2001;84;13;3;10
Pagėgiai mun.;2001;85;99;22;77
Pagėgiai mun.;2002;-1;12093;5768;6325
Pagėgiai mun.;2002;0;128;54;74
Pagėgiai mun.;2002;1;166;65;101
Pagėgiai mun.;2002;2;142;77;65
Pagėgiai mun.;2002;3;181;95;86
Pagėgiai mun.;2002;4;154;79;75
Pagėgiai mun.;2002;5;137;63;74
Pagėgiai mun.;2002;6;158;81;77
Pagėgiai mun.;2002;7;176;100;76
Pagėgiai mun.;2002;8;191;98;93
Pagėgiai mun.;2002;9;220;103;117
Pagėgiai mun.;2002;10;236;113;123
Pagėgiai mun.;2002;11;221;105;116
Pagėgiai mun.;2002;12;194;115;79
Pagėgiai mun.;2002;13;202;100;102
Pagėgiai mun.;2002;14;223;122;101
Pagėgiai mun.;2002;15;240;132;108
Pagėgiai mun.;2002;16;251;128;123
Pagėgiai mun.;2002;17;218;104;114
Pagėgiai mun.;2002;18;203;105;98
Pagėgiai mun.;2002;19;156;74;82
Pagėgiai mun.;2002;20;158;93;65
Pagėgiai mun.;2002;21;155;82;73
Pagėgiai mun.;2002;22;148;91;57
Pagėgiai mun.;2002;23;166;87;79
Pagėgiai mun.;2002;24;158;83;75
Pagėgiai mun.;2002;25;148;66;82
Pagėgiai mun.;2002;26;130;63;67
Pagėgiai mun.;2002;27;136;87;49
Pagėgiai mun.;2002;28;150;79;71
Pagėgiai mun.;2002;29;159;74;85
Pagėgiai mun.;2002;30;182;91;91
Pagėgiai mun.;2002;31;158;83;75
Pagėgiai mun.;2002;32;161;89;72
Pagėgiai mun.;2002;33;142;80;62
Pagėgiai mun.;2002;34;172;88;84
Pagėgiai mun.;2002;35;137;66;71
Pagėgiai mun.;2002;36;156;82;74
Pagėgiai mun.;2002;37;144;73;71
Pagėgiai mun.;2002;38;166;80;86
Pagėgiai mun.;2002;39;168;84;84
Pagėgiai mun.;2002;40;200;115;85
Pagėgiai mun.;2002;41;199;109;90
Pagėgiai mun.;2002;42;160;79;81
Pagėgiai mun.;2002;43;185;97;88
Pagėgiai mun.;2002;44;148;72;76
Pagėgiai mun.;2002;45;169;86;83
Pagėgiai mun.;2002;46;129;71;58
Pagėgiai mun.;2002;47;142;71;71
Pagėgiai mun.;2002;48;125;68;57
Pagėgiai mun.;2002;49;110;61;49
Pagėgiai mun.;2002;50;120;62;58
Pagėgiai mun.;2002;51;122;69;53
Pagėgiai mun.;2002;52;130;62;68
Pagėgiai mun.;2002;53;132;58;74
Pagėgiai mun.;2002;54;84;43;41
Pagėgiai mun.;2002;55;109;50;59
Pagėgiai mun.;2002;56;96;42;54
Pagėgiai mun.;2002;57;101;39;62
Pagėgiai mun.;2002;58;115;50;65
Pagėgiai mun.;2002;59;128;53;75
Pagėgiai mun.;2002;60;163;69;94
Pagėgiai mun.;2002;61;127;53;74
Pagėgiai mun.;2002;62;115;40;75
Pagėgiai mun.;2002;63;119;44;75
Pagėgiai mun.;2002;64;127;49;78
Pagėgiai mun.;2002;65;141;63;78
Pagėgiai mun.;2002;66;155;50;105
Pagėgiai mun.;2002;67;124;52;72
Pagėgiai mun.;2002;68;123;41;82
Pagėgiai mun.;2002;69;145;46;99
Pagėgiai mun.;2002;70;129;58;71
Pagėgiai mun.;2002;71;108;37;71
Pagėgiai mun.;2002;72;109;38;71
Pagėgiai mun.;2002;73;102;37;65
Pagėgiai mun.;2002;74;102;28;74
Pagėgiai mun.;2002;75;91;32;59
Pagėgiai mun.;2002;76;81;29;52
Pagėgiai mun.;2002;77;51;13;38
Pagėgiai mun.;2002;78;69;20;49
Pagėgiai mun.;2002;79;50;12;38
Pagėgiai mun.;2002;80;48;16;32
Pagėgiai mun.;2002;81;46;15;31
Pagėgiai mun.;2002;82;31;6;25
Pagėgiai mun.;2002;83;28;5;23
Pagėgiai mun.;2002;84;17;4;13
Pagėgiai mun.;2002;85;97;20;77
Pagėgiai mun.;2003;-1;11974;5695;6279
Pagėgiai mun.;2003;0;129;63;66
Pagėgiai mun.;2003;1;130;56;74
Pagėgiai mun.;2003;2;167;66;101
Pagėgiai mun.;2003;3;146;81;65
Pagėgiai mun.;2003;4;181;94;87
Pagėgiai mun.;2003;5;156;80;76
Pagėgiai mun.;2003;6;137;63;74
Pagėgiai mun.;2003;7;158;81;77
Pagėgiai mun.;2003;8;175;100;75
Pagėgiai mun.;2003;9;194;99;95
Pagėgiai mun.;2003;10;219;103;116
Pagėgiai mun.;2003;11;234;112;122
Pagėgiai mun.;2003;12;218;104;114
Pagėgiai mun.;2003;13;192;114;78
Pagėgiai mun.;2003;14;198;97;101
Pagėgiai mun.;2003;15;221;121;100
Pagėgiai mun.;2003;16;238;131;107
Pagėgiai mun.;2003;17;243;125;118
Pagėgiai mun.;2003;18;212;101;111
Pagėgiai mun.;2003;19;197;104;93
Pagėgiai mun.;2003;20;156;73;83
Pagėgiai mun.;2003;21;153;89;64
Pagėgiai mun.;2003;22;160;83;77
Pagėgiai mun.;2003;23;141;84;57
Pagėgiai mun.;2003;24;165;86;79
Pagėgiai mun.;2003;25;153;80;73
Pagėgiai mun.;2003;26;146;67;79
Pagėgiai mun.;2003;27;122;54;68
Pagėgiai mun.;2003;28;137;91;46
Pagėgiai mun.;2003;29;148;78;70
Pagėgiai mun.;2003;30;156;72;84
Pagėgiai mun.;2003;31;181;90;91
Pagėgiai mun.;2003;32;155;82;73
Pagėgiai mun.;2003;33;160;88;72
Pagėgiai mun.;2003;34;141;80;61
Pagėgiai mun.;2003;35;169;87;82
Pagėgiai mun.;2003;36;138;67;71
Pagėgiai mun.;2003;37;151;78;73
Pagėgiai mun.;2003;38;140;70;70
Pagėgiai mun.;2003;39;162;78;84
Pagėgiai mun.;2003;40;172;86;86
Pagėgiai mun.;2003;41;200;117;83
Pagėgiai mun.;2003;42;194;106;88
Pagėgiai mun.;2003;43;159;78;81
Pagėgiai mun.;2003;44;181;93;88
Pagėgiai mun.;2003;45;144;69;75
Pagėgiai mun.;2003;46;167;85;82
Pagėgiai mun.;2003;47;128;70;58
Pagėgiai mun.;2003;48;145;71;74
Pagėgiai mun.;2003;49;127;70;57
Pagėgiai mun.;2003;50;110;60;50
Pagėgiai mun.;2003;51;120;62;58
Pagėgiai mun.;2003;52;118;65;53
Pagėgiai mun.;2003;53;129;61;68
Pagėgiai mun.;2003;54;130;56;74
Pagėgiai mun.;2003;55;79;42;37
Pagėgiai mun.;2003;56;108;49;59
Pagėgiai mun.;2003;57;93;41;52
Pagėgiai mun.;2003;58;100;35;65
Pagėgiai mun.;2003;59;107;44;63
Pagėgiai mun.;2003;60;125;51;74
Pagėgiai mun.;2003;61;160;65;95
Pagėgiai mun.;2003;62;121;51;70
Pagėgiai mun.;2003;63;110;38;72
Pagėgiai mun.;2003;64;118;45;73
Pagėgiai mun.;2003;65;122;46;76
Pagėgiai mun.;2003;66;136;59;77
Pagėgiai mun.;2003;67;153;49;104
Pagėgiai mun.;2003;68;118;48;70
Pagėgiai mun.;2003;69;121;40;81
Pagėgiai mun.;2003;70;141;44;97
Pagėgiai mun.;2003;71;123;53;70
Pagėgiai mun.;2003;72;105;36;69
Pagėgiai mun.;2003;73;99;32;67
Pagėgiai mun.;2003;74;99;34;65
Pagėgiai mun.;2003;75;95;26;69
Pagėgiai mun.;2003;76;88;29;59
Pagėgiai mun.;2003;77;78;27;51
Pagėgiai mun.;2003;78;44;12;32
Pagėgiai mun.;2003;79;60;15;45
Pagėgiai mun.;2003;80;47;12;35
Pagėgiai mun.;2003;81;43;15;28
Pagėgiai mun.;2003;82;40;11;29
Pagėgiai mun.;2003;83;22;3;19
Pagėgiai mun.;2003;84;25;4;21
Pagėgiai mun.;2003;85;91;18;73
Pagėgiai mun.;2004;-1;11745;5565;6180
Pagėgiai mun.;2004;0;113;59;54
Pagėgiai mun.;2004;1;128;63;65
Pagėgiai mun.;2004;2;129;55;74
Pagėgiai mun.;2004;3;166;65;101
Pagėgiai mun.;2004;4;144;79;65
Pagėgiai mun.;2004;5;178;93;85
Pagėgiai mun.;2004;6;155;79;76
Pagėgiai mun.;2004;7;136;63;73
Pagėgiai mun.;2004;8;156;80;76
Pagėgiai mun.;2004;9;171;97;74
Pagėgiai mun.;2004;10;192;98;94
Pagėgiai mun.;2004;11;216;101;115
Pagėgiai mun.;2004;12;232;111;121
Pagėgiai mun.;2004;13;213;103;110
Pagėgiai mun.;2004;14;186;112;74
Pagėgiai mun.;2004;15;192;96;96
Pagėgiai mun.;2004;16;214;117;97
Pagėgiai mun.;2004;17;231;128;103
Pagėgiai mun.;2004;18;237;123;114
Pagėgiai mun.;2004;19;203;97;106
Pagėgiai mun.;2004;20;192;100;92
Pagėgiai mun.;2004;21;153;73;80
Pagėgiai mun.;2004;22;153;90;63
Pagėgiai mun.;2004;23;159;82;77
Pagėgiai mun.;2004;24;142;83;59
Pagėgiai mun.;2004;25;158;83;75
Pagėgiai mun.;2004;26;150;77;73
Pagėgiai mun.;2004;27;136;61;75
Pagėgiai mun.;2004;28;115;50;65
Pagėgiai mun.;2004;29;126;83;43
Pagėgiai mun.;2004;30;141;76;65
Pagėgiai mun.;2004;31;156;70;86
Pagėgiai mun.;2004;32;182;90;92
Pagėgiai mun.;2004;33;152;79;73
Pagėgiai mun.;2004;34;153;85;68
Pagėgiai mun.;2004;35;135;77;58
Pagėgiai mun.;2004;36;165;84;81
Pagėgiai mun.;2004;37;133;64;69
Pagėgiai mun.;2004;38;148;76;72
Pagėgiai mun.;2004;39;141;70;71
Pagėgiai mun.;2004;40;158;76;82
Pagėgiai mun.;2004;41;166;83;83
Pagėgiai mun.;2004;42;196;114;82
Pagėgiai mun.;2004;43;194;106;88
Pagėgiai mun.;2004;44;151;72;79
Pagėgiai mun.;2004;45;176;90;86
Pagėgiai mun.;2004;46;144;68;76
Pagėgiai mun.;2004;47;158;81;77
Pagėgiai mun.;2004;48;127;69;58
Pagėgiai mun.;2004;49;144;70;74
Pagėgiai mun.;2004;50;121;65;56
Pagėgiai mun.;2004;51;106;59;47
Pagėgiai mun.;2004;52;117;62;55
Pagėgiai mun.;2004;53;115;63;52
Pagėgiai mun.;2004;54;130;63;67
Pagėgiai mun.;2004;55;128;54;74
Pagėgiai mun.;2004;56;75;38;37
Pagėgiai mun.;2004;57;106;48;58
Pagėgiai mun.;2004;58;93;41;52
Pagėgiai mun.;2004;59;95;33;62
Pagėgiai mun.;2004;60;104;42;62
Pagėgiai mun.;2004;61;121;47;74
Pagėgiai mun.;2004;62;158;63;95
Pagėgiai mun.;2004;63;117;49;68
Pagėgiai mun.;2004;64;107;36;71
Pagėgiai mun.;2004;65;116;44;72
Pagėgiai mun.;2004;66;114;41;73
Pagėgiai mun.;2004;67;130;54;76
Pagėgiai mun.;2004;68;146;44;102
Pagėgiai mun.;2004;69;115;46;69
Pagėgiai mun.;2004;70;116;38;78
Pagėgiai mun.;2004;71;138;43;95
Pagėgiai mun.;2004;72;113;46;67
Pagėgiai mun.;2004;73;98;34;64
Pagėgiai mun.;2004;74;92;28;64
Pagėgiai mun.;2004;75;92;30;62
Pagėgiai mun.;2004;76;92;23;69
Pagėgiai mun.;2004;77;85;26;59
Pagėgiai mun.;2004;78;74;24;50
Pagėgiai mun.;2004;79;39;10;29
Pagėgiai mun.;2004;80;57;13;44
Pagėgiai mun.;2004;81;39;10;29
Pagėgiai mun.;2004;82;38;12;26
Pagėgiai mun.;2004;83;37;10;27
Pagėgiai mun.;2004;84;22;3;19
Pagėgiai mun.;2004;85;103;22;81
Pagėgiai mun.;2005;-1;11476;5453;6023
Pagėgiai mun.;2005;0;105;53;52
Pagėgiai mun.;2005;1;111;57;54
Pagėgiai mun.;2005;2;128;63;65
Pagėgiai mun.;2005;3;129;55;74
Pagėgiai mun.;2005;4;164;66;98
Pagėgiai mun.;2005;5;140;76;64
Pagėgiai mun.;2005;6;176;92;84
Pagėgiai mun.;2005;7;151;77;74
Pagėgiai mun.;2005;8;137;63;74
Pagėgiai mun.;2005;9;155;79;76
Pagėgiai mun.;2005;10;169;96;73
Pagėgiai mun.;2005;11;189;96;93
Pagėgiai mun.;2005;12;213;101;112
Pagėgiai mun.;2005;13;227;108;119
Pagėgiai mun.;2005;14;206;100;106
Pagėgiai mun.;2005;15;186;112;74
Pagėgiai mun.;2005;16;186;92;94
Pagėgiai mun.;2005;17;210;115;95
Pagėgiai mun.;2005;18;223;125;98
Pagėgiai mun.;2005;19;234;121;113
Pagėgiai mun.;2005;20;195;93;102
Pagėgiai mun.;2005;21;186;99;87
Pagėgiai mun.;2005;22;145;71;74
Pagėgiai mun.;2005;23;152;87;65
Pagėgiai mun.;2005;24;153;84;69
Pagėgiai mun.;2005;25;135;79;56
Pagėgiai mun.;2005;26;149;75;74
Pagėgiai mun.;2005;27;139;69;70
Pagėgiai mun.;2005;28;136;62;74
Pagėgiai mun.;2005;29;114;47;67
Pagėgiai mun.;2005;30;119;82;37
Pagėgiai mun.;2005;31;130;71;59
Pagėgiai mun.;2005;32;149;66;83
Pagėgiai mun.;2005;33;181;90;91
Pagėgiai mun.;2005;34;145;72;73
Pagėgiai mun.;2005;35;151;86;65
Pagėgiai mun.;2005;36;133;76;57
Pagėgiai mun.;2005;37;160;85;75
Pagėgiai mun.;2005;38;129;64;65
Pagėgiai mun.;2005;39;146;75;71
Pagėgiai mun.;2005;40;143;71;72
Pagėgiai mun.;2005;41;154;73;81
Pagėgiai mun.;2005;42;167;84;83
Pagėgiai mun.;2005;43;195;112;83
Pagėgiai mun.;2005;44;183;101;82
Pagėgiai mun.;2005;45;146;72;74
Pagėgiai mun.;2005;46;171;88;83
Pagėgiai mun.;2005;47;142;66;76
Pagėgiai mun.;2005;48;152;76;76
Pagėgiai mun.;2005;49;126;70;56
Pagėgiai mun.;2005;50;139;68;71
Pagėgiai mun.;2005;51;122;64;58
Pagėgiai mun.;2005;52;104;60;44
Pagėgiai mun.;2005;53;113;59;54
Pagėgiai mun.;2005;54;114;60;54
Pagėgiai mun.;2005;55;129;62;67
Pagėgiai mun.;2005;56;122;51;71
Pagėgiai mun.;2005;57;74;38;36
Pagėgiai mun.;2005;58;105;48;57
Pagėgiai mun.;2005;59;93;42;51
Pagėgiai mun.;2005;60;93;31;62
Pagėgiai mun.;2005;61;102;42;60
Pagėgiai mun.;2005;62;117;46;71
Pagėgiai mun.;2005;63;150;59;91
Pagėgiai mun.;2005;64;112;48;64
Pagėgiai mun.;2005;65;101;32;69
Pagėgiai mun.;2005;66;110;42;68
Pagėgiai mun.;2005;67;113;41;72
Pagėgiai mun.;2005;68;122;50;72
Pagėgiai mun.;2005;69;143;42;101
Pagėgiai mun.;2005;70;113;46;67
Pagėgiai mun.;2005;71;108;35;73
Pagėgiai mun.;2005;72;133;41;92
Pagėgiai mun.;2005;73;110;44;66
Pagėgiai mun.;2005;74;96;34;62
Pagėgiai mun.;2005;75;80;21;59
Pagėgiai mun.;2005;76;88;26;62
Pagėgiai mun.;2005;77;87;19;68
Pagėgiai mun.;2005;78;79;23;56
Pagėgiai mun.;2005;79;70;24;46
Pagėgiai mun.;2005;80;32;9;23
Pagėgiai mun.;2005;81;50;9;41
Pagėgiai mun.;2005;82;30;8;22
Pagėgiai mun.;2005;83;32;9;23
Pagėgiai mun.;2005;84;31;8;23
Pagėgiai mun.;2005;85;94;19;75
Pagėgiai mun.;2006;-1;11094;5239;5855
Pagėgiai mun.;2006;0;120;61;59
Pagėgiai mun.;2006;1;101;51;50
Pagėgiai mun.;2006;2;107;54;53
Pagėgiai mun.;2006;3;121;58;63
Pagėgiai mun.;2006;4;124;52;72
Pagėgiai mun.;2006;5;160;62;98
Pagėgiai mun.;2006;6;135;72;63
Pagėgiai mun.;2006;7;171;88;83
Pagėgiai mun.;2006;8;150;76;74
Pagėgiai mun.;2006;9;136;61;75
Pagėgiai mun.;2006;10;152;77;75
Pagėgiai mun.;2006;11;166;94;72
Pagėgiai mun.;2006;12;186;93;93
Pagėgiai mun.;2006;13;207;96;111
Pagėgiai mun.;2006;14;220;102;118
Pagėgiai mun.;2006;15;202;98;104
Pagėgiai mun.;2006;16;179;107;72
Pagėgiai mun.;2006;17;180;90;90
Pagėgiai mun.;2006;18;200;111;89
Pagėgiai mun.;2006;19;208;116;92
Pagėgiai mun.;2006;20;217;111;106
Pagėgiai mun.;2006;21;182;85;97
Pagėgiai mun.;2006;22;176;95;81
Pagėgiai mun.;2006;23;133;67;66
Pagėgiai mun.;2006;24;138;80;58
Pagėgiai mun.;2006;25;138;76;62
Pagėgiai mun.;2006;26;125;73;52
Pagėgiai mun.;2006;27;139;72;67
Pagėgiai mun.;2006;28;130;65;65
Pagėgiai mun.;2006;29;124;59;65
Pagėgiai mun.;2006;30;103;40;63
Pagėgiai mun.;2006;31;112;76;36
Pagėgiai mun.;2006;32;124;67;57
Pagėgiai mun.;2006;33;146;65;81
Pagėgiai mun.;2006;34;180;89;91
Pagėgiai mun.;2006;35;141;70;71
Pagėgiai mun.;2006;36;142;80;62
Pagėgiai mun.;2006;37;128;74;54
Pagėgiai mun.;2006;38;155;79;76
Pagėgiai mun.;2006;39;127;62;65
Pagėgiai mun.;2006;40;145;76;69
Pagėgiai mun.;2006;41;140;67;73
Pagėgiai mun.;2006;42;152;70;82
Pagėgiai mun.;2006;43;160;79;81
Pagėgiai mun.;2006;44;190;108;82
Pagėgiai mun.;2006;45;180;99;81
Pagėgiai mun.;2006;46;141;70;71
Pagėgiai mun.;2006;47;169;85;84
Pagėgiai mun.;2006;48;142;66;76
Pagėgiai mun.;2006;49;147;75;72
Pagėgiai mun.;2006;50;124;68;56
Pagėgiai mun.;2006;51;132;67;65
Pagėgiai mun.;2006;52;117;62;55
Pagėgiai mun.;2006;53;105;62;43
Pagėgiai mun.;2006;54;109;56;53
Pagėgiai mun.;2006;55;110;56;54
Pagėgiai mun.;2006;56;125;60;65
Pagėgiai mun.;2006;57;120;50;70
Pagėgiai mun.;2006;58;73;36;37
Pagėgiai mun.;2006;59;104;48;56
Pagėgiai mun.;2006;60;92;42;50
Pagėgiai mun.;2006;61;87;27;60
Pagėgiai mun.;2006;62;96;39;57
Pagėgiai mun.;2006;63;110;40;70
Pagėgiai mun.;2006;64;143;54;89
Pagėgiai mun.;2006;65;104;43;61
Pagėgiai mun.;2006;66;101;33;68
Pagėgiai mun.;2006;67;103;35;68
Pagėgiai mun.;2006;68;104;36;68
Pagėgiai mun.;2006;69;114;47;67
Pagėgiai mun.;2006;70;141;41;100
Pagėgiai mun.;2006;71;107;41;66
Pagėgiai mun.;2006;72;102;30;72
Pagėgiai mun.;2006;73;126;36;90
Pagėgiai mun.;2006;74;105;42;63
Pagėgiai mun.;2006;75;93;33;60
Pagėgiai mun.;2006;76;78;21;57
Pagėgiai mun.;2006;77;78;23;55
Pagėgiai mun.;2006;78;81;19;62
Pagėgiai mun.;2006;79;72;23;49
Pagėgiai mun.;2006;80;63;20;43
Pagėgiai mun.;2006;81;23;6;17
Pagėgiai mun.;2006;82;45;8;37
Pagėgiai mun.;2006;83;26;6;20
Pagėgiai mun.;2006;84;29;7;22
Pagėgiai mun.;2006;85;101;23;78
Pagėgiai mun.;2007;-1;10808;5106;5702
Pagėgiai mun.;2007;0;97;47;50
Pagėgiai mun.;2007;1;117;60;57
Pagėgiai mun.;2007;2;102;52;50
Pagėgiai mun.;2007;3;101;52;49
Pagėgiai mun.;2007;4;119;57;62
Pagėgiai mun.;2007;5;120;50;70
Pagėgiai mun.;2007;6;154;60;94
Pagėgiai mun.;2007;7;134;70;64
Pagėgiai mun.;2007;8;170;87;83
Pagėgiai mun.;2007;9;147;76;71
Pagėgiai mun.;2007;10;135;61;74
Pagėgiai mun.;2007;11;152;78;74
Pagėgiai mun.;2007;12;162;91;71
Pagėgiai mun.;2007;13;184;92;92
Pagėgiai mun.;2007;14;204;95;109
Pagėgiai mun.;2007;15;219;103;116
Pagėgiai mun.;2007;16;204;101;103
Pagėgiai mun.;2007;17;175;104;71
Pagėgiai mun.;2007;18;173;87;86
Pagėgiai mun.;2007;19;196;106;90
Pagėgiai mun.;2007;20;200;113;87
Pagėgiai mun.;2007;21;204;106;98
Pagėgiai mun.;2007;22;179;87;92
Pagėgiai mun.;2007;23;164;86;78
Pagėgiai mun.;2007;24;129;65;64
Pagėgiai mun.;2007;25;128;72;56
Pagėgiai mun.;2007;26;133;74;59
Pagėgiai mun.;2007;27;121;70;51
Pagėgiai mun.;2007;28;131;69;62
Pagėgiai mun.;2007;29;126;63;63
Pagėgiai mun.;2007;30;120;56;64
Pagėgiai mun.;2007;31;100;39;61
Pagėgiai mun.;2007;32;106;75;31
Pagėgiai mun.;2007;33;126;68;58
Pagėgiai mun.;2007;34;140;64;76
Pagėgiai mun.;2007;35;175;86;89
Pagėgiai mun.;2007;36;135;66;69
Pagėgiai mun.;2007;37;142;79;63
Pagėgiai mun.;2007;38;125;71;54
Pagėgiai mun.;2007;39;150;77;73
Pagėgiai mun.;2007;40;123;62;61
Pagėgiai mun.;2007;41;143;76;67
Pagėgiai mun.;2007;42;136;62;74
Pagėgiai mun.;2007;43;152;69;83
Pagėgiai mun.;2007;44;151;74;77
Pagėgiai mun.;2007;45;186;103;83
Pagėgiai mun.;2007;46;181;100;81
Pagėgiai mun.;2007;47;142;72;70
Pagėgiai mun.;2007;48;165;84;81
Pagėgiai mun.;2007;49;141;69;72
Pagėgiai mun.;2007;50;143;74;69
Pagėgiai mun.;2007;51;116;63;53
Pagėgiai mun.;2007;52;126;65;61
Pagėgiai mun.;2007;53;113;59;54
Pagėgiai mun.;2007;54;106;61;45
Pagėgiai mun.;2007;55;108;54;54
Pagėgiai mun.;2007;56;107;54;53
Pagėgiai mun.;2007;57;121;57;64
Pagėgiai mun.;2007;58;115;47;68
Pagėgiai mun.;2007;59;71;34;37
Pagėgiai mun.;2007;60;99;45;54
Pagėgiai mun.;2007;61;85;39;46
Pagėgiai mun.;2007;62;86;26;60
Pagėgiai mun.;2007;63;91;36;55
Pagėgiai mun.;2007;64;102;35;67
Pagėgiai mun.;2007;65;141;53;88
Pagėgiai mun.;2007;66;97;40;57
Pagėgiai mun.;2007;67;98;32;66
Pagėgiai mun.;2007;68;102;35;67
Pagėgiai mun.;2007;69;99;33;66
Pagėgiai mun.;2007;70;111;45;66
Pagėgiai mun.;2007;71;128;37;91
Pagėgiai mun.;2007;72;101;38;63
Pagėgiai mun.;2007;73;96;27;69
Pagėgiai mun.;2007;74;117;32;85
Pagėgiai mun.;2007;75;91;32;59
Pagėgiai mun.;2007;76;87;30;57
Pagėgiai mun.;2007;77;69;20;49
Pagėgiai mun.;2007;78;69;21;48
Pagėgiai mun.;2007;79;77;19;58
Pagėgiai mun.;2007;80;64;21;43
Pagėgiai mun.;2007;81;54;16;38
Pagėgiai mun.;2007;82;19;5;14
Pagėgiai mun.;2007;83;41;6;35
Pagėgiai mun.;2007;84;27;6;21
Pagėgiai mun.;2007;85;112;23;89
Pagėgiai mun.;2008;-1;10468;4945;5523
Pagėgiai mun.;2008;0;96;46;50
Pagėgiai mun.;2008;1;95;47;48
Pagėgiai mun.;2008;2;113;58;55
Pagėgiai mun.;2008;3;100;52;48
Pagėgiai mun.;2008;4;100;52;48
Pagėgiai mun.;2008;5;114;56;58
Pagėgiai mun.;2008;6;115;48;67
Pagėgiai mun.;2008;7;153;59;94
Pagėgiai mun.;2008;8;131;68;63
Pagėgiai mun.;2008;9;168;85;83
Pagėgiai mun.;2008;10;147;75;72
Pagėgiai mun.;2008;11;132;59;73
Pagėgiai mun.;2008;12;146;76;70
Pagėgiai mun.;2008;13;160;90;70
Pagėgiai mun.;2008;14;179;91;88
Pagėgiai mun.;2008;15;201;92;109
Pagėgiai mun.;2008;16;213;100;113
Pagėgiai mun.;2008;17;199;101;98
Pagėgiai mun.;2008;18;169;101;68
Pagėgiai mun.;2008;19;168;87;81
Pagėgiai mun.;2008;20;188;103;85
Pagėgiai mun.;2008;21;192;111;81
Pagėgiai mun.;2008;22;196;102;94
Pagėgiai mun.;2008;23;169;85;84
Pagėgiai mun.;2008;24;159;82;77
Pagėgiai mun.;2008;25;124;64;60
Pagėgiai mun.;2008;26;123;70;53
Pagėgiai mun.;2008;27;127;68;59
Pagėgiai mun.;2008;28;112;66;46
Pagėgiai mun.;2008;29;124;66;58
Pagėgiai mun.;2008;30;122;62;60
Pagėgiai mun.;2008;31;108;51;57
Pagėgiai mun.;2008;32;98;37;61
Pagėgiai mun.;2008;33;100;71;29
Pagėgiai mun.;2008;34;121;65;56
Pagėgiai mun.;2008;35;135;61;74
Pagėgiai mun.;2008;36;171;83;88
Pagėgiai mun.;2008;37;130;63;67
Pagėgiai mun.;2008;38;137;76;61
Pagėgiai mun.;2008;39;119;69;50
Pagėgiai mun.;2008;40;148;76;72
Pagėgiai mun.;2008;41;124;60;64
Pagėgiai mun.;2008;42;138;71;67
Pagėgiai mun.;2008;43;131;61;70
Pagėgiai mun.;2008;44;148;68;80
Pagėgiai mun.;2008;45;147;72;75
Pagėgiai mun.;2008;46;182;101;81
Pagėgiai mun.;2008;47;175;94;81
Pagėgiai mun.;2008;48;134;68;66
Pagėgiai mun.;2008;49;161;83;78
Pagėgiai mun.;2008;50;135;63;72
Pagėgiai mun.;2008;51;143;73;70
Pagėgiai mun.;2008;52;113;61;52
Pagėgiai mun.;2008;53;122;62;60
Pagėgiai mun.;2008;54;113;59;54
Pagėgiai mun.;2008;55;103;59;44
Pagėgiai mun.;2008;56;103;51;52
Pagėgiai mun.;2008;57;106;52;54
Pagėgiai mun.;2008;58;112;51;61
Pagėgiai mun.;2008;59;114;45;69
Pagėgiai mun.;2008;60;65;30;35
Pagėgiai mun.;2008;61;97;45;52
Pagėgiai mun.;2008;62;85;39;46
Pagėgiai mun.;2008;63;82;23;59
Pagėgiai mun.;2008;64;89;33;56
Pagėgiai mun.;2008;65;99;32;67
Pagėgiai mun.;2008;66;133;48;85
Pagėgiai mun.;2008;67;95;39;56
Pagėgiai mun.;2008;68;91;29;62
Pagėgiai mun.;2008;69;97;32;65
Pagėgiai mun.;2008;70;92;29;63
Pagėgiai mun.;2008;71;102;39;63
Pagėgiai mun.;2008;72;121;35;86
Pagėgiai mun.;2008;73;93;33;60
Pagėgiai mun.;2008;74;86;21;65
Pagėgiai mun.;2008;75;111;29;82
Pagėgiai mun.;2008;76;83;30;53
Pagėgiai mun.;2008;77;76;26;50
Pagėgiai mun.;2008;78;66;20;46
Pagėgiai mun.;2008;79;64;21;43
Pagėgiai mun.;2008;80;70;18;52
Pagėgiai mun.;2008;81;56;19;37
Pagėgiai mun.;2008;82;52;15;37
Pagėgiai mun.;2008;83;16;5;11
Pagėgiai mun.;2008;84;33;4;29
Pagėgiai mun.;2008;85;108;23;85
Pagėgiai mun.;2009;-1;10190;4806;5384
Pagėgiai mun.;2009;0;112;60;52
Pagėgiai mun.;2009;1;95;45;50
Pagėgiai mun.;2009;2;95;47;48
Pagėgiai mun.;2009;3;113;57;56
Pagėgiai mun.;2009;4;97;51;46
Pagėgiai mun.;2009;5;96;52;44
Pagėgiai mun.;2009;6;108;51;57
Pagėgiai mun.;2009;7;113;47;66
Pagėgiai mun.;2009;8;149;57;92
Pagėgiai mun.;2009;9;130;67;63
Pagėgiai mun.;2009;10;157;81;76
Pagėgiai mun.;2009;11;144;74;70
Pagėgiai mun.;2009;12;127;56;71
Pagėgiai mun.;2009;13;144;75;69
Pagėgiai mun.;2009;14;159;89;70
Pagėgiai mun.;2009;15;176;90;86
Pagėgiai mun.;2009;16;198;92;106
Pagėgiai mun.;2009;17;210;98;112
Pagėgiai mun.;2009;18;194;100;94
Pagėgiai mun.;2009;19;164;99;65
Pagėgiai mun.;2009;20;166;85;81
Pagėgiai mun.;2009;21;187;102;85
Pagėgiai mun.;2009;22;187;109;78
Pagėgiai mun.;2009;23;195;102;93
Pagėgiai mun.;2009;24;158;81;77
Pagėgiai mun.;2009;25;152;81;71
Pagėgiai mun.;2009;26;114;62;52
Pagėgiai mun.;2009;27;113;64;49
Pagėgiai mun.;2009;28;121;66;55
Pagėgiai mun.;2009;29;103;61;42
Pagėgiai mun.;2009;30;118;62;56
Pagėgiai mun.;2009;31;115;59;56
Pagėgiai mun.;2009;32;102;50;52
Pagėgiai mun.;2009;33;94;38;56
Pagėgiai mun.;2009;34;96;68;28
Pagėgiai mun.;2009;35;114;62;52
Pagėgiai mun.;2009;36;129;54;75
Pagėgiai mun.;2009;37;171;80;91
Pagėgiai mun.;2009;38;133;63;70
Pagėgiai mun.;2009;39;134;75;59
Pagėgiai mun.;2009;40;117;67;50
Pagėgiai mun.;2009;41;143;72;71
Pagėgiai mun.;2009;42;123;60;63
Pagėgiai mun.;2009;43;133;68;65
Pagėgiai mun.;2009;44;129;60;69
Pagėgiai mun.;2009;45;144;67;77
Pagėgiai mun.;2009;46;145;70;75
Pagėgiai mun.;2009;47;178;97;81
Pagėgiai mun.;2009;48;169;91;78
Pagėgiai mun.;2009;49;130;65;65
Pagėgiai mun.;2009;50;155;77;78
Pagėgiai mun.;2009;51;129;61;68
Pagėgiai mun.;2009;52;144;73;71
Pagėgiai mun.;2009;53;110;59;51
Pagėgiai mun.;2009;54;123;61;62
Pagėgiai mun.;2009;55;109;57;52
Pagėgiai mun.;2009;56;100;57;43
Pagėgiai mun.;2009;57;98;47;51
Pagėgiai mun.;2009;58;103;50;53
Pagėgiai mun.;2009;59;111;50;61
Pagėgiai mun.;2009;60;112;45;67
Pagėgiai mun.;2009;61;63;28;35
Pagėgiai mun.;2009;62;91;41;50
Pagėgiai mun.;2009;63;79;35;44
Pagėgiai mun.;2009;64;77;21;56
Pagėgiai mun.;2009;65;83;30;53
Pagėgiai mun.;2009;66;93;28;65
Pagėgiai mun.;2009;67;125;45;80
Pagėgiai mun.;2009;68;91;36;55
Pagėgiai mun.;2009;69;87;27;60
Pagėgiai mun.;2009;70;93;30;63
Pagėgiai mun.;2009;71;86;26;60
Pagėgiai mun.;2009;72;99;36;63
Pagėgiai mun.;2009;73;112;31;81
Pagėgiai mun.;2009;74;89;31;58
Pagėgiai mun.;2009;75;80;19;61
Pagėgiai mun.;2009;76;106;26;80
Pagėgiai mun.;2009;77;79;26;53
Pagėgiai mun.;2009;78;68;21;47
Pagėgiai mun.;2009;79;55;14;41
Pagėgiai mun.;2009;80;56;17;39
Pagėgiai mun.;2009;81;62;16;46
Pagėgiai mun.;2009;82;52;17;35
Pagėgiai mun.;2009;83;49;15;34
Pagėgiai mun.;2009;84;15;5;10
Pagėgiai mun.;2009;85;112;19;93
Pagėgiai mun.;2010;-1;9942;4687;5255
Pagėgiai mun.;2010;0;100;55;45
Pagėgiai mun.;2010;1;108;57;51
Pagėgiai mun.;2010;2;92;44;48
Pagėgiai mun.;2010;3;94;46;48
Pagėgiai mun.;2010;4;111;57;54
Pagėgiai mun.;2010;5;96;51;45
Pagėgiai mun.;2010;6;95;51;44
Pagėgiai mun.;2010;7;110;56;54
Pagėgiai mun.;2010;8;112;47;65
Pagėgiai mun.;2010;9;147;57;90
Pagėgiai mun.;2010;10;129;67;62
Pagėgiai mun.;2010;11;157;81;76
Pagėgiai mun.;2010;12;143;74;69
Pagėgiai mun.;2010;13;124;55;69
Pagėgiai mun.;2010;14;142;74;68
Pagėgiai mun.;2010;15;158;89;69
Pagėgiai mun.;2010;16;173;88;85
Pagėgiai mun.;2010;17;195;90;105
Pagėgiai mun.;2010;18;204;95;109
Pagėgiai mun.;2010;19;187;96;91
Pagėgiai mun.;2010;20;158;95;63
Pagėgiai mun.;2010;21;160;83;77
Pagėgiai mun.;2010;22;175;96;79
Pagėgiai mun.;2010;23;176;103;73
Pagėgiai mun.;2010;24;183;94;89
Pagėgiai mun.;2010;25;151;77;74
Pagėgiai mun.;2010;26;144;78;66
Pagėgiai mun.;2010;27;112;60;52
Pagėgiai mun.;2010;28;103;58;45
Pagėgiai mun.;2010;29;119;64;55
Pagėgiai mun.;2010;30;99;60;39
Pagėgiai mun.;2010;31;112;60;52
Pagėgiai mun.;2010;32;113;60;53
Pagėgiai mun.;2010;33;101;46;55
Pagėgiai mun.;2010;34;92;37;55
Pagėgiai mun.;2010;35;92;66;26
Pagėgiai mun.;2010;36;115;61;54
Pagėgiai mun.;2010;37;126;52;74
Pagėgiai mun.;2010;38;168;78;90
Pagėgiai mun.;2010;39;129;60;69
Pagėgiai mun.;2010;40;135;76;59
Pagėgiai mun.;2010;41;116;66;50
Pagėgiai mun.;2010;42;138;69;69
Pagėgiai mun.;2010;43;120;57;63
Pagėgiai mun.;2010;44;131;66;65
Pagėgiai mun.;2010;45;123;55;68
Pagėgiai mun.;2010;46;139;63;76
Pagėgiai mun.;2010;47;137;65;72
Pagėgiai mun.;2010;48;178;97;81
Pagėgiai mun.;2010;49;167;90;77
Pagėgiai mun.;2010;50;129;63;66
Pagėgiai mun.;2010;51;147;72;75
Pagėgiai mun.;2010;52;125;60;65
Pagėgiai mun.;2010;53;139;69;70
Pagėgiai mun.;2010;54;106;55;51
Pagėgiai mun.;2010;55;119;59;60
Pagėgiai mun.;2010;56;103;53;50
Pagėgiai mun.;2010;57;99;57;42
Pagėgiai mun.;2010;58;92;43;49
Pagėgiai mun.;2010;59;98;47;51
Pagėgiai mun.;2010;60;107;49;58
Pagėgiai mun.;2010;61;112;46;66
Pagėgiai mun.;2010;62;62;27;35
Pagėgiai mun.;2010;63;88;40;48
Pagėgiai mun.;2010;64;79;34;45
Pagėgiai mun.;2010;65;73;19;54
Pagėgiai mun.;2010;66;75;25;50
Pagėgiai mun.;2010;67;93;29;64
Pagėgiai mun.;2010;68;124;42;82
Pagėgiai mun.;2010;69;85;33;52
Pagėgiai mun.;2010;70;83;26;57
Pagėgiai mun.;2010;71;87;27;60
Pagėgiai mun.;2010;72;84;25;59
Pagėgiai mun.;2010;73;96;33;63
Pagėgiai mun.;2010;74;106;29;77
Pagėgiai mun.;2010;75;82;27;55
Pagėgiai mun.;2010;76;74;17;57
Pagėgiai mun.;2010;77;104;24;80
Pagėgiai mun.;2010;78;78;26;52
Pagėgiai mun.;2010;79;63;21;42
Pagėgiai mun.;2010;80;49;10;39
Pagėgiai mun.;2010;81;47;15;32
Pagėgiai mun.;2010;82;54;14;40
Pagėgiai mun.;2010;83;47;16;31
Pagėgiai mun.;2010;84;40;12;28
Pagėgiai mun.;2010;85;104;21;83
Pagėgiai mun.;2011;-1;9535;4500;5035
Pagėgiai mun.;2011;0;85;37;48
Pagėgiai mun.;2011;1;82;42;40
Pagėgiai mun.;2011;2;88;42;46
Pagėgiai mun.;2011;3;82;43;39
Pagėgiai mun.;2011;4;73;37;36
Pagėgiai mun.;2011;5;95;50;45
Pagėgiai mun.;2011;6;76;35;41
Pagėgiai mun.;2011;7;83;46;37
Pagėgiai mun.;2011;8;101;56;45
Pagėgiai mun.;2011;9;102;47;55
Pagėgiai mun.;2011;10;143;62;81
Pagėgiai mun.;2011;11;124;66;58
Pagėgiai mun.;2011;12;161;90;71
Pagėgiai mun.;2011;13;142;74;68
Pagėgiai mun.;2011;14;117;55;62
Pagėgiai mun.;2011;15;141;70;71
Pagėgiai mun.;2011;16;160;89;71
Pagėgiai mun.;2011;17;165;86;79
Pagėgiai mun.;2011;18;190;91;99
Pagėgiai mun.;2011;19;176;74;102
Pagėgiai mun.;2011;20;167;90;77
Pagėgiai mun.;2011;21;139;86;53
Pagėgiai mun.;2011;22;128;69;59
Pagėgiai mun.;2011;23;143;84;59
Pagėgiai mun.;2011;24;126;66;60
Pagėgiai mun.;2011;25;130;64;66
Pagėgiai mun.;2011;26;110;59;51
Pagėgiai mun.;2011;27;89;50;39
Pagėgiai mun.;2011;28;77;35;42
Pagėgiai mun.;2011;29;83;45;38
Pagėgiai mun.;2011;30;104;54;50
Pagėgiai mun.;2011;31;99;51;48
Pagėgiai mun.;2011;32;102;52;50
Pagėgiai mun.;2011;33;118;71;47
Pagėgiai mun.;2011;34;100;47;53
Pagėgiai mun.;2011;35;92;42;50
Pagėgiai mun.;2011;36;106;62;44
Pagėgiai mun.;2011;37;117;61;56
Pagėgiai mun.;2011;38;127;60;67
Pagėgiai mun.;2011;39;169;88;81
Pagėgiai mun.;2011;40;139;69;70
Pagėgiai mun.;2011;41;141;75;66
Pagėgiai mun.;2011;42;131;70;61
Pagėgiai mun.;2011;43;145;72;73
Pagėgiai mun.;2011;44;121;58;63
Pagėgiai mun.;2011;45;132;67;65
Pagėgiai mun.;2011;46;131;60;71
Pagėgiai mun.;2011;47;136;64;72
Pagėgiai mun.;2011;48;151;74;77
Pagėgiai mun.;2011;49;166;90;76
Pagėgiai mun.;2011;50;171;94;77
Pagėgiai mun.;2011;51;136;63;73
Pagėgiai mun.;2011;52;160;79;81
Pagėgiai mun.;2011;53;125;61;64
Pagėgiai mun.;2011;54;150;72;78
Pagėgiai mun.;2011;55;111;57;54
Pagėgiai mun.;2011;56;116;57;59
Pagėgiai mun.;2011;57;106;55;51
Pagėgiai mun.;2011;58;103;52;51
Pagėgiai mun.;2011;59;97;46;51
Pagėgiai mun.;2011;60;98;49;49
Pagėgiai mun.;2011;61;111;53;58
Pagėgiai mun.;2011;62;111;42;69
Pagėgiai mun.;2011;63;70;31;39
Pagėgiai mun.;2011;64;93;40;53
Pagėgiai mun.;2011;65;76;31;45
Pagėgiai mun.;2011;66;77;21;56
Pagėgiai mun.;2011;67;73;27;46
Pagėgiai mun.;2011;68;94;29;65
Pagėgiai mun.;2011;69;122;42;80
Pagėgiai mun.;2011;70;89;35;54
Pagėgiai mun.;2011;71;89;27;62
Pagėgiai mun.;2011;72;87;26;61
Pagėgiai mun.;2011;73;80;26;54
Pagėgiai mun.;2011;74;93;35;58
Pagėgiai mun.;2011;75;103;32;71
Pagėgiai mun.;2011;76;80;27;53
Pagėgiai mun.;2011;77;72;16;56
Pagėgiai mun.;2011;78;100;24;76
Pagėgiai mun.;2011;79;76;28;48
Pagėgiai mun.;2011;80;58;16;42
Pagėgiai mun.;2011;81;46;9;37
Pagėgiai mun.;2011;82;45;14;31
Pagėgiai mun.;2011;83;50;12;38
Pagėgiai mun.;2011;84;42;15;27
Pagėgiai mun.;2011;85;120;30;90
Pagėgiai mun.;2012;-1;9297;4395;4902
Pagėgiai mun.;2012;0;101;47;54
Pagėgiai mun.;2012;1;85;38;47
Pagėgiai mun.;2012;2;83;44;39
Pagėgiai mun.;2012;3;87;40;47
Pagėgiai mun.;2012;4;77;42;35
Pagėgiai mun.;2012;5;74;38;36
Pagėgiai mun.;2012;6;96;49;47
Pagėgiai mun.;2012;7;77;35;42
Pagėgiai mun.;2012;8;83;46;37
Pagėgiai mun.;2012;9;100;56;44
Pagėgiai mun.;2012;10;104;46;58
Pagėgiai mun.;2012;11;142;61;81
Pagėgiai mun.;2012;12;118;62;56
Pagėgiai mun.;2012;13;160;89;71
Pagėgiai mun.;2012;14;144;75;69
Pagėgiai mun.;2012;15;116;57;59
Pagėgiai mun.;2012;16;142;70;72
Pagėgiai mun.;2012;17;159;88;71
Pagėgiai mun.;2012;18;163;86;77
Pagėgiai mun.;2012;19;186;91;95
Pagėgiai mun.;2012;20;177;76;101
Pagėgiai mun.;2012;21;158;90;68
Pagėgiai mun.;2012;22;128;83;45
Pagėgiai mun.;2012;23;124;66;58
Pagėgiai mun.;2012;24;132;75;57
Pagėgiai mun.;2012;25;114;60;54
Pagėgiai mun.;2012;26;114;59;55
Pagėgiai mun.;2012;27;108;56;52
Pagėgiai mun.;2012;28;80;45;35
Pagėgiai mun.;2012;29;72;30;42
Pagėgiai mun.;2012;30;73;38;35
Pagėgiai mun.;2012;31;100;52;48
Pagėgiai mun.;2012;32;94;51;43
Pagėgiai mun.;2012;33;97;49;48
Pagėgiai mun.;2012;34;114;68;46
Pagėgiai mun.;2012;35;96;46;50
Pagėgiai mun.;2012;36;90;44;46
Pagėgiai mun.;2012;37;102;61;41
Pagėgiai mun.;2012;38;109;57;52
Pagėgiai mun.;2012;39;122;55;67
Pagėgiai mun.;2012;40;166;88;78
Pagėgiai mun.;2012;41;131;66;65
Pagėgiai mun.;2012;42;138;73;65
Pagėgiai mun.;2012;43;128;67;61
Pagėgiai mun.;2012;44;145;72;73
Pagėgiai mun.;2012;45;119;57;62
Pagėgiai mun.;2012;46;132;67;65
Pagėgiai mun.;2012;47;128;56;72
Pagėgiai mun.;2012;48;134;64;70
Pagėgiai mun.;2012;49;156;77;79
Pagėgiai mun.;2012;50;161;88;73
Pagėgiai mun.;2012;51;169;93;76
Pagėgiai mun.;2012;52;132;62;70
Pagėgiai mun.;2012;53;160;81;79
Pagėgiai mun.;2012;54;122;59;63
Pagėgiai mun.;2012;55;146;67;79
Pagėgiai mun.;2012;56;110;56;54
Pagėgiai mun.;2012;57;115;57;58
Pagėgiai mun.;2012;58;103;53;50
Pagėgiai mun.;2012;59;99;50;49
Pagėgiai mun.;2012;60;96;46;50
Pagėgiai mun.;2012;61;99;51;48
Pagėgiai mun.;2012;62;110;53;57
Pagėgiai mun.;2012;63;107;40;67
Pagėgiai mun.;2012;64;69;31;38
Pagėgiai mun.;2012;65;88;36;52
Pagėgiai mun.;2012;66;73;29;44
Pagėgiai mun.;2012;67;75;19;56
Pagėgiai mun.;2012;68;68;27;41
Pagėgiai mun.;2012;69;91;27;64
Pagėgiai mun.;2012;70;113;37;76
Pagėgiai mun.;2012;71;83;30;53
Pagėgiai mun.;2012;72;84;26;58
Pagėgiai mun.;2012;73;81;23;58
Pagėgiai mun.;2012;74;76;23;53
Pagėgiai mun.;2012;75;89;34;55
Pagėgiai mun.;2012;76;95;28;67
Pagėgiai mun.;2012;77;73;25;48
Pagėgiai mun.;2012;78;69;15;54
Pagėgiai mun.;2012;79;93;20;73
Pagėgiai mun.;2012;80;71;25;46
Pagėgiai mun.;2012;81;50;13;37
Pagėgiai mun.;2012;82;41;8;33
Pagėgiai mun.;2012;83;38;12;26
Pagėgiai mun.;2012;84;39;8;31
Pagėgiai mun.;2012;85;131;35;96
Pagėgiai mun.;2013;-1;9124;4325;4799
Pagėgiai mun.;2013;0;130;74;56
Pagėgiai mun.;2013;1;100;48;52
Pagėgiai mun.;2013;2;81;35;46
Pagėgiai mun.;2013;3;87;46;41
Pagėgiai mun.;2013;4;87;41;46
Pagėgiai mun.;2013;5;72;40;32
Pagėgiai mun.;2013;6;70;36;34
Pagėgiai mun.;2013;7;89;44;45
Pagėgiai mun.;2013;8;76;35;41
Pagėgiai mun.;2013;9;82;45;37
Pagėgiai mun.;2013;10;96;53;43
Pagėgiai mun.;2013;11;104;47;57
Pagėgiai mun.;2013;12;140;61;79
Pagėgiai mun.;2013;13;120;64;56
Pagėgiai mun.;2013;14;160;90;70
Pagėgiai mun.;2013;15;135;69;66
Pagėgiai mun.;2013;16;116;56;60
Pagėgiai mun.;2013;17;139;68;71
Pagėgiai mun.;2013;18;157;88;69
Pagėgiai mun.;2013;19;154;81;73
Pagėgiai mun.;2013;20;176;88;88
Pagėgiai mun.;2013;21;167;71;96
Pagėgiai mun.;2013;22;151;87;64
Pagėgiai mun.;2013;23;120;77;43
Pagėgiai mun.;2013;24;120;67;53
Pagėgiai mun.;2013;25;125;70;55
Pagėgiai mun.;2013;26;115;60;55
Pagėgiai mun.;2013;27;107;55;52
Pagėgiai mun.;2013;28;107;56;51
Pagėgiai mun.;2013;29;75;43;32
Pagėgiai mun.;2013;30;67;28;39
Pagėgiai mun.;2013;31;74;43;31
Pagėgiai mun.;2013;32;98;53;45
Pagėgiai mun.;2013;33;88;46;42
Pagėgiai mun.;2013;34;97;50;47
Pagėgiai mun.;2013;35;111;67;44
Pagėgiai mun.;2013;36;86;37;49
Pagėgiai mun.;2013;37;85;41;44
Pagėgiai mun.;2013;38;99;58;41
Pagėgiai mun.;2013;39;105;56;49
Pagėgiai mun.;2013;40;118;54;64
Pagėgiai mun.;2013;41;167;88;79
Pagėgiai mun.;2013;42;131;66;65
Pagėgiai mun.;2013;43;135;72;63
Pagėgiai mun.;2013;44;127;67;60
Pagėgiai mun.;2013;45;143;69;74
Pagėgiai mun.;2013;46;113;54;59
Pagėgiai mun.;2013;47;131;66;65
Pagėgiai mun.;2013;48;126;56;70
Pagėgiai mun.;2013;49;129;62;67
Pagėgiai mun.;2013;50;155;76;79
Pagėgiai mun.;2013;51;157;86;71
Pagėgiai mun.;2013;52;162;88;74
Pagėgiai mun.;2013;53;129;59;70
Pagėgiai mun.;2013;54;161;82;79
Pagėgiai mun.;2013;55;121;59;62
Pagėgiai mun.;2013;56;148;68;80
Pagėgiai mun.;2013;57;104;52;52
Pagėgiai mun.;2013;58;119;59;60
Pagėgiai mun.;2013;59;102;51;51
Pagėgiai mun.;2013;60;98;48;50
Pagėgiai mun.;2013;61;99;47;52
Pagėgiai mun.;2013;62;94;49;45
Pagėgiai mun.;2013;63;109;53;56
Pagėgiai mun.;2013;64;105;38;67
Pagėgiai mun.;2013;65;69;30;39
Pagėgiai mun.;2013;66;88;38;50
Pagėgiai mun.;2013;67;69;26;43
Pagėgiai mun.;2013;68;73;18;55
Pagėgiai mun.;2013;69;65;26;39
Pagėgiai mun.;2013;70;84;24;60
Pagėgiai mun.;2013;71;104;33;71
Pagėgiai mun.;2013;72;78;26;52
Pagėgiai mun.;2013;73;77;23;54
Pagėgiai mun.;2013;74;78;22;56
Pagėgiai mun.;2013;75;72;20;52
Pagėgiai mun.;2013;76;87;33;54
Pagėgiai mun.;2013;77;90;28;62
Pagėgiai mun.;2013;78;66;21;45
Pagėgiai mun.;2013;79;63;13;50
Pagėgiai mun.;2013;80;86;17;69
Pagėgiai mun.;2013;81;65;22;43
Pagėgiai mun.;2013;82;46;12;34
Pagėgiai mun.;2013;83;38;7;31
Pagėgiai mun.;2013;84;31;8;23
Pagėgiai mun.;2013;85;144;35;109
Pagėgiai mun.;2014;-1;8928;4227;4701
Pagėgiai mun.;2014;0;110;50;60
Pagėgiai mun.;2014;1;130;73;57
Pagėgiai mun.;2014;2;96;43;53
Pagėgiai mun.;2014;3;73;32;41
Pagėgiai mun.;2014;4;82;42;40
Pagėgiai mun.;2014;5;87;42;45
Pagėgiai mun.;2014;6;65;36;29
Pagėgiai mun.;2014;7;69;35;34
Pagėgiai mun.;2014;8;86;43;43
Pagėgiai mun.;2014;9;75;34;41
Pagėgiai mun.;2014;10;81;44;37
Pagėgiai mun.;2014;11;93;51;42
Pagėgiai mun.;2014;12;100;44;56
Pagėgiai mun.;2014;13;140;62;78
Pagėgiai mun.;2014;14;117;62;55
Pagėgiai mun.;2014;15;158;89;69
Pagėgiai mun.;2014;16;130;67;63
Pagėgiai mun.;2014;17;115;55;60
Pagėgiai mun.;2014;18;136;68;68
Pagėgiai mun.;2014;19;157;88;69
Pagėgiai mun.;2014;20;155;81;74
Pagėgiai mun.;2014;21;172;88;84
Pagėgiai mun.;2014;22;156;66;90
Pagėgiai mun.;2014;23;147;86;61
Pagėgiai mun.;2014;24;119;76;43
Pagėgiai mun.;2014;25;117;65;52
Pagėgiai mun.;2014;26;124;69;55
Pagėgiai mun.;2014;27;106;54;52
Pagėgiai mun.;2014;28;99;54;45
Pagėgiai mun.;2014;29;101;54;47
Pagėgiai mun.;2014;30;67;36;31
Pagėgiai mun.;2014;31;67;30;37
Pagėgiai mun.;2014;32;68;40;28
Pagėgiai mun.;2014;33;92;55;37
Pagėgiai mun.;2014;34;87;47;40
Pagėgiai mun.;2014;35;91;44;47
Pagėgiai mun.;2014;36;111;66;45
Pagėgiai mun.;2014;37;83;33;50
Pagėgiai mun.;2014;38;83;39;44
Pagėgiai mun.;2014;39;98;59;39
Pagėgiai mun.;2014;40;104;56;48
Pagėgiai mun.;2014;41;117;57;60
Pagėgiai mun.;2014;42;165;87;78
Pagėgiai mun.;2014;43;133;66;67
Pagėgiai mun.;2014;44;131;69;62
Pagėgiai mun.;2014;45;127;68;59
Pagėgiai mun.;2014;46;142;70;72
Pagėgiai mun.;2014;47;117;57;60
Pagėgiai mun.;2014;48;128;64;64
Pagėgiai mun.;2014;49;120;53;67
Pagėgiai mun.;2014;50;124;60;64
Pagėgiai mun.;2014;51;152;74;78
Pagėgiai mun.;2014;52;154;84;70
Pagėgiai mun.;2014;53;163;88;75
Pagėgiai mun.;2014;54;125;58;67
Pagėgiai mun.;2014;55;154;76;78
Pagėgiai mun.;2014;56;115;56;59
Pagėgiai mun.;2014;57;141;63;78
Pagėgiai mun.;2014;58;100;49;51
Pagėgiai mun.;2014;59;117;56;61
Pagėgiai mun.;2014;60;103;51;52
Pagėgiai mun.;2014;61;96;47;49
Pagėgiai mun.;2014;62;99;47;52
Pagėgiai mun.;2014;63;92;48;44
Pagėgiai mun.;2014;64;104;50;54
Pagėgiai mun.;2014;65;100;37;63
Pagėgiai mun.;2014;66;68;30;38
Pagėgiai mun.;2014;67;84;36;48
Pagėgiai mun.;2014;68;60;17;43
Pagėgiai mun.;2014;69;71;17;54
Pagėgiai mun.;2014;70;65;26;39
Pagėgiai mun.;2014;71;81;22;59
Pagėgiai mun.;2014;72;98;30;68
Pagėgiai mun.;2014;73;78;26;52
Pagėgiai mun.;2014;74;76;23;53
Pagėgiai mun.;2014;75;77;22;55
Pagėgiai mun.;2014;76;67;16;51
Pagėgiai mun.;2014;77;82;31;51
Pagėgiai mun.;2014;78;81;24;57
Pagėgiai mun.;2014;79;57;19;38
Pagėgiai mun.;2014;80;59;11;48
Pagėgiai mun.;2014;81;80;15;65
Pagėgiai mun.;2014;82;58;19;39
Pagėgiai mun.;2014;83;39;10;29
Pagėgiai mun.;2014;84;33;7;26
Pagėgiai mun.;2014;85;148;33;115
Pagėgiai mun.;2015;-1;8711;4140;4571
Pagėgiai mun.;2015;0;94;46;48
Pagėgiai mun.;2015;1;110;50;60
Pagėgiai mun.;2015;2;117;66;51
Pagėgiai mun.;2015;3;92;40;52
Pagėgiai mun.;2015;4;65;27;38
Pagėgiai mun.;2015;5;83;43;40
Pagėgiai mun.;2015;6;79;37;42
Pagėgiai mun.;2015;7;62;36;26
Pagėgiai mun.;2015;8;64;34;30
Pagėgiai mun.;2015;9;83;43;40
Pagėgiai mun.;2015;10;70;30;40
Pagėgiai mun.;2015;11;78;42;36
Pagėgiai mun.;2015;12;91;50;41
Pagėgiai mun.;2015;13;96;42;54
Pagėgiai mun.;2015;14;142;64;78
Pagėgiai mun.;2015;15;114;62;52
Pagėgiai mun.;2015;16;158;90;68
Pagėgiai mun.;2015;17;128;66;62
Pagėgiai mun.;2015;18;114;54;60
Pagėgiai mun.;2015;19;133;67;66
Pagėgiai mun.;2015;20;153;87;66
Pagėgiai mun.;2015;21;154;82;72
Pagėgiai mun.;2015;22;168;86;82
Pagėgiai mun.;2015;23;149;67;82
Pagėgiai mun.;2015;24;141;84;57
Pagėgiai mun.;2015;25;113;76;37
Pagėgiai mun.;2015;26;115;64;51
Pagėgiai mun.;2015;27;115;68;47
Pagėgiai mun.;2015;28;98;53;45
Pagėgiai mun.;2015;29;91;48;43
Pagėgiai mun.;2015;30;90;51;39
Pagėgiai mun.;2015;31;60;33;27
Pagėgiai mun.;2015;32;65;32;33
Pagėgiai mun.;2015;33;61;37;24
Pagėgiai mun.;2015;34;92;54;38
Pagėgiai mun.;2015;35;81;44;37
Pagėgiai mun.;2015;36;87;46;41
Pagėgiai mun.;2015;37;109;65;44
Pagėgiai mun.;2015;38;82;33;49
Pagėgiai mun.;2015;39;84;40;44
Pagėgiai mun.;2015;40;96;58;38
Pagėgiai mun.;2015;41;103;56;47
Pagėgiai mun.;2015;42;110;53;57
Pagėgiai mun.;2015;43;162;84;78
Pagėgiai mun.;2015;44;129;63;66
Pagėgiai mun.;2015;45;129;67;62
Pagėgiai mun.;2015;46;123;65;58
Pagėgiai mun.;2015;47;139;66;73
Pagėgiai mun.;2015;48;116;57;59
Pagėgiai mun.;2015;49;134;70;64
Pagėgiai mun.;2015;50;119;53;66
Pagėgiai mun.;2015;51;123;58;65
Pagėgiai mun.;2015;52;154;73;81
Pagėgiai mun.;2015;53;147;79;68
Pagėgiai mun.;2015;54;162;89;73
Pagėgiai mun.;2015;55;128;60;68
Pagėgiai mun.;2015;56;153;74;79
Pagėgiai mun.;2015;57;115;55;60
Pagėgiai mun.;2015;58;139;59;80
Pagėgiai mun.;2015;59;97;48;49
Pagėgiai mun.;2015;60;115;55;60
Pagėgiai mun.;2015;61;102;50;52
Pagėgiai mun.;2015;62;94;44;50
Pagėgiai mun.;2015;63;95;44;51
Pagėgiai mun.;2015;64;87;44;43
Pagėgiai mun.;2015;65;99;48;51
Pagėgiai mun.;2015;66;97;35;62
Pagėgiai mun.;2015;67;67;30;37
Pagėgiai mun.;2015;68;84;35;49
Pagėgiai mun.;2015;69;57;16;41
Pagėgiai mun.;2015;70;69;16;53
Pagėgiai mun.;2015;71;60;24;36
Pagėgiai mun.;2015;72;79;21;58
Pagėgiai mun.;2015;73;94;28;66
Pagėgiai mun.;2015;74;77;26;51
Pagėgiai mun.;2015;75;73;22;51
Pagėgiai mun.;2015;76;72;20;52
Pagėgiai mun.;2015;77;59;11;48
Pagėgiai mun.;2015;78;72;25;47
Pagėgiai mun.;2015;79;73;21;52
Pagėgiai mun.;2015;80;54;19;35
Pagėgiai mun.;2015;81;54;10;44
Pagėgiai mun.;2015;82;74;13;61
Pagėgiai mun.;2015;83;52;17;35
Pagėgiai mun.;2015;84;35;9;26
Pagėgiai mun.;2015;85;158;31;127
Pagėgiai mun.;2016;-1;8414;3977;4437
Pagėgiai mun.;2016;0;106;53;53
Pagėgiai mun.;2016;1;96;46;50
Pagėgiai mun.;2016;2;106;47;59
Pagėgiai mun.;2016;3;108;59;49
Pagėgiai mun.;2016;4;87;37;50
Pagėgiai mun.;2016;5;63;28;35
Pagėgiai mun.;2016;6;78;40;38
Pagėgiai mun.;2016;7;76;35;41
Pagėgiai mun.;2016;8;60;36;24
Pagėgiai mun.;2016;9;66;34;32
Pagėgiai mun.;2016;10;81;41;40
Pagėgiai mun.;2016;11;66;25;41
Pagėgiai mun.;2016;12;75;41;34
Pagėgiai mun.;2016;13;86;47;39
Pagėgiai mun.;2016;14;96;43;53
Pagėgiai mun.;2016;15;138;62;76
Pagėgiai mun.;2016;16;110;60;50
Pagėgiai mun.;2016;17;152;86;66
Pagėgiai mun.;2016;18;127;67;60
Pagėgiai mun.;2016;19;112;52;60
Pagėgiai mun.;2016;20;127;66;61
Pagėgiai mun.;2016;21;146;81;65
Pagėgiai mun.;2016;22;143;75;68
Pagėgiai mun.;2016;23;156;80;76
Pagėgiai mun.;2016;24;135;57;78
Pagėgiai mun.;2016;25;133;80;53
Pagėgiai mun.;2016;26;103;73;30
Pagėgiai mun.;2016;27;110;61;49
Pagėgiai mun.;2016;28;106;65;41
Pagėgiai mun.;2016;29;86;46;40
Pagėgiai mun.;2016;30;79;39;40
Pagėgiai mun.;2016;31;83;46;37
Pagėgiai mun.;2016;32;53;29;24
Pagėgiai mun.;2016;33;62;31;31
Pagėgiai mun.;2016;34;54;33;21
Pagėgiai mun.;2016;35;81;48;33
Pagėgiai mun.;2016;36;73;38;35
Pagėgiai mun.;2016;37;86;44;42
Pagėgiai mun.;2016;38;105;66;39
Pagėgiai mun.;2016;39;77;28;49
Pagėgiai mun.;2016;40;83;40;43
Pagėgiai mun.;2016;41;90;53;37
Pagėgiai mun.;2016;42;102;55;47
Pagėgiai mun.;2016;43;107;53;54
Pagėgiai mun.;2016;44;153;82;71
Pagėgiai mun.;2016;45;126;60;66
Pagėgiai mun.;2016;46;128;64;64
Pagėgiai mun.;2016;47;125;67;58
Pagėgiai mun.;2016;48;138;65;73
Pagėgiai mun.;2016;49;113;54;59
Pagėgiai mun.;2016;50;129;67;62
Pagėgiai mun.;2016;51;117;53;64
Pagėgiai mun.;2016;52;118;54;64
Pagėgiai mun.;2016;53;146;69;77
Pagėgiai mun.;2016;54;147;81;66
Pagėgiai mun.;2016;55;157;85;72
Pagėgiai mun.;2016;56;126;58;68
Pagėgiai mun.;2016;57;152;73;79
Pagėgiai mun.;2016;58;114;54;60
Pagėgiai mun.;2016;59;139;62;77
Pagėgiai mun.;2016;60;93;45;48
Pagėgiai mun.;2016;61;110;52;58
Pagėgiai mun.;2016;62;99;48;51
Pagėgiai mun.;2016;63;88;40;48
Pagėgiai mun.;2016;64;89;39;50
Pagėgiai mun.;2016;65;86;43;43
Pagėgiai mun.;2016;66;94;43;51
Pagėgiai mun.;2016;67;89;30;59
Pagėgiai mun.;2016;68;65;28;37
Pagėgiai mun.;2016;69;82;34;48
Pagėgiai mun.;2016;70;55;16;39
Pagėgiai mun.;2016;71;67;14;53
Pagėgiai mun.;2016;72;59;24;35
Pagėgiai mun.;2016;73;76;20;56
Pagėgiai mun.;2016;74;88;25;63
Pagėgiai mun.;2016;75;74;25;49
Pagėgiai mun.;2016;76;71;20;51
Pagėgiai mun.;2016;77;69;18;51
Pagėgiai mun.;2016;78;55;8;47
Pagėgiai mun.;2016;79;67;23;44
Pagėgiai mun.;2016;80;68;21;47
Pagėgiai mun.;2016;81;47;15;32
Pagėgiai mun.;2016;82;50;8;42
Pagėgiai mun.;2016;83;70;13;57
Pagėgiai mun.;2016;84;44;16;28
Pagėgiai mun.;2016;85;162;35;127
Pagėgiai mun.;2017;-1;8094;3817;4277
Pagėgiai mun.;2017;0;102;47;55
Pagėgiai mun.;2017;1;103;50;53
Pagėgiai mun.;2017;2;96;47;49
Pagėgiai mun.;2017;3;96;43;53
Pagėgiai mun.;2017;4;105;56;49
Pagėgiai mun.;2017;5;85;33;52
Pagėgiai mun.;2017;6;58;26;32
Pagėgiai mun.;2017;7;74;38;36
Pagėgiai mun.;2017;8;74;36;38
Pagėgiai mun.;2017;9;58;36;22
Pagėgiai mun.;2017;10;66;32;34
Pagėgiai mun.;2017;11;83;41;42
Pagėgiai mun.;2017;12;66;25;41
Pagėgiai mun.;2017;13;75;41;34
Pagėgiai mun.;2017;14;85;48;37
Pagėgiai mun.;2017;15;95;43;52
Pagėgiai mun.;2017;16;136;61;75
Pagėgiai mun.;2017;17;106;56;50
Pagėgiai mun.;2017;18;144;83;61
Pagėgiai mun.;2017;19;120;66;54
Pagėgiai mun.;2017;20;101;47;54
Pagėgiai mun.;2017;21;122;63;59
Pagėgiai mun.;2017;22;136;76;60
Pagėgiai mun.;2017;23;128;69;59
Pagėgiai mun.;2017;24;150;79;71
Pagėgiai mun.;2017;25;132;54;78
Pagėgiai mun.;2017;26;125;76;49
Pagėgiai mun.;2017;27;97;68;29
Pagėgiai mun.;2017;28;96;58;38
Pagėgiai mun.;2017;29;100;63;37
Pagėgiai mun.;2017;30;80;42;38
Pagėgiai mun.;2017;31;67;33;34
Pagėgiai mun.;2017;32;76;40;36
Pagėgiai mun.;2017;33;50;27;23
Pagėgiai mun.;2017;34;50;24;26
Pagėgiai mun.;2017;35;45;27;18
Pagėgiai mun.;2017;36;74;44;30
Pagėgiai mun.;2017;37;69;34;35
Pagėgiai mun.;2017;38;78;38;40
Pagėgiai mun.;2017;39;103;63;40
Pagėgiai mun.;2017;40;75;29;46
Pagėgiai mun.;2017;41;73;34;39
Pagėgiai mun.;2017;42;88;55;33
Pagėgiai mun.;2017;43;101;53;48
Pagėgiai mun.;2017;44;102;46;56
Pagėgiai mun.;2017;45;151;83;68
Pagėgiai mun.;2017;46;119;58;61
Pagėgiai mun.;2017;47;128;63;65
Pagėgiai mun.;2017;48;123;67;56
Pagėgiai mun.;2017;49;139;65;74
Pagėgiai mun.;2017;50;113;52;61
Pagėgiai mun.;2017;51;124;65;59
Pagėgiai mun.;2017;52;114;51;63
Pagėgiai mun.;2017;53;115;53;62
Pagėgiai mun.;2017;54;143;67;76
Pagėgiai mun.;2017;55;143;80;63
Pagėgiai mun.;2017;56;151;80;71
Pagėgiai mun.;2017;57;124;56;68
Pagėgiai mun.;2017;58;147;69;78
Pagėgiai mun.;2017;59;113;53;60
Pagėgiai mun.;2017;60;136;61;75
Pagėgiai mun.;2017;61;88;42;46
Pagėgiai mun.;2017;62;107;48;59
Pagėgiai mun.;2017;63;95;46;49
Pagėgiai mun.;2017;64;84;39;45
Pagėgiai mun.;2017;65;86;37;49
Pagėgiai mun.;2017;66;78;39;39
Pagėgiai mun.;2017;67;88;40;48
Pagėgiai mun.;2017;68;84;28;56
Pagėgiai mun.;2017;69;64;26;38
Pagėgiai mun.;2017;70;81;34;47
Pagėgiai mun.;2017;71;48;13;35
Pagėgiai mun.;2017;72;64;12;52
Pagėgiai mun.;2017;73;54;22;32
Pagėgiai mun.;2017;74;72;20;52
Pagėgiai mun.;2017;75;81;22;59
Pagėgiai mun.;2017;76;69;21;48
Pagėgiai mun.;2017;77;66;18;48
Pagėgiai mun.;2017;78;65;17;48
Pagėgiai mun.;2017;79;48;6;42
Pagėgiai mun.;2017;80;65;22;43
Pagėgiai mun.;2017;81;61;19;42
Pagėgiai mun.;2017;82;42;14;28
Pagėgiai mun.;2017;83;43;7;36
Pagėgiai mun.;2017;84;64;10;54
Pagėgiai mun.;2017;85;169;42;127
Pagėgiai mun.;2018;-1;7793;3671;4122
Pagėgiai mun.;2018;0;79;37;42
Pagėgiai mun.;2018;1;101;48;53
Pagėgiai mun.;2018;2;101;48;53
Pagėgiai mun.;2018;3;93;47;46
Pagėgiai mun.;2018;4;92;43;49
Pagėgiai mun.;2018;5;103;54;49
Pagėgiai mun.;2018;6;82;32;50
Pagėgiai mun.;2018;7;56;25;31
Pagėgiai mun.;2018;8;71;37;34
Pagėgiai mun.;2018;9;70;32;38
Pagėgiai mun.;2018;10;53;34;19
Pagėgiai mun.;2018;11;63;32;31
Pagėgiai mun.;2018;12;82;42;40
Pagėgiai mun.;2018;13;64;23;41
Pagėgiai mun.;2018;14;72;39;33
Pagėgiai mun.;2018;15;82;46;36
Pagėgiai mun.;2018;16;91;42;49
Pagėgiai mun.;2018;17;135;62;73
Pagėgiai mun.;2018;18;103;55;48
Pagėgiai mun.;2018;19;140;78;62
Pagėgiai mun.;2018;20;111;64;47
Pagėgiai mun.;2018;21;93;44;49
Pagėgiai mun.;2018;22;117;60;57
Pagėgiai mun.;2018;23;132;73;59
Pagėgiai mun.;2018;24;121;64;57
Pagėgiai mun.;2018;25;137;73;64
Pagėgiai mun.;2018;26;117;44;73
Pagėgiai mun.;2018;27;113;69;44
Pagėgiai mun.;2018;28;87;63;24
Pagėgiai mun.;2018;29;85;52;33
Pagėgiai mun.;2018;30;84;54;30
Pagėgiai mun.;2018;31;69;40;29
Pagėgiai mun.;2018;32;56;27;29
Pagėgiai mun.;2018;33;71;37;34
Pagėgiai mun.;2018;34;36;18;18
Pagėgiai mun.;2018;35;47;21;26
Pagėgiai mun.;2018;36;46;31;15
Pagėgiai mun.;2018;37;63;38;25
Pagėgiai mun.;2018;38;66;31;35
Pagėgiai mun.;2018;39;78;38;40
Pagėgiai mun.;2018;40;95;57;38
Pagėgiai mun.;2018;41;75;29;46
Pagėgiai mun.;2018;42;72;34;38
Pagėgiai mun.;2018;43;86;54;32
Pagėgiai mun.;2018;44;97;51;46
Pagėgiai mun.;2018;45;96;44;52
Pagėgiai mun.;2018;46;152;85;67
Pagėgiai mun.;2018;47;120;58;62
Pagėgiai mun.;2018;48;125;59;66
Pagėgiai mun.;2018;49;121;65;56
Pagėgiai mun.;2018;50;138;65;73
Pagėgiai mun.;2018;51;113;53;60
Pagėgiai mun.;2018;52;122;63;59
Pagėgiai mun.;2018;53;112;50;62
Pagėgiai mun.;2018;54;112;51;61
Pagėgiai mun.;2018;55;141;66;75
Pagėgiai mun.;2018;56;141;78;63
Pagėgiai mun.;2018;57;151;80;71
Pagėgiai mun.;2018;58;127;56;71
Pagėgiai mun.;2018;59;147;69;78
Pagėgiai mun.;2018;60;113;53;60
Pagėgiai mun.;2018;61;133;59;74
Pagėgiai mun.;2018;62;84;39;45
Pagėgiai mun.;2018;63;102;44;58
Pagėgiai mun.;2018;64;92;45;47
Pagėgiai mun.;2018;65;82;39;43
Pagėgiai mun.;2018;66;84;36;48
Pagėgiai mun.;2018;67;77;38;39
Pagėgiai mun.;2018;68;85;39;46
Pagėgiai mun.;2018;69;78;24;54
Pagėgiai mun.;2018;70;59;21;38
Pagėgiai mun.;2018;71;75;29;46
Pagėgiai mun.;2018;72;45;10;35
Pagėgiai mun.;2018;73;62;11;51
Pagėgiai mun.;2018;74;54;22;32
Pagėgiai mun.;2018;75;69;20;49
Pagėgiai mun.;2018;76;73;20;53
Pagėgiai mun.;2018;77;63;16;47
Pagėgiai mun.;2018;78;63;18;45
Pagėgiai mun.;2018;79;63;17;46
Pagėgiai mun.;2018;80;43;5;38
Pagėgiai mun.;2018;81;59;22;37
Pagėgiai mun.;2018;82;58;18;40
Pagėgiai mun.;2018;83;38;12;26
Pagėgiai mun.;2018;84;37;7;30
Pagėgiai mun.;2018;85;197;43;154
Pakruojis d. mun.;2001;-1;29528;14073;15455
Pakruojis d. mun.;2001;0;317;166;151
Pakruojis d. mun.;2001;1;356;191;165
Pakruojis d. mun.;2001;2;337;164;173
Pakruojis d. mun.;2001;3;330;166;164
Pakruojis d. mun.;2001;4;371;195;176
Pakruojis d. mun.;2001;5;377;187;190
Pakruojis d. mun.;2001;6;410;205;205
Pakruojis d. mun.;2001;7;436;233;203
Pakruojis d. mun.;2001;8;487;242;245
Pakruojis d. mun.;2001;9;486;264;222
Pakruojis d. mun.;2001;10;472;226;246
Pakruojis d. mun.;2001;11;478;233;245
Pakruojis d. mun.;2001;12;476;228;248
Pakruojis d. mun.;2001;13;503;247;256
Pakruojis d. mun.;2001;14;532;272;260
Pakruojis d. mun.;2001;15;513;247;266
Pakruojis d. mun.;2001;16;472;244;228
Pakruojis d. mun.;2001;17;452;227;225
Pakruojis d. mun.;2001;18;401;207;194
Pakruojis d. mun.;2001;19;335;182;153
Pakruojis d. mun.;2001;20;313;167;146
Pakruojis d. mun.;2001;21;287;161;126
Pakruojis d. mun.;2001;22;321;179;142
Pakruojis d. mun.;2001;23;316;154;162
Pakruojis d. mun.;2001;24;335;180;155
Pakruojis d. mun.;2001;25;403;221;182
Pakruojis d. mun.;2001;26;335;173;162
Pakruojis d. mun.;2001;27;351;187;164
Pakruojis d. mun.;2001;28;399;201;198
Pakruojis d. mun.;2001;29;405;204;201
Pakruojis d. mun.;2001;30;440;217;223
Pakruojis d. mun.;2001;31;415;208;207
Pakruojis d. mun.;2001;32;410;220;190
Pakruojis d. mun.;2001;33;421;226;195
Pakruojis d. mun.;2001;34;393;189;204
Pakruojis d. mun.;2001;35;406;219;187
Pakruojis d. mun.;2001;36;437;226;211
Pakruojis d. mun.;2001;37;424;214;210
Pakruojis d. mun.;2001;38;391;197;194
Pakruojis d. mun.;2001;39;418;217;201
Pakruojis d. mun.;2001;40;434;212;222
Pakruojis d. mun.;2001;41;411;206;205
Pakruojis d. mun.;2001;42;422;227;195
Pakruojis d. mun.;2001;43;409;223;186
Pakruojis d. mun.;2001;44;372;185;187
Pakruojis d. mun.;2001;45;355;184;171
Pakruojis d. mun.;2001;46;351;165;186
Pakruojis d. mun.;2001;47;334;164;170
Pakruojis d. mun.;2001;48;349;181;168
Pakruojis d. mun.;2001;49;357;175;182
Pakruojis d. mun.;2001;50;353;176;177
Pakruojis d. mun.;2001;51;355;168;187
Pakruojis d. mun.;2001;52;332;169;163
Pakruojis d. mun.;2001;53;294;148;146
Pakruojis d. mun.;2001;54;277;147;130
Pakruojis d. mun.;2001;55;331;150;181
Pakruojis d. mun.;2001;56;316;152;164
Pakruojis d. mun.;2001;57;335;158;177
Pakruojis d. mun.;2001;58;408;178;230
Pakruojis d. mun.;2001;59;403;189;214
Pakruojis d. mun.;2001;60;341;154;187
Pakruojis d. mun.;2001;61;315;141;174
Pakruojis d. mun.;2001;62;330;139;191
Pakruojis d. mun.;2001;63;328;141;187
Pakruojis d. mun.;2001;64;308;129;179
Pakruojis d. mun.;2001;65;292;121;171
Pakruojis d. mun.;2001;66;301;123;178
Pakruojis d. mun.;2001;67;326;133;193
Pakruojis d. mun.;2001;68;336;135;201
Pakruojis d. mun.;2001;69;277;115;162
Pakruojis d. mun.;2001;70;285;97;188
Pakruojis d. mun.;2001;71;254;83;171
Pakruojis d. mun.;2001;72;280;98;182
Pakruojis d. mun.;2001;73;258;102;156
Pakruojis d. mun.;2001;74;245;82;163
Pakruojis d. mun.;2001;75;214;59;155
Pakruojis d. mun.;2001;76;187;44;143
Pakruojis d. mun.;2001;77;195;54;141
Pakruojis d. mun.;2001;78;157;39;118
Pakruojis d. mun.;2001;79;148;38;110
Pakruojis d. mun.;2001;80;145;34;111
Pakruojis d. mun.;2001;81;92;31;61
Pakruojis d. mun.;2001;82;58;18;40
Pakruojis d. mun.;2001;83;69;20;49
Pakruojis d. mun.;2001;84;62;14;48
Pakruojis d. mun.;2001;85;366;86;280
Pakruojis d. mun.;2002;-1;29157;13855;15302
Pakruojis d. mun.;2002;0;274;133;141
Pakruojis d. mun.;2002;1;313;164;149
Pakruojis d. mun.;2002;2;345;185;160
Pakruojis d. mun.;2002;3;334;163;171
Pakruojis d. mun.;2002;4;328;164;164
Pakruojis d. mun.;2002;5;365;190;175
Pakruojis d. mun.;2002;6;377;185;192
Pakruojis d. mun.;2002;7;408;203;205
Pakruojis d. mun.;2002;8;431;230;201
Pakruojis d. mun.;2002;9;483;240;243
Pakruojis d. mun.;2002;10;482;262;220
Pakruojis d. mun.;2002;11;469;223;246
Pakruojis d. mun.;2002;12;469;227;242
Pakruojis d. mun.;2002;13;465;222;243
Pakruojis d. mun.;2002;14;496;244;252
Pakruojis d. mun.;2002;15;526;268;258
Pakruojis d. mun.;2002;16;512;246;266
Pakruojis d. mun.;2002;17;465;238;227
Pakruojis d. mun.;2002;18;447;223;224
Pakruojis d. mun.;2002;19;387;198;189
Pakruojis d. mun.;2002;20;325;177;148
Pakruojis d. mun.;2002;21;305;165;140
Pakruojis d. mun.;2002;22;281;158;123
Pakruojis d. mun.;2002;23;327;179;148
Pakruojis d. mun.;2002;24;307;149;158
Pakruojis d. mun.;2002;25;329;179;150
Pakruojis d. mun.;2002;26;394;218;176
Pakruojis d. mun.;2002;27;324;166;158
Pakruojis d. mun.;2002;28;345;182;163
Pakruojis d. mun.;2002;29;383;195;188
Pakruojis d. mun.;2002;30;399;201;198
Pakruojis d. mun.;2002;31;426;213;213
Pakruojis d. mun.;2002;32;408;203;205
Pakruojis d. mun.;2002;33;403;216;187
Pakruojis d. mun.;2002;34;412;219;193
Pakruojis d. mun.;2002;35;389;187;202
Pakruojis d. mun.;2002;36;401;215;186
Pakruojis d. mun.;2002;37;429;220;209
Pakruojis d. mun.;2002;38;414;207;207
Pakruojis d. mun.;2002;39;386;193;193
Pakruojis d. mun.;2002;40;414;213;201
Pakruojis d. mun.;2002;41;428;209;219
Pakruojis d. mun.;2002;42;403;200;203
Pakruojis d. mun.;2002;43;426;227;199
Pakruojis d. mun.;2002;44;407;223;184
Pakruojis d. mun.;2002;45;365;181;184
Pakruojis d. mun.;2002;46;353;182;171
Pakruojis d. mun.;2002;47;348;162;186
Pakruojis d. mun.;2002;48;328;160;168
Pakruojis d. mun.;2002;49;343;178;165
Pakruojis d. mun.;2002;50;355;173;182
Pakruojis d. mun.;2002;51;345;170;175
Pakruojis d. mun.;2002;52;348;163;185
Pakruojis d. mun.;2002;53;328;167;161
Pakruojis d. mun.;2002;54;289;144;145
Pakruojis d. mun.;2002;55;269;141;128
Pakruojis d. mun.;2002;56;321;146;175
Pakruojis d. mun.;2002;57;311;148;163
Pakruojis d. mun.;2002;58;327;154;173
Pakruojis d. mun.;2002;59;399;172;227
Pakruojis d. mun.;2002;60;396;182;214
Pakruojis d. mun.;2002;61;332;148;184
Pakruojis d. mun.;2002;62;311;136;175
Pakruojis d. mun.;2002;63;330;136;194
Pakruojis d. mun.;2002;64;321;136;185
Pakruojis d. mun.;2002;65;304;127;177
Pakruojis d. mun.;2002;66;287;121;166
Pakruojis d. mun.;2002;67;295;122;173
Pakruojis d. mun.;2002;68;316;129;187
Pakruojis d. mun.;2002;69;333;133;200
Pakruojis d. mun.;2002;70;265;108;157
Pakruojis d. mun.;2002;71;272;93;179
Pakruojis d. mun.;2002;72;246;80;166
Pakruojis d. mun.;2002;73;271;93;178
Pakruojis d. mun.;2002;74;243;96;147
Pakruojis d. mun.;2002;75;237;78;159
Pakruojis d. mun.;2002;76;206;55;151
Pakruojis d. mun.;2002;77;178;41;137
Pakruojis d. mun.;2002;78;188;52;136
Pakruojis d. mun.;2002;79;143;31;112
Pakruojis d. mun.;2002;80;135;33;102
Pakruojis d. mun.;2002;81;137;31;106
Pakruojis d. mun.;2002;82;81;26;55
Pakruojis d. mun.;2002;83;55;18;37
Pakruojis d. mun.;2002;84;64;18;46
Pakruojis d. mun.;2002;85;341;69;272
Pakruojis d. mun.;2003;-1;28926;13747;15179
Pakruojis d. mun.;2003;0;276;150;126
Pakruojis d. mun.;2003;1;272;135;137
Pakruojis d. mun.;2003;2;316;163;153
Pakruojis d. mun.;2003;3;346;185;161
Pakruojis d. mun.;2003;4;337;165;172
Pakruojis d. mun.;2003;5;328;166;162
Pakruojis d. mun.;2003;6;365;190;175
Pakruojis d. mun.;2003;7;378;184;194
Pakruojis d. mun.;2003;8;405;203;202
Pakruojis d. mun.;2003;9;437;231;206
Pakruojis d. mun.;2003;10;480;240;240
Pakruojis d. mun.;2003;11;480;262;218
Pakruojis d. mun.;2003;12;465;221;244
Pakruojis d. mun.;2003;13;466;223;243
Pakruojis d. mun.;2003;14;464;221;243
Pakruojis d. mun.;2003;15;486;239;247
Pakruojis d. mun.;2003;16;516;263;253
Pakruojis d. mun.;2003;17;503;239;264
Pakruojis d. mun.;2003;18;458;234;224
Pakruojis d. mun.;2003;19;444;223;221
Pakruojis d. mun.;2003;20;377;196;181
Pakruojis d. mun.;2003;21;320;177;143
Pakruojis d. mun.;2003;22;308;166;142
Pakruojis d. mun.;2003;23;286;163;123
Pakruojis d. mun.;2003;24;330;179;151
Pakruojis d. mun.;2003;25;307;149;158
Pakruojis d. mun.;2003;26;320;176;144
Pakruojis d. mun.;2003;27;380;213;167
Pakruojis d. mun.;2003;28;322;162;160
Pakruojis d. mun.;2003;29;341;181;160
Pakruojis d. mun.;2003;30;378;194;184
Pakruojis d. mun.;2003;31;391;196;195
Pakruojis d. mun.;2003;32;423;210;213
Pakruojis d. mun.;2003;33;402;198;204
Pakruojis d. mun.;2003;34;399;215;184
Pakruojis d. mun.;2003;35;409;219;190
Pakruojis d. mun.;2003;36;387;189;198
Pakruojis d. mun.;2003;37;396;212;184
Pakruojis d. mun.;2003;38;422;217;205
Pakruojis d. mun.;2003;39;412;207;205
Pakruojis d. mun.;2003;40;380;192;188
Pakruojis d. mun.;2003;41;407;208;199
Pakruojis d. mun.;2003;42;428;208;220
Pakruojis d. mun.;2003;43;397;198;199
Pakruojis d. mun.;2003;44;423;224;199
Pakruojis d. mun.;2003;45;405;221;184
Pakruojis d. mun.;2003;46;364;179;185
Pakruojis d. mun.;2003;47;348;180;168
Pakruojis d. mun.;2003;48;341;158;183
Pakruojis d. mun.;2003;49;322;156;166
Pakruojis d. mun.;2003;50;337;175;162
Pakruojis d. mun.;2003;51;351;170;181
Pakruojis d. mun.;2003;52;340;167;173
Pakruojis d. mun.;2003;53;348;162;186
Pakruojis d. mun.;2003;54;322;160;162
Pakruojis d. mun.;2003;55;284;140;144
Pakruojis d. mun.;2003;56;264;139;125
Pakruojis d. mun.;2003;57;314;140;174
Pakruojis d. mun.;2003;58;302;145;157
Pakruojis d. mun.;2003;59;322;150;172
Pakruojis d. mun.;2003;60;386;164;222
Pakruojis d. mun.;2003;61;391;178;213
Pakruojis d. mun.;2003;62;325;143;182
Pakruojis d. mun.;2003;63;304;134;170
Pakruojis d. mun.;2003;64;325;131;194
Pakruojis d. mun.;2003;65;320;135;185
Pakruojis d. mun.;2003;66;298;123;175
Pakruojis d. mun.;2003;67;287;122;165
Pakruojis d. mun.;2003;68;283;112;171
Pakruojis d. mun.;2003;69;301;119;182
Pakruojis d. mun.;2003;70;320;122;198
Pakruojis d. mun.;2003;71;256;103;153
Pakruojis d. mun.;2003;72;263;87;176
Pakruojis d. mun.;2003;73;241;76;165
Pakruojis d. mun.;2003;74;260;88;172
Pakruojis d. mun.;2003;75;236;92;144
Pakruojis d. mun.;2003;76;224;71;153
Pakruojis d. mun.;2003;77;199;54;145
Pakruojis d. mun.;2003;78;172;39;133
Pakruojis d. mun.;2003;79;175;46;129
Pakruojis d. mun.;2003;80;135;25;110
Pakruojis d. mun.;2003;81;130;28;102
Pakruojis d. mun.;2003;82;122;23;99
Pakruojis d. mun.;2003;83;68;20;48
Pakruojis d. mun.;2003;84;49;15;34
Pakruojis d. mun.;2003;85;325;69;256
Pakruojis d. mun.;2004;-1;28535;13554;14981
Pakruojis d. mun.;2004;0;274;137;137
Pakruojis d. mun.;2004;1;274;149;125
Pakruojis d. mun.;2004;2;270;134;136
Pakruojis d. mun.;2004;3;317;162;155
Pakruojis d. mun.;2004;4;348;186;162
Pakruojis d. mun.;2004;5;335;164;171
Pakruojis d. mun.;2004;6;327;165;162
Pakruojis d. mun.;2004;7;373;195;178
Pakruojis d. mun.;2004;8;376;183;193
Pakruojis d. mun.;2004;9;404;202;202
Pakruojis d. mun.;2004;10;433;228;205
Pakruojis d. mun.;2004;11;479;242;237
Pakruojis d. mun.;2004;12;475;257;218
Pakruojis d. mun.;2004;13;460;219;241
Pakruojis d. mun.;2004;14;455;219;236
Pakruojis d. mun.;2004;15;452;219;233
Pakruojis d. mun.;2004;16;480;236;244
Pakruojis d. mun.;2004;17;504;256;248
Pakruojis d. mun.;2004;18;489;234;255
Pakruojis d. mun.;2004;19;448;230;218
Pakruojis d. mun.;2004;20;434;219;215
Pakruojis d. mun.;2004;21;362;189;173
Pakruojis d. mun.;2004;22;311;178;133
Pakruojis d. mun.;2004;23;299;161;138
Pakruojis d. mun.;2004;24;292;166;126
Pakruojis d. mun.;2004;25;314;170;144
Pakruojis d. mun.;2004;26;293;139;154
Pakruojis d. mun.;2004;27;318;169;149
Pakruojis d. mun.;2004;28;368;208;160
Pakruojis d. mun.;2004;29;313;157;156
Pakruojis d. mun.;2004;30;333;175;158
Pakruojis d. mun.;2004;31;370;190;180
Pakruojis d. mun.;2004;32;385;192;193
Pakruojis d. mun.;2004;33;414;205;209
Pakruojis d. mun.;2004;34;393;194;199
Pakruojis d. mun.;2004;35;389;213;176
Pakruojis d. mun.;2004;36;403;218;185
Pakruojis d. mun.;2004;37;379;184;195
Pakruojis d. mun.;2004;38;391;211;180
Pakruojis d. mun.;2004;39;412;213;199
Pakruojis d. mun.;2004;40;404;201;203
Pakruojis d. mun.;2004;41;374;187;187
Pakruojis d. mun.;2004;42;401;208;193
Pakruojis d. mun.;2004;43;423;206;217
Pakruojis d. mun.;2004;44;395;196;199
Pakruojis d. mun.;2004;45;421;224;197
Pakruojis d. mun.;2004;46;401;219;182
Pakruojis d. mun.;2004;47;361;177;184
Pakruojis d. mun.;2004;48;342;176;166
Pakruojis d. mun.;2004;49;340;156;184
Pakruojis d. mun.;2004;50;314;152;162
Pakruojis d. mun.;2004;51;329;170;159
Pakruojis d. mun.;2004;52;343;166;177
Pakruojis d. mun.;2004;53;339;168;171
Pakruojis d. mun.;2004;54;336;153;183
Pakruojis d. mun.;2004;55;319;157;162
Pakruojis d. mun.;2004;56;282;137;145
Pakruojis d. mun.;2004;57;260;137;123
Pakruojis d. mun.;2004;58;310;139;171
Pakruojis d. mun.;2004;59;296;139;157
Pakruojis d. mun.;2004;60;311;141;170
Pakruojis d. mun.;2004;61;382;162;220
Pakruojis d. mun.;2004;62;384;173;211
Pakruojis d. mun.;2004;63;320;142;178
Pakruojis d. mun.;2004;64;296;127;169
Pakruojis d. mun.;2004;65;314;120;194
Pakruojis d. mun.;2004;66;312;127;185
Pakruojis d. mun.;2004;67;291;121;170
Pakruojis d. mun.;2004;68;279;120;159
Pakruojis d. mun.;2004;69;274;105;169
Pakruojis d. mun.;2004;70;290;115;175
Pakruojis d. mun.;2004;71;302;115;187
Pakruojis d. mun.;2004;72;241;91;150
Pakruojis d. mun.;2004;73;257;84;173
Pakruojis d. mun.;2004;74;228;68;160
Pakruojis d. mun.;2004;75;250;82;168
Pakruojis d. mun.;2004;76;211;80;131
Pakruojis d. mun.;2004;77;205;64;141
Pakruojis d. mun.;2004;78;193;49;144
Pakruojis d. mun.;2004;79;163;37;126
Pakruojis d. mun.;2004;80;167;43;124
Pakruojis d. mun.;2004;81;122;21;101
Pakruojis d. mun.;2004;82;117;24;93
Pakruojis d. mun.;2004;83;112;19;93
Pakruojis d. mun.;2004;84;66;19;47
Pakruojis d. mun.;2004;85;312;69;243
Pakruojis d. mun.;2005;-1;28025;13289;14736
Pakruojis d. mun.;2005;0;247;129;118
Pakruojis d. mun.;2005;1;276;141;135
Pakruojis d. mun.;2005;2;272;148;124
Pakruojis d. mun.;2005;3;265;131;134
Pakruojis d. mun.;2005;4;316;161;155
Pakruojis d. mun.;2005;5;342;183;159
Pakruojis d. mun.;2005;6;331;161;170
Pakruojis d. mun.;2005;7;325;164;161
Pakruojis d. mun.;2005;8;371;194;177
Pakruojis d. mun.;2005;9;374;181;193
Pakruojis d. mun.;2005;10;399;200;199
Pakruojis d. mun.;2005;11;430;228;202
Pakruojis d. mun.;2005;12;475;240;235
Pakruojis d. mun.;2005;13;470;255;215
Pakruojis d. mun.;2005;14;457;220;237
Pakruojis d. mun.;2005;15;448;213;235
Pakruojis d. mun.;2005;16;451;221;230
Pakruojis d. mun.;2005;17;469;233;236
Pakruojis d. mun.;2005;18;494;250;244
Pakruojis d. mun.;2005;19;474;228;246
Pakruojis d. mun.;2005;20;434;224;210
Pakruojis d. mun.;2005;21;421;216;205
Pakruojis d. mun.;2005;22;356;185;171
Pakruojis d. mun.;2005;23;300;175;125
Pakruojis d. mun.;2005;24;289;153;136
Pakruojis d. mun.;2005;25;284;157;127
Pakruojis d. mun.;2005;26;308;166;142
Pakruojis d. mun.;2005;27;275;133;142
Pakruojis d. mun.;2005;28;306;165;141
Pakruojis d. mun.;2005;29;363;203;160
Pakruojis d. mun.;2005;30;312;155;157
Pakruojis d. mun.;2005;31;318;169;149
Pakruojis d. mun.;2005;32;362;187;175
Pakruojis d. mun.;2005;33;380;184;196
Pakruojis d. mun.;2005;34;406;202;204
Pakruojis d. mun.;2005;35;381;185;196
Pakruojis d. mun.;2005;36;383;211;172
Pakruojis d. mun.;2005;37;398;214;184
Pakruojis d. mun.;2005;38;371;174;197
Pakruojis d. mun.;2005;39;390;209;181
Pakruojis d. mun.;2005;40;407;211;196
Pakruojis d. mun.;2005;41;396;194;202
Pakruojis d. mun.;2005;42;364;183;181
Pakruojis d. mun.;2005;43;391;206;185
Pakruojis d. mun.;2005;44;417;203;214
Pakruojis d. mun.;2005;45;384;194;190
Pakruojis d. mun.;2005;46;417;221;196
Pakruojis d. mun.;2005;47;394;215;179
Pakruojis d. mun.;2005;48;357;175;182
Pakruojis d. mun.;2005;49;331;173;158
Pakruojis d. mun.;2005;50;336;154;182
Pakruojis d. mun.;2005;51;308;148;160
Pakruojis d. mun.;2005;52;324;166;158
Pakruojis d. mun.;2005;53;338;162;176
Pakruojis d. mun.;2005;54;331;163;168
Pakruojis d. mun.;2005;55;329;149;180
Pakruojis d. mun.;2005;56;315;151;164
Pakruojis d. mun.;2005;57;281;134;147
Pakruojis d. mun.;2005;58;255;134;121
Pakruojis d. mun.;2005;59;297;128;169
Pakruojis d. mun.;2005;60;288;132;156
Pakruojis d. mun.;2005;61;298;133;165
Pakruojis d. mun.;2005;62;370;155;215
Pakruojis d. mun.;2005;63;372;165;207
Pakruojis d. mun.;2005;64;311;135;176
Pakruojis d. mun.;2005;65;288;123;165
Pakruojis d. mun.;2005;66;308;116;192
Pakruojis d. mun.;2005;67;302;122;180
Pakruojis d. mun.;2005;68;282;114;168
Pakruojis d. mun.;2005;69;265;110;155
Pakruojis d. mun.;2005;70;258;94;164
Pakruojis d. mun.;2005;71;286;113;173
Pakruojis d. mun.;2005;72;294;109;185
Pakruojis d. mun.;2005;73;232;86;146
Pakruojis d. mun.;2005;74;250;82;168
Pakruojis d. mun.;2005;75;214;59;155
Pakruojis d. mun.;2005;76;232;72;160
Pakruojis d. mun.;2005;77;193;73;120
Pakruojis d. mun.;2005;78;189;57;132
Pakruojis d. mun.;2005;79;179;41;138
Pakruojis d. mun.;2005;80;147;35;112
Pakruojis d. mun.;2005;81;149;38;111
Pakruojis d. mun.;2005;82;116;15;101
Pakruojis d. mun.;2005;83;100;19;81
Pakruojis d. mun.;2005;84;103;17;86
Pakruojis d. mun.;2005;85;304;62;242
Pakruojis d. mun.;2006;-1;27252;12959;14293
Pakruojis d. mun.;2006;0;256;141;115
Pakruojis d. mun.;2006;1;239;125;114
Pakruojis d. mun.;2006;2;273;139;134
Pakruojis d. mun.;2006;3;267;146;121
Pakruojis d. mun.;2006;4;261;130;131
Pakruojis d. mun.;2006;5;307;155;152
Pakruojis d. mun.;2006;6;336;181;155
Pakruojis d. mun.;2006;7;328;160;168
Pakruojis d. mun.;2006;8;323;164;159
Pakruojis d. mun.;2006;9;367;192;175
Pakruojis d. mun.;2006;10;374;182;192
Pakruojis d. mun.;2006;11;397;198;199
Pakruojis d. mun.;2006;12;426;229;197
Pakruojis d. mun.;2006;13;464;237;227
Pakruojis d. mun.;2006;14;465;253;212
Pakruojis d. mun.;2006;15;443;214;229
Pakruojis d. mun.;2006;16;435;207;228
Pakruojis d. mun.;2006;17;444;218;226
Pakruojis d. mun.;2006;18;449;224;225
Pakruojis d. mun.;2006;19;461;236;225
Pakruojis d. mun.;2006;20;449;216;233
Pakruojis d. mun.;2006;21;408;212;196
Pakruojis d. mun.;2006;22;398;209;189
Pakruojis d. mun.;2006;23;328;175;153
Pakruojis d. mun.;2006;24;274;158;116
Pakruojis d. mun.;2006;25;268;142;126
Pakruojis d. mun.;2006;26;265;148;117
Pakruojis d. mun.;2006;27;293;159;134
Pakruojis d. mun.;2006;28;252;123;129
Pakruojis d. mun.;2006;29;292;158;134
Pakruojis d. mun.;2006;30;357;199;158
Pakruojis d. mun.;2006;31;299;147;152
Pakruojis d. mun.;2006;32;310;164;146
Pakruojis d. mun.;2006;33;347;180;167
Pakruojis d. mun.;2006;34;370;181;189
Pakruojis d. mun.;2006;35;396;197;199
Pakruojis d. mun.;2006;36;370;180;190
Pakruojis d. mun.;2006;37;373;203;170
Pakruojis d. mun.;2006;38;387;206;181
Pakruojis d. mun.;2006;39;363;170;193
Pakruojis d. mun.;2006;40;378;199;179
Pakruojis d. mun.;2006;41;398;206;192
Pakruojis d. mun.;2006;42;385;190;195
Pakruojis d. mun.;2006;43;362;181;181
Pakruojis d. mun.;2006;44;379;195;184
Pakruojis d. mun.;2006;45;407;202;205
Pakruojis d. mun.;2006;46;375;187;188
Pakruojis d. mun.;2006;47;407;216;191
Pakruojis d. mun.;2006;48;388;214;174
Pakruojis d. mun.;2006;49;347;169;178
Pakruojis d. mun.;2006;50;324;169;155
Pakruojis d. mun.;2006;51;320;145;175
Pakruojis d. mun.;2006;52;298;143;155
Pakruojis d. mun.;2006;53;309;156;153
Pakruojis d. mun.;2006;54;333;159;174
Pakruojis d. mun.;2006;55;323;160;163
Pakruojis d. mun.;2006;56;321;143;178
Pakruojis d. mun.;2006;57;307;145;162
Pakruojis d. mun.;2006;58;272;128;144
Pakruojis d. mun.;2006;59;247;129;118
Pakruojis d. mun.;2006;60;287;125;162
Pakruojis d. mun.;2006;61;282;128;154
Pakruojis d. mun.;2006;62;291;127;164
Pakruojis d. mun.;2006;63;359;150;209
Pakruojis d. mun.;2006;64;358;159;199
Pakruojis d. mun.;2006;65;299;129;170
Pakruojis d. mun.;2006;66;278;117;161
Pakruojis d. mun.;2006;67;293;109;184
Pakruojis d. mun.;2006;68;300;120;180
Pakruojis d. mun.;2006;69;272;107;165
Pakruojis d. mun.;2006;70;250;103;147
Pakruojis d. mun.;2006;71;250;91;159
Pakruojis d. mun.;2006;72;274;106;168
Pakruojis d. mun.;2006;73;281;105;176
Pakruojis d. mun.;2006;74;222;79;143
Pakruojis d. mun.;2006;75;236;74;162
Pakruojis d. mun.;2006;76;203;54;149
Pakruojis d. mun.;2006;77;218;67;151
Pakruojis d. mun.;2006;78;178;68;110
Pakruojis d. mun.;2006;79;171;49;122
Pakruojis d. mun.;2006;80;163;37;126
Pakruojis d. mun.;2006;81;134;32;102
Pakruojis d. mun.;2006;82;131;31;100
Pakruojis d. mun.;2006;83;100;13;87
Pakruojis d. mun.;2006;84;90;17;73
Pakruojis d. mun.;2006;85;338;68;270
Pakruojis d. mun.;2007;-1;26589;12600;13989
Pakruojis d. mun.;2007;0;228;96;132
Pakruojis d. mun.;2007;1;253;137;116
Pakruojis d. mun.;2007;2;237;125;112
Pakruojis d. mun.;2007;3;272;137;135
Pakruojis d. mun.;2007;4;265;144;121
Pakruojis d. mun.;2007;5;257;127;130
Pakruojis d. mun.;2007;6;305;152;153
Pakruojis d. mun.;2007;7;331;179;152
Pakruojis d. mun.;2007;8;321;156;165
Pakruojis d. mun.;2007;9;319;162;157
Pakruojis d. mun.;2007;10;356;188;168
Pakruojis d. mun.;2007;11;369;181;188
Pakruojis d. mun.;2007;12;392;194;198
Pakruojis d. mun.;2007;13;421;227;194
Pakruojis d. mun.;2007;14;462;238;224
Pakruojis d. mun.;2007;15;460;251;209
Pakruojis d. mun.;2007;16;435;210;225
Pakruojis d. mun.;2007;17;423;198;225
Pakruojis d. mun.;2007;18;430;213;217
Pakruojis d. mun.;2007;19;438;217;221
Pakruojis d. mun.;2007;20;443;227;216
Pakruojis d. mun.;2007;21;431;206;225
Pakruojis d. mun.;2007;22;394;204;190
Pakruojis d. mun.;2007;23;383;202;181
Pakruojis d. mun.;2007;24;312;169;143
Pakruojis d. mun.;2007;25;263;149;114
Pakruojis d. mun.;2007;26;252;133;119
Pakruojis d. mun.;2007;27;251;142;109
Pakruojis d. mun.;2007;28;280;145;135
Pakruojis d. mun.;2007;29;244;119;125
Pakruojis d. mun.;2007;30;281;149;132
Pakruojis d. mun.;2007;31;343;193;150
Pakruojis d. mun.;2007;32;289;142;147
Pakruojis d. mun.;2007;33;303;159;144
Pakruojis d. mun.;2007;34;341;174;167
Pakruojis d. mun.;2007;35;363;176;187
Pakruojis d. mun.;2007;36;388;193;195
Pakruojis d. mun.;2007;37;365;178;187
Pakruojis d. mun.;2007;38;364;201;163
Pakruojis d. mun.;2007;39;378;201;177
Pakruojis d. mun.;2007;40;354;164;190
Pakruojis d. mun.;2007;41;365;194;171
Pakruojis d. mun.;2007;42;392;206;186
Pakruojis d. mun.;2007;43;381;187;194
Pakruojis d. mun.;2007;44;349;175;174
Pakruojis d. mun.;2007;45;369;189;180
Pakruojis d. mun.;2007;46;401;197;204
Pakruojis d. mun.;2007;47;368;185;183
Pakruojis d. mun.;2007;48;398;211;187
Pakruojis d. mun.;2007;49;386;211;175
Pakruojis d. mun.;2007;50;336;163;173
Pakruojis d. mun.;2007;51;320;167;153
Pakruojis d. mun.;2007;52;314;145;169
Pakruojis d. mun.;2007;53;294;141;153
Pakruojis d. mun.;2007;54;302;150;152
Pakruojis d. mun.;2007;55;328;156;172
Pakruojis d. mun.;2007;56;321;158;163
Pakruojis d. mun.;2007;57;315;138;177
Pakruojis d. mun.;2007;58;298;140;158
Pakruojis d. mun.;2007;59;264;122;142
Pakruojis d. mun.;2007;60;238;122;116
Pakruojis d. mun.;2007;61;283;121;162
Pakruojis d. mun.;2007;62;278;126;152
Pakruojis d. mun.;2007;63;270;116;154
Pakruojis d. mun.;2007;64;349;148;201
Pakruojis d. mun.;2007;65;346;152;194
Pakruojis d. mun.;2007;66;285;119;166
Pakruojis d. mun.;2007;67;261;106;155
Pakruojis d. mun.;2007;68;282;104;178
Pakruojis d. mun.;2007;69;291;115;176
Pakruojis d. mun.;2007;70;259;98;161
Pakruojis d. mun.;2007;71;227;88;139
Pakruojis d. mun.;2007;72;242;85;157
Pakruojis d. mun.;2007;73;257;96;161
Pakruojis d. mun.;2007;74;265;93;172
Pakruojis d. mun.;2007;75;213;75;138
Pakruojis d. mun.;2007;76;220;69;151
Pakruojis d. mun.;2007;77;187;50;137
Pakruojis d. mun.;2007;78;207;63;144
Pakruojis d. mun.;2007;79;165;60;105
Pakruojis d. mun.;2007;80;157;42;115
Pakruojis d. mun.;2007;81;144;30;114
Pakruojis d. mun.;2007;82;120;26;94
Pakruojis d. mun.;2007;83;121;28;93
Pakruojis d. mun.;2007;84;90;12;78
Pakruojis d. mun.;2007;85;335;63;272
Pakruojis d. mun.;2008;-1;25953;12250;13703
Pakruojis d. mun.;2008;0;225;109;116
Pakruojis d. mun.;2008;1;226;94;132
Pakruojis d. mun.;2008;2;249;136;113
Pakruojis d. mun.;2008;3;236;123;113
Pakruojis d. mun.;2008;4;269;135;134
Pakruojis d. mun.;2008;5;259;142;117
Pakruojis d. mun.;2008;6;255;127;128
Pakruojis d. mun.;2008;7;295;149;146
Pakruojis d. mun.;2008;8;324;175;149
Pakruojis d. mun.;2008;9;318;154;164
Pakruojis d. mun.;2008;10;316;162;154
Pakruojis d. mun.;2008;11;353;186;167
Pakruojis d. mun.;2008;12;366;180;186
Pakruojis d. mun.;2008;13;390;193;197
Pakruojis d. mun.;2008;14;417;223;194
Pakruojis d. mun.;2008;15;461;237;224
Pakruojis d. mun.;2008;16;455;249;206
Pakruojis d. mun.;2008;17;431;209;222
Pakruojis d. mun.;2008;18;412;193;219
Pakruojis d. mun.;2008;19;421;209;212
Pakruojis d. mun.;2008;20;432;214;218
Pakruojis d. mun.;2008;21;429;219;210
Pakruojis d. mun.;2008;22;424;204;220
Pakruojis d. mun.;2008;23;377;199;178
Pakruojis d. mun.;2008;24;368;195;173
Pakruojis d. mun.;2008;25;298;163;135
Pakruojis d. mun.;2008;26;240;139;101
Pakruojis d. mun.;2008;27;242;126;116
Pakruojis d. mun.;2008;28;229;128;101
Pakruojis d. mun.;2008;29;259;134;125
Pakruojis d. mun.;2008;30;231;111;120
Pakruojis d. mun.;2008;31;266;144;122
Pakruojis d. mun.;2008;32;333;187;146
Pakruojis d. mun.;2008;33;281;140;141
Pakruojis d. mun.;2008;34;295;157;138
Pakruojis d. mun.;2008;35;326;163;163
Pakruojis d. mun.;2008;36;355;169;186
Pakruojis d. mun.;2008;37;381;190;191
Pakruojis d. mun.;2008;38;352;171;181
Pakruojis d. mun.;2008;39;359;196;163
Pakruojis d. mun.;2008;40;373;198;175
Pakruojis d. mun.;2008;41;351;164;187
Pakruojis d. mun.;2008;42;362;188;174
Pakruojis d. mun.;2008;43;384;199;185
Pakruojis d. mun.;2008;44;372;180;192
Pakruojis d. mun.;2008;45;346;172;174
Pakruojis d. mun.;2008;46;364;186;178
Pakruojis d. mun.;2008;47;396;194;202
Pakruojis d. mun.;2008;48;356;177;179
Pakruojis d. mun.;2008;49;388;205;183
Pakruojis d. mun.;2008;50;377;204;173
Pakruojis d. mun.;2008;51;330;157;173
Pakruojis d. mun.;2008;52;314;162;152
Pakruojis d. mun.;2008;53;301;134;167
Pakruojis d. mun.;2008;54;285;137;148
Pakruojis d. mun.;2008;55;295;146;149
Pakruojis d. mun.;2008;56;319;151;168
Pakruojis d. mun.;2008;57;311;151;160
Pakruojis d. mun.;2008;58;311;134;177
Pakruojis d. mun.;2008;59;289;134;155
Pakruojis d. mun.;2008;60;257;118;139
Pakruojis d. mun.;2008;61;228;115;113
Pakruojis d. mun.;2008;62;277;115;162
Pakruojis d. mun.;2008;63;264;118;146
Pakruojis d. mun.;2008;64;260;111;149
Pakruojis d. mun.;2008;65;333;135;198
Pakruojis d. mun.;2008;66;332;143;189
Pakruojis d. mun.;2008;67;269;108;161
Pakruojis d. mun.;2008;68;248;97;151
Pakruojis d. mun.;2008;69;270;97;173
Pakruojis d. mun.;2008;70;279;105;174
Pakruojis d. mun.;2008;71;253;96;157
Pakruojis d. mun.;2008;72;219;82;137
Pakruojis d. mun.;2008;73;230;81;149
Pakruojis d. mun.;2008;74;245;90;155
Pakruojis d. mun.;2008;75;261;92;169
Pakruojis d. mun.;2008;76;201;70;131
Pakruojis d. mun.;2008;77;201;60;141
Pakruojis d. mun.;2008;78;173;47;126
Pakruojis d. mun.;2008;79;199;59;140
Pakruojis d. mun.;2008;80;153;52;101
Pakruojis d. mun.;2008;81;137;33;104
Pakruojis d. mun.;2008;82;136;26;110
Pakruojis d. mun.;2008;83;101;21;80
Pakruojis d. mun.;2008;84;97;17;80
Pakruojis d. mun.;2008;85;351;55;296
Pakruojis d. mun.;2009;-1;25434;12017;13417
Pakruojis d. mun.;2009;0;221;115;106
Pakruojis d. mun.;2009;1;224;108;116
Pakruojis d. mun.;2009;2;223;94;129
Pakruojis d. mun.;2009;3;247;135;112
Pakruojis d. mun.;2009;4;234;123;111
Pakruojis d. mun.;2009;5;262;134;128
Pakruojis d. mun.;2009;6;253;138;115
Pakruojis d. mun.;2009;7;251;123;128
Pakruojis d. mun.;2009;8;293;146;147
Pakruojis d. mun.;2009;9;319;172;147
Pakruojis d. mun.;2009;10;316;153;163
Pakruojis d. mun.;2009;11;317;160;157
Pakruojis d. mun.;2009;12;352;185;167
Pakruojis d. mun.;2009;13;363;176;187
Pakruojis d. mun.;2009;14;385;188;197
Pakruojis d. mun.;2009;15;409;221;188
Pakruojis d. mun.;2009;16;458;235;223
Pakruojis d. mun.;2009;17;455;249;206
Pakruojis d. mun.;2009;18;427;207;220
Pakruojis d. mun.;2009;19;406;190;216
Pakruojis d. mun.;2009;20;411;204;207
Pakruojis d. mun.;2009;21;421;209;212
Pakruojis d. mun.;2009;22;418;215;203
Pakruojis d. mun.;2009;23;416;198;218
Pakruojis d. mun.;2009;24;360;193;167
Pakruojis d. mun.;2009;25;354;189;165
Pakruojis d. mun.;2009;26;271;156;115
Pakruojis d. mun.;2009;27;219;127;92
Pakruojis d. mun.;2009;28;230;123;107
Pakruojis d. mun.;2009;29;216;121;95
Pakruojis d. mun.;2009;30;249;126;123
Pakruojis d. mun.;2009;31;214;102;112
Pakruojis d. mun.;2009;32;259;138;121
Pakruojis d. mun.;2009;33;323;184;139
Pakruojis d. mun.;2009;34;274;138;136
Pakruojis d. mun.;2009;35;290;153;137
Pakruojis d. mun.;2009;36;321;162;159
Pakruojis d. mun.;2009;37;349;165;184
Pakruojis d. mun.;2009;38;376;190;186
Pakruojis d. mun.;2009;39;347;168;179
Pakruojis d. mun.;2009;40;358;193;165
Pakruojis d. mun.;2009;41;366;193;173
Pakruojis d. mun.;2009;42;344;159;185
Pakruojis d. mun.;2009;43;361;188;173
Pakruojis d. mun.;2009;44;384;199;185
Pakruojis d. mun.;2009;45;363;179;184
Pakruojis d. mun.;2009;46;340;170;170
Pakruojis d. mun.;2009;47;357;180;177
Pakruojis d. mun.;2009;48;390;192;198
Pakruojis d. mun.;2009;49;352;177;175
Pakruojis d. mun.;2009;50;386;204;182
Pakruojis d. mun.;2009;51;374;203;171
Pakruojis d. mun.;2009;52;321;152;169
Pakruojis d. mun.;2009;53;313;165;148
Pakruojis d. mun.;2009;54;300;134;166
Pakruojis d. mun.;2009;55;274;128;146
Pakruojis d. mun.;2009;56;284;135;149
Pakruojis d. mun.;2009;57;314;147;167
Pakruojis d. mun.;2009;58;302;144;158
Pakruojis d. mun.;2009;59;303;132;171
Pakruojis d. mun.;2009;60;284;130;154
Pakruojis d. mun.;2009;61;253;113;140
Pakruojis d. mun.;2009;62;220;110;110
Pakruojis d. mun.;2009;63;269;111;158
Pakruojis d. mun.;2009;64;260;113;147
Pakruojis d. mun.;2009;65;253;105;148
Pakruojis d. mun.;2009;66;326;129;197
Pakruojis d. mun.;2009;67;319;136;183
Pakruojis d. mun.;2009;68;256;102;154
Pakruojis d. mun.;2009;69;239;92;147
Pakruojis d. mun.;2009;70;264;95;169
Pakruojis d. mun.;2009;71;269;101;168
Pakruojis d. mun.;2009;72;247;91;156
Pakruojis d. mun.;2009;73;205;75;130
Pakruojis d. mun.;2009;74;216;72;144
Pakruojis d. mun.;2009;75;231;80;151
Pakruojis d. mun.;2009;76;243;83;160
Pakruojis d. mun.;2009;77;194;66;128
Pakruojis d. mun.;2009;78;185;55;130
Pakruojis d. mun.;2009;79;163;44;119
Pakruojis d. mun.;2009;80;182;55;127
Pakruojis d. mun.;2009;81;142;48;94
Pakruojis d. mun.;2009;82;118;27;91
Pakruojis d. mun.;2009;83;126;24;102
Pakruojis d. mun.;2009;84;91;18;73
Pakruojis d. mun.;2009;85;360;55;305
Pakruojis d. mun.;2010;-1;24705;11628;13077
Pakruojis d. mun.;2010;0;211;111;100
Pakruojis d. mun.;2010;1;211;107;104
Pakruojis d. mun.;2010;2;218;104;114
Pakruojis d. mun.;2010;3;217;90;127
Pakruojis d. mun.;2010;4;243;135;108
Pakruojis d. mun.;2010;5;224;119;105
Pakruojis d. mun.;2010;6;256;128;128
Pakruojis d. mun.;2010;7;247;136;111
Pakruojis d. mun.;2010;8;245;117;128
Pakruojis d. mun.;2010;9;287;141;146
Pakruojis d. mun.;2010;10;315;169;146
Pakruojis d. mun.;2010;11;308;150;158
Pakruojis d. mun.;2010;12;313;158;155
Pakruojis d. mun.;2010;13;350;183;167
Pakruojis d. mun.;2010;14;357;174;183
Pakruojis d. mun.;2010;15;380;184;196
Pakruojis d. mun.;2010;16;403;215;188
Pakruojis d. mun.;2010;17;452;231;221
Pakruojis d. mun.;2010;18;445;243;202
Pakruojis d. mun.;2010;19;415;201;214
Pakruojis d. mun.;2010;20;397;187;210
Pakruojis d. mun.;2010;21;393;198;195
Pakruojis d. mun.;2010;22;400;202;198
Pakruojis d. mun.;2010;23;399;205;194
Pakruojis d. mun.;2010;24;393;186;207
Pakruojis d. mun.;2010;25;338;183;155
Pakruojis d. mun.;2010;26;331;176;155
Pakruojis d. mun.;2010;27;248;146;102
Pakruojis d. mun.;2010;28;205;121;84
Pakruojis d. mun.;2010;29;224;119;105
Pakruojis d. mun.;2010;30;199;113;86
Pakruojis d. mun.;2010;31;236;124;112
Pakruojis d. mun.;2010;32;202;93;109
Pakruojis d. mun.;2010;33;250;132;118
Pakruojis d. mun.;2010;34;317;179;138
Pakruojis d. mun.;2010;35;268;135;133
Pakruojis d. mun.;2010;36;278;146;132
Pakruojis d. mun.;2010;37;310;155;155
Pakruojis d. mun.;2010;38;341;157;184
Pakruojis d. mun.;2010;39;365;182;183
Pakruojis d. mun.;2010;40;337;162;175
Pakruojis d. mun.;2010;41;348;187;161
Pakruojis d. mun.;2010;42;355;186;169
Pakruojis d. mun.;2010;43;336;152;184
Pakruojis d. mun.;2010;44;351;182;169
Pakruojis d. mun.;2010;45;371;194;177
Pakruojis d. mun.;2010;46;361;177;184
Pakruojis d. mun.;2010;47;335;168;167
Pakruojis d. mun.;2010;48;348;172;176
Pakruojis d. mun.;2010;49;380;184;196
Pakruojis d. mun.;2010;50;344;168;176
Pakruojis d. mun.;2010;51;375;193;182
Pakruojis d. mun.;2010;52;370;198;172
Pakruojis d. mun.;2010;53;313;147;166
Pakruojis d. mun.;2010;54;308;159;149
Pakruojis d. mun.;2010;55;296;130;166
Pakruojis d. mun.;2010;56;266;122;144
Pakruojis d. mun.;2010;57;274;130;144
Pakruojis d. mun.;2010;58;308;144;164
Pakruojis d. mun.;2010;59;291;137;154
Pakruojis d. mun.;2010;60;303;132;171
Pakruojis d. mun.;2010;61;276;124;152
Pakruojis d. mun.;2010;62;250;110;140
Pakruojis d. mun.;2010;63;210;103;107
Pakruojis d. mun.;2010;64;263;107;156
Pakruojis d. mun.;2010;65;251;107;144
Pakruojis d. mun.;2010;66;246;100;146
Pakruojis d. mun.;2010;67;315;122;193
Pakruojis d. mun.;2010;68;296;121;175
Pakruojis d. mun.;2010;69;246;93;153
Pakruojis d. mun.;2010;70;230;86;144
Pakruojis d. mun.;2010;71;251;89;162
Pakruojis d. mun.;2010;72;259;91;168
Pakruojis d. mun.;2010;73;237;82;155
Pakruojis d. mun.;2010;74;190;68;122
Pakruojis d. mun.;2010;75;208;69;139
Pakruojis d. mun.;2010;76;212;71;141
Pakruojis d. mun.;2010;77;226;76;150
Pakruojis d. mun.;2010;78;178;58;120
Pakruojis d. mun.;2010;79;173;51;122
Pakruojis d. mun.;2010;80;148;39;109
Pakruojis d. mun.;2010;81;166;52;114
Pakruojis d. mun.;2010;82;124;42;82
Pakruojis d. mun.;2010;83;104;22;82
Pakruojis d. mun.;2010;84;113;23;90
Pakruojis d. mun.;2010;85;372;63;309
Pakruojis d. mun.;2011;-1;23847;11226;12621
Pakruojis d. mun.;2011;0;184;87;97
Pakruojis d. mun.;2011;1;191;99;92
Pakruojis d. mun.;2011;2;192;100;92
Pakruojis d. mun.;2011;3;203;102;101
Pakruojis d. mun.;2011;4;190;75;115
Pakruojis d. mun.;2011;5;228;129;99
Pakruojis d. mun.;2011;6;223;120;103
Pakruojis d. mun.;2011;7;250;121;129
Pakruojis d. mun.;2011;8;240;126;114
Pakruojis d. mun.;2011;9;257;122;135
Pakruojis d. mun.;2011;10;290;147;143
Pakruojis d. mun.;2011;11;318;171;147
Pakruojis d. mun.;2011;12;305;149;156
Pakruojis d. mun.;2011;13;296;154;142
Pakruojis d. mun.;2011;14;350;188;162
Pakruojis d. mun.;2011;15;350;173;177
Pakruojis d. mun.;2011;16;375;181;194
Pakruojis d. mun.;2011;17;385;209;176
Pakruojis d. mun.;2011;18;428;207;221
Pakruojis d. mun.;2011;19;355;202;153
Pakruojis d. mun.;2011;20;330;161;169
Pakruojis d. mun.;2011;21;307;156;151
Pakruojis d. mun.;2011;22;290;156;134
Pakruojis d. mun.;2011;23;287;152;135
Pakruojis d. mun.;2011;24;288;154;134
Pakruojis d. mun.;2011;25;281;139;142
Pakruojis d. mun.;2011;26;231;137;94
Pakruojis d. mun.;2011;27;221;126;95
Pakruojis d. mun.;2011;28;206;108;98
Pakruojis d. mun.;2011;29;216;113;103
Pakruojis d. mun.;2011;30;240;121;119
Pakruojis d. mun.;2011;31;225;124;101
Pakruojis d. mun.;2011;32;254;133;121
Pakruojis d. mun.;2011;33;245;107;138
Pakruojis d. mun.;2011;34;271;134;137
Pakruojis d. mun.;2011;35;329;179;150
Pakruojis d. mun.;2011;36;291;140;151
Pakruojis d. mun.;2011;37;291;147;144
Pakruojis d. mun.;2011;38;341;172;169
Pakruojis d. mun.;2011;39;348;166;182
Pakruojis d. mun.;2011;40;379;187;192
Pakruojis d. mun.;2011;41;357;181;176
Pakruojis d. mun.;2011;42;352;188;164
Pakruojis d. mun.;2011;43;361;189;172
Pakruojis d. mun.;2011;44;341;159;182
Pakruojis d. mun.;2011;45;348;180;168
Pakruojis d. mun.;2011;46;388;205;183
Pakruojis d. mun.;2011;47;377;182;195
Pakruojis d. mun.;2011;48;361;189;172
Pakruojis d. mun.;2011;49;363;178;185
Pakruojis d. mun.;2011;50;399;196;203
Pakruojis d. mun.;2011;51;336;171;165
Pakruojis d. mun.;2011;52;362;194;168
Pakruojis d. mun.;2011;53;357;190;167
Pakruojis d. mun.;2011;54;317;152;165
Pakruojis d. mun.;2011;55;310;152;158
Pakruojis d. mun.;2011;56;291;129;162
Pakruojis d. mun.;2011;57;273;120;153
Pakruojis d. mun.;2011;58;288;136;152
Pakruojis d. mun.;2011;59;308;138;170
Pakruojis d. mun.;2011;60;292;134;158
Pakruojis d. mun.;2011;61;313;136;177
Pakruojis d. mun.;2011;62;268;123;145
Pakruojis d. mun.;2011;63;246;105;141
Pakruojis d. mun.;2011;64;210;103;107
Pakruojis d. mun.;2011;65;254;103;151
Pakruojis d. mun.;2011;66;252;104;148
Pakruojis d. mun.;2011;67;261;104;157
Pakruojis d. mun.;2011;68;319;124;195
Pakruojis d. mun.;2011;69;279;105;174
Pakruojis d. mun.;2011;70;247;95;152
Pakruojis d. mun.;2011;71;218;76;142
Pakruojis d. mun.;2011;72;237;87;150
Pakruojis d. mun.;2011;73;253;88;165
Pakruojis d. mun.;2011;74;223;77;146
Pakruojis d. mun.;2011;75;173;62;111
Pakruojis d. mun.;2011;76;194;65;129
Pakruojis d. mun.;2011;77;205;69;136
Pakruojis d. mun.;2011;78;209;69;140
Pakruojis d. mun.;2011;79;170;54;116
Pakruojis d. mun.;2011;80;141;38;103
Pakruojis d. mun.;2011;81;135;35;100
Pakruojis d. mun.;2011;82;146;39;107
Pakruojis d. mun.;2011;83;119;37;82
Pakruojis d. mun.;2011;84;92;21;71
Pakruojis d. mun.;2011;85;421;70;351
Pakruojis d. mun.;2012;-1;23170;10920;12250
Pakruojis d. mun.;2012;0;215;119;96
Pakruojis d. mun.;2012;1;181;83;98
Pakruojis d. mun.;2012;2;177;91;86
Pakruojis d. mun.;2012;3;178;88;90
Pakruojis d. mun.;2012;4;193;98;95
Pakruojis d. mun.;2012;5;189;76;113
Pakruojis d. mun.;2012;6;220;127;93
Pakruojis d. mun.;2012;7;217;118;99
Pakruojis d. mun.;2012;8;248;119;129
Pakruojis d. mun.;2012;9;233;122;111
Pakruojis d. mun.;2012;10;252;119;133
Pakruojis d. mun.;2012;11;286;148;138
Pakruojis d. mun.;2012;12;316;168;148
Pakruojis d. mun.;2012;13;304;149;155
Pakruojis d. mun.;2012;14;296;154;142
Pakruojis d. mun.;2012;15;348;185;163
Pakruojis d. mun.;2012;16;345;170;175
Pakruojis d. mun.;2012;17;374;182;192
Pakruojis d. mun.;2012;18;381;210;171
Pakruojis d. mun.;2012;19;411;200;211
Pakruojis d. mun.;2012;20;337;195;142
Pakruojis d. mun.;2012;21;309;154;155
Pakruojis d. mun.;2012;22;285;147;138
Pakruojis d. mun.;2012;23;258;141;117
Pakruojis d. mun.;2012;24;265;145;120
Pakruojis d. mun.;2012;25;257;144;113
Pakruojis d. mun.;2012;26;242;120;122
Pakruojis d. mun.;2012;27;208;128;80
Pakruojis d. mun.;2012;28;190;113;77
Pakruojis d. mun.;2012;29;193;100;93
Pakruojis d. mun.;2012;30;206;111;95
Pakruojis d. mun.;2012;31;221;109;112
Pakruojis d. mun.;2012;32;217;120;97
Pakruojis d. mun.;2012;33;247;129;118
Pakruojis d. mun.;2012;34;239;108;131
Pakruojis d. mun.;2012;35;263;130;133
Pakruojis d. mun.;2012;36;320;178;142
Pakruojis d. mun.;2012;37;281;130;151
Pakruojis d. mun.;2012;38;287;143;144
Pakruojis d. mun.;2012;39;332;168;164
Pakruojis d. mun.;2012;40;349;166;183
Pakruojis d. mun.;2012;41;379;189;190
Pakruojis d. mun.;2012;42;345;177;168
Pakruojis d. mun.;2012;43;339;178;161
Pakruojis d. mun.;2012;44;355;185;170
Pakruojis d. mun.;2012;45;336;156;180
Pakruojis d. mun.;2012;46;338;175;163
Pakruojis d. mun.;2012;47;380;201;179
Pakruojis d. mun.;2012;48;372;180;192
Pakruojis d. mun.;2012;49;357;182;175
Pakruojis d. mun.;2012;50;359;174;185
Pakruojis d. mun.;2012;51;391;192;199
Pakruojis d. mun.;2012;52;328;166;162
Pakruojis d. mun.;2012;53;354;189;165
Pakruojis d. mun.;2012;54;349;182;167
Pakruojis d. mun.;2012;55;306;145;161
Pakruojis d. mun.;2012;56;304;147;157
Pakruojis d. mun.;2012;57;285;123;162
Pakruojis d. mun.;2012;58;269;116;153
Pakruojis d. mun.;2012;59;283;133;150
Pakruojis d. mun.;2012;60;301;134;167
Pakruojis d. mun.;2012;61;279;124;155
Pakruojis d. mun.;2012;62;295;124;171
Pakruojis d. mun.;2012;63;259;118;141
Pakruojis d. mun.;2012;64;238;101;137
Pakruojis d. mun.;2012;65;204;100;104
Pakruojis d. mun.;2012;66;245;98;147
Pakruojis d. mun.;2012;67;245;98;147
Pakruojis d. mun.;2012;68;255;100;155
Pakruojis d. mun.;2012;69;310;119;191
Pakruojis d. mun.;2012;70;269;98;171
Pakruojis d. mun.;2012;71;244;93;151
Pakruojis d. mun.;2012;72;212;73;139
Pakruojis d. mun.;2012;73;225;79;146
Pakruojis d. mun.;2012;74;239;80;159
Pakruojis d. mun.;2012;75;213;71;142
Pakruojis d. mun.;2012;76;170;62;108
Pakruojis d. mun.;2012;77;185;60;125
Pakruojis d. mun.;2012;78;186;63;123
Pakruojis d. mun.;2012;79;201;65;136
Pakruojis d. mun.;2012;80;160;51;109
Pakruojis d. mun.;2012;81;132;34;98
Pakruojis d. mun.;2012;82;126;30;96
Pakruojis d. mun.;2012;83;133;38;95
Pakruojis d. mun.;2012;84;114;37;77
Pakruojis d. mun.;2012;85;431;75;356
Pakruojis d. mun.;2013;-1;22549;10633;11916
Pakruojis d. mun.;2013;0;189;85;104
Pakruojis d. mun.;2013;1;212;119;93
Pakruojis d. mun.;2013;2;173;79;94
Pakruojis d. mun.;2013;3;167;87;80
Pakruojis d. mun.;2013;4;174;89;85
Pakruojis d. mun.;2013;5;186;95;91
Pakruojis d. mun.;2013;6;189;73;116
Pakruojis d. mun.;2013;7;214;123;91
Pakruojis d. mun.;2013;8;215;117;98
Pakruojis d. mun.;2013;9;246;117;129
Pakruojis d. mun.;2013;10;233;122;111
Pakruojis d. mun.;2013;11;252;119;133
Pakruojis d. mun.;2013;12;283;147;136
Pakruojis d. mun.;2013;13;311;166;145
Pakruojis d. mun.;2013;14;301;150;151
Pakruojis d. mun.;2013;15;293;153;140
Pakruojis d. mun.;2013;16;343;182;161
Pakruojis d. mun.;2013;17;343;169;174
Pakruojis d. mun.;2013;18;375;185;190
Pakruojis d. mun.;2013;19;375;208;167
Pakruojis d. mun.;2013;20;398;192;206
Pakruojis d. mun.;2013;21;322;187;135
Pakruojis d. mun.;2013;22;296;156;140
Pakruojis d. mun.;2013;23;255;133;122
Pakruojis d. mun.;2013;24;241;134;107
Pakruojis d. mun.;2013;25;247;132;115
Pakruojis d. mun.;2013;26;220;123;97
Pakruojis d. mun.;2013;27;211;107;104
Pakruojis d. mun.;2013;28;178;109;69
Pakruojis d. mun.;2013;29;172;103;69
Pakruojis d. mun.;2013;30;186;92;94
Pakruojis d. mun.;2013;31;196;105;91
Pakruojis d. mun.;2013;32;215;107;108
Pakruojis d. mun.;2013;33;206;117;89
Pakruojis d. mun.;2013;34;234;125;109
Pakruojis d. mun.;2013;35;231;106;125
Pakruojis d. mun.;2013;36;256;124;132
Pakruojis d. mun.;2013;37;312;173;139
Pakruojis d. mun.;2013;38;279;128;151
Pakruojis d. mun.;2013;39;286;142;144
Pakruojis d. mun.;2013;40;331;171;160
Pakruojis d. mun.;2013;41;343;165;178
Pakruojis d. mun.;2013;42;371;183;188
Pakruojis d. mun.;2013;43;347;177;170
Pakruojis d. mun.;2013;44;333;176;157
Pakruojis d. mun.;2013;45;344;179;165
Pakruojis d. mun.;2013;46;340;158;182
Pakruojis d. mun.;2013;47;325;170;155
Pakruojis d. mun.;2013;48;377;197;180
Pakruojis d. mun.;2013;49;363;175;188
Pakruojis d. mun.;2013;50;354;183;171
Pakruojis d. mun.;2013;51;358;175;183
Pakruojis d. mun.;2013;52;380;187;193
Pakruojis d. mun.;2013;53;317;157;160
Pakruojis d. mun.;2013;54;342;177;165
Pakruojis d. mun.;2013;55;344;178;166
Pakruojis d. mun.;2013;56;303;144;159
Pakruojis d. mun.;2013;57;293;140;153
Pakruojis d. mun.;2013;58;282;122;160
Pakruojis d. mun.;2013;59;266;113;153
Pakruojis d. mun.;2013;60;277;130;147
Pakruojis d. mun.;2013;61;300;132;168
Pakruojis d. mun.;2013;62;273;120;153
Pakruojis d. mun.;2013;63;288;118;170
Pakruojis d. mun.;2013;64;245;107;138
Pakruojis d. mun.;2013;65;232;99;133
Pakruojis d. mun.;2013;66;195;95;100
Pakruojis d. mun.;2013;67;235;92;143
Pakruojis d. mun.;2013;68;233;91;142
Pakruojis d. mun.;2013;69;250;97;153
Pakruojis d. mun.;2013;70;304;119;185
Pakruojis d. mun.;2013;71;258;95;163
Pakruojis d. mun.;2013;72;240;92;148
Pakruojis d. mun.;2013;73;205;70;135
Pakruojis d. mun.;2013;74;207;73;134
Pakruojis d. mun.;2013;75;227;74;153
Pakruojis d. mun.;2013;76;197;62;135
Pakruojis d. mun.;2013;77;164;58;106
Pakruojis d. mun.;2013;78;172;54;118
Pakruojis d. mun.;2013;79;175;59;116
Pakruojis d. mun.;2013;80;189;58;131
Pakruojis d. mun.;2013;81;151;46;105
Pakruojis d. mun.;2013;82;114;30;84
Pakruojis d. mun.;2013;83;114;29;85
Pakruojis d. mun.;2013;84;117;32;85
Pakruojis d. mun.;2013;85;459;94;365
Pakruojis d. mun.;2014;-1;21979;10360;11619
Pakruojis d. mun.;2014;0;208;92;116
Pakruojis d. mun.;2014;1;185;79;106
Pakruojis d. mun.;2014;2;193;111;82
Pakruojis d. mun.;2014;3;167;80;87
Pakruojis d. mun.;2014;4;166;88;78
Pakruojis d. mun.;2014;5;173;92;81
Pakruojis d. mun.;2014;6;182;93;89
Pakruojis d. mun.;2014;7;189;72;117
Pakruojis d. mun.;2014;8;211;121;90
Pakruojis d. mun.;2014;9;214;119;95
Pakruojis d. mun.;2014;10;241;114;127
Pakruojis d. mun.;2014;11;229;120;109
Pakruojis d. mun.;2014;12;248;116;132
Pakruojis d. mun.;2014;13;276;142;134
Pakruojis d. mun.;2014;14;311;168;143
Pakruojis d. mun.;2014;15;298;147;151
Pakruojis d. mun.;2014;16;292;154;138
Pakruojis d. mun.;2014;17;337;179;158
Pakruojis d. mun.;2014;18;340;169;171
Pakruojis d. mun.;2014;19;356;179;177
Pakruojis d. mun.;2014;20;367;205;162
Pakruojis d. mun.;2014;21;376;179;197
Pakruojis d. mun.;2014;22;299;172;127
Pakruojis d. mun.;2014;23;273;147;126
Pakruojis d. mun.;2014;24;222;122;100
Pakruojis d. mun.;2014;25;219;122;97
Pakruojis d. mun.;2014;26;226;122;104
Pakruojis d. mun.;2014;27;201;108;93
Pakruojis d. mun.;2014;28;194;102;92
Pakruojis d. mun.;2014;29;170;101;69
Pakruojis d. mun.;2014;30;157;100;57
Pakruojis d. mun.;2014;31;162;76;86
Pakruojis d. mun.;2014;32;187;101;86
Pakruojis d. mun.;2014;33;202;99;103
Pakruojis d. mun.;2014;34;197;114;83
Pakruojis d. mun.;2014;35;227;120;107
Pakruojis d. mun.;2014;36;231;106;125
Pakruojis d. mun.;2014;37;253;125;128
Pakruojis d. mun.;2014;38;305;168;137
Pakruojis d. mun.;2014;39;274;126;148
Pakruojis d. mun.;2014;40;278;137;141
Pakruojis d. mun.;2014;41;331;172;159
Pakruojis d. mun.;2014;42;341;166;175
Pakruojis d. mun.;2014;43;367;182;185
Pakruojis d. mun.;2014;44;345;174;171
Pakruojis d. mun.;2014;45;324;171;153
Pakruojis d. mun.;2014;46;340;177;163
Pakruojis d. mun.;2014;47;337;157;180
Pakruojis d. mun.;2014;48;325;168;157
Pakruojis d. mun.;2014;49;375;196;179
Pakruojis d. mun.;2014;50;363;175;188
Pakruojis d. mun.;2014;51;352;183;169
Pakruojis d. mun.;2014;52;359;174;185
Pakruojis d. mun.;2014;53;376;184;192
Pakruojis d. mun.;2014;54;319;159;160
Pakruojis d. mun.;2014;55;343;177;166
Pakruojis d. mun.;2014;56;338;175;163
Pakruojis d. mun.;2014;57;299;141;158
Pakruojis d. mun.;2014;58;288;138;150
Pakruojis d. mun.;2014;59;276;119;157
Pakruojis d. mun.;2014;60;263;110;153
Pakruojis d. mun.;2014;61;270;125;145
Pakruojis d. mun.;2014;62;294;129;165
Pakruojis d. mun.;2014;63;264;116;148
Pakruojis d. mun.;2014;64;280;114;166
Pakruojis d. mun.;2014;65;238;102;136
Pakruojis d. mun.;2014;66;231;98;133
Pakruojis d. mun.;2014;67;187;88;99
Pakruojis d. mun.;2014;68;230;89;141
Pakruojis d. mun.;2014;69;225;88;137
Pakruojis d. mun.;2014;70;238;88;150
Pakruojis d. mun.;2014;71;292;111;181
Pakruojis d. mun.;2014;72;247;88;159
Pakruojis d. mun.;2014;73;225;85;140
Pakruojis d. mun.;2014;74;196;63;133
Pakruojis d. mun.;2014;75;200;70;130
Pakruojis d. mun.;2014;76;210;67;143
Pakruojis d. mun.;2014;77;185;59;126
Pakruojis d. mun.;2014;78;152;53;99
Pakruojis d. mun.;2014;79;158;48;110
Pakruojis d. mun.;2014;80;166;54;112
Pakruojis d. mun.;2014;81;172;49;123
Pakruojis d. mun.;2014;82;138;38;100
Pakruojis d. mun.;2014;83;99;25;74
Pakruojis d. mun.;2014;84;101;26;75
Pakruojis d. mun.;2014;85;484;102;382
Pakruojis d. mun.;2015;-1;21555;10162;11393
Pakruojis d. mun.;2015;0;207;98;109
Pakruojis d. mun.;2015;1;201;91;110
Pakruojis d. mun.;2015;2;182;79;103
Pakruojis d. mun.;2015;3;188;106;82
Pakruojis d. mun.;2015;4;167;78;89
Pakruojis d. mun.;2015;5;164;88;76
Pakruojis d. mun.;2015;6;172;89;83
Pakruojis d. mun.;2015;7;183;94;89
Pakruojis d. mun.;2015;8;190;73;117
Pakruojis d. mun.;2015;9;211;119;92
Pakruojis d. mun.;2015;10;212;118;94
Pakruojis d. mun.;2015;11;243;116;127
Pakruojis d. mun.;2015;12;231;121;110
Pakruojis d. mun.;2015;13;243;113;130
Pakruojis d. mun.;2015;14;278;142;136
Pakruojis d. mun.;2015;15;312;168;144
Pakruojis d. mun.;2015;16;297;146;151
Pakruojis d. mun.;2015;17;291;156;135
Pakruojis d. mun.;2015;18;332;177;155
Pakruojis d. mun.;2015;19;330;166;164
Pakruojis d. mun.;2015;20;348;175;173
Pakruojis d. mun.;2015;21;356;198;158
Pakruojis d. mun.;2015;22;368;170;198
Pakruojis d. mun.;2015;23;278;172;106
Pakruojis d. mun.;2015;24;237;139;98
Pakruojis d. mun.;2015;25;205;111;94
Pakruojis d. mun.;2015;26;193;111;82
Pakruojis d. mun.;2015;27;204;115;89
Pakruojis d. mun.;2015;28;181;96;85
Pakruojis d. mun.;2015;29;183;93;90
Pakruojis d. mun.;2015;30;165;97;68
Pakruojis d. mun.;2015;31;149;96;53
Pakruojis d. mun.;2015;32;160;70;90
Pakruojis d. mun.;2015;33;178;96;82
Pakruojis d. mun.;2015;34;200;93;107
Pakruojis d. mun.;2015;35;193;114;79
Pakruojis d. mun.;2015;36;226;122;104
Pakruojis d. mun.;2015;37;225;101;124
Pakruojis d. mun.;2015;38;250;126;124
Pakruojis d. mun.;2015;39;302;163;139
Pakruojis d. mun.;2015;40;276;128;148
Pakruojis d. mun.;2015;41;279;137;142
Pakruojis d. mun.;2015;42;325;172;153
Pakruojis d. mun.;2015;43;343;166;177
Pakruojis d. mun.;2015;44;361;181;180
Pakruojis d. mun.;2015;45;339;168;171
Pakruojis d. mun.;2015;46;319;167;152
Pakruojis d. mun.;2015;47;336;172;164
Pakruojis d. mun.;2015;48;338;157;181
Pakruojis d. mun.;2015;49;323;169;154
Pakruojis d. mun.;2015;50;369;193;176
Pakruojis d. mun.;2015;51;358;174;184
Pakruojis d. mun.;2015;52;350;183;167
Pakruojis d. mun.;2015;53;354;169;185
Pakruojis d. mun.;2015;54;369;183;186
Pakruojis d. mun.;2015;55;314;154;160
Pakruojis d. mun.;2015;56;336;173;163
Pakruojis d. mun.;2015;57;332;169;163
Pakruojis d. mun.;2015;58;297;139;158
Pakruojis d. mun.;2015;59;283;133;150
Pakruojis d. mun.;2015;60;264;116;148
Pakruojis d. mun.;2015;61;257;108;149
Pakruojis d. mun.;2015;62;261;120;141
Pakruojis d. mun.;2015;63;283;123;160
Pakruojis d. mun.;2015;64;261;114;147
Pakruojis d. mun.;2015;65;272;109;163
Pakruojis d. mun.;2015;66;235;99;136
Pakruojis d. mun.;2015;67;226;95;131
Pakruojis d. mun.;2015;68;181;85;96
Pakruojis d. mun.;2015;69;225;86;139
Pakruojis d. mun.;2015;70;220;86;134
Pakruojis d. mun.;2015;71;236;88;148
Pakruojis d. mun.;2015;72;280;103;177
Pakruojis d. mun.;2015;73;239;84;155
Pakruojis d. mun.;2015;74;210;79;131
Pakruojis d. mun.;2015;75;190;59;131
Pakruojis d. mun.;2015;76;189;65;124
Pakruojis d. mun.;2015;77;199;61;138
Pakruojis d. mun.;2015;78;174;55;119
Pakruojis d. mun.;2015;79;147;49;98
Pakruojis d. mun.;2015;80;148;44;104
Pakruojis d. mun.;2015;81;158;48;110
Pakruojis d. mun.;2015;82;156;42;114
Pakruojis d. mun.;2015;83;127;32;95
Pakruojis d. mun.;2015;84;87;23;64
Pakruojis d. mun.;2015;85;494;106;388
Pakruojis d. mun.;2016;-1;20956;9830;11126
Pakruojis d. mun.;2016;0;167;81;86
Pakruojis d. mun.;2016;1;205;98;107
Pakruojis d. mun.;2016;2;191;84;107
Pakruojis d. mun.;2016;3;177;76;101
Pakruojis d. mun.;2016;4;180;104;76
Pakruojis d. mun.;2016;5;165;75;90
Pakruojis d. mun.;2016;6;152;83;69
Pakruojis d. mun.;2016;7;169;85;84
Pakruojis d. mun.;2016;8;178;89;89
Pakruojis d. mun.;2016;9;187;71;116
Pakruojis d. mun.;2016;10;206;115;91
Pakruojis d. mun.;2016;11;210;117;93
Pakruojis d. mun.;2016;12;245;115;130
Pakruojis d. mun.;2016;13;232;121;111
Pakruojis d. mun.;2016;14;238;110;128
Pakruojis d. mun.;2016;15;270;138;132
Pakruojis d. mun.;2016;16;307;162;145
Pakruojis d. mun.;2016;17;295;144;151
Pakruojis d. mun.;2016;18;280;150;130
Pakruojis d. mun.;2016;19;322;170;152
Pakruojis d. mun.;2016;20;314;161;153
Pakruojis d. mun.;2016;21;337;174;163
Pakruojis d. mun.;2016;22;338;187;151
Pakruojis d. mun.;2016;23;359;164;195
Pakruojis d. mun.;2016;24;261;160;101
Pakruojis d. mun.;2016;25;223;128;95
Pakruojis d. mun.;2016;26;188;105;83
Pakruojis d. mun.;2016;27;173;98;75
Pakruojis d. mun.;2016;28;185;108;77
Pakruojis d. mun.;2016;29;157;86;71
Pakruojis d. mun.;2016;30;167;81;86
Pakruojis d. mun.;2016;31;147;89;58
Pakruojis d. mun.;2016;32;136;87;49
Pakruojis d. mun.;2016;33;147;58;89
Pakruojis d. mun.;2016;34;171;87;84
Pakruojis d. mun.;2016;35;191;90;101
Pakruojis d. mun.;2016;36;186;107;79
Pakruojis d. mun.;2016;37;220;118;102
Pakruojis d. mun.;2016;38;217;97;120
Pakruojis d. mun.;2016;39;249;126;123
Pakruojis d. mun.;2016;40;292;157;135
Pakruojis d. mun.;2016;41;268;123;145
Pakruojis d. mun.;2016;42;272;137;135
Pakruojis d. mun.;2016;43;325;175;150
Pakruojis d. mun.;2016;44;333;160;173
Pakruojis d. mun.;2016;45;358;179;179
Pakruojis d. mun.;2016;46;338;166;172
Pakruojis d. mun.;2016;47;319;165;154
Pakruojis d. mun.;2016;48;331;168;163
Pakruojis d. mun.;2016;49;333;154;179
Pakruojis d. mun.;2016;50;314;163;151
Pakruojis d. mun.;2016;51;360;188;172
Pakruojis d. mun.;2016;52;354;173;181
Pakruojis d. mun.;2016;53;348;182;166
Pakruojis d. mun.;2016;54;349;164;185
Pakruojis d. mun.;2016;55;363;178;185
Pakruojis d. mun.;2016;56;311;154;157
Pakruojis d. mun.;2016;57;336;171;165
Pakruojis d. mun.;2016;58;329;166;163
Pakruojis d. mun.;2016;59;292;138;154
Pakruojis d. mun.;2016;60;274;127;147
Pakruojis d. mun.;2016;61;264;118;146
Pakruojis d. mun.;2016;62;250;105;145
Pakruojis d. mun.;2016;63;256;117;139
Pakruojis d. mun.;2016;64;272;120;152
Pakruojis d. mun.;2016;65;252;106;146
Pakruojis d. mun.;2016;66;270;107;163
Pakruojis d. mun.;2016;67;225;93;132
Pakruojis d. mun.;2016;68;219;89;130
Pakruojis d. mun.;2016;69;177;83;94
Pakruojis d. mun.;2016;70;218;83;135
Pakruojis d. mun.;2016;71;215;82;133
Pakruojis d. mun.;2016;72;232;87;145
Pakruojis d. mun.;2016;73;268;98;170
Pakruojis d. mun.;2016;74;224;75;149
Pakruojis d. mun.;2016;75;200;75;125
Pakruojis d. mun.;2016;76;181;52;129
Pakruojis d. mun.;2016;77;178;58;120
Pakruojis d. mun.;2016;78;182;49;133
Pakruojis d. mun.;2016;79;167;51;116
Pakruojis d. mun.;2016;80;142;47;95
Pakruojis d. mun.;2016;81;137;39;98
Pakruojis d. mun.;2016;82;142;37;105
Pakruojis d. mun.;2016;83;145;39;106
Pakruojis d. mun.;2016;84;116;28;88
Pakruojis d. mun.;2016;85;483;105;378
Pakruojis d. mun.;2017;-1;20311;9529;10782
Pakruojis d. mun.;2017;0;192;115;77
Pakruojis d. mun.;2017;1;161;77;84
Pakruojis d. mun.;2017;2;197;94;103
Pakruojis d. mun.;2017;3;190;82;108
Pakruojis d. mun.;2017;4;169;71;98
Pakruojis d. mun.;2017;5;179;102;77
Pakruojis d. mun.;2017;6;156;72;84
Pakruojis d. mun.;2017;7;144;78;66
Pakruojis d. mun.;2017;8;167;88;79
Pakruojis d. mun.;2017;9;170;84;86
Pakruojis d. mun.;2017;10;189;72;117
Pakruojis d. mun.;2017;11;205;114;91
Pakruojis d. mun.;2017;12;204;113;91
Pakruojis d. mun.;2017;13;247;118;129
Pakruojis d. mun.;2017;14;226;116;110
Pakruojis d. mun.;2017;15;234;108;126
Pakruojis d. mun.;2017;16;268;138;130
Pakruojis d. mun.;2017;17;308;164;144
Pakruojis d. mun.;2017;18;290;139;151
Pakruojis d. mun.;2017;19;274;148;126
Pakruojis d. mun.;2017;20;302;161;141
Pakruojis d. mun.;2017;21;306;156;150
Pakruojis d. mun.;2017;22;312;157;155
Pakruojis d. mun.;2017;23;318;184;134
Pakruojis d. mun.;2017;24;338;156;182
Pakruojis d. mun.;2017;25;233;149;84
Pakruojis d. mun.;2017;26;191;112;79
Pakruojis d. mun.;2017;27;169;99;70
Pakruojis d. mun.;2017;28;145;84;61
Pakruojis d. mun.;2017;29;167;97;70
Pakruojis d. mun.;2017;30;136;73;63
Pakruojis d. mun.;2017;31;145;71;74
Pakruojis d. mun.;2017;32;131;81;50
Pakruojis d. mun.;2017;33;118;74;44
Pakruojis d. mun.;2017;34;132;51;81
Pakruojis d. mun.;2017;35;158;77;81
Pakruojis d. mun.;2017;36;174;78;96
Pakruojis d. mun.;2017;37;179;99;80
Pakruojis d. mun.;2017;38;212;112;100
Pakruojis d. mun.;2017;39;212;95;117
Pakruojis d. mun.;2017;40;242;125;117
Pakruojis d. mun.;2017;41;290;158;132
Pakruojis d. mun.;2017;42;261;119;142
Pakruojis d. mun.;2017;43;266;135;131
Pakruojis d. mun.;2017;44;320;172;148
Pakruojis d. mun.;2017;45;327;156;171
Pakruojis d. mun.;2017;46;352;175;177
Pakruojis d. mun.;2017;47;329;161;168
Pakruojis d. mun.;2017;48;315;162;153
Pakruojis d. mun.;2017;49;317;158;159
Pakruojis d. mun.;2017;50;327;152;175
Pakruojis d. mun.;2017;51;312;163;149
Pakruojis d. mun.;2017;52;350;180;170
Pakruojis d. mun.;2017;53;345;166;179
Pakruojis d. mun.;2017;54;342;177;165
Pakruojis d. mun.;2017;55;345;162;183
Pakruojis d. mun.;2017;56;363;180;183
Pakruojis d. mun.;2017;57;307;151;156
Pakruojis d. mun.;2017;58;332;171;161
Pakruojis d. mun.;2017;59;325;160;165
Pakruojis d. mun.;2017;60;289;136;153
Pakruojis d. mun.;2017;61;271;127;144
Pakruojis d. mun.;2017;62;256;113;143
Pakruojis d. mun.;2017;63;246;101;145
Pakruojis d. mun.;2017;64;247;109;138
Pakruojis d. mun.;2017;65;263;114;149
Pakruojis d. mun.;2017;66;247;102;145
Pakruojis d. mun.;2017;67;263;105;158
Pakruojis d. mun.;2017;68;218;88;130
Pakruojis d. mun.;2017;69;211;82;129
Pakruojis d. mun.;2017;70;171;79;92
Pakruojis d. mun.;2017;71;210;80;130
Pakruojis d. mun.;2017;72;208;78;130
Pakruojis d. mun.;2017;73;222;81;141
Pakruojis d. mun.;2017;74;258;96;162
Pakruojis d. mun.;2017;75;216;72;144
Pakruojis d. mun.;2017;76;188;69;119
Pakruojis d. mun.;2017;77;177;51;126
Pakruojis d. mun.;2017;78;167;55;112
Pakruojis d. mun.;2017;79;169;46;123
Pakruojis d. mun.;2017;80;162;48;114
Pakruojis d. mun.;2017;81;129;40;89
Pakruojis d. mun.;2017;82;124;36;88
Pakruojis d. mun.;2017;83;131;33;98
Pakruojis d. mun.;2017;84;134;33;101
Pakruojis d. mun.;2017;85;519;113;406
Pakruojis d. mun.;2018;-1;19546;9160;10386
Pakruojis d. mun.;2018;0;171;83;88
Pakruojis d. mun.;2018;1;185;108;77
Pakruojis d. mun.;2018;2;153;73;80
Pakruojis d. mun.;2018;3;190;90;100
Pakruojis d. mun.;2018;4;187;82;105
Pakruojis d. mun.;2018;5;166;72;94
Pakruojis d. mun.;2018;6;179;101;78
Pakruojis d. mun.;2018;7;154;70;84
Pakruojis d. mun.;2018;8;144;79;65
Pakruojis d. mun.;2018;9;167;89;78
Pakruojis d. mun.;2018;10;165;83;82
Pakruojis d. mun.;2018;11;188;72;116
Pakruojis d. mun.;2018;12;198;110;88
Pakruojis d. mun.;2018;13;198;107;91
Pakruojis d. mun.;2018;14;244;117;127
Pakruojis d. mun.;2018;15;220;111;109
Pakruojis d. mun.;2018;16;233;108;125
Pakruojis d. mun.;2018;17;261;135;126
Pakruojis d. mun.;2018;18;295;157;138
Pakruojis d. mun.;2018;19;269;131;138
Pakruojis d. mun.;2018;20;249;136;113
Pakruojis d. mun.;2018;21;275;150;125
Pakruojis d. mun.;2018;22;274;139;135
Pakruojis d. mun.;2018;23;295;152;143
Pakruojis d. mun.;2018;24;279;169;110
Pakruojis d. mun.;2018;25;305;145;160
Pakruojis d. mun.;2018;26;206;141;65
Pakruojis d. mun.;2018;27;170;103;67
Pakruojis d. mun.;2018;28;151;89;62
Pakruojis d. mun.;2018;29;123;71;52
Pakruojis d. mun.;2018;30;150;89;61
Pakruojis d. mun.;2018;31;125;63;62
Pakruojis d. mun.;2018;32;130;65;65
Pakruojis d. mun.;2018;33;120;76;44
Pakruojis d. mun.;2018;34;107;65;42
Pakruojis d. mun.;2018;35;119;45;74
Pakruojis d. mun.;2018;36;149;71;78
Pakruojis d. mun.;2018;37;164;71;93
Pakruojis d. mun.;2018;38;175;97;78
Pakruojis d. mun.;2018;39;204;107;97
Pakruojis d. mun.;2018;40;206;90;116
Pakruojis d. mun.;2018;41;236;123;113
Pakruojis d. mun.;2018;42;276;150;126
Pakruojis d. mun.;2018;43;247;111;136
Pakruojis d. mun.;2018;44;264;134;130
Pakruojis d. mun.;2018;45;315;170;145
Pakruojis d. mun.;2018;46;321;155;166
Pakruojis d. mun.;2018;47;343;170;173
Pakruojis d. mun.;2018;48;321;156;165
Pakruojis d. mun.;2018;49;315;163;152
Pakruojis d. mun.;2018;50;311;153;158
Pakruojis d. mun.;2018;51;317;146;171
Pakruojis d. mun.;2018;52;303;158;145
Pakruojis d. mun.;2018;53;346;178;168
Pakruojis d. mun.;2018;54;341;163;178
Pakruojis d. mun.;2018;55;332;169;163
Pakruojis d. mun.;2018;56;341;160;181
Pakruojis d. mun.;2018;57;360;176;184
Pakruojis d. mun.;2018;58;302;148;154
Pakruojis d. mun.;2018;59;324;166;158
Pakruojis d. mun.;2018;60;319;158;161
Pakruojis d. mun.;2018;61;283;133;150
Pakruojis d. mun.;2018;62;268;126;142
Pakruojis d. mun.;2018;63;246;108;138
Pakruojis d. mun.;2018;64;242;98;144
Pakruojis d. mun.;2018;65;238;101;137
Pakruojis d. mun.;2018;66;252;109;143
Pakruojis d. mun.;2018;67;242;100;142
Pakruojis d. mun.;2018;68;255;99;156
Pakruojis d. mun.;2018;69;205;82;123
Pakruojis d. mun.;2018;70;200;78;122
Pakruojis d. mun.;2018;71;161;69;92
Pakruojis d. mun.;2018;72;203;74;129
Pakruojis d. mun.;2018;73;200;71;129
Pakruojis d. mun.;2018;74;209;74;135
Pakruojis d. mun.;2018;75;249;93;156
Pakruojis d. mun.;2018;76;208;68;140
Pakruojis d. mun.;2018;77;176;62;114
Pakruojis d. mun.;2018;78;164;46;118
Pakruojis d. mun.;2018;79;154;48;106
Pakruojis d. mun.;2018;80;161;43;118
Pakruojis d. mun.;2018;81;147;42;105
Pakruojis d. mun.;2018;82;122;38;84
Pakruojis d. mun.;2018;83;116;33;83
Pakruojis d. mun.;2018;84;124;31;93
Pakruojis d. mun.;2018;85;544;115;429
Palanga t. mun.;2001;-1;17619;8071;9548
Palanga t. mun.;2001;0;154;78;76
Palanga t. mun.;2001;1;147;67;80
Palanga t. mun.;2001;2;144;78;66
Palanga t. mun.;2001;3;185;91;94
Palanga t. mun.;2001;4;179;87;92
Palanga t. mun.;2001;5;195;102;93
Palanga t. mun.;2001;6;224;110;114
Palanga t. mun.;2001;7;229;118;111
Palanga t. mun.;2001;8;253;132;121
Palanga t. mun.;2001;9;245;126;119
Palanga t. mun.;2001;10;317;167;150
Palanga t. mun.;2001;11;269;135;134
Palanga t. mun.;2001;12;310;160;150
Palanga t. mun.;2001;13;299;166;133
Palanga t. mun.;2001;14;318;176;142
Palanga t. mun.;2001;15;276;151;125
Palanga t. mun.;2001;16;319;168;151
Palanga t. mun.;2001;17;272;137;135
Palanga t. mun.;2001;18;265;146;119
Palanga t. mun.;2001;19;210;121;89
Palanga t. mun.;2001;20;204;98;106
Palanga t. mun.;2001;21;214;112;102
Palanga t. mun.;2001;22;195;114;81
Palanga t. mun.;2001;23;224;131;93
Palanga t. mun.;2001;24;256;126;130
Palanga t. mun.;2001;25;231;115;116
Palanga t. mun.;2001;26;208;103;105
Palanga t. mun.;2001;27;231;122;109
Palanga t. mun.;2001;28;263;119;144
Palanga t. mun.;2001;29;235;125;110
Palanga t. mun.;2001;30;255;114;141
Palanga t. mun.;2001;31;238;105;133
Palanga t. mun.;2001;32;233;111;122
Palanga t. mun.;2001;33;242;111;131
Palanga t. mun.;2001;34;270;114;156
Palanga t. mun.;2001;35;291;135;156
Palanga t. mun.;2001;36;291;137;154
Palanga t. mun.;2001;37;291;132;159
Palanga t. mun.;2001;38;280;131;149
Palanga t. mun.;2001;39;318;142;176
Palanga t. mun.;2001;40;294;130;164
Palanga t. mun.;2001;41;332;137;195
Palanga t. mun.;2001;42;299;133;166
Palanga t. mun.;2001;43;319;150;169
Palanga t. mun.;2001;44;254;112;142
Palanga t. mun.;2001;45;258;123;135
Palanga t. mun.;2001;46;234;112;122
Palanga t. mun.;2001;47;222;101;121
Palanga t. mun.;2001;48;217;96;121
Palanga t. mun.;2001;49;235;107;128
Palanga t. mun.;2001;50;253;101;152
Palanga t. mun.;2001;51;209;100;109
Palanga t. mun.;2001;52;201;79;122
Palanga t. mun.;2001;53;166;75;91
Palanga t. mun.;2001;54;186;69;117
Palanga t. mun.;2001;55;188;75;113
Palanga t. mun.;2001;56;185;63;122
Palanga t. mun.;2001;57;179;81;98
Palanga t. mun.;2001;58;184;79;105
Palanga t. mun.;2001;59;194;86;108
Palanga t. mun.;2001;60;191;74;117
Palanga t. mun.;2001;61;169;67;102
Palanga t. mun.;2001;62;187;72;115
Palanga t. mun.;2001;63;170;69;101
Palanga t. mun.;2001;64;207;72;135
Palanga t. mun.;2001;65;162;68;94
Palanga t. mun.;2001;66;152;53;99
Palanga t. mun.;2001;67;167;56;111
Palanga t. mun.;2001;68;138;59;79
Palanga t. mun.;2001;69;157;60;97
Palanga t. mun.;2001;70;157;61;96
Palanga t. mun.;2001;71;129;53;76
Palanga t. mun.;2001;72;158;48;110
Palanga t. mun.;2001;73;126;53;73
Palanga t. mun.;2001;74;132;46;86
Palanga t. mun.;2001;75;124;30;94
Palanga t. mun.;2001;76;85;27;58
Palanga t. mun.;2001;77;98;28;70
Palanga t. mun.;2001;78;88;23;65
Palanga t. mun.;2001;79;64;17;47
Palanga t. mun.;2001;80;50;14;36
Palanga t. mun.;2001;81;57;15;42
Palanga t. mun.;2001;82;30;9;21
Palanga t. mun.;2001;83;28;10;18
Palanga t. mun.;2001;84;25;5;20
Palanga t. mun.;2001;85;179;60;119
Palanga t. mun.;2002;-1;17372;7964;9408
Palanga t. mun.;2002;0;136;67;69
Palanga t. mun.;2002;1;154;79;75
Palanga t. mun.;2002;2;146;68;78
Palanga t. mun.;2002;3;142;77;65
Palanga t. mun.;2002;4;185;92;93
Palanga t. mun.;2002;5;179;87;92
Palanga t. mun.;2002;6;190;102;88
Palanga t. mun.;2002;7;220;109;111
Palanga t. mun.;2002;8;224;114;110
Palanga t. mun.;2002;9;249;130;119
Palanga t. mun.;2002;10;243;125;118
Palanga t. mun.;2002;11;312;164;148
Palanga t. mun.;2002;12;263;133;130
Palanga t. mun.;2002;13;302;153;149
Palanga t. mun.;2002;14;297;165;132
Palanga t. mun.;2002;15;313;171;142
Palanga t. mun.;2002;16;271;149;122
Palanga t. mun.;2002;17;313;165;148
Palanga t. mun.;2002;18;266;133;133
Palanga t. mun.;2002;19;253;141;112
Palanga t. mun.;2002;20;200;117;83
Palanga t. mun.;2002;21;200;96;104
Palanga t. mun.;2002;22;206;111;95
Palanga t. mun.;2002;23;188;109;79
Palanga t. mun.;2002;24;221;127;94
Palanga t. mun.;2002;25;247;120;127
Palanga t. mun.;2002;26;228;115;113
Palanga t. mun.;2002;27;204;99;105
Palanga t. mun.;2002;28;229;122;107
Palanga t. mun.;2002;29;257;115;142
Palanga t. mun.;2002;30;232;122;110
Palanga t. mun.;2002;31;247;110;137
Palanga t. mun.;2002;32;228;103;125
Palanga t. mun.;2002;33;231;110;121
Palanga t. mun.;2002;34;237;110;127
Palanga t. mun.;2002;35;260;107;153
Palanga t. mun.;2002;36;287;129;158
Palanga t. mun.;2002;37;286;135;151
Palanga t. mun.;2002;38;283;128;155
Palanga t. mun.;2002;39;275;126;149
Palanga t. mun.;2002;40;310;140;170
Palanga t. mun.;2002;41;288;127;161
Palanga t. mun.;2002;42;326;134;192
Palanga t. mun.;2002;43;292;131;161
Palanga t. mun.;2002;44;316;148;168
Palanga t. mun.;2002;45;247;108;139
Palanga t. mun.;2002;46;255;124;131
Palanga t. mun.;2002;47;233;113;120
Palanga t. mun.;2002;48;217;99;118
Palanga t. mun.;2002;49;214;95;119
Palanga t. mun.;2002;50;232;105;127
Palanga t. mun.;2002;51;245;99;146
Palanga t. mun.;2002;52;206;99;107
Palanga t. mun.;2002;53;201;80;121
Palanga t. mun.;2002;54;161;73;88
Palanga t. mun.;2002;55;178;65;113
Palanga t. mun.;2002;56;187;77;110
Palanga t. mun.;2002;57;180;62;118
Palanga t. mun.;2002;58;174;80;94
Palanga t. mun.;2002;59;174;76;98
Palanga t. mun.;2002;60;194;87;107
Palanga t. mun.;2002;61;187;74;113
Palanga t. mun.;2002;62;173;68;105
Palanga t. mun.;2002;63;185;69;116
Palanga t. mun.;2002;64;168;66;102
Palanga t. mun.;2002;65;203;68;135
Palanga t. mun.;2002;66;157;65;92
Palanga t. mun.;2002;67;146;52;94
Palanga t. mun.;2002;68;163;52;111
Palanga t. mun.;2002;69;138;58;80
Palanga t. mun.;2002;70;155;61;94
Palanga t. mun.;2002;71;157;62;95
Palanga t. mun.;2002;72;126;51;75
Palanga t. mun.;2002;73;158;49;109
Palanga t. mun.;2002;74;124;53;71
Palanga t. mun.;2002;75;126;44;82
Palanga t. mun.;2002;76;120;27;93
Palanga t. mun.;2002;77;82;24;58
Palanga t. mun.;2002;78;92;26;66
Palanga t. mun.;2002;79;84;21;63
Palanga t. mun.;2002;80;63;17;46
Palanga t. mun.;2002;81;48;14;34
Palanga t. mun.;2002;82;51;13;38
Palanga t. mun.;2002;83;29;10;19
Palanga t. mun.;2002;84;25;8;17
Palanga t. mun.;2002;85;178;55;123
Palanga t. mun.;2003;-1;17324;7956;9368
Palanga t. mun.;2003;0;119;69;50
Palanga t. mun.;2003;1;131;65;66
Palanga t. mun.;2003;2;154;80;74
Palanga t. mun.;2003;3;146;70;76
Palanga t. mun.;2003;4;142;77;65
Palanga t. mun.;2003;5;185;92;93
Palanga t. mun.;2003;6;181;88;93
Palanga t. mun.;2003;7;188;100;88
Palanga t. mun.;2003;8;222;111;111
Palanga t. mun.;2003;9;226;117;109
Palanga t. mun.;2003;10;250;130;120
Palanga t. mun.;2003;11;237;122;115
Palanga t. mun.;2003;12;310;164;146
Palanga t. mun.;2003;13;265;134;131
Palanga t. mun.;2003;14;296;149;147
Palanga t. mun.;2003;15;294;165;129
Palanga t. mun.;2003;16;305;169;136
Palanga t. mun.;2003;17;268;147;121
Palanga t. mun.;2003;18;311;165;146
Palanga t. mun.;2003;19;265;132;133
Palanga t. mun.;2003;20;251;139;112
Palanga t. mun.;2003;21;199;119;80
Palanga t. mun.;2003;22;195;98;97
Palanga t. mun.;2003;23;202;111;91
Palanga t. mun.;2003;24;189;104;85
Palanga t. mun.;2003;25;226;127;99
Palanga t. mun.;2003;26;249;120;129
Palanga t. mun.;2003;27;226;115;111
Palanga t. mun.;2003;28;200;96;104
Palanga t. mun.;2003;29;236;122;114
Palanga t. mun.;2003;30;254;115;139
Palanga t. mun.;2003;31;233;123;110
Palanga t. mun.;2003;32;251;113;138
Palanga t. mun.;2003;33;227;104;123
Palanga t. mun.;2003;34;231;109;122
Palanga t. mun.;2003;35;236;110;126
Palanga t. mun.;2003;36;257;109;148
Palanga t. mun.;2003;37;282;124;158
Palanga t. mun.;2003;38;285;133;152
Palanga t. mun.;2003;39;286;130;156
Palanga t. mun.;2003;40;271;124;147
Palanga t. mun.;2003;41;307;140;167
Palanga t. mun.;2003;42;287;127;160
Palanga t. mun.;2003;43;329;137;192
Palanga t. mun.;2003;44;288;131;157
Palanga t. mun.;2003;45;311;144;167
Palanga t. mun.;2003;46;246;108;138
Palanga t. mun.;2003;47;252;123;129
Palanga t. mun.;2003;48;226;109;117
Palanga t. mun.;2003;49;213;96;117
Palanga t. mun.;2003;50;207;87;120
Palanga t. mun.;2003;51;230;102;128
Palanga t. mun.;2003;52;247;99;148
Palanga t. mun.;2003;53;208;100;108
Palanga t. mun.;2003;54;200;81;119
Palanga t. mun.;2003;55;162;73;89
Palanga t. mun.;2003;56;180;65;115
Palanga t. mun.;2003;57;180;74;106
Palanga t. mun.;2003;58;181;61;120
Palanga t. mun.;2003;59;173;78;95
Palanga t. mun.;2003;60;172;74;98
Palanga t. mun.;2003;61;193;86;107
Palanga t. mun.;2003;62;189;75;114
Palanga t. mun.;2003;63;175;71;104
Palanga t. mun.;2003;64;188;71;117
Palanga t. mun.;2003;65;170;66;104
Palanga t. mun.;2003;66;203;70;133
Palanga t. mun.;2003;67;156;64;92
Palanga t. mun.;2003;68;145;51;94
Palanga t. mun.;2003;69;162;49;113
Palanga t. mun.;2003;70;138;59;79
Palanga t. mun.;2003;71;153;58;95
Palanga t. mun.;2003;72;149;57;92
Palanga t. mun.;2003;73;122;50;72
Palanga t. mun.;2003;74;156;47;109
Palanga t. mun.;2003;75;125;53;72
Palanga t. mun.;2003;76;124;42;82
Palanga t. mun.;2003;77;115;24;91
Palanga t. mun.;2003;78;77;22;55
Palanga t. mun.;2003;79;90;28;62
Palanga t. mun.;2003;80;79;19;60
Palanga t. mun.;2003;81;58;15;43
Palanga t. mun.;2003;82;41;12;29
Palanga t. mun.;2003;83;42;9;33
Palanga t. mun.;2003;84;22;8;14
Palanga t. mun.;2003;85;172;50;122
Palanga t. mun.;2004;-1;17222;7883;9339
Palanga t. mun.;2004;0;145;69;76
Palanga t. mun.;2004;1;121;72;49
Palanga t. mun.;2004;2;131;66;65
Palanga t. mun.;2004;3;158;85;73
Palanga t. mun.;2004;4;145;70;75
Palanga t. mun.;2004;5;148;84;64
Palanga t. mun.;2004;6;181;90;91
Palanga t. mun.;2004;7;181;91;90
Palanga t. mun.;2004;8;187;98;89
Palanga t. mun.;2004;9;226;114;112
Palanga t. mun.;2004;10;229;121;108
Palanga t. mun.;2004;11;254;133;121
Palanga t. mun.;2004;12;233;124;109
Palanga t. mun.;2004;13;307;164;143
Palanga t. mun.;2004;14;260;132;128
Palanga t. mun.;2004;15;299;147;152
Palanga t. mun.;2004;16;297;164;133
Palanga t. mun.;2004;17;302;165;137
Palanga t. mun.;2004;18;256;136;120
Palanga t. mun.;2004;19;302;160;142
Palanga t. mun.;2004;20;255;125;130
Palanga t. mun.;2004;21;239;134;105
Palanga t. mun.;2004;22;194;112;82
Palanga t. mun.;2004;23;183;89;94
Palanga t. mun.;2004;24;196;104;92
Palanga t. mun.;2004;25;190;101;89
Palanga t. mun.;2004;26;217;126;91
Palanga t. mun.;2004;27;245;119;126
Palanga t. mun.;2004;28;223;115;108
Palanga t. mun.;2004;29;197;92;105
Palanga t. mun.;2004;30;224;117;107
Palanga t. mun.;2004;31;255;114;141
Palanga t. mun.;2004;32;225;118;107
Palanga t. mun.;2004;33;245;109;136
Palanga t. mun.;2004;34;216;100;116
Palanga t. mun.;2004;35;228;105;123
Palanga t. mun.;2004;36;230;107;123
Palanga t. mun.;2004;37;254;110;144
Palanga t. mun.;2004;38;285;124;161
Palanga t. mun.;2004;39;279;131;148
Palanga t. mun.;2004;40;282;128;154
Palanga t. mun.;2004;41;266;124;142
Palanga t. mun.;2004;42;305;138;167
Palanga t. mun.;2004;43;285;124;161
Palanga t. mun.;2004;44;330;139;191
Palanga t. mun.;2004;45;280;128;152
Palanga t. mun.;2004;46;304;141;163
Palanga t. mun.;2004;47;241;105;136
Palanga t. mun.;2004;48;246;121;125
Palanga t. mun.;2004;49;227;108;119
Palanga t. mun.;2004;50;206;95;111
Palanga t. mun.;2004;51;206;88;118
Palanga t. mun.;2004;52;226;99;127
Palanga t. mun.;2004;53;244;98;146
Palanga t. mun.;2004;54;212;100;112
Palanga t. mun.;2004;55;201;80;121
Palanga t. mun.;2004;56;161;70;91
Palanga t. mun.;2004;57;177;62;115
Palanga t. mun.;2004;58;178;68;110
Palanga t. mun.;2004;59;183;63;120
Palanga t. mun.;2004;60;176;78;98
Palanga t. mun.;2004;61;174;74;100
Palanga t. mun.;2004;62;194;86;108
Palanga t. mun.;2004;63;190;76;114
Palanga t. mun.;2004;64;172;71;101
Palanga t. mun.;2004;65;187;68;119
Palanga t. mun.;2004;66;164;60;104
Palanga t. mun.;2004;67;196;62;134
Palanga t. mun.;2004;68;155;60;95
Palanga t. mun.;2004;69;150;50;100
Palanga t. mun.;2004;70;164;50;114
Palanga t. mun.;2004;71;134;57;77
Palanga t. mun.;2004;72;149;57;92
Palanga t. mun.;2004;73;151;59;92
Palanga t. mun.;2004;74;121;48;73
Palanga t. mun.;2004;75;155;47;108
Palanga t. mun.;2004;76;122;50;72
Palanga t. mun.;2004;77;115;39;76
Palanga t. mun.;2004;78;110;22;88
Palanga t. mun.;2004;79;74;21;53
Palanga t. mun.;2004;80;82;24;58
Palanga t. mun.;2004;81;77;18;59
Palanga t. mun.;2004;82;54;15;39
Palanga t. mun.;2004;83;39;12;27
Palanga t. mun.;2004;84;42;10;32
Palanga t. mun.;2004;85;173;53;120
Palanga t. mun.;2005;-1;17048;7797;9251
Palanga t. mun.;2005;0;133;68;65
Palanga t. mun.;2005;1;141;69;72
Palanga t. mun.;2005;2;120;70;50
Palanga t. mun.;2005;3;134;69;65
Palanga t. mun.;2005;4;157;83;74
Palanga t. mun.;2005;5;145;68;77
Palanga t. mun.;2005;6;150;86;64
Palanga t. mun.;2005;7;180;89;91
Palanga t. mun.;2005;8;178;90;88
Palanga t. mun.;2005;9;194;103;91
Palanga t. mun.;2005;10;220;112;108
Palanga t. mun.;2005;11;226;120;106
Palanga t. mun.;2005;12;248;131;117
Palanga t. mun.;2005;13;233;125;108
Palanga t. mun.;2005;14;301;160;141
Palanga t. mun.;2005;15;251;127;124
Palanga t. mun.;2005;16;287;141;146
Palanga t. mun.;2005;17;288;159;129
Palanga t. mun.;2005;18;292;160;132
Palanga t. mun.;2005;19;250;134;116
Palanga t. mun.;2005;20;290;157;133
Palanga t. mun.;2005;21;248;121;127
Palanga t. mun.;2005;22;230;130;100
Palanga t. mun.;2005;23;182;109;73
Palanga t. mun.;2005;24;173;83;90
Palanga t. mun.;2005;25;186;102;84
Palanga t. mun.;2005;26;190;102;88
Palanga t. mun.;2005;27;214;125;89
Palanga t. mun.;2005;28;245;114;131
Palanga t. mun.;2005;29;220;111;109
Palanga t. mun.;2005;30;200;95;105
Palanga t. mun.;2005;31;226;119;107
Palanga t. mun.;2005;32;251;110;141
Palanga t. mun.;2005;33;218;114;104
Palanga t. mun.;2005;34;252;111;141
Palanga t. mun.;2005;35;204;97;107
Palanga t. mun.;2005;36;228;108;120
Palanga t. mun.;2005;37;226;106;120
Palanga t. mun.;2005;38;250;106;144
Palanga t. mun.;2005;39;278;121;157
Palanga t. mun.;2005;40;275;129;146
Palanga t. mun.;2005;41;281;125;156
Palanga t. mun.;2005;42;263;123;140
Palanga t. mun.;2005;43;299;137;162
Palanga t. mun.;2005;44;283;119;164
Palanga t. mun.;2005;45;322;137;185
Palanga t. mun.;2005;46;272;123;149
Palanga t. mun.;2005;47;295;135;160
Palanga t. mun.;2005;48;232;99;133
Palanga t. mun.;2005;49;242;117;125
Palanga t. mun.;2005;50;222;103;119
Palanga t. mun.;2005;51;199;91;108
Palanga t. mun.;2005;52;205;90;115
Palanga t. mun.;2005;53;218;89;129
Palanga t. mun.;2005;54;242;96;146
Palanga t. mun.;2005;55;219;105;114
Palanga t. mun.;2005;56;199;80;119
Palanga t. mun.;2005;57;155;67;88
Palanga t. mun.;2005;58;180;62;118
Palanga t. mun.;2005;59;180;69;111
Palanga t. mun.;2005;60;183;61;122
Palanga t. mun.;2005;61;176;77;99
Palanga t. mun.;2005;62;175;75;100
Palanga t. mun.;2005;63;196;85;111
Palanga t. mun.;2005;64;188;76;112
Palanga t. mun.;2005;65;176;74;102
Palanga t. mun.;2005;66;192;71;121
Palanga t. mun.;2005;67;157;57;100
Palanga t. mun.;2005;68;194;60;134
Palanga t. mun.;2005;69;156;58;98
Palanga t. mun.;2005;70;149;49;100
Palanga t. mun.;2005;71;165;51;114
Palanga t. mun.;2005;72;134;58;76
Palanga t. mun.;2005;73;149;58;91
Palanga t. mun.;2005;74;145;56;89
Palanga t. mun.;2005;75;116;45;71
Palanga t. mun.;2005;76;155;47;108
Palanga t. mun.;2005;77;116;46;70
Palanga t. mun.;2005;78;111;39;72
Palanga t. mun.;2005;79;104;20;84
Palanga t. mun.;2005;80;68;18;50
Palanga t. mun.;2005;81;78;22;56
Palanga t. mun.;2005;82;70;17;53
Palanga t. mun.;2005;83;51;15;36
Palanga t. mun.;2005;84;37;11;26
Palanga t. mun.;2005;85;185;50;135
Palanga t. mun.;2006;-1;16704;7626;9078
Palanga t. mun.;2006;0;128;67;61
Palanga t. mun.;2006;1;131;68;63
Palanga t. mun.;2006;2;140;70;70
Palanga t. mun.;2006;3;118;70;48
Palanga t. mun.;2006;4;124;65;59
Palanga t. mun.;2006;5;152;81;71
Palanga t. mun.;2006;6;144;68;76
Palanga t. mun.;2006;7;146;81;65
Palanga t. mun.;2006;8;175;87;88
Palanga t. mun.;2006;9;174;90;84
Palanga t. mun.;2006;10;193;103;90
Palanga t. mun.;2006;11;220;110;110
Palanga t. mun.;2006;12;223;120;103
Palanga t. mun.;2006;13;246;132;114
Palanga t. mun.;2006;14;228;123;105
Palanga t. mun.;2006;15;289;151;138
Palanga t. mun.;2006;16;245;123;122
Palanga t. mun.;2006;17;278;139;139
Palanga t. mun.;2006;18;275;148;127
Palanga t. mun.;2006;19;274;148;126
Palanga t. mun.;2006;20;232;125;107
Palanga t. mun.;2006;21;274;148;126
Palanga t. mun.;2006;22;236;117;119
Palanga t. mun.;2006;23;224;123;101
Palanga t. mun.;2006;24;176;107;69
Palanga t. mun.;2006;25;177;82;95
Palanga t. mun.;2006;26;185;99;86
Palanga t. mun.;2006;27;184;99;85
Palanga t. mun.;2006;28;200;118;82
Palanga t. mun.;2006;29;240;112;128
Palanga t. mun.;2006;30;223;114;109
Palanga t. mun.;2006;31;193;93;100
Palanga t. mun.;2006;32;230;121;109
Palanga t. mun.;2006;33;249;109;140
Palanga t. mun.;2006;34;213;113;100
Palanga t. mun.;2006;35;245;107;138
Palanga t. mun.;2006;36;203;97;106
Palanga t. mun.;2006;37;219;102;117
Palanga t. mun.;2006;38;223;107;116
Palanga t. mun.;2006;39;240;99;141
Palanga t. mun.;2006;40;269;116;153
Palanga t. mun.;2006;41;258;117;141
Palanga t. mun.;2006;42;279;126;153
Palanga t. mun.;2006;43;255;120;135
Palanga t. mun.;2006;44;288;132;156
Palanga t. mun.;2006;45;276;113;163
Palanga t. mun.;2006;46;316;140;176
Palanga t. mun.;2006;47;263;121;142
Palanga t. mun.;2006;48;290;132;158
Palanga t. mun.;2006;49;229;99;130
Palanga t. mun.;2006;50;239;117;122
Palanga t. mun.;2006;51;214;99;115
Palanga t. mun.;2006;52;198;94;104
Palanga t. mun.;2006;53;204;92;112
Palanga t. mun.;2006;54;210;86;124
Palanga t. mun.;2006;55;236;92;144
Palanga t. mun.;2006;56;212;98;114
Palanga t. mun.;2006;57;191;75;116
Palanga t. mun.;2006;58;155;66;89
Palanga t. mun.;2006;59;182;62;120
Palanga t. mun.;2006;60;175;70;105
Palanga t. mun.;2006;61;179;58;121
Palanga t. mun.;2006;62;178;76;102
Palanga t. mun.;2006;63;178;76;102
Palanga t. mun.;2006;64;192;84;108
Palanga t. mun.;2006;65;181;70;111
Palanga t. mun.;2006;66;173;67;106
Palanga t. mun.;2006;67;183;62;121
Palanga t. mun.;2006;68;155;57;98
Palanga t. mun.;2006;69;186;57;129
Palanga t. mun.;2006;70;155;56;99
Palanga t. mun.;2006;71;142;45;97
Palanga t. mun.;2006;72;157;48;109
Palanga t. mun.;2006;73;135;58;77
Palanga t. mun.;2006;74;144;58;86
Palanga t. mun.;2006;75;141;55;86
Palanga t. mun.;2006;76;114;43;71
Palanga t. mun.;2006;77;148;45;103
Palanga t. mun.;2006;78;111;44;67
Palanga t. mun.;2006;79;107;38;69
Palanga t. mun.;2006;80;96;18;78
Palanga t. mun.;2006;81;65;15;50
Palanga t. mun.;2006;82;74;21;53
Palanga t. mun.;2006;83;64;14;50
Palanga t. mun.;2006;84;53;14;39
Palanga t. mun.;2006;85;185;44;141
Palanga t. mun.;2007;-1;16518;7504;9014
Palanga t. mun.;2007;0;139;79;60
Palanga t. mun.;2007;1;127;68;59
Palanga t. mun.;2007;2;130;66;64
Palanga t. mun.;2007;3;145;71;74
Palanga t. mun.;2007;4;116;70;46
Palanga t. mun.;2007;5;125;65;60
Palanga t. mun.;2007;6;152;79;73
Palanga t. mun.;2007;7;143;66;77
Palanga t. mun.;2007;8;146;84;62
Palanga t. mun.;2007;9;167;82;85
Palanga t. mun.;2007;10;176;91;85
Palanga t. mun.;2007;11;189;101;88
Palanga t. mun.;2007;12;212;108;104
Palanga t. mun.;2007;13;222;119;103
Palanga t. mun.;2007;14;249;133;116
Palanga t. mun.;2007;15;229;123;106
Palanga t. mun.;2007;16;289;151;138
Palanga t. mun.;2007;17;243;123;120
Palanga t. mun.;2007;18;271;136;135
Palanga t. mun.;2007;19;273;147;126
Palanga t. mun.;2007;20;267;144;123
Palanga t. mun.;2007;21;220;121;99
Palanga t. mun.;2007;22;261;142;119
Palanga t. mun.;2007;23;231;114;117
Palanga t. mun.;2007;24;214;116;98
Palanga t. mun.;2007;25;178;107;71
Palanga t. mun.;2007;26;171;79;92
Palanga t. mun.;2007;27;176;96;80
Palanga t. mun.;2007;28;187;97;90
Palanga t. mun.;2007;29;190;110;80
Palanga t. mun.;2007;30;239;111;128
Palanga t. mun.;2007;31;220;109;111
Palanga t. mun.;2007;32;191;91;100
Palanga t. mun.;2007;33;232;124;108
Palanga t. mun.;2007;34;250;108;142
Palanga t. mun.;2007;35;201;105;96
Palanga t. mun.;2007;36;241;105;136
Palanga t. mun.;2007;37;208;101;107
Palanga t. mun.;2007;38;214;98;116
Palanga t. mun.;2007;39;217;103;114
Palanga t. mun.;2007;40;236;97;139
Palanga t. mun.;2007;41;263;113;150
Palanga t. mun.;2007;42;257;120;137
Palanga t. mun.;2007;43;267;119;148
Palanga t. mun.;2007;44;252;120;132
Palanga t. mun.;2007;45;283;129;154
Palanga t. mun.;2007;46;272;111;161
Palanga t. mun.;2007;47;312;136;176
Palanga t. mun.;2007;48;259;117;142
Palanga t. mun.;2007;49;288;131;157
Palanga t. mun.;2007;50;219;92;127
Palanga t. mun.;2007;51;233;112;121
Palanga t. mun.;2007;52;216;99;117
Palanga t. mun.;2007;53;195;90;105
Palanga t. mun.;2007;54;199;88;111
Palanga t. mun.;2007;55;210;83;127
Palanga t. mun.;2007;56;229;87;142
Palanga t. mun.;2007;57;210;95;115
Palanga t. mun.;2007;58;188;71;117
Palanga t. mun.;2007;59;154;63;91
Palanga t. mun.;2007;60;180;60;120
Palanga t. mun.;2007;61;173;70;103
Palanga t. mun.;2007;62;173;52;121
Palanga t. mun.;2007;63;175;74;101
Palanga t. mun.;2007;64;178;76;102
Palanga t. mun.;2007;65;185;78;107
Palanga t. mun.;2007;66;178;66;112
Palanga t. mun.;2007;67;172;68;104
Palanga t. mun.;2007;68;180;61;119
Palanga t. mun.;2007;69;155;55;100
Palanga t. mun.;2007;70;186;57;129
Palanga t. mun.;2007;71;153;54;99
Palanga t. mun.;2007;72;139;43;96
Palanga t. mun.;2007;73;157;50;107
Palanga t. mun.;2007;74;133;55;78
Palanga t. mun.;2007;75;143;57;86
Palanga t. mun.;2007;76;134;50;84
Palanga t. mun.;2007;77;103;38;65
Palanga t. mun.;2007;78;142;42;100
Palanga t. mun.;2007;79;102;36;66
Palanga t. mun.;2007;80;99;36;63
Palanga t. mun.;2007;81;93;18;75
Palanga t. mun.;2007;82;58;13;45
Palanga t. mun.;2007;83;66;18;48
Palanga t. mun.;2007;84;55;10;45
Palanga t. mun.;2007;85;213;51;162
Palanga t. mun.;2008;-1;16386;7408;8978
Palanga t. mun.;2008;0;131;69;62
Palanga t. mun.;2008;1;134;75;59
Palanga t. mun.;2008;2;126;69;57
Palanga t. mun.;2008;3;132;66;66
Palanga t. mun.;2008;4;144;72;72
Palanga t. mun.;2008;5;115;68;47
Palanga t. mun.;2008;6;127;65;62
Palanga t. mun.;2008;7;152;78;74
Palanga t. mun.;2008;8;143;67;76
Palanga t. mun.;2008;9;146;79;67
Palanga t. mun.;2008;10;163;80;83
Palanga t. mun.;2008;11;175;90;85
Palanga t. mun.;2008;12;191;102;89
Palanga t. mun.;2008;13;213;109;104
Palanga t. mun.;2008;14;221;118;103
Palanga t. mun.;2008;15;247;131;116
Palanga t. mun.;2008;16;226;122;104
Palanga t. mun.;2008;17;285;149;136
Palanga t. mun.;2008;18;236;122;114
Palanga t. mun.;2008;19;266;134;132
Palanga t. mun.;2008;20;269;144;125
Palanga t. mun.;2008;21;265;143;122
Palanga t. mun.;2008;22;214;119;95
Palanga t. mun.;2008;23;258;140;118
Palanga t. mun.;2008;24;226;106;120
Palanga t. mun.;2008;25;213;113;100
Palanga t. mun.;2008;26;182;109;73
Palanga t. mun.;2008;27;171;77;94
Palanga t. mun.;2008;28;170;92;78
Palanga t. mun.;2008;29;192;99;93
Palanga t. mun.;2008;30;184;106;78
Palanga t. mun.;2008;31;236;105;131
Palanga t. mun.;2008;32;224;110;114
Palanga t. mun.;2008;33;197;96;101
Palanga t. mun.;2008;34;230;122;108
Palanga t. mun.;2008;35;252;109;143
Palanga t. mun.;2008;36;199;106;93
Palanga t. mun.;2008;37;246;111;135
Palanga t. mun.;2008;38;205;97;108
Palanga t. mun.;2008;39;212;94;118
Palanga t. mun.;2008;40;218;105;113
Palanga t. mun.;2008;41;231;94;137
Palanga t. mun.;2008;42;260;113;147
Palanga t. mun.;2008;43;252;113;139
Palanga t. mun.;2008;44;264;116;148
Palanga t. mun.;2008;45;249;116;133
Palanga t. mun.;2008;46;279;123;156
Palanga t. mun.;2008;47;269;114;155
Palanga t. mun.;2008;48;306;132;174
Palanga t. mun.;2008;49;255;112;143
Palanga t. mun.;2008;50;289;128;161
Palanga t. mun.;2008;51;212;88;124
Palanga t. mun.;2008;52;231;111;120
Palanga t. mun.;2008;53;215;97;118
Palanga t. mun.;2008;54;190;86;104
Palanga t. mun.;2008;55;196;85;111
Palanga t. mun.;2008;56;204;80;124
Palanga t. mun.;2008;57;223;81;142
Palanga t. mun.;2008;58;202;86;116
Palanga t. mun.;2008;59;187;72;115
Palanga t. mun.;2008;60;154;64;90
Palanga t. mun.;2008;61;174;56;118
Palanga t. mun.;2008;62;171;67;104
Palanga t. mun.;2008;63;174;51;123
Palanga t. mun.;2008;64;171;70;101
Palanga t. mun.;2008;65;171;73;98
Palanga t. mun.;2008;66;180;75;105
Palanga t. mun.;2008;67;178;65;113
Palanga t. mun.;2008;68;168;69;99
Palanga t. mun.;2008;69;174;58;116
Palanga t. mun.;2008;70;154;55;99
Palanga t. mun.;2008;71;180;56;124
Palanga t. mun.;2008;72;149;53;96
Palanga t. mun.;2008;73;140;45;95
Palanga t. mun.;2008;74;150;45;105
Palanga t. mun.;2008;75;132;54;78
Palanga t. mun.;2008;76;139;55;84
Palanga t. mun.;2008;77;130;46;84
Palanga t. mun.;2008;78;100;35;65
Palanga t. mun.;2008;79;135;40;95
Palanga t. mun.;2008;80;96;33;63
Palanga t. mun.;2008;81;90;33;57
Palanga t. mun.;2008;82;87;17;70
Palanga t. mun.;2008;83;56;12;44
Palanga t. mun.;2008;84;63;14;49
Palanga t. mun.;2008;85;220;52;168
Palanga t. mun.;2009;-1;16272;7315;8957
Palanga t. mun.;2009;0;154;82;72
Palanga t. mun.;2009;1;134;69;65
Palanga t. mun.;2009;2;133;75;58
Palanga t. mun.;2009;3;122;65;57
Palanga t. mun.;2009;4;131;65;66
Palanga t. mun.;2009;5;142;74;68
Palanga t. mun.;2009;6;111;65;46
Palanga t. mun.;2009;7;125;66;59
Palanga t. mun.;2009;8;142;72;70
Palanga t. mun.;2009;9;141;66;75
Palanga t. mun.;2009;10;148;81;67
Palanga t. mun.;2009;11;166;82;84
Palanga t. mun.;2009;12;181;91;90
Palanga t. mun.;2009;13;188;101;87
Palanga t. mun.;2009;14;212;107;105
Palanga t. mun.;2009;15;223;119;104
Palanga t. mun.;2009;16;241;127;114
Palanga t. mun.;2009;17;218;118;100
Palanga t. mun.;2009;18;279;144;135
Palanga t. mun.;2009;19;233;119;114
Palanga t. mun.;2009;20;265;132;133
Palanga t. mun.;2009;21;263;140;123
Palanga t. mun.;2009;22;261;145;116
Palanga t. mun.;2009;23;208;115;93
Palanga t. mun.;2009;24;258;136;122
Palanga t. mun.;2009;25;213;100;113
Palanga t. mun.;2009;26;200;110;90
Palanga t. mun.;2009;27;182;108;74
Palanga t. mun.;2009;28;170;78;92
Palanga t. mun.;2009;29;158;84;74
Palanga t. mun.;2009;30;186;97;89
Palanga t. mun.;2009;31;183;102;81
Palanga t. mun.;2009;32;229;103;126
Palanga t. mun.;2009;33;228;111;117
Palanga t. mun.;2009;34;194;92;102
Palanga t. mun.;2009;35;228;118;110
Palanga t. mun.;2009;36;254;108;146
Palanga t. mun.;2009;37;199;103;96
Palanga t. mun.;2009;38;247;110;137
Palanga t. mun.;2009;39;205;96;109
Palanga t. mun.;2009;40;214;94;120
Palanga t. mun.;2009;41;218;104;114
Palanga t. mun.;2009;42;227;92;135
Palanga t. mun.;2009;43;257;111;146
Palanga t. mun.;2009;44;252;113;139
Palanga t. mun.;2009;45;266;116;150
Palanga t. mun.;2009;46;249;115;134
Palanga t. mun.;2009;47;284;125;159
Palanga t. mun.;2009;48;264;112;152
Palanga t. mun.;2009;49;309;131;178
Palanga t. mun.;2009;50;254;111;143
Palanga t. mun.;2009;51;285;128;157
Palanga t. mun.;2009;52;210;85;125
Palanga t. mun.;2009;53;228;107;121
Palanga t. mun.;2009;54;208;90;118
Palanga t. mun.;2009;55;189;85;104
Palanga t. mun.;2009;56;196;83;113
Palanga t. mun.;2009;57;199;75;124
Palanga t. mun.;2009;58;222;78;144
Palanga t. mun.;2009;59;197;83;114
Palanga t. mun.;2009;60;189;71;118
Palanga t. mun.;2009;61;152;63;89
Palanga t. mun.;2009;62;174;57;117
Palanga t. mun.;2009;63;171;66;105
Palanga t. mun.;2009;64;173;49;124
Palanga t. mun.;2009;65;161;63;98
Palanga t. mun.;2009;66;167;70;97
Palanga t. mun.;2009;67;178;73;105
Palanga t. mun.;2009;68;174;63;111
Palanga t. mun.;2009;69;165;70;95
Palanga t. mun.;2009;70;172;57;115
Palanga t. mun.;2009;71;151;55;96
Palanga t. mun.;2009;72;181;57;124
Palanga t. mun.;2009;73;149;52;97
Palanga t. mun.;2009;74;138;43;95
Palanga t. mun.;2009;75;151;47;104
Palanga t. mun.;2009;76;128;49;79
Palanga t. mun.;2009;77;131;49;82
Palanga t. mun.;2009;78;126;46;80
Palanga t. mun.;2009;79;89;27;62
Palanga t. mun.;2009;80;132;38;94
Palanga t. mun.;2009;81;83;26;57
Palanga t. mun.;2009;82;82;31;51
Palanga t. mun.;2009;83;86;19;67
Palanga t. mun.;2009;84;51;8;43
Palanga t. mun.;2009;85;235;52;183
Palanga t. mun.;2010;-1;16212;7307;8905
Palanga t. mun.;2010;0;142;67;75
Palanga t. mun.;2010;1;150;79;71
Palanga t. mun.;2010;2;135;70;65
Palanga t. mun.;2010;3;128;70;58
Palanga t. mun.;2010;4;125;67;58
Palanga t. mun.;2010;5;130;64;66
Palanga t. mun.;2010;6;141;75;66
Palanga t. mun.;2010;7;109;65;44
Palanga t. mun.;2010;8;123;65;58
Palanga t. mun.;2010;9;145;73;72
Palanga t. mun.;2010;10;148;68;80
Palanga t. mun.;2010;11;145;81;64
Palanga t. mun.;2010;12;167;82;85
Palanga t. mun.;2010;13;178;90;88
Palanga t. mun.;2010;14;190;103;87
Palanga t. mun.;2010;15;214;112;102
Palanga t. mun.;2010;16;223;119;104
Palanga t. mun.;2010;17;241;128;113
Palanga t. mun.;2010;18;224;118;106
Palanga t. mun.;2010;19;277;144;133
Palanga t. mun.;2010;20;226;113;113
Palanga t. mun.;2010;21;258;131;127
Palanga t. mun.;2010;22;258;138;120
Palanga t. mun.;2010;23;252;141;111
Palanga t. mun.;2010;24;199;108;91
Palanga t. mun.;2010;25;249;135;114
Palanga t. mun.;2010;26;194;92;102
Palanga t. mun.;2010;27;198;108;90
Palanga t. mun.;2010;28;180;104;76
Palanga t. mun.;2010;29;170;77;93
Palanga t. mun.;2010;30;162;86;76
Palanga t. mun.;2010;31;182;100;82
Palanga t. mun.;2010;32;186;102;84
Palanga t. mun.;2010;33;227;104;123
Palanga t. mun.;2010;34;230;112;118
Palanga t. mun.;2010;35;192;91;101
Palanga t. mun.;2010;36;221;115;106
Palanga t. mun.;2010;37;249;105;144
Palanga t. mun.;2010;38;204;106;98
Palanga t. mun.;2010;39;245;110;135
Palanga t. mun.;2010;40;209;98;111
Palanga t. mun.;2010;41;210;90;120
Palanga t. mun.;2010;42;218;105;113
Palanga t. mun.;2010;43;229;93;136
Palanga t. mun.;2010;44;261;112;149
Palanga t. mun.;2010;45;252;117;135
Palanga t. mun.;2010;46;268;115;153
Palanga t. mun.;2010;47;250;118;132
Palanga t. mun.;2010;48;283;127;156
Palanga t. mun.;2010;49;264;113;151
Palanga t. mun.;2010;50;309;133;176
Palanga t. mun.;2010;51;258;111;147
Palanga t. mun.;2010;52;287;130;157
Palanga t. mun.;2010;53;208;85;123
Palanga t. mun.;2010;54;227;106;121
Palanga t. mun.;2010;55;210;91;119
Palanga t. mun.;2010;56;190;85;105
Palanga t. mun.;2010;57;197;83;114
Palanga t. mun.;2010;58;193;71;122
Palanga t. mun.;2010;59;220;77;143
Palanga t. mun.;2010;60;199;83;116
Palanga t. mun.;2010;61;182;68;114
Palanga t. mun.;2010;62;144;56;88
Palanga t. mun.;2010;63;175;59;116
Palanga t. mun.;2010;64;167;64;103
Palanga t. mun.;2010;65;166;47;119
Palanga t. mun.;2010;66;158;61;97
Palanga t. mun.;2010;67;170;73;97
Palanga t. mun.;2010;68;174;69;105
Palanga t. mun.;2010;69;171;62;109
Palanga t. mun.;2010;70;160;68;92
Palanga t. mun.;2010;71;170;55;115
Palanga t. mun.;2010;72;147;54;93
Palanga t. mun.;2010;73;177;57;120
Palanga t. mun.;2010;74;151;53;98
Palanga t. mun.;2010;75;132;42;90
Palanga t. mun.;2010;76;148;47;101
Palanga t. mun.;2010;77;126;48;78
Palanga t. mun.;2010;78;128;46;82
Palanga t. mun.;2010;79;120;43;77
Palanga t. mun.;2010;80;86;25;61
Palanga t. mun.;2010;81;129;36;93
Palanga t. mun.;2010;82;79;24;55
Palanga t. mun.;2010;83;77;27;50
Palanga t. mun.;2010;84;76;15;61
Palanga t. mun.;2010;85;240;47;193
Palanga t. mun.;2011;-1;15771;7057;8714
Palanga t. mun.;2011;0;151;81;70
Palanga t. mun.;2011;1;143;67;76
Palanga t. mun.;2011;2;165;76;89
Palanga t. mun.;2011;3;136;70;66
Palanga t. mun.;2011;4;123;67;56
Palanga t. mun.;2011;5;132;72;60
Palanga t. mun.;2011;6;125;61;64
Palanga t. mun.;2011;7;136;70;66
Palanga t. mun.;2011;8;121;74;47
Palanga t. mun.;2011;9;124;64;60
Palanga t. mun.;2011;10;143;71;72
Palanga t. mun.;2011;11;159;71;88
Palanga t. mun.;2011;12;152;81;71
Palanga t. mun.;2011;13;179;92;87
Palanga t. mun.;2011;14;176;91;85
Palanga t. mun.;2011;15;191;95;96
Palanga t. mun.;2011;16;204;106;98
Palanga t. mun.;2011;17;222;121;101
Palanga t. mun.;2011;18;231;128;103
Palanga t. mun.;2011;19;188;97;91
Palanga t. mun.;2011;20;200;102;98
Palanga t. mun.;2011;21;170;79;91
Palanga t. mun.;2011;22;189;95;94
Palanga t. mun.;2011;23;198;118;80
Palanga t. mun.;2011;24;190;100;90
Palanga t. mun.;2011;25;159;82;77
Palanga t. mun.;2011;26;180;96;84
Palanga t. mun.;2011;27;168;72;96
Palanga t. mun.;2011;28;166;90;76
Palanga t. mun.;2011;29;148;74;74
Palanga t. mun.;2011;30;165;77;88
Palanga t. mun.;2011;31;155;68;87
Palanga t. mun.;2011;32;154;80;74
Palanga t. mun.;2011;33;168;93;75
Palanga t. mun.;2011;34;203;99;104
Palanga t. mun.;2011;35;191;95;96
Palanga t. mun.;2011;36;184;91;93
Palanga t. mun.;2011;37;184;96;88
Palanga t. mun.;2011;38;230;97;133
Palanga t. mun.;2011;39;207;107;100
Palanga t. mun.;2011;40;232;115;117
Palanga t. mun.;2011;41;214;93;121
Palanga t. mun.;2011;42;220;100;120
Palanga t. mun.;2011;43;206;101;105
Palanga t. mun.;2011;44;233;91;142
Palanga t. mun.;2011;45;249;104;145
Palanga t. mun.;2011;46;255;124;131
Palanga t. mun.;2011;47;252;106;146
Palanga t. mun.;2011;48;252;117;135
Palanga t. mun.;2011;49;286;131;155
Palanga t. mun.;2011;50;277;118;159
Palanga t. mun.;2011;51;300;125;175
Palanga t. mun.;2011;52;300;130;170
Palanga t. mun.;2011;53;308;136;172
Palanga t. mun.;2011;54;219;90;129
Palanga t. mun.;2011;55;235;108;127
Palanga t. mun.;2011;56;226;103;123
Palanga t. mun.;2011;57;204;95;109
Palanga t. mun.;2011;58;213;98;115
Palanga t. mun.;2011;59;210;76;134
Palanga t. mun.;2011;60;262;102;160
Palanga t. mun.;2011;61;217;94;123
Palanga t. mun.;2011;62;191;72;119
Palanga t. mun.;2011;63;152;68;84
Palanga t. mun.;2011;64;167;55;112
Palanga t. mun.;2011;65;173;69;104
Palanga t. mun.;2011;66;176;57;119
Palanga t. mun.;2011;67;161;69;92
Palanga t. mun.;2011;68;172;72;100
Palanga t. mun.;2011;69;176;73;103
Palanga t. mun.;2011;70;176;65;111
Palanga t. mun.;2011;71;153;60;93
Palanga t. mun.;2011;72;158;50;108
Palanga t. mun.;2011;73;132;50;82
Palanga t. mun.;2011;74;171;51;120
Palanga t. mun.;2011;75;141;50;91
Palanga t. mun.;2011;76;131;39;92
Palanga t. mun.;2011;77;151;48;103
Palanga t. mun.;2011;78;121;43;78
Palanga t. mun.;2011;79;129;46;83
Palanga t. mun.;2011;80;112;37;75
Palanga t. mun.;2011;81;85;26;59
Palanga t. mun.;2011;82;114;30;84
Palanga t. mun.;2011;83;80;23;57
Palanga t. mun.;2011;84;69;22;47
Palanga t. mun.;2011;85;300;59;241
Palanga t. mun.;2012;-1;15512;6906;8606
Palanga t. mun.;2012;0;152;70;82
Palanga t. mun.;2012;1;148;80;68
Palanga t. mun.;2012;2;147;72;75
Palanga t. mun.;2012;3;156;69;87
Palanga t. mun.;2012;4;127;65;62
Palanga t. mun.;2012;5;120;65;55
Palanga t. mun.;2012;6;129;71;58
Palanga t. mun.;2012;7;122;58;64
Palanga t. mun.;2012;8;136;68;68
Palanga t. mun.;2012;9;120;73;47
Palanga t. mun.;2012;10;123;62;61
Palanga t. mun.;2012;11;141;73;68
Palanga t. mun.;2012;12;159;69;90
Palanga t. mun.;2012;13;150;78;72
Palanga t. mun.;2012;14;180;92;88
Palanga t. mun.;2012;15;175;88;87
Palanga t. mun.;2012;16;192;95;97
Palanga t. mun.;2012;17;204;108;96
Palanga t. mun.;2012;18;217;118;99
Palanga t. mun.;2012;19;220;122;98
Palanga t. mun.;2012;20;176;88;88
Palanga t. mun.;2012;21;190;97;93
Palanga t. mun.;2012;22;160;75;85
Palanga t. mun.;2012;23;172;83;89
Palanga t. mun.;2012;24;173;101;72
Palanga t. mun.;2012;25;181;96;85
Palanga t. mun.;2012;26;149;83;66
Palanga t. mun.;2012;27;158;86;72
Palanga t. mun.;2012;28;168;72;96
Palanga t. mun.;2012;29;154;85;69
Palanga t. mun.;2012;30;145;65;80
Palanga t. mun.;2012;31;161;77;84
Palanga t. mun.;2012;32;149;66;83
Palanga t. mun.;2012;33;152;79;73
Palanga t. mun.;2012;34;167;94;73
Palanga t. mun.;2012;35;191;92;99
Palanga t. mun.;2012;36;181;88;93
Palanga t. mun.;2012;37;186;94;92
Palanga t. mun.;2012;38;181;92;89
Palanga t. mun.;2012;39;223;96;127
Palanga t. mun.;2012;40;207;107;100
Palanga t. mun.;2012;41;230;115;115
Palanga t. mun.;2012;42;206;92;114
Palanga t. mun.;2012;43;213;97;116
Palanga t. mun.;2012;44;200;95;105
Palanga t. mun.;2012;45;226;88;138
Palanga t. mun.;2012;46;239;101;138
Palanga t. mun.;2012;47;254;124;130
Palanga t. mun.;2012;48;260;112;148
Palanga t. mun.;2012;49;248;114;134
Palanga t. mun.;2012;50;280;125;155
Palanga t. mun.;2012;51;270;113;157
Palanga t. mun.;2012;52;297;122;175
Palanga t. mun.;2012;53;294;126;168
Palanga t. mun.;2012;54;301;134;167
Palanga t. mun.;2012;55;215;90;125
Palanga t. mun.;2012;56;237;109;128
Palanga t. mun.;2012;57;223;105;118
Palanga t. mun.;2012;58;204;96;108
Palanga t. mun.;2012;59;214;99;115
Palanga t. mun.;2012;60;211;75;136
Palanga t. mun.;2012;61;262;101;161
Palanga t. mun.;2012;62;216;89;127
Palanga t. mun.;2012;63;193;72;121
Palanga t. mun.;2012;64;153;65;88
Palanga t. mun.;2012;65;163;52;111
Palanga t. mun.;2012;66;166;64;102
Palanga t. mun.;2012;67;173;56;117
Palanga t. mun.;2012;68;163;70;93
Palanga t. mun.;2012;69;168;66;102
Palanga t. mun.;2012;70;172;69;103
Palanga t. mun.;2012;71;175;67;108
Palanga t. mun.;2012;72;145;56;89
Palanga t. mun.;2012;73;156;48;108
Palanga t. mun.;2012;74;129;49;80
Palanga t. mun.;2012;75;166;49;117
Palanga t. mun.;2012;76;136;45;91
Palanga t. mun.;2012;77;127;37;90
Palanga t. mun.;2012;78;143;44;99
Palanga t. mun.;2012;79;116;44;72
Palanga t. mun.;2012;80;122;43;79
Palanga t. mun.;2012;81;109;36;73
Palanga t. mun.;2012;82;81;23;58
Palanga t. mun.;2012;83;109;27;82
Palanga t. mun.;2012;84;73;19;54
Palanga t. mun.;2012;85;332;71;261
Palanga t. mun.;2013;-1;15353;6803;8550
Palanga t. mun.;2013;0;140;61;79
Palanga t. mun.;2013;1;146;70;76
Palanga t. mun.;2013;2;144;75;69
Palanga t. mun.;2013;3;146;71;75
Palanga t. mun.;2013;4;143;62;81
Palanga t. mun.;2013;5;127;64;63
Palanga t. mun.;2013;6;122;63;59
Palanga t. mun.;2013;7;133;75;58
Palanga t. mun.;2013;8;123;61;62
Palanga t. mun.;2013;9;135;68;67
Palanga t. mun.;2013;10;116;72;44
Palanga t. mun.;2013;11;124;61;63
Palanga t. mun.;2013;12;137;70;67
Palanga t. mun.;2013;13;152;67;85
Palanga t. mun.;2013;14;152;79;73
Palanga t. mun.;2013;15;176;88;88
Palanga t. mun.;2013;16;175;87;88
Palanga t. mun.;2013;17;189;93;96
Palanga t. mun.;2013;18;196;103;93
Palanga t. mun.;2013;19;210;114;96
Palanga t. mun.;2013;20;216;120;96
Palanga t. mun.;2013;21;174;89;85
Palanga t. mun.;2013;22;169;90;79
Palanga t. mun.;2013;23;148;71;77
Palanga t. mun.;2013;24;167;83;84
Palanga t. mun.;2013;25;168;98;70
Palanga t. mun.;2013;26;173;91;82
Palanga t. mun.;2013;27;150;86;64
Palanga t. mun.;2013;28;159;87;72
Palanga t. mun.;2013;29;160;67;93
Palanga t. mun.;2013;30;157;85;72
Palanga t. mun.;2013;31;155;73;82
Palanga t. mun.;2013;32;156;70;86
Palanga t. mun.;2013;33;143;59;84
Palanga t. mun.;2013;34;144;75;69
Palanga t. mun.;2013;35;157;84;73
Palanga t. mun.;2013;36;192;92;100
Palanga t. mun.;2013;37;177;88;89
Palanga t. mun.;2013;38;185;91;94
Palanga t. mun.;2013;39;181;91;90
Palanga t. mun.;2013;40;218;90;128
Palanga t. mun.;2013;41;202;101;101
Palanga t. mun.;2013;42;234;118;116
Palanga t. mun.;2013;43;204;91;113
Palanga t. mun.;2013;44;209;97;112
Palanga t. mun.;2013;45;193;88;105
Palanga t. mun.;2013;46;225;89;136
Palanga t. mun.;2013;47;240;102;138
Palanga t. mun.;2013;48;247;120;127
Palanga t. mun.;2013;49;261;111;150
Palanga t. mun.;2013;50;245;113;132
Palanga t. mun.;2013;51;276;122;154
Palanga t. mun.;2013;52;274;115;159
Palanga t. mun.;2013;53;291;119;172
Palanga t. mun.;2013;54;291;126;165
Palanga t. mun.;2013;55;300;128;172
Palanga t. mun.;2013;56;217;90;127
Palanga t. mun.;2013;57;237;108;129
Palanga t. mun.;2013;58;224;104;120
Palanga t. mun.;2013;59;199;93;106
Palanga t. mun.;2013;60;211;98;113
Palanga t. mun.;2013;61;211;73;138
Palanga t. mun.;2013;62;270;104;166
Palanga t. mun.;2013;63;222;92;130
Palanga t. mun.;2013;64;192;71;121
Palanga t. mun.;2013;65;152;67;85
Palanga t. mun.;2013;66;164;52;112
Palanga t. mun.;2013;67;163;65;98
Palanga t. mun.;2013;68;172;55;117
Palanga t. mun.;2013;69;164;69;95
Palanga t. mun.;2013;70;165;61;104
Palanga t. mun.;2013;71;171;69;102
Palanga t. mun.;2013;72;176;65;111
Palanga t. mun.;2013;73;140;53;87
Palanga t. mun.;2013;74;151;45;106
Palanga t. mun.;2013;75;122;45;77
Palanga t. mun.;2013;76;163;49;114
Palanga t. mun.;2013;77;132;42;90
Palanga t. mun.;2013;78;127;39;88
Palanga t. mun.;2013;79;136;42;94
Palanga t. mun.;2013;80;106;39;67
Palanga t. mun.;2013;81;114;40;74
Palanga t. mun.;2013;82;105;35;70
Palanga t. mun.;2013;83;78;20;58
Palanga t. mun.;2013;84;100;26;74
Palanga t. mun.;2013;85;342;68;274
Palanga t. mun.;2014;-1;15358;6818;8540
Palanga t. mun.;2014;0;151;89;62
Palanga t. mun.;2014;1;138;60;78
Palanga t. mun.;2014;2;141;68;73
Palanga t. mun.;2014;3;147;77;70
Palanga t. mun.;2014;4;136;70;66
Palanga t. mun.;2014;5;138;56;82
Palanga t. mun.;2014;6;132;64;68
Palanga t. mun.;2014;7;133;68;65
Palanga t. mun.;2014;8;136;74;62
Palanga t. mun.;2014;9;122;61;61
Palanga t. mun.;2014;10;132;68;64
Palanga t. mun.;2014;11;119;73;46
Palanga t. mun.;2014;12;125;61;64
Palanga t. mun.;2014;13;142;71;71
Palanga t. mun.;2014;14;152;67;85
Palanga t. mun.;2014;15;147;77;70
Palanga t. mun.;2014;16;177;91;86
Palanga t. mun.;2014;17;170;84;86
Palanga t. mun.;2014;18;189;90;99
Palanga t. mun.;2014;19;194;103;91
Palanga t. mun.;2014;20;203;109;94
Palanga t. mun.;2014;21;222;122;100
Palanga t. mun.;2014;22;168;88;80
Palanga t. mun.;2014;23;169;94;75
Palanga t. mun.;2014;24;133;69;64
Palanga t. mun.;2014;25;174;85;89
Palanga t. mun.;2014;26;164;94;70
Palanga t. mun.;2014;27;176;93;83
Palanga t. mun.;2014;28;155;83;72
Palanga t. mun.;2014;29;164;92;72
Palanga t. mun.;2014;30;160;65;95
Palanga t. mun.;2014;31;159;85;74
Palanga t. mun.;2014;32;156;69;87
Palanga t. mun.;2014;33;154;71;83
Palanga t. mun.;2014;34;148;68;80
Palanga t. mun.;2014;35;148;72;76
Palanga t. mun.;2014;36;157;82;75
Palanga t. mun.;2014;37;194;96;98
Palanga t. mun.;2014;38;177;89;88
Palanga t. mun.;2014;39;184;90;94
Palanga t. mun.;2014;40;183;95;88
Palanga t. mun.;2014;41;222;90;132
Palanga t. mun.;2014;42;208;102;106
Palanga t. mun.;2014;43;230;117;113
Palanga t. mun.;2014;44;202;89;113
Palanga t. mun.;2014;45;203;94;109
Palanga t. mun.;2014;46;188;86;102
Palanga t. mun.;2014;47;227;88;139
Palanga t. mun.;2014;48;235;99;136
Palanga t. mun.;2014;49;246;121;125
Palanga t. mun.;2014;50;257;110;147
Palanga t. mun.;2014;51;247;117;130
Palanga t. mun.;2014;52;273;118;155
Palanga t. mun.;2014;53;279;116;163
Palanga t. mun.;2014;54;289;118;171
Palanga t. mun.;2014;55;296;128;168
Palanga t. mun.;2014;56;299;128;171
Palanga t. mun.;2014;57;221;92;129
Palanga t. mun.;2014;58;238;108;130
Palanga t. mun.;2014;59;225;107;118
Palanga t. mun.;2014;60;192;87;105
Palanga t. mun.;2014;61;215;98;117
Palanga t. mun.;2014;62;211;70;141
Palanga t. mun.;2014;63;265;100;165
Palanga t. mun.;2014;64;219;89;130
Palanga t. mun.;2014;65;187;66;121
Palanga t. mun.;2014;66;148;65;83
Palanga t. mun.;2014;67;163;50;113
Palanga t. mun.;2014;68;156;63;93
Palanga t. mun.;2014;69;170;54;116
Palanga t. mun.;2014;70;161;68;93
Palanga t. mun.;2014;71;164;60;104
Palanga t. mun.;2014;72;168;67;101
Palanga t. mun.;2014;73;176;64;112
Palanga t. mun.;2014;74;139;52;87
Palanga t. mun.;2014;75;146;42;104
Palanga t. mun.;2014;76;119;44;75
Palanga t. mun.;2014;77;153;46;107
Palanga t. mun.;2014;78;124;38;86
Palanga t. mun.;2014;79;122;38;84
Palanga t. mun.;2014;80;130;38;92
Palanga t. mun.;2014;81;99;35;64
Palanga t. mun.;2014;82;104;39;65
Palanga t. mun.;2014;83;102;33;69
Palanga t. mun.;2014;84;72;20;52
Palanga t. mun.;2014;85;399;81;318
Palanga t. mun.;2015;-1;15379;6800;8579
Palanga t. mun.;2015;0;136;58;78
Palanga t. mun.;2015;1;153;85;68
Palanga t. mun.;2015;2;143;63;80
Palanga t. mun.;2015;3;140;70;70
Palanga t. mun.;2015;4;142;77;65
Palanga t. mun.;2015;5;136;69;67
Palanga t. mun.;2015;6;145;59;86
Palanga t. mun.;2015;7;138;69;69
Palanga t. mun.;2015;8;138;73;65
Palanga t. mun.;2015;9;137;78;59
Palanga t. mun.;2015;10;120;61;59
Palanga t. mun.;2015;11;128;69;59
Palanga t. mun.;2015;12;116;71;45
Palanga t. mun.;2015;13;124;62;62
Palanga t. mun.;2015;14;137;69;68
Palanga t. mun.;2015;15;150;69;81
Palanga t. mun.;2015;16;148;77;71
Palanga t. mun.;2015;17;174;87;87
Palanga t. mun.;2015;18;163;81;82
Palanga t. mun.;2015;19;186;90;96
Palanga t. mun.;2015;20;189;100;89
Palanga t. mun.;2015;21;204;108;96
Palanga t. mun.;2015;22;215;117;98
Palanga t. mun.;2015;23;162;82;80
Palanga t. mun.;2015;24;169;94;75
Palanga t. mun.;2015;25;140;73;67
Palanga t. mun.;2015;26;171;83;88
Palanga t. mun.;2015;27;161;93;68
Palanga t. mun.;2015;28;170;85;85
Palanga t. mun.;2015;29;167;88;79
Palanga t. mun.;2015;30;159;87;72
Palanga t. mun.;2015;31;166;66;100
Palanga t. mun.;2015;32;159;85;74
Palanga t. mun.;2015;33;158;74;84
Palanga t. mun.;2015;34;159;72;87
Palanga t. mun.;2015;35;154;70;84
Palanga t. mun.;2015;36;137;64;73
Palanga t. mun.;2015;37;157;82;75
Palanga t. mun.;2015;38;199;100;99
Palanga t. mun.;2015;39;181;95;86
Palanga t. mun.;2015;40;194;98;96
Palanga t. mun.;2015;41;188;101;87
Palanga t. mun.;2015;42;224;91;133
Palanga t. mun.;2015;43;211;103;108
Palanga t. mun.;2015;44;233;120;113
Palanga t. mun.;2015;45;207;88;119
Palanga t. mun.;2015;46;202;94;108
Palanga t. mun.;2015;47;184;83;101
Palanga t. mun.;2015;48;224;83;141
Palanga t. mun.;2015;49;238;101;137
Palanga t. mun.;2015;50;252;123;129
Palanga t. mun.;2015;51;260;110;150
Palanga t. mun.;2015;52;234;112;122
Palanga t. mun.;2015;53;275;124;151
Palanga t. mun.;2015;54;281;115;166
Palanga t. mun.;2015;55;290;116;174
Palanga t. mun.;2015;56;293;127;166
Palanga t. mun.;2015;57;300;121;179
Palanga t. mun.;2015;58;219;90;129
Palanga t. mun.;2015;59;241;109;132
Palanga t. mun.;2015;60;224;103;121
Palanga t. mun.;2015;61;194;86;108
Palanga t. mun.;2015;62;221;100;121
Palanga t. mun.;2015;63;217;69;148
Palanga t. mun.;2015;64;267;99;168
Palanga t. mun.;2015;65;215;86;129
Palanga t. mun.;2015;66;179;61;118
Palanga t. mun.;2015;67;143;60;83
Palanga t. mun.;2015;68;166;52;114
Palanga t. mun.;2015;69;149;58;91
Palanga t. mun.;2015;70;168;53;115
Palanga t. mun.;2015;71;158;65;93
Palanga t. mun.;2015;72;163;58;105
Palanga t. mun.;2015;73;168;65;103
Palanga t. mun.;2015;74;163;54;109
Palanga t. mun.;2015;75;133;50;83
Palanga t. mun.;2015;76;142;38;104
Palanga t. mun.;2015;77;113;38;75
Palanga t. mun.;2015;78;148;45;103
Palanga t. mun.;2015;79;122;36;86
Palanga t. mun.;2015;80;117;37;80
Palanga t. mun.;2015;81;125;37;88
Palanga t. mun.;2015;82;98;34;64
Palanga t. mun.;2015;83;98;35;63
Palanga t. mun.;2015;84;91;27;64
Palanga t. mun.;2015;85;416;90;326
Palanga t. mun.;2016;-1;15542;6922;8620
Palanga t. mun.;2016;0;158;84;74
Palanga t. mun.;2016;1;133;55;78
Palanga t. mun.;2016;2;159;87;72
Palanga t. mun.;2016;3;142;67;75
Palanga t. mun.;2016;4;147;73;74
Palanga t. mun.;2016;5;151;83;68
Palanga t. mun.;2016;6;136;71;65
Palanga t. mun.;2016;7;153;61;92
Palanga t. mun.;2016;8;144;71;73
Palanga t. mun.;2016;9;142;73;69
Palanga t. mun.;2016;10;136;75;61
Palanga t. mun.;2016;11;128;64;64
Palanga t. mun.;2016;12;126;67;59
Palanga t. mun.;2016;13;116;70;46
Palanga t. mun.;2016;14;124;61;63
Palanga t. mun.;2016;15;138;69;69
Palanga t. mun.;2016;16;147;69;78
Palanga t. mun.;2016;17;146;78;68
Palanga t. mun.;2016;18;170;85;85
Palanga t. mun.;2016;19;158;78;80
Palanga t. mun.;2016;20;181;85;96
Palanga t. mun.;2016;21;189;97;92
Palanga t. mun.;2016;22;202;107;95
Palanga t. mun.;2016;23;205;107;98
Palanga t. mun.;2016;24;158;79;79
Palanga t. mun.;2016;25;172;96;76
Palanga t. mun.;2016;26;151;73;78
Palanga t. mun.;2016;27;172;87;85
Palanga t. mun.;2016;28;159;92;67
Palanga t. mun.;2016;29;167;84;83
Palanga t. mun.;2016;30;176;91;85
Palanga t. mun.;2016;31;152;80;72
Palanga t. mun.;2016;32;166;71;95
Palanga t. mun.;2016;33;166;93;73
Palanga t. mun.;2016;34;160;77;83
Palanga t. mun.;2016;35;171;80;91
Palanga t. mun.;2016;36;157;72;85
Palanga t. mun.;2016;37;140;68;72
Palanga t. mun.;2016;38;164;89;75
Palanga t. mun.;2016;39;201;103;98
Palanga t. mun.;2016;40;182;98;84
Palanga t. mun.;2016;41;203;100;103
Palanga t. mun.;2016;42;203;109;94
Palanga t. mun.;2016;43;229;92;137
Palanga t. mun.;2016;44;212;100;112
Palanga t. mun.;2016;45;233;119;114
Palanga t. mun.;2016;46;209;93;116
Palanga t. mun.;2016;47;204;92;112
Palanga t. mun.;2016;48;190;88;102
Palanga t. mun.;2016;49;230;87;143
Palanga t. mun.;2016;50;242;105;137
Palanga t. mun.;2016;51;256;123;133
Palanga t. mun.;2016;52;264;112;152
Palanga t. mun.;2016;53;230;113;117
Palanga t. mun.;2016;54;279;130;149
Palanga t. mun.;2016;55;290;122;168
Palanga t. mun.;2016;56;296;121;175
Palanga t. mun.;2016;57;294;128;166
Palanga t. mun.;2016;58;298;120;178
Palanga t. mun.;2016;59;220;91;129
Palanga t. mun.;2016;60;240;108;132
Palanga t. mun.;2016;61;227;105;122
Palanga t. mun.;2016;62;197;86;111
Palanga t. mun.;2016;63;227;101;126
Palanga t. mun.;2016;64;218;70;148
Palanga t. mun.;2016;65;271;100;171
Palanga t. mun.;2016;66;210;82;128
Palanga t. mun.;2016;67;178;65;113
Palanga t. mun.;2016;68;144;59;85
Palanga t. mun.;2016;69;160;53;107
Palanga t. mun.;2016;70;157;63;94
Palanga t. mun.;2016;71;166;50;116
Palanga t. mun.;2016;72;152;60;92
Palanga t. mun.;2016;73;158;57;101
Palanga t. mun.;2016;74;168;66;102
Palanga t. mun.;2016;75;163;53;110
Palanga t. mun.;2016;76;127;47;80
Palanga t. mun.;2016;77;136;36;100
Palanga t. mun.;2016;78;107;38;69
Palanga t. mun.;2016;79;137;41;96
Palanga t. mun.;2016;80;119;35;84
Palanga t. mun.;2016;81;104;32;72
Palanga t. mun.;2016;82;121;35;86
Palanga t. mun.;2016;83;93;32;61
Palanga t. mun.;2016;84;88;30;58
Palanga t. mun.;2016;85;447;103;344
Palanga t. mun.;2017;-1;15449;6848;8601
Palanga t. mun.;2017;0;156;79;77
Palanga t. mun.;2017;1;159;86;73
Palanga t. mun.;2017;2;132;56;76
Palanga t. mun.;2017;3;158;83;75
Palanga t. mun.;2017;4;141;65;76
Palanga t. mun.;2017;5;146;71;75
Palanga t. mun.;2017;6;148;78;70
Palanga t. mun.;2017;7;141;71;70
Palanga t. mun.;2017;8;151;63;88
Palanga t. mun.;2017;9;139;68;71
Palanga t. mun.;2017;10;137;72;65
Palanga t. mun.;2017;11;133;72;61
Palanga t. mun.;2017;12;127;65;62
Palanga t. mun.;2017;13;123;62;61
Palanga t. mun.;2017;14;111;66;45
Palanga t. mun.;2017;15;121;57;64
Palanga t. mun.;2017;16;142;71;71
Palanga t. mun.;2017;17;147;68;79
Palanga t. mun.;2017;18;142;76;66
Palanga t. mun.;2017;19;167;84;83
Palanga t. mun.;2017;20;149;72;77
Palanga t. mun.;2017;21;181;86;95
Palanga t. mun.;2017;22;189;92;97
Palanga t. mun.;2017;23;197;101;96
Palanga t. mun.;2017;24;198;103;95
Palanga t. mun.;2017;25;142;76;66
Palanga t. mun.;2017;26;157;87;70
Palanga t. mun.;2017;27;140;70;70
Palanga t. mun.;2017;28;168;89;79
Palanga t. mun.;2017;29;154;88;66
Palanga t. mun.;2017;30;158;77;81
Palanga t. mun.;2017;31;168;84;84
Palanga t. mun.;2017;32;148;82;66
Palanga t. mun.;2017;33;158;65;93
Palanga t. mun.;2017;34;154;84;70
Palanga t. mun.;2017;35;161;77;84
Palanga t. mun.;2017;36;167;75;92
Palanga t. mun.;2017;37;160;72;88
Palanga t. mun.;2017;38;146;69;77
Palanga t. mun.;2017;39;162;88;74
Palanga t. mun.;2017;40;201;104;97
Palanga t. mun.;2017;41;182;99;83
Palanga t. mun.;2017;42;207;101;106
Palanga t. mun.;2017;43;199;106;93
Palanga t. mun.;2017;44;217;84;133
Palanga t. mun.;2017;45;212;101;111
Palanga t. mun.;2017;46;232;119;113
Palanga t. mun.;2017;47;211;94;117
Palanga t. mun.;2017;48;209;97;112
Palanga t. mun.;2017;49;196;91;105
Palanga t. mun.;2017;50;229;86;143
Palanga t. mun.;2017;51;237;106;131
Palanga t. mun.;2017;52;251;120;131
Palanga t. mun.;2017;53;260;109;151
Palanga t. mun.;2017;54;236;120;116
Palanga t. mun.;2017;55;278;130;148
Palanga t. mun.;2017;56;288;120;168
Palanga t. mun.;2017;57;292;117;175
Palanga t. mun.;2017;58;294;129;165
Palanga t. mun.;2017;59;299;116;183
Palanga t. mun.;2017;60;219;88;131
Palanga t. mun.;2017;61;235;101;134
Palanga t. mun.;2017;62;235;106;129
Palanga t. mun.;2017;63;195;81;114
Palanga t. mun.;2017;64;235;102;133
Palanga t. mun.;2017;65;219;66;153
Palanga t. mun.;2017;66;272;98;174
Palanga t. mun.;2017;67;218;87;131
Palanga t. mun.;2017;68;179;65;114
Palanga t. mun.;2017;69;143;58;85
Palanga t. mun.;2017;70;159;55;104
Palanga t. mun.;2017;71;155;62;93
Palanga t. mun.;2017;72;168;50;118
Palanga t. mun.;2017;73;150;60;90
Palanga t. mun.;2017;74;161;57;104
Palanga t. mun.;2017;75;169;69;100
Palanga t. mun.;2017;76;164;53;111
Palanga t. mun.;2017;77;121;39;82
Palanga t. mun.;2017;78;129;34;95
Palanga t. mun.;2017;79;106;38;68
Palanga t. mun.;2017;80;127;39;88
Palanga t. mun.;2017;81;118;36;82
Palanga t. mun.;2017;82;93;28;65
Palanga t. mun.;2017;83;117;32;85
Palanga t. mun.;2017;84;90;32;58
Palanga t. mun.;2017;85;464;113;351
Palanga t. mun.;2018;-1;15381;6803;8578
Palanga t. mun.;2018;0;132;68;64
Palanga t. mun.;2018;1;155;78;77
Palanga t. mun.;2018;2;158;84;74
Palanga t. mun.;2018;3;128;52;76
Palanga t. mun.;2018;4;148;78;70
Palanga t. mun.;2018;5;139;64;75
Palanga t. mun.;2018;6;150;73;77
Palanga t. mun.;2018;7;153;80;73
Palanga t. mun.;2018;8;144;73;71
Palanga t. mun.;2018;9;152;67;85
Palanga t. mun.;2018;10;142;73;69
Palanga t. mun.;2018;11;131;71;60
Palanga t. mun.;2018;12;127;69;58
Palanga t. mun.;2018;13;126;65;61
Palanga t. mun.;2018;14;120;63;57
Palanga t. mun.;2018;15;115;69;46
Palanga t. mun.;2018;16;120;56;64
Palanga t. mun.;2018;17;140;69;71
Palanga t. mun.;2018;18;148;70;78
Palanga t. mun.;2018;19;137;74;63
Palanga t. mun.;2018;20;165;80;85
Palanga t. mun.;2018;21;134;66;68
Palanga t. mun.;2018;22;172;83;89
Palanga t. mun.;2018;23;175;88;87
Palanga t. mun.;2018;24;188;93;95
Palanga t. mun.;2018;25;190;97;93
Palanga t. mun.;2018;26;134;70;64
Palanga t. mun.;2018;27;142;77;65
Palanga t. mun.;2018;28;135;66;69
Palanga t. mun.;2018;29;164;87;77
Palanga t. mun.;2018;30;152;85;67
Palanga t. mun.;2018;31;148;74;74
Palanga t. mun.;2018;32;165;78;87
Palanga t. mun.;2018;33;142;76;66
Palanga t. mun.;2018;34;157;61;96
Palanga t. mun.;2018;35;150;80;70
Palanga t. mun.;2018;36;154;77;77
Palanga t. mun.;2018;37;164;74;90
Palanga t. mun.;2018;38;153;68;85
Palanga t. mun.;2018;39;153;75;78
Palanga t. mun.;2018;40;162;83;79
Palanga t. mun.;2018;41;205;104;101
Palanga t. mun.;2018;42;180;97;83
Palanga t. mun.;2018;43;207;99;108
Palanga t. mun.;2018;44;196;106;90
Palanga t. mun.;2018;45;230;89;141
Palanga t. mun.;2018;46;216;106;110
Palanga t. mun.;2018;47;231;117;114
Palanga t. mun.;2018;48;214;97;117
Palanga t. mun.;2018;49;209;98;111
Palanga t. mun.;2018;50;198;92;106
Palanga t. mun.;2018;51;232;88;144
Palanga t. mun.;2018;52;245;108;137
Palanga t. mun.;2018;53;255;118;137
Palanga t. mun.;2018;54;261;110;151
Palanga t. mun.;2018;55;238;119;119
Palanga t. mun.;2018;56;283;132;151
Palanga t. mun.;2018;57;291;121;170
Palanga t. mun.;2018;58;298;121;177
Palanga t. mun.;2018;59;295;128;167
Palanga t. mun.;2018;60;296;114;182
Palanga t. mun.;2018;61;224;84;140
Palanga t. mun.;2018;62;244;107;137
Palanga t. mun.;2018;63;236;107;129
Palanga t. mun.;2018;64;195;80;115
Palanga t. mun.;2018;65;229;98;131
Palanga t. mun.;2018;66;223;65;158
Palanga t. mun.;2018;67;273;98;175
Palanga t. mun.;2018;68;220;89;131
Palanga t. mun.;2018;69;182;67;115
Palanga t. mun.;2018;70;152;61;91
Palanga t. mun.;2018;71;158;54;104
Palanga t. mun.;2018;72;147;57;90
Palanga t. mun.;2018;73;170;52;118
Palanga t. mun.;2018;74;148;61;87
Palanga t. mun.;2018;75;156;54;102
Palanga t. mun.;2018;76;167;69;98
Palanga t. mun.;2018;77;164;50;114
Palanga t. mun.;2018;78;117;36;81
Palanga t. mun.;2018;79;125;31;94
Palanga t. mun.;2018;80;101;36;65
Palanga t. mun.;2018;81;123;36;87
Palanga t. mun.;2018;82;117;36;81
Palanga t. mun.;2018;83;82;23;59
Palanga t. mun.;2018;84;108;28;80
Palanga t. mun.;2018;85;476;126;350
Panevėžys c. mun.;2001;-1;119808;54592;65216
Panevėžys c. mun.;2001;0;1061;564;497
Panevėžys c. mun.;2001;1;1126;606;520
Panevėžys c. mun.;2001;2;1178;579;599
Panevėžys c. mun.;2001;3;1298;638;660
Panevėžys c. mun.;2001;4;1290;655;635
Panevėžys c. mun.;2001;5;1371;693;678
Panevėžys c. mun.;2001;6;1362;715;647
Panevėžys c. mun.;2001;7;1518;793;725
Panevėžys c. mun.;2001;8;1731;872;859
Panevėžys c. mun.;2001;9;1823;937;886
Panevėžys c. mun.;2001;10;1855;968;887
Panevėžys c. mun.;2001;11;1794;907;887
Panevėžys c. mun.;2001;12;1928;983;945
Panevėžys c. mun.;2001;13;1952;1021;931
Panevėžys c. mun.;2001;14;2009;1041;968
Panevėžys c. mun.;2001;15;1888;941;947
Panevėžys c. mun.;2001;16;1881;903;978
Panevėžys c. mun.;2001;17;1843;938;905
Panevėžys c. mun.;2001;18;1565;764;801
Panevėžys c. mun.;2001;19;1457;745;712
Panevėžys c. mun.;2001;20;1471;747;724
Panevėžys c. mun.;2001;21;1402;676;726
Panevėžys c. mun.;2001;22;1487;742;745
Panevėžys c. mun.;2001;23;1582;770;812
Panevėžys c. mun.;2001;24;1622;786;836
Panevėžys c. mun.;2001;25;1666;780;886
Panevėžys c. mun.;2001;26;1715;776;939
Panevėžys c. mun.;2001;27;1769;852;917
Panevėžys c. mun.;2001;28;1766;832;934
Panevėžys c. mun.;2001;29;1774;786;988
Panevėžys c. mun.;2001;30;1854;902;952
Panevėžys c. mun.;2001;31;1859;903;956
Panevėžys c. mun.;2001;32;1979;953;1026
Panevėžys c. mun.;2001;33;1983;920;1063
Panevėžys c. mun.;2001;34;1974;926;1048
Panevėžys c. mun.;2001;35;1973;932;1041
Panevėžys c. mun.;2001;36;2079;943;1136
Panevėžys c. mun.;2001;37;2109;980;1129
Panevėžys c. mun.;2001;38;2218;1008;1210
Panevėžys c. mun.;2001;39;2214;1015;1199
Panevėžys c. mun.;2001;40;2064;954;1110
Panevėžys c. mun.;2001;41;2133;978;1155
Panevėžys c. mun.;2001;42;1893;863;1030
Panevėžys c. mun.;2001;43;1826;792;1034
Panevėžys c. mun.;2001;44;1742;800;942
Panevėžys c. mun.;2001;45;1560;733;827
Panevėžys c. mun.;2001;46;1560;703;857
Panevėžys c. mun.;2001;47;1441;676;765
Panevėžys c. mun.;2001;48;1572;709;863
Panevėžys c. mun.;2001;49;1445;645;800
Panevėžys c. mun.;2001;50;1465;626;839
Panevėžys c. mun.;2001;51;1403;599;804
Panevėžys c. mun.;2001;52;1346;599;747
Panevėžys c. mun.;2001;53;1253;511;742
Panevėžys c. mun.;2001;54;1291;549;742
Panevėžys c. mun.;2001;55;1346;580;766
Panevėžys c. mun.;2001;56;1305;594;711
Panevėžys c. mun.;2001;57;1468;638;830
Panevėžys c. mun.;2001;58;1522;641;881
Panevėžys c. mun.;2001;59;1456;638;818
Panevėžys c. mun.;2001;60;1278;558;720
Panevėžys c. mun.;2001;61;1233;516;717
Panevėžys c. mun.;2001;62;1211;481;730
Panevėžys c. mun.;2001;63;1139;442;697
Panevėžys c. mun.;2001;64;1163;469;694
Panevėžys c. mun.;2001;65;1029;390;639
Panevėžys c. mun.;2001;66;1053;427;626
Panevėžys c. mun.;2001;67;1035;406;629
Panevėžys c. mun.;2001;68;1006;381;625
Panevėžys c. mun.;2001;69;876;336;540
Panevėžys c. mun.;2001;70;869;334;535
Panevėžys c. mun.;2001;71;886;335;551
Panevėžys c. mun.;2001;72;867;328;539
Panevėžys c. mun.;2001;73;741;278;463
Panevėžys c. mun.;2001;74;688;199;489
Panevėžys c. mun.;2001;75;662;188;474
Panevėžys c. mun.;2001;76;602;168;434
Panevėžys c. mun.;2001;77;589;169;420
Panevėžys c. mun.;2001;78;468;123;345
Panevėžys c. mun.;2001;79;438;125;313
Panevėžys c. mun.;2001;80;377;104;273
Panevėžys c. mun.;2001;81;242;67;175
Panevėžys c. mun.;2001;82;216;57;159
Panevėžys c. mun.;2001;83;177;45;132
Panevėžys c. mun.;2001;84;196;47;149
Panevėžys c. mun.;2001;85;1250;299;951
Panevėžys c. mun.;2002;-1;118231;53687;64544
Panevėžys c. mun.;2002;0;906;437;469
Panevėžys c. mun.;2002;1;1071;574;497
Panevėžys c. mun.;2002;2;1126;599;527
Panevėžys c. mun.;2002;3;1166;568;598
Panevėžys c. mun.;2002;4;1289;635;654
Panevėžys c. mun.;2002;5;1280;651;629
Panevėžys c. mun.;2002;6;1359;682;677
Panevėžys c. mun.;2002;7;1359;707;652
Panevėžys c. mun.;2002;8;1513;789;724
Panevėžys c. mun.;2002;9;1720;857;863
Panevėžys c. mun.;2002;10;1805;926;879
Panevėžys c. mun.;2002;11;1829;953;876
Panevėžys c. mun.;2002;12;1758;890;868
Panevėžys c. mun.;2002;13;1882;958;924
Panevėžys c. mun.;2002;14;1916;999;917
Panevėžys c. mun.;2002;15;1969;1011;958
Panevėžys c. mun.;2002;16;1857;919;938
Panevėžys c. mun.;2002;17;1841;877;964
Panevėžys c. mun.;2002;18;1797;912;885
Panevėžys c. mun.;2002;19;1533;745;788
Panevėžys c. mun.;2002;20;1423;718;705
Panevėžys c. mun.;2002;21;1409;715;694
Panevėžys c. mun.;2002;22;1352;657;695
Panevėžys c. mun.;2002;23;1433;713;720
Panevėžys c. mun.;2002;24;1544;747;797
Panevėžys c. mun.;2002;25;1609;788;821
Panevėžys c. mun.;2002;26;1643;771;872
Panevėžys c. mun.;2002;27;1689;757;932
Panevėžys c. mun.;2002;28;1748;830;918
Panevėžys c. mun.;2002;29;1732;810;922
Panevėžys c. mun.;2002;30;1731;760;971
Panevėžys c. mun.;2002;31;1826;885;941
Panevėžys c. mun.;2002;32;1822;882;940
Panevėžys c. mun.;2002;33;1957;940;1017
Panevėžys c. mun.;2002;34;1954;904;1050
Panevėžys c. mun.;2002;35;1928;894;1034
Panevėžys c. mun.;2002;36;1941;923;1018
Panevėžys c. mun.;2002;37;2040;918;1122
Panevėžys c. mun.;2002;38;2070;956;1114
Panevėžys c. mun.;2002;39;2174;974;1200
Panevėžys c. mun.;2002;40;2161;982;1179
Panevėžys c. mun.;2002;41;2020;929;1091
Panevėžys c. mun.;2002;42;2098;964;1134
Panevėžys c. mun.;2002;43;1876;852;1024
Panevėžys c. mun.;2002;44;1792;777;1015
Panevėžys c. mun.;2002;45;1693;770;923
Panevėžys c. mun.;2002;46;1527;718;809
Panevėžys c. mun.;2002;47;1543;698;845
Panevėžys c. mun.;2002;48;1411;659;752
Panevėžys c. mun.;2002;49;1514;672;842
Panevėžys c. mun.;2002;50;1412;621;791
Panevėžys c. mun.;2002;51;1420;599;821
Panevėžys c. mun.;2002;52;1389;590;799
Panevėžys c. mun.;2002;53;1321;589;732
Panevėžys c. mun.;2002;54;1218;499;719
Panevėžys c. mun.;2002;55;1251;530;721
Panevėžys c. mun.;2002;56;1304;557;747
Panevėžys c. mun.;2002;57;1277;579;698
Panevėžys c. mun.;2002;58;1429;621;808
Panevėžys c. mun.;2002;59;1482;621;861
Panevėžys c. mun.;2002;60;1435;627;808
Panevėžys c. mun.;2002;61;1263;548;715
Panevėžys c. mun.;2002;62;1219;508;711
Panevėžys c. mun.;2002;63;1190;467;723
Panevėžys c. mun.;2002;64;1118;431;687
Panevėžys c. mun.;2002;65;1139;456;683
Panevėžys c. mun.;2002;66;1014;379;635
Panevėžys c. mun.;2002;67;1040;421;619
Panevėžys c. mun.;2002;68;1017;391;626
Panevėžys c. mun.;2002;69;983;371;612
Panevėžys c. mun.;2002;70;859;326;533
Panevėžys c. mun.;2002;71;847;315;532
Panevėžys c. mun.;2002;72;866;329;537
Panevėžys c. mun.;2002;73;855;317;538
Panevėžys c. mun.;2002;74;725;270;455
Panevėžys c. mun.;2002;75;666;189;477
Panevėžys c. mun.;2002;76;637;175;462
Panevėžys c. mun.;2002;77;586;162;424
Panevėžys c. mun.;2002;78;574;161;413
Panevėžys c. mun.;2002;79;454;121;333
Panevėžys c. mun.;2002;80;409;113;296
Panevėžys c. mun.;2002;81;351;96;255
Panevėžys c. mun.;2002;82;226;63;163
Panevėžys c. mun.;2002;83;200;52;148
Panevėžys c. mun.;2002;84;164;43;121
Panevėžys c. mun.;2002;85;1255;298;957
Panevėžys c. mun.;2003;-1;116925;53045;63880
Panevėžys c. mun.;2003;0;927;481;446
Panevėžys c. mun.;2003;1;914;446;468
Panevėžys c. mun.;2003;2;1066;572;494
Panevėžys c. mun.;2003;3;1125;598;527
Panevėžys c. mun.;2003;4;1165;565;600
Panevėžys c. mun.;2003;5;1279;625;654
Panevėžys c. mun.;2003;6;1270;645;625
Panevėžys c. mun.;2003;7;1357;678;679
Panevėžys c. mun.;2003;8;1355;702;653
Panevėžys c. mun.;2003;9;1512;789;723
Panevėžys c. mun.;2003;10;1704;849;855
Panevėžys c. mun.;2003;11;1786;919;867
Panevėžys c. mun.;2003;12;1797;933;864
Panevėžys c. mun.;2003;13;1719;867;852
Panevėžys c. mun.;2003;14;1841;938;903
Panevėžys c. mun.;2003;15;1879;977;902
Panevėžys c. mun.;2003;16;1927;988;939
Panevėžys c. mun.;2003;17;1809;893;916
Panevėžys c. mun.;2003;18;1810;860;950
Panevėžys c. mun.;2003;19;1764;887;877
Panevėžys c. mun.;2003;20;1476;720;756
Panevėžys c. mun.;2003;21;1377;698;679
Panevėžys c. mun.;2003;22;1364;696;668
Panevėžys c. mun.;2003;23;1318;645;673
Panevėžys c. mun.;2003;24;1407;700;707
Panevėžys c. mun.;2003;25;1525;739;786
Panevėžys c. mun.;2003;26;1594;786;808
Panevėžys c. mun.;2003;27;1607;746;861
Panevėžys c. mun.;2003;28;1662;740;922
Panevėžys c. mun.;2003;29;1721;816;905
Panevėžys c. mun.;2003;30;1709;801;908
Panevėžys c. mun.;2003;31;1714;753;961
Panevėžys c. mun.;2003;32;1800;875;925
Panevėžys c. mun.;2003;33;1794;872;922
Panevėžys c. mun.;2003;34;1936;932;1004
Panevėžys c. mun.;2003;35;1918;889;1029
Panevėžys c. mun.;2003;36;1900;884;1016
Panevėžys c. mun.;2003;37;1901;899;1002
Panevėžys c. mun.;2003;38;2010;905;1105
Panevėžys c. mun.;2003;39;2037;937;1100
Panevėžys c. mun.;2003;40;2142;960;1182
Panevėžys c. mun.;2003;41;2119;960;1159
Panevėžys c. mun.;2003;42;1991;912;1079
Panevėžys c. mun.;2003;43;2072;947;1125
Panevėžys c. mun.;2003;44;1847;842;1005
Panevėžys c. mun.;2003;45;1763;762;1001
Panevėžys c. mun.;2003;46;1674;763;911
Panevėžys c. mun.;2003;47;1514;711;803
Panevėžys c. mun.;2003;48;1521;684;837
Panevėžys c. mun.;2003;49;1389;648;741
Panevėžys c. mun.;2003;50;1488;653;835
Panevėžys c. mun.;2003;51;1385;608;777
Panevėžys c. mun.;2003;52;1397;588;809
Panevėžys c. mun.;2003;53;1368;579;789
Panevėžys c. mun.;2003;54;1302;575;727
Panevėžys c. mun.;2003;55;1201;489;712
Panevėžys c. mun.;2003;56;1225;516;709
Panevėžys c. mun.;2003;57;1277;537;740
Panevėžys c. mun.;2003;58;1241;559;682
Panevėžys c. mun.;2003;59;1397;600;797
Panevėžys c. mun.;2003;60;1446;606;840
Panevėžys c. mun.;2003;61;1414;611;803
Panevėžys c. mun.;2003;62;1254;542;712
Panevėžys c. mun.;2003;63;1205;497;708
Panevėžys c. mun.;2003;64;1172;455;717
Panevėžys c. mun.;2003;65;1109;423;686
Panevėžys c. mun.;2003;66;1120;442;678
Panevėžys c. mun.;2003;67;1018;376;642
Panevėžys c. mun.;2003;68;1009;399;610
Panevėžys c. mun.;2003;69;985;374;611
Panevėžys c. mun.;2003;70;961;356;605
Panevėžys c. mun.;2003;71;838;311;527
Panevėžys c. mun.;2003;72;830;310;520
Panevėžys c. mun.;2003;73;837;311;526
Panevėžys c. mun.;2003;74;841;305;536
Panevėžys c. mun.;2003;75;689;252;437
Panevėžys c. mun.;2003;76;643;176;467
Panevėžys c. mun.;2003;77;614;163;451
Panevėžys c. mun.;2003;78;561;153;408
Panevėžys c. mun.;2003;79;540;145;395
Panevėžys c. mun.;2003;80;425;112;313
Panevėžys c. mun.;2003;81;387;103;284
Panevėžys c. mun.;2003;82;316;80;236
Panevėžys c. mun.;2003;83;218;61;157
Panevėžys c. mun.;2003;84;177;45;132
Panevėžys c. mun.;2003;85;1227;299;928
Panevėžys c. mun.;2004;-1;114917;52078;62839
Panevėžys c. mun.;2004;0;872;452;420
Panevėžys c. mun.;2004;1;938;479;459
Panevėžys c. mun.;2004;2;926;448;478
Panevėžys c. mun.;2004;3;1056;560;496
Panevėžys c. mun.;2004;4;1121;595;526
Panevėžys c. mun.;2004;5;1157;564;593
Panevėžys c. mun.;2004;6;1280;624;656
Panevėžys c. mun.;2004;7;1265;634;631
Panevėžys c. mun.;2004;8;1348;674;674
Panevėžys c. mun.;2004;9;1345;695;650
Panevėžys c. mun.;2004;10;1512;793;719
Panevėžys c. mun.;2004;11;1698;853;845
Panevėžys c. mun.;2004;12;1764;905;859
Panevėžys c. mun.;2004;13;1758;917;841
Panevėžys c. mun.;2004;14;1678;851;827
Panevėžys c. mun.;2004;15;1803;918;885
Panevėžys c. mun.;2004;16;1841;961;880
Panevėžys c. mun.;2004;17;1886;965;921
Panevėžys c. mun.;2004;18;1755;866;889
Panevėžys c. mun.;2004;19;1752;833;919
Panevėžys c. mun.;2004;20;1691;843;848
Panevėžys c. mun.;2004;21;1409;688;721
Panevėžys c. mun.;2004;22;1325;672;653
Panevėžys c. mun.;2004;23;1311;668;643
Panevėžys c. mun.;2004;24;1284;632;652
Panevėžys c. mun.;2004;25;1341;682;659
Panevėžys c. mun.;2004;26;1479;722;757
Panevėžys c. mun.;2004;27;1558;768;790
Panevėžys c. mun.;2004;28;1579;737;842
Panevėžys c. mun.;2004;29;1635;733;902
Panevėžys c. mun.;2004;30;1668;791;877
Panevėžys c. mun.;2004;31;1659;778;881
Panevėžys c. mun.;2004;32;1685;742;943
Panevėžys c. mun.;2004;33;1755;849;906
Panevėžys c. mun.;2004;34;1750;854;896
Panevėžys c. mun.;2004;35;1893;910;983
Panevėžys c. mun.;2004;36;1883;877;1006
Panevėžys c. mun.;2004;37;1867;859;1008
Panevėžys c. mun.;2004;38;1851;877;974
Panevėžys c. mun.;2004;39;1960;879;1081
Panevėžys c. mun.;2004;40;1980;915;1065
Panevėžys c. mun.;2004;41;2099;941;1158
Panevėžys c. mun.;2004;42;2075;936;1139
Panevėžys c. mun.;2004;43;1961;900;1061
Panevėžys c. mun.;2004;44;2028;920;1108
Panevėžys c. mun.;2004;45;1804;828;976
Panevėžys c. mun.;2004;46;1729;749;980
Panevėžys c. mun.;2004;47;1622;737;885
Panevėžys c. mun.;2004;48;1479;691;788
Panevėžys c. mun.;2004;49;1485;666;819
Panevėžys c. mun.;2004;50;1353;634;719
Panevėžys c. mun.;2004;51;1450;641;809
Panevėžys c. mun.;2004;52;1361;591;770
Panevėžys c. mun.;2004;53;1360;568;792
Panevėžys c. mun.;2004;54;1337;562;775
Panevėžys c. mun.;2004;55;1276;556;720
Panevėžys c. mun.;2004;56;1182;479;703
Panevėžys c. mun.;2004;57;1196;499;697
Panevėžys c. mun.;2004;58;1230;510;720
Panevėžys c. mun.;2004;59;1206;542;664
Panevėžys c. mun.;2004;60;1346;570;776
Panevėžys c. mun.;2004;61;1397;581;816
Panevėžys c. mun.;2004;62;1369;584;785
Panevėžys c. mun.;2004;63;1232;525;707
Panevėžys c. mun.;2004;64;1180;484;696
Panevėžys c. mun.;2004;65;1146;435;711
Panevėžys c. mun.;2004;66;1091;403;688
Panevėžys c. mun.;2004;67;1096;426;670
Panevėžys c. mun.;2004;68;996;362;634
Panevėžys c. mun.;2004;69;990;381;609
Panevėžys c. mun.;2004;70;959;359;600
Panevėžys c. mun.;2004;71;945;337;608
Panevėžys c. mun.;2004;72;820;297;523
Panevėžys c. mun.;2004;73;803;296;507
Panevėžys c. mun.;2004;74;810;300;510
Panevėžys c. mun.;2004;75;817;287;530
Panevėžys c. mun.;2004;76;662;237;425
Panevėžys c. mun.;2004;77;618;169;449
Panevėžys c. mun.;2004;78;578;145;433
Panevėžys c. mun.;2004;79;543;147;396
Panevėžys c. mun.;2004;80;502;133;369
Panevėžys c. mun.;2004;81;398;101;297
Panevėžys c. mun.;2004;82;361;98;263
Panevėžys c. mun.;2004;83;297;73;224
Panevėžys c. mun.;2004;84;204;54;150
Panevėžys c. mun.;2004;85;1206;281;925
Panevėžys c. mun.;2005;-1;112543;50901;61642
Panevėžys c. mun.;2005;0;901;441;460
Panevėžys c. mun.;2005;1;861;447;414
Panevėžys c. mun.;2005;2;930;476;454
Panevėžys c. mun.;2005;3;910;444;466
Panevėžys c. mun.;2005;4;1029;547;482
Panevėžys c. mun.;2005;5;1106;586;520
Panevėžys c. mun.;2005;6;1147;562;585
Panevėžys c. mun.;2005;7;1258;613;645
Panevėžys c. mun.;2005;8;1253;628;625
Panevėžys c. mun.;2005;9;1332;665;667
Panevėžys c. mun.;2005;10;1326;679;647
Panevėžys c. mun.;2005;11;1496;785;711
Panevėžys c. mun.;2005;12;1672;836;836
Panevėžys c. mun.;2005;13;1729;882;847
Panevėžys c. mun.;2005;14;1723;897;826
Panevėžys c. mun.;2005;15;1647;835;812
Panevėžys c. mun.;2005;16;1750;894;856
Panevėžys c. mun.;2005;17;1798;934;864
Panevėžys c. mun.;2005;18;1819;925;894
Panevėžys c. mun.;2005;19;1683;828;855
Panevėžys c. mun.;2005;20;1672;795;877
Panevėžys c. mun.;2005;21;1624;809;815
Panevėžys c. mun.;2005;22;1347;652;695
Panevėžys c. mun.;2005;23;1267;642;625
Panevėžys c. mun.;2005;24;1261;649;612
Panevėžys c. mun.;2005;25;1213;608;605
Panevėžys c. mun.;2005;26;1293;648;645
Panevėžys c. mun.;2005;27;1475;720;755
Panevėžys c. mun.;2005;28;1514;753;761
Panevėžys c. mun.;2005;29;1540;728;812
Panevėžys c. mun.;2005;30;1614;728;886
Panevėžys c. mun.;2005;31;1623;765;858
Panevėžys c. mun.;2005;32;1602;747;855
Panevėžys c. mun.;2005;33;1635;720;915
Panevėžys c. mun.;2005;34;1713;828;885
Panevėžys c. mun.;2005;35;1704;830;874
Panevėžys c. mun.;2005;36;1837;881;956
Panevėžys c. mun.;2005;37;1830;843;987
Panevėžys c. mun.;2005;38;1811;829;982
Panevėžys c. mun.;2005;39;1811;859;952
Panevėžys c. mun.;2005;40;1901;850;1051
Panevėžys c. mun.;2005;41;1931;888;1043
Panevėžys c. mun.;2005;42;2050;922;1128
Panevėžys c. mun.;2005;43;2030;912;1118
Panevėžys c. mun.;2005;44;1933;884;1049
Panevėžys c. mun.;2005;45;1975;904;1071
Panevėžys c. mun.;2005;46;1770;805;965
Panevėžys c. mun.;2005;47;1685;726;959
Panevėžys c. mun.;2005;48;1575;715;860
Panevėžys c. mun.;2005;49;1441;670;771
Panevėžys c. mun.;2005;50;1447;647;800
Panevėžys c. mun.;2005;51;1311;607;704
Panevėžys c. mun.;2005;52;1415;622;793
Panevėžys c. mun.;2005;53;1321;565;756
Panevėžys c. mun.;2005;54;1333;554;779
Panevėžys c. mun.;2005;55;1299;545;754
Panevėžys c. mun.;2005;56;1255;547;708
Panevėžys c. mun.;2005;57;1158;465;693
Panevėžys c. mun.;2005;58;1170;487;683
Panevėžys c. mun.;2005;59;1210;494;716
Panevėžys c. mun.;2005;60;1176;524;652
Panevėžys c. mun.;2005;61;1321;557;764
Panevėžys c. mun.;2005;62;1374;563;811
Panevėžys c. mun.;2005;63;1342;569;773
Panevėžys c. mun.;2005;64;1195;515;680
Panevėžys c. mun.;2005;65;1134;458;676
Panevėžys c. mun.;2005;66;1123;417;706
Panevėžys c. mun.;2005;67;1057;378;679
Panevėžys c. mun.;2005;68;1071;412;659
Panevėžys c. mun.;2005;69;969;348;621
Panevėžys c. mun.;2005;70;964;365;599
Panevėžys c. mun.;2005;71;931;344;587
Panevėžys c. mun.;2005;72;912;314;598
Panevėžys c. mun.;2005;73;787;280;507
Panevėžys c. mun.;2005;74;777;280;497
Panevėžys c. mun.;2005;75;774;279;495
Panevėžys c. mun.;2005;76;778;269;509
Panevėžys c. mun.;2005;77;631;226;405
Panevėžys c. mun.;2005;78;578;161;417
Panevėžys c. mun.;2005;79;536;129;407
Panevėžys c. mun.;2005;80;499;131;368
Panevėžys c. mun.;2005;81;482;123;359
Panevėžys c. mun.;2005;82;369;91;278
Panevėžys c. mun.;2005;83;340;90;250
Panevėžys c. mun.;2005;84;272;63;209
Panevėžys c. mun.;2005;85;1185;268;917
Panevėžys c. mun.;2006;-1;109901;49518;60383
Panevėžys c. mun.;2006;0;881;457;424
Panevėžys c. mun.;2006;1;880;429;451
Panevėžys c. mun.;2006;2;840;432;408
Panevėžys c. mun.;2006;3;906;465;441
Panevėžys c. mun.;2006;4;892;433;459
Panevėžys c. mun.;2006;5;1014;536;478
Panevėžys c. mun.;2006;6;1090;577;513
Panevėžys c. mun.;2006;7;1128;553;575
Panevėžys c. mun.;2006;8;1240;610;630
Panevėžys c. mun.;2006;9;1231;619;612
Panevėžys c. mun.;2006;10;1318;655;663
Panevėžys c. mun.;2006;11;1307;669;638
Panevėžys c. mun.;2006;12;1484;781;703
Panevėžys c. mun.;2006;13;1635;815;820
Panevėžys c. mun.;2006;14;1691;863;828
Panevėžys c. mun.;2006;15;1656;861;795
Panevėžys c. mun.;2006;16;1584;799;785
Panevėžys c. mun.;2006;17;1695;860;835
Panevėžys c. mun.;2006;18;1731;899;832
Panevėžys c. mun.;2006;19;1707;859;848
Panevėžys c. mun.;2006;20;1585;773;812
Panevėžys c. mun.;2006;21;1569;739;830
Panevėžys c. mun.;2006;22;1534;767;767
Panevėžys c. mun.;2006;23;1273;608;665
Panevėžys c. mun.;2006;24;1194;608;586
Panevėžys c. mun.;2006;25;1193;618;575
Panevėžys c. mun.;2006;26;1174;579;595
Panevėžys c. mun.;2006;27;1253;634;619
Panevėžys c. mun.;2006;28;1430;694;736
Panevėžys c. mun.;2006;29;1479;738;741
Panevėžys c. mun.;2006;30;1510;713;797
Panevėžys c. mun.;2006;31;1564;705;859
Panevėžys c. mun.;2006;32;1582;743;839
Panevėžys c. mun.;2006;33;1568;726;842
Panevėžys c. mun.;2006;34;1594;704;890
Panevėžys c. mun.;2006;35;1665;796;869
Panevėžys c. mun.;2006;36;1655;805;850
Panevėžys c. mun.;2006;37;1794;849;945
Panevėžys c. mun.;2006;38;1770;807;963
Panevėžys c. mun.;2006;39;1760;797;963
Panevėžys c. mun.;2006;40;1756;829;927
Panevėžys c. mun.;2006;41;1846;821;1025
Panevėžys c. mun.;2006;42;1894;864;1030
Panevėžys c. mun.;2006;43;1997;890;1107
Panevėžys c. mun.;2006;44;1999;902;1097
Panevėžys c. mun.;2006;45;1892;863;1029
Panevėžys c. mun.;2006;46;1924;883;1041
Panevėžys c. mun.;2006;47;1741;790;951
Panevėžys c. mun.;2006;48;1641;707;934
Panevėžys c. mun.;2006;49;1534;692;842
Panevėžys c. mun.;2006;50;1399;649;750
Panevėžys c. mun.;2006;51;1415;630;785
Panevėžys c. mun.;2006;52;1287;595;692
Panevėžys c. mun.;2006;53;1381;598;783
Panevėžys c. mun.;2006;54;1298;550;748
Panevėžys c. mun.;2006;55;1301;539;762
Panevėžys c. mun.;2006;56;1255;517;738
Panevėžys c. mun.;2006;57;1234;536;698
Panevėžys c. mun.;2006;58;1138;455;683
Panevėžys c. mun.;2006;59;1148;472;676
Panevėžys c. mun.;2006;60;1166;470;696
Panevėžys c. mun.;2006;61;1141;501;640
Panevėžys c. mun.;2006;62;1286;535;751
Panevėžys c. mun.;2006;63;1331;539;792
Panevėžys c. mun.;2006;64;1300;547;753
Panevėžys c. mun.;2006;65;1166;493;673
Panevėžys c. mun.;2006;66;1099;433;666
Panevėžys c. mun.;2006;67;1088;397;691
Panevėžys c. mun.;2006;68;1020;357;663
Panevėžys c. mun.;2006;69;1043;401;642
Panevėžys c. mun.;2006;70;933;323;610
Panevėžys c. mun.;2006;71;935;347;588
Panevėžys c. mun.;2006;72;905;329;576
Panevėžys c. mun.;2006;73;885;301;584
Panevėžys c. mun.;2006;74;754;263;491
Panevėžys c. mun.;2006;75;746;261;485
Panevėžys c. mun.;2006;76;735;260;475
Panevėžys c. mun.;2006;77;729;246;483
Panevėžys c. mun.;2006;78;609;215;394
Panevėžys c. mun.;2006;79;540;143;397
Panevėžys c. mun.;2006;80;505;114;391
Panevėžys c. mun.;2006;81;468;121;347
Panevėžys c. mun.;2006;82;448;112;336
Panevėžys c. mun.;2006;83;349;85;264
Panevėžys c. mun.;2006;84;321;84;237
Panevėžys c. mun.;2006;85;1263;284;979
Panevėžys c. mun.;2007;-1;108314;48650;59664
Panevėžys c. mun.;2007;0;891;430;461
Panevėžys c. mun.;2007;1;871;449;422
Panevėžys c. mun.;2007;2;861;420;441
Panevėžys c. mun.;2007;3;829;424;405
Panevėžys c. mun.;2007;4;896;463;433
Panevėžys c. mun.;2007;5;892;433;459
Panevėžys c. mun.;2007;6;996;527;469
Panevėžys c. mun.;2007;7;1090;584;506
Panevėžys c. mun.;2007;8;1111;542;569
Panevėžys c. mun.;2007;9;1232;607;625
Panevėžys c. mun.;2007;10;1219;613;606
Panevėžys c. mun.;2007;11;1311;656;655
Panevėžys c. mun.;2007;12;1294;662;632
Panevėžys c. mun.;2007;13;1462;770;692
Panevėžys c. mun.;2007;14;1611;800;811
Panevėžys c. mun.;2007;15;1666;849;817
Panevėžys c. mun.;2007;16;1624;843;781
Panevėžys c. mun.;2007;17;1553;786;767
Panevėžys c. mun.;2007;18;1650;835;815
Panevėžys c. mun.;2007;19;1687;870;817
Panevėžys c. mun.;2007;20;1663;830;833
Panevėžys c. mun.;2007;21;1547;755;792
Panevėžys c. mun.;2007;22;1521;714;807
Panevėžys c. mun.;2007;23;1496;741;755
Panevėžys c. mun.;2007;24;1226;582;644
Panevėžys c. mun.;2007;25;1150;581;569
Panevėžys c. mun.;2007;26;1171;597;574
Panevėžys c. mun.;2007;27;1172;574;598
Panevėžys c. mun.;2007;28;1239;627;612
Panevėžys c. mun.;2007;29;1414;678;736
Panevėžys c. mun.;2007;30;1456;720;736
Panevėžys c. mun.;2007;31;1492;706;786
Panevėžys c. mun.;2007;32;1532;686;846
Panevėžys c. mun.;2007;33;1547;730;817
Panevėžys c. mun.;2007;34;1548;710;838
Panevėžys c. mun.;2007;35;1554;682;872
Panevėžys c. mun.;2007;36;1637;776;861
Panevėžys c. mun.;2007;37;1625;795;830
Panevėžys c. mun.;2007;38;1748;826;922
Panevėžys c. mun.;2007;39;1741;792;949
Panevėžys c. mun.;2007;40;1727;776;951
Panevėžys c. mun.;2007;41;1727;816;911
Panevėžys c. mun.;2007;42;1811;809;1002
Panevėžys c. mun.;2007;43;1867;851;1016
Panevėžys c. mun.;2007;44;1963;877;1086
Panevėžys c. mun.;2007;45;1962;886;1076
Panevėžys c. mun.;2007;46;1874;853;1021
Panevėžys c. mun.;2007;47;1894;870;1024
Panevėžys c. mun.;2007;48;1713;772;941
Panevėžys c. mun.;2007;49;1626;701;925
Panevėžys c. mun.;2007;50;1505;671;834
Panevėžys c. mun.;2007;51;1362;628;734
Panevėžys c. mun.;2007;52;1398;624;774
Panevėžys c. mun.;2007;53;1271;591;680
Panevėžys c. mun.;2007;54;1353;582;771
Panevėžys c. mun.;2007;55;1264;529;735
Panevėžys c. mun.;2007;56;1276;525;751
Panevėžys c. mun.;2007;57;1234;505;729
Panevėžys c. mun.;2007;58;1211;525;686
Panevėžys c. mun.;2007;59;1114;443;671
Panevėžys c. mun.;2007;60;1126;459;667
Panevėžys c. mun.;2007;61;1142;453;689
Panevėžys c. mun.;2007;62;1116;482;634
Panevėžys c. mun.;2007;63;1251;509;742
Panevėžys c. mun.;2007;64;1298;522;776
Panevėžys c. mun.;2007;65;1258;514;744
Panevėžys c. mun.;2007;66;1126;467;659
Panevėžys c. mun.;2007;67;1065;417;648
Panevėžys c. mun.;2007;68;1054;374;680
Panevėžys c. mun.;2007;69;994;344;650
Panevėžys c. mun.;2007;70;1008;384;624
Panevėžys c. mun.;2007;71;913;306;607
Panevėžys c. mun.;2007;72;911;335;576
Panevėžys c. mun.;2007;73;865;309;556
Panevėžys c. mun.;2007;74;860;289;571
Panevėžys c. mun.;2007;75;729;252;477
Panevėžys c. mun.;2007;76;713;241;472
Panevėžys c. mun.;2007;77;708;246;462
Panevėžys c. mun.;2007;78;685;222;463
Panevėžys c. mun.;2007;79;577;201;376
Panevėžys c. mun.;2007;80;506;130;376
Panevėžys c. mun.;2007;81;480;106;374
Panevėžys c. mun.;2007;82;439;109;330
Panevėžys c. mun.;2007;83;418;105;313
Panevėžys c. mun.;2007;84;320;75;245
Panevėžys c. mun.;2007;85;1375;300;1075
Panevėžys c. mun.;2008;-1;106495;47790;58705
Panevėžys c. mun.;2008;0;824;424;400
Panevėžys c. mun.;2008;1;869;416;453
Panevėžys c. mun.;2008;2;856;442;414
Panevėžys c. mun.;2008;3;854;420;434
Panevėžys c. mun.;2008;4;829;426;403
Panevėžys c. mun.;2008;5;886;453;433
Panevėžys c. mun.;2008;6;874;423;451
Panevėžys c. mun.;2008;7;987;528;459
Panevėžys c. mun.;2008;8;1087;586;501
Panevėžys c. mun.;2008;9;1097;536;561
Panevėžys c. mun.;2008;10;1216;606;610
Panevėžys c. mun.;2008;11;1207;609;598
Panevėžys c. mun.;2008;12;1297;649;648
Panevėžys c. mun.;2008;13;1270;651;619
Panevėžys c. mun.;2008;14;1443;762;681
Panevėžys c. mun.;2008;15;1589;787;802
Panevėžys c. mun.;2008;16;1639;834;805
Panevėžys c. mun.;2008;17;1607;833;774
Panevėžys c. mun.;2008;18;1532;773;759
Panevėžys c. mun.;2008;19;1610;811;799
Panevėžys c. mun.;2008;20;1638;852;786
Panevėžys c. mun.;2008;21;1620;804;816
Panevėžys c. mun.;2008;22;1503;740;763
Panevėžys c. mun.;2008;23;1482;693;789
Panevėžys c. mun.;2008;24;1450;711;739
Panevėžys c. mun.;2008;25;1195;575;620
Panevėžys c. mun.;2008;26;1107;553;554
Panevėžys c. mun.;2008;27;1144;578;566
Panevėžys c. mun.;2008;28;1150;558;592
Panevėžys c. mun.;2008;29;1206;615;591
Panevėžys c. mun.;2008;30;1375;663;712
Panevėžys c. mun.;2008;31;1441;714;727
Panevėžys c. mun.;2008;32;1470;690;780
Panevėžys c. mun.;2008;33;1503;675;828
Panevėžys c. mun.;2008;34;1532;729;803
Panevėžys c. mun.;2008;35;1521;697;824
Panevėžys c. mun.;2008;36;1524;672;852
Panevėžys c. mun.;2008;37;1602;756;846
Panevėžys c. mun.;2008;38;1611;791;820
Panevėžys c. mun.;2008;39;1715;804;911
Panevėžys c. mun.;2008;40;1705;778;927
Panevėžys c. mun.;2008;41;1690;754;936
Panevėžys c. mun.;2008;42;1702;806;896
Panevėžys c. mun.;2008;43;1769;788;981
Panevėžys c. mun.;2008;44;1836;836;1000
Panevėžys c. mun.;2008;45;1917;856;1061
Panevėžys c. mun.;2008;46;1922;863;1059
Panevėžys c. mun.;2008;47;1836;831;1005
Panevėžys c. mun.;2008;48;1859;847;1012
Panevėžys c. mun.;2008;49;1681;758;923
Panevėžys c. mun.;2008;50;1597;687;910
Panevėžys c. mun.;2008;51;1474;652;822
Panevėžys c. mun.;2008;52;1342;616;726
Panevėžys c. mun.;2008;53;1368;611;757
Panevėžys c. mun.;2008;54;1237;572;665
Panevėžys c. mun.;2008;55;1318;561;757
Panevėžys c. mun.;2008;56;1234;510;724
Panevėžys c. mun.;2008;57;1240;508;732
Panevėžys c. mun.;2008;58;1200;486;714
Panevėžys c. mun.;2008;59;1198;512;686
Panevėžys c. mun.;2008;60;1086;428;658
Panevėžys c. mun.;2008;61;1104;446;658
Panevėžys c. mun.;2008;62;1121;445;676
Panevėžys c. mun.;2008;63;1082;461;621
Panevėžys c. mun.;2008;64;1213;483;730
Panevėžys c. mun.;2008;65;1255;493;762
Panevėžys c. mun.;2008;66;1226;496;730
Panevėžys c. mun.;2008;67;1092;447;645
Panevėžys c. mun.;2008;68;1049;404;645
Panevėžys c. mun.;2008;69;1030;361;669
Panevėžys c. mun.;2008;70;964;330;634
Panevėžys c. mun.;2008;71;967;365;602
Panevėžys c. mun.;2008;72;884;294;590
Panevėžys c. mun.;2008;73;888;317;571
Panevėžys c. mun.;2008;74;830;294;536
Panevėžys c. mun.;2008;75;829;272;557
Panevėžys c. mun.;2008;76;695;234;461
Panevėžys c. mun.;2008;77;672;224;448
Panevėžys c. mun.;2008;78;671;229;442
Panevėžys c. mun.;2008;79;630;196;434
Panevėžys c. mun.;2008;80;538;185;353
Panevėžys c. mun.;2008;81;484;124;360
Panevėžys c. mun.;2008;82;448;96;352
Panevėžys c. mun.;2008;83;403;96;307
Panevėžys c. mun.;2008;84;383;92;291
Panevėžys c. mun.;2008;85;1464;307;1157
Panevėžys c. mun.;2009;-1;104793;46885;57908
Panevėžys c. mun.;2009;0;856;461;395
Panevėžys c. mun.;2009;1;800;412;388
Panevėžys c. mun.;2009;2;846;402;444
Panevėžys c. mun.;2009;3;842;437;405
Panevėžys c. mun.;2009;4;847;413;434
Panevėžys c. mun.;2009;5;813;416;397
Panevėžys c. mun.;2009;6;858;436;422
Panevėžys c. mun.;2009;7;874;420;454
Panevėžys c. mun.;2009;8;968;516;452
Panevėžys c. mun.;2009;9;1082;585;497
Panevėžys c. mun.;2009;10;1085;527;558
Panevėžys c. mun.;2009;11;1194;593;601
Panevėžys c. mun.;2009;12;1191;598;593
Panevėžys c. mun.;2009;13;1282;639;643
Panevėžys c. mun.;2009;14;1247;634;613
Panevėžys c. mun.;2009;15;1421;748;673
Panevėžys c. mun.;2009;16;1580;779;801
Panevėžys c. mun.;2009;17;1611;817;794
Panevėžys c. mun.;2009;18;1588;820;768
Panevėžys c. mun.;2009;19;1506;756;750
Panevėžys c. mun.;2009;20;1589;795;794
Panevėžys c. mun.;2009;21;1599;829;770
Panevėžys c. mun.;2009;22;1586;784;802
Panevėžys c. mun.;2009;23;1470;720;750
Panevėžys c. mun.;2009;24;1452;682;770
Panevėžys c. mun.;2009;25;1411;693;718
Panevėžys c. mun.;2009;26;1135;552;583
Panevėžys c. mun.;2009;27;1053;532;521
Panevėžys c. mun.;2009;28;1094;551;543
Panevėžys c. mun.;2009;29;1123;548;575
Panevėžys c. mun.;2009;30;1184;604;580
Panevėžys c. mun.;2009;31;1330;630;700
Panevėžys c. mun.;2009;32;1414;698;716
Panevėžys c. mun.;2009;33;1431;673;758
Panevėžys c. mun.;2009;34;1466;661;805
Panevėžys c. mun.;2009;35;1495;708;787
Panevėžys c. mun.;2009;36;1490;679;811
Panevėžys c. mun.;2009;37;1506;663;843
Panevėžys c. mun.;2009;38;1578;750;828
Panevėžys c. mun.;2009;39;1579;773;806
Panevėžys c. mun.;2009;40;1691;790;901
Panevėžys c. mun.;2009;41;1681;759;922
Panevėžys c. mun.;2009;42;1668;739;929
Panevėžys c. mun.;2009;43;1670;786;884
Panevėžys c. mun.;2009;44;1749;775;974
Panevėžys c. mun.;2009;45;1805;818;987
Panevėžys c. mun.;2009;46;1890;842;1048
Panevėžys c. mun.;2009;47;1903;856;1047
Panevėžys c. mun.;2009;48;1804;810;994
Panevėžys c. mun.;2009;49;1832;833;999
Panevėžys c. mun.;2009;50;1653;738;915
Panevėžys c. mun.;2009;51;1579;676;903
Panevėžys c. mun.;2009;52;1457;642;815
Panevėžys c. mun.;2009;53;1308;595;713
Panevėžys c. mun.;2009;54;1355;603;752
Panevėžys c. mun.;2009;55;1205;547;658
Panevėžys c. mun.;2009;56;1288;548;740
Panevėžys c. mun.;2009;57;1219;505;714
Panevėžys c. mun.;2009;58;1212;484;728
Panevėžys c. mun.;2009;59;1177;467;710
Panevėžys c. mun.;2009;60;1172;492;680
Panevėžys c. mun.;2009;61;1068;418;650
Panevėžys c. mun.;2009;62;1077;428;649
Panevėžys c. mun.;2009;63;1087;424;663
Panevėžys c. mun.;2009;64;1064;447;617
Panevėžys c. mun.;2009;65;1167;456;711
Panevėžys c. mun.;2009;66;1220;467;753
Panevėžys c. mun.;2009;67;1198;477;721
Panevėžys c. mun.;2009;68;1061;424;637
Panevėžys c. mun.;2009;69;1018;388;630
Panevėžys c. mun.;2009;70;1001;343;658
Panevėžys c. mun.;2009;71;939;312;627
Panevėžys c. mun.;2009;72;930;341;589
Panevėžys c. mun.;2009;73;852;277;575
Panevėžys c. mun.;2009;74;853;295;558
Panevėžys c. mun.;2009;75;795;280;515
Panevėžys c. mun.;2009;76;800;259;541
Panevėžys c. mun.;2009;77;663;215;448
Panevėžys c. mun.;2009;78;630;205;425
Panevėžys c. mun.;2009;79;633;210;423
Panevėžys c. mun.;2009;80;596;176;420
Panevėžys c. mun.;2009;81;507;175;332
Panevėžys c. mun.;2009;82;446;110;336
Panevėžys c. mun.;2009;83;417;91;326
Panevėžys c. mun.;2009;84;370;79;291
Panevėžys c. mun.;2009;85;1607;349;1258
Panevėžys c. mun.;2010;-1;103101;45927;57174
Panevėžys c. mun.;2010;0;931;477;454
Panevėžys c. mun.;2010;1;846;453;393
Panevėžys c. mun.;2010;2;794;414;380
Panevėžys c. mun.;2010;3;830;400;430
Panevėžys c. mun.;2010;4;834;432;402
Panevėžys c. mun.;2010;5;836;410;426
Panevėžys c. mun.;2010;6;803;412;391
Panevėžys c. mun.;2010;7;870;437;433
Panevėžys c. mun.;2010;8;872;416;456
Panevėžys c. mun.;2010;9;975;513;462
Panevėžys c. mun.;2010;10;1083;583;500
Panevėžys c. mun.;2010;11;1073;514;559
Panevėžys c. mun.;2010;12;1178;578;600
Panevėžys c. mun.;2010;13;1183;595;588
Panevėžys c. mun.;2010;14;1277;638;639
Panevėžys c. mun.;2010;15;1235;628;607
Panevėžys c. mun.;2010;16;1412;739;673
Panevėžys c. mun.;2010;17;1567;765;802
Panevėžys c. mun.;2010;18;1586;801;785
Panevėžys c. mun.;2010;19;1548;804;744
Panevėžys c. mun.;2010;20;1472;740;732
Panevėžys c. mun.;2010;21;1535;770;765
Panevėžys c. mun.;2010;22;1550;795;755
Panevėžys c. mun.;2010;23;1520;744;776
Panevėžys c. mun.;2010;24;1405;690;715
Panevėžys c. mun.;2010;25;1380;649;731
Panevėžys c. mun.;2010;26;1339;658;681
Panevėžys c. mun.;2010;27;1057;514;543
Panevėžys c. mun.;2010;28;1018;510;508
Panevėžys c. mun.;2010;29;1072;531;541
Panevėžys c. mun.;2010;30;1091;533;558
Panevėžys c. mun.;2010;31;1157;580;577
Panevėžys c. mun.;2010;32;1294;617;677
Panevėžys c. mun.;2010;33;1401;687;714
Panevėžys c. mun.;2010;34;1407;653;754
Panevėžys c. mun.;2010;35;1429;638;791
Panevėžys c. mun.;2010;36;1456;689;767
Panevėžys c. mun.;2010;37;1477;668;809
Panevėžys c. mun.;2010;38;1482;647;835
Panevėžys c. mun.;2010;39;1548;733;815
Panevėžys c. mun.;2010;40;1553;752;801
Panevėžys c. mun.;2010;41;1654;764;890
Panevėžys c. mun.;2010;42;1658;740;918
Panevėžys c. mun.;2010;43;1633;722;911
Panevėžys c. mun.;2010;44;1644;770;874
Panevėžys c. mun.;2010;45;1715;752;963
Panevėžys c. mun.;2010;46;1767;797;970
Panevėžys c. mun.;2010;47;1849;816;1033
Panevėžys c. mun.;2010;48;1864;832;1032
Panevėžys c. mun.;2010;49;1775;794;981
Panevėžys c. mun.;2010;50;1806;816;990
Panevėžys c. mun.;2010;51;1627;717;910
Panevėžys c. mun.;2010;52;1545;659;886
Panevėžys c. mun.;2010;53;1426;626;800
Panevėžys c. mun.;2010;54;1280;580;700
Panevėžys c. mun.;2010;55;1333;592;741
Panevėžys c. mun.;2010;56;1187;534;653
Panevėžys c. mun.;2010;57;1261;527;734
Panevėžys c. mun.;2010;58;1189;485;704
Panevėžys c. mun.;2010;59;1181;470;711
Panevėžys c. mun.;2010;60;1153;452;701
Panevėžys c. mun.;2010;61;1160;483;677
Panevėžys c. mun.;2010;62;1042;400;642
Panevėžys c. mun.;2010;63;1059;413;646
Panevėžys c. mun.;2010;64;1060;404;656
Panevėžys c. mun.;2010;65;1038;427;611
Panevėžys c. mun.;2010;66;1131;437;694
Panevėžys c. mun.;2010;67;1195;453;742
Panevėžys c. mun.;2010;68;1158;452;706
Panevėžys c. mun.;2010;69;1031;408;623
Panevėžys c. mun.;2010;70;987;365;622
Panevėžys c. mun.;2010;71;973;329;644
Panevėžys c. mun.;2010;72;917;304;613
Panevėžys c. mun.;2010;73;897;320;577
Panevėžys c. mun.;2010;74;825;263;562
Panevėžys c. mun.;2010;75;809;274;535
Panevėžys c. mun.;2010;76;758;256;502
Panevėžys c. mun.;2010;77;757;247;510
Panevėžys c. mun.;2010;78;641;204;437
Panevėžys c. mun.;2010;79;598;190;408
Panevėžys c. mun.;2010;80;588;197;391
Panevėžys c. mun.;2010;81;563;162;401
Panevėžys c. mun.;2010;82;471;161;310
Panevėžys c. mun.;2010;83;420;96;324
Panevėžys c. mun.;2010;84;385;81;304
Panevėžys c. mun.;2010;85;1715;349;1366
Panevėžys c. mun.;2011;-1;100027;44432;55595
Panevėžys c. mun.;2011;0;858;442;416
Panevėžys c. mun.;2011;1;941;509;432
Panevėžys c. mun.;2011;2;879;496;383
Panevėžys c. mun.;2011;3;826;418;408
Panevėžys c. mun.;2011;4;870;426;444
Panevėžys c. mun.;2011;5;877;468;409
Panevėžys c. mun.;2011;6;894;442;452
Panevėžys c. mun.;2011;7;848;443;405
Panevėžys c. mun.;2011;8;867;452;415
Panevėžys c. mun.;2011;9;843;409;434
Panevėžys c. mun.;2011;10;968;504;464
Panevėžys c. mun.;2011;11;1043;557;486
Panevėžys c. mun.;2011;12;1076;527;549
Panevėžys c. mun.;2011;13;1168;583;585
Panevėžys c. mun.;2011;14;1179;594;585
Panevėžys c. mun.;2011;15;1233;641;592
Panevėžys c. mun.;2011;16;1222;634;588
Panevėžys c. mun.;2011;17;1374;714;660
Panevėžys c. mun.;2011;18;1578;764;814
Panevėžys c. mun.;2011;19;1441;743;698
Panevėžys c. mun.;2011;20;1308;685;623
Panevėžys c. mun.;2011;21;1259;630;629
Panevėžys c. mun.;2011;22;1369;682;687
Panevėžys c. mun.;2011;23;1353;692;661
Panevėžys c. mun.;2011;24;1298;663;635
Panevėžys c. mun.;2011;25;1142;594;548
Panevėžys c. mun.;2011;26;1100;546;554
Panevėžys c. mun.;2011;27;1124;559;565
Panevėžys c. mun.;2011;28;1023;483;540
Panevėžys c. mun.;2011;29;1035;534;501
Panevėžys c. mun.;2011;30;1047;524;523
Panevėžys c. mun.;2011;31;1095;536;559
Panevėžys c. mun.;2011;32;1105;544;561
Panevėžys c. mun.;2011;33;1186;566;620
Panevėžys c. mun.;2011;34;1207;591;616
Panevėžys c. mun.;2011;35;1236;580;656
Panevėžys c. mun.;2011;36;1258;547;711
Panevėžys c. mun.;2011;37;1354;634;720
Panevėžys c. mun.;2011;38;1378;632;746
Panevėžys c. mun.;2011;39;1408;616;792
Panevėžys c. mun.;2011;40;1454;666;788
Panevėžys c. mun.;2011;41;1433;657;776
Panevėžys c. mun.;2011;42;1545;694;851
Panevėžys c. mun.;2011;43;1610;696;914
Panevėžys c. mun.;2011;44;1569;700;869
Panevėžys c. mun.;2011;45;1566;696;870
Panevėžys c. mun.;2011;46;1656;711;945
Panevėžys c. mun.;2011;47;1741;774;967
Panevėžys c. mun.;2011;48;1816;787;1029
Panevėžys c. mun.;2011;49;1856;808;1048
Panevėžys c. mun.;2011;50;1778;784;994
Panevėžys c. mun.;2011;51;1764;778;986
Panevėžys c. mun.;2011;52;1647;715;932
Panevėžys c. mun.;2011;53;1567;655;912
Panevėžys c. mun.;2011;54;1449;624;825
Panevėžys c. mun.;2011;55;1288;568;720
Panevėžys c. mun.;2011;56;1313;593;720
Panevėžys c. mun.;2011;57;1171;527;644
Panevėžys c. mun.;2011;58;1244;517;727
Panevėžys c. mun.;2011;59;1189;471;718
Panevėžys c. mun.;2011;60;1216;484;732
Panevėžys c. mun.;2011;61;1158;447;711
Panevėžys c. mun.;2011;62;1174;489;685
Panevėžys c. mun.;2011;63;1013;379;634
Panevėžys c. mun.;2011;64;1028;390;638
Panevėžys c. mun.;2011;65;1051;402;649
Panevėžys c. mun.;2011;66;1045;418;627
Panevėžys c. mun.;2011;67;1177;450;727
Panevėžys c. mun.;2011;68;1218;460;758
Panevėžys c. mun.;2011;69;1170;450;720
Panevėžys c. mun.;2011;70;1028;396;632
Panevėžys c. mun.;2011;71;991;357;634
Panevėžys c. mun.;2011;72;984;328;656
Panevėžys c. mun.;2011;73;897;292;605
Panevėžys c. mun.;2011;74;902;310;592
Panevėžys c. mun.;2011;75;834;254;580
Panevėžys c. mun.;2011;76;811;274;537
Panevėžys c. mun.;2011;77;763;245;518
Panevėžys c. mun.;2011;78;748;243;505
Panevėžys c. mun.;2011;79;638;211;427
Panevėžys c. mun.;2011;80;596;192;404
Panevėžys c. mun.;2011;81;574;183;391
Panevėžys c. mun.;2011;82;542;154;388
Panevėžys c. mun.;2011;83;440;143;297
Panevėžys c. mun.;2011;84;398;94;304
Panevėžys c. mun.;2011;85;1705;362;1343
Panevėžys c. mun.;2012;-1;98469;43640;54829
Panevėžys c. mun.;2012;0;899;451;448
Panevėžys c. mun.;2012;1;867;451;416
Panevėžys c. mun.;2012;2;954;511;443
Panevėžys c. mun.;2012;3;877;493;384
Panevėžys c. mun.;2012;4;828;418;410
Panevėžys c. mun.;2012;5;870;427;443
Panevėžys c. mun.;2012;6;875;469;406
Panevėžys c. mun.;2012;7;896;443;453
Panevėžys c. mun.;2012;8;837;444;393
Panevėžys c. mun.;2012;9;848;439;409
Panevėžys c. mun.;2012;10;838;406;432
Panevėžys c. mun.;2012;11;974;509;465
Panevėžys c. mun.;2012;12;1030;551;479
Panevėžys c. mun.;2012;13;1071;528;543
Panevėžys c. mun.;2012;14;1163;576;587
Panevėžys c. mun.;2012;15;1166;586;580
Panevėžys c. mun.;2012;16;1219;629;590
Panevėžys c. mun.;2012;17;1224;635;589
Panevėžys c. mun.;2012;18;1360;713;647
Panevėžys c. mun.;2012;19;1533;740;793
Panevėžys c. mun.;2012;20;1424;726;698
Panevėžys c. mun.;2012;21;1258;667;591
Panevėžys c. mun.;2012;22;1208;603;605
Panevėžys c. mun.;2012;23;1309;658;651
Panevėžys c. mun.;2012;24;1286;668;618
Panevėžys c. mun.;2012;25;1223;627;596
Panevėžys c. mun.;2012;26;1037;545;492
Panevėžys c. mun.;2012;27;1023;510;513
Panevėžys c. mun.;2012;28;1064;525;539
Panevėžys c. mun.;2012;29;998;458;540
Panevėžys c. mun.;2012;30;999;514;485
Panevėžys c. mun.;2012;31;1001;501;500
Panevėžys c. mun.;2012;32;1049;504;545
Panevėžys c. mun.;2012;33;1081;533;548
Panevėžys c. mun.;2012;34;1158;558;600
Panevėžys c. mun.;2012;35;1177;576;601
Panevėžys c. mun.;2012;36;1218;568;650
Panevėžys c. mun.;2012;37;1240;534;706
Panevėžys c. mun.;2012;38;1338;626;712
Panevėžys c. mun.;2012;39;1369;628;741
Panevėžys c. mun.;2012;40;1397;611;786
Panevėžys c. mun.;2012;41;1418;652;766
Panevėžys c. mun.;2012;42;1408;638;770
Panevėžys c. mun.;2012;43;1526;684;842
Panevėžys c. mun.;2012;44;1571;676;895
Panevėžys c. mun.;2012;45;1552;692;860
Panevėžys c. mun.;2012;46;1553;690;863
Panevėžys c. mun.;2012;47;1637;708;929
Panevėžys c. mun.;2012;48;1723;767;956
Panevėžys c. mun.;2012;49;1794;776;1018
Panevėžys c. mun.;2012;50;1835;794;1041
Panevėžys c. mun.;2012;51;1762;781;981
Panevėžys c. mun.;2012;52;1746;766;980
Panevėžys c. mun.;2012;53;1615;698;917
Panevėžys c. mun.;2012;54;1543;640;903
Panevėžys c. mun.;2012;55;1424;609;815
Panevėžys c. mun.;2012;56;1279;555;724
Panevėžys c. mun.;2012;57;1291;574;717
Panevėžys c. mun.;2012;58;1151;517;634
Panevėžys c. mun.;2012;59;1220;504;716
Panevėžys c. mun.;2012;60;1169;455;714
Panevėžys c. mun.;2012;61;1192;466;726
Panevėžys c. mun.;2012;62;1120;428;692
Panevėžys c. mun.;2012;63;1153;477;676
Panevėžys c. mun.;2012;64;993;365;628
Panevėžys c. mun.;2012;65;999;372;627
Panevėžys c. mun.;2012;66;1027;384;643
Panevėžys c. mun.;2012;67;1013;393;620
Panevėžys c. mun.;2012;68;1157;436;721
Panevėžys c. mun.;2012;69;1197;442;755
Panevėžys c. mun.;2012;70;1146;437;709
Panevėžys c. mun.;2012;71;1006;382;624
Panevėžys c. mun.;2012;72;949;329;620
Panevėžys c. mun.;2012;73;955;312;643
Panevėžys c. mun.;2012;74;864;271;593
Panevėžys c. mun.;2012;75;871;292;579
Panevėžys c. mun.;2012;76;806;240;566
Panevėžys c. mun.;2012;77;778;255;523
Panevėžys c. mun.;2012;78;726;221;505
Panevėžys c. mun.;2012;79;708;221;487
Panevėžys c. mun.;2012;80;590;192;398
Panevėžys c. mun.;2012;81;566;180;386
Panevėžys c. mun.;2012;82;546;170;376
Panevėžys c. mun.;2012;83;496;134;362
Panevėžys c. mun.;2012;84;398;126;272
Panevėžys c. mun.;2012;85;1810;380;1430
Panevėžys c. mun.;2013;-1;97343;43029;54314
Panevėžys c. mun.;2013;0;917;473;444
Panevėžys c. mun.;2013;1;914;461;453
Panevėžys c. mun.;2013;2;884;464;420
Panevėžys c. mun.;2013;3;954;504;450
Panevėžys c. mun.;2013;4;862;483;379
Panevėžys c. mun.;2013;5;806;400;406
Panevėžys c. mun.;2013;6;867;422;445
Panevėžys c. mun.;2013;7;876;469;407
Panevėžys c. mun.;2013;8;891;441;450
Panevėžys c. mun.;2013;9;840;443;397
Panevėžys c. mun.;2013;10;852;446;406
Panevėžys c. mun.;2013;11;839;401;438
Panevėžys c. mun.;2013;12;960;499;461
Panevėžys c. mun.;2013;13;1016;545;471
Panevėžys c. mun.;2013;14;1073;528;545
Panevėžys c. mun.;2013;15;1161;571;590
Panevėžys c. mun.;2013;16;1160;582;578
Panevėžys c. mun.;2013;17;1215;624;591
Panevėžys c. mun.;2013;18;1207;621;586
Panevėžys c. mun.;2013;19;1332;700;632
Panevėžys c. mun.;2013;20;1502;717;785
Panevėžys c. mun.;2013;21;1395;704;691
Panevėžys c. mun.;2013;22;1228;647;581
Panevėžys c. mun.;2013;23;1144;566;578
Panevėžys c. mun.;2013;24;1270;640;630
Panevėžys c. mun.;2013;25;1246;648;598
Panevėžys c. mun.;2013;26;1161;584;577
Panevėžys c. mun.;2013;27;992;521;471
Panevėžys c. mun.;2013;28;1004;504;500
Panevėžys c. mun.;2013;29;1024;501;523
Panevėžys c. mun.;2013;30;973;454;519
Panevėžys c. mun.;2013;31;980;500;480
Panevėžys c. mun.;2013;32;977;496;481
Panevėžys c. mun.;2013;33;1027;488;539
Panevėžys c. mun.;2013;34;1061;524;537
Panevėžys c. mun.;2013;35;1149;553;596
Panevėžys c. mun.;2013;36;1167;576;591
Panevėžys c. mun.;2013;37;1213;567;646
Panevėžys c. mun.;2013;38;1224;528;696
Panevėžys c. mun.;2013;39;1337;624;713
Panevėžys c. mun.;2013;40;1358;629;729
Panevėžys c. mun.;2013;41;1385;608;777
Panevėžys c. mun.;2013;42;1404;643;761
Panevėžys c. mun.;2013;43;1395;630;765
Panevėžys c. mun.;2013;44;1506;668;838
Panevėžys c. mun.;2013;45;1545;665;880
Panevėžys c. mun.;2013;46;1527;683;844
Panevėžys c. mun.;2013;47;1546;690;856
Panevėžys c. mun.;2013;48;1613;696;917
Panevėžys c. mun.;2013;49;1713;757;956
Panevėžys c. mun.;2013;50;1786;774;1012
Panevėžys c. mun.;2013;51;1812;778;1034
Panevėžys c. mun.;2013;52;1732;760;972
Panevėžys c. mun.;2013;53;1725;754;971
Panevėžys c. mun.;2013;54;1598;684;914
Panevėžys c. mun.;2013;55;1515;627;888
Panevėžys c. mun.;2013;56;1402;591;811
Panevėžys c. mun.;2013;57;1258;540;718
Panevėžys c. mun.;2013;58;1280;562;718
Panevėžys c. mun.;2013;59;1133;506;627
Panevėžys c. mun.;2013;60;1206;495;711
Panevėžys c. mun.;2013;61;1142;437;705
Panevėžys c. mun.;2013;62;1158;447;711
Panevėžys c. mun.;2013;63;1103;418;685
Panevėžys c. mun.;2013;64;1134;467;667
Panevėžys c. mun.;2013;65;974;355;619
Panevėžys c. mun.;2013;66;972;354;618
Panevėžys c. mun.;2013;67;1000;362;638
Panevėžys c. mun.;2013;68;993;379;614
Panevėžys c. mun.;2013;69;1127;420;707
Panevėžys c. mun.;2013;70;1157;421;736
Panevėžys c. mun.;2013;71;1103;405;698
Panevėžys c. mun.;2013;72;975;362;613
Panevėžys c. mun.;2013;73;921;311;610
Panevėžys c. mun.;2013;74;930;295;635
Panevėžys c. mun.;2013;75;831;248;583
Panevėžys c. mun.;2013;76;837;275;562
Panevėžys c. mun.;2013;77;770;222;548
Panevėžys c. mun.;2013;78;749;241;508
Panevėžys c. mun.;2013;79;693;208;485
Panevėžys c. mun.;2013;80;679;211;468
Panevėžys c. mun.;2013;81;554;176;378
Panevėžys c. mun.;2013;82;525;162;363
Panevėžys c. mun.;2013;83;507;156;351
Panevėžys c. mun.;2013;84;460;118;342
Panevėžys c. mun.;2013;85;1910;420;1490
Panevėžys c. mun.;2014;-1;96328;42597;53731
Panevėžys c. mun.;2014;0;858;443;415
Panevėžys c. mun.;2014;1;935;487;448
Panevėžys c. mun.;2014;2;921;467;454
Panevėžys c. mun.;2014;3;878;466;412
Panevėžys c. mun.;2014;4;949;507;442
Panevėžys c. mun.;2014;5;859;484;375
Panevėžys c. mun.;2014;6;805;398;407
Panevėžys c. mun.;2014;7;884;433;451
Panevėžys c. mun.;2014;8;879;473;406
Panevėžys c. mun.;2014;9;881;435;446
Panevėžys c. mun.;2014;10;830;437;393
Panevėžys c. mun.;2014;11;860;449;411
Panevėžys c. mun.;2014;12;826;397;429
Panevėžys c. mun.;2014;13;956;495;461
Panevėžys c. mun.;2014;14;998;531;467
Panevėžys c. mun.;2014;15;1072;528;544
Panevėžys c. mun.;2014;16;1151;567;584
Panevėžys c. mun.;2014;17;1152;583;569
Panevėžys c. mun.;2014;18;1213;624;589
Panevėžys c. mun.;2014;19;1182;607;575
Panevėžys c. mun.;2014;20;1297;678;619
Panevėžys c. mun.;2014;21;1472;697;775
Panevėžys c. mun.;2014;22;1366;689;677
Panevėžys c. mun.;2014;23;1171;612;559
Panevėžys c. mun.;2014;24;1138;564;574
Panevėžys c. mun.;2014;25;1217;613;604
Panevėžys c. mun.;2014;26;1225;639;586
Panevėžys c. mun.;2014;27;1128;567;561
Panevėžys c. mun.;2014;28;950;507;443
Panevėžys c. mun.;2014;29;960;490;470
Panevėžys c. mun.;2014;30;995;481;514
Panevėžys c. mun.;2014;31;960;444;516
Panevėžys c. mun.;2014;32;957;491;466
Panevėžys c. mun.;2014;33;969;485;484
Panevėžys c. mun.;2014;34;1025;486;539
Panevėžys c. mun.;2014;35;1054;525;529
Panevėžys c. mun.;2014;36;1130;542;588
Panevėžys c. mun.;2014;37;1155;570;585
Panevėžys c. mun.;2014;38;1213;565;648
Panevėžys c. mun.;2014;39;1209;521;688
Panevėžys c. mun.;2014;40;1328;621;707
Panevėžys c. mun.;2014;41;1333;617;716
Panevėžys c. mun.;2014;42;1382;605;777
Panevėžys c. mun.;2014;43;1398;644;754
Panevėžys c. mun.;2014;44;1384;630;754
Panevėžys c. mun.;2014;45;1471;647;824
Panevėžys c. mun.;2014;46;1530;659;871
Panevėžys c. mun.;2014;47;1501;670;831
Panevėžys c. mun.;2014;48;1527;682;845
Panevėžys c. mun.;2014;49;1606;691;915
Panevėžys c. mun.;2014;50;1707;752;955
Panevėžys c. mun.;2014;51;1771;766;1005
Panevėžys c. mun.;2014;52;1792;770;1022
Panevėžys c. mun.;2014;53;1720;756;964
Panevėžys c. mun.;2014;54;1709;744;965
Panevėžys c. mun.;2014;55;1583;674;909
Panevėžys c. mun.;2014;56;1489;606;883
Panevėžys c. mun.;2014;57;1383;583;800
Panevėžys c. mun.;2014;58;1247;537;710
Panevėžys c. mun.;2014;59;1255;546;709
Panevėžys c. mun.;2014;60;1117;496;621
Panevėžys c. mun.;2014;61;1189;486;703
Panevėžys c. mun.;2014;62;1122;425;697
Panevėžys c. mun.;2014;63;1139;440;699
Panevėžys c. mun.;2014;64;1085;400;685
Panevėžys c. mun.;2014;65;1111;449;662
Panevėžys c. mun.;2014;66;957;345;612
Panevėžys c. mun.;2014;67;953;344;609
Panevėžys c. mun.;2014;68;978;351;627
Panevėžys c. mun.;2014;69;963;363;600
Panevėžys c. mun.;2014;70;1092;402;690
Panevėžys c. mun.;2014;71;1128;405;723
Panevėžys c. mun.;2014;72;1079;387;692
Panevėžys c. mun.;2014;73;954;346;608
Panevėžys c. mun.;2014;74;900;299;601
Panevėžys c. mun.;2014;75;900;279;621
Panevėžys c. mun.;2014;76;810;239;571
Panevėžys c. mun.;2014;77;807;258;549
Panevėžys c. mun.;2014;78;747;209;538
Panevėžys c. mun.;2014;79;708;216;492
Panevėžys c. mun.;2014;80;660;196;464
Panevėžys c. mun.;2014;81;647;197;450
Panevėžys c. mun.;2014;82;518;162;356
Panevėžys c. mun.;2014;83;482;142;340
Panevėžys c. mun.;2014;84;464;143;321
Panevėžys c. mun.;2014;85;2022;441;1581
Panevėžys c. mun.;2015;-1;95202;42004;53198
Panevėžys c. mun.;2015;0;903;434;469
Panevėžys c. mun.;2015;1;868;440;428
Panevėžys c. mun.;2015;2;948;488;460
Panevėžys c. mun.;2015;3;912;462;450
Panevėžys c. mun.;2015;4;860;458;402
Panevėžys c. mun.;2015;5;947;504;443
Panevėžys c. mun.;2015;6;853;484;369
Panevėžys c. mun.;2015;7;802;399;403
Panevėžys c. mun.;2015;8;855;415;440
Panevėžys c. mun.;2015;9;873;470;403
Panevėžys c. mun.;2015;10;872;429;443
Panevėžys c. mun.;2015;11;822;436;386
Panevėžys c. mun.;2015;12;846;445;401
Panevėžys c. mun.;2015;13;812;390;422
Panevėžys c. mun.;2015;14;945;489;456
Panevėžys c. mun.;2015;15;1002;534;468
Panevėžys c. mun.;2015;16;1056;519;537
Panevėžys c. mun.;2015;17;1147;568;579
Panevėžys c. mun.;2015;18;1150;579;571
Panevėžys c. mun.;2015;19;1179;609;570
Panevėžys c. mun.;2015;20;1166;597;569
Panevėžys c. mun.;2015;21;1266;659;607
Panevėžys c. mun.;2015;22;1440;689;751
Panevėžys c. mun.;2015;23;1327;675;652
Panevėžys c. mun.;2015;24;1132;594;538
Panevėžys c. mun.;2015;25;1135;561;574
Panevėžys c. mun.;2015;26;1175;596;579
Panevėžys c. mun.;2015;27;1206;629;577
Panevėžys c. mun.;2015;28;1087;549;538
Panevėžys c. mun.;2015;29;936;489;447
Panevėžys c. mun.;2015;30;916;465;451
Panevėžys c. mun.;2015;31;974;477;497
Panevėžys c. mun.;2015;32;930;438;492
Panevėžys c. mun.;2015;33;940;480;460
Panevėžys c. mun.;2015;34;943;468;475
Panevėžys c. mun.;2015;35;1004;481;523
Panevėžys c. mun.;2015;36;1042;519;523
Panevėžys c. mun.;2015;37;1118;533;585
Panevėžys c. mun.;2015;38;1128;557;571
Panevėžys c. mun.;2015;39;1199;565;634
Panevėžys c. mun.;2015;40;1202;526;676
Panevėžys c. mun.;2015;41;1313;610;703
Panevėžys c. mun.;2015;42;1317;603;714
Panevėžys c. mun.;2015;43;1364;598;766
Panevėžys c. mun.;2015;44;1371;628;743
Panevėžys c. mun.;2015;45;1368;620;748
Panevėžys c. mun.;2015;46;1457;640;817
Panevėžys c. mun.;2015;47;1510;646;864
Panevėžys c. mun.;2015;48;1484;660;824
Panevėžys c. mun.;2015;49;1500;660;840
Panevėžys c. mun.;2015;50;1574;667;907
Panevėžys c. mun.;2015;51;1673;726;947
Panevėžys c. mun.;2015;52;1752;751;1001
Panevėžys c. mun.;2015;53;1767;755;1012
Panevėžys c. mun.;2015;54;1700;744;956
Panevėžys c. mun.;2015;55;1688;735;953
Panevėžys c. mun.;2015;56;1565;664;901
Panevėžys c. mun.;2015;57;1462;590;872
Panevėžys c. mun.;2015;58;1369;577;792
Panevėžys c. mun.;2015;59;1232;527;705
Panevėžys c. mun.;2015;60;1246;538;708
Panevėžys c. mun.;2015;61;1100;480;620
Panevėžys c. mun.;2015;62;1159;462;697
Panevėžys c. mun.;2015;63;1105;419;686
Panevėžys c. mun.;2015;64;1107;421;686
Panevėžys c. mun.;2015;65;1056;382;674
Panevėžys c. mun.;2015;66;1094;437;657
Panevėžys c. mun.;2015;67;933;330;603
Panevėžys c. mun.;2015;68;930;329;601
Panevėžys c. mun.;2015;69;952;342;610
Panevėžys c. mun.;2015;70;951;354;597
Panevėžys c. mun.;2015;71;1061;383;678
Panevėžys c. mun.;2015;72;1096;380;716
Panevėžys c. mun.;2015;73;1054;373;681
Panevėžys c. mun.;2015;74;920;326;594
Panevėžys c. mun.;2015;75;879;285;594
Panevėžys c. mun.;2015;76;872;262;610
Panevėžys c. mun.;2015;77;786;229;557
Panevėžys c. mun.;2015;78;778;245;533
Panevėžys c. mun.;2015;79;712;195;517
Panevėžys c. mun.;2015;80;670;195;475
Panevėžys c. mun.;2015;81;635;190;445
Panevėžys c. mun.;2015;82;613;181;432
Panevėžys c. mun.;2015;83;478;140;338
Panevėžys c. mun.;2015;84;455;128;327
Panevėžys c. mun.;2015;85;2176;498;1678
Panevėžys c. mun.;2016;-1;93598;41152;52446
Panevėžys c. mun.;2016;0;942;483;459
Panevėžys c. mun.;2016;1;919;443;476
Panevėžys c. mun.;2016;2;886;450;436
Panevėžys c. mun.;2016;3;919;465;454
Panevėžys c. mun.;2016;4;889;444;445
Panevėžys c. mun.;2016;5;842;444;398
Panevėžys c. mun.;2016;6;925;492;433
Panevėžys c. mun.;2016;7;837;476;361
Panevėžys c. mun.;2016;8;787;388;399
Panevėžys c. mun.;2016;9;845;403;442
Panevėžys c. mun.;2016;10;855;463;392
Panevėžys c. mun.;2016;11;858;421;437
Panevėžys c. mun.;2016;12;808;427;381
Panevėžys c. mun.;2016;13;839;443;396
Panevėžys c. mun.;2016;14;809;389;420
Panevėžys c. mun.;2016;15;955;496;459
Panevėžys c. mun.;2016;16;979;520;459
Panevėžys c. mun.;2016;17;1048;516;532
Panevėžys c. mun.;2016;18;1142;566;576
Panevėžys c. mun.;2016;19;1122;565;557
Panevėžys c. mun.;2016;20;1145;592;553
Panevėžys c. mun.;2016;21;1138;579;559
Panevėžys c. mun.;2016;22;1226;636;590
Panevėžys c. mun.;2016;23;1380;654;726
Panevėžys c. mun.;2016;24;1270;657;613
Panevėžys c. mun.;2016;25;1073;556;517
Panevėžys c. mun.;2016;26;1075;518;557
Panevėžys c. mun.;2016;27;1115;562;553
Panevėžys c. mun.;2016;28;1185;616;569
Panevėžys c. mun.;2016;29;1041;523;518
Panevėžys c. mun.;2016;30;894;477;417
Panevėžys c. mun.;2016;31;852;431;421
Panevėžys c. mun.;2016;32;918;454;464
Panevėžys c. mun.;2016;33;905;423;482
Panevėžys c. mun.;2016;34;919;469;450
Panevėžys c. mun.;2016;35;912;446;466
Panevėžys c. mun.;2016;36;978;464;514
Panevėžys c. mun.;2016;37;1016;510;506
Panevėžys c. mun.;2016;38;1080;519;561
Panevėžys c. mun.;2016;39;1099;539;560
Panevėžys c. mun.;2016;40;1194;559;635
Panevėžys c. mun.;2016;41;1199;530;669
Panevėžys c. mun.;2016;42;1303;605;698
Panevėžys c. mun.;2016;43;1299;592;707
Panevėžys c. mun.;2016;44;1341;583;758
Panevėžys c. mun.;2016;45;1331;605;726
Panevėžys c. mun.;2016;46;1344;596;748
Panevėžys c. mun.;2016;47;1433;627;806
Panevėžys c. mun.;2016;48;1489;631;858
Panevėžys c. mun.;2016;49;1465;650;815
Panevėžys c. mun.;2016;50;1488;648;840
Panevėžys c. mun.;2016;51;1555;654;901
Panevėžys c. mun.;2016;52;1638;703;935
Panevėžys c. mun.;2016;53;1711;723;988
Panevėžys c. mun.;2016;54;1737;734;1003
Panevėžys c. mun.;2016;55;1662;723;939
Panevėžys c. mun.;2016;56;1668;720;948
Panevėžys c. mun.;2016;57;1538;651;887
Panevėžys c. mun.;2016;58;1435;571;864
Panevėžys c. mun.;2016;59;1346;558;788
Panevėžys c. mun.;2016;60;1227;522;705
Panevėžys c. mun.;2016;61;1214;520;694
Panevėžys c. mun.;2016;62;1088;470;618
Panevėžys c. mun.;2016;63;1140;454;686
Panevėžys c. mun.;2016;64;1083;401;682
Panevėžys c. mun.;2016;65;1086;406;680
Panevėžys c. mun.;2016;66;1032;369;663
Panevėžys c. mun.;2016;67;1080;424;656
Panevėžys c. mun.;2016;68;920;324;596
Panevėžys c. mun.;2016;69;911;317;594
Panevėžys c. mun.;2016;70;928;328;600
Panevėžys c. mun.;2016;71;929;340;589
Panevėžys c. mun.;2016;72;1032;360;672
Panevėžys c. mun.;2016;73;1058;365;693
Panevėžys c. mun.;2016;74;1025;353;672
Panevėžys c. mun.;2016;75;901;314;587
Panevėžys c. mun.;2016;76;852;267;585
Panevėžys c. mun.;2016;77;831;247;584
Panevėžys c. mun.;2016;78;748;208;540
Panevėžys c. mun.;2016;79;747;225;522
Panevėžys c. mun.;2016;80;682;188;494
Panevėžys c. mun.;2016;81;632;182;450
Panevėžys c. mun.;2016;82;592;173;419
Panevėžys c. mun.;2016;83;567;159;408
Panevėžys c. mun.;2016;84;438;128;310
Panevėžys c. mun.;2016;85;2252;526;1726
Panevėžys c. mun.;2017;-1;91054;39959;51095
Panevėžys c. mun.;2017;0;850;442;408
Panevėžys c. mun.;2017;1;933;480;453
Panevėžys c. mun.;2017;2;906;436;470
Panevėžys c. mun.;2017;3;854;428;426
Panevėžys c. mun.;2017;4;893;455;438
Panevėžys c. mun.;2017;5;841;419;422
Panevėžys c. mun.;2017;6;818;429;389
Panevėžys c. mun.;2017;7;910;483;427
Panevėžys c. mun.;2017;8;800;451;349
Panevėžys c. mun.;2017;9;772;379;393
Panevėžys c. mun.;2017;10;827;398;429
Panevėžys c. mun.;2017;11;835;449;386
Panevėžys c. mun.;2017;12;830;410;420
Panevėžys c. mun.;2017;13;783;418;365
Panevėžys c. mun.;2017;14;825;436;389
Panevėžys c. mun.;2017;15;794;378;416
Panevėžys c. mun.;2017;16;933;481;452
Panevėžys c. mun.;2017;17;961;511;450
Panevėžys c. mun.;2017;18;1018;505;513
Panevėžys c. mun.;2017;19;1094;552;542
Panevėžys c. mun.;2017;20;1092;553;539
Panevėžys c. mun.;2017;21;1100;576;524
Panevėžys c. mun.;2017;22;1081;554;527
Panevėžys c. mun.;2017;23;1165;605;560
Panevėžys c. mun.;2017;24;1311;620;691
Panevėžys c. mun.;2017;25;1223;631;592
Panevėžys c. mun.;2017;26;982;519;463
Panevėžys c. mun.;2017;27;984;479;505
Panevėžys c. mun.;2017;28;1058;548;510
Panevėžys c. mun.;2017;29;1075;563;512
Panevėžys c. mun.;2017;30;968;492;476
Panevėžys c. mun.;2017;31;837;456;381
Panevėžys c. mun.;2017;32;816;406;410
Panevėžys c. mun.;2017;33;865;413;452
Panevėžys c. mun.;2017;34;844;385;459
Panevėžys c. mun.;2017;35;870;445;425
Panevėžys c. mun.;2017;36;864;419;445
Panevėžys c. mun.;2017;37;948;449;499
Panevėžys c. mun.;2017;38;980;489;491
Panevėžys c. mun.;2017;39;1055;512;543
Panevėžys c. mun.;2017;40;1052;512;540
Panevėžys c. mun.;2017;41;1164;540;624
Panevėžys c. mun.;2017;42;1163;513;650
Panevėžys c. mun.;2017;43;1271;586;685
Panevėžys c. mun.;2017;44;1265;573;692
Panevėžys c. mun.;2017;45;1312;568;744
Panevėžys c. mun.;2017;46;1305;590;715
Panevėžys c. mun.;2017;47;1309;574;735
Panevėžys c. mun.;2017;48;1410;615;795
Panevėžys c. mun.;2017;49;1466;618;848
Panevėžys c. mun.;2017;50;1435;632;803
Panevėžys c. mun.;2017;51;1453;629;824
Panevėžys c. mun.;2017;52;1532;642;890
Panevėžys c. mun.;2017;53;1612;697;915
Panevėžys c. mun.;2017;54;1668;696;972
Panevėžys c. mun.;2017;55;1702;715;987
Panevėžys c. mun.;2017;56;1623;698;925
Panevėžys c. mun.;2017;57;1646;711;935
Panevėžys c. mun.;2017;58;1506;631;875
Panevėžys c. mun.;2017;59;1411;558;853
Panevėžys c. mun.;2017;60;1312;537;775
Panevėžys c. mun.;2017;61;1205;506;699
Panevėžys c. mun.;2017;62;1189;506;683
Panevėžys c. mun.;2017;63;1075;460;615
Panevėžys c. mun.;2017;64;1123;444;679
Panevėžys c. mun.;2017;65;1051;379;672
Panevėžys c. mun.;2017;66;1057;387;670
Panevėžys c. mun.;2017;67;1009;358;651
Panevėžys c. mun.;2017;68;1042;399;643
Panevėžys c. mun.;2017;69;901;314;587
Panevėžys c. mun.;2017;70;890;306;584
Panevėžys c. mun.;2017;71;907;313;594
Panevėžys c. mun.;2017;72;900;323;577
Panevėžys c. mun.;2017;73;993;337;656
Panevėžys c. mun.;2017;74;1016;336;680
Panevėžys c. mun.;2017;75;981;328;653
Panevėžys c. mun.;2017;76;871;296;575
Panevėžys c. mun.;2017;77;816;247;569
Panevėžys c. mun.;2017;78;800;237;563
Panevėžys c. mun.;2017;79;697;186;511
Panevėžys c. mun.;2017;80;719;220;499
Panevėžys c. mun.;2017;81;645;170;475
Panevėžys c. mun.;2017;82;583;164;419
Panevėžys c. mun.;2017;83;552;156;396
Panevėžys c. mun.;2017;84;530;147;383
Panevėžys c. mun.;2017;85;2290;551;1739
Panevėžys c. mun.;2018;-1;88678;38835;49843
Panevėžys c. mun.;2018;0;831;403;428
Panevėžys c. mun.;2018;1;844;436;408
Panevėžys c. mun.;2018;2;914;470;444
Panevėžys c. mun.;2018;3;868;422;446
Panevėžys c. mun.;2018;4;827;414;413
Panevėžys c. mun.;2018;5;867;444;423
Panevėžys c. mun.;2018;6;824;415;409
Panevėžys c. mun.;2018;7;799;427;372
Panevėžys c. mun.;2018;8;875;467;408
Panevėžys c. mun.;2018;9;765;433;332
Panevėžys c. mun.;2018;10;753;370;383
Panevėžys c. mun.;2018;11;799;388;411
Panevėžys c. mun.;2018;12;807;433;374
Panevėžys c. mun.;2018;13;814;407;407
Panevėžys c. mun.;2018;14;769;410;359
Panevėžys c. mun.;2018;15;814;432;382
Panevėžys c. mun.;2018;16;780;367;413
Panevėžys c. mun.;2018;17;922;478;444
Panevėžys c. mun.;2018;18;941;502;439
Panevėžys c. mun.;2018;19;958;479;479
Panevėžys c. mun.;2018;20;1027;525;502
Panevėžys c. mun.;2018;21;1024;518;506
Panevėžys c. mun.;2018;22;1039;542;497
Panevėžys c. mun.;2018;23;994;503;491
Panevėžys c. mun.;2018;24;1093;570;523
Panevėžys c. mun.;2018;25;1221;582;639
Panevėžys c. mun.;2018;26;1118;582;536
Panevėžys c. mun.;2018;27;926;479;447
Panevėžys c. mun.;2018;28;927;453;474
Panevėžys c. mun.;2018;29;994;511;483
Panevėžys c. mun.;2018;30;1007;521;486
Panevėžys c. mun.;2018;31;912;465;447
Panevėžys c. mun.;2018;32;792;435;357
Panevėžys c. mun.;2018;33;758;376;382
Panevėžys c. mun.;2018;34;836;400;436
Panevėžys c. mun.;2018;35;820;381;439
Panevėžys c. mun.;2018;36;835;427;408
Panevėžys c. mun.;2018;37;842;415;427
Panevėžys c. mun.;2018;38;917;438;479
Panevėžys c. mun.;2018;39;957;483;474
Panevėžys c. mun.;2018;40;1034;500;534
Panevėžys c. mun.;2018;41;1038;503;535
Panevėžys c. mun.;2018;42;1127;527;600
Panevėžys c. mun.;2018;43;1143;501;642
Panevėžys c. mun.;2018;44;1245;571;674
Panevėžys c. mun.;2018;45;1235;555;680
Panevėžys c. mun.;2018;46;1276;553;723
Panevėžys c. mun.;2018;47;1274;575;699
Panevėžys c. mun.;2018;48;1284;560;724
Panevėžys c. mun.;2018;49;1384;600;784
Panevėžys c. mun.;2018;50;1450;607;843
Panevėžys c. mun.;2018;51;1418;625;793
Panevėžys c. mun.;2018;52;1423;612;811
Panevėžys c. mun.;2018;53;1495;627;868
Panevėžys c. mun.;2018;54;1586;682;904
Panevėžys c. mun.;2018;55;1637;679;958
Panevėžys c. mun.;2018;56;1680;706;974
Panevėžys c. mun.;2018;57;1603;686;917
Panevėžys c. mun.;2018;58;1619;686;933
Panevėžys c. mun.;2018;59;1487;619;868
Panevėžys c. mun.;2018;60;1396;547;849
Panevėžys c. mun.;2018;61;1284;525;759
Panevėžys c. mun.;2018;62;1189;493;696
Panevėžys c. mun.;2018;63;1179;494;685
Panevėžys c. mun.;2018;64;1055;444;611
Panevėžys c. mun.;2018;65;1096;426;670
Panevėžys c. mun.;2018;66;1031;362;669
Panevėžys c. mun.;2018;67;1045;383;662
Panevėžys c. mun.;2018;68;970;335;635
Panevėžys c. mun.;2018;69;1021;381;640
Panevėžys c. mun.;2018;70;873;301;572
Panevėžys c. mun.;2018;71;864;287;577
Panevėžys c. mun.;2018;72;880;298;582
Panevėžys c. mun.;2018;73;866;302;564
Panevėžys c. mun.;2018;74;951;315;636
Panevėžys c. mun.;2018;75;981;314;667
Panevėžys c. mun.;2018;76;948;304;644
Panevėžys c. mun.;2018;77;841;281;560
Panevėžys c. mun.;2018;78;786;234;552
Panevėžys c. mun.;2018;79;769;222;547
Panevėžys c. mun.;2018;80;662;172;490
Panevėžys c. mun.;2018;81;671;202;469
Panevėžys c. mun.;2018;82;618;161;457
Panevėžys c. mun.;2018;83;529;144;385
Panevėžys c. mun.;2018;84;498;141;357
Panevėžys c. mun.;2018;85;2427;590;1837
Panevėžys county;2001;-1;300305;139877;160428
Panevėžys county;2001;0;2817;1496;1321
Panevėžys county;2001;1;3049;1571;1478
Panevėžys county;2001;2;3091;1566;1525
Panevėžys county;2001;3;3250;1635;1615
Panevėžys county;2001;4;3432;1720;1712
Panevėžys county;2001;5;3463;1773;1690
Panevėžys county;2001;6;3650;1877;1773
Panevėžys county;2001;7;4114;2153;1961
Panevėžys county;2001;8;4766;2410;2356
Panevėžys county;2001;9;4755;2427;2328
Panevėžys county;2001;10;4746;2438;2308
Panevėžys county;2001;11;4695;2387;2308
Panevėžys county;2001;12;4815;2414;2401
Panevėžys county;2001;13;4975;2532;2443
Panevėžys county;2001;14;4988;2583;2405
Panevėžys county;2001;15;4687;2351;2336
Panevėžys county;2001;16;4712;2347;2365
Panevėžys county;2001;17;4556;2330;2226
Panevėžys county;2001;18;3714;1915;1799
Panevėžys county;2001;19;3149;1726;1423
Panevėžys county;2001;20;3141;1717;1424
Panevėžys county;2001;21;3149;1601;1548
Panevėžys county;2001;22;3308;1726;1582
Panevėžys county;2001;23;3542;1826;1716
Panevėžys county;2001;24;3580;1812;1768
Panevėžys county;2001;25;3698;1809;1889
Panevėžys county;2001;26;3739;1817;1922
Panevėžys county;2001;27;3958;1970;1988
Panevėžys county;2001;28;4055;2031;2024
Panevėžys county;2001;29;4128;1961;2167
Panevėžys county;2001;30;4296;2164;2132
Panevėžys county;2001;31;4326;2115;2211
Panevėžys county;2001;32;4458;2215;2243
Panevėžys county;2001;33;4547;2157;2390
Panevėžys county;2001;34;4536;2233;2303
Panevėžys county;2001;35;4497;2240;2257
Panevėžys county;2001;36;4678;2264;2414
Panevėžys county;2001;37;4675;2274;2401
Panevėžys county;2001;38;4913;2424;2489
Panevėžys county;2001;39;4955;2436;2519
Panevėžys county;2001;40;4755;2351;2404
Panevėžys county;2001;41;4806;2350;2456
Panevėžys county;2001;42;4423;2137;2286
Panevėžys county;2001;43;4154;1928;2226
Panevėžys county;2001;44;3918;1905;2013
Panevėžys county;2001;45;3707;1778;1929
Panevėžys county;2001;46;3648;1753;1895
Panevėžys county;2001;47;3448;1722;1726
Panevėžys county;2001;48;3633;1787;1846
Panevėžys county;2001;49;3566;1705;1861
Panevėžys county;2001;50;3531;1665;1866
Panevėžys county;2001;51;3391;1516;1875
Panevėžys county;2001;52;3275;1530;1745
Panevėžys county;2001;53;3019;1366;1653
Panevėžys county;2001;54;3005;1398;1607
Panevėžys county;2001;55;3323;1530;1793
Panevėžys county;2001;56;3121;1454;1667
Panevėžys county;2001;57;3704;1663;2041
Panevėžys county;2001;58;3806;1674;2132
Panevėžys county;2001;59;3784;1668;2116
Panevėžys county;2001;60;3430;1545;1885
Panevėžys county;2001;61;3346;1430;1916
Panevėžys county;2001;62;3304;1378;1926
Panevėžys county;2001;63;3299;1330;1969
Panevėžys county;2001;64;3459;1450;2009
Panevėžys county;2001;65;3059;1254;1805
Panevėžys county;2001;66;3167;1270;1897
Panevėžys county;2001;67;3052;1215;1837
Panevėžys county;2001;68;3109;1185;1924
Panevėžys county;2001;69;2760;1037;1723
Panevėžys county;2001;70;2784;1027;1757
Panevėžys county;2001;71;2665;985;1680
Panevėžys county;2001;72;2709;981;1728
Panevėžys county;2001;73;2480;886;1594
Panevėžys county;2001;74;2258;666;1592
Panevėžys county;2001;75;2147;607;1540
Panevėžys county;2001;76;2004;585;1419
Panevėžys county;2001;77;1995;592;1403
Panevėžys county;2001;78;1763;505;1258
Panevėžys county;2001;79;1582;470;1112
Panevėžys county;2001;80;1348;375;973
Panevėžys county;2001;81;908;247;661
Panevėžys county;2001;82;670;159;511
Panevėžys county;2001;83;639;174;465
Panevėžys county;2001;84;635;181;454
Panevėžys county;2001;85;4113;1020;3093
Panevėžys county;2002;-1;296871;138121;158750
Panevėžys county;2002;0;2641;1317;1324
Panevėžys county;2002;1;2798;1489;1309
Panevėžys county;2002;2;3036;1560;1476
Panevėžys county;2002;3;3071;1556;1515
Panevėžys county;2002;4;3228;1625;1603
Panevėžys county;2002;5;3424;1716;1708
Panevėžys county;2002;6;3443;1759;1684
Panevėžys county;2002;7;3635;1866;1769
Panevėžys county;2002;8;4091;2140;1951
Panevėžys county;2002;9;4736;2380;2356
Panevėžys county;2002;10;4728;2410;2318
Panevėžys county;2002;11;4691;2405;2286
Panevėžys county;2002;12;4637;2365;2272
Panevėžys county;2002;13;4729;2366;2363
Panevėžys county;2002;14;4907;2487;2420
Panevėžys county;2002;15;4912;2531;2381
Panevėžys county;2002;16;4622;2315;2307
Panevėžys county;2002;17;4626;2298;2328
Panevėžys county;2002;18;4468;2282;2186
Panevėžys county;2002;19;3616;1860;1756
Panevėžys county;2002;20;3093;1679;1414
Panevėžys county;2002;21;3065;1668;1397
Panevėžys county;2002;22;3090;1563;1527
Panevėžys county;2002;23;3237;1691;1546
Panevėžys county;2002;24;3451;1776;1675
Panevėžys county;2002;25;3536;1800;1736
Panevėžys county;2002;26;3634;1780;1854
Panevėžys county;2002;27;3658;1767;1891
Panevėžys county;2002;28;3883;1913;1970
Panevėžys county;2002;29;3949;1966;1983
Panevėžys county;2002;30;4028;1912;2116
Panevėžys county;2002;31;4224;2124;2100
Panevėžys county;2002;32;4243;2068;2175
Panevėžys county;2002;33;4387;2170;2217
Panevėžys county;2002;34;4488;2126;2362
Panevėžys county;2002;35;4450;2177;2273
Panevėžys county;2002;36;4438;2209;2229
Panevėžys county;2002;37;4609;2217;2392
Panevėžys county;2002;38;4594;2225;2369
Panevėžys county;2002;39;4814;2361;2453
Panevėžys county;2002;40;4863;2377;2486
Panevėžys county;2002;41;4692;2313;2379
Panevėžys county;2002;42;4734;2323;2411
Panevėžys county;2002;43;4381;2113;2268
Panevėžys county;2002;44;4100;1900;2200
Panevėžys county;2002;45;3840;1864;1976
Panevėžys county;2002;46;3633;1736;1897
Panevėžys county;2002;47;3630;1750;1880
Panevėžys county;2002;48;3387;1684;1703
Panevėžys county;2002;49;3534;1734;1800
Panevėžys county;2002;50;3497;1655;1842
Panevėžys county;2002;51;3447;1614;1833
Panevėžys county;2002;52;3360;1500;1860
Panevėžys county;2002;53;3230;1509;1721
Panevėžys county;2002;54;2944;1334;1610
Panevėžys county;2002;55;2935;1365;1570
Panevėžys county;2002;56;3228;1483;1745
Panevėžys county;2002;57;3050;1415;1635
Panevėžys county;2002;58;3598;1605;1993
Panevėžys county;2002;59;3710;1618;2092
Panevėžys county;2002;60;3738;1640;2098
Panevėžys county;2002;61;3392;1519;1873
Panevėžys county;2002;62;3317;1409;1908
Panevėžys county;2002;63;3277;1363;1914
Panevėžys county;2002;64;3255;1302;1953
Panevėžys county;2002;65;3418;1423;1995
Panevėžys county;2002;66;3001;1217;1784
Panevėžys county;2002;67;3114;1242;1872
Panevėžys county;2002;68;3008;1187;1821
Panevėžys county;2002;69;3038;1138;1900
Panevėžys county;2002;70;2717;1015;1702
Panevėžys county;2002;71;2723;986;1737
Panevėžys county;2002;72;2598;952;1646
Panevėžys county;2002;73;2647;948;1699
Panevėžys county;2002;74;2401;850;1551
Panevėžys county;2002;75;2180;625;1555
Panevėžys county;2002;76;2064;567;1497
Panevėžys county;2002;77;1929;553;1376
Panevėžys county;2002;78;1913;570;1343
Panevėžys county;2002;79;1676;472;1204
Panevėžys county;2002;80;1503;445;1058
Panevėžys county;2002;81;1223;332;891
Panevėžys county;2002;82;833;222;611
Panevėžys county;2002;83;605;144;461
Panevėžys county;2002;84;585;158;427
Panevėžys county;2002;85;4013;1031;2982
Panevėžys county;2003;-1;294182;136801;157381
Panevėžys county;2003;0;2521;1321;1200
Panevėžys county;2003;1;2644;1321;1323
Panevėžys county;2003;2;2777;1481;1296
Panevėžys county;2003;3;3026;1553;1473
Panevėžys county;2003;4;3058;1544;1514
Panevėžys county;2003;5;3224;1616;1608
Panevėžys county;2003;6;3406;1708;1698
Panevėžys county;2003;7;3431;1751;1680
Panevėžys county;2003;8;3631;1866;1765
Panevėžys county;2003;9;4075;2130;1945
Panevėžys county;2003;10;4707;2374;2333
Panevėžys county;2003;11;4700;2400;2300
Panevėžys county;2003;12;4616;2365;2251
Panevėžys county;2003;13;4579;2330;2249
Panevėžys county;2003;14;4659;2326;2333
Panevėžys county;2003;15;4828;2442;2386
Panevėžys county;2003;16;4831;2486;2345
Panevėžys county;2003;17;4530;2261;2269
Panevėžys county;2003;18;4550;2258;2292
Panevėžys county;2003;19;4389;2238;2151
Panevėžys county;2003;20;3530;1823;1707
Panevėžys county;2003;21;3041;1660;1381
Panevėžys county;2003;22;3036;1656;1380
Panevėžys county;2003;23;3043;1535;1508
Panevėžys county;2003;24;3199;1668;1531
Panevėžys county;2003;25;3412;1764;1648
Panevėžys county;2003;26;3495;1785;1710
Panevėžys county;2003;27;3556;1732;1824
Panevėžys county;2003;28;3616;1746;1870
Panevėžys county;2003;29;3813;1870;1943
Panevėžys county;2003;30;3897;1944;1953
Panevėžys county;2003;31;3993;1896;2097
Panevėžys county;2003;32;4176;2106;2070
Panevėžys county;2003;33;4189;2046;2143
Panevėžys county;2003;34;4342;2146;2196
Panevėžys county;2003;35;4412;2079;2333
Panevėžys county;2003;36;4398;2151;2247
Panevėžys county;2003;37;4363;2161;2202
Panevėžys county;2003;38;4564;2200;2364
Panevėžys county;2003;39;4544;2199;2345
Panevėžys county;2003;40;4755;2328;2427
Panevėžys county;2003;41;4813;2352;2461
Panevėžys county;2003;42;4652;2287;2365
Panevėžys county;2003;43;4690;2300;2390
Panevėžys county;2003;44;4346;2106;2240
Panevėžys county;2003;45;4064;1887;2177
Panevėžys county;2003;46;3802;1840;1962
Panevėžys county;2003;47;3602;1716;1886
Panevėžys county;2003;48;3591;1720;1871
Panevėžys county;2003;49;3346;1659;1687
Panevėžys county;2003;50;3501;1713;1788
Panevėžys county;2003;51;3451;1632;1819
Panevėžys county;2003;52;3401;1585;1816
Panevėžys county;2003;53;3333;1490;1843
Panevėžys county;2003;54;3188;1479;1709
Panevėžys county;2003;55;2903;1304;1599
Panevėžys county;2003;56;2891;1342;1549
Panevėžys county;2003;57;3177;1446;1731
Panevėžys county;2003;58;2991;1377;1614
Panevėžys county;2003;59;3531;1564;1967
Panevėžys county;2003;60;3645;1584;2061
Panevėžys county;2003;61;3679;1605;2074
Panevėžys county;2003;62;3359;1501;1858
Panevėžys county;2003;63;3285;1388;1897
Panevėžys county;2003;64;3229;1335;1894
Panevėžys county;2003;65;3229;1287;1942
Panevėžys county;2003;66;3376;1393;1983
Panevėžys county;2003;67;2984;1199;1785
Panevėžys county;2003;68;3041;1182;1859
Panevėžys county;2003;69;2941;1142;1799
Panevėžys county;2003;70;2980;1099;1881
Panevėžys county;2003;71;2621;949;1672
Panevėžys county;2003;72;2652;944;1708
Panevėžys county;2003;73;2521;901;1620
Panevėžys county;2003;74;2560;884;1676
Panevėžys county;2003;75;2291;796;1495
Panevėžys county;2003;76;2092;584;1508
Panevėžys county;2003;77;1989;528;1461
Panevėžys county;2003;78;1823;511;1312
Panevėžys county;2003;79;1805;515;1290
Panevėžys county;2003;80;1564;414;1150
Panevėžys county;2003;81;1390;397;993
Panevėžys county;2003;82;1122;291;831
Panevėžys county;2003;83;757;193;564
Panevėžys county;2003;84;550;126;424
Panevėžys county;2003;85;3868;988;2880
Panevėžys county;2004;-1;290097;134825;155272
Panevėžys county;2004;0;2462;1308;1154
Panevėžys county;2004;1;2509;1310;1199
Panevėžys county;2004;2;2635;1315;1320
Panevėžys county;2004;3;2759;1468;1291
Panevėžys county;2004;4;3014;1544;1470
Panevėžys county;2004;5;3040;1534;1506
Panevėžys county;2004;6;3205;1605;1600
Panevėžys county;2004;7;3389;1695;1694
Panevėžys county;2004;8;3416;1744;1672
Panevėžys county;2004;9;3615;1859;1756
Panevėžys county;2004;10;4066;2127;1939
Panevėžys county;2004;11;4671;2359;2312
Panevėžys county;2004;12;4645;2363;2282
Panevėžys county;2004;13;4539;2332;2207
Panevėžys county;2004;14;4483;2285;2198
Panevėžys county;2004;15;4584;2295;2289
Panevėžys county;2004;16;4733;2404;2329
Panevėžys county;2004;17;4742;2447;2295
Panevėžys county;2004;18;4421;2209;2212
Panevėžys county;2004;19;4454;2220;2234
Panevėžys county;2004;20;4279;2170;2109
Panevėžys county;2004;21;3429;1764;1665
Panevėžys county;2004;22;2954;1613;1341
Panevėžys county;2004;23;2962;1610;1352
Panevėžys county;2004;24;2981;1515;1466
Panevėžys county;2004;25;3121;1637;1484
Panevėžys county;2004;26;3319;1718;1601
Panevėžys county;2004;27;3395;1733;1662
Panevėžys county;2004;28;3473;1689;1784
Panevėžys county;2004;29;3526;1698;1828
Panevėžys county;2004;30;3701;1811;1890
Panevėžys county;2004;31;3803;1896;1907
Panevėžys county;2004;32;3901;1855;2046
Panevėžys county;2004;33;4082;2062;2020
Panevėžys county;2004;34;4107;2007;2100
Panevėžys county;2004;35;4271;2110;2161
Panevėžys county;2004;36;4341;2052;2289
Panevėžys county;2004;37;4328;2115;2213
Panevėžys county;2004;38;4285;2119;2166
Panevėžys county;2004;39;4483;2158;2325
Panevėžys county;2004;40;4464;2166;2298
Panevėžys county;2004;41;4680;2294;2386
Panevėžys county;2004;42;4736;2311;2425
Panevėžys county;2004;43;4603;2264;2339
Panevėžys county;2004;44;4613;2254;2359
Panevėžys county;2004;45;4296;2084;2212
Panevėžys county;2004;46;4011;1863;2148
Panevėžys county;2004;47;3733;1803;1930
Panevėžys county;2004;48;3563;1701;1862
Panevėžys county;2004;49;3537;1690;1847
Panevėžys county;2004;50;3293;1631;1662
Panevėžys county;2004;51;3456;1690;1766
Panevėžys county;2004;52;3397;1604;1793
Panevėžys county;2004;53;3351;1560;1791
Panevėžys county;2004;54;3280;1456;1824
Panevėžys county;2004;55;3133;1440;1693
Panevėžys county;2004;56;2864;1279;1585
Panevėžys county;2004;57;2843;1309;1534
Panevėžys county;2004;58;3111;1407;1704
Panevėžys county;2004;59;2945;1351;1594
Panevėžys county;2004;60;3449;1504;1945
Panevėžys county;2004;61;3561;1532;2029
Panevėžys county;2004;62;3608;1561;2047
Panevėžys county;2004;63;3314;1466;1848
Panevėžys county;2004;64;3217;1342;1875
Panevėžys county;2004;65;3184;1303;1881
Panevėžys county;2004;66;3174;1243;1931
Panevėžys county;2004;67;3302;1332;1970
Panevėžys county;2004;68;2905;1137;1768
Panevėžys county;2004;69;2980;1131;1849
Panevėžys county;2004;70;2845;1090;1755
Panevėžys county;2004;71;2908;1048;1860
Panevėžys county;2004;72;2537;895;1642
Panevėžys county;2004;73;2575;897;1678
Panevėžys county;2004;74;2424;859;1565
Panevėžys county;2004;75;2450;825;1625
Panevėžys county;2004;76;2184;746;1438
Panevėžys county;2004;77;1998;544;1454
Panevėžys county;2004;78;1875;470;1405
Panevėžys county;2004;79;1713;474;1239
Panevėžys county;2004;80;1694;464;1230
Panevėžys county;2004;81;1450;366;1084
Panevėžys county;2004;82;1292;363;929
Panevėžys county;2004;83;1025;262;763
Panevėžys county;2004;84;687;171;516
Panevėžys county;2004;85;3714;888;2826
Panevėžys county;2005;-1;284918;132342;152576
Panevėžys county;2005;0;2372;1197;1175
Panevėžys county;2005;1;2438;1300;1138
Panevėžys county;2005;2;2486;1296;1190
Panevėžys county;2005;3;2607;1304;1303
Panevėžys county;2005;4;2714;1444;1270
Panevėžys county;2005;5;2984;1527;1457
Panevėžys county;2005;6;3008;1520;1488
Panevėžys county;2005;7;3179;1594;1585
Panevėžys county;2005;8;3366;1680;1686
Panevėžys county;2005;9;3390;1728;1662
Panevėžys county;2005;10;3583;1837;1746
Panevėžys county;2005;11;4030;2113;1917
Panevėžys county;2005;12;4624;2330;2294
Panevėžys county;2005;13;4599;2340;2259
Panevėžys county;2005;14;4474;2296;2178
Panevėžys county;2005;15;4413;2249;2164
Panevėžys county;2005;16;4484;2240;2244
Panevėžys county;2005;17;4635;2350;2285
Panevėžys county;2005;18;4608;2371;2237
Panevėžys county;2005;19;4278;2131;2147
Panevėžys county;2005;20;4299;2149;2150
Panevėžys county;2005;21;4144;2102;2042
Panevėžys county;2005;22;3295;1695;1600
Panevėžys county;2005;23;2858;1558;1300
Panevėžys county;2005;24;2855;1562;1293
Panevėžys county;2005;25;2846;1461;1385
Panevėžys county;2005;26;2991;1568;1423
Panevėžys county;2005;27;3209;1649;1560
Panevėžys county;2005;28;3299;1694;1605
Panevėžys county;2005;29;3386;1663;1723
Panevėžys county;2005;30;3457;1674;1783
Panevėžys county;2005;31;3604;1763;1841
Panevėžys county;2005;32;3676;1821;1855
Panevėžys county;2005;33;3817;1816;2001
Panevėžys county;2005;34;3996;2006;1990
Panevėžys county;2005;35;4023;1969;2054
Panevėžys county;2005;36;4160;2047;2113
Panevėžys county;2005;37;4250;1997;2253
Panevėžys county;2005;38;4264;2075;2189
Panevėžys county;2005;39;4215;2082;2133
Panevėžys county;2005;40;4398;2114;2284
Panevėžys county;2005;41;4385;2123;2262
Panevėžys county;2005;42;4599;2256;2343
Panevėžys county;2005;43;4663;2271;2392
Panevėžys county;2005;44;4539;2225;2314
Panevėžys county;2005;45;4547;2227;2320
Panevėžys county;2005;46;4246;2050;2196
Panevėžys county;2005;47;3948;1825;2123
Panevėžys county;2005;48;3666;1772;1894
Panevėžys county;2005;49;3505;1667;1838
Panevėžys county;2005;50;3481;1653;1828
Panevėžys county;2005;51;3227;1592;1635
Panevėžys county;2005;52;3399;1655;1744
Panevėžys county;2005;53;3328;1555;1773
Panevėžys county;2005;54;3288;1530;1758
Panevėžys county;2005;55;3223;1414;1809
Panevėžys county;2005;56;3091;1413;1678
Panevėžys county;2005;57;2818;1248;1570
Panevėžys county;2005;58;2795;1280;1515
Panevėžys county;2005;59;3045;1366;1679
Panevėžys county;2005;60;2878;1313;1565
Panevėžys county;2005;61;3382;1465;1917
Panevėžys county;2005;62;3505;1496;2009
Panevėžys county;2005;63;3539;1513;2026
Panevėžys county;2005;64;3233;1421;1812
Panevėžys county;2005;65;3136;1289;1847
Panevėžys county;2005;66;3114;1250;1864
Panevėžys county;2005;67;3094;1192;1902
Panevėžys county;2005;68;3213;1277;1936
Panevėžys county;2005;69;2819;1088;1731
Panevėžys county;2005;70;2903;1097;1806
Panevėžys county;2005;71;2747;1040;1707
Panevėžys county;2005;72;2806;987;1819
Panevėžys county;2005;73;2452;853;1599
Panevėžys county;2005;74;2472;848;1624
Panevėžys county;2005;75;2325;811;1514
Panevėžys county;2005;76;2337;773;1564
Panevėžys county;2005;77;2056;682;1374
Panevėžys county;2005;78;1898;514;1384
Panevėžys county;2005;79;1741;422;1319
Panevėžys county;2005;80;1597;437;1160
Panevėžys county;2005;81;1565;419;1146
Panevėžys county;2005;82;1309;318;991
Panevėžys county;2005;83;1184;325;859
Panevėžys county;2005;84;921;233;688
Panevėžys county;2005;85;3585;845;2740
Panevėžys county;2006;-1;278262;128780;149482
Panevėžys county;2006;0;2329;1204;1125
Panevėžys county;2006;1;2332;1171;1161
Panevėžys county;2006;2;2385;1269;1116
Panevėžys county;2006;3;2441;1277;1164
Panevėžys county;2006;4;2561;1279;1282
Panevėžys county;2006;5;2672;1416;1256
Panevėžys county;2006;6;2946;1509;1437
Panevėžys county;2006;7;2983;1503;1480
Panevėžys county;2006;8;3144;1578;1566
Panevėžys county;2006;9;3330;1659;1671
Panevėžys county;2006;10;3360;1709;1651
Panevėžys county;2006;11;3554;1819;1735
Panevėžys county;2006;12;4001;2096;1905
Panevėžys county;2006;13;4517;2265;2252
Panevėžys county;2006;14;4519;2297;2222
Panevėžys county;2006;15;4344;2227;2117
Panevėžys county;2006;16;4263;2165;2098
Panevėžys county;2006;17;4343;2156;2187
Panevėžys county;2006;18;4480;2262;2218
Panevėžys county;2006;19;4369;2235;2134
Panevėžys county;2006;20;4042;2003;2039
Panevėžys county;2006;21;4044;2024;2020
Panevėžys county;2006;22;3904;1998;1906
Panevėžys county;2006;23;3109;1592;1517
Panevėžys county;2006;24;2673;1464;1209
Panevėžys county;2006;25;2660;1455;1205
Panevėžys county;2006;26;2707;1386;1321
Panevėžys county;2006;27;2860;1501;1359
Panevėžys county;2006;28;3095;1590;1505
Panevėžys county;2006;29;3203;1655;1548
Panevėžys county;2006;30;3302;1615;1687
Panevėžys county;2006;31;3365;1627;1738
Panevėžys county;2006;32;3498;1701;1797
Panevėžys county;2006;33;3571;1758;1813
Panevėžys county;2006;34;3710;1762;1948
Panevėžys county;2006;35;3891;1938;1953
Panevėžys county;2006;36;3916;1903;2013
Panevėžys county;2006;37;4048;1967;2081
Panevėžys county;2006;38;4141;1936;2205
Panevėžys county;2006;39;4162;2014;2148
Panevėžys county;2006;40;4118;2015;2103
Panevėžys county;2006;41;4294;2054;2240
Panevėžys county;2006;42;4283;2053;2230
Panevėžys county;2006;43;4514;2201;2313
Panevėžys county;2006;44;4590;2230;2360
Panevėžys county;2006;45;4486;2192;2294
Panevėžys county;2006;46;4464;2179;2285
Panevėžys county;2006;47;4182;2008;2174
Panevėžys county;2006;48;3883;1792;2091
Panevėžys county;2006;49;3589;1721;1868
Panevėžys county;2006;50;3430;1622;1808
Panevėžys county;2006;51;3424;1620;1804
Panevėžys county;2006;52;3169;1553;1616
Panevėžys county;2006;53;3326;1603;1723
Panevėžys county;2006;54;3261;1513;1748
Panevėžys county;2006;55;3222;1492;1730
Panevėžys county;2006;56;3161;1374;1787
Panevėžys county;2006;57;3029;1370;1659
Panevėžys county;2006;58;2775;1226;1549
Panevėžys county;2006;59;2734;1242;1492
Panevėžys county;2006;60;2954;1314;1640
Panevėžys county;2006;61;2808;1261;1547
Panevėžys county;2006;62;3301;1409;1892
Panevėžys county;2006;63;3425;1449;1976
Panevėžys county;2006;64;3441;1454;1987
Panevėžys county;2006;65;3142;1355;1787
Panevėžys county;2006;66;3053;1230;1823
Panevėžys county;2006;67;3023;1189;1834
Panevėžys county;2006;68;3007;1140;1867
Panevėžys county;2006;69;3120;1221;1899
Panevėžys county;2006;70;2727;1026;1701
Panevėžys county;2006;71;2802;1039;1763
Panevėžys county;2006;72;2657;985;1672
Panevėžys county;2006;73;2695;925;1770
Panevėžys county;2006;74;2342;795;1547
Panevėžys county;2006;75;2354;772;1582
Panevėžys county;2006;76;2216;761;1455
Panevėžys county;2006;77;2220;719;1501
Panevėžys county;2006;78;1942;627;1315
Panevėžys county;2006;79;1786;472;1314
Panevėžys county;2006;80;1637;383;1254
Panevėžys county;2006;81;1479;391;1088
Panevėžys county;2006;82;1448;372;1076
Panevėžys county;2006;83;1198;291;907
Panevėžys county;2006;84;1075;289;786
Panevėžys county;2006;85;3702;866;2836
Panevėžys county;2007;-1;273701;126341;147360
Panevėžys county;2007;0;2253;1098;1155
Panevėžys county;2007;1;2302;1191;1111
Panevėžys county;2007;2;2301;1157;1144
Panevėžys county;2007;3;2353;1250;1103
Panevėžys county;2007;4;2416;1260;1156
Panevėžys county;2007;5;2543;1268;1275
Panevėžys county;2007;6;2642;1403;1239
Panevėžys county;2007;7;2923;1499;1424
Panevėžys county;2007;8;2954;1485;1469
Panevėžys county;2007;9;3119;1562;1557
Panevėžys county;2007;10;3321;1651;1670
Panevėžys county;2007;11;3346;1704;1642
Panevėžys county;2007;12;3532;1803;1729
Panevėžys county;2007;13;3969;2081;1888
Panevėžys county;2007;14;4473;2240;2233
Panevėžys county;2007;15;4470;2273;2197
Panevėžys county;2007;16;4274;2192;2082
Panevėžys county;2007;17;4192;2133;2059
Panevėžys county;2007;18;4237;2098;2139
Panevėžys county;2007;19;4378;2208;2170
Panevėžys county;2007;20;4245;2165;2080
Panevėžys county;2007;21;3911;1934;1977
Panevėžys county;2007;22;3920;1954;1966
Panevėžys county;2007;23;3785;1927;1858
Panevėžys county;2007;24;2997;1531;1466
Panevėžys county;2007;25;2543;1394;1149
Panevėžys county;2007;26;2562;1402;1160
Panevėžys county;2007;27;2628;1339;1289
Panevėžys county;2007;28;2790;1459;1331
Panevėžys county;2007;29;3030;1546;1484
Panevėžys county;2007;30;3129;1609;1520
Panevėžys county;2007;31;3258;1589;1669
Panevėžys county;2007;32;3311;1594;1717
Panevėžys county;2007;33;3436;1662;1774
Panevėžys county;2007;34;3521;1727;1794
Panevėžys county;2007;35;3644;1726;1918
Panevėžys county;2007;36;3823;1895;1928
Panevėžys county;2007;37;3846;1869;1977
Panevėžys county;2007;38;3988;1940;2048
Panevėžys county;2007;39;4072;1899;2173
Panevėžys county;2007;40;4091;1965;2126
Panevėžys county;2007;41;4044;1967;2077
Panevėžys county;2007;42;4222;2019;2203
Panevėžys county;2007;43;4214;2011;2203
Panevėžys county;2007;44;4436;2160;2276
Panevėžys county;2007;45;4505;2187;2318
Panevėžys county;2007;46;4455;2173;2282
Panevėžys county;2007;47;4397;2141;2256
Panevėžys county;2007;48;4129;1977;2152
Panevėžys county;2007;49;3827;1763;2064
Panevėžys county;2007;50;3531;1679;1852
Panevėžys county;2007;51;3366;1587;1779
Panevėžys county;2007;52;3362;1581;1781
Panevėžys county;2007;53;3109;1515;1594
Panevėžys county;2007;54;3263;1558;1705
Panevėžys county;2007;55;3199;1472;1727
Panevėžys county;2007;56;3159;1445;1714
Panevėžys county;2007;57;3109;1336;1773
Panevėžys county;2007;58;2973;1340;1633
Panevėžys county;2007;59;2721;1192;1529
Panevėžys county;2007;60;2670;1198;1472
Panevėžys county;2007;61;2907;1286;1621
Panevėžys county;2007;62;2750;1218;1532
Panevėžys county;2007;63;3215;1350;1865
Panevėžys county;2007;64;3334;1390;1944
Panevėžys county;2007;65;3349;1388;1961
Panevėžys county;2007;66;3041;1299;1742
Panevėžys county;2007;67;2971;1180;1791
Panevėžys county;2007;68;2943;1140;1803
Panevėžys county;2007;69;2942;1102;1840
Panevėžys county;2007;70;3020;1160;1860
Panevėžys county;2007;71;2646;980;1666
Panevėžys county;2007;72;2708;980;1728
Panevėžys county;2007;73;2546;921;1625
Panevėžys county;2007;74;2604;870;1734
Panevėžys county;2007;75;2245;752;1493
Panevėžys county;2007;76;2241;719;1522
Panevėžys county;2007;77;2107;711;1396
Panevėžys county;2007;78;2082;657;1425
Panevėžys county;2007;79;1837;588;1249
Panevėžys county;2007;80;1661;426;1235
Panevėžys county;2007;81;1525;355;1170
Panevėžys county;2007;82;1353;350;1003
Panevėžys county;2007;83;1322;339;983
Panevėžys county;2007;84;1085;253;832
Panevėžys county;2007;85;4048;944;3104
Panevėžys county;2008;-1;268815;123947;144868
Panevėžys county;2008;0;2116;1046;1070
Panevėžys county;2008;1;2222;1082;1140
Panevėžys county;2008;2;2274;1179;1095
Panevėžys county;2008;3;2267;1149;1118
Panevėžys county;2008;4;2340;1241;1099
Panevėžys county;2008;5;2392;1248;1144
Panevėžys county;2008;6;2505;1248;1257
Panevėžys county;2008;7;2615;1392;1223
Panevėžys county;2008;8;2902;1491;1411
Panevėžys county;2008;9;2918;1465;1453
Panevėžys county;2008;10;3091;1552;1539
Panevėžys county;2008;11;3283;1633;1650
Panevėžys county;2008;12;3311;1686;1625
Panevėžys county;2008;13;3499;1787;1712
Panevėžys county;2008;14;3927;2061;1866
Panevėžys county;2008;15;4424;2215;2209
Panevėžys county;2008;16;4428;2244;2184
Panevėžys county;2008;17;4228;2167;2061
Panevėžys county;2008;18;4130;2102;2028
Panevėžys county;2008;19;4158;2065;2093
Panevėžys county;2008;20;4274;2168;2106
Panevėžys county;2008;21;4126;2106;2020
Panevėžys county;2008;22;3802;1891;1911
Panevėžys county;2008;23;3799;1902;1897
Panevėžys county;2008;24;3652;1858;1794
Panevėžys county;2008;25;2899;1490;1409
Panevėžys county;2008;26;2453;1338;1115
Panevėžys county;2008;27;2479;1356;1123
Panevėžys county;2008;28;2545;1300;1245
Panevėžys county;2008;29;2690;1414;1276
Panevėžys county;2008;30;2959;1511;1448
Panevėžys county;2008;31;3076;1575;1501
Panevėžys county;2008;32;3187;1550;1637
Panevėžys county;2008;33;3236;1557;1679
Panevėžys county;2008;34;3380;1630;1750
Panevėžys county;2008;35;3464;1703;1761
Panevėžys county;2008;36;3594;1697;1897
Panevėžys county;2008;37;3764;1863;1901
Panevėžys county;2008;38;3796;1848;1948
Panevėžys county;2008;39;3929;1902;2027
Panevėžys county;2008;40;4013;1868;2145
Panevėžys county;2008;41;4016;1916;2100
Panevėžys county;2008;42;3985;1942;2043
Panevėžys county;2008;43;4133;1973;2160
Panevėžys county;2008;44;4146;1971;2175
Panevėžys county;2008;45;4369;2121;2248
Panevėžys county;2008;46;4433;2151;2282
Panevėžys county;2008;47;4379;2127;2252
Panevėžys county;2008;48;4329;2096;2233
Panevėžys county;2008;49;4056;1924;2132
Panevėžys county;2008;50;3764;1729;2035
Panevėžys county;2008;51;3469;1641;1828
Panevėžys county;2008;52;3304;1547;1757
Panevėžys county;2008;53;3304;1551;1753
Panevėžys county;2008;54;3040;1474;1566
Panevėžys county;2008;55;3186;1509;1677
Panevėžys county;2008;56;3130;1429;1701
Panevėžys county;2008;57;3073;1399;1674
Panevėžys county;2008;58;3029;1287;1742
Panevėžys county;2008;59;2911;1290;1621
Panevėžys county;2008;60;2662;1155;1507
Panevėžys county;2008;61;2612;1165;1447
Panevėžys county;2008;62;2843;1248;1595
Panevėžys county;2008;63;2659;1169;1490
Panevėžys county;2008;64;3117;1287;1830
Panevėžys county;2008;65;3245;1335;1910
Panevėžys county;2008;66;3269;1334;1935
Panevėžys county;2008;67;2932;1230;1702
Panevėžys county;2008;68;2901;1137;1764
Panevėžys county;2008;69;2853;1093;1760
Panevėžys county;2008;70;2851;1052;1799
Panevėžys county;2008;71;2921;1104;1817
Panevėžys county;2008;72;2569;940;1629
Panevėžys county;2008;73;2627;932;1695
Panevėžys county;2008;74;2442;867;1575
Panevėžys county;2008;75;2507;810;1697
Panevėžys county;2008;76;2118;694;1424
Panevėžys county;2008;77;2119;663;1456
Panevėžys county;2008;78;1997;659;1338
Panevėžys county;2008;79;1956;599;1357
Panevėžys county;2008;80;1709;521;1188
Panevėžys county;2008;81;1550;386;1164
Panevėžys county;2008;82;1396;306;1090
Panevėžys county;2008;83;1219;308;911
Panevėžys county;2008;84;1194;298;896
Panevėžys county;2008;85;4344;998;3346
Panevėžys county;2009;-1;264319;121778;142541
Panevėžys county;2009;0;2164;1152;1012
Panevėžys county;2009;1;2092;1036;1056
Panevėžys county;2009;2;2203;1071;1132
Panevėžys county;2009;3;2245;1164;1081
Panevėžys county;2009;4;2254;1145;1109
Panevėžys county;2009;5;2311;1224;1087
Panevėžys county;2009;6;2364;1228;1136
Panevėžys county;2009;7;2472;1232;1240
Panevėžys county;2009;8;2588;1381;1207
Panevėžys county;2009;9;2880;1482;1398
Panevėžys county;2009;10;2890;1448;1442
Panevėžys county;2009;11;3058;1536;1522
Panevėžys county;2009;12;3262;1619;1643
Panevėžys county;2009;13;3296;1677;1619
Panevėžys county;2009;14;3464;1767;1697
Panevėžys county;2009;15;3893;2047;1846
Panevėžys county;2009;16;4396;2197;2199
Panevėžys county;2009;17;4394;2229;2165
Panevėžys county;2009;18;4189;2145;2044
Panevėžys county;2009;19;4086;2075;2011
Panevėžys county;2009;20;4097;2036;2061
Panevėžys county;2009;21;4183;2122;2061
Panevėžys county;2009;22;4034;2064;1970
Panevėžys county;2009;23;3727;1853;1874
Panevėžys county;2009;24;3677;1857;1820
Panevėžys county;2009;25;3538;1811;1727
Panevėžys county;2009;26;2765;1435;1330
Panevėžys county;2009;27;2343;1290;1053
Panevėžys county;2009;28;2365;1294;1071
Panevėžys county;2009;29;2451;1253;1198
Panevėžys county;2009;30;2601;1368;1233
Panevėžys county;2009;31;2895;1478;1417
Panevėžys county;2009;32;3022;1548;1474
Panevėžys county;2009;33;3123;1519;1604
Panevėžys county;2009;34;3170;1518;1652
Panevėžys county;2009;35;3317;1596;1721
Panevėžys county;2009;36;3418;1679;1739
Panevėžys county;2009;37;3539;1668;1871
Panevėžys county;2009;38;3704;1833;1871
Panevėžys county;2009;39;3732;1809;1923
Panevėžys county;2009;40;3885;1877;2008
Panevėžys county;2009;41;3964;1837;2127
Panevėžys county;2009;42;3965;1887;2078
Panevėžys county;2009;43;3935;1912;2023
Panevėžys county;2009;44;4083;1939;2144
Panevėžys county;2009;45;4085;1937;2148
Panevėžys county;2009;46;4316;2088;2228
Panevėžys county;2009;47;4372;2119;2253
Panevėžys county;2009;48;4321;2088;2233
Panevėžys county;2009;49;4274;2057;2217
Panevėžys county;2009;50;3999;1883;2116
Panevėžys county;2009;51;3713;1695;2018
Panevėžys county;2009;52;3422;1604;1818
Panevėžys county;2009;53;3246;1514;1732
Panevėžys county;2009;54;3240;1514;1726
Panevėžys county;2009;55;2978;1429;1549
Panevėžys county;2009;56;3137;1484;1653
Panevėžys county;2009;57;3086;1398;1688
Panevėžys county;2009;58;3005;1343;1662
Panevėžys county;2009;59;2959;1240;1719
Panevėžys county;2009;60;2839;1235;1604
Panevėžys county;2009;61;2612;1124;1488
Panevėžys county;2009;62;2565;1133;1432
Panevėžys county;2009;63;2744;1184;1560
Panevėžys county;2009;64;2598;1124;1474
Panevėžys county;2009;65;3023;1226;1797
Panevėžys county;2009;66;3156;1270;1886
Panevėžys county;2009;67;3156;1264;1892
Panevėžys county;2009;68;2832;1162;1670
Panevėžys county;2009;69;2811;1085;1726
Panevėžys county;2009;70;2765;1036;1729
Panevėžys county;2009;71;2748;991;1757
Panevėžys county;2009;72;2808;1033;1775
Panevėžys county;2009;73;2455;877;1578
Panevėžys county;2009;74;2531;884;1647
Panevėžys county;2009;75;2343;816;1527
Panevėžys county;2009;76;2406;752;1654
Panevėžys county;2009;77;2024;648;1376
Panevėžys county;2009;78;2005;617;1388
Panevėžys county;2009;79;1868;602;1266
Panevėžys county;2009;80;1837;539;1298
Panevėžys county;2009;81;1571;470;1101
Panevėžys county;2009;82;1434;358;1076
Panevėžys county;2009;83;1268;267;1001
Panevėžys county;2009;84;1107;266;841
Panevėžys county;2009;85;4626;1084;3542
Panevėžys county;2010;-1;259374;119218;140156
Panevėžys county;2010;0;2277;1188;1089
Panevėžys county;2010;1;2135;1132;1003
Panevėžys county;2010;2;2046;1012;1034
Panevėžys county;2010;3;2174;1055;1119
Panevėžys county;2010;4;2215;1142;1073
Panevėžys county;2010;5;2219;1122;1097
Panevėžys county;2010;6;2273;1203;1070
Panevėžys county;2010;7;2327;1202;1125
Panevėžys county;2010;8;2453;1221;1232
Panevėžys county;2010;9;2568;1364;1204
Panevėžys county;2010;10;2855;1471;1384
Panevėžys county;2010;11;2863;1433;1430
Panevėžys county;2010;12;3038;1523;1515
Panevėžys county;2010;13;3231;1607;1624
Panevėžys county;2010;14;3282;1669;1613
Panevėžys county;2010;15;3441;1747;1694
Panevėžys county;2010;16;3863;2032;1831
Panevėžys county;2010;17;4368;2176;2192
Panevėžys county;2010;18;4341;2200;2141
Panevėžys county;2010;19;4105;2104;2001
Panevėžys county;2010;20;4005;2032;1973
Panevėžys county;2010;21;3994;1988;2006
Panevėžys county;2010;22;4063;2056;2007
Panevėžys county;2010;23;3877;1976;1901
Panevėžys county;2010;24;3562;1773;1789
Panevėžys county;2010;25;3516;1772;1744
Panevėžys county;2010;26;3336;1719;1617
Panevėžys county;2010;27;2588;1354;1234
Panevėžys county;2010;28;2204;1216;988
Panevėžys county;2010;29;2296;1251;1045
Panevėžys county;2010;30;2359;1207;1152
Panevėžys county;2010;31;2519;1325;1194
Panevėžys county;2010;32;2821;1443;1378
Panevėžys county;2010;33;2959;1520;1439
Panevėžys county;2010;34;3051;1481;1570
Panevėžys county;2010;35;3093;1472;1621
Panevėžys county;2010;36;3238;1556;1682
Panevėžys county;2010;37;3351;1636;1715
Panevėžys county;2010;38;3478;1629;1849
Panevėžys county;2010;39;3637;1791;1846
Panevėžys county;2010;40;3672;1773;1899
Panevėžys county;2010;41;3821;1839;1982
Panevėžys county;2010;42;3903;1793;2110
Panevėžys county;2010;43;3896;1844;2052
Panevėžys county;2010;44;3875;1878;1997
Panevėžys county;2010;45;4003;1890;2113
Panevėžys county;2010;46;4023;1899;2124
Panevėžys county;2010;47;4248;2047;2201
Panevėžys county;2010;48;4305;2084;2221
Panevėžys county;2010;49;4255;2048;2207
Panevėžys county;2010;50;4203;2013;2190
Panevėžys county;2010;51;3954;1852;2102
Panevėžys county;2010;52;3656;1658;1998
Panevėžys county;2010;53;3361;1566;1795
Panevėžys county;2010;54;3185;1477;1708
Panevėžys county;2010;55;3187;1486;1701
Panevėžys county;2010;56;2924;1399;1525
Panevėžys county;2010;57;3073;1441;1632
Panevėžys county;2010;58;3014;1351;1663
Panevėžys county;2010;59;2944;1305;1639
Panevėžys county;2010;60;2910;1210;1700
Panevėžys county;2010;61;2787;1200;1587
Panevėžys county;2010;62;2548;1079;1469
Panevėžys county;2010;63;2505;1089;1416
Panevėžys county;2010;64;2653;1121;1532
Panevėžys county;2010;65;2526;1076;1450
Panevėžys county;2010;66;2932;1170;1762
Panevėžys county;2010;67;3084;1226;1858
Panevėžys county;2010;68;3053;1193;1860
Panevėžys county;2010;69;2737;1103;1634
Panevėžys county;2010;70;2727;1026;1701
Panevėžys county;2010;71;2681;990;1691
Panevėžys county;2010;72;2658;946;1712
Panevėžys county;2010;73;2715;979;1736
Panevėžys county;2010;74;2351;815;1536
Panevėžys county;2010;75;2417;817;1600
Panevėžys county;2010;76;2233;756;1477
Panevėžys county;2010;77;2284;699;1585
Panevėžys county;2010;78;1917;596;1321
Panevėžys county;2010;79;1888;564;1324
Panevėžys county;2010;80;1747;561;1186
Panevėžys county;2010;81;1702;478;1224
Panevėžys county;2010;82;1432;416;1016
Panevėžys county;2010;83;1311;317;994
Panevėžys county;2010;84;1154;232;922
Panevėžys county;2010;85;4899;1116;3783
Panevėžys county;2011;-1;251401;115537;135864
Panevėžys county;2011;0;1951;992;959
Panevėžys county;2011;1;2153;1124;1029
Panevėžys county;2011;2;2011;1101;910
Panevėžys county;2011;3;1958;955;1003
Panevėžys county;2011;4;2114;1026;1088
Panevėžys county;2011;5;2141;1108;1033
Panevėžys county;2011;6;2214;1121;1093
Panevėžys county;2011;7;2234;1181;1053
Panevėžys county;2011;8;2290;1210;1080
Panevėžys county;2011;9;2411;1208;1203
Panevėžys county;2011;10;2589;1380;1209
Panevėžys county;2011;11;2833;1470;1363
Panevėžys county;2011;12;2846;1448;1398
Panevėžys county;2011;13;3033;1521;1512
Panevėžys county;2011;14;3246;1609;1637
Panevėžys county;2011;15;3248;1671;1577
Panevėžys county;2011;16;3399;1738;1661
Panevėžys county;2011;17;3846;2009;1837
Panevėžys county;2011;18;4329;2163;2166
Panevėžys county;2011;19;3691;1944;1747
Panevėžys county;2011;20;3330;1760;1570
Panevėžys county;2011;21;3247;1707;1540
Panevėžys county;2011;22;3221;1674;1547
Panevėžys county;2011;23;3240;1695;1545
Panevėžys county;2011;24;3059;1637;1422
Panevėžys county;2011;25;2692;1436;1256
Panevėžys county;2011;26;2594;1361;1233
Panevėžys county;2011;27;2510;1300;1210
Panevėžys county;2011;28;2349;1192;1157
Panevėžys county;2011;29;2306;1203;1103
Panevėžys county;2011;30;2325;1223;1102
Panevėžys county;2011;31;2432;1186;1246
Panevėžys county;2011;32;2551;1298;1253
Panevėžys county;2011;33;2784;1406;1378
Panevėžys county;2011;34;2838;1409;1429
Panevėžys county;2011;35;2990;1433;1557
Panevėžys county;2011;36;3111;1465;1646
Panevėžys county;2011;37;3275;1585;1690
Panevėžys county;2011;38;3437;1676;1761
Panevėžys county;2011;39;3565;1691;1874
Panevėžys county;2011;40;3713;1815;1898
Panevėžys county;2011;41;3699;1757;1942
Panevėžys county;2011;42;3852;1848;2004
Panevėžys county;2011;43;3978;1833;2145
Panevėžys county;2011;44;3931;1882;2049
Panevėžys county;2011;45;3903;1891;2012
Panevėžys county;2011;46;4046;1916;2130
Panevėžys county;2011;47;4056;1920;2136
Panevėžys county;2011;48;4303;2074;2229
Panevėžys county;2011;49;4318;2069;2249
Panevėžys county;2011;50;4252;2041;2211
Panevėžys county;2011;51;4210;2004;2206
Panevėžys county;2011;52;3943;1845;2098
Panevėžys county;2011;53;3682;1669;2013
Panevėžys county;2011;54;3442;1590;1852
Panevėžys county;2011;55;3219;1492;1727
Panevėžys county;2011;56;3204;1499;1705
Panevėžys county;2011;57;2926;1396;1530
Panevėžys county;2011;58;3110;1444;1666
Panevėžys county;2011;59;3050;1350;1700
Panevėžys county;2011;60;2995;1314;1681
Panevėžys county;2011;61;2911;1191;1720
Panevėžys county;2011;62;2778;1190;1588
Panevėžys county;2011;63;2529;1055;1474
Panevėžys county;2011;64;2462;1033;1429
Panevėžys county;2011;65;2646;1095;1551
Panevėžys county;2011;66;2508;1060;1448
Panevėžys county;2011;67;2966;1163;1803
Panevėžys county;2011;68;3076;1203;1873
Panevėžys county;2011;69;3004;1152;1852
Panevėžys county;2011;70;2665;1053;1612
Panevėžys county;2011;71;2661;978;1683
Panevėžys county;2011;72;2597;928;1669
Panevėžys county;2011;73;2538;868;1670
Panevėžys county;2011;74;2635;932;1703
Panevėžys county;2011;75;2268;768;1500
Panevėžys county;2011;76;2326;779;1547
Panevėžys county;2011;77;2167;725;1442
Panevėžys county;2011;78;2155;642;1513
Panevėžys county;2011;79;1819;551;1268
Panevėžys county;2011;80;1780;522;1258
Panevėžys county;2011;81;1622;492;1130
Panevėžys county;2011;82;1578;446;1132
Panevėžys county;2011;83;1307;374;933
Panevėžys county;2011;84;1172;275;897
Panevėžys county;2011;85;5006;1097;3909
Panevėžys county;2012;-1;246298;113057;133241
Panevėžys county;2012;0;2072;1078;994
Panevėžys county;2012;1;1930;980;950
Panevėžys county;2012;2;2117;1100;1017
Panevėžys county;2012;3;1997;1090;907
Panevėžys county;2012;4;1928;941;987
Panevėžys county;2012;5;2089;1017;1072
Panevėžys county;2012;6;2123;1098;1025
Panevėžys county;2012;7;2202;1115;1087
Panevėžys county;2012;8;2218;1175;1043
Panevėžys county;2012;9;2265;1200;1065
Panevėžys county;2012;10;2380;1188;1192
Panevėžys county;2012;11;2572;1363;1209
Panevėžys county;2012;12;2805;1459;1346
Panevėžys county;2012;13;2809;1429;1380
Panevėžys county;2012;14;3001;1504;1497
Panevėžys county;2012;15;3214;1593;1621
Panevėžys county;2012;16;3216;1654;1562
Panevėžys county;2012;17;3392;1734;1658
Panevėžys county;2012;18;3811;1999;1812
Panevėžys county;2012;19;4204;2099;2105
Panevėžys county;2012;20;3611;1906;1705
Panevėžys county;2012;21;3215;1704;1511
Panevėžys county;2012;22;3098;1626;1472
Panevėžys county;2012;23;3042;1607;1435
Panevėžys county;2012;24;3065;1628;1437
Panevėžys county;2012;25;2838;1525;1313
Panevėžys county;2012;26;2422;1333;1089
Panevėžys county;2012;27;2376;1255;1121
Panevėžys county;2012;28;2308;1205;1103
Panevėžys county;2012;29;2230;1124;1106
Panevėžys county;2012;30;2188;1135;1053
Panevėžys county;2012;31;2219;1174;1045
Panevėžys county;2012;32;2339;1124;1215
Panevėžys county;2012;33;2467;1247;1220
Panevėžys county;2012;34;2689;1366;1323
Panevėžys county;2012;35;2762;1362;1400
Panevėžys county;2012;36;2922;1404;1518
Panevėžys county;2012;37;3044;1428;1616
Panevėžys county;2012;38;3215;1554;1661
Panevėžys county;2012;39;3391;1651;1740
Panevėžys county;2012;40;3519;1664;1855
Panevėžys county;2012;41;3646;1778;1868
Panevėžys county;2012;42;3663;1735;1928
Panevėžys county;2012;43;3802;1823;1979
Panevėžys county;2012;44;3926;1799;2127
Panevėžys county;2012;45;3879;1859;2020
Panevėžys county;2012;46;3873;1881;1992
Panevėžys county;2012;47;3983;1884;2099
Panevėžys county;2012;48;4027;1901;2126
Panevėžys county;2012;49;4247;2033;2214
Panevėžys county;2012;50;4274;2041;2233
Panevėžys county;2012;51;4204;2018;2186
Panevėžys county;2012;52;4160;1977;2183
Panevėžys county;2012;53;3887;1809;2078
Panevėžys county;2012;54;3627;1631;1996
Panevėžys county;2012;55;3395;1558;1837
Panevėžys county;2012;56;3184;1466;1718
Panevėžys county;2012;57;3161;1465;1696
Panevėžys county;2012;58;2879;1371;1508
Panevėžys county;2012;59;3057;1410;1647
Panevėžys county;2012;60;2993;1303;1690
Panevėžys county;2012;61;2951;1279;1672
Panevėžys county;2012;62;2856;1157;1699
Panevėžys county;2012;63;2737;1164;1573
Panevėžys county;2012;64;2461;1003;1458
Panevėžys county;2012;65;2407;994;1413
Panevėžys county;2012;66;2583;1055;1528
Panevėžys county;2012;67;2433;1004;1429
Panevėžys county;2012;68;2892;1116;1776
Panevėžys county;2012;69;2996;1151;1845
Panevėžys county;2012;70;2926;1106;1820
Panevėžys county;2012;71;2587;1005;1582
Panevėžys county;2012;72;2575;921;1654
Panevėžys county;2012;73;2518;883;1635
Panevėžys county;2012;74;2426;797;1629
Panevėžys county;2012;75;2542;882;1660
Panevėžys county;2012;76;2180;727;1453
Panevėžys county;2012;77;2205;719;1486
Panevėžys county;2012;78;2059;661;1398
Panevėžys county;2012;79;2022;587;1435
Panevėžys county;2012;80;1704;503;1201
Panevėžys county;2012;81;1656;474;1182
Panevėžys county;2012;82;1519;444;1075
Panevėžys county;2012;83;1446;387;1059
Panevėžys county;2012;84;1188;331;857
Panevėžys county;2012;85;5257;1127;4130
Panevėžys county;2013;-1;242340;111157;131183
Panevėžys county;2013;0;2138;1062;1076
Panevėžys county;2013;1;2074;1077;997
Panevėžys county;2013;2;1892;967;925
Panevėžys county;2013;3;2100;1085;1015
Panevėžys county;2013;4;1976;1080;896
Panevėžys county;2013;5;1893;911;982
Panevėžys county;2013;6;2061;1003;1058
Panevėžys county;2013;7;2101;1088;1013
Panevėžys county;2013;8;2176;1105;1071
Panevėžys county;2013;9;2196;1163;1033
Panevėžys county;2013;10;2248;1191;1057
Panevėžys county;2013;11;2370;1178;1192
Panevėžys county;2013;12;2549;1352;1197
Panevėžys county;2013;13;2792;1452;1340
Panevėžys county;2013;14;2800;1425;1375
Panevėžys county;2013;15;2986;1492;1494
Panevėžys county;2013;16;3206;1589;1617
Panevėžys county;2013;17;3196;1647;1549
Panevėžys county;2013;18;3363;1713;1650
Panevėžys county;2013;19;3729;1963;1766
Panevėžys county;2013;20;4115;2061;2054
Panevėžys county;2013;21;3530;1852;1678
Panevėžys county;2013;22;3108;1658;1450
Panevėžys county;2013;23;2946;1564;1382
Panevėžys county;2013;24;2895;1550;1345
Panevėžys county;2013;25;2931;1581;1350
Panevėžys county;2013;26;2668;1444;1224
Panevėžys county;2013;27;2270;1257;1013
Panevėžys county;2013;28;2248;1216;1032
Panevėžys county;2013;29;2210;1146;1064
Panevėžys county;2013;30;2160;1101;1059
Panevėžys county;2013;31;2120;1093;1027
Panevėžys county;2013;32;2156;1151;1005
Panevėžys county;2013;33;2293;1086;1207
Panevėžys county;2013;34;2425;1232;1193
Panevėžys county;2013;35;2628;1331;1297
Panevėžys county;2013;36;2721;1345;1376
Panevėžys county;2013;37;2873;1386;1487
Panevėžys county;2013;38;3006;1400;1606
Panevėžys county;2013;39;3178;1528;1650
Panevėžys county;2013;40;3357;1633;1724
Panevėžys county;2013;41;3474;1642;1832
Panevėžys county;2013;42;3615;1760;1855
Panevėžys county;2013;43;3629;1713;1916
Panevėžys county;2013;44;3771;1800;1971
Panevėžys county;2013;45;3882;1779;2103
Panevėžys county;2013;46;3836;1837;1999
Panevėžys county;2013;47;3829;1859;1970
Panevėžys county;2013;48;3949;1863;2086
Panevėžys county;2013;49;4001;1884;2117
Panevėžys county;2013;50;4205;2007;2198
Panevėžys county;2013;51;4213;1997;2216
Panevėžys county;2013;52;4158;1986;2172
Panevėžys county;2013;53;4123;1951;2172
Panevėžys county;2013;54;3828;1766;2062
Panevėžys county;2013;55;3595;1615;1980
Panevėžys county;2013;56;3359;1530;1829
Panevėžys county;2013;57;3146;1436;1710
Panevėžys county;2013;58;3116;1429;1687
Panevėžys county;2013;59;2838;1342;1496
Panevėžys county;2013;60;3010;1375;1635
Panevėžys county;2013;61;2929;1252;1677
Panevėžys county;2013;62;2891;1238;1653
Panevėžys county;2013;63;2798;1121;1677
Panevėžys county;2013;64;2701;1141;1560
Panevėžys county;2013;65;2403;967;1436
Panevėžys county;2013;66;2354;954;1400
Panevėžys county;2013;67;2518;1004;1514
Panevėžys county;2013;68;2375;965;1410
Panevėžys county;2013;69;2809;1070;1739
Panevėžys county;2013;70;2900;1096;1804
Panevėžys county;2013;71;2831;1046;1785
Panevėžys county;2013;72;2498;955;1543
Panevėžys county;2013;73;2492;867;1625
Panevėžys county;2013;74;2440;834;1606
Panevėžys county;2013;75;2333;748;1585
Panevėžys county;2013;76;2430;830;1600
Panevėžys county;2013;77;2086;683;1403
Panevėžys county;2013;78;2113;673;1440
Panevėžys county;2013;79;1955;606;1349
Panevėžys county;2013;80;1915;550;1365
Panevėžys county;2013;81;1597;469;1128
Panevėžys county;2013;82;1526;425;1101
Panevėžys county;2013;83;1391;395;996
Panevėžys county;2013;84;1310;330;980
Panevėžys county;2013;85;5484;1209;4275
Panevėžys county;2014;-1;238748;109605;129143
Panevėžys county;2014;0;2112;1076;1036
Panevėžys county;2014;1;2146;1064;1082
Panevėžys county;2014;2;2038;1055;983
Panevėžys county;2014;3;1877;962;915
Panevėžys county;2014;4;2072;1077;995
Panevėžys county;2014;5;1946;1056;890
Panevėžys county;2014;6;1872;906;966
Panevėžys county;2014;7;2039;986;1053
Panevėžys county;2014;8;2083;1081;1002
Panevėžys county;2014;9;2170;1101;1069
Panevėžys county;2014;10;2177;1155;1022
Panevėžys county;2014;11;2242;1188;1054
Panevėžys county;2014;12;2352;1166;1186
Panevėžys county;2014;13;2526;1336;1190
Panevėžys county;2014;14;2767;1439;1328
Panevėžys county;2014;15;2795;1425;1370
Panevėžys county;2014;16;2969;1486;1483
Panevėžys county;2014;17;3187;1581;1606
Panevėžys county;2014;18;3160;1634;1526
Panevėžys county;2014;19;3301;1683;1618
Panevėžys county;2014;20;3642;1920;1722
Panevėžys county;2014;21;4022;1995;2027
Panevėžys county;2014;22;3475;1825;1650
Panevėžys county;2014;23;2992;1613;1379
Panevėžys county;2014;24;2856;1535;1321
Panevėžys county;2014;25;2764;1492;1272
Panevėžys county;2014;26;2817;1546;1271
Panevėžys county;2014;27;2543;1388;1155
Panevėžys county;2014;28;2149;1218;931
Panevėžys county;2014;29;2102;1145;957
Panevėžys county;2014;30;2114;1098;1016
Panevėžys county;2014;31;2096;1070;1026
Panevėžys county;2014;32;2061;1063;998
Panevėžys county;2014;33;2116;1124;992
Panevėžys county;2014;34;2242;1066;1176
Panevėžys county;2014;35;2378;1210;1168
Panevėžys county;2014;36;2595;1310;1285
Panevėžys county;2014;37;2693;1334;1359
Panevėžys county;2014;38;2851;1378;1473
Panevėžys county;2014;39;2956;1380;1576
Panevėžys county;2014;40;3141;1514;1627
Panevėžys county;2014;41;3327;1614;1713
Panevėžys county;2014;42;3457;1634;1823
Panevėžys county;2014;43;3598;1754;1844
Panevėžys county;2014;44;3601;1697;1904
Panevėžys county;2014;45;3730;1783;1947
Panevėžys county;2014;46;3836;1755;2081
Panevėžys county;2014;47;3807;1824;1983
Panevėžys county;2014;48;3795;1834;1961
Panevėžys county;2014;49;3928;1846;2082
Panevėžys county;2014;50;3984;1874;2110
Panevėžys county;2014;51;4177;1994;2183
Panevėžys county;2014;52;4162;1973;2189
Panevėžys county;2014;53;4122;1964;2158
Panevėžys county;2014;54;4093;1931;2162
Panevėžys county;2014;55;3799;1739;2060
Panevėžys county;2014;56;3541;1580;1961
Panevėžys county;2014;57;3309;1502;1807
Panevėžys county;2014;58;3117;1422;1695
Panevėžys county;2014;59;3067;1398;1669
Panevėžys county;2014;60;2794;1312;1482
Panevėžys county;2014;61;2962;1341;1621
Panevėžys county;2014;62;2881;1220;1661
Panevėžys county;2014;63;2841;1213;1628
Panevėžys county;2014;64;2755;1083;1672
Panevėžys county;2014;65;2649;1100;1549
Panevėžys county;2014;66;2363;942;1421
Panevėžys county;2014;67;2288;912;1376
Panevėžys county;2014;68;2455;966;1489
Panevėžys county;2014;69;2300;919;1381
Panevėžys county;2014;70;2727;1017;1710
Panevėžys county;2014;71;2820;1048;1772
Panevėžys county;2014;72;2746;995;1751
Panevėžys county;2014;73;2417;901;1516
Panevėžys county;2014;74;2409;827;1582
Panevėžys county;2014;75;2348;779;1569
Panevėžys county;2014;76;2251;710;1541
Panevėžys county;2014;77;2334;778;1556
Panevėžys county;2014;78;1995;634;1361
Panevėžys county;2014;79;1997;620;1377
Panevėžys county;2014;80;1840;555;1285
Panevėžys county;2014;81;1800;513;1287
Panevėžys county;2014;82;1479;426;1053
Panevėžys county;2014;83;1406;379;1027
Panevėžys county;2014;84;1257;349;908
Panevėžys county;2014;85;5748;1267;4481
Panevėžys county;2015;-1;235394;108063;127331
Panevėžys county;2015;0;2161;1090;1071
Panevėžys county;2015;1;2114;1072;1042
Panevėžys county;2015;2;2122;1048;1074
Panevėžys county;2015;3;2017;1046;971
Panevėžys county;2015;4;1846;949;897
Panevėžys county;2015;5;2064;1074;990
Panevėžys county;2015;6;1922;1050;872
Panevėžys county;2015;7;1859;900;959
Panevėžys county;2015;8;2013;976;1037
Panevėžys county;2015;9;2074;1077;997
Panevėžys county;2015;10;2149;1085;1064
Panevėžys county;2015;11;2158;1138;1020
Panevėžys county;2015;12;2229;1183;1046
Panevėžys county;2015;13;2335;1153;1182
Panevėžys county;2015;14;2504;1325;1179
Panevėžys county;2015;15;2750;1429;1321
Panevėžys county;2015;16;2774;1416;1358
Panevėžys county;2015;17;2954;1478;1476
Panevėžys county;2015;18;3168;1570;1598
Panevėžys county;2015;19;3101;1605;1496
Panevėžys county;2015;20;3234;1653;1581
Panevėžys county;2015;21;3595;1889;1706
Panevėžys county;2015;22;3941;1979;1962
Panevėžys county;2015;23;3374;1784;1590
Panevėžys county;2015;24;2887;1570;1317
Panevėžys county;2015;25;2798;1521;1277
Panevėžys county;2015;26;2656;1451;1205
Panevėžys county;2015;27;2678;1482;1196
Panevėžys county;2015;28;2457;1352;1105
Panevėžys county;2015;29;2069;1171;898
Panevėžys county;2015;30;1989;1089;900
Panevėžys county;2015;31;2018;1061;957
Panevėžys county;2015;32;2032;1046;986
Panevėžys county;2015;33;2018;1039;979
Panevėžys county;2015;34;2046;1083;963
Panevėžys county;2015;35;2203;1048;1155
Panevėžys county;2015;36;2346;1188;1158
Panevėžys county;2015;37;2555;1289;1266
Panevėžys county;2015;38;2655;1310;1345
Panevėžys county;2015;39;2827;1367;1460
Panevėžys county;2015;40;2938;1377;1561
Panevėžys county;2015;41;3118;1501;1617
Panevėžys county;2015;42;3296;1596;1700
Panevėžys county;2015;43;3425;1617;1808
Panevėžys county;2015;44;3565;1734;1831
Panevėžys county;2015;45;3561;1676;1885
Panevėžys county;2015;46;3715;1775;1940
Panevėžys county;2015;47;3806;1732;2074
Panevėžys county;2015;48;3774;1801;1973
Panevėžys county;2015;49;3754;1802;1952
Panevėžys county;2015;50;3879;1807;2072
Panevėžys county;2015;51;3938;1839;2099
Panevėžys county;2015;52;4133;1963;2170
Panevėžys county;2015;53;4118;1944;2174
Panevėžys county;2015;54;4081;1934;2147
Panevėžys county;2015;55;4053;1904;2149
Panevėžys county;2015;56;3767;1723;2044
Panevėžys county;2015;57;3493;1550;1943
Panevėžys county;2015;58;3259;1467;1792
Panevėžys county;2015;59;3082;1395;1687
Panevėžys county;2015;60;3039;1375;1664
Panevėžys county;2015;61;2749;1284;1465
Panevėžys county;2015;62;2902;1297;1605
Panevėžys county;2015;63;2825;1185;1640
Panevėžys county;2015;64;2782;1173;1609
Panevėžys county;2015;65;2695;1043;1652
Panevėžys county;2015;66;2594;1065;1529
Panevėžys county;2015;67;2307;910;1397
Panevėžys county;2015;68;2223;870;1353
Panevėžys county;2015;69;2378;924;1454
Panevėžys county;2015;70;2242;886;1356
Panevėžys county;2015;71;2650;973;1677
Panevėžys county;2015;72;2733;987;1746
Panevėžys county;2015;73;2671;954;1717
Panevėžys county;2015;74;2331;843;1488
Panevėžys county;2015;75;2329;779;1550
Panevėžys county;2015;76;2268;736;1532
Panevėžys county;2015;77;2167;672;1495
Panevėžys county;2015;78;2242;734;1508
Panevėžys county;2015;79;1878;587;1291
Panevėžys county;2015;80;1885;570;1315
Panevėžys county;2015;81;1752;522;1230
Panevėžys county;2015;82;1674;460;1214
Panevėžys county;2015;83;1355;377;978
Panevėžys county;2015;84;1304;339;965
Panevėžys county;2015;85;5972;1345;4627
Panevėžys county;2016;-1;231001;105939;125062
Panevėžys county;2016;0;2219;1129;1090
Panevėžys county;2016;1;2169;1104;1065
Panevėžys county;2016;2;2094;1057;1037
Panevėžys county;2016;3;2076;1013;1063
Panevėžys county;2016;4;1982;1028;954
Panevėžys county;2016;5;1824;935;889
Panevėžys county;2016;6;2029;1050;979
Panevėžys county;2016;7;1886;1032;854
Panevėžys county;2016;8;1846;890;956
Panevėžys county;2016;9;1997;970;1027
Panevėžys county;2016;10;2051;1065;986
Panevėžys county;2016;11;2128;1072;1056
Panevėžys county;2016;12;2144;1135;1009
Panevėžys county;2016;13;2219;1179;1040
Panevėžys county;2016;14;2317;1152;1165
Panevėžys county;2016;15;2486;1316;1170
Panevėžys county;2016;16;2730;1420;1310
Panevėžys county;2016;17;2752;1404;1348
Panevėžys county;2016;18;2932;1460;1472
Panevėžys county;2016;19;3094;1534;1560
Panevėžys county;2016;20;3039;1569;1470
Panevėžys county;2016;21;3174;1619;1555
Panevėžys county;2016;22;3482;1829;1653
Panevėžys county;2016;23;3796;1904;1892
Panevėžys county;2016;24;3183;1695;1488
Panevėžys county;2016;25;2714;1474;1240
Panevėžys county;2016;26;2627;1426;1201
Panevėžys county;2016;27;2511;1388;1123
Panevėžys county;2016;28;2567;1418;1149
Panevėžys county;2016;29;2323;1293;1030
Panevėžys county;2016;30;1966;1117;849
Panevėžys county;2016;31;1869;1021;848
Panevėžys county;2016;32;1925;1016;909
Panevėžys county;2016;33;1947;1005;942
Panevėžys county;2016;34;1978;1018;960
Panevėžys county;2016;35;1957;1026;931
Panevėžys county;2016;36;2136;1018;1118
Panevėžys county;2016;37;2288;1157;1131
Panevėžys county;2016;38;2504;1269;1235
Panevėžys county;2016;39;2602;1286;1316
Panevėžys county;2016;40;2799;1356;1443
Panevėžys county;2016;41;2914;1370;1544
Panevėžys county;2016;42;3079;1480;1599
Panevėžys county;2016;43;3259;1575;1684
Panevėžys county;2016;44;3381;1595;1786
Panevėžys county;2016;45;3502;1702;1800
Panevėžys county;2016;46;3508;1638;1870
Panevėžys county;2016;47;3676;1755;1921
Panevėžys county;2016;48;3775;1714;2061
Panevėžys county;2016;49;3744;1779;1965
Panevėžys county;2016;50;3729;1786;1943
Panevėžys county;2016;51;3841;1780;2061
Panevėžys county;2016;52;3885;1800;2085
Panevėžys county;2016;53;4073;1929;2144
Panevėžys county;2016;54;4062;1903;2159
Panevėžys county;2016;55;4021;1893;2128
Panevėžys county;2016;56;3991;1863;2128
Panevėžys county;2016;57;3712;1694;2018
Panevėžys county;2016;58;3435;1506;1929
Panevėžys county;2016;59;3214;1430;1784
Panevėžys county;2016;60;3054;1376;1678
Panevėžys county;2016;61;2992;1341;1651
Panevėžys county;2016;62;2703;1250;1453
Panevėžys county;2016;63;2847;1262;1585
Panevėžys county;2016;64;2769;1143;1626
Panevėžys county;2016;65;2714;1132;1582
Panevėžys county;2016;66;2634;1006;1628
Panevėžys county;2016;67;2551;1032;1519
Panevėžys county;2016;68;2258;882;1376
Panevėžys county;2016;69;2172;841;1331
Panevėžys county;2016;70;2308;882;1426
Panevėžys county;2016;71;2181;845;1336
Panevėžys county;2016;72;2567;918;1649
Panevėžys county;2016;73;2634;935;1699
Panevėžys county;2016;74;2565;893;1672
Panevėžys county;2016;75;2254;802;1452
Panevėžys county;2016;76;2228;717;1511
Panevėžys county;2016;77;2158;686;1472
Panevėžys county;2016;78;2064;616;1448
Panevėžys county;2016;79;2136;683;1453
Panevėžys county;2016;80;1764;535;1229
Panevėžys county;2016;81;1768;527;1241
Panevėžys county;2016;82;1613;464;1149
Panevėžys county;2016;83;1547;415;1132
Panevėžys county;2016;84;1232;336;896
Panevėžys county;2016;85;6125;1379;4746
Panevėžys county;2017;-1;225033;103277;121756
Panevėžys county;2017;0;1992;1030;962
Panevėžys county;2017;1;2187;1118;1069
Panevėžys county;2017;2;2110;1078;1032
Panevėžys county;2017;3;2046;1030;1016
Panevėžys county;2017;4;2042;1001;1041
Panevėžys county;2017;5;1949;1007;942
Panevėžys county;2017;6;1797;926;871
Panevėžys county;2017;7;2008;1034;974
Panevėžys county;2017;8;1849;1006;843
Panevėžys county;2017;9;1820;878;942
Panevėžys county;2017;10;1969;964;1005
Panevėžys county;2017;11;2018;1048;970
Panevėžys county;2017;12;2105;1060;1045
Panevėžys county;2017;13;2119;1120;999
Panevėžys county;2017;14;2190;1160;1030
Panevėžys county;2017;15;2296;1140;1156
Panevėžys county;2017;16;2463;1303;1160
Panevėžys county;2017;17;2705;1408;1297
Panevėžys county;2017;18;2704;1382;1322
Panevėžys county;2017;19;2832;1426;1406
Panevėžys county;2017;20;3009;1499;1510
Panevėžys county;2017;21;2957;1532;1425
Panevėžys county;2017;22;3056;1560;1496
Panevėžys county;2017;23;3299;1748;1551
Panevėžys county;2017;24;3591;1822;1769
Panevėžys county;2017;25;2987;1617;1370
Panevėžys county;2017;26;2487;1380;1107
Panevėžys county;2017;27;2393;1319;1074
Panevėžys county;2017;28;2297;1297;1000
Panevėžys county;2017;29;2319;1294;1025
Panevėžys county;2017;30;2089;1198;891
Panevėžys county;2017;31;1802;1042;760
Panevėžys county;2017;32;1746;952;794
Panevėžys county;2017;33;1787;935;852
Panevėžys county;2017;34;1822;938;884
Panevėžys county;2017;35;1872;963;909
Panevėžys county;2017;36;1876;978;898
Panevėžys county;2017;37;2064;982;1082
Panevėžys county;2017;38;2210;1116;1094
Panevėžys county;2017;39;2453;1241;1212
Panevėžys county;2017;40;2541;1251;1290
Panevėžys county;2017;41;2749;1324;1425
Panevėžys county;2017;42;2864;1337;1527
Panevėžys county;2017;43;3032;1454;1578
Panevėžys county;2017;44;3198;1551;1647
Panevėžys county;2017;45;3315;1553;1762
Panevėžys county;2017;46;3466;1686;1780
Panevėžys county;2017;47;3465;1614;1851
Panevėžys county;2017;48;3622;1726;1896
Panevėžys county;2017;49;3717;1683;2034
Panevėžys county;2017;50;3702;1762;1940
Panevėžys county;2017;51;3681;1760;1921
Panevėžys county;2017;52;3789;1752;2037
Panevėžys county;2017;53;3825;1771;2054
Panevėžys county;2017;54;4006;1895;2111
Panevėžys county;2017;55;3999;1860;2139
Panevėžys county;2017;56;3962;1856;2106
Panevėžys county;2017;57;3947;1835;2112
Panevėžys county;2017;58;3666;1665;2001
Panevėžys county;2017;59;3395;1485;1910
Panevėžys county;2017;60;3165;1396;1769
Panevėžys county;2017;61;2998;1337;1661
Panevėžys county;2017;62;2930;1304;1626
Panevėžys county;2017;63;2665;1222;1443
Panevėžys county;2017;64;2780;1216;1564
Panevėžys county;2017;65;2688;1093;1595
Panevėžys county;2017;66;2652;1092;1560
Panevėžys county;2017;67;2563;958;1605
Panevėžys county;2017;68;2478;984;1494
Panevėžys county;2017;69;2208;855;1353
Panevėžys county;2017;70;2109;807;1302
Panevėžys county;2017;71;2245;842;1403
Panevėžys county;2017;72;2119;808;1311
Panevėžys county;2017;73;2476;864;1612
Panevėžys county;2017;74;2523;864;1659
Panevėžys county;2017;75;2454;830;1624
Panevėžys county;2017;76;2153;741;1412
Panevėžys county;2017;77;2137;669;1468
Panevėžys county;2017;78;2053;641;1412
Panevėžys county;2017;79;1944;574;1370
Panevėžys county;2017;80;2008;627;1381
Panevėžys county;2017;81;1663;490;1173
Panevėžys county;2017;82;1657;482;1175
Panevėžys county;2017;83;1492;418;1074
Panevėžys county;2017;84;1431;385;1046
Panevėžys county;2017;85;6184;1426;4758
Panevėžys county;2018;-1;218726;100267;118459
Panevėžys county;2018;0;1927;971;956
Panevėžys county;2018;1;1966;1014;952
Panevėžys county;2018;2;2138;1086;1052
Panevėžys county;2018;3;2061;1049;1012
Panevėžys county;2018;4;2020;1013;1007
Panevėžys county;2018;5;2005;985;1020
Panevėžys county;2018;6;1902;988;914
Panevėžys county;2018;7;1763;911;852
Panevėžys county;2018;8;1969;1013;956
Panevėžys county;2018;9;1813;986;827
Panevėžys county;2018;10;1785;863;922
Panevėžys county;2018;11;1947;955;992
Panevėžys county;2018;12;1992;1033;959
Panevėžys county;2018;13;2076;1049;1027
Panevėžys county;2018;14;2085;1102;983
Panevėžys county;2018;15;2161;1142;1019
Panevėžys county;2018;16;2279;1130;1149
Panevėžys county;2018;17;2446;1296;1150
Panevėžys county;2018;18;2642;1372;1270
Panevėžys county;2018;19;2545;1314;1231
Panevėžys county;2018;20;2686;1348;1338
Panevėžys county;2018;21;2843;1426;1417
Panevėžys county;2018;22;2776;1443;1333
Panevėžys county;2018;23;2813;1433;1380
Panevėžys county;2018;24;3070;1639;1431
Panevėžys county;2018;25;3331;1711;1620
Panevėžys county;2018;26;2664;1482;1182
Panevėžys county;2018;27;2272;1282;990
Panevėžys county;2018;28;2181;1219;962
Panevėžys county;2018;29;2073;1195;878
Panevėžys county;2018;30;2121;1187;934
Panevėžys county;2018;31;1957;1127;830
Panevėžys county;2018;32;1668;976;692
Panevėžys county;2018;33;1613;883;730
Panevėžys county;2018;34;1691;877;814
Panevėžys county;2018;35;1740;903;837
Panevėžys county;2018;36;1819;935;884
Panevėžys county;2018;37;1825;948;877
Panevėžys county;2018;38;1992;943;1049
Panevėžys county;2018;39;2154;1089;1065
Panevėžys county;2018;40;2380;1200;1180
Panevėžys county;2018;41;2500;1221;1279
Panevėžys county;2018;42;2692;1293;1399
Panevėžys county;2018;43;2814;1301;1513
Panevėžys county;2018;44;2992;1438;1554
Panevėžys county;2018;45;3141;1516;1625
Panevėžys county;2018;46;3237;1509;1728
Panevėžys county;2018;47;3417;1661;1756
Panevėžys county;2018;48;3414;1581;1833
Panevėžys county;2018;49;3556;1678;1878
Panevėžys county;2018;50;3672;1664;2008
Panevėžys county;2018;51;3657;1733;1924
Panevėžys county;2018;52;3634;1728;1906
Panevėžys county;2018;53;3728;1721;2007
Panevėžys county;2018;54;3787;1750;2037
Panevėžys county;2018;55;3951;1860;2091
Panevėžys county;2018;56;3955;1829;2126
Panevėžys county;2018;57;3916;1827;2089
Panevėžys county;2018;58;3882;1795;2087
Panevėžys county;2018;59;3608;1628;1980
Panevėžys county;2018;60;3353;1454;1899
Panevėžys county;2018;61;3116;1368;1748
Panevėžys county;2018;62;2952;1307;1645
Panevėžys county;2018;63;2884;1274;1610
Panevėžys county;2018;64;2614;1183;1431
Panevėžys county;2018;65;2722;1178;1544
Panevėžys county;2018;66;2613;1049;1564
Panevėžys county;2018;67;2588;1050;1538
Panevėžys county;2018;68;2487;908;1579
Panevėžys county;2018;69;2422;943;1479
Panevėžys county;2018;70;2145;818;1327
Panevėžys county;2018;71;2031;750;1281
Panevėžys county;2018;72;2169;793;1376
Panevėžys county;2018;73;2050;770;1280
Panevėžys county;2018;74;2379;813;1566
Panevėžys county;2018;75;2432;807;1625
Panevėžys county;2018;76;2373;778;1595
Panevėžys county;2018;77;2062;695;1367
Panevėžys county;2018;78;2033;625;1408
Panevėžys county;2018;79;1960;598;1362
Panevėžys county;2018;80;1850;533;1317
Panevėžys county;2018;81;1861;556;1305
Panevėžys county;2018;82;1547;435;1112
Panevėžys county;2018;83;1526;435;1091
Panevėžys county;2018;84;1367;374;993
Panevėžys county;2018;85;6446;1522;4924
Panevėžys d. mun.;2001;-1;42886;20529;22357
Panevėžys d. mun.;2001;0;410;224;186
Panevėžys d. mun.;2001;1;477;236;241
Panevėžys d. mun.;2001;2;472;239;233
Panevėžys d. mun.;2001;3;480;243;237
Panevėžys d. mun.;2001;4;527;264;263
Panevėžys d. mun.;2001;5;482;251;231
Panevėžys d. mun.;2001;6;544;286;258
Panevėžys d. mun.;2001;7;629;309;320
Panevėžys d. mun.;2001;8;741;370;371
Panevėžys d. mun.;2001;9;737;384;353
Panevėžys d. mun.;2001;10;743;364;379
Panevėžys d. mun.;2001;11;728;372;356
Panevėžys d. mun.;2001;12;699;359;340
Panevėžys d. mun.;2001;13;752;381;371
Panevėžys d. mun.;2001;14;730;387;343
Panevėžys d. mun.;2001;15;714;366;348
Panevėžys d. mun.;2001;16;697;365;332
Panevėžys d. mun.;2001;17;658;336;322
Panevėžys d. mun.;2001;18;522;274;248
Panevėžys d. mun.;2001;19;426;258;168
Panevėžys d. mun.;2001;20;407;220;187
Panevėžys d. mun.;2001;21;441;232;209
Panevėžys d. mun.;2001;22;470;261;209
Panevėžys d. mun.;2001;23;497;280;217
Panevėžys d. mun.;2001;24;507;273;234
Panevėžys d. mun.;2001;25;468;232;236
Panevėžys d. mun.;2001;26;485;260;225
Panevėžys d. mun.;2001;27;491;279;212
Panevėžys d. mun.;2001;28;493;256;237
Panevėžys d. mun.;2001;29;500;248;252
Panevėžys d. mun.;2001;30;555;289;266
Panevėžys d. mun.;2001;31;601;282;319
Panevėžys d. mun.;2001;32;582;292;290
Panevėžys d. mun.;2001;33;589;275;314
Panevėžys d. mun.;2001;34;623;316;307
Panevėžys d. mun.;2001;35;626;328;298
Panevėžys d. mun.;2001;36;657;334;323
Panevėžys d. mun.;2001;37;640;317;323
Panevėžys d. mun.;2001;38;692;366;326
Panevėžys d. mun.;2001;39;682;353;329
Panevėžys d. mun.;2001;40;651;350;301
Panevėžys d. mun.;2001;41;659;333;326
Panevėžys d. mun.;2001;42;630;322;308
Panevėžys d. mun.;2001;43;571;275;296
Panevėžys d. mun.;2001;44;524;277;247
Panevėžys d. mun.;2001;45;523;259;264
Panevėžys d. mun.;2001;46;512;269;243
Panevėžys d. mun.;2001;47;491;255;236
Panevėžys d. mun.;2001;48;496;258;238
Panevėžys d. mun.;2001;49;497;268;229
Panevėžys d. mun.;2001;50;475;234;241
Panevėžys d. mun.;2001;51;455;211;244
Panevėžys d. mun.;2001;52;472;238;234
Panevėžys d. mun.;2001;53;438;235;203
Panevėžys d. mun.;2001;54;419;209;210
Panevėžys d. mun.;2001;55;501;242;259
Panevėžys d. mun.;2001;56;438;197;241
Panevėžys d. mun.;2001;57;557;273;284
Panevėžys d. mun.;2001;58;530;247;283
Panevėžys d. mun.;2001;59;538;259;279
Panevėžys d. mun.;2001;60;520;240;280
Panevėžys d. mun.;2001;61;470;212;258
Panevėžys d. mun.;2001;62;481;215;266
Panevėžys d. mun.;2001;63;486;210;276
Panevėžys d. mun.;2001;64;480;188;292
Panevėžys d. mun.;2001;65;447;189;258
Panevėžys d. mun.;2001;66;492;216;276
Panevėžys d. mun.;2001;67;463;175;288
Panevėžys d. mun.;2001;68;427;154;273
Panevėžys d. mun.;2001;69;421;158;263
Panevėžys d. mun.;2001;70;429;159;270
Panevėžys d. mun.;2001;71;375;141;234
Panevėžys d. mun.;2001;72;387;131;256
Panevėžys d. mun.;2001;73;392;134;258
Panevėžys d. mun.;2001;74;328;110;218
Panevėžys d. mun.;2001;75;276;75;201
Panevėžys d. mun.;2001;76;295;75;220
Panevėžys d. mun.;2001;77;283;77;206
Panevėžys d. mun.;2001;78;304;86;218
Panevėžys d. mun.;2001;79;239;75;164
Panevėžys d. mun.;2001;80;213;55;158
Panevėžys d. mun.;2001;81;171;42;129
Panevėžys d. mun.;2001;82;84;23;61
Panevėžys d. mun.;2001;83;110;26;84
Panevėžys d. mun.;2001;84;108;29;79
Panevėžys d. mun.;2001;85;654;162;492
Panevėžys d. mun.;2002;-1;42628;20448;22180
Panevėžys d. mun.;2002;0;455;237;218
Panevėžys d. mun.;2002;1;396;218;178
Panevėžys d. mun.;2002;2;475;238;237
Panevėžys d. mun.;2002;3;473;241;232
Panevėžys d. mun.;2002;4;483;246;237
Panevėžys d. mun.;2002;5;536;268;268
Panevėžys d. mun.;2002;6;480;253;227
Panevėžys d. mun.;2002;7;540;292;248
Panevėžys d. mun.;2002;8;625;311;314
Panevėžys d. mun.;2002;9;738;372;366
Panevėžys d. mun.;2002;10;740;387;353
Panevėžys d. mun.;2002;11;733;359;374
Panevėžys d. mun.;2002;12;726;371;355
Panevėžys d. mun.;2002;13;694;355;339
Panevėžys d. mun.;2002;14;754;379;375
Panevėžys d. mun.;2002;15;724;385;339
Panevėžys d. mun.;2002;16;704;359;345
Panevėžys d. mun.;2002;17;684;359;325
Panevėžys d. mun.;2002;18;657;334;323
Panevėžys d. mun.;2002;19;511;268;243
Panevėžys d. mun.;2002;20;425;252;173
Panevėžys d. mun.;2002;21;410;215;195
Panevėžys d. mun.;2002;22;436;227;209
Panevėžys d. mun.;2002;23;476;266;210
Panevėžys d. mun.;2002;24;485;276;209
Panevėžys d. mun.;2002;25;508;271;237
Panevėžys d. mun.;2002;26;460;227;233
Panevėžys d. mun.;2002;27;473;255;218
Panevėžys d. mun.;2002;28;469;265;204
Panevėžys d. mun.;2002;29;475;242;233
Panevėžys d. mun.;2002;30;501;252;249
Panevėžys d. mun.;2002;31;543;284;259
Panevėžys d. mun.;2002;32;589;278;311
Panevėžys d. mun.;2002;33;566;281;285
Panevėžys d. mun.;2002;34;581;271;310
Panevėžys d. mun.;2002;35;615;313;302
Panevėžys d. mun.;2002;36;626;324;302
Panevėžys d. mun.;2002;37;649;325;324
Panevėžys d. mun.;2002;38;631;314;317
Panevėžys d. mun.;2002;39;676;360;316
Panevėžys d. mun.;2002;40;670;342;328
Panevėžys d. mun.;2002;41;658;352;306
Panevėžys d. mun.;2002;42;655;334;321
Panevėžys d. mun.;2002;43;627;321;306
Panevėžys d. mun.;2002;44;572;275;297
Panevėžys d. mun.;2002;45;524;280;244
Panevėžys d. mun.;2002;46;513;252;261
Panevėžys d. mun.;2002;47;511;269;242
Panevėžys d. mun.;2002;48;486;251;235
Panevėžys d. mun.;2002;49;498;266;232
Panevėžys d. mun.;2002;50;490;262;228
Panevėžys d. mun.;2002;51;467;226;241
Panevėžys d. mun.;2002;52;455;214;241
Panevėžys d. mun.;2002;53;470;238;232
Panevėžys d. mun.;2002;54;430;225;205
Panevėžys d. mun.;2002;55;416;211;205
Panevėžys d. mun.;2002;56;489;239;250
Panevėžys d. mun.;2002;57;422;189;233
Panevėžys d. mun.;2002;58;545;266;279
Panevėžys d. mun.;2002;59;520;240;280
Panevėžys d. mun.;2002;60;531;252;279
Panevėžys d. mun.;2002;61;518;238;280
Panevėžys d. mun.;2002;62;472;209;263
Panevėžys d. mun.;2002;63;478;213;265
Panevėžys d. mun.;2002;64;479;205;274
Panevėžys d. mun.;2002;65;485;191;294
Panevėžys d. mun.;2002;66;437;182;255
Panevėžys d. mun.;2002;67;482;209;273
Panevėžys d. mun.;2002;68;455;171;284
Panevėžys d. mun.;2002;69;419;145;274
Panevėžys d. mun.;2002;70;416;159;257
Panevėžys d. mun.;2002;71;412;152;260
Panevėžys d. mun.;2002;72;365;136;229
Panevėžys d. mun.;2002;73;375;123;252
Panevėžys d. mun.;2002;74;378;128;250
Panevėžys d. mun.;2002;75;312;102;210
Panevėžys d. mun.;2002;76;258;67;191
Panevėžys d. mun.;2002;77;289;73;216
Panevėžys d. mun.;2002;78;266;73;193
Panevėžys d. mun.;2002;79;287;75;212
Panevėžys d. mun.;2002;80;232;75;157
Panevėžys d. mun.;2002;81;192;50;142
Panevėžys d. mun.;2002;82;159;35;124
Panevėžys d. mun.;2002;83;74;21;53
Panevėžys d. mun.;2002;84;92;21;71
Panevėžys d. mun.;2002;85;625;161;464
Panevėžys d. mun.;2003;-1;42657;20467;22190
Panevėžys d. mun.;2003;0;443;240;203
Panevėžys d. mun.;2003;1;460;237;223
Panevėžys d. mun.;2003;2;398;220;178
Panevėžys d. mun.;2003;3;472;235;237
Panevėžys d. mun.;2003;4;476;241;235
Panevėžys d. mun.;2003;5;488;250;238
Panevėžys d. mun.;2003;6;538;270;268
Panevėžys d. mun.;2003;7;484;253;231
Panevėžys d. mun.;2003;8;542;294;248
Panevėžys d. mun.;2003;9;629;309;320
Panevėžys d. mun.;2003;10;740;375;365
Panevėžys d. mun.;2003;11;742;389;353
Panevėžys d. mun.;2003;12;726;358;368
Panevėžys d. mun.;2003;13;732;373;359
Panevėžys d. mun.;2003;14;697;352;345
Panevėžys d. mun.;2003;15;747;374;373
Panevėžys d. mun.;2003;16;719;383;336
Panevėžys d. mun.;2003;17;695;354;341
Panevėžys d. mun.;2003;18;680;356;324
Panevėžys d. mun.;2003;19;650;334;316
Panevėžys d. mun.;2003;20;512;272;240
Panevėžys d. mun.;2003;21;424;251;173
Panevėžys d. mun.;2003;22;415;215;200
Panevėžys d. mun.;2003;23;439;226;213
Panevėžys d. mun.;2003;24;479;264;215
Panevėžys d. mun.;2003;25;488;280;208
Panevėžys d. mun.;2003;26;502;268;234
Panevėžys d. mun.;2003;27;458;227;231
Panevėžys d. mun.;2003;28;476;256;220
Panevėžys d. mun.;2003;29;459;257;202
Panevėžys d. mun.;2003;30;475;238;237
Panevėžys d. mun.;2003;31;503;254;249
Panevėžys d. mun.;2003;32;538;285;253
Panevėžys d. mun.;2003;33;586;278;308
Panevėžys d. mun.;2003;34;565;279;286
Panevėžys d. mun.;2003;35;577;262;315
Panevėžys d. mun.;2003;36;618;312;306
Panevėžys d. mun.;2003;37;616;319;297
Panevėžys d. mun.;2003;38;644;325;319
Panevėžys d. mun.;2003;39;633;317;316
Panevėžys d. mun.;2003;40;671;358;313
Panevėžys d. mun.;2003;41;680;348;332
Panevėžys d. mun.;2003;42;656;349;307
Panevėžys d. mun.;2003;43;650;334;316
Panevėžys d. mun.;2003;44;629;324;305
Panevėžys d. mun.;2003;45;575;280;295
Panevėžys d. mun.;2003;46;521;273;248
Panevėžys d. mun.;2003;47;513;249;264
Panevėžys d. mun.;2003;48;514;268;246
Panevėžys d. mun.;2003;49;482;249;233
Panevėžys d. mun.;2003;50;501;270;231
Panevėžys d. mun.;2003;51;489;260;229
Panevėžys d. mun.;2003;52;469;227;242
Panevėžys d. mun.;2003;53;458;219;239
Panevėžys d. mun.;2003;54;467;236;231
Panevėžys d. mun.;2003;55;422;216;206
Panevėžys d. mun.;2003;56;422;213;209
Panevėžys d. mun.;2003;57;486;234;252
Panevėžys d. mun.;2003;58;414;184;230
Panevėžys d. mun.;2003;59;541;266;275
Panevėžys d. mun.;2003;60;522;240;282
Panevėžys d. mun.;2003;61;525;248;277
Panevėžys d. mun.;2003;62;514;236;278
Panevėžys d. mun.;2003;63;462;202;260
Panevėžys d. mun.;2003;64;475;208;267
Panevėžys d. mun.;2003;65;473;205;268
Panevėžys d. mun.;2003;66;478;190;288
Panevėžys d. mun.;2003;67;429;177;252
Panevėžys d. mun.;2003;68;475;200;275
Panevėžys d. mun.;2003;69;446;166;280
Panevėžys d. mun.;2003;70;409;140;269
Panevėžys d. mun.;2003;71;397;143;254
Panevėžys d. mun.;2003;72;411;149;262
Panevėžys d. mun.;2003;73;353;124;229
Panevėžys d. mun.;2003;74;358;108;250
Panevėžys d. mun.;2003;75;363;125;238
Panevėžys d. mun.;2003;76;300;97;203
Panevėžys d. mun.;2003;77;256;66;190
Panevėžys d. mun.;2003;78;277;71;206
Panevėžys d. mun.;2003;79;252;67;185
Panevėžys d. mun.;2003;80;274;64;210
Panevėžys d. mun.;2003;81;210;64;146
Panevėžys d. mun.;2003;82;176;41;135
Panevėžys d. mun.;2003;83;141;29;112
Panevėžys d. mun.;2003;84;64;19;45
Panevėžys d. mun.;2003;85;592;149;443
Panevėžys d. mun.;2004;-1;42588;20420;22168
Panevėžys d. mun.;2004;0;431;225;206
Panevėžys d. mun.;2004;1;430;234;196
Panevėžys d. mun.;2004;2;459;238;221
Panevėžys d. mun.;2004;3;404;227;177
Panevėžys d. mun.;2004;4;478;239;239
Panevėžys d. mun.;2004;5;480;242;238
Panevėžys d. mun.;2004;6;489;247;242
Panevėžys d. mun.;2004;7;537;274;263
Panevėžys d. mun.;2004;8;486;255;231
Panevėžys d. mun.;2004;9;546;298;248
Panevėžys d. mun.;2004;10;633;310;323
Panevėžys d. mun.;2004;11;733;370;363
Panevėžys d. mun.;2004;12;742;386;356
Panevėžys d. mun.;2004;13;721;354;367
Panevėžys d. mun.;2004;14;712;357;355
Panevėžys d. mun.;2004;15;700;353;347
Panevėžys d. mun.;2004;16;734;370;364
Panevėžys d. mun.;2004;17;717;386;331
Panevėžys d. mun.;2004;18;691;352;339
Panevėžys d. mun.;2004;19;681;359;322
Panevėžys d. mun.;2004;20;655;336;319
Panevėžys d. mun.;2004;21;517;272;245
Panevėžys d. mun.;2004;22;413;245;168
Panevėžys d. mun.;2004;23;419;214;205
Panevėžys d. mun.;2004;24;431;228;203
Panevėžys d. mun.;2004;25;482;258;224
Panevėžys d. mun.;2004;26;478;275;203
Panevėžys d. mun.;2004;27;498;268;230
Panevėžys d. mun.;2004;28;449;219;230
Panevėžys d. mun.;2004;29;472;249;223
Panevėžys d. mun.;2004;30;448;248;200
Panevėžys d. mun.;2004;31;469;231;238
Panevėžys d. mun.;2004;32;493;251;242
Panevėžys d. mun.;2004;33;536;286;250
Panevėžys d. mun.;2004;34;585;277;308
Panevėžys d. mun.;2004;35;565;277;288
Panevėžys d. mun.;2004;36;571;260;311
Panevėžys d. mun.;2004;37;611;309;302
Panevėžys d. mun.;2004;38;614;314;300
Panevėžys d. mun.;2004;39;642;322;320
Panevėžys d. mun.;2004;40;635;316;319
Panevėžys d. mun.;2004;41;674;362;312
Panevėžys d. mun.;2004;42;678;348;330
Panevėžys d. mun.;2004;43;661;348;313
Panevėžys d. mun.;2004;44;652;336;316
Panevėžys d. mun.;2004;45;633;323;310
Panevėžys d. mun.;2004;46;572;279;293
Panevėžys d. mun.;2004;47;533;277;256
Panevėžys d. mun.;2004;48;523;256;267
Panevėžys d. mun.;2004;49;510;264;246
Panevėžys d. mun.;2004;50;482;247;235
Panevėžys d. mun.;2004;51;512;274;238
Panevėžys d. mun.;2004;52;477;257;220
Panevėžys d. mun.;2004;53;468;228;240
Panevėžys d. mun.;2004;54;468;221;247
Panevėžys d. mun.;2004;55;468;236;232
Panevėžys d. mun.;2004;56;423;218;205
Panevėžys d. mun.;2004;57;418;207;211
Panevėžys d. mun.;2004;58;494;237;257
Panevėžys d. mun.;2004;59;421;184;237
Panevėžys d. mun.;2004;60;536;260;276
Panevėžys d. mun.;2004;61;518;237;281
Panevėžys d. mun.;2004;62;522;242;280
Panevėžys d. mun.;2004;63;514;238;276
Panevėžys d. mun.;2004;64;458;194;264
Panevėžys d. mun.;2004;65;477;213;264
Panevėžys d. mun.;2004;66;464;201;263
Panevėžys d. mun.;2004;67;463;180;283
Panevėžys d. mun.;2004;68;417;162;255
Panevėžys d. mun.;2004;69;459;188;271
Panevėžys d. mun.;2004;70;432;157;275
Panevėžys d. mun.;2004;71;398;136;262
Panevėžys d. mun.;2004;72;387;141;246
Panevėžys d. mun.;2004;73;400;139;261
Panevėžys d. mun.;2004;74;341;120;221
Panevėžys d. mun.;2004;75;339;100;239
Panevėžys d. mun.;2004;76;350;115;235
Panevėžys d. mun.;2004;77;285;91;194
Panevėžys d. mun.;2004;78;237;57;180
Panevėžys d. mun.;2004;79;259;63;196
Panevėžys d. mun.;2004;80;228;55;173
Panevėžys d. mun.;2004;81;244;56;188
Panevėžys d. mun.;2004;82;195;59;136
Panevėžys d. mun.;2004;83;151;36;115
Panevėžys d. mun.;2004;84;125;22;103
Panevėžys d. mun.;2004;85;535;125;410
Panevėžys d. mun.;2005;-1;42435;20401;22034
Panevėžys d. mun.;2005;0;408;206;202
Panevėžys d. mun.;2005;1;439;230;209
Panevėžys d. mun.;2005;2;428;231;197
Panevėžys d. mun.;2005;3;456;234;222
Panevėžys d. mun.;2005;4;403;227;176
Panevėžys d. mun.;2005;5;476;238;238
Panevėžys d. mun.;2005;6;476;239;237
Panevėžys d. mun.;2005;7;492;248;244
Panevėžys d. mun.;2005;8;535;271;264
Panevėžys d. mun.;2005;9;490;256;234
Panevėžys d. mun.;2005;10;548;299;249
Panevėžys d. mun.;2005;11;630;310;320
Panevėžys d. mun.;2005;12;732;368;364
Panevėžys d. mun.;2005;13;749;392;357
Panevėžys d. mun.;2005;14;720;354;366
Panevėžys d. mun.;2005;15;704;353;351
Panevėžys d. mun.;2005;16;692;346;346
Panevėžys d. mun.;2005;17;725;368;357
Panevėžys d. mun.;2005;18;702;378;324
Panevėžys d. mun.;2005;19;688;351;337
Panevėžys d. mun.;2005;20;667;356;311
Panevėžys d. mun.;2005;21;650;336;314
Panevėžys d. mun.;2005;22;508;266;242
Panevėžys d. mun.;2005;23;413;244;169
Panevėžys d. mun.;2005;24;410;212;198
Panevėžys d. mun.;2005;25;419;220;199
Panevėžys d. mun.;2005;26;471;255;216
Panevėžys d. mun.;2005;27;461;271;190
Panevėžys d. mun.;2005;28;499;271;228
Panevėžys d. mun.;2005;29;454;218;236
Panevėžys d. mun.;2005;30;468;249;219
Panevėžys d. mun.;2005;31;448;252;196
Panevėžys d. mun.;2005;32;461;230;231
Panevėžys d. mun.;2005;33;495;250;245
Panevėžys d. mun.;2005;34;534;278;256
Panevėžys d. mun.;2005;35;585;282;303
Panevėžys d. mun.;2005;36;561;273;288
Panevėžys d. mun.;2005;37;567;260;307
Panevėžys d. mun.;2005;38;627;319;308
Panevėžys d. mun.;2005;39;615;309;306
Panevėžys d. mun.;2005;40;642;324;318
Panevėžys d. mun.;2005;41;635;315;320
Panevėžys d. mun.;2005;42;676;358;318
Panevėžys d. mun.;2005;43;677;347;330
Panevėžys d. mun.;2005;44;650;339;311
Panevėžys d. mun.;2005;45;662;339;323
Panevėžys d. mun.;2005;46;643;329;314
Panevėžys d. mun.;2005;47;578;282;296
Panevėžys d. mun.;2005;48;540;283;257
Panevėžys d. mun.;2005;49;528;261;267
Panevėžys d. mun.;2005;50;517;267;250
Panevėžys d. mun.;2005;51;484;250;234
Panevėžys d. mun.;2005;52;514;277;237
Panevėžys d. mun.;2005;53;476;254;222
Panevėžys d. mun.;2005;54;466;230;236
Panevėžys d. mun.;2005;55;469;216;253
Panevėžys d. mun.;2005;56;466;232;234
Panevėžys d. mun.;2005;57;417;210;207
Panevėžys d. mun.;2005;58;415;204;211
Panevėžys d. mun.;2005;59;488;239;249
Panevėžys d. mun.;2005;60;413;181;232
Panevėžys d. mun.;2005;61;529;257;272
Panevėžys d. mun.;2005;62;510;234;276
Panevėžys d. mun.;2005;63;515;234;281
Panevėžys d. mun.;2005;64;498;224;274
Panevėžys d. mun.;2005;65;449;188;261
Panevėžys d. mun.;2005;66;470;209;261
Panevėžys d. mun.;2005;67;456;199;257
Panevėžys d. mun.;2005;68;445;170;275
Panevėžys d. mun.;2005;69;404;153;251
Panevėžys d. mun.;2005;70;443;180;263
Panevėžys d. mun.;2005;71;418;152;266
Panevėžys d. mun.;2005;72;379;128;251
Panevėžys d. mun.;2005;73;376;136;240
Panevėžys d. mun.;2005;74;382;131;251
Panevėžys d. mun.;2005;75;330;116;214
Panevėžys d. mun.;2005;76;322;92;230
Panevėžys d. mun.;2005;77;331;103;228
Panevėžys d. mun.;2005;78;269;86;183
Panevėžys d. mun.;2005;79;221;54;167
Panevėžys d. mun.;2005;80;256;66;190
Panevėžys d. mun.;2005;81;217;53;164
Panevėžys d. mun.;2005;82;215;50;165
Panevėžys d. mun.;2005;83;173;50;123
Panevėžys d. mun.;2005;84;129;31;98
Panevėžys d. mun.;2005;85;536;118;418
Panevėžys d. mun.;2006;-1;41930;20067;21863
Panevėžys d. mun.;2006;0;432;240;192
Panevėžys d. mun.;2006;1;408;207;201
Panevėžys d. mun.;2006;2;434;229;205
Panevėžys d. mun.;2006;3;425;230;195
Panevėžys d. mun.;2006;4;445;226;219
Panevėžys d. mun.;2006;5;395;221;174
Panevėžys d. mun.;2006;6;474;235;239
Panevėžys d. mun.;2006;7;472;235;237
Panevėžys d. mun.;2006;8;489;243;246
Panevėžys d. mun.;2006;9;537;269;268
Panevėžys d. mun.;2006;10;486;252;234
Panevėžys d. mun.;2006;11;546;297;249
Panevėžys d. mun.;2006;12;630;310;320
Panevėžys d. mun.;2006;13;720;358;362
Panevėžys d. mun.;2006;14;741;383;358
Panevėžys d. mun.;2006;15;713;352;361
Panevėžys d. mun.;2006;16;686;342;344
Panevėžys d. mun.;2006;17;669;329;340
Panevėžys d. mun.;2006;18;702;354;348
Panevėžys d. mun.;2006;19;682;365;317
Panevėžys d. mun.;2006;20;661;332;329
Panevėžys d. mun.;2006;21;639;342;297
Panevėžys d. mun.;2006;22;620;324;296
Panevėžys d. mun.;2006;23;489;255;234
Panevėžys d. mun.;2006;24;398;233;165
Panevėžys d. mun.;2006;25;389;201;188
Panevėžys d. mun.;2006;26;395;209;186
Panevėžys d. mun.;2006;27;449;243;206
Panevėžys d. mun.;2006;28;460;272;188
Panevėžys d. mun.;2006;29;490;267;223
Panevėžys d. mun.;2006;30;451;214;237
Panevėžys d. mun.;2006;31;473;252;221
Panevėžys d. mun.;2006;32;438;245;193
Panevėžys d. mun.;2006;33;452;226;226
Panevėžys d. mun.;2006;34;486;240;246
Panevėžys d. mun.;2006;35;519;269;250
Panevėžys d. mun.;2006;36;574;274;300
Panevėžys d. mun.;2006;37;553;265;288
Panevėžys d. mun.;2006;38;561;252;309
Panevėžys d. mun.;2006;39;622;314;308
Panevėžys d. mun.;2006;40;608;297;311
Panevėžys d. mun.;2006;41;637;317;320
Panevėžys d. mun.;2006;42;621;306;315
Panevėžys d. mun.;2006;43;674;357;317
Panevėžys d. mun.;2006;44;669;339;330
Panevėžys d. mun.;2006;45;655;342;313
Panevėžys d. mun.;2006;46;664;334;330
Panevėžys d. mun.;2006;47;638;322;316
Panevėžys d. mun.;2006;48;576;282;294
Panevėžys d. mun.;2006;49;535;274;261
Panevėžys d. mun.;2006;50;526;255;271
Panevėžys d. mun.;2006;51;523;271;252
Panevėžys d. mun.;2006;52;476;242;234
Panevėžys d. mun.;2006;53;510;270;240
Panevėžys d. mun.;2006;54;471;252;219
Panevėžys d. mun.;2006;55;469;231;238
Panevėžys d. mun.;2006;56;474;219;255
Panevėžys d. mun.;2006;57;457;223;234
Panevėžys d. mun.;2006;58;412;207;205
Panevėžys d. mun.;2006;59;405;199;206
Panevėžys d. mun.;2006;60;483;234;249
Panevėžys d. mun.;2006;61;411;176;235
Panevėžys d. mun.;2006;62;523;250;273
Panevėžys d. mun.;2006;63;503;227;276
Panevėžys d. mun.;2006;64;504;228;276
Panevėžys d. mun.;2006;65;487;218;269
Panevėžys d. mun.;2006;66;440;180;260
Panevėžys d. mun.;2006;67;465;204;261
Panevėžys d. mun.;2006;68;446;193;253
Panevėžys d. mun.;2006;69;433;161;272
Panevėžys d. mun.;2006;70;390;142;248
Panevėžys d. mun.;2006;71;416;163;253
Panevėžys d. mun.;2006;72;402;145;257
Panevėžys d. mun.;2006;73;362;118;244
Panevėžys d. mun.;2006;74;360;127;233
Panevėžys d. mun.;2006;75;364;118;246
Panevėžys d. mun.;2006;76;313;108;205
Panevėžys d. mun.;2006;77;313;88;225
Panevėžys d. mun.;2006;78;317;97;220
Panevėžys d. mun.;2006;79;249;77;172
Panevėžys d. mun.;2006;80;210;49;161
Panevėžys d. mun.;2006;81;237;59;178
Panevėžys d. mun.;2006;82;204;50;154
Panevėžys d. mun.;2006;83;195;48;147
Panevėžys d. mun.;2006;84;155;43;112
Panevėžys d. mun.;2006;85;543;119;424
Panevėžys d. mun.;2007;-1;41573;19913;21660
Panevėžys d. mun.;2007;0;390;197;193
Panevėžys d. mun.;2007;1;431;242;189
Panevėžys d. mun.;2007;2;412;213;199
Panevėžys d. mun.;2007;3;431;228;203
Panevėžys d. mun.;2007;4;425;229;196
Panevėžys d. mun.;2007;5;439;223;216
Panevėžys d. mun.;2007;6;401;225;176
Panevėžys d. mun.;2007;7;464;226;238
Panevėžys d. mun.;2007;8;482;241;241
Panevėžys d. mun.;2007;9;487;239;248
Panevėžys d. mun.;2007;10;544;274;270
Panevėžys d. mun.;2007;11;488;254;234
Panevėžys d. mun.;2007;12;546;295;251
Panevėžys d. mun.;2007;13;632;317;315
Panevėžys d. mun.;2007;14;718;357;361
Panevėžys d. mun.;2007;15;739;385;354
Panevėžys d. mun.;2007;16;708;353;355
Panevėžys d. mun.;2007;17;679;338;341
Panevėžys d. mun.;2007;18;662;328;334
Panevėžys d. mun.;2007;19;692;354;338
Panevėžys d. mun.;2007;20;674;364;310
Panevėžys d. mun.;2007;21;638;318;320
Panevėžys d. mun.;2007;22;630;335;295
Panevėžys d. mun.;2007;23;607;319;288
Panevėžys d. mun.;2007;24;480;248;232
Panevėžys d. mun.;2007;25;376;231;145
Panevėžys d. mun.;2007;26;370;195;175
Panevėžys d. mun.;2007;27;383;202;181
Panevėžys d. mun.;2007;28;438;234;204
Panevėžys d. mun.;2007;29;455;266;189
Panevėžys d. mun.;2007;30;480;261;219
Panevėžys d. mun.;2007;31;452;213;239
Panevėžys d. mun.;2007;32;480;255;225
Panevėžys d. mun.;2007;33;441;240;201
Panevėžys d. mun.;2007;34;448;225;223
Panevėžys d. mun.;2007;35;489;238;251
Panevėžys d. mun.;2007;36;517;271;246
Panevėžys d. mun.;2007;37;564;268;296
Panevėžys d. mun.;2007;38;563;274;289
Panevėžys d. mun.;2007;39;553;250;303
Panevėžys d. mun.;2007;40;613;307;306
Panevėžys d. mun.;2007;41;594;286;308
Panevėžys d. mun.;2007;42;630;312;318
Panevėžys d. mun.;2007;43;616;303;313
Panevėžys d. mun.;2007;44;666;351;315
Panevėžys d. mun.;2007;45;662;334;328
Panevėžys d. mun.;2007;46;656;347;309
Panevėžys d. mun.;2007;47;657;327;330
Panevėžys d. mun.;2007;48;634;320;314
Panevėžys d. mun.;2007;49;572;280;292
Panevėžys d. mun.;2007;50;538;275;263
Panevėžys d. mun.;2007;51;523;255;268
Panevėžys d. mun.;2007;52;507;258;249
Panevėžys d. mun.;2007;53;471;233;238
Panevėžys d. mun.;2007;54;505;266;239
Panevėžys d. mun.;2007;55;468;251;217
Panevėžys d. mun.;2007;56;468;228;240
Panevėžys d. mun.;2007;57;472;215;257
Panevėžys d. mun.;2007;58;452;219;233
Panevėžys d. mun.;2007;59;406;203;203
Panevėžys d. mun.;2007;60;392;190;202
Panevėžys d. mun.;2007;61;483;236;247
Panevėžys d. mun.;2007;62;409;173;236
Panevėžys d. mun.;2007;63;511;237;274
Panevėžys d. mun.;2007;64;496;221;275
Panevėžys d. mun.;2007;65;496;222;274
Panevėžys d. mun.;2007;66;466;208;258
Panevėžys d. mun.;2007;67;429;173;256
Panevėžys d. mun.;2007;68;455;199;256
Panevėžys d. mun.;2007;69;441;191;250
Panevėžys d. mun.;2007;70;419;156;263
Panevėžys d. mun.;2007;71;380;141;239
Panevėžys d. mun.;2007;72;396;150;246
Panevėžys d. mun.;2007;73;387;136;251
Panevėžys d. mun.;2007;74;346;105;241
Panevėžys d. mun.;2007;75;345;118;227
Panevėžys d. mun.;2007;76;344;109;235
Panevėžys d. mun.;2007;77;292;98;194
Panevėžys d. mun.;2007;78;299;84;215
Panevėžys d. mun.;2007;79;308;93;215
Panevėžys d. mun.;2007;80;224;62;162
Panevėžys d. mun.;2007;81;187;46;141
Panevėžys d. mun.;2007;82;215;50;165
Panevėžys d. mun.;2007;83;175;45;130
Panevėžys d. mun.;2007;84;176;42;134
Panevėžys d. mun.;2007;85;584;133;451
Panevėžys d. mun.;2008;-1;41162;19713;21449
Panevėžys d. mun.;2008;0;382;174;208
Panevėžys d. mun.;2008;1;398;202;196
Panevėžys d. mun.;2008;2;424;236;188
Panevėžys d. mun.;2008;3;403;209;194
Panevėžys d. mun.;2008;4;426;224;202
Panevėžys d. mun.;2008;5;430;231;199
Panevėžys d. mun.;2008;6;431;223;208
Panevėžys d. mun.;2008;7;401;224;177
Panevėžys d. mun.;2008;8;457;221;236
Panevėžys d. mun.;2008;9;476;238;238
Panevėžys d. mun.;2008;10;480;233;247
Panevėžys d. mun.;2008;11;542;273;269
Panevėžys d. mun.;2008;12;482;252;230
Panevėžys d. mun.;2008;13;551;296;255
Panevėžys d. mun.;2008;14;625;313;312
Panevėžys d. mun.;2008;15;718;360;358
Panevėžys d. mun.;2008;16;746;387;359
Panevėžys d. mun.;2008;17;699;351;348
Panevėžys d. mun.;2008;18;669;334;335
Panevėžys d. mun.;2008;19;656;327;329
Panevėžys d. mun.;2008;20;678;348;330
Panevėžys d. mun.;2008;21;650;354;296
Panevėžys d. mun.;2008;22;633;315;318
Panevėžys d. mun.;2008;23;620;333;287
Panevėžys d. mun.;2008;24;589;313;276
Panevėžys d. mun.;2008;25;463;240;223
Panevėžys d. mun.;2008;26;373;229;144
Panevėžys d. mun.;2008;27;355;189;166
Panevėžys d. mun.;2008;28;380;207;173
Panevėžys d. mun.;2008;29;419;222;197
Panevėžys d. mun.;2008;30;459;266;193
Panevėžys d. mun.;2008;31;471;253;218
Panevėžys d. mun.;2008;32;434;206;228
Panevėžys d. mun.;2008;33;471;250;221
Panevėžys d. mun.;2008;34;424;230;194
Panevėžys d. mun.;2008;35;445;223;222
Panevėžys d. mun.;2008;36;492;236;256
Panevėžys d. mun.;2008;37;523;279;244
Panevėžys d. mun.;2008;38;552;264;288
Panevėžys d. mun.;2008;39;573;278;295
Panevėžys d. mun.;2008;40;551;249;302
Panevėžys d. mun.;2008;41;606;297;309
Panevėžys d. mun.;2008;42;598;288;310
Panevėžys d. mun.;2008;43;616;306;310
Panevėžys d. mun.;2008;44;600;295;305
Panevėžys d. mun.;2008;45;672;351;321
Panevėžys d. mun.;2008;46;653;331;322
Panevėžys d. mun.;2008;47;646;342;304
Panevėžys d. mun.;2008;48;655;326;329
Panevėžys d. mun.;2008;49;631;312;319
Panevėžys d. mun.;2008;50;569;277;292
Panevėžys d. mun.;2008;51;537;272;265
Panevėžys d. mun.;2008;52;513;246;267
Panevėžys d. mun.;2008;53;509;260;249
Panevėžys d. mun.;2008;54;470;232;238
Panevėžys d. mun.;2008;55;500;264;236
Panevėžys d. mun.;2008;56;463;247;216
Panevėžys d. mun.;2008;57;454;220;234
Panevėžys d. mun.;2008;58;460;207;253
Panevėžys d. mun.;2008;59;439;209;230
Panevėžys d. mun.;2008;60;394;194;200
Panevėžys d. mun.;2008;61;388;187;201
Panevėžys d. mun.;2008;62;472;231;241
Panevėžys d. mun.;2008;63;403;169;234
Panevėžys d. mun.;2008;64;495;227;268
Panevėžys d. mun.;2008;65;489;216;273
Panevėžys d. mun.;2008;66;491;216;275
Panevėžys d. mun.;2008;67;449;197;252
Panevėžys d. mun.;2008;68;420;168;252
Panevėžys d. mun.;2008;69;436;193;243
Panevėžys d. mun.;2008;70;426;180;246
Panevėžys d. mun.;2008;71;405;144;261
Panevėžys d. mun.;2008;72;372;136;236
Panevėžys d. mun.;2008;73;387;147;240
Panevėžys d. mun.;2008;74;379;132;247
Panevėžys d. mun.;2008;75;328;94;234
Panevėžys d. mun.;2008;76;322;107;215
Panevėžys d. mun.;2008;77;328;100;228
Panevėžys d. mun.;2008;78;282;96;186
Panevėžys d. mun.;2008;79;289;84;205
Panevėžys d. mun.;2008;80;283;81;202
Panevėžys d. mun.;2008;81;207;56;151
Panevėžys d. mun.;2008;82;173;39;134
Panevėžys d. mun.;2008;83;192;44;148
Panevėžys d. mun.;2008;84;158;44;114
Panevėžys d. mun.;2008;85;652;157;495
Panevėžys d. mun.;2009;-1;40980;19680;21300
Panevėžys d. mun.;2009;0;349;189;160
Panevėžys d. mun.;2009;1;386;176;210
Panevėžys d. mun.;2009;2;407;205;202
Panevėžys d. mun.;2009;3;423;234;189
Panevėžys d. mun.;2009;4;409;217;192
Panevėžys d. mun.;2009;5;423;221;202
Panevėžys d. mun.;2009;6;435;233;202
Panevėžys d. mun.;2009;7;418;217;201
Panevėžys d. mun.;2009;8;404;226;178
Panevėžys d. mun.;2009;9;460;223;237
Panevėžys d. mun.;2009;10;470;235;235
Panevėžys d. mun.;2009;11;483;235;248
Panevėžys d. mun.;2009;12;547;277;270
Panevėžys d. mun.;2009;13;489;261;228
Panevėžys d. mun.;2009;14;552;298;254
Panevėžys d. mun.;2009;15;627;316;311
Panevėžys d. mun.;2009;16;710;354;356
Panevėžys d. mun.;2009;17;751;393;358
Panevėžys d. mun.;2009;18;701;353;348
Panevėžys d. mun.;2009;19;669;332;337
Panevėžys d. mun.;2009;20;653;329;324
Panevėžys d. mun.;2009;21;673;345;328
Panevėžys d. mun.;2009;22;638;351;287
Panevėžys d. mun.;2009;23;628;319;309
Panevėžys d. mun.;2009;24;605;326;279
Panevėžys d. mun.;2009;25;580;308;272
Panevėžys d. mun.;2009;26;457;239;218
Panevėžys d. mun.;2009;27;377;230;147
Panevėžys d. mun.;2009;28;347;182;165
Panevėžys d. mun.;2009;29;372;201;171
Panevėžys d. mun.;2009;30;406;217;189
Panevėžys d. mun.;2009;31;468;280;188
Panevėžys d. mun.;2009;32;476;256;220
Panevėžys d. mun.;2009;33;443;207;236
Panevėžys d. mun.;2009;34;467;244;223
Panevėžys d. mun.;2009;35;430;232;198
Panevėžys d. mun.;2009;36;449;229;220
Panevėžys d. mun.;2009;37;489;234;255
Panevėžys d. mun.;2009;38;524;277;247
Panevėžys d. mun.;2009;39;555;265;290
Panevėžys d. mun.;2009;40;578;280;298
Panevėžys d. mun.;2009;41;553;254;299
Panevėžys d. mun.;2009;42;607;301;306
Panevėžys d. mun.;2009;43;602;292;310
Panevėžys d. mun.;2009;44;619;308;311
Panevėžys d. mun.;2009;45;597;297;300
Panevėžys d. mun.;2009;46;668;350;318
Panevėžys d. mun.;2009;47;640;324;316
Panevėžys d. mun.;2009;48;648;343;305
Panevėžys d. mun.;2009;49;655;321;334
Panevėžys d. mun.;2009;50;636;315;321
Panevėžys d. mun.;2009;51;562;273;289
Panevėžys d. mun.;2009;52;532;267;265
Panevėžys d. mun.;2009;53;521;251;270
Panevėžys d. mun.;2009;54;496;250;246
Panevėžys d. mun.;2009;55;469;231;238
Panevėžys d. mun.;2009;56;503;264;239
Panevėžys d. mun.;2009;57;457;242;215
Panevėžys d. mun.;2009;58;451;215;236
Panevėžys d. mun.;2009;59;447;201;246
Panevėžys d. mun.;2009;60;426;198;228
Panevėžys d. mun.;2009;61;385;187;198
Panevėžys d. mun.;2009;62;390;186;204
Panevėžys d. mun.;2009;63;463;225;238
Panevėžys d. mun.;2009;64;392;163;229
Panevėžys d. mun.;2009;65;486;219;267
Panevėžys d. mun.;2009;66;477;208;269
Panevėžys d. mun.;2009;67;474;205;269
Panevėžys d. mun.;2009;68;428;183;245
Panevėžys d. mun.;2009;69;405;156;249
Panevėžys d. mun.;2009;70;422;181;241
Panevėžys d. mun.;2009;71;411;176;235
Panevėžys d. mun.;2009;72;387;132;255
Panevėžys d. mun.;2009;73;352;125;227
Panevėžys d. mun.;2009;74;373;141;232
Panevėžys d. mun.;2009;75;364;121;243
Panevėžys d. mun.;2009;76;320;87;233
Panevėžys d. mun.;2009;77;314;105;209
Panevėžys d. mun.;2009;78;312;94;218
Panevėžys d. mun.;2009;79;264;91;173
Panevėžys d. mun.;2009;80;272;77;195
Panevėžys d. mun.;2009;81;263;80;183
Panevėžys d. mun.;2009;82;197;52;145
Panevėžys d. mun.;2009;83;165;36;129
Panevėžys d. mun.;2009;84;167;35;132
Panevėžys d. mun.;2009;85;680;172;508
Panevėžys d. mun.;2010;-1;40377;19431;20946
Panevėžys d. mun.;2010;0;372;202;170
Panevėžys d. mun.;2010;1;344;186;158
Panevėžys d. mun.;2010;2;368;163;205
Panevėžys d. mun.;2010;3;402;199;203
Panevėžys d. mun.;2010;4;404;222;182
Panevėžys d. mun.;2010;5;398;207;191
Panevėžys d. mun.;2010;6;409;215;194
Panevėžys d. mun.;2010;7;416;226;190
Panevėžys d. mun.;2010;8;414;216;198
Panevėžys d. mun.;2010;9;392;219;173
Panevėžys d. mun.;2010;10;443;219;224
Panevėžys d. mun.;2010;11;472;241;231
Panevėžys d. mun.;2010;12;489;242;247
Panevėžys d. mun.;2010;13;539;274;265
Panevėžys d. mun.;2010;14;485;255;230
Panevėžys d. mun.;2010;15;555;299;256
Panevėžys d. mun.;2010;16;622;317;305
Panevėžys d. mun.;2010;17;709;357;352
Panevėžys d. mun.;2010;18;751;392;359
Panevėžys d. mun.;2010;19;692;346;346
Panevėžys d. mun.;2010;20;660;326;334
Panevėžys d. mun.;2010;21;658;334;324
Panevėžys d. mun.;2010;22;664;346;318
Panevėžys d. mun.;2010;23;621;342;279
Panevėžys d. mun.;2010;24;604;305;299
Panevėžys d. mun.;2010;25;587;316;271
Panevėžys d. mun.;2010;26;552;295;257
Panevėžys d. mun.;2010;27;428;231;197
Panevėžys d. mun.;2010;28;351;213;138
Panevėžys d. mun.;2010;29;338;178;160
Panevėžys d. mun.;2010;30;363;198;165
Panevėžys d. mun.;2010;31;394;215;179
Panevėžys d. mun.;2010;32;459;277;182
Panevėžys d. mun.;2010;33;461;250;211
Panevėžys d. mun.;2010;34;434;209;225
Panevėžys d. mun.;2010;35;457;237;220
Panevėžys d. mun.;2010;36;432;235;197
Panevėžys d. mun.;2010;37;429;221;208
Panevėžys d. mun.;2010;38;486;235;251
Panevėžys d. mun.;2010;39;514;269;245
Panevėžys d. mun.;2010;40;546;263;283
Panevėžys d. mun.;2010;41;572;280;292
Panevėžys d. mun.;2010;42;546;251;295
Panevėžys d. mun.;2010;43;604;296;308
Panevėžys d. mun.;2010;44;593;291;302
Panevėžys d. mun.;2010;45;611;310;301
Panevėžys d. mun.;2010;46;599;293;306
Panevėžys d. mun.;2010;47;668;352;316
Panevėžys d. mun.;2010;48;635;318;317
Panevėžys d. mun.;2010;49;643;339;304
Panevėžys d. mun.;2010;50;647;321;326
Panevėžys d. mun.;2010;51;632;315;317
Panevėžys d. mun.;2010;52;561;268;293
Panevėžys d. mun.;2010;53;528;261;267
Panevėžys d. mun.;2010;54;514;245;269
Panevėžys d. mun.;2010;55;488;246;242
Panevėžys d. mun.;2010;56;460;225;235
Panevėžys d. mun.;2010;57;500;261;239
Panevėžys d. mun.;2010;58;449;238;211
Panevėžys d. mun.;2010;59;444;208;236
Panevėžys d. mun.;2010;60;451;201;250
Panevėžys d. mun.;2010;61;421;194;227
Panevėžys d. mun.;2010;62;380;183;197
Panevėžys d. mun.;2010;63;374;175;199
Panevėžys d. mun.;2010;64;450;215;235
Panevėžys d. mun.;2010;65;386;161;225
Panevėžys d. mun.;2010;66;477;212;265
Panevėžys d. mun.;2010;67;466;203;263
Panevėžys d. mun.;2010;68;466;197;269
Panevėžys d. mun.;2010;69;412;172;240
Panevėžys d. mun.;2010;70;391;147;244
Panevėžys d. mun.;2010;71;406;172;234
Panevėžys d. mun.;2010;72;395;165;230
Panevėžys d. mun.;2010;73;376;126;250
Panevėžys d. mun.;2010;74;335;115;220
Panevėžys d. mun.;2010;75;360;132;228
Panevėžys d. mun.;2010;76;352;116;236
Panevėžys d. mun.;2010;77;306;79;227
Panevėžys d. mun.;2010;78;296;97;199
Panevėžys d. mun.;2010;79;287;90;197
Panevėžys d. mun.;2010;80;252;88;164
Panevėžys d. mun.;2010;81;247;64;183
Panevėžys d. mun.;2010;82;242;71;171
Panevėžys d. mun.;2010;83;177;47;130
Panevėžys d. mun.;2010;84;157;31;126
Panevėžys d. mun.;2010;85;707;168;539
Panevėžys d. mun.;2011;-1;39164;18958;20206
Panevėžys d. mun.;2011;0;309;155;154
Panevėžys d. mun.;2011;1;362;194;168
Panevėžys d. mun.;2011;2;299;161;138
Panevėžys d. mun.;2011;3;342;153;189
Panevėžys d. mun.;2011;4;370;181;189
Panevėžys d. mun.;2011;5;371;207;164
Panevėžys d. mun.;2011;6;364;186;178
Panevėžys d. mun.;2011;7;369;181;188
Panevėžys d. mun.;2011;8;429;231;198
Panevėžys d. mun.;2011;9;405;216;189
Panevėžys d. mun.;2011;10;422;227;195
Panevėžys d. mun.;2011;11;465;239;226
Panevėžys d. mun.;2011;12;497;261;236
Panevėžys d. mun.;2011;13;500;248;252
Panevėžys d. mun.;2011;14;544;276;268
Panevėžys d. mun.;2011;15;521;264;257
Panevėžys d. mun.;2011;16;565;310;255
Panevėžys d. mun.;2011;17;639;327;312
Panevėžys d. mun.;2011;18;686;348;338
Panevėžys d. mun.;2011;19;612;335;277
Panevėžys d. mun.;2011;20;567;291;276
Panevėžys d. mun.;2011;21;516;271;245
Panevėžys d. mun.;2011;22;504;273;231
Panevėžys d. mun.;2011;23;531;283;248
Panevėžys d. mun.;2011;24;472;261;211
Panevėžys d. mun.;2011;25;455;247;208
Panevėžys d. mun.;2011;26;406;227;179
Panevėžys d. mun.;2011;27;401;201;200
Panevėžys d. mun.;2011;28;370;195;175
Panevėžys d. mun.;2011;29;370;195;175
Panevėžys d. mun.;2011;30;354;182;172
Panevėžys d. mun.;2011;31;369;180;189
Panevėžys d. mun.;2011;32;392;216;176
Panevėžys d. mun.;2011;33;459;249;210
Panevėžys d. mun.;2011;34;459;246;213
Panevėžys d. mun.;2011;35;488;233;255
Panevėžys d. mun.;2011;36;519;261;258
Panevėžys d. mun.;2011;37;502;281;221
Panevėžys d. mun.;2011;38;515;261;254
Panevėžys d. mun.;2011;39;535;270;265
Panevėžys d. mun.;2011;40;575;308;267
Panevėžys d. mun.;2011;41;613;297;316
Panevėžys d. mun.;2011;42;613;305;308
Panevėžys d. mun.;2011;43;597;284;313
Panevėžys d. mun.;2011;44;640;323;317
Panevėžys d. mun.;2011;45;630;331;299
Panevėžys d. mun.;2011;46;644;328;316
Panevėžys d. mun.;2011;47;628;312;316
Panevėžys d. mun.;2011;48;689;363;326
Panevėžys d. mun.;2011;49;626;322;304
Panevėžys d. mun.;2011;50;622;337;285
Panevėžys d. mun.;2011;51;669;343;326
Panevėžys d. mun.;2011;52;612;310;302
Panevėžys d. mun.;2011;53;560;273;287
Panevėžys d. mun.;2011;54;524;262;262
Panevėžys d. mun.;2011;55;497;246;251
Panevėžys d. mun.;2011;56;497;251;246
Panevėžys d. mun.;2011;57;471;229;242
Panevėžys d. mun.;2011;58;490;246;244
Panevėžys d. mun.;2011;59;460;252;208
Panevėžys d. mun.;2011;60;434;207;227
Panevėžys d. mun.;2011;61;454;205;249
Panevėžys d. mun.;2011;62;403;186;217
Panevėžys d. mun.;2011;63;374;179;195
Panevėžys d. mun.;2011;64;367;166;201
Panevėžys d. mun.;2011;65;441;200;241
Panevėžys d. mun.;2011;66;364;157;207
Panevėžys d. mun.;2011;67;449;204;245
Panevėžys d. mun.;2011;68;437;181;256
Panevėžys d. mun.;2011;69;429;179;250
Panevėžys d. mun.;2011;70;391;167;224
Panevėžys d. mun.;2011;71;368;141;227
Panevėžys d. mun.;2011;72;363;145;218
Panevėžys d. mun.;2011;73;352;136;216
Panevėžys d. mun.;2011;74;345;116;229
Panevėžys d. mun.;2011;75;306;107;199
Panevėžys d. mun.;2011;76;327;118;209
Panevėžys d. mun.;2011;77;318;108;210
Panevėžys d. mun.;2011;78;281;66;215
Panevėžys d. mun.;2011;79;275;81;194
Panevėžys d. mun.;2011;80;259;75;184
Panevėžys d. mun.;2011;81;215;70;145
Panevėžys d. mun.;2011;82;216;62;154
Panevėžys d. mun.;2011;83;205;60;145
Panevėžys d. mun.;2011;84;156;39;117
Panevėžys d. mun.;2011;85;723;158;565
Panevėžys d. mun.;2012;-1;38392;18619;19773
Panevėžys d. mun.;2012;0;302;173;129
Panevėžys d. mun.;2012;1;293;149;144
Panevėžys d. mun.;2012;2;338;184;154
Panevėžys d. mun.;2012;3;296;158;138
Panevėžys d. mun.;2012;4;332;150;182
Panevėžys d. mun.;2012;5;361;179;182
Panevėžys d. mun.;2012;6;375;212;163
Panevėžys d. mun.;2012;7;355;181;174
Panevėžys d. mun.;2012;8;371;181;190
Panevėžys d. mun.;2012;9;436;237;199
Panevėžys d. mun.;2012;10;391;205;186
Panevėžys d. mun.;2012;11;416;222;194
Panevėžys d. mun.;2012;12;463;239;224
Panevėžys d. mun.;2012;13;483;249;234
Panevėžys d. mun.;2012;14;486;242;244
Panevėžys d. mun.;2012;15;542;274;268
Panevėžys d. mun.;2012;16;516;262;254
Panevėžys d. mun.;2012;17;561;308;253
Panevėžys d. mun.;2012;18;634;325;309
Panevėžys d. mun.;2012;19;664;339;325
Panevėžys d. mun.;2012;20;604;336;268
Panevėžys d. mun.;2012;21;553;284;269
Panevėžys d. mun.;2012;22;494;255;239
Panevėžys d. mun.;2012;23;477;261;216
Panevėžys d. mun.;2012;24;501;272;229
Panevėžys d. mun.;2012;25;433;238;195
Panevėžys d. mun.;2012;26;415;237;178
Panevėžys d. mun.;2012;27;370;212;158
Panevėžys d. mun.;2012;28;363;186;177
Panevėžys d. mun.;2012;29;343;184;159
Panevėžys d. mun.;2012;30;349;181;168
Panevėžys d. mun.;2012;31;343;178;165
Panevėžys d. mun.;2012;32;367;176;191
Panevėžys d. mun.;2012;33;383;207;176
Panevėžys d. mun.;2012;34;447;244;203
Panevėžys d. mun.;2012;35;449;239;210
Panevėžys d. mun.;2012;36;474;231;243
Panevėžys d. mun.;2012;37;499;253;246
Panevėžys d. mun.;2012;38;489;278;211
Panevėžys d. mun.;2012;39;498;257;241
Panevėžys d. mun.;2012;40;527;265;262
Panevėžys d. mun.;2012;41;572;303;269
Panevėžys d. mun.;2012;42;617;305;312
Panevėžys d. mun.;2012;43;611;304;307
Panevėžys d. mun.;2012;44;602;282;320
Panevėžys d. mun.;2012;45;630;320;310
Panevėžys d. mun.;2012;46;622;328;294
Panevėžys d. mun.;2012;47;633;319;314
Panevėžys d. mun.;2012;48;626;309;317
Panevėžys d. mun.;2012;49;688;360;328
Panevėžys d. mun.;2012;50;621;322;299
Panevėžys d. mun.;2012;51;619;332;287
Panevėžys d. mun.;2012;52;661;342;319
Panevėžys d. mun.;2012;53;604;305;299
Panevėžys d. mun.;2012;54;557;267;290
Panevėžys d. mun.;2012;55;522;261;261
Panevėžys d. mun.;2012;56;486;241;245
Panevėžys d. mun.;2012;57;494;250;244
Panevėžys d. mun.;2012;58;464;226;238
Panevėžys d. mun.;2012;59;484;242;242
Panevėžys d. mun.;2012;60;447;242;205
Panevėžys d. mun.;2012;61;432;203;229
Panevėžys d. mun.;2012;62;456;203;253
Panevėžys d. mun.;2012;63;402;186;216
Panevėžys d. mun.;2012;64;364;169;195
Panevėžys d. mun.;2012;65;365;163;202
Panevėžys d. mun.;2012;66;432;197;235
Panevėžys d. mun.;2012;67;355;149;206
Panevėžys d. mun.;2012;68;433;192;241
Panevėžys d. mun.;2012;69;424;176;248
Panevėžys d. mun.;2012;70;419;175;244
Panevėžys d. mun.;2012;71;383;159;224
Panevėžys d. mun.;2012;72;361;135;226
Panevėžys d. mun.;2012;73;357;141;216
Panevėžys d. mun.;2012;74;335;124;211
Panevėžys d. mun.;2012;75;330;108;222
Panevėžys d. mun.;2012;76;294;103;191
Panevėžys d. mun.;2012;77;309;110;199
Panevėžys d. mun.;2012;78;301;101;200
Panevėžys d. mun.;2012;79;262;58;204
Panevėžys d. mun.;2012;80;267;77;190
Panevėžys d. mun.;2012;81;239;66;173
Panevėžys d. mun.;2012;82;193;58;135
Panevėžys d. mun.;2012;83;190;48;142
Panevėžys d. mun.;2012;84;193;56;137
Panevėžys d. mun.;2012;85;743;159;584
Panevėžys d. mun.;2013;-1;37867;18407;19460
Panevėžys d. mun.;2013;0;349;172;177
Panevėžys d. mun.;2013;1;303;174;129
Panevėžys d. mun.;2013;2;272;136;136
Panevėžys d. mun.;2013;3;333;182;151
Panevėžys d. mun.;2013;4;299;160;139
Panevėžys d. mun.;2013;5;336;147;189
Panevėžys d. mun.;2013;6;354;177;177
Panevėžys d. mun.;2013;7;358;205;153
Panevėžys d. mun.;2013;8;354;180;174
Panevėžys d. mun.;2013;9;360;177;183
Panevėžys d. mun.;2013;10;424;225;199
Panevėžys d. mun.;2013;11;378;199;179
Panevėžys d. mun.;2013;12;417;226;191
Panevėžys d. mun.;2013;13;473;244;229
Panevėžys d. mun.;2013;14;477;246;231
Panevėžys d. mun.;2013;15;483;238;245
Panevėžys d. mun.;2013;16;542;274;268
Panevėžys d. mun.;2013;17;509;260;249
Panevėžys d. mun.;2013;18;563;312;251
Panevėžys d. mun.;2013;19;618;317;301
Panevėžys d. mun.;2013;20;642;334;308
Panevėžys d. mun.;2013;21;600;329;271
Panevėžys d. mun.;2013;22;547;289;258
Panevėžys d. mun.;2013;23;481;263;218
Panevėžys d. mun.;2013;24;450;249;201
Panevėžys d. mun.;2013;25;486;271;215
Panevėžys d. mun.;2013;26;409;230;179
Panevėžys d. mun.;2013;27;385;220;165
Panevėžys d. mun.;2013;28;349;210;139
Panevėžys d. mun.;2013;29;339;171;168
Panevėžys d. mun.;2013;30;334;184;150
Panevėžys d. mun.;2013;31;342;182;160
Panevėžys d. mun.;2013;32;337;179;158
Panevėžys d. mun.;2013;33;364;177;187
Panevėžys d. mun.;2013;34;379;208;171
Panevėžys d. mun.;2013;35;425;231;194
Panevėžys d. mun.;2013;36;436;230;206
Panevėžys d. mun.;2013;37;462;225;237
Panevėžys d. mun.;2013;38;494;248;246
Panevėžys d. mun.;2013;39;481;268;213
Panevėžys d. mun.;2013;40;495;250;245
Panevėžys d. mun.;2013;41;514;257;257
Panevėžys d. mun.;2013;42;572;302;270
Panevėžys d. mun.;2013;43;619;308;311
Panevėžys d. mun.;2013;44;605;306;299
Panevėžys d. mun.;2013;45;598;281;317
Panevėžys d. mun.;2013;46;630;322;308
Panevėžys d. mun.;2013;47;615;325;290
Panevėžys d. mun.;2013;48;634;316;318
Panevėžys d. mun.;2013;49;624;309;315
Panevėžys d. mun.;2013;50;671;348;323
Panevėžys d. mun.;2013;51;610;313;297
Panevėžys d. mun.;2013;52;618;331;287
Panevėžys d. mun.;2013;53;665;339;326
Panevėžys d. mun.;2013;54;587;295;292
Panevėžys d. mun.;2013;55;568;271;297
Panevėžys d. mun.;2013;56;525;262;263
Panevėžys d. mun.;2013;57;482;238;244
Panevėžys d. mun.;2013;58;482;245;237
Panevėžys d. mun.;2013;59;461;223;238
Panevėžys d. mun.;2013;60;472;231;241
Panevėžys d. mun.;2013;61;445;239;206
Panevėžys d. mun.;2013;62;430;200;230
Panevėžys d. mun.;2013;63;448;203;245
Panevėžys d. mun.;2013;64;398;181;217
Panevėžys d. mun.;2013;65;360;167;193
Panevėžys d. mun.;2013;66;357;156;201
Panevėžys d. mun.;2013;67;424;193;231
Panevėžys d. mun.;2013;68;349;143;206
Panevėžys d. mun.;2013;69;418;185;233
Panevėžys d. mun.;2013;70;402;161;241
Panevėžys d. mun.;2013;71;406;169;237
Panevėžys d. mun.;2013;72;369;156;213
Panevėžys d. mun.;2013;73;350;129;221
Panevėžys d. mun.;2013;74;347;136;211
Panevėžys d. mun.;2013;75;324;118;206
Panevėžys d. mun.;2013;76;323;104;219
Panevėžys d. mun.;2013;77;284;101;183
Panevėžys d. mun.;2013;78;291;101;190
Panevėžys d. mun.;2013;79;287;93;194
Panevėžys d. mun.;2013;80;251;55;196
Panevėžys d. mun.;2013;81;249;69;180
Panevėžys d. mun.;2013;82;223;57;166
Panevėžys d. mun.;2013;83;178;52;126
Panevėžys d. mun.;2013;84;173;40;133
Panevėžys d. mun.;2013;85;790;178;612
Panevėžys d. mun.;2014;-1;37488;18252;19236
Panevėžys d. mun.;2014;0;354;167;187
Panevėžys d. mun.;2014;1;342;167;175
Panevėžys d. mun.;2014;2;289;164;125
Panevėžys d. mun.;2014;3;278;141;137
Panevėžys d. mun.;2014;4;333;182;151
Panevėžys d. mun.;2014;5;296;159;137
Panevėžys d. mun.;2014;6;331;151;180
Panevėžys d. mun.;2014;7;329;159;170
Panevėžys d. mun.;2014;8;357;203;154
Panevėžys d. mun.;2014;9;356;182;174
Panevėžys d. mun.;2014;10;360;178;182
Panevėžys d. mun.;2014;11;418;224;194
Panevėžys d. mun.;2014;12;389;200;189
Panevėžys d. mun.;2014;13;412;226;186
Panevėžys d. mun.;2014;14;477;250;227
Panevėžys d. mun.;2014;15;475;244;231
Panevėžys d. mun.;2014;16;488;238;250
Panevėžys d. mun.;2014;17;537;270;267
Panevėžys d. mun.;2014;18;501;259;242
Panevėžys d. mun.;2014;19;561;308;253
Panevėžys d. mun.;2014;20;606;310;296
Panevėžys d. mun.;2014;21;636;327;309
Panevėžys d. mun.;2014;22;599;325;274
Panevėžys d. mun.;2014;23;546;291;255
Panevėžys d. mun.;2014;24;459;259;200
Panevėžys d. mun.;2014;25;436;246;190
Panevėžys d. mun.;2014;26;458;264;194
Panevėžys d. mun.;2014;27;390;223;167
Panevėžys d. mun.;2014;28;367;215;152
Panevėžys d. mun.;2014;29;330;199;131
Panevėžys d. mun.;2014;30;327;166;161
Panevėžys d. mun.;2014;31;339;186;153
Panevėžys d. mun.;2014;32;338;178;160
Panevėžys d. mun.;2014;33;329;175;154
Panevėžys d. mun.;2014;34;357;175;182
Panevėžys d. mun.;2014;35;366;199;167
Panevėžys d. mun.;2014;36;425;231;194
Panevėžys d. mun.;2014;37;436;236;200
Panevėžys d. mun.;2014;38;458;225;233
Panevėžys d. mun.;2014;39;487;246;241
Panevėžys d. mun.;2014;40;480;273;207
Panevėžys d. mun.;2014;41;506;255;251
Panevėžys d. mun.;2014;42;511;261;250
Panevėžys d. mun.;2014;43;571;300;271
Panevėžys d. mun.;2014;44;613;301;312
Panevėžys d. mun.;2014;45;605;307;298
Panevėžys d. mun.;2014;46;587;279;308
Panevėžys d. mun.;2014;47;635;325;310
Panevėžys d. mun.;2014;48;611;323;288
Panevėžys d. mun.;2014;49;627;311;316
Panevėžys d. mun.;2014;50;628;310;318
Panevėžys d. mun.;2014;51;669;347;322
Panevėžys d. mun.;2014;52;604;311;293
Panevėžys d. mun.;2014;53;609;324;285
Panevėžys d. mun.;2014;54;655;333;322
Panevėžys d. mun.;2014;55;586;290;296
Panevėžys d. mun.;2014;56;559;267;292
Panevėžys d. mun.;2014;57;521;259;262
Panevėžys d. mun.;2014;58;478;237;241
Panevėžys d. mun.;2014;59;479;240;239
Panevėžys d. mun.;2014;60;462;224;238
Panevėžys d. mun.;2014;61;466;227;239
Panevėžys d. mun.;2014;62;433;230;203
Panevėžys d. mun.;2014;63;430;198;232
Panevėžys d. mun.;2014;64;449;206;243
Panevėžys d. mun.;2014;65;386;171;215
Panevėžys d. mun.;2014;66;357;164;193
Panevėžys d. mun.;2014;67;345;151;194
Panevėžys d. mun.;2014;68;410;185;225
Panevėžys d. mun.;2014;69;337;138;199
Panevėžys d. mun.;2014;70;404;175;229
Panevėžys d. mun.;2014;71;394;153;241
Panevėžys d. mun.;2014;72;393;160;233
Panevėžys d. mun.;2014;73;358;149;209
Panevėžys d. mun.;2014;74;336;122;214
Panevėžys d. mun.;2014;75;332;126;206
Panevėžys d. mun.;2014;76;311;112;199
Panevėžys d. mun.;2014;77;308;96;212
Panevėžys d. mun.;2014;78;273;94;179
Panevėžys d. mun.;2014;79;272;94;178
Panevėžys d. mun.;2014;80;270;84;186
Panevėžys d. mun.;2014;81;237;54;183
Panevėžys d. mun.;2014;82;227;61;166
Panevėžys d. mun.;2014;83;205;51;154
Panevėžys d. mun.;2014;84;159;43;116
Panevėžys d. mun.;2014;85;828;183;645
Panevėžys d. mun.;2015;-1;37173;18133;19040
Panevėžys d. mun.;2015;0;364;183;181
Panevėžys d. mun.;2015;1;345;168;177
Panevėžys d. mun.;2015;2;322;159;163
Panevėžys d. mun.;2015;3;289;166;123
Panevėžys d. mun.;2015;4;286;144;142
Panevėžys d. mun.;2015;5;327;179;148
Panevėžys d. mun.;2015;6;288;153;135
Panevėžys d. mun.;2015;7;323;148;175
Panevėžys d. mun.;2015;8;340;169;171
Panevėžys d. mun.;2015;9;353;202;151
Panevėžys d. mun.;2015;10;358;180;178
Panevėžys d. mun.;2015;11;354;170;184
Panevėžys d. mun.;2015;12;417;225;192
Panevėžys d. mun.;2015;13;393;200;193
Panevėžys d. mun.;2015;14;413;228;185
Panevėžys d. mun.;2015;15;462;242;220
Panevėžys d. mun.;2015;16;478;245;233
Panevėžys d. mun.;2015;17;488;236;252
Panevėžys d. mun.;2015;18;534;271;263
Panevėžys d. mun.;2015;19;501;257;244
Panevėžys d. mun.;2015;20;554;303;251
Panevėžys d. mun.;2015;21;601;308;293
Panevėžys d. mun.;2015;22;630;328;302
Panevėžys d. mun.;2015;23;577;319;258
Panevėžys d. mun.;2015;24;536;285;251
Panevėžys d. mun.;2015;25;447;254;193
Panevėžys d. mun.;2015;26;420;241;179
Panevėžys d. mun.;2015;27;430;252;178
Panevėžys d. mun.;2015;28;384;216;168
Panevėžys d. mun.;2015;29;345;208;137
Panevėžys d. mun.;2015;30;314;194;120
Panevėžys d. mun.;2015;31;307;156;151
Panevėžys d. mun.;2015;32;329;175;154
Panevėžys d. mun.;2015;33;343;183;160
Panevėžys d. mun.;2015;34;316;174;142
Panevėžys d. mun.;2015;35;352;169;183
Panevėžys d. mun.;2015;36;367;200;167
Panevėžys d. mun.;2015;37;413;229;184
Panevėžys d. mun.;2015;38;446;237;209
Panevėžys d. mun.;2015;39;456;222;234
Panevėžys d. mun.;2015;40;487;240;247
Panevėžys d. mun.;2015;41;482;278;204
Panevėžys d. mun.;2015;42;500;253;247
Panevėžys d. mun.;2015;43;517;264;253
Panevėžys d. mun.;2015;44;574;298;276
Panevėžys d. mun.;2015;45;605;298;307
Panevėžys d. mun.;2015;46;604;310;294
Panevėžys d. mun.;2015;47;589;281;308
Panevėžys d. mun.;2015;48;637;328;309
Panevėžys d. mun.;2015;49;608;320;288
Panevėžys d. mun.;2015;50;628;309;319
Panevėžys d. mun.;2015;51;631;315;316
Panevėžys d. mun.;2015;52;664;343;321
Panevėžys d. mun.;2015;53;604;309;295
Panevėžys d. mun.;2015;54;601;318;283
Panevėžys d. mun.;2015;55;653;329;324
Panevėžys d. mun.;2015;56;589;291;298
Panevėžys d. mun.;2015;57;556;268;288
Panevėžys d. mun.;2015;58;508;245;263
Panevėžys d. mun.;2015;59;470;229;241
Panevėžys d. mun.;2015;60;478;237;241
Panevėžys d. mun.;2015;61;450;220;230
Panevėžys d. mun.;2015;62;462;225;237
Panevėžys d. mun.;2015;63;420;223;197
Panevėžys d. mun.;2015;64;432;197;235
Panevėžys d. mun.;2015;65;442;203;239
Panevėžys d. mun.;2015;66;376;162;214
Panevėžys d. mun.;2015;67;347;159;188
Panevėžys d. mun.;2015;68;334;145;189
Panevėžys d. mun.;2015;69;395;177;218
Panevėžys d. mun.;2015;70;329;138;191
Panevėžys d. mun.;2015;71;391;167;224
Panevėžys d. mun.;2015;72;384;148;236
Panevėžys d. mun.;2015;73;381;154;227
Panevėžys d. mun.;2015;74;350;140;210
Panevėžys d. mun.;2015;75;323;115;208
Panevėžys d. mun.;2015;76;327;121;206
Panevėžys d. mun.;2015;77;304;109;195
Panevėžys d. mun.;2015;78;298;91;207
Panevėžys d. mun.;2015;79;252;85;167
Panevėžys d. mun.;2015;80;261;90;171
Panevėžys d. mun.;2015;81;254;75;179
Panevėžys d. mun.;2015;82;216;47;169
Panevėžys d. mun.;2015;83;215;59;156
Panevėžys d. mun.;2015;84;193;46;147
Panevėžys d. mun.;2015;85;850;196;654
Panevėžys d. mun.;2016;-1;36705;17924;18781
Panevėžys d. mun.;2016;0;339;169;170
Panevėžys d. mun.;2016;1;357;181;176
Panevėžys d. mun.;2016;2;329;156;173
Panevėžys d. mun.;2016;3;324;162;162
Panevėžys d. mun.;2016;4;286;167;119
Panevėžys d. mun.;2016;5;292;149;143
Panevėžys d. mun.;2016;6;324;175;149
Panevėžys d. mun.;2016;7;277;146;131
Panevėžys d. mun.;2016;8;323;151;172
Panevėžys d. mun.;2016;9;346;179;167
Panevėžys d. mun.;2016;10;355;202;153
Panevėžys d. mun.;2016;11;353;174;179
Panevėžys d. mun.;2016;12;350;171;179
Panevėžys d. mun.;2016;13;429;232;197
Panevėžys d. mun.;2016;14;389;201;188
Panevėžys d. mun.;2016;15;394;216;178
Panevėžys d. mun.;2016;16;473;250;223
Panevėžys d. mun.;2016;17;478;242;236
Panevėžys d. mun.;2016;18;484;230;254
Panevėžys d. mun.;2016;19;521;265;256
Panevėžys d. mun.;2016;20;497;248;249
Panevėžys d. mun.;2016;21;543;296;247
Panevėžys d. mun.;2016;22;584;301;283
Panevėžys d. mun.;2016;23;617;322;295
Panevėžys d. mun.;2016;24;537;296;241
Panevėžys d. mun.;2016;25;521;280;241
Panevėžys d. mun.;2016;26;440;250;190
Panevėžys d. mun.;2016;27;402;236;166
Panevėžys d. mun.;2016;28;416;244;172
Panevėžys d. mun.;2016;29;357;203;154
Panevėžys d. mun.;2016;30;326;201;125
Panevėžys d. mun.;2016;31;303;189;114
Panevėžys d. mun.;2016;32;305;153;152
Panevėžys d. mun.;2016;33;311;166;145
Panevėžys d. mun.;2016;34;343;187;156
Panevėžys d. mun.;2016;35;308;172;136
Panevėžys d. mun.;2016;36;337;164;173
Panevėžys d. mun.;2016;37;367;199;168
Panevėžys d. mun.;2016;38;413;226;187
Panevėžys d. mun.;2016;39;446;241;205
Panevėžys d. mun.;2016;40;451;219;232
Panevėžys d. mun.;2016;41;483;239;244
Panevėžys d. mun.;2016;42;474;270;204
Panevėžys d. mun.;2016;43;496;251;245
Panevėžys d. mun.;2016;44;518;265;253
Panevėžys d. mun.;2016;45;567;295;272
Panevėžys d. mun.;2016;46;593;292;301
Panevėžys d. mun.;2016;47;599;309;290
Panevėžys d. mun.;2016;48;597;286;311
Panevėžys d. mun.;2016;49;642;332;310
Panevėžys d. mun.;2016;50;604;323;281
Panevėžys d. mun.;2016;51;627;307;320
Panevėžys d. mun.;2016;52;632;313;319
Panevėžys d. mun.;2016;53;666;345;321
Panevėžys d. mun.;2016;54;606;308;298
Panevėžys d. mun.;2016;55;605;319;286
Panevėžys d. mun.;2016;56;644;324;320
Panevėžys d. mun.;2016;57;588;289;299
Panevėžys d. mun.;2016;58;547;260;287
Panevėžys d. mun.;2016;59;508;246;262
Panevėžys d. mun.;2016;60;466;224;242
Panevėžys d. mun.;2016;61;476;233;243
Panevėžys d. mun.;2016;62;447;216;231
Panevėžys d. mun.;2016;63;459;220;239
Panevėžys d. mun.;2016;64;411;217;194
Panevėžys d. mun.;2016;65;421;194;227
Panevėžys d. mun.;2016;66;432;195;237
Panevėžys d. mun.;2016;67;369;157;212
Panevėžys d. mun.;2016;68;340;153;187
Panevėžys d. mun.;2016;69;325;142;183
Panevėžys d. mun.;2016;70;383;168;215
Panevėžys d. mun.;2016;71;322;133;189
Panevėžys d. mun.;2016;72;375;156;219
Panevėžys d. mun.;2016;73;371;138;233
Panevėžys d. mun.;2016;74;362;143;219
Panevėžys d. mun.;2016;75;334;131;203
Panevėžys d. mun.;2016;76;296;102;194
Panevėžys d. mun.;2016;77;313;114;199
Panevėžys d. mun.;2016;78;291;100;191
Panevėžys d. mun.;2016;79;285;86;199
Panevėžys d. mun.;2016;80;239;80;159
Panevėžys d. mun.;2016;81;243;83;160
Panevėžys d. mun.;2016;82;232;64;168
Panevėžys d. mun.;2016;83;204;42;162
Panevėžys d. mun.;2016;84;196;53;143
Panevėžys d. mun.;2016;85;870;196;674
Panevėžys d. mun.;2017;-1;36417;17871;18546
Panevėžys d. mun.;2017;0;340;189;151
Panevėžys d. mun.;2017;1;331;164;167
Panevėžys d. mun.;2017;2;340;175;165
Panevėžys d. mun.;2017;3;336;164;172
Panevėžys d. mun.;2017;4;335;168;167
Panevėžys d. mun.;2017;5;300;176;124
Panevėžys d. mun.;2017;6;285;151;134
Panevėžys d. mun.;2017;7;331;178;153
Panevėžys d. mun.;2017;8;292;154;138
Panevėžys d. mun.;2017;9;321;153;168
Panevėžys d. mun.;2017;10;343;181;162
Panevėžys d. mun.;2017;11;362;208;154
Panevėžys d. mun.;2017;12;363;178;185
Panevėžys d. mun.;2017;13;358;173;185
Panevėžys d. mun.;2017;14;427;233;194
Panevėžys d. mun.;2017;15;388;201;187
Panevėžys d. mun.;2017;16;402;221;181
Panevėžys d. mun.;2017;17;478;253;225
Panevėžys d. mun.;2017;18;483;241;242
Panevėžys d. mun.;2017;19;479;227;252
Panevėžys d. mun.;2017;20;512;263;249
Panevėžys d. mun.;2017;21;498;251;247
Panevėžys d. mun.;2017;22;537;289;248
Panevėžys d. mun.;2017;23;569;299;270
Panevėžys d. mun.;2017;24;590;313;277
Panevėžys d. mun.;2017;25;511;285;226
Panevėžys d. mun.;2017;26;496;268;228
Panevėžys d. mun.;2017;27;423;239;184
Panevėžys d. mun.;2017;28;366;220;146
Panevėžys d. mun.;2017;29;400;235;165
Panevėžys d. mun.;2017;30;323;192;131
Panevėžys d. mun.;2017;31;313;196;117
Panevėžys d. mun.;2017;32;289;182;107
Panevėžys d. mun.;2017;33;292;150;142
Panevėžys d. mun.;2017;34;306;168;138
Panevėžys d. mun.;2017;35;329;182;147
Panevėžys d. mun.;2017;36;318;176;142
Panevėžys d. mun.;2017;37;336;163;173
Panevėžys d. mun.;2017;38;368;203;165
Panevėžys d. mun.;2017;39;419;231;188
Panevėžys d. mun.;2017;40;449;241;208
Panevėžys d. mun.;2017;41;453;219;234
Panevėžys d. mun.;2017;42;490;239;251
Panevėžys d. mun.;2017;43;478;271;207
Panevėžys d. mun.;2017;44;501;260;241
Panevėžys d. mun.;2017;45;515;259;256
Panevėžys d. mun.;2017;46;563;296;267
Panevėžys d. mun.;2017;47;594;293;301
Panevėžys d. mun.;2017;48;592;308;284
Panevėžys d. mun.;2017;49;598;290;308
Panevėžys d. mun.;2017;50;646;340;306
Panevėžys d. mun.;2017;51;608;327;281
Panevėžys d. mun.;2017;52;629;307;322
Panevėžys d. mun.;2017;53;630;306;324
Panevėžys d. mun.;2017;54;670;348;322
Panevėžys d. mun.;2017;55;604;304;300
Panevėžys d. mun.;2017;56;608;318;290
Panevėžys d. mun.;2017;57;643;324;319
Panevėžys d. mun.;2017;58;590;288;302
Panevėžys d. mun.;2017;59;550;261;289
Panevėžys d. mun.;2017;60;515;247;268
Panevėžys d. mun.;2017;61;458;219;239
Panevėžys d. mun.;2017;62;470;229;241
Panevėžys d. mun.;2017;63;443;211;232
Panevėžys d. mun.;2017;64;441;206;235
Panevėžys d. mun.;2017;65;398;212;186
Panevėžys d. mun.;2017;66;415;190;225
Panevėžys d. mun.;2017;67;431;191;240
Panevėžys d. mun.;2017;68;363;155;208
Panevėžys d. mun.;2017;69;328;143;185
Panevėžys d. mun.;2017;70;314;133;181
Panevėžys d. mun.;2017;71;375;162;213
Panevėžys d. mun.;2017;72;310;123;187
Panevėžys d. mun.;2017;73;369;151;218
Panevėžys d. mun.;2017;74;356;127;229
Panevėžys d. mun.;2017;75;346;131;215
Panevėžys d. mun.;2017;76;312;123;189
Panevėžys d. mun.;2017;77;290;96;194
Panevėžys d. mun.;2017;78;297;106;191
Panevėžys d. mun.;2017;79;269;94;175
Panevėžys d. mun.;2017;80;264;78;186
Panevėžys d. mun.;2017;81;226;74;152
Panevėžys d. mun.;2017;82;231;77;154
Panevėžys d. mun.;2017;83;204;53;151
Panevėžys d. mun.;2017;84;187;38;149
Panevėžys d. mun.;2017;85;905;210;695
Panevėžys d. mun.;2018;-1;35734;17513;18221
Panevėžys d. mun.;2018;0;323;162;161
Panevėžys d. mun.;2018;1;332;186;146
Panevėžys d. mun.;2018;2;335;166;169
Panevėžys d. mun.;2018;3;350;175;175
Panevėžys d. mun.;2018;4;345;167;178
Panevėžys d. mun.;2018;5;337;165;172
Panevėžys d. mun.;2018;6;294;170;124
Panevėžys d. mun.;2018;7;280;144;136
Panevėžys d. mun.;2018;8;347;180;167
Panevėžys d. mun.;2018;9;305;159;146
Panevėžys d. mun.;2018;10;321;155;166
Panevėžys d. mun.;2018;11;353;182;171
Panevėžys d. mun.;2018;12;372;212;160
Panevėžys d. mun.;2018;13;361;175;186
Panevėžys d. mun.;2018;14;363;175;188
Panevėžys d. mun.;2018;15;425;230;195
Panevėžys d. mun.;2018;16;387;204;183
Panevėžys d. mun.;2018;17;405;222;183
Panevėžys d. mun.;2018;18;473;249;224
Panevėžys d. mun.;2018;19;462;233;229
Panevėžys d. mun.;2018;20;466;218;248
Panevėžys d. mun.;2018;21;497;259;238
Panevėžys d. mun.;2018;22;459;233;226
Panevėžys d. mun.;2018;23;506;267;239
Panevėžys d. mun.;2018;24;524;281;243
Panevėžys d. mun.;2018;25;545;291;254
Panevėžys d. mun.;2018;26;457;266;191
Panevėžys d. mun.;2018;27;440;251;189
Panevėžys d. mun.;2018;28;380;223;157
Panevėžys d. mun.;2018;29;322;201;121
Panevėžys d. mun.;2018;30;377;225;152
Panevėžys d. mun.;2018;31;326;188;138
Panevėžys d. mun.;2018;32;293;184;109
Panevėžys d. mun.;2018;33;265;174;91
Panevėžys d. mun.;2018;34;288;140;148
Panevėžys d. mun.;2018;35;301;164;137
Panevėžys d. mun.;2018;36;330;181;149
Panevėžys d. mun.;2018;37;317;168;149
Panevėžys d. mun.;2018;38;332;158;174
Panevėžys d. mun.;2018;39;359;197;162
Panevėžys d. mun.;2018;40;402;219;183
Panevėžys d. mun.;2018;41;437;231;206
Panevėžys d. mun.;2018;42;454;218;236
Panevėžys d. mun.;2018;43;478;234;244
Panevėžys d. mun.;2018;44;476;275;201
Panevėžys d. mun.;2018;45;500;256;244
Panevėžys d. mun.;2018;46;505;249;256
Panevėžys d. mun.;2018;47;576;302;274
Panevėžys d. mun.;2018;48;591;288;303
Panevėžys d. mun.;2018;49;582;297;285
Panevėžys d. mun.;2018;50;599;295;304
Panevėžys d. mun.;2018;51;639;335;304
Panevėžys d. mun.;2018;52;606;319;287
Panevėžys d. mun.;2018;53;628;303;325
Panevėžys d. mun.;2018;54;626;303;323
Panevėžys d. mun.;2018;55;666;347;319
Panevėžys d. mun.;2018;56;608;304;304
Panevėžys d. mun.;2018;57;601;315;286
Panevėžys d. mun.;2018;58;637;329;308
Panevėžys d. mun.;2018;59;581;283;298
Panevėžys d. mun.;2018;60;540;253;287
Panevėžys d. mun.;2018;61;519;251;268
Panevėžys d. mun.;2018;62;450;215;235
Panevėžys d. mun.;2018;63;461;223;238
Panevėžys d. mun.;2018;64;435;208;227
Panevėžys d. mun.;2018;65;432;198;234
Panevėžys d. mun.;2018;66;381;206;175
Panevėžys d. mun.;2018;67;401;178;223
Panevėžys d. mun.;2018;68;420;177;243
Panevėžys d. mun.;2018;69;358;151;207
Panevėžys d. mun.;2018;70;320;136;184
Panevėžys d. mun.;2018;71;299;121;178
Panevėžys d. mun.;2018;72;358;146;212
Panevėžys d. mun.;2018;73;307;124;183
Panevėžys d. mun.;2018;74;357;147;210
Panevėžys d. mun.;2018;75;347;122;225
Panevėžys d. mun.;2018;76;332;121;211
Panevėžys d. mun.;2018;77;296;117;179
Panevėžys d. mun.;2018;78;277;93;184
Panevėžys d. mun.;2018;79;280;99;181
Panevėžys d. mun.;2018;80;250;84;166
Panevėžys d. mun.;2018;81;245;70;175
Panevėžys d. mun.;2018;82;207;63;144
Panevėžys d. mun.;2018;83;212;72;140
Panevėžys d. mun.;2018;84;192;49;143
Panevėžys d. mun.;2018;85;912;207;705
Pasvalys d. mun.;2001;-1;34980;16610;18370
Pasvalys d. mun.;2001;0;387;192;195
Pasvalys d. mun.;2001;1;414;221;193
Pasvalys d. mun.;2001;2;400;224;176
Pasvalys d. mun.;2001;3;398;191;207
Pasvalys d. mun.;2001;4;432;211;221
Pasvalys d. mun.;2001;5;444;223;221
Pasvalys d. mun.;2001;6;503;258;245
Pasvalys d. mun.;2001;7;546;282;264
Pasvalys d. mun.;2001;8;623;306;317
Pasvalys d. mun.;2001;9;616;309;307
Pasvalys d. mun.;2001;10;577;308;269
Pasvalys d. mun.;2001;11;578;299;279
Pasvalys d. mun.;2001;12;580;283;297
Pasvalys d. mun.;2001;13;618;311;307
Pasvalys d. mun.;2001;14;592;303;289
Pasvalys d. mun.;2001;15;505;265;240
Pasvalys d. mun.;2001;16;567;284;283
Pasvalys d. mun.;2001;17;517;256;261
Pasvalys d. mun.;2001;18;475;258;217
Pasvalys d. mun.;2001;19;382;218;164
Pasvalys d. mun.;2001;20;377;206;171
Pasvalys d. mun.;2001;21;366;197;169
Pasvalys d. mun.;2001;22;375;190;185
Pasvalys d. mun.;2001;23;425;214;211
Pasvalys d. mun.;2001;24;374;181;193
Pasvalys d. mun.;2001;25;423;228;195
Pasvalys d. mun.;2001;26;423;220;203
Pasvalys d. mun.;2001;27;440;222;218
Pasvalys d. mun.;2001;28;470;246;224
Pasvalys d. mun.;2001;29;460;251;209
Pasvalys d. mun.;2001;30;495;254;241
Pasvalys d. mun.;2001;31;487;245;242
Pasvalys d. mun.;2001;32;509;280;229
Pasvalys d. mun.;2001;33;461;212;249
Pasvalys d. mun.;2001;34;512;262;250
Pasvalys d. mun.;2001;35;473;242;231
Pasvalys d. mun.;2001;36;480;249;231
Pasvalys d. mun.;2001;37;475;264;211
Pasvalys d. mun.;2001;38;519;277;242
Pasvalys d. mun.;2001;39;491;270;221
Pasvalys d. mun.;2001;40;457;247;210
Pasvalys d. mun.;2001;41;507;265;242
Pasvalys d. mun.;2001;42;462;238;224
Pasvalys d. mun.;2001;43;427;212;215
Pasvalys d. mun.;2001;44;394;196;198
Pasvalys d. mun.;2001;45;380;183;197
Pasvalys d. mun.;2001;46;385;197;188
Pasvalys d. mun.;2001;47;387;209;178
Pasvalys d. mun.;2001;48;400;220;180
Pasvalys d. mun.;2001;49;409;192;217
Pasvalys d. mun.;2001;50;383;203;180
Pasvalys d. mun.;2001;51;397;161;236
Pasvalys d. mun.;2001;52;369;181;188
Pasvalys d. mun.;2001;53;311;136;175
Pasvalys d. mun.;2001;54;338;160;178
Pasvalys d. mun.;2001;55;359;170;189
Pasvalys d. mun.;2001;56;339;161;178
Pasvalys d. mun.;2001;57;414;198;216
Pasvalys d. mun.;2001;58;427;185;242
Pasvalys d. mun.;2001;59;446;194;252
Pasvalys d. mun.;2001;60;433;197;236
Pasvalys d. mun.;2001;61;409;166;243
Pasvalys d. mun.;2001;62;419;164;255
Pasvalys d. mun.;2001;63;388;136;252
Pasvalys d. mun.;2001;64;453;213;240
Pasvalys d. mun.;2001;65;387;162;225
Pasvalys d. mun.;2001;66;384;163;221
Pasvalys d. mun.;2001;67;367;141;226
Pasvalys d. mun.;2001;68;380;140;240
Pasvalys d. mun.;2001;69;347;128;219
Pasvalys d. mun.;2001;70;361;139;222
Pasvalys d. mun.;2001;71;324;120;204
Pasvalys d. mun.;2001;72;335;121;214
Pasvalys d. mun.;2001;73;305;96;209
Pasvalys d. mun.;2001;74;280;71;209
Pasvalys d. mun.;2001;75;260;85;175
Pasvalys d. mun.;2001;76;250;76;174
Pasvalys d. mun.;2001;77;279;85;194
Pasvalys d. mun.;2001;78;205;58;147
Pasvalys d. mun.;2001;79;184;50;134
Pasvalys d. mun.;2001;80;163;54;109
Pasvalys d. mun.;2001;81;118;29;89
Pasvalys d. mun.;2001;82;92;19;73
Pasvalys d. mun.;2001;83;90;25;65
Pasvalys d. mun.;2001;84;91;28;63
Pasvalys d. mun.;2001;85;496;124;372
Pasvalys d. mun.;2002;-1;34569;16422;18147
Pasvalys d. mun.;2002;0;380;180;200
Pasvalys d. mun.;2002;1;376;186;190
Pasvalys d. mun.;2002;2;407;218;189
Pasvalys d. mun.;2002;3;395;221;174
Pasvalys d. mun.;2002;4;391;187;204
Pasvalys d. mun.;2002;5;431;212;219
Pasvalys d. mun.;2002;6;439;220;219
Pasvalys d. mun.;2002;7;501;257;244
Pasvalys d. mun.;2002;8;540;279;261
Pasvalys d. mun.;2002;9;623;304;319
Pasvalys d. mun.;2002;10;612;305;307
Pasvalys d. mun.;2002;11;566;301;265
Pasvalys d. mun.;2002;12;574;300;274
Pasvalys d. mun.;2002;13;574;278;296
Pasvalys d. mun.;2002;14;607;304;303
Pasvalys d. mun.;2002;15;578;293;285
Pasvalys d. mun.;2002;16;498;263;235
Pasvalys d. mun.;2002;17;562;281;281
Pasvalys d. mun.;2002;18;507;253;254
Pasvalys d. mun.;2002;19;457;249;208
Pasvalys d. mun.;2002;20;367;208;159
Pasvalys d. mun.;2002;21;364;200;164
Pasvalys d. mun.;2002;22;362;192;170
Pasvalys d. mun.;2002;23;364;183;181
Pasvalys d. mun.;2002;24;414;208;206
Pasvalys d. mun.;2002;25;364;178;186
Pasvalys d. mun.;2002;26;414;224;190
Pasvalys d. mun.;2002;27;414;212;202
Pasvalys d. mun.;2002;28;437;220;217
Pasvalys d. mun.;2002;29;453;238;215
Pasvalys d. mun.;2002;30;442;241;201
Pasvalys d. mun.;2002;31;485;249;236
Pasvalys d. mun.;2002;32;477;238;239
Pasvalys d. mun.;2002;33;500;273;227
Pasvalys d. mun.;2002;34;458;212;246
Pasvalys d. mun.;2002;35;502;256;246
Pasvalys d. mun.;2002;36;470;238;232
Pasvalys d. mun.;2002;37;472;244;228
Pasvalys d. mun.;2002;38;467;256;211
Pasvalys d. mun.;2002;39;507;270;237
Pasvalys d. mun.;2002;40;481;265;216
Pasvalys d. mun.;2002;41;450;243;207
Pasvalys d. mun.;2002;42;495;259;236
Pasvalys d. mun.;2002;43;452;233;219
Pasvalys d. mun.;2002;44;422;209;213
Pasvalys d. mun.;2002;45;388;192;196
Pasvalys d. mun.;2002;46;369;176;193
Pasvalys d. mun.;2002;47;385;199;186
Pasvalys d. mun.;2002;48;381;205;176
Pasvalys d. mun.;2002;49;389;216;173
Pasvalys d. mun.;2002;50;403;188;215
Pasvalys d. mun.;2002;51;374;199;175
Pasvalys d. mun.;2002;52;392;159;233
Pasvalys d. mun.;2002;53;366;180;186
Pasvalys d. mun.;2002;54;300;132;168
Pasvalys d. mun.;2002;55;330;158;172
Pasvalys d. mun.;2002;56;350;164;186
Pasvalys d. mun.;2002;57;333;157;176
Pasvalys d. mun.;2002;58;402;191;211
Pasvalys d. mun.;2002;59;411;176;235
Pasvalys d. mun.;2002;60;442;193;249
Pasvalys d. mun.;2002;61;426;194;232
Pasvalys d. mun.;2002;62;405;165;240
Pasvalys d. mun.;2002;63;416;163;253
Pasvalys d. mun.;2002;64;381;131;250
Pasvalys d. mun.;2002;65;450;212;238
Pasvalys d. mun.;2002;66;375;157;218
Pasvalys d. mun.;2002;67;376;157;219
Pasvalys d. mun.;2002;68;357;137;220
Pasvalys d. mun.;2002;69;367;132;235
Pasvalys d. mun.;2002;70;344;126;218
Pasvalys d. mun.;2002;71;354;136;218
Pasvalys d. mun.;2002;72;315;117;198
Pasvalys d. mun.;2002;73;327;122;205
Pasvalys d. mun.;2002;74;299;93;206
Pasvalys d. mun.;2002;75;278;68;210
Pasvalys d. mun.;2002;76;253;80;173
Pasvalys d. mun.;2002;77;237;71;166
Pasvalys d. mun.;2002;78;263;81;182
Pasvalys d. mun.;2002;79;192;54;138
Pasvalys d. mun.;2002;80;174;48;126
Pasvalys d. mun.;2002;81;152;50;102
Pasvalys d. mun.;2002;82;105;26;79
Pasvalys d. mun.;2002;83;79;15;64
Pasvalys d. mun.;2002;84;80;23;57
Pasvalys d. mun.;2002;85;498;139;359
Pasvalys d. mun.;2003;-1;34211;16257;17954
Pasvalys d. mun.;2003;0;321;179;142
Pasvalys d. mun.;2003;1;374;176;198
Pasvalys d. mun.;2003;2;371;185;186
Pasvalys d. mun.;2003;3;407;219;188
Pasvalys d. mun.;2003;4;389;218;171
Pasvalys d. mun.;2003;5;394;187;207
Pasvalys d. mun.;2003;6;429;211;218
Pasvalys d. mun.;2003;7;437;221;216
Pasvalys d. mun.;2003;8;497;258;239
Pasvalys d. mun.;2003;9;532;275;257
Pasvalys d. mun.;2003;10;616;302;314
Pasvalys d. mun.;2003;11;610;306;304
Pasvalys d. mun.;2003;12;561;298;263
Pasvalys d. mun.;2003;13;565;296;269
Pasvalys d. mun.;2003;14;568;275;293
Pasvalys d. mun.;2003;15;597;299;298
Pasvalys d. mun.;2003;16;571;290;281
Pasvalys d. mun.;2003;17;488;256;232
Pasvalys d. mun.;2003;18;552;276;276
Pasvalys d. mun.;2003;19;494;247;247
Pasvalys d. mun.;2003;20;450;242;208
Pasvalys d. mun.;2003;21;368;210;158
Pasvalys d. mun.;2003;22;369;204;165
Pasvalys d. mun.;2003;23;354;184;170
Pasvalys d. mun.;2003;24;358;180;178
Pasvalys d. mun.;2003;25;409;201;208
Pasvalys d. mun.;2003;26;361;179;182
Pasvalys d. mun.;2003;27;404;219;185
Pasvalys d. mun.;2003;28;408;211;197
Pasvalys d. mun.;2003;29;426;214;212
Pasvalys d. mun.;2003;30;445;235;210
Pasvalys d. mun.;2003;31;432;236;196
Pasvalys d. mun.;2003;32;479;248;231
Pasvalys d. mun.;2003;33;473;237;236
Pasvalys d. mun.;2003;34;487;264;223
Pasvalys d. mun.;2003;35;448;206;242
Pasvalys d. mun.;2003;36;496;254;242
Pasvalys d. mun.;2003;37;464;236;228
Pasvalys d. mun.;2003;38;473;245;228
Pasvalys d. mun.;2003;39;461;251;210
Pasvalys d. mun.;2003;40;504;267;237
Pasvalys d. mun.;2003;41;476;262;214
Pasvalys d. mun.;2003;42;446;241;205
Pasvalys d. mun.;2003;43;492;257;235
Pasvalys d. mun.;2003;44;445;229;216
Pasvalys d. mun.;2003;45;420;210;210
Pasvalys d. mun.;2003;46;378;186;192
Pasvalys d. mun.;2003;47;363;172;191
Pasvalys d. mun.;2003;48;380;194;186
Pasvalys d. mun.;2003;49;376;202;174
Pasvalys d. mun.;2003;50;391;217;174
Pasvalys d. mun.;2003;51;398;186;212
Pasvalys d. mun.;2003;52;366;191;175
Pasvalys d. mun.;2003;53;390;156;234
Pasvalys d. mun.;2003;54;355;174;181
Pasvalys d. mun.;2003;55;298;131;167
Pasvalys d. mun.;2003;56;322;153;169
Pasvalys d. mun.;2003;57;342;161;181
Pasvalys d. mun.;2003;58;330;155;175
Pasvalys d. mun.;2003;59;391;184;207
Pasvalys d. mun.;2003;60;402;171;231
Pasvalys d. mun.;2003;61;432;186;246
Pasvalys d. mun.;2003;62;418;192;226
Pasvalys d. mun.;2003;63;403;163;240
Pasvalys d. mun.;2003;64;402;156;246
Pasvalys d. mun.;2003;65;376;126;250
Pasvalys d. mun.;2003;66;447;211;236
Pasvalys d. mun.;2003;67;375;158;217
Pasvalys d. mun.;2003;68;370;154;216
Pasvalys d. mun.;2003;69;346;129;217
Pasvalys d. mun.;2003;70;363;129;234
Pasvalys d. mun.;2003;71;320;112;208
Pasvalys d. mun.;2003;72;344;129;215
Pasvalys d. mun.;2003;73;306;110;196
Pasvalys d. mun.;2003;74;316;118;198
Pasvalys d. mun.;2003;75;284;81;203
Pasvalys d. mun.;2003;76;264;64;200
Pasvalys d. mun.;2003;77;246;75;171
Pasvalys d. mun.;2003;78;215;62;153
Pasvalys d. mun.;2003;79;244;71;173
Pasvalys d. mun.;2003;80;174;47;127
Pasvalys d. mun.;2003;81;160;40;120
Pasvalys d. mun.;2003;82;139;45;94
Pasvalys d. mun.;2003;83;92;21;71
Pasvalys d. mun.;2003;84;73;12;61
Pasvalys d. mun.;2003;85;499;137;362
Pasvalys d. mun.;2004;-1;33629;15932;17697
Pasvalys d. mun.;2004;0;343;177;166
Pasvalys d. mun.;2004;1;319;179;140
Pasvalys d. mun.;2004;2;367;174;193
Pasvalys d. mun.;2004;3;365;181;184
Pasvalys d. mun.;2004;4;399;215;184
Pasvalys d. mun.;2004;5;380;212;168
Pasvalys d. mun.;2004;6;382;182;200
Pasvalys d. mun.;2004;7;421;205;216
Pasvalys d. mun.;2004;8;433;219;214
Pasvalys d. mun.;2004;9;491;257;234
Pasvalys d. mun.;2004;10;525;272;253
Pasvalys d. mun.;2004;11;605;296;309
Pasvalys d. mun.;2004;12;597;298;299
Pasvalys d. mun.;2004;13;544;291;253
Pasvalys d. mun.;2004;14;556;293;263
Pasvalys d. mun.;2004;15;554;269;285
Pasvalys d. mun.;2004;16;580;291;289
Pasvalys d. mun.;2004;17;557;284;273
Pasvalys d. mun.;2004;18;474;249;225
Pasvalys d. mun.;2004;19;538;269;269
Pasvalys d. mun.;2004;20;483;239;244
Pasvalys d. mun.;2004;21;434;231;203
Pasvalys d. mun.;2004;22;365;207;158
Pasvalys d. mun.;2004;23;357;197;160
Pasvalys d. mun.;2004;24;350;179;171
Pasvalys d. mun.;2004;25;355;178;177
Pasvalys d. mun.;2004;26;404;202;202
Pasvalys d. mun.;2004;27;349;170;179
Pasvalys d. mun.;2004;28;392;209;183
Pasvalys d. mun.;2004;29;385;198;187
Pasvalys d. mun.;2004;30;405;203;202
Pasvalys d. mun.;2004;31;431;228;203
Pasvalys d. mun.;2004;32;419;230;189
Pasvalys d. mun.;2004;33;468;247;221
Pasvalys d. mun.;2004;34;463;234;229
Pasvalys d. mun.;2004;35;480;260;220
Pasvalys d. mun.;2004;36;441;203;238
Pasvalys d. mun.;2004;37;482;250;232
Pasvalys d. mun.;2004;38;452;230;222
Pasvalys d. mun.;2004;39;460;241;219
Pasvalys d. mun.;2004;40;455;249;206
Pasvalys d. mun.;2004;41;491;258;233
Pasvalys d. mun.;2004;42;468;256;212
Pasvalys d. mun.;2004;43;439;237;202
Pasvalys d. mun.;2004;44;483;251;232
Pasvalys d. mun.;2004;45;444;227;217
Pasvalys d. mun.;2004;46;415;207;208
Pasvalys d. mun.;2004;47;371;183;188
Pasvalys d. mun.;2004;48;359;171;188
Pasvalys d. mun.;2004;49;371;188;183
Pasvalys d. mun.;2004;50;370;199;171
Pasvalys d. mun.;2004;51;383;211;172
Pasvalys d. mun.;2004;52;391;182;209
Pasvalys d. mun.;2004;53;362;189;173
Pasvalys d. mun.;2004;54;380;153;227
Pasvalys d. mun.;2004;55;348;170;178
Pasvalys d. mun.;2004;56;293;128;165
Pasvalys d. mun.;2004;57;317;149;168
Pasvalys d. mun.;2004;58;333;155;178
Pasvalys d. mun.;2004;59;325;151;174
Pasvalys d. mun.;2004;60;386;177;209
Pasvalys d. mun.;2004;61;394;164;230
Pasvalys d. mun.;2004;62;426;184;242
Pasvalys d. mun.;2004;63;414;186;228
Pasvalys d. mun.;2004;64;392;153;239
Pasvalys d. mun.;2004;65;392;152;240
Pasvalys d. mun.;2004;66;366;120;246
Pasvalys d. mun.;2004;67;435;200;235
Pasvalys d. mun.;2004;68;360;146;214
Pasvalys d. mun.;2004;69;359;142;217
Pasvalys d. mun.;2004;70;335;125;210
Pasvalys d. mun.;2004;71;351;122;229
Pasvalys d. mun.;2004;72;309;106;203
Pasvalys d. mun.;2004;73;328;116;212
Pasvalys d. mun.;2004;74;294;104;190
Pasvalys d. mun.;2004;75;296;109;187
Pasvalys d. mun.;2004;76;268;74;194
Pasvalys d. mun.;2004;77;246;56;190
Pasvalys d. mun.;2004;78;231;69;162
Pasvalys d. mun.;2004;79;200;54;146
Pasvalys d. mun.;2004;80;231;65;166
Pasvalys d. mun.;2004;81;157;37;120
Pasvalys d. mun.;2004;82;149;33;116
Pasvalys d. mun.;2004;83;126;39;87
Pasvalys d. mun.;2004;84;87;20;67
Pasvalys d. mun.;2004;85;494;116;378
Pasvalys d. mun.;2005;-1;32870;15544;17326
Pasvalys d. mun.;2005;0;275;141;134
Pasvalys d. mun.;2005;1;333;173;160
Pasvalys d. mun.;2005;2;316;177;139
Pasvalys d. mun.;2005;3;364;174;190
Pasvalys d. mun.;2005;4;358;175;183
Pasvalys d. mun.;2005;5;394;213;181
Pasvalys d. mun.;2005;6;375;210;165
Pasvalys d. mun.;2005;7;381;184;197
Pasvalys d. mun.;2005;8;416;201;215
Pasvalys d. mun.;2005;9;428;215;213
Pasvalys d. mun.;2005;10;484;254;230
Pasvalys d. mun.;2005;11;518;267;251
Pasvalys d. mun.;2005;12;598;294;304
Pasvalys d. mun.;2005;13;592;296;296
Pasvalys d. mun.;2005;14;536;285;251
Pasvalys d. mun.;2005;15;543;286;257
Pasvalys d. mun.;2005;16;548;267;281
Pasvalys d. mun.;2005;17;566;283;283
Pasvalys d. mun.;2005;18;542;276;266
Pasvalys d. mun.;2005;19;462;238;224
Pasvalys d. mun.;2005;20;520;262;258
Pasvalys d. mun.;2005;21;469;230;239
Pasvalys d. mun.;2005;22;422;230;192
Pasvalys d. mun.;2005;23;343;198;145
Pasvalys d. mun.;2005;24;343;187;156
Pasvalys d. mun.;2005;25;331;168;163
Pasvalys d. mun.;2005;26;343;170;173
Pasvalys d. mun.;2005;27;377;179;198
Pasvalys d. mun.;2005;28;328;163;165
Pasvalys d. mun.;2005;29;372;207;165
Pasvalys d. mun.;2005;30;363;186;177
Pasvalys d. mun.;2005;31;395;198;197
Pasvalys d. mun.;2005;32;415;215;200
Pasvalys d. mun.;2005;33;410;228;182
Pasvalys d. mun.;2005;34;456;237;219
Pasvalys d. mun.;2005;35;450;230;220
Pasvalys d. mun.;2005;36;463;253;210
Pasvalys d. mun.;2005;37;436;199;237
Pasvalys d. mun.;2005;38;481;244;237
Pasvalys d. mun.;2005;39;444;224;220
Pasvalys d. mun.;2005;40;456;240;216
Pasvalys d. mun.;2005;41;450;247;203
Pasvalys d. mun.;2005;42;478;254;224
Pasvalys d. mun.;2005;43;463;253;210
Pasvalys d. mun.;2005;44;432;231;201
Pasvalys d. mun.;2005;45;476;245;231
Pasvalys d. mun.;2005;46;431;219;212
Pasvalys d. mun.;2005;47;412;203;209
Pasvalys d. mun.;2005;48;365;179;186
Pasvalys d. mun.;2005;49;353;167;186
Pasvalys d. mun.;2005;50;368;184;184
Pasvalys d. mun.;2005;51;363;193;170
Pasvalys d. mun.;2005;52;376;205;171
Pasvalys d. mun.;2005;53;382;175;207
Pasvalys d. mun.;2005;54;352;185;167
Pasvalys d. mun.;2005;55;369;144;225
Pasvalys d. mun.;2005;56;343;166;177
Pasvalys d. mun.;2005;57;288;125;163
Pasvalys d. mun.;2005;58;312;145;167
Pasvalys d. mun.;2005;59;322;148;174
Pasvalys d. mun.;2005;60;316;146;170
Pasvalys d. mun.;2005;61;376;171;205
Pasvalys d. mun.;2005;62;390;162;228
Pasvalys d. mun.;2005;63;415;176;239
Pasvalys d. mun.;2005;64;398;173;225
Pasvalys d. mun.;2005;65;384;146;238
Pasvalys d. mun.;2005;66;387;147;240
Pasvalys d. mun.;2005;67;356;116;240
Pasvalys d. mun.;2005;68;421;190;231
Pasvalys d. mun.;2005;69;342;135;207
Pasvalys d. mun.;2005;70;346;136;210
Pasvalys d. mun.;2005;71;321;117;204
Pasvalys d. mun.;2005;72;339;118;221
Pasvalys d. mun.;2005;73;299;100;199
Pasvalys d. mun.;2005;74;307;106;201
Pasvalys d. mun.;2005;75;278;95;183
Pasvalys d. mun.;2005;76;282;104;178
Pasvalys d. mun.;2005;77;250;66;184
Pasvalys d. mun.;2005;78;232;50;182
Pasvalys d. mun.;2005;79;214;58;156
Pasvalys d. mun.;2005;80;188;50;138
Pasvalys d. mun.;2005;81;199;53;146
Pasvalys d. mun.;2005;82;142;30;112
Pasvalys d. mun.;2005;83;133;29;104
Pasvalys d. mun.;2005;84;120;36;84
Pasvalys d. mun.;2005;85;454;109;345
Pasvalys d. mun.;2006;-1;31898;15016;16882
Pasvalys d. mun.;2006;0;266;135;131
Pasvalys d. mun.;2006;1;271;139;132
Pasvalys d. mun.;2006;2;322;167;155
Pasvalys d. mun.;2006;3;309;173;136
Pasvalys d. mun.;2006;4;359;172;187
Pasvalys d. mun.;2006;5;351;171;180
Pasvalys d. mun.;2006;6;387;210;177
Pasvalys d. mun.;2006;7;373;208;165
Pasvalys d. mun.;2006;8;376;180;196
Pasvalys d. mun.;2006;9;409;197;212
Pasvalys d. mun.;2006;10;424;214;210
Pasvalys d. mun.;2006;11;479;250;229
Pasvalys d. mun.;2006;12;513;264;249
Pasvalys d. mun.;2006;13;581;286;295
Pasvalys d. mun.;2006;14;582;291;291
Pasvalys d. mun.;2006;15;516;273;243
Pasvalys d. mun.;2006;16;524;275;249
Pasvalys d. mun.;2006;17;528;257;271
Pasvalys d. mun.;2006;18;547;271;276
Pasvalys d. mun.;2006;19;514;260;254
Pasvalys d. mun.;2006;20;437;225;212
Pasvalys d. mun.;2006;21;489;247;242
Pasvalys d. mun.;2006;22;436;216;220
Pasvalys d. mun.;2006;23;393;213;180
Pasvalys d. mun.;2006;24;319;188;131
Pasvalys d. mun.;2006;25;318;175;143
Pasvalys d. mun.;2006;26;302;159;143
Pasvalys d. mun.;2006;27;321;157;164
Pasvalys d. mun.;2006;28;355;168;187
Pasvalys d. mun.;2006;29;312;155;157
Pasvalys d. mun.;2006;30;354;191;163
Pasvalys d. mun.;2006;31;353;181;172
Pasvalys d. mun.;2006;32;378;187;191
Pasvalys d. mun.;2006;33;395;203;192
Pasvalys d. mun.;2006;34;397;218;179
Pasvalys d. mun.;2006;35;441;229;212
Pasvalys d. mun.;2006;36;440;221;219
Pasvalys d. mun.;2006;37;449;240;209
Pasvalys d. mun.;2006;38;419;191;228
Pasvalys d. mun.;2006;39;466;237;229
Pasvalys d. mun.;2006;40;435;220;215
Pasvalys d. mun.;2006;41;442;232;210
Pasvalys d. mun.;2006;42;434;236;198
Pasvalys d. mun.;2006;43;465;247;218
Pasvalys d. mun.;2006;44;451;245;206
Pasvalys d. mun.;2006;45;427;228;199
Pasvalys d. mun.;2006;46;463;235;228
Pasvalys d. mun.;2006;47;426;216;210
Pasvalys d. mun.;2006;48;406;198;208
Pasvalys d. mun.;2006;49;362;177;185
Pasvalys d. mun.;2006;50;346;163;183
Pasvalys d. mun.;2006;51;363;180;183
Pasvalys d. mun.;2006;52;353;185;168
Pasvalys d. mun.;2006;53;370;201;169
Pasvalys d. mun.;2006;54;375;172;203
Pasvalys d. mun.;2006;55;338;176;162
Pasvalys d. mun.;2006;56;361;138;223
Pasvalys d. mun.;2006;57;338;161;177
Pasvalys d. mun.;2006;58;285;124;161
Pasvalys d. mun.;2006;59;303;139;164
Pasvalys d. mun.;2006;60;308;141;167
Pasvalys d. mun.;2006;61;307;138;169
Pasvalys d. mun.;2006;62;368;164;204
Pasvalys d. mun.;2006;63;381;158;223
Pasvalys d. mun.;2006;64;402;167;235
Pasvalys d. mun.;2006;65;380;162;218
Pasvalys d. mun.;2006;66;371;138;233
Pasvalys d. mun.;2006;67;368;138;230
Pasvalys d. mun.;2006;68;342;110;232
Pasvalys d. mun.;2006;69;397;176;221
Pasvalys d. mun.;2006;70;333;129;204
Pasvalys d. mun.;2006;71;341;133;208
Pasvalys d. mun.;2006;72;311;112;199
Pasvalys d. mun.;2006;73;322;106;216
Pasvalys d. mun.;2006;74;287;93;194
Pasvalys d. mun.;2006;75;290;94;196
Pasvalys d. mun.;2006;76;264;89;175
Pasvalys d. mun.;2006;77;265;95;170
Pasvalys d. mun.;2006;78;231;59;172
Pasvalys d. mun.;2006;79;220;49;171
Pasvalys d. mun.;2006;80;205;53;152
Pasvalys d. mun.;2006;81;173;45;128
Pasvalys d. mun.;2006;82;182;42;140
Pasvalys d. mun.;2006;83;123;26;97
Pasvalys d. mun.;2006;84;117;24;93
Pasvalys d. mun.;2006;85;462;108;354
Pasvalys d. mun.;2007;-1;31230;14657;16573
Pasvalys d. mun.;2007;0;272;142;130
Pasvalys d. mun.;2007;1;262;133;129
Pasvalys d. mun.;2007;2;267;135;132
Pasvalys d. mun.;2007;3;317;166;151
Pasvalys d. mun.;2007;4;302;168;134
Pasvalys d. mun.;2007;5;354;171;183
Pasvalys d. mun.;2007;6;346;169;177
Pasvalys d. mun.;2007;7;386;209;177
Pasvalys d. mun.;2007;8;366;204;162
Pasvalys d. mun.;2007;9;371;178;193
Pasvalys d. mun.;2007;10;407;195;212
Pasvalys d. mun.;2007;11;420;210;210
Pasvalys d. mun.;2007;12;476;249;227
Pasvalys d. mun.;2007;13;510;262;248
Pasvalys d. mun.;2007;14;575;283;292
Pasvalys d. mun.;2007;15;574;288;286
Pasvalys d. mun.;2007;16;505;265;240
Pasvalys d. mun.;2007;17;517;272;245
Pasvalys d. mun.;2007;18;514;249;265
Pasvalys d. mun.;2007;19;536;267;269
Pasvalys d. mun.;2007;20;494;248;246
Pasvalys d. mun.;2007;21;422;215;207
Pasvalys d. mun.;2007;22;465;236;229
Pasvalys d. mun.;2007;23;416;204;212
Pasvalys d. mun.;2007;24;373;204;169
Pasvalys d. mun.;2007;25;304;179;125
Pasvalys d. mun.;2007;26;306;170;136
Pasvalys d. mun.;2007;27;287;148;139
Pasvalys d. mun.;2007;28;306;150;156
Pasvalys d. mun.;2007;29;345;165;180
Pasvalys d. mun.;2007;30;301;147;154
Pasvalys d. mun.;2007;31;349;186;163
Pasvalys d. mun.;2007;32;345;179;166
Pasvalys d. mun.;2007;33;371;184;187
Pasvalys d. mun.;2007;34;388;197;191
Pasvalys d. mun.;2007;35;384;213;171
Pasvalys d. mun.;2007;36;436;226;210
Pasvalys d. mun.;2007;37;426;215;211
Pasvalys d. mun.;2007;38;447;240;207
Pasvalys d. mun.;2007;39;416;189;227
Pasvalys d. mun.;2007;40;458;230;228
Pasvalys d. mun.;2007;41;425;212;213
Pasvalys d. mun.;2007;42;434;227;207
Pasvalys d. mun.;2007;43;423;229;194
Pasvalys d. mun.;2007;44;453;239;214
Pasvalys d. mun.;2007;45;442;241;201
Pasvalys d. mun.;2007;46;422;224;198
Pasvalys d. mun.;2007;47;453;228;225
Pasvalys d. mun.;2007;48;422;214;208
Pasvalys d. mun.;2007;49;401;195;206
Pasvalys d. mun.;2007;50;350;167;183
Pasvalys d. mun.;2007;51;340;160;180
Pasvalys d. mun.;2007;52;353;176;177
Pasvalys d. mun.;2007;53;340;178;162
Pasvalys d. mun.;2007;54;355;191;164
Pasvalys d. mun.;2007;55;371;168;203
Pasvalys d. mun.;2007;56;327;167;160
Pasvalys d. mun.;2007;57;354;132;222
Pasvalys d. mun.;2007;58;329;157;172
Pasvalys d. mun.;2007;59;279;118;161
Pasvalys d. mun.;2007;60;296;136;160
Pasvalys d. mun.;2007;61;300;137;163
Pasvalys d. mun.;2007;62;298;132;166
Pasvalys d. mun.;2007;63;361;161;200
Pasvalys d. mun.;2007;64;366;148;218
Pasvalys d. mun.;2007;65;389;157;232
Pasvalys d. mun.;2007;66;365;154;211
Pasvalys d. mun.;2007;67;359;130;229
Pasvalys d. mun.;2007;68;352;130;222
Pasvalys d. mun.;2007;69;336;107;229
Pasvalys d. mun.;2007;70;387;169;218
Pasvalys d. mun.;2007;71;326;126;200
Pasvalys d. mun.;2007;72;320;118;202
Pasvalys d. mun.;2007;73;300;105;195
Pasvalys d. mun.;2007;74;305;97;208
Pasvalys d. mun.;2007;75;278;90;188
Pasvalys d. mun.;2007;76;270;84;186
Pasvalys d. mun.;2007;77;249;85;164
Pasvalys d. mun.;2007;78;242;87;155
Pasvalys d. mun.;2007;79;224;57;167
Pasvalys d. mun.;2007;80;205;42;163
Pasvalys d. mun.;2007;81;189;46;143
Pasvalys d. mun.;2007;82;152;37;115
Pasvalys d. mun.;2007;83;163;37;126
Pasvalys d. mun.;2007;84;110;22;88
Pasvalys d. mun.;2007;85;499;100;399
Pasvalys d. mun.;2008;-1;30598;14369;16229
Pasvalys d. mun.;2008;0;267;138;129
Pasvalys d. mun.;2008;1;267;138;129
Pasvalys d. mun.;2008;2;261;133;128
Pasvalys d. mun.;2008;3;264;135;129
Pasvalys d. mun.;2008;4;316;165;151
Pasvalys d. mun.;2008;5;292;165;127
Pasvalys d. mun.;2008;6;352;170;182
Pasvalys d. mun.;2008;7;338;166;172
Pasvalys d. mun.;2008;8;386;210;176
Pasvalys d. mun.;2008;9;367;203;164
Pasvalys d. mun.;2008;10;367;176;191
Pasvalys d. mun.;2008;11;401;191;210
Pasvalys d. mun.;2008;12;415;208;207
Pasvalys d. mun.;2008;13;472;247;225
Pasvalys d. mun.;2008;14;509;262;247
Pasvalys d. mun.;2008;15;569;279;290
Pasvalys d. mun.;2008;16;565;283;282
Pasvalys d. mun.;2008;17;499;263;236
Pasvalys d. mun.;2008;18;510;269;241
Pasvalys d. mun.;2008;19;506;246;260
Pasvalys d. mun.;2008;20;528;263;265
Pasvalys d. mun.;2008;21;480;241;239
Pasvalys d. mun.;2008;22;407;209;198
Pasvalys d. mun.;2008;23;445;227;218
Pasvalys d. mun.;2008;24;397;194;203
Pasvalys d. mun.;2008;25;363;199;164
Pasvalys d. mun.;2008;26;289;171;118
Pasvalys d. mun.;2008;27;292;163;129
Pasvalys d. mun.;2008;28;272;144;128
Pasvalys d. mun.;2008;29;295;147;148
Pasvalys d. mun.;2008;30;326;154;172
Pasvalys d. mun.;2008;31;292;141;151
Pasvalys d. mun.;2008;32;344;183;161
Pasvalys d. mun.;2008;33;330;173;157
Pasvalys d. mun.;2008;34;365;179;186
Pasvalys d. mun.;2008;35;379;191;188
Pasvalys d. mun.;2008;36;383;212;171
Pasvalys d. mun.;2008;37;429;219;210
Pasvalys d. mun.;2008;38;422;212;210
Pasvalys d. mun.;2008;39;438;236;202
Pasvalys d. mun.;2008;40;412;185;227
Pasvalys d. mun.;2008;41;452;227;225
Pasvalys d. mun.;2008;42;417;209;208
Pasvalys d. mun.;2008;43;428;223;205
Pasvalys d. mun.;2008;44;417;225;192
Pasvalys d. mun.;2008;45;448;233;215
Pasvalys d. mun.;2008;46;436;238;198
Pasvalys d. mun.;2008;47;416;220;196
Pasvalys d. mun.;2008;48;448;224;224
Pasvalys d. mun.;2008;49;412;209;203
Pasvalys d. mun.;2008;50;393;191;202
Pasvalys d. mun.;2008;51;340;162;178
Pasvalys d. mun.;2008;52;334;157;177
Pasvalys d. mun.;2008;53;343;168;175
Pasvalys d. mun.;2008;54;334;171;163
Pasvalys d. mun.;2008;55;348;187;161
Pasvalys d. mun.;2008;56;364;163;201
Pasvalys d. mun.;2008;57;320;164;156
Pasvalys d. mun.;2008;58;347;127;220
Pasvalys d. mun.;2008;59;322;153;169
Pasvalys d. mun.;2008;60;271;114;157
Pasvalys d. mun.;2008;61;282;128;154
Pasvalys d. mun.;2008;62;293;133;160
Pasvalys d. mun.;2008;63;292;132;160
Pasvalys d. mun.;2008;64;351;155;196
Pasvalys d. mun.;2008;65;354;141;213
Pasvalys d. mun.;2008;66;371;145;226
Pasvalys d. mun.;2008;67;346;145;201
Pasvalys d. mun.;2008;68;348;127;221
Pasvalys d. mun.;2008;69;332;123;209
Pasvalys d. mun.;2008;70;323;99;224
Pasvalys d. mun.;2008;71;375;162;213
Pasvalys d. mun.;2008;72;314;120;194
Pasvalys d. mun.;2008;73;298;106;192
Pasvalys d. mun.;2008;74;284;97;187
Pasvalys d. mun.;2008;75;297;93;204
Pasvalys d. mun.;2008;76;255;79;176
Pasvalys d. mun.;2008;77;258;79;179
Pasvalys d. mun.;2008;78;238;79;159
Pasvalys d. mun.;2008;79;227;77;150
Pasvalys d. mun.;2008;80;207;51;156
Pasvalys d. mun.;2008;81;190;38;152
Pasvalys d. mun.;2008;82;173;40;133
Pasvalys d. mun.;2008;83;134;31;103
Pasvalys d. mun.;2008;84;143;32;111
Pasvalys d. mun.;2008;85;512;102;410
Pasvalys d. mun.;2009;-1;30004;14130;15874
Pasvalys d. mun.;2009;0;233;131;102
Pasvalys d. mun.;2009;1;265;138;127
Pasvalys d. mun.;2009;2;264;137;127
Pasvalys d. mun.;2009;3;256;134;122
Pasvalys d. mun.;2009;4;265;135;130
Pasvalys d. mun.;2009;5;315;167;148
Pasvalys d. mun.;2009;6;293;165;128
Pasvalys d. mun.;2009;7;343;166;177
Pasvalys d. mun.;2009;8;337;167;170
Pasvalys d. mun.;2009;9;377;206;171
Pasvalys d. mun.;2009;10;363;202;161
Pasvalys d. mun.;2009;11;368;179;189
Pasvalys d. mun.;2009;12;400;191;209
Pasvalys d. mun.;2009;13;412;205;207
Pasvalys d. mun.;2009;14;471;249;222
Pasvalys d. mun.;2009;15;505;261;244
Pasvalys d. mun.;2009;16;568;280;288
Pasvalys d. mun.;2009;17;565;282;283
Pasvalys d. mun.;2009;18;498;263;235
Pasvalys d. mun.;2009;19;506;267;239
Pasvalys d. mun.;2009;20;501;244;257
Pasvalys d. mun.;2009;21;517;261;256
Pasvalys d. mun.;2009;22;469;236;233
Pasvalys d. mun.;2009;23;398;203;195
Pasvalys d. mun.;2009;24;422;221;201
Pasvalys d. mun.;2009;25;375;191;184
Pasvalys d. mun.;2009;26;346;188;158
Pasvalys d. mun.;2009;27;276;162;114
Pasvalys d. mun.;2009;28;287;161;126
Pasvalys d. mun.;2009;29;259;133;126
Pasvalys d. mun.;2009;30;281;142;139
Pasvalys d. mun.;2009;31;322;151;171
Pasvalys d. mun.;2009;32;289;141;148
Pasvalys d. mun.;2009;33;339;181;158
Pasvalys d. mun.;2009;34;324;171;153
Pasvalys d. mun.;2009;35;360;178;182
Pasvalys d. mun.;2009;36;380;191;189
Pasvalys d. mun.;2009;37;378;205;173
Pasvalys d. mun.;2009;38;419;212;207
Pasvalys d. mun.;2009;39;411;206;205
Pasvalys d. mun.;2009;40;437;235;202
Pasvalys d. mun.;2009;41;406;181;225
Pasvalys d. mun.;2009;42;444;222;222
Pasvalys d. mun.;2009;43;415;208;207
Pasvalys d. mun.;2009;44;415;214;201
Pasvalys d. mun.;2009;45;409;217;192
Pasvalys d. mun.;2009;46;446;231;215
Pasvalys d. mun.;2009;47;428;235;193
Pasvalys d. mun.;2009;48;410;214;196
Pasvalys d. mun.;2009;49;442;219;223
Pasvalys d. mun.;2009;50;408;206;202
Pasvalys d. mun.;2009;51;388;187;201
Pasvalys d. mun.;2009;52;334;158;176
Pasvalys d. mun.;2009;53;325;153;172
Pasvalys d. mun.;2009;54;335;164;171
Pasvalys d. mun.;2009;55;326;165;161
Pasvalys d. mun.;2009;56;347;186;161
Pasvalys d. mun.;2009;57;364;162;202
Pasvalys d. mun.;2009;58;309;159;150
Pasvalys d. mun.;2009;59;333;120;213
Pasvalys d. mun.;2009;60;315;148;167
Pasvalys d. mun.;2009;61;262;109;153
Pasvalys d. mun.;2009;62;278;127;151
Pasvalys d. mun.;2009;63;280;124;156
Pasvalys d. mun.;2009;64;286;129;157
Pasvalys d. mun.;2009;65;344;150;194
Pasvalys d. mun.;2009;66;344;134;210
Pasvalys d. mun.;2009;67;355;138;217
Pasvalys d. mun.;2009;68;335;137;198
Pasvalys d. mun.;2009;69;341;123;218
Pasvalys d. mun.;2009;70;322;117;205
Pasvalys d. mun.;2009;71;304;89;215
Pasvalys d. mun.;2009;72;361;152;209
Pasvalys d. mun.;2009;73;296;110;186
Pasvalys d. mun.;2009;74;280;99;181
Pasvalys d. mun.;2009;75;272;90;182
Pasvalys d. mun.;2009;76;283;86;197
Pasvalys d. mun.;2009;77;249;76;173
Pasvalys d. mun.;2009;78;245;75;170
Pasvalys d. mun.;2009;79;218;71;147
Pasvalys d. mun.;2009;80;212;71;141
Pasvalys d. mun.;2009;81;186;45;141
Pasvalys d. mun.;2009;82;172;36;136
Pasvalys d. mun.;2009;83;151;30;121
Pasvalys d. mun.;2009;84;120;26;94
Pasvalys d. mun.;2009;85;515;99;416
Pasvalys d. mun.;2010;-1;29400;13815;15585
Pasvalys d. mun.;2010;0;291;146;145
Pasvalys d. mun.;2010;1;229;127;102
Pasvalys d. mun.;2010;2;257;133;124
Pasvalys d. mun.;2010;3;261;135;126
Pasvalys d. mun.;2010;4;254;132;122
Pasvalys d. mun.;2010;5;261;132;129
Pasvalys d. mun.;2010;6;311;163;148
Pasvalys d. mun.;2010;7;276;154;122
Pasvalys d. mun.;2010;8;338;163;175
Pasvalys d. mun.;2010;9;333;166;167
Pasvalys d. mun.;2010;10;370;201;169
Pasvalys d. mun.;2010;11;357;198;159
Pasvalys d. mun.;2010;12;362;177;185
Pasvalys d. mun.;2010;13;400;191;209
Pasvalys d. mun.;2010;14;407;202;205
Pasvalys d. mun.;2010;15;469;245;224
Pasvalys d. mun.;2010;16;498;258;240
Pasvalys d. mun.;2010;17;567;278;289
Pasvalys d. mun.;2010;18;558;279;279
Pasvalys d. mun.;2010;19;494;259;235
Pasvalys d. mun.;2010;20;499;263;236
Pasvalys d. mun.;2010;21;484;238;246
Pasvalys d. mun.;2010;22;504;254;250
Pasvalys d. mun.;2010;23;455;228;227
Pasvalys d. mun.;2010;24;374;191;183
Pasvalys d. mun.;2010;25;404;211;193
Pasvalys d. mun.;2010;26;348;180;168
Pasvalys d. mun.;2010;27;321;174;147
Pasvalys d. mun.;2010;28;252;147;105
Pasvalys d. mun.;2010;29;277;155;122
Pasvalys d. mun.;2010;30;248;127;121
Pasvalys d. mun.;2010;31;267;138;129
Pasvalys d. mun.;2010;32;309;143;166
Pasvalys d. mun.;2010;33;287;145;142
Pasvalys d. mun.;2010;34;331;178;153
Pasvalys d. mun.;2010;35;310;162;148
Pasvalys d. mun.;2010;36;347;172;175
Pasvalys d. mun.;2010;37;370;188;182
Pasvalys d. mun.;2010;38;366;198;168
Pasvalys d. mun.;2010;39;417;211;206
Pasvalys d. mun.;2010;40;406;204;202
Pasvalys d. mun.;2010;41;433;233;200
Pasvalys d. mun.;2010;42;399;175;224
Pasvalys d. mun.;2010;43;438;216;222
Pasvalys d. mun.;2010;44;408;205;203
Pasvalys d. mun.;2010;45;410;207;203
Pasvalys d. mun.;2010;46;399;212;187
Pasvalys d. mun.;2010;47;437;225;212
Pasvalys d. mun.;2010;48;424;237;187
Pasvalys d. mun.;2010;49;408;212;196
Pasvalys d. mun.;2010;50;429;211;218
Pasvalys d. mun.;2010;51;409;208;201
Pasvalys d. mun.;2010;52;386;186;200
Pasvalys d. mun.;2010;53;326;154;172
Pasvalys d. mun.;2010;54;321;150;171
Pasvalys d. mun.;2010;55;331;161;170
Pasvalys d. mun.;2010;56;319;162;157
Pasvalys d. mun.;2010;57;340;179;161
Pasvalys d. mun.;2010;58;358;158;200
Pasvalys d. mun.;2010;59;306;156;150
Pasvalys d. mun.;2010;60;326;118;208
Pasvalys d. mun.;2010;61;303;140;163
Pasvalys d. mun.;2010;62;258;107;151
Pasvalys d. mun.;2010;63;269;118;151
Pasvalys d. mun.;2010;64;266;115;151
Pasvalys d. mun.;2010;65;281;126;155
Pasvalys d. mun.;2010;66;334;143;191
Pasvalys d. mun.;2010;67;333;126;207
Pasvalys d. mun.;2010;68;339;129;210
Pasvalys d. mun.;2010;69;322;133;189
Pasvalys d. mun.;2010;70;333;117;216
Pasvalys d. mun.;2010;71;311;113;198
Pasvalys d. mun.;2010;72;291;82;209
Pasvalys d. mun.;2010;73;346;141;205
Pasvalys d. mun.;2010;74;290;108;182
Pasvalys d. mun.;2010;75;269;91;178
Pasvalys d. mun.;2010;76;257;82;175
Pasvalys d. mun.;2010;77;266;78;188
Pasvalys d. mun.;2010;78;235;68;167
Pasvalys d. mun.;2010;79;230;66;164
Pasvalys d. mun.;2010;80;204;67;137
Pasvalys d. mun.;2010;81;193;64;129
Pasvalys d. mun.;2010;82;164;35;129
Pasvalys d. mun.;2010;83;154;27;127
Pasvalys d. mun.;2010;84;136;25;111
Pasvalys d. mun.;2010;85;540;103;437
Pasvalys d. mun.;2011;-1;28511;13392;15119
Pasvalys d. mun.;2011;0;220;104;116
Pasvalys d. mun.;2011;1;251;122;129
Pasvalys d. mun.;2011;2;220;120;100
Pasvalys d. mun.;2011;3;235;113;122
Pasvalys d. mun.;2011;4;226;116;110
Pasvalys d. mun.;2011;5;240;119;121
Pasvalys d. mun.;2011;6;242;118;124
Pasvalys d. mun.;2011;7;310;167;143
Pasvalys d. mun.;2011;8;266;151;115
Pasvalys d. mun.;2011;9;334;163;171
Pasvalys d. mun.;2011;10;330;166;164
Pasvalys d. mun.;2011;11;361;199;162
Pasvalys d. mun.;2011;12;345;188;157
Pasvalys d. mun.;2011;13;368;180;188
Pasvalys d. mun.;2011;14;400;191;209
Pasvalys d. mun.;2011;15;400;202;198
Pasvalys d. mun.;2011;16;457;235;222
Pasvalys d. mun.;2011;17;502;259;243
Pasvalys d. mun.;2011;18;554;275;279
Pasvalys d. mun.;2011;19;483;253;230
Pasvalys d. mun.;2011;20;387;215;172
Pasvalys d. mun.;2011;21;390;228;162
Pasvalys d. mun.;2011;22;363;188;175
Pasvalys d. mun.;2011;23;355;191;164
Pasvalys d. mun.;2011;24;328;182;146
Pasvalys d. mun.;2011;25;285;156;129
Pasvalys d. mun.;2011;26;287;154;133
Pasvalys d. mun.;2011;27;241;122;119
Pasvalys d. mun.;2011;28;271;142;129
Pasvalys d. mun.;2011;29;242;128;114
Pasvalys d. mun.;2011;30;247;138;109
Pasvalys d. mun.;2011;31;241;119;122
Pasvalys d. mun.;2011;32;280;138;142
Pasvalys d. mun.;2011;33;330;160;170
Pasvalys d. mun.;2011;34;302;145;157
Pasvalys d. mun.;2011;35;342;178;164
Pasvalys d. mun.;2011;36;359;184;175
Pasvalys d. mun.;2011;37;373;180;193
Pasvalys d. mun.;2011;38;391;194;197
Pasvalys d. mun.;2011;39;394;211;183
Pasvalys d. mun.;2011;40;431;214;217
Pasvalys d. mun.;2011;41;423;211;212
Pasvalys d. mun.;2011;42;460;243;217
Pasvalys d. mun.;2011;43;422;192;230
Pasvalys d. mun.;2011;44;455;227;228
Pasvalys d. mun.;2011;45;429;213;216
Pasvalys d. mun.;2011;46;432;229;203
Pasvalys d. mun.;2011;47;420;228;192
Pasvalys d. mun.;2011;48;473;244;229
Pasvalys d. mun.;2011;49;442;245;197
Pasvalys d. mun.;2011;50;405;210;195
Pasvalys d. mun.;2011;51;450;225;225
Pasvalys d. mun.;2011;52;418;211;207
Pasvalys d. mun.;2011;53;388;187;201
Pasvalys d. mun.;2011;54;344;162;182
Pasvalys d. mun.;2011;55;333;156;177
Pasvalys d. mun.;2011;56;345;165;180
Pasvalys d. mun.;2011;57;328;163;165
Pasvalys d. mun.;2011;58;348;183;165
Pasvalys d. mun.;2011;59;362;152;210
Pasvalys d. mun.;2011;60;324;165;159
Pasvalys d. mun.;2011;61;334;119;215
Pasvalys d. mun.;2011;62;315;144;171
Pasvalys d. mun.;2011;63;269;106;163
Pasvalys d. mun.;2011;64;268;113;155
Pasvalys d. mun.;2011;65;272;111;161
Pasvalys d. mun.;2011;66;279;126;153
Pasvalys d. mun.;2011;67;339;140;199
Pasvalys d. mun.;2011;68;342;127;215
Pasvalys d. mun.;2011;69;345;131;214
Pasvalys d. mun.;2011;70;311;124;187
Pasvalys d. mun.;2011;71;315;106;209
Pasvalys d. mun.;2011;72;299;99;200
Pasvalys d. mun.;2011;73;281;77;204
Pasvalys d. mun.;2011;74;338;135;203
Pasvalys d. mun.;2011;75;269;97;172
Pasvalys d. mun.;2011;76;255;84;171
Pasvalys d. mun.;2011;77;235;74;161
Pasvalys d. mun.;2011;78;243;70;173
Pasvalys d. mun.;2011;79;220;59;161
Pasvalys d. mun.;2011;80;210;57;153
Pasvalys d. mun.;2011;81;178;49;129
Pasvalys d. mun.;2011;82;169;55;114
Pasvalys d. mun.;2011;83;155;34;121
Pasvalys d. mun.;2011;84;130;26;104
Pasvalys d. mun.;2011;85;556;110;446
Pasvalys d. mun.;2012;-1;27752;13028;14724
Pasvalys d. mun.;2012;0;252;127;125
Pasvalys d. mun.;2012;1;217;98;119
Pasvalys d. mun.;2012;2;235;114;121
Pasvalys d. mun.;2012;3;213;114;99
Pasvalys d. mun.;2012;4;226;108;118
Pasvalys d. mun.;2012;5;214;109;105
Pasvalys d. mun.;2012;6;235;115;120
Pasvalys d. mun.;2012;7;237;117;120
Pasvalys d. mun.;2012;8;308;165;143
Pasvalys d. mun.;2012;9;259;149;110
Pasvalys d. mun.;2012;10;326;159;167
Pasvalys d. mun.;2012;11;326;160;166
Pasvalys d. mun.;2012;12;355;195;160
Pasvalys d. mun.;2012;13;341;185;156
Pasvalys d. mun.;2012;14;363;178;185
Pasvalys d. mun.;2012;15;394;189;205
Pasvalys d. mun.;2012;16;398;201;197
Pasvalys d. mun.;2012;17;456;234;222
Pasvalys d. mun.;2012;18;499;259;240
Pasvalys d. mun.;2012;19;537;266;271
Pasvalys d. mun.;2012;20;467;246;221
Pasvalys d. mun.;2012;21;374;205;169
Pasvalys d. mun.;2012;22;378;222;156
Pasvalys d. mun.;2012;23;332;179;153
Pasvalys d. mun.;2012;24;324;177;147
Pasvalys d. mun.;2012;25;301;169;132
Pasvalys d. mun.;2012;26;255;151;104
Pasvalys d. mun.;2012;27;251;131;120
Pasvalys d. mun.;2012;28;215;105;110
Pasvalys d. mun.;2012;29;252;133;119
Pasvalys d. mun.;2012;30;222;117;105
Pasvalys d. mun.;2012;31;237;136;101
Pasvalys d. mun.;2012;32;223;113;110
Pasvalys d. mun.;2012;33;269;129;140
Pasvalys d. mun.;2012;34;314;151;163
Pasvalys d. mun.;2012;35;295;140;155
Pasvalys d. mun.;2012;36;335;177;158
Pasvalys d. mun.;2012;37;345;173;172
Pasvalys d. mun.;2012;38;363;171;192
Pasvalys d. mun.;2012;39;381;187;194
Pasvalys d. mun.;2012;40;384;205;179
Pasvalys d. mun.;2012;41;425;214;211
Pasvalys d. mun.;2012;42;420;206;214
Pasvalys d. mun.;2012;43;454;243;211
Pasvalys d. mun.;2012;44;420;191;229
Pasvalys d. mun.;2012;45;449;226;223
Pasvalys d. mun.;2012;46;432;217;215
Pasvalys d. mun.;2012;47;421;221;200
Pasvalys d. mun.;2012;48;416;224;192
Pasvalys d. mun.;2012;49;468;239;229
Pasvalys d. mun.;2012;50;440;242;198
Pasvalys d. mun.;2012;51;400;208;192
Pasvalys d. mun.;2012;52;444;222;222
Pasvalys d. mun.;2012;53;412;206;206
Pasvalys d. mun.;2012;54;382;184;198
Pasvalys d. mun.;2012;55;342;161;181
Pasvalys d. mun.;2012;56;329;154;175
Pasvalys d. mun.;2012;57;339;159;180
Pasvalys d. mun.;2012;58;326;163;163
Pasvalys d. mun.;2012;59;343;179;164
Pasvalys d. mun.;2012;60;354;145;209
Pasvalys d. mun.;2012;61;323;164;159
Pasvalys d. mun.;2012;62;330;116;214
Pasvalys d. mun.;2012;63;307;139;168
Pasvalys d. mun.;2012;64;257;98;159
Pasvalys d. mun.;2012;65;261;108;153
Pasvalys d. mun.;2012;66;265;107;158
Pasvalys d. mun.;2012;67;272;119;153
Pasvalys d. mun.;2012;68;328;133;195
Pasvalys d. mun.;2012;69;329;120;209
Pasvalys d. mun.;2012;70;329;122;207
Pasvalys d. mun.;2012;71;298;120;178
Pasvalys d. mun.;2012;72;301;98;203
Pasvalys d. mun.;2012;73;290;95;195
Pasvalys d. mun.;2012;74;268;68;200
Pasvalys d. mun.;2012;75;318;126;192
Pasvalys d. mun.;2012;76;261;96;165
Pasvalys d. mun.;2012;77;232;75;157
Pasvalys d. mun.;2012;78;222;67;155
Pasvalys d. mun.;2012;79;226;65;161
Pasvalys d. mun.;2012;80;202;54;148
Pasvalys d. mun.;2012;81;190;48;142
Pasvalys d. mun.;2012;82;164;44;120
Pasvalys d. mun.;2012;83;150;46;104
Pasvalys d. mun.;2012;84;133;29;104
Pasvalys d. mun.;2012;85;572;108;464
Pasvalys d. mun.;2013;-1;27245;12786;14459
Pasvalys d. mun.;2013;0;264;131;133
Pasvalys d. mun.;2013;1;247;124;123
Pasvalys d. mun.;2013;2;203;92;111
Pasvalys d. mun.;2013;3;223;108;115
Pasvalys d. mun.;2013;4;207;113;94
Pasvalys d. mun.;2013;5;226;105;121
Pasvalys d. mun.;2013;6;207;103;104
Pasvalys d. mun.;2013;7;234;113;121
Pasvalys d. mun.;2013;8;228;114;114
Pasvalys d. mun.;2013;9;301;163;138
Pasvalys d. mun.;2013;10;259;149;110
Pasvalys d. mun.;2013;11;323;157;166
Pasvalys d. mun.;2013;12;323;160;163
Pasvalys d. mun.;2013;13;352;192;160
Pasvalys d. mun.;2013;14;340;184;156
Pasvalys d. mun.;2013;15;359;175;184
Pasvalys d. mun.;2013;16;395;191;204
Pasvalys d. mun.;2013;17;395;202;193
Pasvalys d. mun.;2013;18;453;232;221
Pasvalys d. mun.;2013;19;490;255;235
Pasvalys d. mun.;2013;20;530;266;264
Pasvalys d. mun.;2013;21;451;240;211
Pasvalys d. mun.;2013;22;349;194;155
Pasvalys d. mun.;2013;23;367;217;150
Pasvalys d. mun.;2013;24;321;178;143
Pasvalys d. mun.;2013;25;310;170;140
Pasvalys d. mun.;2013;26;276;161;115
Pasvalys d. mun.;2013;27;241;147;94
Pasvalys d. mun.;2013;28;231;124;107
Pasvalys d. mun.;2013;29;207;99;108
Pasvalys d. mun.;2013;30;241;130;111
Pasvalys d. mun.;2013;31;212;113;99
Pasvalys d. mun.;2013;32;227;128;99
Pasvalys d. mun.;2013;33;228;114;114
Pasvalys d. mun.;2013;34;263;126;137
Pasvalys d. mun.;2013;35;310;151;159
Pasvalys d. mun.;2013;36;291;139;152
Pasvalys d. mun.;2013;37;325;172;153
Pasvalys d. mun.;2013;38;344;171;173
Pasvalys d. mun.;2013;39;355;165;190
Pasvalys d. mun.;2013;40;378;183;195
Pasvalys d. mun.;2013;41;382;203;179
Pasvalys d. mun.;2013;42;425;213;212
Pasvalys d. mun.;2013;43;418;206;212
Pasvalys d. mun.;2013;44;451;238;213
Pasvalys d. mun.;2013;45;414;186;228
Pasvalys d. mun.;2013;46;448;222;226
Pasvalys d. mun.;2013;47;421;210;211
Pasvalys d. mun.;2013;48;420;221;199
Pasvalys d. mun.;2013;49;414;221;193
Pasvalys d. mun.;2013;50;466;238;228
Pasvalys d. mun.;2013;51;433;239;194
Pasvalys d. mun.;2013;52;397;206;191
Pasvalys d. mun.;2013;53;442;221;221
Pasvalys d. mun.;2013;54;405;203;202
Pasvalys d. mun.;2013;55;379;182;197
Pasvalys d. mun.;2013;56;335;156;179
Pasvalys d. mun.;2013;57;326;152;174
Pasvalys d. mun.;2013;58;333;151;182
Pasvalys d. mun.;2013;59;324;161;163
Pasvalys d. mun.;2013;60;338;176;162
Pasvalys d. mun.;2013;61;343;136;207
Pasvalys d. mun.;2013;62;317;158;159
Pasvalys d. mun.;2013;63;323;111;212
Pasvalys d. mun.;2013;64;307;139;168
Pasvalys d. mun.;2013;65;249;92;157
Pasvalys d. mun.;2013;66;256;104;152
Pasvalys d. mun.;2013;67;259;101;158
Pasvalys d. mun.;2013;68;265;114;151
Pasvalys d. mun.;2013;69;319;128;191
Pasvalys d. mun.;2013;70;322;115;207
Pasvalys d. mun.;2013;71;319;116;203
Pasvalys d. mun.;2013;72;282;108;174
Pasvalys d. mun.;2013;73;287;91;196
Pasvalys d. mun.;2013;74;273;85;188
Pasvalys d. mun.;2013;75;254;62;192
Pasvalys d. mun.;2013;76;302;118;184
Pasvalys d. mun.;2013;77;251;90;161
Pasvalys d. mun.;2013;78;224;70;154
Pasvalys d. mun.;2013;79;201;57;144
Pasvalys d. mun.;2013;80;211;61;150
Pasvalys d. mun.;2013;81;193;53;140
Pasvalys d. mun.;2013;82;169;43;126
Pasvalys d. mun.;2013;83;148;37;111
Pasvalys d. mun.;2013;84;124;36;88
Pasvalys d. mun.;2013;85;590;105;485
Pasvalys d. mun.;2014;-1;26653;12543;14110
Pasvalys d. mun.;2014;0;249;124;125
Pasvalys d. mun.;2014;1;261;127;134
Pasvalys d. mun.;2014;2;233;117;116
Pasvalys d. mun.;2014;3;205;93;112
Pasvalys d. mun.;2014;4;211;104;107
Pasvalys d. mun.;2014;5;196;107;89
Pasvalys d. mun.;2014;6;213;99;114
Pasvalys d. mun.;2014;7;199;98;101
Pasvalys d. mun.;2014;8;230;111;119
Pasvalys d. mun.;2014;9;227;114;113
Pasvalys d. mun.;2014;10;296;158;138
Pasvalys d. mun.;2014;11;258;146;112
Pasvalys d. mun.;2014;12;315;154;161
Pasvalys d. mun.;2014;13;316;155;161
Pasvalys d. mun.;2014;14;345;189;156
Pasvalys d. mun.;2014;15;339;187;152
Pasvalys d. mun.;2014;16;350;170;180
Pasvalys d. mun.;2014;17;393;188;205
Pasvalys d. mun.;2014;18;383;198;185
Pasvalys d. mun.;2014;19;438;226;212
Pasvalys d. mun.;2014;20;477;251;226
Pasvalys d. mun.;2014;21;510;256;254
Pasvalys d. mun.;2014;22;441;238;203
Pasvalys d. mun.;2014;23;326;191;135
Pasvalys d. mun.;2014;24;344;210;134
Pasvalys d. mun.;2014;25;299;168;131
Pasvalys d. mun.;2014;26;291;167;124
Pasvalys d. mun.;2014;27;254;156;98
Pasvalys d. mun.;2014;28;238;149;89
Pasvalys d. mun.;2014;29;206;110;96
Pasvalys d. mun.;2014;30;191;90;101
Pasvalys d. mun.;2014;31;225;121;104
Pasvalys d. mun.;2014;32;207;107;100
Pasvalys d. mun.;2014;33;226;128;98
Pasvalys d. mun.;2014;34;213;107;106
Pasvalys d. mun.;2014;35;258;121;137
Pasvalys d. mun.;2014;36;303;147;156
Pasvalys d. mun.;2014;37;284;135;149
Pasvalys d. mun.;2014;38;314;166;148
Pasvalys d. mun.;2014;39;329;165;164
Pasvalys d. mun.;2014;40;347;164;183
Pasvalys d. mun.;2014;41;375;180;195
Pasvalys d. mun.;2014;42;375;198;177
Pasvalys d. mun.;2014;43;431;216;215
Pasvalys d. mun.;2014;44;414;203;211
Pasvalys d. mun.;2014;45;441;231;210
Pasvalys d. mun.;2014;46;413;188;225
Pasvalys d. mun.;2014;47;449;222;227
Pasvalys d. mun.;2014;48;417;203;214
Pasvalys d. mun.;2014;49;417;218;199
Pasvalys d. mun.;2014;50;410;217;193
Pasvalys d. mun.;2014;51;464;239;225
Pasvalys d. mun.;2014;52;427;236;191
Pasvalys d. mun.;2014;53;393;204;189
Pasvalys d. mun.;2014;54;442;221;221
Pasvalys d. mun.;2014;55;399;199;200
Pasvalys d. mun.;2014;56;374;180;194
Pasvalys d. mun.;2014;57;328;153;175
Pasvalys d. mun.;2014;58;321;149;172
Pasvalys d. mun.;2014;59;328;149;179
Pasvalys d. mun.;2014;60;312;153;159
Pasvalys d. mun.;2014;61;331;170;161
Pasvalys d. mun.;2014;62;337;132;205
Pasvalys d. mun.;2014;63;311;156;155
Pasvalys d. mun.;2014;64;319;110;209
Pasvalys d. mun.;2014;65;303;136;167
Pasvalys d. mun.;2014;66;244;89;155
Pasvalys d. mun.;2014;67;243;95;148
Pasvalys d. mun.;2014;68;255;99;156
Pasvalys d. mun.;2014;69;258;108;150
Pasvalys d. mun.;2014;70;312;119;193
Pasvalys d. mun.;2014;71;311;110;201
Pasvalys d. mun.;2014;72;305;113;192
Pasvalys d. mun.;2014;73;273;104;169
Pasvalys d. mun.;2014;74;276;89;187
Pasvalys d. mun.;2014;75;261;79;182
Pasvalys d. mun.;2014;76;242;58;184
Pasvalys d. mun.;2014;77;287;110;177
Pasvalys d. mun.;2014;78;232;80;152
Pasvalys d. mun.;2014;79;215;66;149
Pasvalys d. mun.;2014;80;187;50;137
Pasvalys d. mun.;2014;81;196;58;138
Pasvalys d. mun.;2014;82;182;48;134
Pasvalys d. mun.;2014;83;161;40;121
Pasvalys d. mun.;2014;84;134;30;104
Pasvalys d. mun.;2014;85;608;123;485
Pasvalys d. mun.;2015;-1;26213;12338;13875
Pasvalys d. mun.;2015;0;253;131;122
Pasvalys d. mun.;2015;1;246;121;125
Pasvalys d. mun.;2015;2;252;124;128
Pasvalys d. mun.;2015;3;228;115;113
Pasvalys d. mun.;2015;4;197;88;109
Pasvalys d. mun.;2015;5;213;104;109
Pasvalys d. mun.;2015;6;192;107;85
Pasvalys d. mun.;2015;7;212;97;115
Pasvalys d. mun.;2015;8;195;96;99
Pasvalys d. mun.;2015;9;230;111;119
Pasvalys d. mun.;2015;10;220;111;109
Pasvalys d. mun.;2015;11;293;154;139
Pasvalys d. mun.;2015;12;261;149;112
Pasvalys d. mun.;2015;13;312;152;160
Pasvalys d. mun.;2015;14;313;155;158
Pasvalys d. mun.;2015;15;345;188;157
Pasvalys d. mun.;2015;16;337;186;151
Pasvalys d. mun.;2015;17;341;164;177
Pasvalys d. mun.;2015;18;387;187;200
Pasvalys d. mun.;2015;19;373;195;178
Pasvalys d. mun.;2015;20;431;223;208
Pasvalys d. mun.;2015;21;476;248;228
Pasvalys d. mun.;2015;22;510;258;252
Pasvalys d. mun.;2015;23;420;226;194
Pasvalys d. mun.;2015;24;310;185;125
Pasvalys d. mun.;2015;25;333;209;124
Pasvalys d. mun.;2015;26;285;163;122
Pasvalys d. mun.;2015;27;256;148;108
Pasvalys d. mun.;2015;28;242;149;93
Pasvalys d. mun.;2015;29;233;149;84
Pasvalys d. mun.;2015;30;197;106;91
Pasvalys d. mun.;2015;31;182;88;94
Pasvalys d. mun.;2015;32;219;118;101
Pasvalys d. mun.;2015;33;204;106;98
Pasvalys d. mun.;2015;34;218;120;98
Pasvalys d. mun.;2015;35;211;110;101
Pasvalys d. mun.;2015;36;248;113;135
Pasvalys d. mun.;2015;37;296;143;153
Pasvalys d. mun.;2015;38;280;135;145
Pasvalys d. mun.;2015;39;311;163;148
Pasvalys d. mun.;2015;40;325;163;162
Pasvalys d. mun.;2015;41;341;159;182
Pasvalys d. mun.;2015;42;370;178;192
Pasvalys d. mun.;2015;43;370;195;175
Pasvalys d. mun.;2015;44;429;214;215
Pasvalys d. mun.;2015;45;411;201;210
Pasvalys d. mun.;2015;46;443;228;215
Pasvalys d. mun.;2015;47;407;183;224
Pasvalys d. mun.;2015;48;445;220;225
Pasvalys d. mun.;2015;49;416;200;216
Pasvalys d. mun.;2015;50;405;211;194
Pasvalys d. mun.;2015;51;402;210;192
Pasvalys d. mun.;2015;52;458;236;222
Pasvalys d. mun.;2015;53;417;230;187
Pasvalys d. mun.;2015;54;393;202;191
Pasvalys d. mun.;2015;55;441;219;222
Pasvalys d. mun.;2015;56;396;198;198
Pasvalys d. mun.;2015;57;370;177;193
Pasvalys d. mun.;2015;58;318;148;170
Pasvalys d. mun.;2015;59;320;147;173
Pasvalys d. mun.;2015;60;325;149;176
Pasvalys d. mun.;2015;61;309;152;157
Pasvalys d. mun.;2015;62;323;165;158
Pasvalys d. mun.;2015;63;331;126;205
Pasvalys d. mun.;2015;64;299;149;150
Pasvalys d. mun.;2015;65;314;105;209
Pasvalys d. mun.;2015;66;295;134;161
Pasvalys d. mun.;2015;67;236;87;149
Pasvalys d. mun.;2015;68;236;90;146
Pasvalys d. mun.;2015;69;247;94;153
Pasvalys d. mun.;2015;70;246;103;143
Pasvalys d. mun.;2015;71;298;111;187
Pasvalys d. mun.;2015;72;301;104;197
Pasvalys d. mun.;2015;73;298;107;191
Pasvalys d. mun.;2015;74;265;97;168
Pasvalys d. mun.;2015;75;265;81;184
Pasvalys d. mun.;2015;76;254;75;179
Pasvalys d. mun.;2015;77;233;57;176
Pasvalys d. mun.;2015;78;276;105;171
Pasvalys d. mun.;2015;79;217;71;146
Pasvalys d. mun.;2015;80;203;58;145
Pasvalys d. mun.;2015;81;180;47;133
Pasvalys d. mun.;2015;82;181;55;126
Pasvalys d. mun.;2015;83;166;43;123
Pasvalys d. mun.;2015;84;146;34;112
Pasvalys d. mun.;2015;85;630;125;505
Pasvalys d. mun.;2016;-1;25601;12077;13524
Pasvalys d. mun.;2016;0;285;154;131
Pasvalys d. mun.;2016;1;257;136;121
Pasvalys d. mun.;2016;2;232;116;116
Pasvalys d. mun.;2016;3;245;120;125
Pasvalys d. mun.;2016;4;228;116;112
Pasvalys d. mun.;2016;5;193;87;106
Pasvalys d. mun.;2016;6;215;102;113
Pasvalys d. mun.;2016;7;190;105;85
Pasvalys d. mun.;2016;8;213;97;116
Pasvalys d. mun.;2016;9;192;96;96
Pasvalys d. mun.;2016;10;228;108;120
Pasvalys d. mun.;2016;11;215;109;106
Pasvalys d. mun.;2016;12;294;154;140
Pasvalys d. mun.;2016;13;259;148;111
Pasvalys d. mun.;2016;14;304;150;154
Pasvalys d. mun.;2016;15;312;155;157
Pasvalys d. mun.;2016;16;341;186;155
Pasvalys d. mun.;2016;17;336;184;152
Pasvalys d. mun.;2016;18;339;163;176
Pasvalys d. mun.;2016;19;377;182;195
Pasvalys d. mun.;2016;20;363;192;171
Pasvalys d. mun.;2016;21;417;215;202
Pasvalys d. mun.;2016;22;450;237;213
Pasvalys d. mun.;2016;23;487;246;241
Pasvalys d. mun.;2016;24;393;213;180
Pasvalys d. mun.;2016;25;278;170;108
Pasvalys d. mun.;2016;26;308;198;110
Pasvalys d. mun.;2016;27;274;159;115
Pasvalys d. mun.;2016;28;239;138;101
Pasvalys d. mun.;2016;29;223;143;80
Pasvalys d. mun.;2016;30;217;136;81
Pasvalys d. mun.;2016;31;191;104;87
Pasvalys d. mun.;2016;32;177;85;92
Pasvalys d. mun.;2016;33;201;108;93
Pasvalys d. mun.;2016;34;201;104;97
Pasvalys d. mun.;2016;35;196;105;91
Pasvalys d. mun.;2016;36;212;109;103
Pasvalys d. mun.;2016;37;239;108;131
Pasvalys d. mun.;2016;38;289;140;149
Pasvalys d. mun.;2016;39;277;136;141
Pasvalys d. mun.;2016;40;309;161;148
Pasvalys d. mun.;2016;41;326;165;161
Pasvalys d. mun.;2016;42;333;155;178
Pasvalys d. mun.;2016;43;356;171;185
Pasvalys d. mun.;2016;44;369;197;172
Pasvalys d. mun.;2016;45;426;214;212
Pasvalys d. mun.;2016;46;406;200;206
Pasvalys d. mun.;2016;47;438;225;213
Pasvalys d. mun.;2016;48;399;177;222
Pasvalys d. mun.;2016;49;441;218;223
Pasvalys d. mun.;2016;50;416;201;215
Pasvalys d. mun.;2016;51;400;206;194
Pasvalys d. mun.;2016;52;400;209;191
Pasvalys d. mun.;2016;53;449;230;219
Pasvalys d. mun.;2016;54;407;223;184
Pasvalys d. mun.;2016;55;386;195;191
Pasvalys d. mun.;2016;56;429;212;217
Pasvalys d. mun.;2016;57;390;194;196
Pasvalys d. mun.;2016;58;358;167;191
Pasvalys d. mun.;2016;59;312;145;167
Pasvalys d. mun.;2016;60;312;142;170
Pasvalys d. mun.;2016;61;318;144;174
Pasvalys d. mun.;2016;62;298;145;153
Pasvalys d. mun.;2016;63;308;155;153
Pasvalys d. mun.;2016;64;323;121;202
Pasvalys d. mun.;2016;65;285;141;144
Pasvalys d. mun.;2016;66;307;101;206
Pasvalys d. mun.;2016;67;287;130;157
Pasvalys d. mun.;2016;68;230;84;146
Pasvalys d. mun.;2016;69;233;89;144
Pasvalys d. mun.;2016;70;236;87;149
Pasvalys d. mun.;2016;71;239;98;141
Pasvalys d. mun.;2016;72;290;107;183
Pasvalys d. mun.;2016;73;293;100;193
Pasvalys d. mun.;2016;74;282;102;180
Pasvalys d. mun.;2016;75;250;89;161
Pasvalys d. mun.;2016;76;251;75;176
Pasvalys d. mun.;2016;77;242;70;172
Pasvalys d. mun.;2016;78;219;52;167
Pasvalys d. mun.;2016;79;257;97;160
Pasvalys d. mun.;2016;80;202;60;142
Pasvalys d. mun.;2016;81;191;53;138
Pasvalys d. mun.;2016;82;164;45;119
Pasvalys d. mun.;2016;83;164;51;113
Pasvalys d. mun.;2016;84;146;35;111
Pasvalys d. mun.;2016;85;637;125;512
Pasvalys d. mun.;2017;-1;24796;11700;13096
Pasvalys d. mun.;2017;0;258;134;124
Pasvalys d. mun.;2017;1;270;147;123
Pasvalys d. mun.;2017;2;246;129;117
Pasvalys d. mun.;2017;3;229;114;115
Pasvalys d. mun.;2017;4;235;115;120
Pasvalys d. mun.;2017;5;235;114;121
Pasvalys d. mun.;2017;6;195;91;104
Pasvalys d. mun.;2017;7;211;101;110
Pasvalys d. mun.;2017;8;186;104;82
Pasvalys d. mun.;2017;9;210;94;116
Pasvalys d. mun.;2017;10;195;96;99
Pasvalys d. mun.;2017;11;221;107;114
Pasvalys d. mun.;2017;12;214;107;107
Pasvalys d. mun.;2017;13;290;152;138
Pasvalys d. mun.;2017;14;255;141;114
Pasvalys d. mun.;2017;15;304;150;154
Pasvalys d. mun.;2017;16;307;152;155
Pasvalys d. mun.;2017;17;335;180;155
Pasvalys d. mun.;2017;18;332;184;148
Pasvalys d. mun.;2017;19;327;161;166
Pasvalys d. mun.;2017;20;364;179;185
Pasvalys d. mun.;2017;21;352;187;165
Pasvalys d. mun.;2017;22;398;207;191
Pasvalys d. mun.;2017;23;410;213;197
Pasvalys d. mun.;2017;24;456;234;222
Pasvalys d. mun.;2017;25;349;200;149
Pasvalys d. mun.;2017;26;250;151;99
Pasvalys d. mun.;2017;27;276;181;95
Pasvalys d. mun.;2017;28;255;148;107
Pasvalys d. mun.;2017;29;201;119;82
Pasvalys d. mun.;2017;30;191;128;63
Pasvalys d. mun.;2017;31;186;120;66
Pasvalys d. mun.;2017;32;171;92;79
Pasvalys d. mun.;2017;33;164;75;89
Pasvalys d. mun.;2017;34;179;94;85
Pasvalys d. mun.;2017;35;191;96;95
Pasvalys d. mun.;2017;36;179;96;83
Pasvalys d. mun.;2017;37;201;103;98
Pasvalys d. mun.;2017;38;224;100;124
Pasvalys d. mun.;2017;39;279;135;144
Pasvalys d. mun.;2017;40;272;132;140
Pasvalys d. mun.;2017;41;304;157;147
Pasvalys d. mun.;2017;42;322;163;159
Pasvalys d. mun.;2017;43;326;151;175
Pasvalys d. mun.;2017;44;345;168;177
Pasvalys d. mun.;2017;45;354;190;164
Pasvalys d. mun.;2017;46;423;211;212
Pasvalys d. mun.;2017;47;401;200;201
Pasvalys d. mun.;2017;48;433;220;213
Pasvalys d. mun.;2017;49;386;170;216
Pasvalys d. mun.;2017;50;430;214;216
Pasvalys d. mun.;2017;51;407;194;213
Pasvalys d. mun.;2017;52;397;206;191
Pasvalys d. mun.;2017;53;390;203;187
Pasvalys d. mun.;2017;54;449;230;219
Pasvalys d. mun.;2017;55;399;218;181
Pasvalys d. mun.;2017;56;378;192;186
Pasvalys d. mun.;2017;57;428;211;217
Pasvalys d. mun.;2017;58;381;187;194
Pasvalys d. mun.;2017;59;357;165;192
Pasvalys d. mun.;2017;60;305;141;164
Pasvalys d. mun.;2017;61;307;140;167
Pasvalys d. mun.;2017;62;310;141;169
Pasvalys d. mun.;2017;63;291;141;150
Pasvalys d. mun.;2017;64;294;147;147
Pasvalys d. mun.;2017;65;316;119;197
Pasvalys d. mun.;2017;66;278;136;142
Pasvalys d. mun.;2017;67;298;95;203
Pasvalys d. mun.;2017;68;278;123;155
Pasvalys d. mun.;2017;69;226;83;143
Pasvalys d. mun.;2017;70;225;86;139
Pasvalys d. mun.;2017;71;226;81;145
Pasvalys d. mun.;2017;72;234;94;140
Pasvalys d. mun.;2017;73;277;100;177
Pasvalys d. mun.;2017;74;278;91;187
Pasvalys d. mun.;2017;75;274;99;175
Pasvalys d. mun.;2017;76;237;80;157
Pasvalys d. mun.;2017;77;245;75;170
Pasvalys d. mun.;2017;78;230;64;166
Pasvalys d. mun.;2017;79;202;49;153
Pasvalys d. mun.;2017;80;231;82;149
Pasvalys d. mun.;2017;81;183;52;131
Pasvalys d. mun.;2017;82;183;46;137
Pasvalys d. mun.;2017;83;149;38;111
Pasvalys d. mun.;2017;84;150;48;102
Pasvalys d. mun.;2017;85;656;136;520
Pasvalys d. mun.;2018;-1;23967;11293;12674
Pasvalys d. mun.;2018;0;196;99;97
Pasvalys d. mun.;2018;1;247;131;116
Pasvalys d. mun.;2018;2;254;136;118
Pasvalys d. mun.;2018;3;247;129;118
Pasvalys d. mun.;2018;4;229;114;115
Pasvalys d. mun.;2018;5;235;116;119
Pasvalys d. mun.;2018;6;227;112;115
Pasvalys d. mun.;2018;7;192;89;103
Pasvalys d. mun.;2018;8;208;104;104
Pasvalys d. mun.;2018;9;183;101;82
Pasvalys d. mun.;2018;10;205;91;114
Pasvalys d. mun.;2018;11;195;97;98
Pasvalys d. mun.;2018;12;217;106;111
Pasvalys d. mun.;2018;13;210;106;104
Pasvalys d. mun.;2018;14;286;151;135
Pasvalys d. mun.;2018;15;252;137;115
Pasvalys d. mun.;2018;16;306;151;155
Pasvalys d. mun.;2018;17;305;151;154
Pasvalys d. mun.;2018;18;327;176;151
Pasvalys d. mun.;2018;19;305;171;134
Pasvalys d. mun.;2018;20;304;146;158
Pasvalys d. mun.;2018;21;340;172;168
Pasvalys d. mun.;2018;22;329;172;157
Pasvalys d. mun.;2018;23;351;184;167
Pasvalys d. mun.;2018;24;373;196;177
Pasvalys d. mun.;2018;25;424;223;201
Pasvalys d. mun.;2018;26;302;174;128
Pasvalys d. mun.;2018;27;219;134;85
Pasvalys d. mun.;2018;28;241;160;81
Pasvalys d. mun.;2018;29;220;131;89
Pasvalys d. mun.;2018;30;176;103;73
Pasvalys d. mun.;2018;31;164;113;51
Pasvalys d. mun.;2018;32;176;116;60
Pasvalys d. mun.;2018;33;168;89;79
Pasvalys d. mun.;2018;34;147;70;77
Pasvalys d. mun.;2018;35;166;89;77
Pasvalys d. mun.;2018;36;187;94;93
Pasvalys d. mun.;2018;37;172;91;81
Pasvalys d. mun.;2018;38;181;88;93
Pasvalys d. mun.;2018;39;219;97;122
Pasvalys d. mun.;2018;40;275;135;140
Pasvalys d. mun.;2018;41;274;133;141
Pasvalys d. mun.;2018;42;298;153;145
Pasvalys d. mun.;2018;43;319;160;159
Pasvalys d. mun.;2018;44;324;151;173
Pasvalys d. mun.;2018;45;340;166;174
Pasvalys d. mun.;2018;46;347;186;161
Pasvalys d. mun.;2018;47;415;203;212
Pasvalys d. mun.;2018;48;396;200;196
Pasvalys d. mun.;2018;49;423;212;211
Pasvalys d. mun.;2018;50;382;165;217
Pasvalys d. mun.;2018;51;426;209;217
Pasvalys d. mun.;2018;52;403;191;212
Pasvalys d. mun.;2018;53;393;204;189
Pasvalys d. mun.;2018;54;389;203;186
Pasvalys d. mun.;2018;55;446;228;218
Pasvalys d. mun.;2018;56;393;210;183
Pasvalys d. mun.;2018;57;371;184;187
Pasvalys d. mun.;2018;58;420;207;213
Pasvalys d. mun.;2018;59;375;180;195
Pasvalys d. mun.;2018;60;353;160;193
Pasvalys d. mun.;2018;61;297;136;161
Pasvalys d. mun.;2018;62;302;136;166
Pasvalys d. mun.;2018;63;303;140;163
Pasvalys d. mun.;2018;64;286;136;150
Pasvalys d. mun.;2018;65;287;142;145
Pasvalys d. mun.;2018;66;308;116;192
Pasvalys d. mun.;2018;67;272;132;140
Pasvalys d. mun.;2018;68;292;93;199
Pasvalys d. mun.;2018;69;271;119;152
Pasvalys d. mun.;2018;70;226;81;145
Pasvalys d. mun.;2018;71;215;79;136
Pasvalys d. mun.;2018;72;218;77;141
Pasvalys d. mun.;2018;73;220;87;133
Pasvalys d. mun.;2018;74;267;95;172
Pasvalys d. mun.;2018;75;268;85;183
Pasvalys d. mun.;2018;76;267;98;169
Pasvalys d. mun.;2018;77;227;73;154
Pasvalys d. mun.;2018;78;227;71;156
Pasvalys d. mun.;2018;79;222;61;161
Pasvalys d. mun.;2018;80;194;45;149
Pasvalys d. mun.;2018;81;210;68;142
Pasvalys d. mun.;2018;82;159;43;116
Pasvalys d. mun.;2018;83;172;42;130
Pasvalys d. mun.;2018;84;138;37;101
Pasvalys d. mun.;2018;85;672;151;521
Plungė d. mun.;2001;-1;44233;21043;23190
Plungė d. mun.;2001;0;449;250;199
Plungė d. mun.;2001;1;537;280;257
Plungė d. mun.;2001;2;562;278;284
Plungė d. mun.;2001;3;581;299;282
Plungė d. mun.;2001;4;572;301;271
Plungė d. mun.;2001;5;597;298;299
Plungė d. mun.;2001;6;667;334;333
Plungė d. mun.;2001;7;776;405;371
Plungė d. mun.;2001;8;847;417;430
Plungė d. mun.;2001;9;797;414;383
Plungė d. mun.;2001;10;837;424;413
Plungė d. mun.;2001;11;896;454;442
Plungė d. mun.;2001;12;770;393;377
Plungė d. mun.;2001;13;815;426;389
Plungė d. mun.;2001;14;793;423;370
Plungė d. mun.;2001;15;790;418;372
Plungė d. mun.;2001;16;726;368;358
Plungė d. mun.;2001;17;693;362;331
Plungė d. mun.;2001;18;572;310;262
Plungė d. mun.;2001;19;436;233;203
Plungė d. mun.;2001;20;442;245;197
Plungė d. mun.;2001;21;462;238;224
Plungė d. mun.;2001;22;497;250;247
Plungė d. mun.;2001;23;540;279;261
Plungė d. mun.;2001;24;515;260;255
Plungė d. mun.;2001;25;534;258;276
Plungė d. mun.;2001;26;574;277;297
Plungė d. mun.;2001;27;610;280;330
Plungė d. mun.;2001;28;672;332;340
Plungė d. mun.;2001;29;692;330;362
Plungė d. mun.;2001;30;660;318;342
Plungė d. mun.;2001;31;664;328;336
Plungė d. mun.;2001;32;648;326;322
Plungė d. mun.;2001;33;675;342;333
Plungė d. mun.;2001;34;654;326;328
Plungė d. mun.;2001;35;664;348;316
Plungė d. mun.;2001;36;695;343;352
Plungė d. mun.;2001;37;639;322;317
Plungė d. mun.;2001;38;692;367;325
Plungė d. mun.;2001;39;665;335;330
Plungė d. mun.;2001;40;642;339;303
Plungė d. mun.;2001;41;643;307;336
Plungė d. mun.;2001;42;629;292;337
Plungė d. mun.;2001;43;581;280;301
Plungė d. mun.;2001;44;535;254;281
Plungė d. mun.;2001;45;553;257;296
Plungė d. mun.;2001;46;492;242;250
Plungė d. mun.;2001;47;470;247;223
Plungė d. mun.;2001;48;490;240;250
Plungė d. mun.;2001;49;472;223;249
Plungė d. mun.;2001;50;486;220;266
Plungė d. mun.;2001;51;515;241;274
Plungė d. mun.;2001;52;470;205;265
Plungė d. mun.;2001;53;407;187;220
Plungė d. mun.;2001;54;412;209;203
Plungė d. mun.;2001;55;437;192;245
Plungė d. mun.;2001;56;429;196;233
Plungė d. mun.;2001;57;455;220;235
Plungė d. mun.;2001;58;470;198;272
Plungė d. mun.;2001;59;490;233;257
Plungė d. mun.;2001;60;436;175;261
Plungė d. mun.;2001;61;435;190;245
Plungė d. mun.;2001;62;444;177;267
Plungė d. mun.;2001;63;419;161;258
Plungė d. mun.;2001;64;503;220;283
Plungė d. mun.;2001;65;451;188;263
Plungė d. mun.;2001;66;414;168;246
Plungė d. mun.;2001;67;423;172;251
Plungė d. mun.;2001;68;390;153;237
Plungė d. mun.;2001;69;351;148;203
Plungė d. mun.;2001;70;335;132;203
Plungė d. mun.;2001;71;321;118;203
Plungė d. mun.;2001;72;369;120;249
Plungė d. mun.;2001;73;342;110;232
Plungė d. mun.;2001;74;311;112;199
Plungė d. mun.;2001;75;295;85;210
Plungė d. mun.;2001;76;254;87;167
Plungė d. mun.;2001;77;269;90;179
Plungė d. mun.;2001;78;226;71;155
Plungė d. mun.;2001;79;213;68;145
Plungė d. mun.;2001;80;158;51;107
Plungė d. mun.;2001;81;124;40;84
Plungė d. mun.;2001;82;95;29;66
Plungė d. mun.;2001;83;95;28;67
Plungė d. mun.;2001;84;88;31;57
Plungė d. mun.;2001;85;487;146;341
Plungė d. mun.;2002;-1;43809;20841;22968
Plungė d. mun.;2002;0;407;215;192
Plungė d. mun.;2002;1;442;246;196
Plungė d. mun.;2002;2;532;281;251
Plungė d. mun.;2002;3;559;280;279
Plungė d. mun.;2002;4;570;295;275
Plungė d. mun.;2002;5;573;303;270
Plungė d. mun.;2002;6;593;297;296
Plungė d. mun.;2002;7;663;333;330
Plungė d. mun.;2002;8;771;405;366
Plungė d. mun.;2002;9;840;412;428
Plungė d. mun.;2002;10;796;411;385
Plungė d. mun.;2002;11;824;418;406
Plungė d. mun.;2002;12;883;449;434
Plungė d. mun.;2002;13;766;392;374
Plungė d. mun.;2002;14;810;421;389
Plungė d. mun.;2002;15;783;415;368
Plungė d. mun.;2002;16;782;414;368
Plungė d. mun.;2002;17;715;362;353
Plungė d. mun.;2002;18;664;351;313
Plungė d. mun.;2002;19;536;291;245
Plungė d. mun.;2002;20;438;233;205
Plungė d. mun.;2002;21;442;247;195
Plungė d. mun.;2002;22;452;229;223
Plungė d. mun.;2002;23;487;246;241
Plungė d. mun.;2002;24;533;275;258
Plungė d. mun.;2002;25;509;257;252
Plungė d. mun.;2002;26;530;260;270
Plungė d. mun.;2002;27;565;272;293
Plungė d. mun.;2002;28;596;273;323
Plungė d. mun.;2002;29;653;323;330
Plungė d. mun.;2002;30;668;316;352
Plungė d. mun.;2002;31;643;313;330
Plungė d. mun.;2002;32;651;321;330
Plungė d. mun.;2002;33;636;315;321
Plungė d. mun.;2002;34;666;337;329
Plungė d. mun.;2002;35;642;319;323
Plungė d. mun.;2002;36;655;345;310
Plungė d. mun.;2002;37;681;333;348
Plungė d. mun.;2002;38;629;314;315
Plungė d. mun.;2002;39;679;358;321
Plungė d. mun.;2002;40;654;326;328
Plungė d. mun.;2002;41;635;334;301
Plungė d. mun.;2002;42;633;301;332
Plungė d. mun.;2002;43;623;289;334
Plungė d. mun.;2002;44;574;276;298
Plungė d. mun.;2002;45;527;248;279
Plungė d. mun.;2002;46;544;253;291
Plungė d. mun.;2002;47;488;242;246
Plungė d. mun.;2002;48;458;238;220
Plungė d. mun.;2002;49;477;232;245
Plungė d. mun.;2002;50;467;219;248
Plungė d. mun.;2002;51;479;218;261
Plungė d. mun.;2002;52;505;233;272
Plungė d. mun.;2002;53;466;203;263
Plungė d. mun.;2002;54;392;181;211
Plungė d. mun.;2002;55;405;206;199
Plungė d. mun.;2002;56;427;190;237
Plungė d. mun.;2002;57;422;194;228
Plungė d. mun.;2002;58;443;213;230
Plungė d. mun.;2002;59;457;189;268
Plungė d. mun.;2002;60;486;232;254
Plungė d. mun.;2002;61;435;176;259
Plungė d. mun.;2002;62;432;190;242
Plungė d. mun.;2002;63;443;176;267
Plungė d. mun.;2002;64;416;157;259
Plungė d. mun.;2002;65;500;217;283
Plungė d. mun.;2002;66;444;181;263
Plungė d. mun.;2002;67;407;163;244
Plungė d. mun.;2002;68;412;165;247
Plungė d. mun.;2002;69;386;151;235
Plungė d. mun.;2002;70;348;147;201
Plungė d. mun.;2002;71;328;125;203
Plungė d. mun.;2002;72;312;114;198
Plungė d. mun.;2002;73;361;115;246
Plungė d. mun.;2002;74;335;105;230
Plungė d. mun.;2002;75;301;106;195
Plungė d. mun.;2002;76;284;79;205
Plungė d. mun.;2002;77;244;85;159
Plungė d. mun.;2002;78;257;80;177
Plungė d. mun.;2002;79;213;66;147
Plungė d. mun.;2002;80;200;59;141
Plungė d. mun.;2002;81;147;46;101
Plungė d. mun.;2002;82;110;36;74
Plungė d. mun.;2002;83;87;26;61
Plungė d. mun.;2002;84;87;25;62
Plungė d. mun.;2002;85;494;157;337
Plungė d. mun.;2003;-1;43676;20748;22928
Plungė d. mun.;2003;0;388;202;186
Plungė d. mun.;2003;1;410;215;195
Plungė d. mun.;2003;2;445;243;202
Plungė d. mun.;2003;3;539;283;256
Plungė d. mun.;2003;4;558;280;278
Plungė d. mun.;2003;5;576;299;277
Plungė d. mun.;2003;6;573;301;272
Plungė d. mun.;2003;7;597;298;299
Plungė d. mun.;2003;8;664;333;331
Plungė d. mun.;2003;9;769;405;364
Plungė d. mun.;2003;10;836;409;427
Plungė d. mun.;2003;11;796;410;386
Plungė d. mun.;2003;12;818;414;404
Plungė d. mun.;2003;13;876;446;430
Plungė d. mun.;2003;14;759;389;370
Plungė d. mun.;2003;15;806;420;386
Plungė d. mun.;2003;16;775;412;363
Plungė d. mun.;2003;17;768;404;364
Plungė d. mun.;2003;18;714;364;350
Plungė d. mun.;2003;19;653;346;307
Plungė d. mun.;2003;20;527;288;239
Plungė d. mun.;2003;21;430;230;200
Plungė d. mun.;2003;22;443;246;197
Plungė d. mun.;2003;23;457;230;227
Plungė d. mun.;2003;24;488;243;245
Plungė d. mun.;2003;25;540;277;263
Plungė d. mun.;2003;26;513;261;252
Plungė d. mun.;2003;27;528;257;271
Plungė d. mun.;2003;28;563;270;293
Plungė d. mun.;2003;29;594;272;322
Plungė d. mun.;2003;30;646;323;323
Plungė d. mun.;2003;31;666;316;350
Plungė d. mun.;2003;32;640;311;329
Plungė d. mun.;2003;33;640;316;324
Plungė d. mun.;2003;34;635;314;321
Plungė d. mun.;2003;35;660;331;329
Plungė d. mun.;2003;36;633;311;322
Plungė d. mun.;2003;37;653;344;309
Plungė d. mun.;2003;38;681;334;347
Plungė d. mun.;2003;39;630;316;314
Plungė d. mun.;2003;40;678;356;322
Plungė d. mun.;2003;41;654;327;327
Plungė d. mun.;2003;42;623;325;298
Plungė d. mun.;2003;43;628;296;332
Plungė d. mun.;2003;44;617;281;336
Plungė d. mun.;2003;45;565;268;297
Plungė d. mun.;2003;46;528;250;278
Plungė d. mun.;2003;47;542;252;290
Plungė d. mun.;2003;48;488;242;246
Plungė d. mun.;2003;49;454;236;218
Plungė d. mun.;2003;50;472;231;241
Plungė d. mun.;2003;51;451;211;240
Plungė d. mun.;2003;52;474;216;258
Plungė d. mun.;2003;53;508;233;275
Plungė d. mun.;2003;54;461;199;262
Plungė d. mun.;2003;55;391;181;210
Plungė d. mun.;2003;56;399;204;195
Plungė d. mun.;2003;57;417;179;238
Plungė d. mun.;2003;58;416;188;228
Plungė d. mun.;2003;59;435;210;225
Plungė d. mun.;2003;60;447;183;264
Plungė d. mun.;2003;61;480;228;252
Plungė d. mun.;2003;62;433;172;261
Plungė d. mun.;2003;63;429;187;242
Plungė d. mun.;2003;64;443;173;270
Plungė d. mun.;2003;65;408;153;255
Plungė d. mun.;2003;66;493;213;280
Plungė d. mun.;2003;67;443;183;260
Plungė d. mun.;2003;68;399;160;239
Plungė d. mun.;2003;69;402;157;245
Plungė d. mun.;2003;70;377;142;235
Plungė d. mun.;2003;71;345;143;202
Plungė d. mun.;2003;72;321;124;197
Plungė d. mun.;2003;73;301;111;190
Plungė d. mun.;2003;74;354;110;244
Plungė d. mun.;2003;75;320;102;218
Plungė d. mun.;2003;76;283;93;190
Plungė d. mun.;2003;77;272;74;198
Plungė d. mun.;2003;78;227;78;149
Plungė d. mun.;2003;79;239;69;170
Plungė d. mun.;2003;80;197;58;139
Plungė d. mun.;2003;81;183;51;132
Plungė d. mun.;2003;82;129;39;90
Plungė d. mun.;2003;83;103;34;69
Plungė d. mun.;2003;84;76;17;59
Plungė d. mun.;2003;85;484;146;338
Plungė d. mun.;2004;-1;43349;20618;22731
Plungė d. mun.;2004;0;412;229;183
Plungė d. mun.;2004;1;389;206;183
Plungė d. mun.;2004;2;412;217;195
Plungė d. mun.;2004;3;442;244;198
Plungė d. mun.;2004;4;541;285;256
Plungė d. mun.;2004;5;562;283;279
Plungė d. mun.;2004;6;576;302;274
Plungė d. mun.;2004;7;577;304;273
Plungė d. mun.;2004;8;601;301;300
Plungė d. mun.;2004;9;668;337;331
Plungė d. mun.;2004;10;767;402;365
Plungė d. mun.;2004;11;836;406;430
Plungė d. mun.;2004;12;794;410;384
Plungė d. mun.;2004;13;811;414;397
Plungė d. mun.;2004;14;865;439;426
Plungė d. mun.;2004;15;757;389;368
Plungė d. mun.;2004;16;797;417;380
Plungė d. mun.;2004;17;765;409;356
Plungė d. mun.;2004;18;749;394;355
Plungė d. mun.;2004;19;696;357;339
Plungė d. mun.;2004;20;641;339;302
Plungė d. mun.;2004;21;512;278;234
Plungė d. mun.;2004;22;425;227;198
Plungė d. mun.;2004;23;447;250;197
Plungė d. mun.;2004;24;449;227;222
Plungė d. mun.;2004;25;470;237;233
Plungė d. mun.;2004;26;520;267;253
Plungė d. mun.;2004;27;508;260;248
Plungė d. mun.;2004;28;524;257;267
Plungė d. mun.;2004;29;555;262;293
Plungė d. mun.;2004;30;575;261;314
Plungė d. mun.;2004;31;633;311;322
Plungė d. mun.;2004;32;656;310;346
Plungė d. mun.;2004;33;628;300;328
Plungė d. mun.;2004;34;631;307;324
Plungė d. mun.;2004;35;627;312;315
Plungė d. mun.;2004;36;658;332;326
Plungė d. mun.;2004;37;631;310;321
Plungė d. mun.;2004;38;646;342;304
Plungė d. mun.;2004;39;670;329;341
Plungė d. mun.;2004;40;619;310;309
Plungė d. mun.;2004;41;676;358;318
Plungė d. mun.;2004;42;649;325;324
Plungė d. mun.;2004;43;621;324;297
Plungė d. mun.;2004;44;621;292;329
Plungė d. mun.;2004;45;618;281;337
Plungė d. mun.;2004;46;558;265;293
Plungė d. mun.;2004;47;526;252;274
Plungė d. mun.;2004;48;534;247;287
Plungė d. mun.;2004;49;482;236;246
Plungė d. mun.;2004;50;451;234;217
Plungė d. mun.;2004;51;465;226;239
Plungė d. mun.;2004;52;442;206;236
Plungė d. mun.;2004;53;468;215;253
Plungė d. mun.;2004;54;499;228;271
Plungė d. mun.;2004;55;458;196;262
Plungė d. mun.;2004;56;384;177;207
Plungė d. mun.;2004;57;387;196;191
Plungė d. mun.;2004;58;411;174;237
Plungė d. mun.;2004;59;410;182;228
Plungė d. mun.;2004;60;419;199;220
Plungė d. mun.;2004;61;443;180;263
Plungė d. mun.;2004;62;477;226;251
Plungė d. mun.;2004;63;428;170;258
Plungė d. mun.;2004;64;420;179;241
Plungė d. mun.;2004;65;436;165;271
Plungė d. mun.;2004;66;400;145;255
Plungė d. mun.;2004;67;484;210;274
Plungė d. mun.;2004;68;436;177;259
Plungė d. mun.;2004;69;391;153;238
Plungė d. mun.;2004;70;397;154;243
Plungė d. mun.;2004;71;370;140;230
Plungė d. mun.;2004;72;332;134;198
Plungė d. mun.;2004;73;309;116;193
Plungė d. mun.;2004;74;290;106;184
Plungė d. mun.;2004;75;332;97;235
Plungė d. mun.;2004;76;312;97;215
Plungė d. mun.;2004;77;269;89;180
Plungė d. mun.;2004;78;257;69;188
Plungė d. mun.;2004;79;203;64;139
Plungė d. mun.;2004;80;217;61;156
Plungė d. mun.;2004;81;182;55;127
Plungė d. mun.;2004;82;168;44;124
Plungė d. mun.;2004;83;109;32;77
Plungė d. mun.;2004;84;89;28;61
Plungė d. mun.;2004;85;477;141;336
Plungė d. mun.;2005;-1;42832;20324;22508
Plungė d. mun.;2005;0;423;225;198
Plungė d. mun.;2005;1;415;232;183
Plungė d. mun.;2005;2;389;206;183
Plungė d. mun.;2005;3;410;217;193
Plungė d. mun.;2005;4;442;243;199
Plungė d. mun.;2005;5;535;283;252
Plungė d. mun.;2005;6;559;282;277
Plungė d. mun.;2005;7;574;300;274
Plungė d. mun.;2005;8;572;302;270
Plungė d. mun.;2005;9;598;298;300
Plungė d. mun.;2005;10;666;337;329
Plungė d. mun.;2005;11;760;398;362
Plungė d. mun.;2005;12;832;401;431
Plungė d. mun.;2005;13;788;407;381
Plungė d. mun.;2005;14;805;408;397
Plungė d. mun.;2005;15;854;435;419
Plungė d. mun.;2005;16;746;382;364
Plungė d. mun.;2005;17;781;406;375
Plungė d. mun.;2005;18;747;399;348
Plungė d. mun.;2005;19;726;384;342
Plungė d. mun.;2005;20;678;347;331
Plungė d. mun.;2005;21;627;332;295
Plungė d. mun.;2005;22;508;276;232
Plungė d. mun.;2005;23;409;219;190
Plungė d. mun.;2005;24;439;248;191
Plungė d. mun.;2005;25;431;215;216
Plungė d. mun.;2005;26;456;232;224
Plungė d. mun.;2005;27;502;257;245
Plungė d. mun.;2005;28;498;256;242
Plungė d. mun.;2005;29;515;246;269
Plungė d. mun.;2005;30;535;253;282
Plungė d. mun.;2005;31;572;258;314
Plungė d. mun.;2005;32;628;308;320
Plungė d. mun.;2005;33;652;307;345
Plungė d. mun.;2005;34;620;292;328
Plungė d. mun.;2005;35;614;294;320
Plungė d. mun.;2005;36;622;307;315
Plungė d. mun.;2005;37;650;327;323
Plungė d. mun.;2005;38;616;299;317
Plungė d. mun.;2005;39;634;331;303
Plungė d. mun.;2005;40;655;320;335
Plungė d. mun.;2005;41;608;305;303
Plungė d. mun.;2005;42;661;349;312
Plungė d. mun.;2005;43;635;315;320
Plungė d. mun.;2005;44;620;322;298
Plungė d. mun.;2005;45;614;287;327
Plungė d. mun.;2005;46;608;275;333
Plungė d. mun.;2005;47;553;263;290
Plungė d. mun.;2005;48;512;243;269
Plungė d. mun.;2005;49;531;248;283
Plungė d. mun.;2005;50;480;232;248
Plungė d. mun.;2005;51;442;226;216
Plungė d. mun.;2005;52;449;212;237
Plungė d. mun.;2005;53;432;199;233
Plungė d. mun.;2005;54;455;208;247
Plungė d. mun.;2005;55;490;223;267
Plungė d. mun.;2005;56;455;195;260
Plungė d. mun.;2005;57;378;174;204
Plungė d. mun.;2005;58;376;189;187
Plungė d. mun.;2005;59;402;169;233
Plungė d. mun.;2005;60;401;175;226
Plungė d. mun.;2005;61;405;190;215
Plungė d. mun.;2005;62;433;174;259
Plungė d. mun.;2005;63;468;220;248
Plungė d. mun.;2005;64;414;160;254
Plungė d. mun.;2005;65;416;178;238
Plungė d. mun.;2005;66;423;159;264
Plungė d. mun.;2005;67;392;140;252
Plungė d. mun.;2005;68;467;199;268
Plungė d. mun.;2005;69;423;170;253
Plungė d. mun.;2005;70;382;148;234
Plungė d. mun.;2005;71;390;147;243
Plungė d. mun.;2005;72;355;130;225
Plungė d. mun.;2005;73;326;128;198
Plungė d. mun.;2005;74;296;110;186
Plungė d. mun.;2005;75;279;101;178
Plungė d. mun.;2005;76;321;94;227
Plungė d. mun.;2005;77;296;90;206
Plungė d. mun.;2005;78;251;84;167
Plungė d. mun.;2005;79;243;65;178
Plungė d. mun.;2005;80;189;55;134
Plungė d. mun.;2005;81;205;55;150
Plungė d. mun.;2005;82;168;49;119
Plungė d. mun.;2005;83;149;38;111
Plungė d. mun.;2005;84;98;28;70
Plungė d. mun.;2005;85;458;134;324
Plungė d. mun.;2006;-1;41588;19644;21944
Plungė d. mun.;2006;0;367;190;177
Plungė d. mun.;2006;1;418;223;195
Plungė d. mun.;2006;2;406;227;179
Plungė d. mun.;2006;3;378;202;176
Plungė d. mun.;2006;4;400;210;190
Plungė d. mun.;2006;5;433;236;197
Plungė d. mun.;2006;6;521;276;245
Plungė d. mun.;2006;7;546;273;273
Plungė d. mun.;2006;8;565;295;270
Plungė d. mun.;2006;9;567;302;265
Plungė d. mun.;2006;10;587;295;292
Plungė d. mun.;2006;11;659;332;327
Plungė d. mun.;2006;12;753;392;361
Plungė d. mun.;2006;13;810;389;421
Plungė d. mun.;2006;14;769;399;370
Plungė d. mun.;2006;15;776;392;384
Plungė d. mun.;2006;16;822;420;402
Plungė d. mun.;2006;17;721;368;353
Plungė d. mun.;2006;18;745;386;359
Plungė d. mun.;2006;19;694;367;327
Plungė d. mun.;2006;20;679;356;323
Plungė d. mun.;2006;21;641;328;313
Plungė d. mun.;2006;22;587;314;273
Plungė d. mun.;2006;23;475;259;216
Plungė d. mun.;2006;24;379;204;175
Plungė d. mun.;2006;25;403;224;179
Plungė d. mun.;2006;26;403;194;209
Plungė d. mun.;2006;27;431;223;208
Plungė d. mun.;2006;28;479;239;240
Plungė d. mun.;2006;29;489;252;237
Plungė d. mun.;2006;30;498;235;263
Plungė d. mun.;2006;31;529;249;280
Plungė d. mun.;2006;32;547;244;303
Plungė d. mun.;2006;33;614;298;316
Plungė d. mun.;2006;34;634;295;339
Plungė d. mun.;2006;35;600;281;319
Plungė d. mun.;2006;36;593;283;310
Plungė d. mun.;2006;37;600;295;305
Plungė d. mun.;2006;38;622;310;312
Plungė d. mun.;2006;39;599;292;307
Plungė d. mun.;2006;40;612;316;296
Plungė d. mun.;2006;41;634;308;326
Plungė d. mun.;2006;42;588;290;298
Plungė d. mun.;2006;43;638;335;303
Plungė d. mun.;2006;44;615;301;314
Plungė d. mun.;2006;45;611;318;293
Plungė d. mun.;2006;46;601;281;320
Plungė d. mun.;2006;47;592;269;323
Plungė d. mun.;2006;48;547;257;290
Plungė d. mun.;2006;49;495;232;263
Plungė d. mun.;2006;50;516;241;275
Plungė d. mun.;2006;51;461;220;241
Plungė d. mun.;2006;52;429;217;212
Plungė d. mun.;2006;53;440;208;232
Plungė d. mun.;2006;54;414;190;224
Plungė d. mun.;2006;55;434;194;240
Plungė d. mun.;2006;56;471;208;263
Plungė d. mun.;2006;57;449;187;262
Plungė d. mun.;2006;58;369;169;200
Plungė d. mun.;2006;59;366;186;180
Plungė d. mun.;2006;60;391;163;228
Plungė d. mun.;2006;61;387;165;222
Plungė d. mun.;2006;62;390;180;210
Plungė d. mun.;2006;63;415;162;253
Plungė d. mun.;2006;64;449;209;240
Plungė d. mun.;2006;65;399;156;243
Plungė d. mun.;2006;66;403;170;233
Plungė d. mun.;2006;67;403;149;254
Plungė d. mun.;2006;68;378;138;240
Plungė d. mun.;2006;69;451;189;262
Plungė d. mun.;2006;70;405;158;247
Plungė d. mun.;2006;71;366;140;226
Plungė d. mun.;2006;72;378;142;236
Plungė d. mun.;2006;73;339;120;219
Plungė d. mun.;2006;74;314;123;191
Plungė d. mun.;2006;75;287;106;181
Plungė d. mun.;2006;76;266;93;173
Plungė d. mun.;2006;77;307;88;219
Plungė d. mun.;2006;78;280;86;194
Plungė d. mun.;2006;79;230;75;155
Plungė d. mun.;2006;80;226;61;165
Plungė d. mun.;2006;81;178;47;131
Plungė d. mun.;2006;82;187;48;139
Plungė d. mun.;2006;83;154;41;113
Plungė d. mun.;2006;84;132;29;103
Plungė d. mun.;2006;85;452;130;322
Plungė d. mun.;2007;-1;40961;19225;21736
Plungė d. mun.;2007;0;392;186;206
Plungė d. mun.;2007;1;362;186;176
Plungė d. mun.;2007;2;411;219;192
Plungė d. mun.;2007;3;406;224;182
Plungė d. mun.;2007;4;375;197;178
Plungė d. mun.;2007;5;396;206;190
Plungė d. mun.;2007;6;428;233;195
Plungė d. mun.;2007;7;514;269;245
Plungė d. mun.;2007;8;541;270;271
Plungė d. mun.;2007;9;560;291;269
Plungė d. mun.;2007;10;562;294;268
Plungė d. mun.;2007;11;586;293;293
Plungė d. mun.;2007;12;651;326;325
Plungė d. mun.;2007;13;739;379;360
Plungė d. mun.;2007;14;802;386;416
Plungė d. mun.;2007;15;766;397;369
Plungė d. mun.;2007;16;763;384;379
Plungė d. mun.;2007;17;808;412;396
Plungė d. mun.;2007;18;710;360;350
Plungė d. mun.;2007;19;724;373;351
Plungė d. mun.;2007;20;671;353;318
Plungė d. mun.;2007;21;658;343;315
Plungė d. mun.;2007;22;621;317;304
Plungė d. mun.;2007;23;565;299;266
Plungė d. mun.;2007;24;450;248;202
Plungė d. mun.;2007;25;364;196;168
Plungė d. mun.;2007;26;387;212;175
Plungė d. mun.;2007;27;395;191;204
Plungė d. mun.;2007;28;418;217;201
Plungė d. mun.;2007;29;467;233;234
Plungė d. mun.;2007;30;487;252;235
Plungė d. mun.;2007;31;489;230;259
Plungė d. mun.;2007;32;513;239;274
Plungė d. mun.;2007;33;538;235;303
Plungė d. mun.;2007;34;609;290;319
Plungė d. mun.;2007;35;624;290;334
Plungė d. mun.;2007;36;593;280;313
Plungė d. mun.;2007;37;586;278;308
Plungė d. mun.;2007;38;595;291;304
Plungė d. mun.;2007;39;612;304;308
Plungė d. mun.;2007;40;585;284;301
Plungė d. mun.;2007;41;599;309;290
Plungė d. mun.;2007;42;620;301;319
Plungė d. mun.;2007;43;568;278;290
Plungė d. mun.;2007;44;631;331;300
Plungė d. mun.;2007;45;608;297;311
Plungė d. mun.;2007;46;607;316;291
Plungė d. mun.;2007;47;596;280;316
Plungė d. mun.;2007;48;583;257;326
Plungė d. mun.;2007;49;535;247;288
Plungė d. mun.;2007;50;486;228;258
Plungė d. mun.;2007;51;508;237;271
Plungė d. mun.;2007;52;455;216;239
Plungė d. mun.;2007;53;415;210;205
Plungė d. mun.;2007;54;435;205;230
Plungė d. mun.;2007;55;408;187;221
Plungė d. mun.;2007;56;424;188;236
Plungė d. mun.;2007;57;460;200;260
Plungė d. mun.;2007;58;434;176;258
Plungė d. mun.;2007;59;363;164;199
Plungė d. mun.;2007;60;354;175;179
Plungė d. mun.;2007;61;383;155;228
Plungė d. mun.;2007;62;379;159;220
Plungė d. mun.;2007;63;376;172;204
Plungė d. mun.;2007;64;402;154;248
Plungė d. mun.;2007;65;431;194;237
Plungė d. mun.;2007;66;384;150;234
Plungė d. mun.;2007;67;395;162;233
Plungė d. mun.;2007;68;396;145;251
Plungė d. mun.;2007;69;370;133;237
Plungė d. mun.;2007;70;435;178;257
Plungė d. mun.;2007;71;395;149;246
Plungė d. mun.;2007;72;352;130;222
Plungė d. mun.;2007;73;363;133;230
Plungė d. mun.;2007;74;322;112;210
Plungė d. mun.;2007;75;294;110;184
Plungė d. mun.;2007;76;276;102;174
Plungė d. mun.;2007;77;251;87;164
Plungė d. mun.;2007;78;284;76;208
Plungė d. mun.;2007;79;265;79;186
Plungė d. mun.;2007;80;213;65;148
Plungė d. mun.;2007;81;210;61;149
Plungė d. mun.;2007;82;166;44;122
Plungė d. mun.;2007;83;173;42;131
Plungė d. mun.;2007;84;138;36;102
Plungė d. mun.;2007;85;496;128;368
Plungė d. mun.;2008;-1;40473;18986;21487
Plungė d. mun.;2008;0;409;200;209
Plungė d. mun.;2008;1;387;185;202
Plungė d. mun.;2008;2;356;184;172
Plungė d. mun.;2008;3;408;219;189
Plungė d. mun.;2008;4;401;220;181
Plungė d. mun.;2008;5;375;197;178
Plungė d. mun.;2008;6;397;206;191
Plungė d. mun.;2008;7;423;232;191
Plungė d. mun.;2008;8;515;270;245
Plungė d. mun.;2008;9;537;267;270
Plungė d. mun.;2008;10;558;294;264
Plungė d. mun.;2008;11;561;293;268
Plungė d. mun.;2008;12;586;292;294
Plungė d. mun.;2008;13;651;323;328
Plungė d. mun.;2008;14;733;375;358
Plungė d. mun.;2008;15;794;380;414
Plungė d. mun.;2008;16;764;397;367
Plungė d. mun.;2008;17;751;382;369
Plungė d. mun.;2008;18;797;409;388
Plungė d. mun.;2008;19;691;349;342
Plungė d. mun.;2008;20;710;367;343
Plungė d. mun.;2008;21;661;349;312
Plungė d. mun.;2008;22;641;330;311
Plungė d. mun.;2008;23;604;310;294
Plungė d. mun.;2008;24;554;291;263
Plungė d. mun.;2008;25;437;240;197
Plungė d. mun.;2008;26;349;193;156
Plungė d. mun.;2008;27;375;204;171
Plungė d. mun.;2008;28;380;184;196
Plungė d. mun.;2008;29;411;209;202
Plungė d. mun.;2008;30;458;226;232
Plungė d. mun.;2008;31;481;248;233
Plungė d. mun.;2008;32;480;229;251
Plungė d. mun.;2008;33;515;241;274
Plungė d. mun.;2008;34;533;232;301
Plungė d. mun.;2008;35;596;284;312
Plungė d. mun.;2008;36;617;285;332
Plungė d. mun.;2008;37;584;277;307
Plungė d. mun.;2008;38;583;275;308
Plungė d. mun.;2008;39;585;287;298
Plungė d. mun.;2008;40;604;299;305
Plungė d. mun.;2008;41;573;277;296
Plungė d. mun.;2008;42;593;306;287
Plungė d. mun.;2008;43;606;290;316
Plungė d. mun.;2008;44;559;272;287
Plungė d. mun.;2008;45;616;321;295
Plungė d. mun.;2008;46;596;289;307
Plungė d. mun.;2008;47;602;314;288
Plungė d. mun.;2008;48;594;281;313
Plungė d. mun.;2008;49;572;254;318
Plungė d. mun.;2008;50;532;244;288
Plungė d. mun.;2008;51;475;223;252
Plungė d. mun.;2008;52;507;239;268
Plungė d. mun.;2008;53;451;215;236
Plungė d. mun.;2008;54;408;204;204
Plungė d. mun.;2008;55;433;203;230
Plungė d. mun.;2008;56;398;181;217
Plungė d. mun.;2008;57;416;185;231
Plungė d. mun.;2008;58;455;197;258
Plungė d. mun.;2008;59;432;174;258
Plungė d. mun.;2008;60;359;165;194
Plungė d. mun.;2008;61;344;170;174
Plungė d. mun.;2008;62;371;149;222
Plungė d. mun.;2008;63;371;154;217
Plungė d. mun.;2008;64;374;170;204
Plungė d. mun.;2008;65;394;151;243
Plungė d. mun.;2008;66;422;190;232
Plungė d. mun.;2008;67;370;138;232
Plungė d. mun.;2008;68;379;150;229
Plungė d. mun.;2008;69;384;138;246
Plungė d. mun.;2008;70;354;122;232
Plungė d. mun.;2008;71;413;165;248
Plungė d. mun.;2008;72;382;141;241
Plungė d. mun.;2008;73;344;125;219
Plungė d. mun.;2008;74;354;127;227
Plungė d. mun.;2008;75;306;105;201
Plungė d. mun.;2008;76;274;97;177
Plungė d. mun.;2008;77;265;93;172
Plungė d. mun.;2008;78;233;80;153
Plungė d. mun.;2008;79;266;70;196
Plungė d. mun.;2008;80;251;72;179
Plungė d. mun.;2008;81;196;58;138
Plungė d. mun.;2008;82;186;51;135
Plungė d. mun.;2008;83;148;38;110
Plungė d. mun.;2008;84;162;36;126
Plungė d. mun.;2008;85;501;128;373
Plungė d. mun.;2009;-1;40095;18842;21253
Plungė d. mun.;2009;0;413;218;195
Plungė d. mun.;2009;1;397;192;205
Plungė d. mun.;2009;2;380;185;195
Plungė d. mun.;2009;3;358;186;172
Plungė d. mun.;2009;4;405;218;187
Plungė d. mun.;2009;5;399;219;180
Plungė d. mun.;2009;6;368;196;172
Plungė d. mun.;2009;7;396;207;189
Plungė d. mun.;2009;8;424;235;189
Plungė d. mun.;2009;9;512;270;242
Plungė d. mun.;2009;10;538;267;271
Plungė d. mun.;2009;11;555;293;262
Plungė d. mun.;2009;12;559;293;266
Plungė d. mun.;2009;13;582;291;291
Plungė d. mun.;2009;14;651;324;327
Plungė d. mun.;2009;15;729;373;356
Plungė d. mun.;2009;16;787;377;410
Plungė d. mun.;2009;17;757;394;363
Plungė d. mun.;2009;18;746;379;367
Plungė d. mun.;2009;19;786;401;385
Plungė d. mun.;2009;20;685;345;340
Plungė d. mun.;2009;21;700;363;337
Plungė d. mun.;2009;22;645;343;302
Plungė d. mun.;2009;23;635;325;310
Plungė d. mun.;2009;24;584;305;279
Plungė d. mun.;2009;25;541;285;256
Plungė d. mun.;2009;26;432;235;197
Plungė d. mun.;2009;27;327;182;145
Plungė d. mun.;2009;28;364;197;167
Plungė d. mun.;2009;29;379;183;196
Plungė d. mun.;2009;30;398;203;195
Plungė d. mun.;2009;31;449;219;230
Plungė d. mun.;2009;32;474;246;228
Plungė d. mun.;2009;33;473;220;253
Plungė d. mun.;2009;34;503;231;272
Plungė d. mun.;2009;35;529;231;298
Plungė d. mun.;2009;36;595;283;312
Plungė d. mun.;2009;37;609;281;328
Plungė d. mun.;2009;38;574;271;303
Plungė d. mun.;2009;39;587;280;307
Plungė d. mun.;2009;40;576;283;293
Plungė d. mun.;2009;41;598;295;303
Plungė d. mun.;2009;42;562;271;291
Plungė d. mun.;2009;43;588;303;285
Plungė d. mun.;2009;44;597;285;312
Plungė d. mun.;2009;45;548;267;281
Plungė d. mun.;2009;46;607;313;294
Plungė d. mun.;2009;47;588;287;301
Plungė d. mun.;2009;48;593;309;284
Plungė d. mun.;2009;49;588;279;309
Plungė d. mun.;2009;50;569;255;314
Plungė d. mun.;2009;51;533;249;284
Plungė d. mun.;2009;52;473;221;252
Plungė d. mun.;2009;53;497;232;265
Plungė d. mun.;2009;54;443;210;233
Plungė d. mun.;2009;55;402;201;201
Plungė d. mun.;2009;56;424;199;225
Plungė d. mun.;2009;57;389;178;211
Plungė d. mun.;2009;58;411;184;227
Plungė d. mun.;2009;59;450;193;257
Plungė d. mun.;2009;60;420;166;254
Plungė d. mun.;2009;61;351;163;188
Plungė d. mun.;2009;62;336;162;174
Plungė d. mun.;2009;63;361;140;221
Plungė d. mun.;2009;64;366;150;216
Plungė d. mun.;2009;65;361;162;199
Plungė d. mun.;2009;66;389;147;242
Plungė d. mun.;2009;67;412;183;229
Plungė d. mun.;2009;68;360;131;229
Plungė d. mun.;2009;69;372;144;228
Plungė d. mun.;2009;70;375;130;245
Plungė d. mun.;2009;71;344;118;226
Plungė d. mun.;2009;72;398;156;242
Plungė d. mun.;2009;73;374;135;239
Plungė d. mun.;2009;74;330;122;208
Plungė d. mun.;2009;75;341;122;219
Plungė d. mun.;2009;76;294;98;196
Plungė d. mun.;2009;77;261;92;169
Plungė d. mun.;2009;78;253;86;167
Plungė d. mun.;2009;79;222;77;145
Plungė d. mun.;2009;80;251;65;186
Plungė d. mun.;2009;81;230;67;163
Plungė d. mun.;2009;82;184;57;127
Plungė d. mun.;2009;83;161;43;118
Plungė d. mun.;2009;84;137;34;103
Plungė d. mun.;2009;85;551;132;419
Plungė d. mun.;2010;-1;39611;18604;21007
Plungė d. mun.;2010;0;386;203;183
Plungė d. mun.;2010;1;408;217;191
Plungė d. mun.;2010;2;387;185;202
Plungė d. mun.;2010;3;373;184;189
Plungė d. mun.;2010;4;352;183;169
Plungė d. mun.;2010;5;399;218;181
Plungė d. mun.;2010;6;401;221;180
Plungė d. mun.;2010;7;369;199;170
Plungė d. mun.;2010;8;397;206;191
Plungė d. mun.;2010;9;422;236;186
Plungė d. mun.;2010;10;507;266;241
Plungė d. mun.;2010;11;538;266;272
Plungė d. mun.;2010;12;555;290;265
Plungė d. mun.;2010;13;560;294;266
Plungė d. mun.;2010;14;579;291;288
Plungė d. mun.;2010;15;653;326;327
Plungė d. mun.;2010;16;726;375;351
Plungė d. mun.;2010;17;788;378;410
Plungė d. mun.;2010;18;753;388;365
Plungė d. mun.;2010;19;738;376;362
Plungė d. mun.;2010;20;776;395;381
Plungė d. mun.;2010;21;674;342;332
Plungė d. mun.;2010;22;678;353;325
Plungė d. mun.;2010;23;623;331;292
Plungė d. mun.;2010;24;616;318;298
Plungė d. mun.;2010;25;560;294;266
Plungė d. mun.;2010;26;507;268;239
Plungė d. mun.;2010;27;410;225;185
Plungė d. mun.;2010;28;309;174;135
Plungė d. mun.;2010;29;347;186;161
Plungė d. mun.;2010;30;368;184;184
Plungė d. mun.;2010;31;388;196;192
Plungė d. mun.;2010;32;441;213;228
Plungė d. mun.;2010;33;463;238;225
Plungė d. mun.;2010;34;468;218;250
Plungė d. mun.;2010;35;497;229;268
Plungė d. mun.;2010;36;524;229;295
Plungė d. mun.;2010;37;586;278;308
Plungė d. mun.;2010;38;603;276;327
Plungė d. mun.;2010;39;568;268;300
Plungė d. mun.;2010;40;574;275;299
Plungė d. mun.;2010;41;571;277;294
Plungė d. mun.;2010;42;592;290;302
Plungė d. mun.;2010;43;552;264;288
Plungė d. mun.;2010;44;580;297;283
Plungė d. mun.;2010;45;585;277;308
Plungė d. mun.;2010;46;542;262;280
Plungė d. mun.;2010;47;599;308;291
Plungė d. mun.;2010;48;584;284;300
Plungė d. mun.;2010;49;583;300;283
Plungė d. mun.;2010;50;578;271;307
Plungė d. mun.;2010;51;564;253;311
Plungė d. mun.;2010;52;528;245;283
Plungė d. mun.;2010;53;462;213;249
Plungė d. mun.;2010;54;487;222;265
Plungė d. mun.;2010;55;434;201;233
Plungė d. mun.;2010;56;395;197;198
Plungė d. mun.;2010;57;424;197;227
Plungė d. mun.;2010;58;382;175;207
Plungė d. mun.;2010;59;406;181;225
Plungė d. mun.;2010;60;444;189;255
Plungė d. mun.;2010;61;416;164;252
Plungė d. mun.;2010;62;347;158;189
Plungė d. mun.;2010;63;327;160;167
Plungė d. mun.;2010;64;357;138;219
Plungė d. mun.;2010;65;357;145;212
Plungė d. mun.;2010;66;353;158;195
Plungė d. mun.;2010;67;376;137;239
Plungė d. mun.;2010;68;404;179;225
Plungė d. mun.;2010;69;343;120;223
Plungė d. mun.;2010;70;363;142;221
Plungė d. mun.;2010;71;371;127;244
Plungė d. mun.;2010;72;333;113;220
Plungė d. mun.;2010;73;379;146;233
Plungė d. mun.;2010;74;365;133;232
Plungė d. mun.;2010;75;318;114;204
Plungė d. mun.;2010;76;326;115;211
Plungė d. mun.;2010;77;280;93;187
Plungė d. mun.;2010;78;252;86;166
Plungė d. mun.;2010;79;245;80;165
Plungė d. mun.;2010;80;205;69;136
Plungė d. mun.;2010;81;237;61;176
Plungė d. mun.;2010;82;209;58;151
Plungė d. mun.;2010;83;168;52;116
Plungė d. mun.;2010;84;149;39;110
Plungė d. mun.;2010;85;568;122;446
Plungė d. mun.;2011;-1;38275;17978;20297
Plungė d. mun.;2011;0;361;180;181
Plungė d. mun.;2011;1;347;187;160
Plungė d. mun.;2011;2;385;202;183
Plungė d. mun.;2011;3;374;186;188
Plungė d. mun.;2011;4;359;180;179
Plungė d. mun.;2011;5;341;182;159
Plungė d. mun.;2011;6;388;213;175
Plungė d. mun.;2011;7;415;222;193
Plungė d. mun.;2011;8;368;193;175
Plungė d. mun.;2011;9;407;221;186
Plungė d. mun.;2011;10;420;233;187
Plungė d. mun.;2011;11;514;269;245
Plungė d. mun.;2011;12;525;263;262
Plungė d. mun.;2011;13;554;289;265
Plungė d. mun.;2011;14;553;290;263
Plungė d. mun.;2011;15;574;289;285
Plungė d. mun.;2011;16;652;318;334
Plungė d. mun.;2011;17;720;375;345
Plungė d. mun.;2011;18;778;376;402
Plungė d. mun.;2011;19;641;354;287
Plungė d. mun.;2011;20;569;310;259
Plungė d. mun.;2011;21;584;313;271
Plungė d. mun.;2011;22;506;260;246
Plungė d. mun.;2011;23;515;280;235
Plungė d. mun.;2011;24;471;254;217
Plungė d. mun.;2011;25;451;233;218
Plungė d. mun.;2011;26;396;216;180
Plungė d. mun.;2011;27;364;185;179
Plungė d. mun.;2011;28;353;173;180
Plungė d. mun.;2011;29;338;164;174
Plungė d. mun.;2011;30;346;178;168
Plungė d. mun.;2011;31;368;174;194
Plungė d. mun.;2011;32;392;197;195
Plungė d. mun.;2011;33;420;200;220
Plungė d. mun.;2011;34;472;243;229
Plungė d. mun.;2011;35;446;219;227
Plungė d. mun.;2011;36;502;237;265
Plungė d. mun.;2011;37;561;253;308
Plungė d. mun.;2011;38;586;279;307
Plungė d. mun.;2011;39;603;276;327
Plungė d. mun.;2011;40;589;283;306
Plungė d. mun.;2011;41;592;282;310
Plungė d. mun.;2011;42;582;298;284
Plungė d. mun.;2011;43;590;282;308
Plungė d. mun.;2011;44;552;265;287
Plungė d. mun.;2011;45;586;305;281
Plungė d. mun.;2011;46;592;278;314
Plungė d. mun.;2011;47;567;273;294
Plungė d. mun.;2011;48;581;299;282
Plungė d. mun.;2011;49;594;294;300
Plungė d. mun.;2011;50;572;287;285
Plungė d. mun.;2011;51;578;273;305
Plungė d. mun.;2011;52;567;264;303
Plungė d. mun.;2011;53;538;252;286
Plungė d. mun.;2011;54;461;206;255
Plungė d. mun.;2011;55;495;224;271
Plungė d. mun.;2011;56;437;208;229
Plungė d. mun.;2011;57;403;200;203
Plungė d. mun.;2011;58;431;200;231
Plungė d. mun.;2011;59;400;186;214
Plungė d. mun.;2011;60;424;181;243
Plungė d. mun.;2011;61;459;193;266
Plungė d. mun.;2011;62;395;158;237
Plungė d. mun.;2011;63;345;149;196
Plungė d. mun.;2011;64;319;152;167
Plungė d. mun.;2011;65;366;141;225
Plungė d. mun.;2011;66;365;151;214
Plungė d. mun.;2011;67;357;152;205
Plungė d. mun.;2011;68;379;139;240
Plungė d. mun.;2011;69;405;184;221
Plungė d. mun.;2011;70;356;122;234
Plungė d. mun.;2011;71;355;135;220
Plungė d. mun.;2011;72;373;125;248
Plungė d. mun.;2011;73;317;108;209
Plungė d. mun.;2011;74;371;134;237
Plungė d. mun.;2011;75;345;123;222
Plungė d. mun.;2011;76;317;113;204
Plungė d. mun.;2011;77;318;112;206
Plungė d. mun.;2011;78;267;89;178
Plungė d. mun.;2011;79;247;82;165
Plungė d. mun.;2011;80;228;66;162
Plungė d. mun.;2011;81;185;55;130
Plungė d. mun.;2011;82;207;54;153
Plungė d. mun.;2011;83;198;55;143
Plungė d. mun.;2011;84;151;46;105
Plungė d. mun.;2011;85;600;134;466
Plungė d. mun.;2012;-1;37576;17663;19913
Plungė d. mun.;2012;0;367;180;187
Plungė d. mun.;2012;1;361;180;181
Plungė d. mun.;2012;2;341;187;154
Plungė d. mun.;2012;3;383;204;179
Plungė d. mun.;2012;4;364;181;183
Plungė d. mun.;2012;5;350;174;176
Plungė d. mun.;2012;6;335;178;157
Plungė d. mun.;2012;7;381;209;172
Plungė d. mun.;2012;8;408;217;191
Plungė d. mun.;2012;9;368;193;175
Plungė d. mun.;2012;10;397;217;180
Plungė d. mun.;2012;11;419;234;185
Plungė d. mun.;2012;12;508;268;240
Plungė d. mun.;2012;13;512;254;258
Plungė d. mun.;2012;14;550;285;265
Plungė d. mun.;2012;15;550;290;260
Plungė d. mun.;2012;16;571;287;284
Plungė d. mun.;2012;17;650;317;333
Plungė d. mun.;2012;18;717;372;345
Plungė d. mun.;2012;19;756;366;390
Plungė d. mun.;2012;20;616;343;273
Plungė d. mun.;2012;21;545;300;245
Plungė d. mun.;2012;22;557;302;255
Plungė d. mun.;2012;23;465;239;226
Plungė d. mun.;2012;24;489;267;222
Plungė d. mun.;2012;25;430;232;198
Plungė d. mun.;2012;26;425;226;199
Plungė d. mun.;2012;27;363;200;163
Plungė d. mun.;2012;28;340;170;170
Plungė d. mun.;2012;29;336;169;167
Plungė d. mun.;2012;30;328;158;170
Plungė d. mun.;2012;31;333;171;162
Plungė d. mun.;2012;32;349;171;178
Plungė d. mun.;2012;33;376;195;181
Plungė d. mun.;2012;34;406;197;209
Plungė d. mun.;2012;35;466;241;225
Plungė d. mun.;2012;36;444;222;222
Plungė d. mun.;2012;37;495;235;260
Plungė d. mun.;2012;38;550;248;302
Plungė d. mun.;2012;39;581;278;303
Plungė d. mun.;2012;40;596;276;320
Plungė d. mun.;2012;41;578;276;302
Plungė d. mun.;2012;42;582;277;305
Plungė d. mun.;2012;43;571;292;279
Plungė d. mun.;2012;44;580;275;305
Plungė d. mun.;2012;45;544;262;282
Plungė d. mun.;2012;46;575;299;276
Plungė d. mun.;2012;47;595;279;316
Plungė d. mun.;2012;48;556;269;287
Plungė d. mun.;2012;49;566;289;277
Plungė d. mun.;2012;50;583;285;298
Plungė d. mun.;2012;51;568;283;285
Plungė d. mun.;2012;52;572;270;302
Plungė d. mun.;2012;53;559;260;299
Plungė d. mun.;2012;54;532;245;287
Plungė d. mun.;2012;55;456;201;255
Plungė d. mun.;2012;56;485;218;267
Plungė d. mun.;2012;57;434;205;229
Plungė d. mun.;2012;58;405;200;205
Plungė d. mun.;2012;59;421;194;227
Plungė d. mun.;2012;60;395;182;213
Plungė d. mun.;2012;61;420;176;244
Plungė d. mun.;2012;62;456;190;266
Plungė d. mun.;2012;63;386;153;233
Plungė d. mun.;2012;64;337;143;194
Plungė d. mun.;2012;65;311;144;167
Plungė d. mun.;2012;66;355;131;224
Plungė d. mun.;2012;67;362;149;213
Plungė d. mun.;2012;68;353;149;204
Plungė d. mun.;2012;69;365;130;235
Plungė d. mun.;2012;70;389;174;215
Plungė d. mun.;2012;71;347;117;230
Plungė d. mun.;2012;72;341;128;213
Plungė d. mun.;2012;73;351;112;239
Plungė d. mun.;2012;74;304;104;200
Plungė d. mun.;2012;75;356;129;227
Plungė d. mun.;2012;76;333;117;216
Plungė d. mun.;2012;77;305;106;199
Plungė d. mun.;2012;78;298;102;196
Plungė d. mun.;2012;79;250;81;169
Plungė d. mun.;2012;80;237;79;158
Plungė d. mun.;2012;81;209;59;150
Plungė d. mun.;2012;82;165;50;115
Plungė d. mun.;2012;83;191;47;144
Plungė d. mun.;2012;84;183;50;133
Plungė d. mun.;2012;85;637;149;488
Plungė d. mun.;2013;-1;37082;17410;19672
Plungė d. mun.;2013;0;384;203;181
Plungė d. mun.;2013;1;361;176;185
Plungė d. mun.;2013;2;358;177;181
Plungė d. mun.;2013;3;331;178;153
Plungė d. mun.;2013;4;380;203;177
Plungė d. mun.;2013;5;360;180;180
Plungė d. mun.;2013;6;343;171;172
Plungė d. mun.;2013;7;336;179;157
Plungė d. mun.;2013;8;383;210;173
Plungė d. mun.;2013;9;413;218;195
Plungė d. mun.;2013;10;369;193;176
Plungė d. mun.;2013;11;393;215;178
Plungė d. mun.;2013;12;413;228;185
Plungė d. mun.;2013;13;502;268;234
Plungė d. mun.;2013;14;508;252;256
Plungė d. mun.;2013;15;549;284;265
Plungė d. mun.;2013;16;545;287;258
Plungė d. mun.;2013;17;568;285;283
Plungė d. mun.;2013;18;645;311;334
Plungė d. mun.;2013;19;702;364;338
Plungė d. mun.;2013;20;741;362;379
Plungė d. mun.;2013;21;595;335;260
Plungė d. mun.;2013;22;528;294;234
Plungė d. mun.;2013;23;523;290;233
Plungė d. mun.;2013;24;425;219;206
Plungė d. mun.;2013;25;460;252;208
Plungė d. mun.;2013;26;398;218;180
Plungė d. mun.;2013;27;408;222;186
Plungė d. mun.;2013;28;342;193;149
Plungė d. mun.;2013;29;332;165;167
Plungė d. mun.;2013;30;327;164;163
Plungė d. mun.;2013;31;324;146;178
Plungė d. mun.;2013;32;333;169;164
Plungė d. mun.;2013;33;343;168;175
Plungė d. mun.;2013;34;375;196;179
Plungė d. mun.;2013;35;399;194;205
Plungė d. mun.;2013;36;453;229;224
Plungė d. mun.;2013;37;442;222;220
Plungė d. mun.;2013;38;487;230;257
Plungė d. mun.;2013;39;545;246;299
Plungė d. mun.;2013;40;570;271;299
Plungė d. mun.;2013;41;591;273;318
Plungė d. mun.;2013;42;570;278;292
Plungė d. mun.;2013;43;577;274;303
Plungė d. mun.;2013;44;570;294;276
Plungė d. mun.;2013;45;575;271;304
Plungė d. mun.;2013;46;535;257;278
Plungė d. mun.;2013;47;563;293;270
Plungė d. mun.;2013;48;594;277;317
Plungė d. mun.;2013;49;553;262;291
Plungė d. mun.;2013;50;561;288;273
Plungė d. mun.;2013;51;581;282;299
Plungė d. mun.;2013;52;555;270;285
Plungė d. mun.;2013;53;564;266;298
Plungė d. mun.;2013;54;556;257;299
Plungė d. mun.;2013;55;524;240;284
Plungė d. mun.;2013;56;449;192;257
Plungė d. mun.;2013;57;479;211;268
Plungė d. mun.;2013;58;429;201;228
Plungė d. mun.;2013;59;399;196;203
Plungė d. mun.;2013;60;411;186;225
Plungė d. mun.;2013;61;381;173;208
Plungė d. mun.;2013;62;412;169;243
Plungė d. mun.;2013;63;444;180;264
Plungė d. mun.;2013;64;375;145;230
Plungė d. mun.;2013;65;330;137;193
Plungė d. mun.;2013;66;304;142;162
Plungė d. mun.;2013;67;345;125;220
Plungė d. mun.;2013;68;349;140;209
Plungė d. mun.;2013;69;348;145;203
Plungė d. mun.;2013;70;357;130;227
Plungė d. mun.;2013;71;374;168;206
Plungė d. mun.;2013;72;344;116;228
Plungė d. mun.;2013;73;326;117;209
Plungė d. mun.;2013;74;341;108;233
Plungė d. mun.;2013;75;296;98;198
Plungė d. mun.;2013;76;345;122;223
Plungė d. mun.;2013;77;320;109;211
Plungė d. mun.;2013;78;293;103;190
Plungė d. mun.;2013;79;286;96;190
Plungė d. mun.;2013;80;237;75;162
Plungė d. mun.;2013;81;227;74;153
Plungė d. mun.;2013;82;190;54;136
Plungė d. mun.;2013;83;158;47;111
Plungė d. mun.;2013;84;176;40;136
Plungė d. mun.;2013;85;695;162;533
Plungė d. mun.;2014;-1;36498;17140;19358
Plungė d. mun.;2014;0;369;182;187
Plungė d. mun.;2014;1;381;202;179
Plungė d. mun.;2014;2;351;171;180
Plungė d. mun.;2014;3;353;172;181
Plungė d. mun.;2014;4;324;178;146
Plungė d. mun.;2014;5;367;195;172
Plungė d. mun.;2014;6;362;180;182
Plungė d. mun.;2014;7;338;165;173
Plungė d. mun.;2014;8;327;175;152
Plungė d. mun.;2014;9;373;204;169
Plungė d. mun.;2014;10;410;214;196
Plungė d. mun.;2014;11;365;190;175
Plungė d. mun.;2014;12;392;214;178
Plungė d. mun.;2014;13;417;231;186
Plungė d. mun.;2014;14;498;264;234
Plungė d. mun.;2014;15;505;250;255
Plungė d. mun.;2014;16;545;280;265
Plungė d. mun.;2014;17;547;288;259
Plungė d. mun.;2014;18;562;280;282
Plungė d. mun.;2014;19;633;306;327
Plungė d. mun.;2014;20;694;361;333
Plungė d. mun.;2014;21;730;353;377
Plungė d. mun.;2014;22;574;326;248
Plungė d. mun.;2014;23;505;286;219
Plungė d. mun.;2014;24;496;282;214
Plungė d. mun.;2014;25;402;209;193
Plungė d. mun.;2014;26;431;241;190
Plungė d. mun.;2014;27;371;201;170
Plungė d. mun.;2014;28;386;213;173
Plungė d. mun.;2014;29;330;186;144
Plungė d. mun.;2014;30;311;158;153
Plungė d. mun.;2014;31;315;153;162
Plungė d. mun.;2014;32;318;143;175
Plungė d. mun.;2014;33;322;167;155
Plungė d. mun.;2014;34;321;159;162
Plungė d. mun.;2014;35;367;193;174
Plungė d. mun.;2014;36;396;191;205
Plungė d. mun.;2014;37;445;226;219
Plungė d. mun.;2014;38;438;219;219
Plungė d. mun.;2014;39;474;227;247
Plungė d. mun.;2014;40;542;240;302
Plungė d. mun.;2014;41;565;268;297
Plungė d. mun.;2014;42;585;268;317
Plungė d. mun.;2014;43;559;272;287
Plungė d. mun.;2014;44;572;270;302
Plungė d. mun.;2014;45;557;286;271
Plungė d. mun.;2014;46;572;271;301
Plungė d. mun.;2014;47;532;252;280
Plungė d. mun.;2014;48;559;291;268
Plungė d. mun.;2014;49;590;274;316
Plungė d. mun.;2014;50;551;260;291
Plungė d. mun.;2014;51;558;286;272
Plungė d. mun.;2014;52;580;281;299
Plungė d. mun.;2014;53;546;270;276
Plungė d. mun.;2014;54;551;256;295
Plungė d. mun.;2014;55;544;252;292
Plungė d. mun.;2014;56;517;239;278
Plungė d. mun.;2014;57;449;193;256
Plungė d. mun.;2014;58;476;208;268
Plungė d. mun.;2014;59;424;197;227
Plungė d. mun.;2014;60;398;195;203
Plungė d. mun.;2014;61;404;179;225
Plungė d. mun.;2014;62;373;167;206
Plungė d. mun.;2014;63;406;165;241
Plungė d. mun.;2014;64;438;178;260
Plungė d. mun.;2014;65;365;138;227
Plungė d. mun.;2014;66;323;133;190
Plungė d. mun.;2014;67;292;131;161
Plungė d. mun.;2014;68;334;120;214
Plungė d. mun.;2014;69;345;138;207
Plungė d. mun.;2014;70;339;138;201
Plungė d. mun.;2014;71;349;124;225
Plungė d. mun.;2014;72;363;162;201
Plungė d. mun.;2014;73;329;111;218
Plungė d. mun.;2014;74;316;111;205
Plungė d. mun.;2014;75;336;106;230
Plungė d. mun.;2014;76;281;91;190
Plungė d. mun.;2014;77;331;110;221
Plungė d. mun.;2014;78;305;104;201
Plungė d. mun.;2014;79;278;97;181
Plungė d. mun.;2014;80;272;91;181
Plungė d. mun.;2014;81;214;67;147
Plungė d. mun.;2014;82;207;69;138
Plungė d. mun.;2014;83;174;48;126
Plungė d. mun.;2014;84;133;39;94
Plungė d. mun.;2014;85;719;159;560
Plungė d. mun.;2015;-1;36052;17002;19050
Plungė d. mun.;2015;0;336;166;170
Plungė d. mun.;2015;1;372;188;184
Plungė d. mun.;2015;2;374;200;174
Plungė d. mun.;2015;3;348;170;178
Plungė d. mun.;2015;4;350;169;181
Plungė d. mun.;2015;5;316;176;140
Plungė d. mun.;2015;6;365;198;167
Plungė d. mun.;2015;7;357;180;177
Plungė d. mun.;2015;8;332;164;168
Plungė d. mun.;2015;9;327;177;150
Plungė d. mun.;2015;10;368;202;166
Plungė d. mun.;2015;11;408;212;196
Plungė d. mun.;2015;12;360;188;172
Plungė d. mun.;2015;13;388;213;175
Plungė d. mun.;2015;14;415;230;185
Plungė d. mun.;2015;15;490;260;230
Plungė d. mun.;2015;16;498;247;251
Plungė d. mun.;2015;17;540;276;264
Plungė d. mun.;2015;18;540;288;252
Plungė d. mun.;2015;19;548;272;276
Plungė d. mun.;2015;20;618;298;320
Plungė d. mun.;2015;21;677;353;324
Plungė d. mun.;2015;22;720;347;373
Plungė d. mun.;2015;23;555;327;228
Plungė d. mun.;2015;24;481;274;207
Plungė d. mun.;2015;25;477;274;203
Plungė d. mun.;2015;26;385;201;184
Plungė d. mun.;2015;27;419;236;183
Plungė d. mun.;2015;28;366;206;160
Plungė d. mun.;2015;29;375;208;167
Plungė d. mun.;2015;30;328;182;146
Plungė d. mun.;2015;31;310;163;147
Plungė d. mun.;2015;32;304;158;146
Plungė d. mun.;2015;33;317;142;175
Plungė d. mun.;2015;34;318;158;160
Plungė d. mun.;2015;35;318;157;161
Plungė d. mun.;2015;36;356;192;164
Plungė d. mun.;2015;37;396;186;210
Plungė d. mun.;2015;38;445;229;216
Plungė d. mun.;2015;39;428;218;210
Plungė d. mun.;2015;40;472;226;246
Plungė d. mun.;2015;41;535;239;296
Plungė d. mun.;2015;42;562;267;295
Plungė d. mun.;2015;43;581;265;316
Plungė d. mun.;2015;44;551;270;281
Plungė d. mun.;2015;45;570;272;298
Plungė d. mun.;2015;46;549;285;264
Plungė d. mun.;2015;47;568;268;300
Plungė d. mun.;2015;48;529;253;276
Plungė d. mun.;2015;49;552;284;268
Plungė d. mun.;2015;50;588;272;316
Plungė d. mun.;2015;51;557;263;294
Plungė d. mun.;2015;52;560;289;271
Plungė d. mun.;2015;53;570;273;297
Plungė d. mun.;2015;54;541;264;277
Plungė d. mun.;2015;55;541;250;291
Plungė d. mun.;2015;56;546;253;293
Plungė d. mun.;2015;57;511;236;275
Plungė d. mun.;2015;58;446;189;257
Plungė d. mun.;2015;59;474;208;266
Plungė d. mun.;2015;60;421;193;228
Plungė d. mun.;2015;61;394;191;203
Plungė d. mun.;2015;62;399;174;225
Plungė d. mun.;2015;63;371;167;204
Plungė d. mun.;2015;64;402;164;238
Plungė d. mun.;2015;65;425;169;256
Plungė d. mun.;2015;66;360;136;224
Plungė d. mun.;2015;67;318;132;186
Plungė d. mun.;2015;68;286;129;157
Plungė d. mun.;2015;69;329;117;212
Plungė d. mun.;2015;70;333;129;204
Plungė d. mun.;2015;71;330;132;198
Plungė d. mun.;2015;72;343;125;218
Plungė d. mun.;2015;73;354;155;199
Plungė d. mun.;2015;74;316;106;210
Plungė d. mun.;2015;75;300;101;199
Plungė d. mun.;2015;76;322;101;221
Plungė d. mun.;2015;77;265;85;180
Plungė d. mun.;2015;78;315;98;217
Plungė d. mun.;2015;79;291;100;191
Plungė d. mun.;2015;80;257;85;172
Plungė d. mun.;2015;81;254;85;169
Plungė d. mun.;2015;82;203;63;140
Plungė d. mun.;2015;83;190;60;130
Plungė d. mun.;2015;84;152;41;111
Plungė d. mun.;2015;85;694;153;541
Plungė d. mun.;2016;-1;35514;16763;18751
Plungė d. mun.;2016;0;400;207;193
Plungė d. mun.;2016;1;331;168;163
Plungė d. mun.;2016;2;380;188;192
Plungė d. mun.;2016;3;369;196;173
Plungė d. mun.;2016;4;343;168;175
Plungė d. mun.;2016;5;341;163;178
Plungė d. mun.;2016;6;309;174;135
Plungė d. mun.;2016;7;360;195;165
Plungė d. mun.;2016;8;355;180;175
Plungė d. mun.;2016;9;329;163;166
Plungė d. mun.;2016;10;320;172;148
Plungė d. mun.;2016;11;364;201;163
Plungė d. mun.;2016;12;401;209;192
Plungė d. mun.;2016;13;357;185;172
Plungė d. mun.;2016;14;382;210;172
Plungė d. mun.;2016;15;408;224;184
Plungė d. mun.;2016;16;482;258;224
Plungė d. mun.;2016;17;498;246;252
Plungė d. mun.;2016;18;541;272;269
Plungė d. mun.;2016;19;528;280;248
Plungė d. mun.;2016;20;534;266;268
Plungė d. mun.;2016;21;595;289;306
Plungė d. mun.;2016;22;648;344;304
Plungė d. mun.;2016;23;686;331;355
Plungė d. mun.;2016;24;536;319;217
Plungė d. mun.;2016;25;452;256;196
Plungė d. mun.;2016;26;437;256;181
Plungė d. mun.;2016;27;367;189;178
Plungė d. mun.;2016;28;396;226;170
Plungė d. mun.;2016;29;349;201;148
Plungė d. mun.;2016;30;351;196;155
Plungė d. mun.;2016;31;320;173;147
Plungė d. mun.;2016;32;301;152;149
Plungė d. mun.;2016;33;287;146;141
Plungė d. mun.;2016;34;314;137;177
Plungė d. mun.;2016;35;301;150;151
Plungė d. mun.;2016;36;318;158;160
Plungė d. mun.;2016;37;350;193;157
Plungė d. mun.;2016;38;387;181;206
Plungė d. mun.;2016;39;445;230;215
Plungė d. mun.;2016;40;421;214;207
Plungė d. mun.;2016;41;467;223;244
Plungė d. mun.;2016;42;527;237;290
Plungė d. mun.;2016;43;561;265;296
Plungė d. mun.;2016;44;573;261;312
Plungė d. mun.;2016;45;547;271;276
Plungė d. mun.;2016;46;565;269;296
Plungė d. mun.;2016;47;549;284;265
Plungė d. mun.;2016;48;563;265;298
Plungė d. mun.;2016;49;527;249;278
Plungė d. mun.;2016;50;554;285;269
Plungė d. mun.;2016;51;575;264;311
Plungė d. mun.;2016;52;551;260;291
Plungė d. mun.;2016;53;553;284;269
Plungė d. mun.;2016;54;565;273;292
Plungė d. mun.;2016;55;533;257;276
Plungė d. mun.;2016;56;538;249;289
Plungė d. mun.;2016;57;537;245;292
Plungė d. mun.;2016;58;507;233;274
Plungė d. mun.;2016;59;436;184;252
Plungė d. mun.;2016;60;467;204;263
Plungė d. mun.;2016;61;417;189;228
Plungė d. mun.;2016;62;385;183;202
Plungė d. mun.;2016;63;395;172;223
Plungė d. mun.;2016;64;364;161;203
Plungė d. mun.;2016;65;394;157;237
Plungė d. mun.;2016;66;412;162;250
Plungė d. mun.;2016;67;353;132;221
Plungė d. mun.;2016;68;306;126;180
Plungė d. mun.;2016;69;278;128;150
Plungė d. mun.;2016;70;321;112;209
Plungė d. mun.;2016;71;322;124;198
Plungė d. mun.;2016;72;324;128;196
Plungė d. mun.;2016;73;336;121;215
Plungė d. mun.;2016;74;347;153;194
Plungė d. mun.;2016;75;303;98;205
Plungė d. mun.;2016;76;287;92;195
Plungė d. mun.;2016;77;307;93;214
Plungė d. mun.;2016;78;253;79;174
Plungė d. mun.;2016;79;297;92;205
Plungė d. mun.;2016;80;275;95;180
Plungė d. mun.;2016;81;246;84;162
Plungė d. mun.;2016;82;238;76;162
Plungė d. mun.;2016;83;187;56;131
Plungė d. mun.;2016;84;170;55;115
Plungė d. mun.;2016;85;709;167;542
Plungė d. mun.;2017;-1;34737;16392;18345
Plungė d. mun.;2017;0;386;182;204
Plungė d. mun.;2017;1;389;206;183
Plungė d. mun.;2017;2;322;158;164
Plungė d. mun.;2017;3;371;182;189
Plungė d. mun.;2017;4;368;193;175
Plungė d. mun.;2017;5;343;168;175
Plungė d. mun.;2017;6;329;155;174
Plungė d. mun.;2017;7;300;170;130
Plungė d. mun.;2017;8;355;193;162
Plungė d. mun.;2017;9;350;176;174
Plungė d. mun.;2017;10;317;159;158
Plungė d. mun.;2017;11;311;170;141
Plungė d. mun.;2017;12;361;200;161
Plungė d. mun.;2017;13;399;206;193
Plungė d. mun.;2017;14;352;180;172
Plungė d. mun.;2017;15;378;211;167
Plungė d. mun.;2017;16;403;220;183
Plungė d. mun.;2017;17;477;256;221
Plungė d. mun.;2017;18;490;241;249
Plungė d. mun.;2017;19;530;267;263
Plungė d. mun.;2017;20;516;277;239
Plungė d. mun.;2017;21;525;261;264
Plungė d. mun.;2017;22;574;276;298
Plungė d. mun.;2017;23;614;329;285
Plungė d. mun.;2017;24;657;318;339
Plungė d. mun.;2017;25;500;309;191
Plungė d. mun.;2017;26;398;231;167
Plungė d. mun.;2017;27;397;238;159
Plungė d. mun.;2017;28;324;171;153
Plungė d. mun.;2017;29;350;204;146
Plungė d. mun.;2017;30;317;186;131
Plungė d. mun.;2017;31;314;177;137
Plungė d. mun.;2017;32;293;160;133
Plungė d. mun.;2017;33;279;144;135
Plungė d. mun.;2017;34;271;141;130
Plungė d. mun.;2017;35;303;134;169
Plungė d. mun.;2017;36;285;140;145
Plungė d. mun.;2017;37;299;154;145
Plungė d. mun.;2017;38;340;186;154
Plungė d. mun.;2017;39;378;176;202
Plungė d. mun.;2017;40;435;224;211
Plungė d. mun.;2017;41;422;210;212
Plungė d. mun.;2017;42;460;219;241
Plungė d. mun.;2017;43;516;233;283
Plungė d. mun.;2017;44;556;265;291
Plungė d. mun.;2017;45;561;257;304
Plungė d. mun.;2017;46;546;274;272
Plungė d. mun.;2017;47;552;260;292
Plungė d. mun.;2017;48;543;281;262
Plungė d. mun.;2017;49;562;265;297
Plungė d. mun.;2017;50;524;247;277
Plungė d. mun.;2017;51;549;281;268
Plungė d. mun.;2017;52;567;264;303
Plungė d. mun.;2017;53;550;262;288
Plungė d. mun.;2017;54;542;277;265
Plungė d. mun.;2017;55;557;267;290
Plungė d. mun.;2017;56;529;253;276
Plungė d. mun.;2017;57;537;250;287
Plungė d. mun.;2017;58;530;240;290
Plungė d. mun.;2017;59;499;226;273
Plungė d. mun.;2017;60;432;182;250
Plungė d. mun.;2017;61;462;199;263
Plungė d. mun.;2017;62;409;182;227
Plungė d. mun.;2017;63;375;176;199
Plungė d. mun.;2017;64;391;169;222
Plungė d. mun.;2017;65;357;158;199
Plungė d. mun.;2017;66;381;148;233
Plungė d. mun.;2017;67;406;159;247
Plungė d. mun.;2017;68;348;127;221
Plungė d. mun.;2017;69;297;124;173
Plungė d. mun.;2017;70;272;124;148
Plungė d. mun.;2017;71;315;109;206
Plungė d. mun.;2017;72;311;117;194
Plungė d. mun.;2017;73;314;122;192
Plungė d. mun.;2017;74;321;111;210
Plungė d. mun.;2017;75;324;137;187
Plungė d. mun.;2017;76;296;96;200
Plungė d. mun.;2017;77;279;88;191
Plungė d. mun.;2017;78;288;86;202
Plungė d. mun.;2017;79;237;73;164
Plungė d. mun.;2017;80;282;86;196
Plungė d. mun.;2017;81;260;85;175
Plungė d. mun.;2017;82;233;75;158
Plungė d. mun.;2017;83;218;68;150
Plungė d. mun.;2017;84;171;49;122
Plungė d. mun.;2017;85;756;182;574
Plungė d. mun.;2018;-1;33707;15876;17831
Plungė d. mun.;2018;0;353;167;186
Plungė d. mun.;2018;1;380;180;200
Plungė d. mun.;2018;2;375;196;179
Plungė d. mun.;2018;3;314;161;153
Plungė d. mun.;2018;4;363;179;184
Plungė d. mun.;2018;5;365;198;167
Plungė d. mun.;2018;6;331;160;171
Plungė d. mun.;2018;7;316;150;166
Plungė d. mun.;2018;8;296;167;129
Plungė d. mun.;2018;9;350;190;160
Plungė d. mun.;2018;10;340;173;167
Plungė d. mun.;2018;11;312;152;160
Plungė d. mun.;2018;12;302;164;138
Plungė d. mun.;2018;13;359;200;159
Plungė d. mun.;2018;14;391;202;189
Plungė d. mun.;2018;15;344;176;168
Plungė d. mun.;2018;16;373;206;167
Plungė d. mun.;2018;17;400;216;184
Plungė d. mun.;2018;18;462;248;214
Plungė d. mun.;2018;19;455;224;231
Plungė d. mun.;2018;20;512;254;258
Plungė d. mun.;2018;21;479;259;220
Plungė d. mun.;2018;22;497;243;254
Plungė d. mun.;2018;23;512;252;260
Plungė d. mun.;2018;24;560;303;257
Plungė d. mun.;2018;25;588;291;297
Plungė d. mun.;2018;26;451;282;169
Plungė d. mun.;2018;27;356;211;145
Plungė d. mun.;2018;28;364;229;135
Plungė d. mun.;2018;29;291;149;142
Plungė d. mun.;2018;30;330;192;138
Plungė d. mun.;2018;31;293;174;119
Plungė d. mun.;2018;32;287;161;126
Plungė d. mun.;2018;33;279;151;128
Plungė d. mun.;2018;34;258;128;130
Plungė d. mun.;2018;35;251;128;123
Plungė d. mun.;2018;36;293;128;165
Plungė d. mun.;2018;37;272;133;139
Plungė d. mun.;2018;38;293;150;143
Plungė d. mun.;2018;39;325;179;146
Plungė d. mun.;2018;40;372;173;199
Plungė d. mun.;2018;41;415;216;199
Plungė d. mun.;2018;42;404;198;206
Plungė d. mun.;2018;43;437;206;231
Plungė d. mun.;2018;44;502;228;274
Plungė d. mun.;2018;45;540;255;285
Plungė d. mun.;2018;46;554;254;300
Plungė d. mun.;2018;47;539;268;271
Plungė d. mun.;2018;48;544;255;289
Plungė d. mun.;2018;49;539;276;263
Plungė d. mun.;2018;50;554;257;297
Plungė d. mun.;2018;51;523;248;275
Plungė d. mun.;2018;52;545;280;265
Plungė d. mun.;2018;53;559;256;303
Plungė d. mun.;2018;54;539;257;282
Plungė d. mun.;2018;55;538;275;263
Plungė d. mun.;2018;56;549;264;285
Plungė d. mun.;2018;57;525;250;275
Plungė d. mun.;2018;58;528;240;288
Plungė d. mun.;2018;59;518;230;288
Plungė d. mun.;2018;60;495;223;272
Plungė d. mun.;2018;61;425;179;246
Plungė d. mun.;2018;62;461;199;262
Plungė d. mun.;2018;63;402;180;222
Plungė d. mun.;2018;64;372;174;198
Plungė d. mun.;2018;65;383;163;220
Plungė d. mun.;2018;66;349;155;194
Plungė d. mun.;2018;67;375;146;229
Plungė d. mun.;2018;68;401;155;246
Plungė d. mun.;2018;69;337;120;217
Plungė d. mun.;2018;70;290;119;171
Plungė d. mun.;2018;71;262;117;145
Plungė d. mun.;2018;72;306;103;203
Plungė d. mun.;2018;73;301;113;188
Plungė d. mun.;2018;74;307;117;190
Plungė d. mun.;2018;75;311;105;206
Plungė d. mun.;2018;76;309;128;181
Plungė d. mun.;2018;77;277;85;192
Plungė d. mun.;2018;78;269;83;186
Plungė d. mun.;2018;79;276;80;196
Plungė d. mun.;2018;80;220;68;152
Plungė d. mun.;2018;81;269;82;187
Plungė d. mun.;2018;82;244;77;167
Plungė d. mun.;2018;83;214;67;147
Plungė d. mun.;2018;84;204;61;143
Plungė d. mun.;2018;85;752;185;567
Prienai d. mun.;2001;-1;35769;17047;18722
Prienai d. mun.;2001;0;360;175;185
Prienai d. mun.;2001;1;366;182;184
Prienai d. mun.;2001;2;387;206;181
Prienai d. mun.;2001;3;398;219;179
Prienai d. mun.;2001;4;386;186;200
Prienai d. mun.;2001;5;432;211;221
Prienai d. mun.;2001;6;437;218;219
Prienai d. mun.;2001;7;491;249;242
Prienai d. mun.;2001;8;545;297;248
Prienai d. mun.;2001;9;556;270;286
Prienai d. mun.;2001;10;527;276;251
Prienai d. mun.;2001;11;591;345;246
Prienai d. mun.;2001;12;523;265;258
Prienai d. mun.;2001;13;594;312;282
Prienai d. mun.;2001;14;620;304;316
Prienai d. mun.;2001;15;558;283;275
Prienai d. mun.;2001;16;539;272;267
Prienai d. mun.;2001;17;514;262;252
Prienai d. mun.;2001;18;455;234;221
Prienai d. mun.;2001;19;388;229;159
Prienai d. mun.;2001;20;383;224;159
Prienai d. mun.;2001;21;369;191;178
Prienai d. mun.;2001;22;349;191;158
Prienai d. mun.;2001;23;395;214;181
Prienai d. mun.;2001;24;405;220;185
Prienai d. mun.;2001;25;389;189;200
Prienai d. mun.;2001;26;366;182;184
Prienai d. mun.;2001;27;413;208;205
Prienai d. mun.;2001;28;458;227;231
Prienai d. mun.;2001;29;475;260;215
Prienai d. mun.;2001;30;427;213;214
Prienai d. mun.;2001;31;442;230;212
Prienai d. mun.;2001;32;472;231;241
Prienai d. mun.;2001;33;442;226;216
Prienai d. mun.;2001;34;495;254;241
Prienai d. mun.;2001;35;500;259;241
Prienai d. mun.;2001;36;488;244;244
Prienai d. mun.;2001;37;458;232;226
Prienai d. mun.;2001;38;520;262;258
Prienai d. mun.;2001;39;560;292;268
Prienai d. mun.;2001;40;537;274;263
Prienai d. mun.;2001;41;540;272;268
Prienai d. mun.;2001;42;505;269;236
Prienai d. mun.;2001;43;507;260;247
Prienai d. mun.;2001;44;450;229;221
Prienai d. mun.;2001;45;443;227;216
Prienai d. mun.;2001;46;415;211;204
Prienai d. mun.;2001;47;391;198;193
Prienai d. mun.;2001;48;386;198;188
Prienai d. mun.;2001;49;393;216;177
Prienai d. mun.;2001;50;385;198;187
Prienai d. mun.;2001;51;393;184;209
Prienai d. mun.;2001;52;358;179;179
Prienai d. mun.;2001;53;308;157;151
Prienai d. mun.;2001;54;336;166;170
Prienai d. mun.;2001;55;384;168;216
Prienai d. mun.;2001;56;300;147;153
Prienai d. mun.;2001;57;416;195;221
Prienai d. mun.;2001;58;433;194;239
Prienai d. mun.;2001;59;413;193;220
Prienai d. mun.;2001;60;405;178;227
Prienai d. mun.;2001;61;391;183;208
Prienai d. mun.;2001;62;423;168;255
Prienai d. mun.;2001;63;453;200;253
Prienai d. mun.;2001;64;423;176;247
Prienai d. mun.;2001;65;411;176;235
Prienai d. mun.;2001;66;466;193;273
Prienai d. mun.;2001;67;421;176;245
Prienai d. mun.;2001;68;486;187;299
Prienai d. mun.;2001;69;453;166;287
Prienai d. mun.;2001;70;506;218;288
Prienai d. mun.;2001;71;373;141;232
Prienai d. mun.;2001;72;402;150;252
Prienai d. mun.;2001;73;377;137;240
Prienai d. mun.;2001;74;334;103;231
Prienai d. mun.;2001;75;303;80;223
Prienai d. mun.;2001;76;298;87;211
Prienai d. mun.;2001;77;295;97;198
Prienai d. mun.;2001;78;254;78;176
Prienai d. mun.;2001;79;225;81;144
Prienai d. mun.;2001;80;205;71;134
Prienai d. mun.;2001;81;179;48;131
Prienai d. mun.;2001;82;128;33;95
Prienai d. mun.;2001;83;97;27;70
Prienai d. mun.;2001;84;82;23;59
Prienai d. mun.;2001;85;613;191;422
Prienai d. mun.;2002;-1;35369;16891;18478
Prienai d. mun.;2002;0;313;163;150
Prienai d. mun.;2002;1;360;174;186
Prienai d. mun.;2002;2;365;182;183
Prienai d. mun.;2002;3;385;205;180
Prienai d. mun.;2002;4;397;218;179
Prienai d. mun.;2002;5;383;186;197
Prienai d. mun.;2002;6;434;210;224
Prienai d. mun.;2002;7;436;218;218
Prienai d. mun.;2002;8;483;243;240
Prienai d. mun.;2002;9;545;298;247
Prienai d. mun.;2002;10;556;273;283
Prienai d. mun.;2002;11;523;273;250
Prienai d. mun.;2002;12;587;343;244
Prienai d. mun.;2002;13;520;263;257
Prienai d. mun.;2002;14;585;307;278
Prienai d. mun.;2002;15;613;297;316
Prienai d. mun.;2002;16;551;281;270
Prienai d. mun.;2002;17;535;272;263
Prienai d. mun.;2002;18;500;257;243
Prienai d. mun.;2002;19;447;233;214
Prienai d. mun.;2002;20;385;227;158
Prienai d. mun.;2002;21;383;222;161
Prienai d. mun.;2002;22;366;187;179
Prienai d. mun.;2002;23;347;190;157
Prienai d. mun.;2002;24;384;209;175
Prienai d. mun.;2002;25;396;217;179
Prienai d. mun.;2002;26;378;184;194
Prienai d. mun.;2002;27;357;178;179
Prienai d. mun.;2002;28;405;205;200
Prienai d. mun.;2002;29;445;221;224
Prienai d. mun.;2002;30;463;253;210
Prienai d. mun.;2002;31;421;212;209
Prienai d. mun.;2002;32;433;227;206
Prienai d. mun.;2002;33;460;225;235
Prienai d. mun.;2002;34;437;223;214
Prienai d. mun.;2002;35;487;248;239
Prienai d. mun.;2002;36;494;257;237
Prienai d. mun.;2002;37;479;240;239
Prienai d. mun.;2002;38;454;230;224
Prienai d. mun.;2002;39;508;253;255
Prienai d. mun.;2002;40;553;288;265
Prienai d. mun.;2002;41;532;270;262
Prienai d. mun.;2002;42;537;267;270
Prienai d. mun.;2002;43;504;270;234
Prienai d. mun.;2002;44;503;260;243
Prienai d. mun.;2002;45;448;230;218
Prienai d. mun.;2002;46;436;223;213
Prienai d. mun.;2002;47;412;214;198
Prienai d. mun.;2002;48;382;192;190
Prienai d. mun.;2002;49;385;200;185
Prienai d. mun.;2002;50;386;212;174
Prienai d. mun.;2002;51;380;195;185
Prienai d. mun.;2002;52;388;182;206
Prienai d. mun.;2002;53;353;178;175
Prienai d. mun.;2002;54;299;154;145
Prienai d. mun.;2002;55;327;160;167
Prienai d. mun.;2002;56;378;163;215
Prienai d. mun.;2002;57;294;146;148
Prienai d. mun.;2002;58;403;188;215
Prienai d. mun.;2002;59;422;188;234
Prienai d. mun.;2002;60;403;188;215
Prienai d. mun.;2002;61;401;174;227
Prienai d. mun.;2002;62;387;181;206
Prienai d. mun.;2002;63;410;160;250
Prienai d. mun.;2002;64;447;196;251
Prienai d. mun.;2002;65;419;174;245
Prienai d. mun.;2002;66;409;171;238
Prienai d. mun.;2002;67;455;188;267
Prienai d. mun.;2002;68;417;172;245
Prienai d. mun.;2002;69;474;181;293
Prienai d. mun.;2002;70;449;164;285
Prienai d. mun.;2002;71;497;214;283
Prienai d. mun.;2002;72;368;142;226
Prienai d. mun.;2002;73;393;145;248
Prienai d. mun.;2002;74;369;130;239
Prienai d. mun.;2002;75;325;98;227
Prienai d. mun.;2002;76;287;75;212
Prienai d. mun.;2002;77;281;81;200
Prienai d. mun.;2002;78;277;89;188
Prienai d. mun.;2002;79;244;71;173
Prienai d. mun.;2002;80;214;75;139
Prienai d. mun.;2002;81;187;61;126
Prienai d. mun.;2002;82;164;46;118
Prienai d. mun.;2002;83;123;33;90
Prienai d. mun.;2002;84;93;29;64
Prienai d. mun.;2002;85;554;169;385
Prienai d. mun.;2003;-1;35021;16680;18341
Prienai d. mun.;2003;0;308;150;158
Prienai d. mun.;2003;1;309;161;148
Prienai d. mun.;2003;2;352;171;181
Prienai d. mun.;2003;3;362;180;182
Prienai d. mun.;2003;4;376;202;174
Prienai d. mun.;2003;5;394;218;176
Prienai d. mun.;2003;6;379;184;195
Prienai d. mun.;2003;7;434;210;224
Prienai d. mun.;2003;8;432;218;214
Prienai d. mun.;2003;9;479;243;236
Prienai d. mun.;2003;10;541;296;245
Prienai d. mun.;2003;11;552;272;280
Prienai d. mun.;2003;12;515;268;247
Prienai d. mun.;2003;13;573;335;238
Prienai d. mun.;2003;14;511;257;254
Prienai d. mun.;2003;15;574;300;274
Prienai d. mun.;2003;16;604;294;310
Prienai d. mun.;2003;17;549;276;273
Prienai d. mun.;2003;18;532;272;260
Prienai d. mun.;2003;19;497;255;242
Prienai d. mun.;2003;20;445;231;214
Prienai d. mun.;2003;21;377;223;154
Prienai d. mun.;2003;22;378;219;159
Prienai d. mun.;2003;23;364;187;177
Prienai d. mun.;2003;24;343;188;155
Prienai d. mun.;2003;25;382;207;175
Prienai d. mun.;2003;26;398;221;177
Prienai d. mun.;2003;27;364;180;184
Prienai d. mun.;2003;28;348;173;175
Prienai d. mun.;2003;29;392;199;193
Prienai d. mun.;2003;30;438;218;220
Prienai d. mun.;2003;31;458;251;207
Prienai d. mun.;2003;32;416;208;208
Prienai d. mun.;2003;33;425;223;202
Prienai d. mun.;2003;34;456;228;228
Prienai d. mun.;2003;35;424;216;208
Prienai d. mun.;2003;36;481;245;236
Prienai d. mun.;2003;37;487;252;235
Prienai d. mun.;2003;38;478;240;238
Prienai d. mun.;2003;39;448;225;223
Prienai d. mun.;2003;40;503;251;252
Prienai d. mun.;2003;41;546;284;262
Prienai d. mun.;2003;42;528;268;260
Prienai d. mun.;2003;43;528;263;265
Prienai d. mun.;2003;44;505;270;235
Prienai d. mun.;2003;45;503;259;244
Prienai d. mun.;2003;46;445;226;219
Prienai d. mun.;2003;47;434;221;213
Prienai d. mun.;2003;48;408;210;198
Prienai d. mun.;2003;49;378;187;191
Prienai d. mun.;2003;50;377;195;182
Prienai d. mun.;2003;51;377;203;174
Prienai d. mun.;2003;52;377;194;183
Prienai d. mun.;2003;53;390;185;205
Prienai d. mun.;2003;54;349;174;175
Prienai d. mun.;2003;55;300;151;149
Prienai d. mun.;2003;56;318;154;164
Prienai d. mun.;2003;57;377;160;217
Prienai d. mun.;2003;58;291;143;148
Prienai d. mun.;2003;59;400;186;214
Prienai d. mun.;2003;60;414;180;234
Prienai d. mun.;2003;61;395;184;211
Prienai d. mun.;2003;62;399;172;227
Prienai d. mun.;2003;63;380;178;202
Prienai d. mun.;2003;64;406;157;249
Prienai d. mun.;2003;65;443;188;255
Prienai d. mun.;2003;66;414;170;244
Prienai d. mun.;2003;67;398;161;237
Prienai d. mun.;2003;68;444;178;266
Prienai d. mun.;2003;69;405;166;239
Prienai d. mun.;2003;70;463;175;288
Prienai d. mun.;2003;71;436;155;281
Prienai d. mun.;2003;72;486;208;278
Prienai d. mun.;2003;73;357;135;222
Prienai d. mun.;2003;74;377;135;242
Prienai d. mun.;2003;75;362;122;240
Prienai d. mun.;2003;76;309;91;218
Prienai d. mun.;2003;77;280;71;209
Prienai d. mun.;2003;78;273;73;200
Prienai d. mun.;2003;79;258;80;178
Prienai d. mun.;2003;80;233;65;168
Prienai d. mun.;2003;81;204;70;134
Prienai d. mun.;2003;82;179;55;124
Prienai d. mun.;2003;83;150;42;108
Prienai d. mun.;2003;84;110;29;81
Prienai d. mun.;2003;85;537;160;377
Prienai d. mun.;2004;-1;34438;16353;18085
Prienai d. mun.;2004;0;278;142;136
Prienai d. mun.;2004;1;301;146;155
Prienai d. mun.;2004;2;304;157;147
Prienai d. mun.;2004;3;343;168;175
Prienai d. mun.;2004;4;355;177;178
Prienai d. mun.;2004;5;371;200;171
Prienai d. mun.;2004;6;387;213;174
Prienai d. mun.;2004;7;372;181;191
Prienai d. mun.;2004;8;424;208;216
Prienai d. mun.;2004;9;426;216;210
Prienai d. mun.;2004;10;473;242;231
Prienai d. mun.;2004;11;534;294;240
Prienai d. mun.;2004;12;536;262;274
Prienai d. mun.;2004;13;508;266;242
Prienai d. mun.;2004;14;554;323;231
Prienai d. mun.;2004;15;503;256;247
Prienai d. mun.;2004;16;565;296;269
Prienai d. mun.;2004;17;589;284;305
Prienai d. mun.;2004;18;533;268;265
Prienai d. mun.;2004;19;526;270;256
Prienai d. mun.;2004;20;481;245;236
Prienai d. mun.;2004;21;427;223;204
Prienai d. mun.;2004;22;382;223;159
Prienai d. mun.;2004;23;370;212;158
Prienai d. mun.;2004;24;367;187;180
Prienai d. mun.;2004;25;336;186;150
Prienai d. mun.;2004;26;381;207;174
Prienai d. mun.;2004;27;374;211;163
Prienai d. mun.;2004;28;355;172;183
Prienai d. mun.;2004;29;336;174;162
Prienai d. mun.;2004;30;385;194;191
Prienai d. mun.;2004;31;429;213;216
Prienai d. mun.;2004;32;447;242;205
Prienai d. mun.;2004;33;405;202;203
Prienai d. mun.;2004;34;415;211;204
Prienai d. mun.;2004;35;453;226;227
Prienai d. mun.;2004;36;414;209;205
Prienai d. mun.;2004;37;473;238;235
Prienai d. mun.;2004;38;480;248;232
Prienai d. mun.;2004;39;472;239;233
Prienai d. mun.;2004;40;436;216;220
Prienai d. mun.;2004;41;496;250;246
Prienai d. mun.;2004;42;534;276;258
Prienai d. mun.;2004;43;525;264;261
Prienai d. mun.;2004;44;524;261;263
Prienai d. mun.;2004;45;499;267;232
Prienai d. mun.;2004;46;500;255;245
Prienai d. mun.;2004;47;438;223;215
Prienai d. mun.;2004;48;432;220;212
Prienai d. mun.;2004;49;407;209;198
Prienai d. mun.;2004;50;370;182;188
Prienai d. mun.;2004;51;369;191;178
Prienai d. mun.;2004;52;371;198;173
Prienai d. mun.;2004;53;368;186;182
Prienai d. mun.;2004;54;383;180;203
Prienai d. mun.;2004;55;346;169;177
Prienai d. mun.;2004;56;290;143;147
Prienai d. mun.;2004;57;316;152;164
Prienai d. mun.;2004;58;374;158;216
Prienai d. mun.;2004;59;283;139;144
Prienai d. mun.;2004;60;388;177;211
Prienai d. mun.;2004;61;409;173;236
Prienai d. mun.;2004;62;386;175;211
Prienai d. mun.;2004;63;394;168;226
Prienai d. mun.;2004;64;367;167;200
Prienai d. mun.;2004;65;401;154;247
Prienai d. mun.;2004;66;428;179;249
Prienai d. mun.;2004;67;406;162;244
Prienai d. mun.;2004;68;389;155;234
Prienai d. mun.;2004;69;436;172;264
Prienai d. mun.;2004;70;393;160;233
Prienai d. mun.;2004;71;465;170;295
Prienai d. mun.;2004;72;419;149;270
Prienai d. mun.;2004;73;476;200;276
Prienai d. mun.;2004;74;338;125;213
Prienai d. mun.;2004;75;353;123;230
Prienai d. mun.;2004;76;351;117;234
Prienai d. mun.;2004;77;300;88;212
Prienai d. mun.;2004;78;273;71;202
Prienai d. mun.;2004;79;263;70;193
Prienai d. mun.;2004;80;244;72;172
Prienai d. mun.;2004;81;212;52;160
Prienai d. mun.;2004;82;182;60;122
Prienai d. mun.;2004;83;161;47;114
Prienai d. mun.;2004;84;136;37;99
Prienai d. mun.;2004;85;543;160;383
Prienai d. mun.;2005;-1;33866;16075;17791
Prienai d. mun.;2005;0;273;147;126
Prienai d. mun.;2005;1;279;142;137
Prienai d. mun.;2005;2;299;146;153
Prienai d. mun.;2005;3;301;156;145
Prienai d. mun.;2005;4;339;165;174
Prienai d. mun.;2005;5;351;175;176
Prienai d. mun.;2005;6;365;196;169
Prienai d. mun.;2005;7;384;212;172
Prienai d. mun.;2005;8;372;183;189
Prienai d. mun.;2005;9;423;207;216
Prienai d. mun.;2005;10;427;217;210
Prienai d. mun.;2005;11;469;240;229
Prienai d. mun.;2005;12;529;291;238
Prienai d. mun.;2005;13;537;263;274
Prienai d. mun.;2005;14;502;265;237
Prienai d. mun.;2005;15;543;316;227
Prienai d. mun.;2005;16;497;256;241
Prienai d. mun.;2005;17;552;289;263
Prienai d. mun.;2005;18;572;279;293
Prienai d. mun.;2005;19;520;261;259
Prienai d. mun.;2005;20;510;265;245
Prienai d. mun.;2005;21;466;234;232
Prienai d. mun.;2005;22;416;214;202
Prienai d. mun.;2005;23;380;222;158
Prienai d. mun.;2005;24;362;209;153
Prienai d. mun.;2005;25;345;175;170
Prienai d. mun.;2005;26;329;187;142
Prienai d. mun.;2005;27;364;199;165
Prienai d. mun.;2005;28;364;203;161
Prienai d. mun.;2005;29;345;162;183
Prienai d. mun.;2005;30;320;169;151
Prienai d. mun.;2005;31;368;191;177
Prienai d. mun.;2005;32;422;207;215
Prienai d. mun.;2005;33;437;234;203
Prienai d. mun.;2005;34;402;198;204
Prienai d. mun.;2005;35;407;204;203
Prienai d. mun.;2005;36;444;220;224
Prienai d. mun.;2005;37;404;204;200
Prienai d. mun.;2005;38;469;238;231
Prienai d. mun.;2005;39;476;246;230
Prienai d. mun.;2005;40;470;240;230
Prienai d. mun.;2005;41;427;209;218
Prienai d. mun.;2005;42;486;247;239
Prienai d. mun.;2005;43;534;274;260
Prienai d. mun.;2005;44;513;256;257
Prienai d. mun.;2005;45;521;261;260
Prienai d. mun.;2005;46;503;269;234
Prienai d. mun.;2005;47;497;251;246
Prienai d. mun.;2005;48;427;217;210
Prienai d. mun.;2005;49;423;213;210
Prienai d. mun.;2005;50;399;202;197
Prienai d. mun.;2005;51;372;182;190
Prienai d. mun.;2005;52;362;188;174
Prienai d. mun.;2005;53;363;195;168
Prienai d. mun.;2005;54;364;181;183
Prienai d. mun.;2005;55;381;178;203
Prienai d. mun.;2005;56;340;165;175
Prienai d. mun.;2005;57;286;138;148
Prienai d. mun.;2005;58;309;147;162
Prienai d. mun.;2005;59;371;156;215
Prienai d. mun.;2005;60;282;138;144
Prienai d. mun.;2005;61;382;172;210
Prienai d. mun.;2005;62;404;170;234
Prienai d. mun.;2005;63;377;170;207
Prienai d. mun.;2005;64;387;162;225
Prienai d. mun.;2005;65;366;165;201
Prienai d. mun.;2005;66;398;154;244
Prienai d. mun.;2005;67;410;169;241
Prienai d. mun.;2005;68;398;157;241
Prienai d. mun.;2005;69;380;150;230
Prienai d. mun.;2005;70;425;163;262
Prienai d. mun.;2005;71;386;152;234
Prienai d. mun.;2005;72;448;161;287
Prienai d. mun.;2005;73;400;138;262
Prienai d. mun.;2005;74;449;184;265
Prienai d. mun.;2005;75;329;121;208
Prienai d. mun.;2005;76;333;113;220
Prienai d. mun.;2005;77;327;102;225
Prienai d. mun.;2005;78;286;77;209
Prienai d. mun.;2005;79;261;66;195
Prienai d. mun.;2005;80;248;61;187
Prienai d. mun.;2005;81;221;66;155
Prienai d. mun.;2005;82;196;51;145
Prienai d. mun.;2005;83;161;53;108
Prienai d. mun.;2005;84;147;44;103
Prienai d. mun.;2005;85;553;160;393
Prienai d. mun.;2006;-1;33060;15630;17430
Prienai d. mun.;2006;0;247;120;127
Prienai d. mun.;2006;1;268;143;125
Prienai d. mun.;2006;2;279;142;137
Prienai d. mun.;2006;3;295;145;150
Prienai d. mun.;2006;4;295;151;144
Prienai d. mun.;2006;5;339;163;176
Prienai d. mun.;2006;6;346;172;174
Prienai d. mun.;2006;7;364;195;169
Prienai d. mun.;2006;8;376;207;169
Prienai d. mun.;2006;9;369;180;189
Prienai d. mun.;2006;10;419;206;213
Prienai d. mun.;2006;11;423;215;208
Prienai d. mun.;2006;12;464;239;225
Prienai d. mun.;2006;13;517;282;235
Prienai d. mun.;2006;14;529;262;267
Prienai d. mun.;2006;15;491;256;235
Prienai d. mun.;2006;16;526;304;222
Prienai d. mun.;2006;17;482;248;234
Prienai d. mun.;2006;18;533;277;256
Prienai d. mun.;2006;19;537;259;278
Prienai d. mun.;2006;20;487;242;245
Prienai d. mun.;2006;21;483;252;231
Prienai d. mun.;2006;22;441;226;215
Prienai d. mun.;2006;23;399;205;194
Prienai d. mun.;2006;24;359;205;154
Prienai d. mun.;2006;25;343;198;145
Prienai d. mun.;2006;26;328;167;161
Prienai d. mun.;2006;27;319;184;135
Prienai d. mun.;2006;28;343;186;157
Prienai d. mun.;2006;29;352;193;159
Prienai d. mun.;2006;30;334;152;182
Prienai d. mun.;2006;31;314;165;149
Prienai d. mun.;2006;32;361;186;175
Prienai d. mun.;2006;33;411;200;211
Prienai d. mun.;2006;34;424;226;198
Prienai d. mun.;2006;35;385;189;196
Prienai d. mun.;2006;36;402;200;202
Prienai d. mun.;2006;37;430;214;216
Prienai d. mun.;2006;38;399;198;201
Prienai d. mun.;2006;39;460;234;226
Prienai d. mun.;2006;40;463;238;225
Prienai d. mun.;2006;41;462;234;228
Prienai d. mun.;2006;42;416;200;216
Prienai d. mun.;2006;43;480;245;235
Prienai d. mun.;2006;44;524;267;257
Prienai d. mun.;2006;45;513;258;255
Prienai d. mun.;2006;46;513;258;255
Prienai d. mun.;2006;47;499;262;237
Prienai d. mun.;2006;48;487;241;246
Prienai d. mun.;2006;49;424;214;210
Prienai d. mun.;2006;50;418;208;210
Prienai d. mun.;2006;51;399;203;196
Prienai d. mun.;2006;52;369;181;188
Prienai d. mun.;2006;53;353;184;169
Prienai d. mun.;2006;54;369;195;174
Prienai d. mun.;2006;55;360;177;183
Prienai d. mun.;2006;56;374;170;204
Prienai d. mun.;2006;57;342;163;179
Prienai d. mun.;2006;58;283;137;146
Prienai d. mun.;2006;59;305;144;161
Prienai d. mun.;2006;60;363;152;211
Prienai d. mun.;2006;61;277;135;142
Prienai d. mun.;2006;62;374;167;207
Prienai d. mun.;2006;63;395;164;231
Prienai d. mun.;2006;64;369;163;206
Prienai d. mun.;2006;65;374;152;222
Prienai d. mun.;2006;66;364;164;200
Prienai d. mun.;2006;67;386;146;240
Prienai d. mun.;2006;68;388;155;233
Prienai d. mun.;2006;69;391;151;240
Prienai d. mun.;2006;70;369;145;224
Prienai d. mun.;2006;71;412;153;259
Prienai d. mun.;2006;72;367;141;226
Prienai d. mun.;2006;73;436;156;280
Prienai d. mun.;2006;74;388;134;254
Prienai d. mun.;2006;75;434;174;260
Prienai d. mun.;2006;76;315;113;202
Prienai d. mun.;2006;77;318;106;212
Prienai d. mun.;2006;78;315;93;222
Prienai d. mun.;2006;79;266;67;199
Prienai d. mun.;2006;80;225;51;174
Prienai d. mun.;2006;81;225;55;170
Prienai d. mun.;2006;82;202;61;141
Prienai d. mun.;2006;83;184;47;137
Prienai d. mun.;2006;84;146;49;97
Prienai d. mun.;2006;85;551;169;382
Prienai d. mun.;2007;-1;32421;15300;17121
Prienai d. mun.;2007;0;238;124;114
Prienai d. mun.;2007;1;242;118;124
Prienai d. mun.;2007;2;265;141;124
Prienai d. mun.;2007;3;279;144;135
Prienai d. mun.;2007;4;291;145;146
Prienai d. mun.;2007;5;296;154;142
Prienai d. mun.;2007;6;343;165;178
Prienai d. mun.;2007;7;341;170;171
Prienai d. mun.;2007;8;360;194;166
Prienai d. mun.;2007;9;372;205;167
Prienai d. mun.;2007;10;371;182;189
Prienai d. mun.;2007;11;415;202;213
Prienai d. mun.;2007;12;423;214;209
Prienai d. mun.;2007;13;468;241;227
Prienai d. mun.;2007;14;510;280;230
Prienai d. mun.;2007;15;527;261;266
Prienai d. mun.;2007;16;481;251;230
Prienai d. mun.;2007;17;515;298;217
Prienai d. mun.;2007;18;472;242;230
Prienai d. mun.;2007;19;519;271;248
Prienai d. mun.;2007;20;517;249;268
Prienai d. mun.;2007;21;471;235;236
Prienai d. mun.;2007;22;465;244;221
Prienai d. mun.;2007;23;425;220;205
Prienai d. mun.;2007;24;385;195;190
Prienai d. mun.;2007;25;352;202;150
Prienai d. mun.;2007;26;323;191;132
Prienai d. mun.;2007;27;314;161;153
Prienai d. mun.;2007;28;307;178;129
Prienai d. mun.;2007;29;327;176;151
Prienai d. mun.;2007;30;342;183;159
Prienai d. mun.;2007;31;331;150;181
Prienai d. mun.;2007;32;307;163;144
Prienai d. mun.;2007;33;354;181;173
Prienai d. mun.;2007;34;402;194;208
Prienai d. mun.;2007;35;419;222;197
Prienai d. mun.;2007;36;383;187;196
Prienai d. mun.;2007;37;395;198;197
Prienai d. mun.;2007;38;423;209;214
Prienai d. mun.;2007;39;397;197;200
Prienai d. mun.;2007;40;450;226;224
Prienai d. mun.;2007;41;461;237;224
Prienai d. mun.;2007;42;447;224;223
Prienai d. mun.;2007;43;411;197;214
Prienai d. mun.;2007;44;472;237;235
Prienai d. mun.;2007;45;523;268;255
Prienai d. mun.;2007;46;505;254;251
Prienai d. mun.;2007;47;510;258;252
Prienai d. mun.;2007;48;494;258;236
Prienai d. mun.;2007;49;481;237;244
Prienai d. mun.;2007;50;420;212;208
Prienai d. mun.;2007;51;411;203;208
Prienai d. mun.;2007;52;390;196;194
Prienai d. mun.;2007;53;360;178;182
Prienai d. mun.;2007;54;347;180;167
Prienai d. mun.;2007;55;362;187;175
Prienai d. mun.;2007;56;357;175;182
Prienai d. mun.;2007;57;365;164;201
Prienai d. mun.;2007;58;343;161;182
Prienai d. mun.;2007;59;279;134;145
Prienai d. mun.;2007;60;297;141;156
Prienai d. mun.;2007;61;354;146;208
Prienai d. mun.;2007;62;267;130;137
Prienai d. mun.;2007;63;363;156;207
Prienai d. mun.;2007;64;385;159;226
Prienai d. mun.;2007;65;362;159;203
Prienai d. mun.;2007;66;368;147;221
Prienai d. mun.;2007;67;351;151;200
Prienai d. mun.;2007;68;365;133;232
Prienai d. mun.;2007;69;376;146;230
Prienai d. mun.;2007;70;377;141;236
Prienai d. mun.;2007;71;360;139;221
Prienai d. mun.;2007;72;396;145;251
Prienai d. mun.;2007;73;344;129;215
Prienai d. mun.;2007;74;426;152;274
Prienai d. mun.;2007;75;378;127;251
Prienai d. mun.;2007;76;418;164;254
Prienai d. mun.;2007;77;301;105;196
Prienai d. mun.;2007;78;301;100;201
Prienai d. mun.;2007;79;292;80;212
Prienai d. mun.;2007;80;252;59;193
Prienai d. mun.;2007;81;209;46;163
Prienai d. mun.;2007;82;213;51;162
Prienai d. mun.;2007;83;184;52;132
Prienai d. mun.;2007;84;171;46;125
Prienai d. mun.;2007;85;556;173;383
Prienai d. mun.;2008;-1;31807;14997;16810
Prienai d. mun.;2008;0;231;120;111
Prienai d. mun.;2008;1;232;119;113
Prienai d. mun.;2008;2;236;113;123
Prienai d. mun.;2008;3;264;138;126
Prienai d. mun.;2008;4;281;144;137
Prienai d. mun.;2008;5;294;145;149
Prienai d. mun.;2008;6;294;153;141
Prienai d. mun.;2008;7;338;163;175
Prienai d. mun.;2008;8;339;169;170
Prienai d. mun.;2008;9;350;189;161
Prienai d. mun.;2008;10;364;202;162
Prienai d. mun.;2008;11;371;182;189
Prienai d. mun.;2008;12;409;202;207
Prienai d. mun.;2008;13;419;214;205
Prienai d. mun.;2008;14;458;239;219
Prienai d. mun.;2008;15;512;280;232
Prienai d. mun.;2008;16;520;257;263
Prienai d. mun.;2008;17;477;251;226
Prienai d. mun.;2008;18;510;294;216
Prienai d. mun.;2008;19;460;238;222
Prienai d. mun.;2008;20;506;265;241
Prienai d. mun.;2008;21;504;241;263
Prienai d. mun.;2008;22;466;234;232
Prienai d. mun.;2008;23;451;235;216
Prienai d. mun.;2008;24;413;213;200
Prienai d. mun.;2008;25;371;188;183
Prienai d. mun.;2008;26;339;195;144
Prienai d. mun.;2008;27;317;184;133
Prienai d. mun.;2008;28;295;151;144
Prienai d. mun.;2008;29;296;173;123
Prienai d. mun.;2008;30;321;178;143
Prienai d. mun.;2008;31;341;184;157
Prienai d. mun.;2008;32;329;153;176
Prienai d. mun.;2008;33;302;158;144
Prienai d. mun.;2008;34;353;179;174
Prienai d. mun.;2008;35;397;192;205
Prienai d. mun.;2008;36;414;217;197
Prienai d. mun.;2008;37;377;184;193
Prienai d. mun.;2008;38;393;201;192
Prienai d. mun.;2008;39;418;207;211
Prienai d. mun.;2008;40;389;192;197
Prienai d. mun.;2008;41;441;221;220
Prienai d. mun.;2008;42;461;238;223
Prienai d. mun.;2008;43;442;219;223
Prienai d. mun.;2008;44;401;192;209
Prienai d. mun.;2008;45;465;231;234
Prienai d. mun.;2008;46;513;263;250
Prienai d. mun.;2008;47;505;252;253
Prienai d. mun.;2008;48;505;253;252
Prienai d. mun.;2008;49;486;254;232
Prienai d. mun.;2008;50;475;233;242
Prienai d. mun.;2008;51;414;204;210
Prienai d. mun.;2008;52;402;197;205
Prienai d. mun.;2008;53;386;197;189
Prienai d. mun.;2008;54;355;175;180
Prienai d. mun.;2008;55;334;170;164
Prienai d. mun.;2008;56;350;181;169
Prienai d. mun.;2008;57;343;167;176
Prienai d. mun.;2008;58;354;155;199
Prienai d. mun.;2008;59;334;154;180
Prienai d. mun.;2008;60;277;131;146
Prienai d. mun.;2008;61;294;138;156
Prienai d. mun.;2008;62;347;144;203
Prienai d. mun.;2008;63;261;123;138
Prienai d. mun.;2008;64;355;151;204
Prienai d. mun.;2008;65;365;146;219
Prienai d. mun.;2008;66;347;146;201
Prienai d. mun.;2008;67;364;145;219
Prienai d. mun.;2008;68;342;147;195
Prienai d. mun.;2008;69;360;131;229
Prienai d. mun.;2008;70;365;139;226
Prienai d. mun.;2008;71;364;138;226
Prienai d. mun.;2008;72;349;134;215
Prienai d. mun.;2008;73;377;135;242
Prienai d. mun.;2008;74;333;123;210
Prienai d. mun.;2008;75;400;141;259
Prienai d. mun.;2008;76;360;120;240
Prienai d. mun.;2008;77;395;148;247
Prienai d. mun.;2008;78;282;93;189
Prienai d. mun.;2008;79;287;96;191
Prienai d. mun.;2008;80;271;68;203
Prienai d. mun.;2008;81;237;55;182
Prienai d. mun.;2008;82;190;37;153
Prienai d. mun.;2008;83;190;48;142
Prienai d. mun.;2008;84;169;46;123
Prienai d. mun.;2008;85;609;182;427
Prienai d. mun.;2009;-1;31457;14829;16628
Prienai d. mun.;2009;0;258;134;124
Prienai d. mun.;2009;1;232;119;113
Prienai d. mun.;2009;2;230;117;113
Prienai d. mun.;2009;3;236;113;123
Prienai d. mun.;2009;4;264;138;126
Prienai d. mun.;2009;5;286;146;140
Prienai d. mun.;2009;6;291;141;150
Prienai d. mun.;2009;7;294;154;140
Prienai d. mun.;2009;8;333;162;171
Prienai d. mun.;2009;9;340;169;171
Prienai d. mun.;2009;10;354;191;163
Prienai d. mun.;2009;11;367;203;164
Prienai d. mun.;2009;12;371;183;188
Prienai d. mun.;2009;13;409;203;206
Prienai d. mun.;2009;14;420;214;206
Prienai d. mun.;2009;15;459;240;219
Prienai d. mun.;2009;16;514;281;233
Prienai d. mun.;2009;17;511;255;256
Prienai d. mun.;2009;18;470;247;223
Prienai d. mun.;2009;19;504;289;215
Prienai d. mun.;2009;20;453;232;221
Prienai d. mun.;2009;21;497;261;236
Prienai d. mun.;2009;22;497;239;258
Prienai d. mun.;2009;23;457;230;227
Prienai d. mun.;2009;24;443;232;211
Prienai d. mun.;2009;25;402;207;195
Prienai d. mun.;2009;26;359;181;178
Prienai d. mun.;2009;27;322;185;137
Prienai d. mun.;2009;28;310;185;125
Prienai d. mun.;2009;29;291;148;143
Prienai d. mun.;2009;30;297;174;123
Prienai d. mun.;2009;31;310;170;140
Prienai d. mun.;2009;32;334;175;159
Prienai d. mun.;2009;33;321;149;172
Prienai d. mun.;2009;34;301;162;139
Prienai d. mun.;2009;35;346;173;173
Prienai d. mun.;2009;36;397;191;206
Prienai d. mun.;2009;37;412;216;196
Prienai d. mun.;2009;38;373;182;191
Prienai d. mun.;2009;39;384;195;189
Prienai d. mun.;2009;40;415;204;211
Prienai d. mun.;2009;41;388;193;195
Prienai d. mun.;2009;42;435;218;217
Prienai d. mun.;2009;43;456;233;223
Prienai d. mun.;2009;44;440;217;223
Prienai d. mun.;2009;45;401;193;208
Prienai d. mun.;2009;46;462;228;234
Prienai d. mun.;2009;47;505;255;250
Prienai d. mun.;2009;48;504;254;250
Prienai d. mun.;2009;49;503;250;253
Prienai d. mun.;2009;50;487;255;232
Prienai d. mun.;2009;51;470;229;241
Prienai d. mun.;2009;52;411;205;206
Prienai d. mun.;2009;53;404;196;208
Prienai d. mun.;2009;54;383;193;190
Prienai d. mun.;2009;55;350;173;177
Prienai d. mun.;2009;56;329;162;167
Prienai d. mun.;2009;57;346;178;168
Prienai d. mun.;2009;58;338;162;176
Prienai d. mun.;2009;59;351;152;199
Prienai d. mun.;2009;60;332;154;178
Prienai d. mun.;2009;61;279;131;148
Prienai d. mun.;2009;62;287;134;153
Prienai d. mun.;2009;63;339;137;202
Prienai d. mun.;2009;64;253;118;135
Prienai d. mun.;2009;65;348;147;201
Prienai d. mun.;2009;66;358;139;219
Prienai d. mun.;2009;67;342;144;198
Prienai d. mun.;2009;68;353;138;215
Prienai d. mun.;2009;69;332;146;186
Prienai d. mun.;2009;70;352;127;225
Prienai d. mun.;2009;71;354;130;224
Prienai d. mun.;2009;72;361;134;227
Prienai d. mun.;2009;73;332;123;209
Prienai d. mun.;2009;74;364;132;232
Prienai d. mun.;2009;75;319;113;206
Prienai d. mun.;2009;76;386;134;252
Prienai d. mun.;2009;77;349;114;235
Prienai d. mun.;2009;78;375;138;237
Prienai d. mun.;2009;79;267;88;179
Prienai d. mun.;2009;80;269;89;180
Prienai d. mun.;2009;81;251;62;189
Prienai d. mun.;2009;82;218;50;168
Prienai d. mun.;2009;83;174;35;139
Prienai d. mun.;2009;84;173;40;133
Prienai d. mun.;2009;85;663;196;467
Prienai d. mun.;2010;-1;30989;14613;16376
Prienai d. mun.;2010;0;271;149;122
Prienai d. mun.;2010;1;257;133;124
Prienai d. mun.;2010;2;230;115;115
Prienai d. mun.;2010;3;229;120;109
Prienai d. mun.;2010;4;233;113;120
Prienai d. mun.;2010;5;260;136;124
Prienai d. mun.;2010;6;285;152;133
Prienai d. mun.;2010;7;292;144;148
Prienai d. mun.;2010;8;296;157;139
Prienai d. mun.;2010;9;330;158;172
Prienai d. mun.;2010;10;343;172;171
Prienai d. mun.;2010;11;360;195;165
Prienai d. mun.;2010;12;365;201;164
Prienai d. mun.;2010;13;369;182;187
Prienai d. mun.;2010;14;409;200;209
Prienai d. mun.;2010;15;420;216;204
Prienai d. mun.;2010;16;462;241;221
Prienai d. mun.;2010;17;510;279;231
Prienai d. mun.;2010;18;504;250;254
Prienai d. mun.;2010;19;467;243;224
Prienai d. mun.;2010;20;494;284;210
Prienai d. mun.;2010;21;440;227;213
Prienai d. mun.;2010;22;483;253;230
Prienai d. mun.;2010;23;475;229;246
Prienai d. mun.;2010;24;445;222;223
Prienai d. mun.;2010;25;430;222;208
Prienai d. mun.;2010;26;379;193;186
Prienai d. mun.;2010;27;343;175;168
Prienai d. mun.;2010;28;302;175;127
Prienai d. mun.;2010;29;303;181;122
Prienai d. mun.;2010;30;287;149;138
Prienai d. mun.;2010;31;290;168;122
Prienai d. mun.;2010;32;307;164;143
Prienai d. mun.;2010;33;318;171;147
Prienai d. mun.;2010;34;320;151;169
Prienai d. mun.;2010;35;297;161;136
Prienai d. mun.;2010;36;333;163;170
Prienai d. mun.;2010;37;395;191;204
Prienai d. mun.;2010;38;410;213;197
Prienai d. mun.;2010;39;371;179;192
Prienai d. mun.;2010;40;378;189;189
Prienai d. mun.;2010;41;407;200;207
Prienai d. mun.;2010;42;388;191;197
Prienai d. mun.;2010;43;428;210;218
Prienai d. mun.;2010;44;454;230;224
Prienai d. mun.;2010;45;436;216;220
Prienai d. mun.;2010;46;401;192;209
Prienai d. mun.;2010;47;456;225;231
Prienai d. mun.;2010;48;500;253;247
Prienai d. mun.;2010;49;499;253;246
Prienai d. mun.;2010;50;493;241;252
Prienai d. mun.;2010;51;478;249;229
Prienai d. mun.;2010;52;466;224;242
Prienai d. mun.;2010;53;402;199;203
Prienai d. mun.;2010;54;396;190;206
Prienai d. mun.;2010;55;375;189;186
Prienai d. mun.;2010;56;343;169;174
Prienai d. mun.;2010;57;322;161;161
Prienai d. mun.;2010;58;343;175;168
Prienai d. mun.;2010;59;335;159;176
Prienai d. mun.;2010;60;345;148;197
Prienai d. mun.;2010;61;328;151;177
Prienai d. mun.;2010;62;275;132;143
Prienai d. mun.;2010;63;280;127;153
Prienai d. mun.;2010;64;329;133;196
Prienai d. mun.;2010;65;248;115;133
Prienai d. mun.;2010;66;347;145;202
Prienai d. mun.;2010;67;347;132;215
Prienai d. mun.;2010;68;336;139;197
Prienai d. mun.;2010;69;345;130;215
Prienai d. mun.;2010;70;320;137;183
Prienai d. mun.;2010;71;343;122;221
Prienai d. mun.;2010;72;343;124;219
Prienai d. mun.;2010;73;353;132;221
Prienai d. mun.;2010;74;317;115;202
Prienai d. mun.;2010;75;351;121;230
Prienai d. mun.;2010;76;311;110;201
Prienai d. mun.;2010;77;368;123;245
Prienai d. mun.;2010;78;330;104;226
Prienai d. mun.;2010;79;350;124;226
Prienai d. mun.;2010;80;246;83;163
Prienai d. mun.;2010;81;253;82;171
Prienai d. mun.;2010;82;230;58;172
Prienai d. mun.;2010;83;197;43;154
Prienai d. mun.;2010;84;154;33;121
Prienai d. mun.;2010;85;729;208;521
Prienai d. mun.;2011;-1;29936;14080;15856
Prienai d. mun.;2011;0;220;109;111
Prienai d. mun.;2011;1;256;142;114
Prienai d. mun.;2011;2;240;130;110
Prienai d. mun.;2011;3;222;110;112
Prienai d. mun.;2011;4;232;125;107
Prienai d. mun.;2011;5;253;120;133
Prienai d. mun.;2011;6;253;134;119
Prienai d. mun.;2011;7;282;140;142
Prienai d. mun.;2011;8;287;133;154
Prienai d. mun.;2011;9;282;145;137
Prienai d. mun.;2011;10;307;138;169
Prienai d. mun.;2011;11;330;168;162
Prienai d. mun.;2011;12;361;195;166
Prienai d. mun.;2011;13;367;213;154
Prienai d. mun.;2011;14;380;193;187
Prienai d. mun.;2011;15;407;202;205
Prienai d. mun.;2011;16;418;206;212
Prienai d. mun.;2011;17;469;246;223
Prienai d. mun.;2011;18;513;275;238
Prienai d. mun.;2011;19;446;218;228
Prienai d. mun.;2011;20;391;206;185
Prienai d. mun.;2011;21;436;251;185
Prienai d. mun.;2011;22;355;191;164
Prienai d. mun.;2011;23;381;198;183
Prienai d. mun.;2011;24;356;195;161
Prienai d. mun.;2011;25;322;171;151
Prienai d. mun.;2011;26;296;160;136
Prienai d. mun.;2011;27;303;151;152
Prienai d. mun.;2011;28;297;153;144
Prienai d. mun.;2011;29;288;154;134
Prienai d. mun.;2011;30;310;179;131
Prienai d. mun.;2011;31;295;144;151
Prienai d. mun.;2011;32;280;146;134
Prienai d. mun.;2011;33;314;167;147
Prienai d. mun.;2011;34;332;172;160
Prienai d. mun.;2011;35;319;152;167
Prienai d. mun.;2011;36;339;179;160
Prienai d. mun.;2011;37;364;174;190
Prienai d. mun.;2011;38;412;207;205
Prienai d. mun.;2011;39;427;231;196
Prienai d. mun.;2011;40;390;188;202
Prienai d. mun.;2011;41;393;201;192
Prienai d. mun.;2011;42;426;199;227
Prienai d. mun.;2011;43;417;212;205
Prienai d. mun.;2011;44;442;229;213
Prienai d. mun.;2011;45;462;232;230
Prienai d. mun.;2011;46;466;236;230
Prienai d. mun.;2011;47;411;203;208
Prienai d. mun.;2011;48;467;226;241
Prienai d. mun.;2011;49;497;262;235
Prienai d. mun.;2011;50;474;230;244
Prienai d. mun.;2011;51;478;231;247
Prienai d. mun.;2011;52;451;231;220
Prienai d. mun.;2011;53;466;231;235
Prienai d. mun.;2011;54;405;193;212
Prienai d. mun.;2011;55;393;191;202
Prienai d. mun.;2011;56;394;200;194
Prienai d. mun.;2011;57;345;168;177
Prienai d. mun.;2011;58;332;160;172
Prienai d. mun.;2011;59;354;179;175
Prienai d. mun.;2011;60;337;160;177
Prienai d. mun.;2011;61;331;139;192
Prienai d. mun.;2011;62;308;141;167
Prienai d. mun.;2011;63;286;130;156
Prienai d. mun.;2011;64;263;117;146
Prienai d. mun.;2011;65;331;133;198
Prienai d. mun.;2011;66;247;109;138
Prienai d. mun.;2011;67;342;140;202
Prienai d. mun.;2011;68;346;134;212
Prienai d. mun.;2011;69;333;137;196
Prienai d. mun.;2011;70;321;118;203
Prienai d. mun.;2011;71;304;130;174
Prienai d. mun.;2011;72;329;117;212
Prienai d. mun.;2011;73;334;123;211
Prienai d. mun.;2011;74;323;117;206
Prienai d. mun.;2011;75;297;109;188
Prienai d. mun.;2011;76;335;113;222
Prienai d. mun.;2011;77;289;98;191
Prienai d. mun.;2011;78;331;105;226
Prienai d. mun.;2011;79;302;84;218
Prienai d. mun.;2011;80;308;104;204
Prienai d. mun.;2011;81;219;72;147
Prienai d. mun.;2011;82;217;63;154
Prienai d. mun.;2011;83;207;50;157
Prienai d. mun.;2011;84;180;38;142
Prienai d. mun.;2011;85;711;174;537
Prienai d. mun.;2012;-1;29365;13798;15567
Prienai d. mun.;2012;0;270;139;131
Prienai d. mun.;2012;1;216;110;106
Prienai d. mun.;2012;2;240;132;108
Prienai d. mun.;2012;3;240;130;110
Prienai d. mun.;2012;4;217;108;109
Prienai d. mun.;2012;5;232;126;106
Prienai d. mun.;2012;6;250;119;131
Prienai d. mun.;2012;7;253;136;117
Prienai d. mun.;2012;8;284;140;144
Prienai d. mun.;2012;9;280;129;151
Prienai d. mun.;2012;10;281;143;138
Prienai d. mun.;2012;11;303;137;166
Prienai d. mun.;2012;12;329;168;161
Prienai d. mun.;2012;13;357;192;165
Prienai d. mun.;2012;14;367;213;154
Prienai d. mun.;2012;15;380;193;187
Prienai d. mun.;2012;16;402;201;201
Prienai d. mun.;2012;17;420;206;214
Prienai d. mun.;2012;18;461;242;219
Prienai d. mun.;2012;19;504;272;232
Prienai d. mun.;2012;20;432;210;222
Prienai d. mun.;2012;21;381;202;179
Prienai d. mun.;2012;22;419;244;175
Prienai d. mun.;2012;23;336;183;153
Prienai d. mun.;2012;24;365;188;177
Prienai d. mun.;2012;25;328;182;146
Prienai d. mun.;2012;26;298;160;138
Prienai d. mun.;2012;27;270;146;124
Prienai d. mun.;2012;28;286;137;149
Prienai d. mun.;2012;29;287;149;138
Prienai d. mun.;2012;30;275;145;130
Prienai d. mun.;2012;31;292;164;128
Prienai d. mun.;2012;32;284;139;145
Prienai d. mun.;2012;33;275;142;133
Prienai d. mun.;2012;34;303;162;141
Prienai d. mun.;2012;35;318;166;152
Prienai d. mun.;2012;36;304;135;169
Prienai d. mun.;2012;37;332;175;157
Prienai d. mun.;2012;38;355;169;186
Prienai d. mun.;2012;39;409;206;203
Prienai d. mun.;2012;40;424;231;193
Prienai d. mun.;2012;41;388;189;199
Prienai d. mun.;2012;42;393;198;195
Prienai d. mun.;2012;43;427;199;228
Prienai d. mun.;2012;44;410;209;201
Prienai d. mun.;2012;45;435;226;209
Prienai d. mun.;2012;46;466;233;233
Prienai d. mun.;2012;47;464;236;228
Prienai d. mun.;2012;48;407;200;207
Prienai d. mun.;2012;49;460;222;238
Prienai d. mun.;2012;50;489;258;231
Prienai d. mun.;2012;51;471;229;242
Prienai d. mun.;2012;52;479;233;246
Prienai d. mun.;2012;53;452;231;221
Prienai d. mun.;2012;54;457;222;235
Prienai d. mun.;2012;55;401;188;213
Prienai d. mun.;2012;56;393;192;201
Prienai d. mun.;2012;57;389;198;191
Prienai d. mun.;2012;58;342;166;176
Prienai d. mun.;2012;59;329;157;172
Prienai d. mun.;2012;60;355;179;176
Prienai d. mun.;2012;61;329;154;175
Prienai d. mun.;2012;62;331;138;193
Prienai d. mun.;2012;63;297;132;165
Prienai d. mun.;2012;64;275;121;154
Prienai d. mun.;2012;65;259;115;144
Prienai d. mun.;2012;66;321;123;198
Prienai d. mun.;2012;67;243;109;134
Prienai d. mun.;2012;68;336;136;200
Prienai d. mun.;2012;69;336;126;210
Prienai d. mun.;2012;70;320;127;193
Prienai d. mun.;2012;71;308;109;199
Prienai d. mun.;2012;72;293;122;171
Prienai d. mun.;2012;73;323;117;206
Prienai d. mun.;2012;74;321;114;207
Prienai d. mun.;2012;75;314;114;200
Prienai d. mun.;2012;76;281;102;179
Prienai d. mun.;2012;77;320;108;212
Prienai d. mun.;2012;78;273;92;181
Prienai d. mun.;2012;79;315;99;216
Prienai d. mun.;2012;80;284;77;207
Prienai d. mun.;2012;81;287;96;191
Prienai d. mun.;2012;82;199;65;134
Prienai d. mun.;2012;83;199;55;144
Prienai d. mun.;2012;84;186;41;145
Prienai d. mun.;2012;85;749;170;579
Prienai d. mun.;2013;-1;29023;13650;15373
Prienai d. mun.;2013;0;241;121;120
Prienai d. mun.;2013;1;260;134;126
Prienai d. mun.;2013;2;215;107;108
Prienai d. mun.;2013;3;237;130;107
Prienai d. mun.;2013;4;238;129;109
Prienai d. mun.;2013;5;214;109;105
Prienai d. mun.;2013;6;224;122;102
Prienai d. mun.;2013;7;254;122;132
Prienai d. mun.;2013;8;259;139;120
Prienai d. mun.;2013;9;285;140;145
Prienai d. mun.;2013;10;282;128;154
Prienai d. mun.;2013;11;283;144;139
Prienai d. mun.;2013;12;307;139;168
Prienai d. mun.;2013;13;331;168;163
Prienai d. mun.;2013;14;359;192;167
Prienai d. mun.;2013;15;370;214;156
Prienai d. mun.;2013;16;379;192;187
Prienai d. mun.;2013;17;399;198;201
Prienai d. mun.;2013;18;418;205;213
Prienai d. mun.;2013;19;457;240;217
Prienai d. mun.;2013;20;492;264;228
Prienai d. mun.;2013;21;413;205;208
Prienai d. mun.;2013;22;368;200;168
Prienai d. mun.;2013;23;409;239;170
Prienai d. mun.;2013;24;316;177;139
Prienai d. mun.;2013;25;354;182;172
Prienai d. mun.;2013;26;305;169;136
Prienai d. mun.;2013;27;272;144;128
Prienai d. mun.;2013;28;255;135;120
Prienai d. mun.;2013;29;270;134;136
Prienai d. mun.;2013;30;271;144;127
Prienai d. mun.;2013;31;271;146;125
Prienai d. mun.;2013;32;298;171;127
Prienai d. mun.;2013;33;284;134;150
Prienai d. mun.;2013;34;268;136;132
Prienai d. mun.;2013;35;305;163;142
Prienai d. mun.;2013;36;310;162;148
Prienai d. mun.;2013;37;297;134;163
Prienai d. mun.;2013;38;333;178;155
Prienai d. mun.;2013;39;346;166;180
Prienai d. mun.;2013;40;399;204;195
Prienai d. mun.;2013;41;418;227;191
Prienai d. mun.;2013;42;386;185;201
Prienai d. mun.;2013;43;389;197;192
Prienai d. mun.;2013;44;429;196;233
Prienai d. mun.;2013;45;413;210;203
Prienai d. mun.;2013;46;433;228;205
Prienai d. mun.;2013;47;467;231;236
Prienai d. mun.;2013;48;461;236;225
Prienai d. mun.;2013;49;405;197;208
Prienai d. mun.;2013;50;461;223;238
Prienai d. mun.;2013;51;485;254;231
Prienai d. mun.;2013;52;475;231;244
Prienai d. mun.;2013;53;477;231;246
Prienai d. mun.;2013;54;448;229;219
Prienai d. mun.;2013;55;458;225;233
Prienai d. mun.;2013;56;400;184;216
Prienai d. mun.;2013;57;393;195;198
Prienai d. mun.;2013;58;387;194;193
Prienai d. mun.;2013;59;340;163;177
Prienai d. mun.;2013;60;325;155;170
Prienai d. mun.;2013;61;353;175;178
Prienai d. mun.;2013;62;324;148;176
Prienai d. mun.;2013;63;329;139;190
Prienai d. mun.;2013;64;295;130;165
Prienai d. mun.;2013;65;271;117;154
Prienai d. mun.;2013;66;256;113;143
Prienai d. mun.;2013;67;319;119;200
Prienai d. mun.;2013;68;240;107;133
Prienai d. mun.;2013;69;330;132;198
Prienai d. mun.;2013;70;328;120;208
Prienai d. mun.;2013;71;319;127;192
Prienai d. mun.;2013;72;300;108;192
Prienai d. mun.;2013;73;284;117;167
Prienai d. mun.;2013;74;319;114;205
Prienai d. mun.;2013;75;318;111;207
Prienai d. mun.;2013;76;306;107;199
Prienai d. mun.;2013;77;274;97;177
Prienai d. mun.;2013;78;302;95;207
Prienai d. mun.;2013;79;260;85;175
Prienai d. mun.;2013;80;298;91;207
Prienai d. mun.;2013;81;264;67;197
Prienai d. mun.;2013;82;257;83;174
Prienai d. mun.;2013;83;184;59;125
Prienai d. mun.;2013;84;184;48;136
Prienai d. mun.;2013;85;811;190;621
Prienai d. mun.;2014;-1;28521;13427;15094
Prienai d. mun.;2014;0;250;125;125
Prienai d. mun.;2014;1;245;118;127
Prienai d. mun.;2014;2;253;132;121
Prienai d. mun.;2014;3;210;101;109
Prienai d. mun.;2014;4;236;129;107
Prienai d. mun.;2014;5;232;126;106
Prienai d. mun.;2014;6;216;110;106
Prienai d. mun.;2014;7;223;124;99
Prienai d. mun.;2014;8;252;119;133
Prienai d. mun.;2014;9;262;141;121
Prienai d. mun.;2014;10;288;144;144
Prienai d. mun.;2014;11;279;128;151
Prienai d. mun.;2014;12;286;147;139
Prienai d. mun.;2014;13;309;139;170
Prienai d. mun.;2014;14;332;169;163
Prienai d. mun.;2014;15;358;193;165
Prienai d. mun.;2014;16;367;213;154
Prienai d. mun.;2014;17;373;192;181
Prienai d. mun.;2014;18;392;198;194
Prienai d. mun.;2014;19;406;204;202
Prienai d. mun.;2014;20;449;237;212
Prienai d. mun.;2014;21;482;263;219
Prienai d. mun.;2014;22;405;201;204
Prienai d. mun.;2014;23;350;194;156
Prienai d. mun.;2014;24;397;236;161
Prienai d. mun.;2014;25;317;169;148
Prienai d. mun.;2014;26;338;181;157
Prienai d. mun.;2014;27;288;165;123
Prienai d. mun.;2014;28;275;144;131
Prienai d. mun.;2014;29;253;139;114
Prienai d. mun.;2014;30;253;126;127
Prienai d. mun.;2014;31;261;138;123
Prienai d. mun.;2014;32;266;144;122
Prienai d. mun.;2014;33;297;173;124
Prienai d. mun.;2014;34;281;128;153
Prienai d. mun.;2014;35;260;127;133
Prienai d. mun.;2014;36;298;159;139
Prienai d. mun.;2014;37;311;162;149
Prienai d. mun.;2014;38;290;130;160
Prienai d. mun.;2014;39;329;176;153
Prienai d. mun.;2014;40;347;167;180
Prienai d. mun.;2014;41;389;198;191
Prienai d. mun.;2014;42;411;225;186
Prienai d. mun.;2014;43;378;181;197
Prienai d. mun.;2014;44;389;197;192
Prienai d. mun.;2014;45;421;194;227
Prienai d. mun.;2014;46;405;201;204
Prienai d. mun.;2014;47;428;223;205
Prienai d. mun.;2014;48;465;230;235
Prienai d. mun.;2014;49;452;231;221
Prienai d. mun.;2014;50;396;192;204
Prienai d. mun.;2014;51;452;216;236
Prienai d. mun.;2014;52;483;253;230
Prienai d. mun.;2014;53;475;230;245
Prienai d. mun.;2014;54;470;227;243
Prienai d. mun.;2014;55;441;225;216
Prienai d. mun.;2014;56;456;221;235
Prienai d. mun.;2014;57;391;181;210
Prienai d. mun.;2014;58;378;183;195
Prienai d. mun.;2014;59;379;186;193
Prienai d. mun.;2014;60;329;155;174
Prienai d. mun.;2014;61;317;147;170
Prienai d. mun.;2014;62;337;165;172
Prienai d. mun.;2014;63;319;147;172
Prienai d. mun.;2014;64;325;137;188
Prienai d. mun.;2014;65;293;128;165
Prienai d. mun.;2014;66;265;113;152
Prienai d. mun.;2014;67;248;106;142
Prienai d. mun.;2014;68;313;116;197
Prienai d. mun.;2014;69;239;106;133
Prienai d. mun.;2014;70;311;122;189
Prienai d. mun.;2014;71;319;114;205
Prienai d. mun.;2014;72;314;125;189
Prienai d. mun.;2014;73;290;103;187
Prienai d. mun.;2014;74;276;110;166
Prienai d. mun.;2014;75;309;109;200
Prienai d. mun.;2014;76;302;103;199
Prienai d. mun.;2014;77;294;100;194
Prienai d. mun.;2014;78;260;90;170
Prienai d. mun.;2014;79;287;88;199
Prienai d. mun.;2014;80;235;73;162
Prienai d. mun.;2014;81;281;84;197
Prienai d. mun.;2014;82;245;60;185
Prienai d. mun.;2014;83;229;78;151
Prienai d. mun.;2014;84;164;52;112
Prienai d. mun.;2014;85;845;191;654
Prienai d. mun.;2015;-1;28181;13301;14880
Prienai d. mun.;2015;0;259;130;129
Prienai d. mun.;2015;1;246;127;119
Prienai d. mun.;2015;2;247;116;131
Prienai d. mun.;2015;3;252;134;118
Prienai d. mun.;2015;4;214;101;113
Prienai d. mun.;2015;5;232;127;105
Prienai d. mun.;2015;6;235;128;107
Prienai d. mun.;2015;7;215;106;109
Prienai d. mun.;2015;8;221;124;97
Prienai d. mun.;2015;9;257;122;135
Prienai d. mun.;2015;10;260;138;122
Prienai d. mun.;2015;11;289;141;148
Prienai d. mun.;2015;12;280;129;151
Prienai d. mun.;2015;13;280;143;137
Prienai d. mun.;2015;14;307;139;168
Prienai d. mun.;2015;15;328;165;163
Prienai d. mun.;2015;16;362;196;166
Prienai d. mun.;2015;17;361;208;153
Prienai d. mun.;2015;18;363;189;174
Prienai d. mun.;2015;19;380;192;188
Prienai d. mun.;2015;20;401;202;199
Prienai d. mun.;2015;21;445;236;209
Prienai d. mun.;2015;22;467;257;210
Prienai d. mun.;2015;23;388;196;192
Prienai d. mun.;2015;24;339;188;151
Prienai d. mun.;2015;25;385;226;159
Prienai d. mun.;2015;26;299;162;137
Prienai d. mun.;2015;27;321;174;147
Prienai d. mun.;2015;28;283;162;121
Prienai d. mun.;2015;29;274;147;127
Prienai d. mun.;2015;30;249;133;116
Prienai d. mun.;2015;31;253;125;128
Prienai d. mun.;2015;32;255;139;116
Prienai d. mun.;2015;33;268;144;124
Prienai d. mun.;2015;34;283;169;114
Prienai d. mun.;2015;35;276;130;146
Prienai d. mun.;2015;36;258;123;135
Prienai d. mun.;2015;37;290;154;136
Prienai d. mun.;2015;38;310;162;148
Prienai d. mun.;2015;39;288;132;156
Prienai d. mun.;2015;40;328;175;153
Prienai d. mun.;2015;41;348;163;185
Prienai d. mun.;2015;42;383;198;185
Prienai d. mun.;2015;43;411;226;185
Prienai d. mun.;2015;44;373;177;196
Prienai d. mun.;2015;45;389;197;192
Prienai d. mun.;2015;46;420;194;226
Prienai d. mun.;2015;47;408;204;204
Prienai d. mun.;2015;48;429;225;204
Prienai d. mun.;2015;49;462;230;232
Prienai d. mun.;2015;50;447;230;217
Prienai d. mun.;2015;51;396;193;203
Prienai d. mun.;2015;52;446;212;234
Prienai d. mun.;2015;53;481;252;229
Prienai d. mun.;2015;54;467;226;241
Prienai d. mun.;2015;55;463;221;242
Prienai d. mun.;2015;56;442;223;219
Prienai d. mun.;2015;57;453;220;233
Prienai d. mun.;2015;58;388;180;208
Prienai d. mun.;2015;59;375;181;194
Prienai d. mun.;2015;60;381;186;195
Prienai d. mun.;2015;61;329;155;174
Prienai d. mun.;2015;62;318;148;170
Prienai d. mun.;2015;63;333;161;172
Prienai d. mun.;2015;64;308;143;165
Prienai d. mun.;2015;65;324;136;188
Prienai d. mun.;2015;66;283;123;160
Prienai d. mun.;2015;67;259;112;147
Prienai d. mun.;2015;68;241;97;144
Prienai d. mun.;2015;69;301;108;193
Prienai d. mun.;2015;70;234;103;131
Prienai d. mun.;2015;71;304;117;187
Prienai d. mun.;2015;72;310;109;201
Prienai d. mun.;2015;73;303;120;183
Prienai d. mun.;2015;74;282;99;183
Prienai d. mun.;2015;75;263;105;158
Prienai d. mun.;2015;76;300;107;193
Prienai d. mun.;2015;77;292;98;194
Prienai d. mun.;2015;78;279;93;186
Prienai d. mun.;2015;79;252;85;167
Prienai d. mun.;2015;80;273;84;189
Prienai d. mun.;2015;81;213;64;149
Prienai d. mun.;2015;82;264;74;190
Prienai d. mun.;2015;83;230;55;175
Prienai d. mun.;2015;84;210;70;140
Prienai d. mun.;2015;85;866;206;660
Prienai d. mun.;2016;-1;27676;13065;14611
Prienai d. mun.;2016;0;280;145;135
Prienai d. mun.;2016;1;253;124;129
Prienai d. mun.;2016;2;246;130;116
Prienai d. mun.;2016;3;243;110;133
Prienai d. mun.;2016;4;242;132;110
Prienai d. mun.;2016;5;211;98;113
Prienai d. mun.;2016;6;227;121;106
Prienai d. mun.;2016;7;224;124;100
Prienai d. mun.;2016;8;211;103;108
Prienai d. mun.;2016;9;217;122;95
Prienai d. mun.;2016;10;257;125;132
Prienai d. mun.;2016;11;258;138;120
Prienai d. mun.;2016;12;284;136;148
Prienai d. mun.;2016;13;277;129;148
Prienai d. mun.;2016;14;277;142;135
Prienai d. mun.;2016;15;302;138;164
Prienai d. mun.;2016;16;324;167;157
Prienai d. mun.;2016;17;359;194;165
Prienai d. mun.;2016;18;359;207;152
Prienai d. mun.;2016;19;356;186;170
Prienai d. mun.;2016;20;373;190;183
Prienai d. mun.;2016;21;391;198;193
Prienai d. mun.;2016;22;434;229;205
Prienai d. mun.;2016;23;450;245;205
Prienai d. mun.;2016;24;374;186;188
Prienai d. mun.;2016;25;328;185;143
Prienai d. mun.;2016;26;366;217;149
Prienai d. mun.;2016;27;286;151;135
Prienai d. mun.;2016;28;313;166;147
Prienai d. mun.;2016;29;280;163;117
Prienai d. mun.;2016;30;260;139;121
Prienai d. mun.;2016;31;243;130;113
Prienai d. mun.;2016;32;239;115;124
Prienai d. mun.;2016;33;243;133;110
Prienai d. mun.;2016;34;260;139;121
Prienai d. mun.;2016;35;271;159;112
Prienai d. mun.;2016;36;268;123;145
Prienai d. mun.;2016;37;250;116;134
Prienai d. mun.;2016;38;285;153;132
Prienai d. mun.;2016;39;299;155;144
Prienai d. mun.;2016;40;286;135;151
Prienai d. mun.;2016;41;331;178;153
Prienai d. mun.;2016;42;351;168;183
Prienai d. mun.;2016;43;389;201;188
Prienai d. mun.;2016;44;401;220;181
Prienai d. mun.;2016;45;368;175;193
Prienai d. mun.;2016;46;386;194;192
Prienai d. mun.;2016;47;414;190;224
Prienai d. mun.;2016;48;400;200;200
Prienai d. mun.;2016;49;427;226;201
Prienai d. mun.;2016;50;462;229;233
Prienai d. mun.;2016;51;447;229;218
Prienai d. mun.;2016;52;389;189;200
Prienai d. mun.;2016;53;445;208;237
Prienai d. mun.;2016;54;478;252;226
Prienai d. mun.;2016;55;459;220;239
Prienai d. mun.;2016;56;462;220;242
Prienai d. mun.;2016;57;435;217;218
Prienai d. mun.;2016;58;448;219;229
Prienai d. mun.;2016;59;384;176;208
Prienai d. mun.;2016;60;375;179;196
Prienai d. mun.;2016;61;372;182;190
Prienai d. mun.;2016;62;323;154;169
Prienai d. mun.;2016;63;312;143;169
Prienai d. mun.;2016;64;320;154;166
Prienai d. mun.;2016;65;299;136;163
Prienai d. mun.;2016;66;307;128;179
Prienai d. mun.;2016;67;284;122;162
Prienai d. mun.;2016;68;256;108;148
Prienai d. mun.;2016;69;231;92;139
Prienai d. mun.;2016;70;290;103;187
Prienai d. mun.;2016;71;229;99;130
Prienai d. mun.;2016;72;300;113;187
Prienai d. mun.;2016;73;293;98;195
Prienai d. mun.;2016;74;295;111;184
Prienai d. mun.;2016;75;271;92;179
Prienai d. mun.;2016;76;250;98;152
Prienai d. mun.;2016;77;288;101;187
Prienai d. mun.;2016;78;281;92;189
Prienai d. mun.;2016;79;258;83;175
Prienai d. mun.;2016;80;234;81;153
Prienai d. mun.;2016;81;256;76;180
Prienai d. mun.;2016;82;207;61;146
Prienai d. mun.;2016;83;250;69;181
Prienai d. mun.;2016;84;208;49;159
Prienai d. mun.;2016;85;905;232;673
Prienai d. mun.;2017;-1;27121;12825;14296
Prienai d. mun.;2017;0;255;141;114
Prienai d. mun.;2017;1;267;138;129
Prienai d. mun.;2017;2;256;126;130
Prienai d. mun.;2017;3;238;125;113
Prienai d. mun.;2017;4;240;112;128
Prienai d. mun.;2017;5;239;129;110
Prienai d. mun.;2017;6;207;99;108
Prienai d. mun.;2017;7;219;113;106
Prienai d. mun.;2017;8;231;125;106
Prienai d. mun.;2017;9;208;100;108
Prienai d. mun.;2017;10;218;121;97
Prienai d. mun.;2017;11;247;121;126
Prienai d. mun.;2017;12;258;135;123
Prienai d. mun.;2017;13;281;133;148
Prienai d. mun.;2017;14;269;127;142
Prienai d. mun.;2017;15;271;137;134
Prienai d. mun.;2017;16;299;140;159
Prienai d. mun.;2017;17;321;167;154
Prienai d. mun.;2017;18;348;187;161
Prienai d. mun.;2017;19;352;202;150
Prienai d. mun.;2017;20;345;179;166
Prienai d. mun.;2017;21;363;189;174
Prienai d. mun.;2017;22;374;194;180
Prienai d. mun.;2017;23;416;224;192
Prienai d. mun.;2017;24;433;236;197
Prienai d. mun.;2017;25;354;173;181
Prienai d. mun.;2017;26;313;182;131
Prienai d. mun.;2017;27;335;201;134
Prienai d. mun.;2017;28;267;142;125
Prienai d. mun.;2017;29;292;154;138
Prienai d. mun.;2017;30;263;153;110
Prienai d. mun.;2017;31;232;123;109
Prienai d. mun.;2017;32;229;127;102
Prienai d. mun.;2017;33;234;115;119
Prienai d. mun.;2017;34;237;129;108
Prienai d. mun.;2017;35;236;127;109
Prienai d. mun.;2017;36;260;154;106
Prienai d. mun.;2017;37;258;119;139
Prienai d. mun.;2017;38;254;121;133
Prienai d. mun.;2017;39;287;154;133
Prienai d. mun.;2017;40;287;149;138
Prienai d. mun.;2017;41;284;134;150
Prienai d. mun.;2017;42;326;177;149
Prienai d. mun.;2017;43;350;166;184
Prienai d. mun.;2017;44;398;204;194
Prienai d. mun.;2017;45;393;218;175
Prienai d. mun.;2017;46;370;176;194
Prienai d. mun.;2017;47;379;191;188
Prienai d. mun.;2017;48;404;181;223
Prienai d. mun.;2017;49;404;202;202
Prienai d. mun.;2017;50;423;225;198
Prienai d. mun.;2017;51;452;226;226
Prienai d. mun.;2017;52;451;231;220
Prienai d. mun.;2017;53;396;193;203
Prienai d. mun.;2017;54;440;204;236
Prienai d. mun.;2017;55;469;247;222
Prienai d. mun.;2017;56;452;214;238
Prienai d. mun.;2017;57;453;214;239
Prienai d. mun.;2017;58;435;218;217
Prienai d. mun.;2017;59;443;214;229
Prienai d. mun.;2017;60;391;183;208
Prienai d. mun.;2017;61;374;176;198
Prienai d. mun.;2017;62;364;175;189
Prienai d. mun.;2017;63;316;152;164
Prienai d. mun.;2017;64;315;143;172
Prienai d. mun.;2017;65;319;151;168
Prienai d. mun.;2017;66;299;134;165
Prienai d. mun.;2017;67;299;122;177
Prienai d. mun.;2017;68;282;120;162
Prienai d. mun.;2017;69;253;104;149
Prienai d. mun.;2017;70;226;89;137
Prienai d. mun.;2017;71;287;103;184
Prienai d. mun.;2017;72;223;95;128
Prienai d. mun.;2017;73;292;111;181
Prienai d. mun.;2017;74;283;92;191
Prienai d. mun.;2017;75;280;101;179
Prienai d. mun.;2017;76;257;87;170
Prienai d. mun.;2017;77;241;92;149
Prienai d. mun.;2017;78;278;97;181
Prienai d. mun.;2017;79;269;86;183
Prienai d. mun.;2017;80;237;72;165
Prienai d. mun.;2017;81;225;75;150
Prienai d. mun.;2017;82;242;66;176
Prienai d. mun.;2017;83;195;54;141
Prienai d. mun.;2017;84;235;62;173
Prienai d. mun.;2017;85;924;225;699
Prienai d. mun.;2018;-1;26492;12536;13956
Prienai d. mun.;2018;0;224;109;115
Prienai d. mun.;2018;1;250;139;111
Prienai d. mun.;2018;2;261;140;121
Prienai d. mun.;2018;3;258;127;131
Prienai d. mun.;2018;4;234;124;110
Prienai d. mun.;2018;5;243;111;132
Prienai d. mun.;2018;6;236;127;109
Prienai d. mun.;2018;7;212;101;111
Prienai d. mun.;2018;8;220;114;106
Prienai d. mun.;2018;9;230;122;108
Prienai d. mun.;2018;10;202;96;106
Prienai d. mun.;2018;11;218;121;97
Prienai d. mun.;2018;12;246;122;124
Prienai d. mun.;2018;13;251;130;121
Prienai d. mun.;2018;14;280;135;145
Prienai d. mun.;2018;15;265;126;139
Prienai d. mun.;2018;16;272;137;135
Prienai d. mun.;2018;17;298;140;158
Prienai d. mun.;2018;18;316;167;149
Prienai d. mun.;2018;19;335;179;156
Prienai d. mun.;2018;20;336;195;141
Prienai d. mun.;2018;21;330;171;159
Prienai d. mun.;2018;22;347;186;161
Prienai d. mun.;2018;23;341;180;161
Prienai d. mun.;2018;24;389;210;179
Prienai d. mun.;2018;25;405;221;184
Prienai d. mun.;2018;26;328;160;168
Prienai d. mun.;2018;27;293;170;123
Prienai d. mun.;2018;28;304;188;116
Prienai d. mun.;2018;29;244;129;115
Prienai d. mun.;2018;30;279;150;129
Prienai d. mun.;2018;31;249;150;99
Prienai d. mun.;2018;32;215;113;102
Prienai d. mun.;2018;33;224;126;98
Prienai d. mun.;2018;34;226;104;122
Prienai d. mun.;2018;35;225;122;103
Prienai d. mun.;2018;36;239;129;110
Prienai d. mun.;2018;37;251;146;105
Prienai d. mun.;2018;38;257;114;143
Prienai d. mun.;2018;39;246;118;128
Prienai d. mun.;2018;40;285;152;133
Prienai d. mun.;2018;41;291;152;139
Prienai d. mun.;2018;42;277;129;148
Prienai d. mun.;2018;43;328;173;155
Prienai d. mun.;2018;44;344;165;179
Prienai d. mun.;2018;45;383;195;188
Prienai d. mun.;2018;46;389;216;173
Prienai d. mun.;2018;47;362;173;189
Prienai d. mun.;2018;48;370;185;185
Prienai d. mun.;2018;49;398;179;219
Prienai d. mun.;2018;50;395;195;200
Prienai d. mun.;2018;51;418;220;198
Prienai d. mun.;2018;52;443;220;223
Prienai d. mun.;2018;53;452;230;222
Prienai d. mun.;2018;54;390;187;203
Prienai d. mun.;2018;55;440;209;231
Prienai d. mun.;2018;56;461;243;218
Prienai d. mun.;2018;57;450;214;236
Prienai d. mun.;2018;58;446;206;240
Prienai d. mun.;2018;59;430;213;217
Prienai d. mun.;2018;60;437;210;227
Prienai d. mun.;2018;61;382;175;207
Prienai d. mun.;2018;62;358;167;191
Prienai d. mun.;2018;63;365;177;188
Prienai d. mun.;2018;64;309;144;165
Prienai d. mun.;2018;65;308;137;171
Prienai d. mun.;2018;66;312;146;166
Prienai d. mun.;2018;67;292;128;164
Prienai d. mun.;2018;68;294;118;176
Prienai d. mun.;2018;69;279;116;163
Prienai d. mun.;2018;70;249;102;147
Prienai d. mun.;2018;71;222;88;134
Prienai d. mun.;2018;72;282;98;184
Prienai d. mun.;2018;73;216;94;122
Prienai d. mun.;2018;74;279;105;174
Prienai d. mun.;2018;75;275;92;183
Prienai d. mun.;2018;76;272;100;172
Prienai d. mun.;2018;77;243;77;166
Prienai d. mun.;2018;78;228;85;143
Prienai d. mun.;2018;79;265;90;175
Prienai d. mun.;2018;80;256;80;176
Prienai d. mun.;2018;81;231;72;159
Prienai d. mun.;2018;82;213;73;140
Prienai d. mun.;2018;83;220;59;161
Prienai d. mun.;2018;84;177;51;126
Prienai d. mun.;2018;85;997;247;750
Radviliškis d. mun.;2001;-1;52203;24828;27375
Radviliškis d. mun.;2001;0;512;261;251
Radviliškis d. mun.;2001;1;558;280;278
Radviliškis d. mun.;2001;2;571;297;274
Radviliškis d. mun.;2001;3;618;287;331
Radviliškis d. mun.;2001;4;646;339;307
Radviliškis d. mun.;2001;5;651;322;329
Radviliškis d. mun.;2001;6;619;326;293
Radviliškis d. mun.;2001;7;740;377;363
Radviliškis d. mun.;2001;8;871;447;424
Radviliškis d. mun.;2001;9;862;416;446
Radviliškis d. mun.;2001;10;861;427;434
Radviliškis d. mun.;2001;11;854;451;403
Radviliškis d. mun.;2001;12;909;489;420
Radviliškis d. mun.;2001;13;873;469;404
Radviliškis d. mun.;2001;14;913;493;420
Radviliškis d. mun.;2001;15;911;436;475
Radviliškis d. mun.;2001;16;889;456;433
Radviliškis d. mun.;2001;17;886;477;409
Radviliškis d. mun.;2001;18;722;394;328
Radviliškis d. mun.;2001;19;649;348;301
Radviliškis d. mun.;2001;20;627;358;269
Radviliškis d. mun.;2001;21;573;324;249
Radviliškis d. mun.;2001;22;578;314;264
Radviliškis d. mun.;2001;23;632;354;278
Radviliškis d. mun.;2001;24;590;302;288
Radviliškis d. mun.;2001;25;575;283;292
Radviliškis d. mun.;2001;26;613;308;305
Radviliškis d. mun.;2001;27;594;308;286
Radviliškis d. mun.;2001;28;705;342;363
Radviliškis d. mun.;2001;29;764;405;359
Radviliškis d. mun.;2001;30;745;401;344
Radviliškis d. mun.;2001;31;702;334;368
Radviliškis d. mun.;2001;32;765;388;377
Radviliškis d. mun.;2001;33;736;367;369
Radviliškis d. mun.;2001;34;780;398;382
Radviliškis d. mun.;2001;35;720;356;364
Radviliškis d. mun.;2001;36;775;399;376
Radviliškis d. mun.;2001;37;795;398;397
Radviliškis d. mun.;2001;38;777;382;395
Radviliškis d. mun.;2001;39;825;430;395
Radviliškis d. mun.;2001;40;798;385;413
Radviliškis d. mun.;2001;41;757;392;365
Radviliškis d. mun.;2001;42;788;421;367
Radviliškis d. mun.;2001;43;743;362;381
Radviliškis d. mun.;2001;44;634;321;313
Radviliškis d. mun.;2001;45;631;320;311
Radviliškis d. mun.;2001;46;657;331;326
Radviliškis d. mun.;2001;47;538;267;271
Radviliškis d. mun.;2001;48;561;258;303
Radviliškis d. mun.;2001;49;575;289;286
Radviliškis d. mun.;2001;50;594;274;320
Radviliškis d. mun.;2001;51;536;256;280
Radviliškis d. mun.;2001;52;511;257;254
Radviliškis d. mun.;2001;53;522;262;260
Radviliškis d. mun.;2001;54;501;223;278
Radviliškis d. mun.;2001;55;573;254;319
Radviliškis d. mun.;2001;56;491;239;252
Radviliškis d. mun.;2001;57;593;268;325
Radviliškis d. mun.;2001;58;657;297;360
Radviliškis d. mun.;2001;59;628;294;334
Radviliškis d. mun.;2001;60;549;252;297
Radviliškis d. mun.;2001;61;569;231;338
Radviliškis d. mun.;2001;62;601;261;340
Radviliškis d. mun.;2001;63;550;242;308
Radviliškis d. mun.;2001;64;626;245;381
Radviliškis d. mun.;2001;65;532;201;331
Radviliškis d. mun.;2001;66;572;218;354
Radviliškis d. mun.;2001;67;536;213;323
Radviliškis d. mun.;2001;68;516;192;324
Radviliškis d. mun.;2001;69;490;182;308
Radviliškis d. mun.;2001;70;507;202;305
Radviliškis d. mun.;2001;71;471;176;295
Radviliškis d. mun.;2001;72;507;163;344
Radviliškis d. mun.;2001;73;453;170;283
Radviliškis d. mun.;2001;74;381;109;272
Radviliškis d. mun.;2001;75;380;110;270
Radviliškis d. mun.;2001;76;395;133;262
Radviliškis d. mun.;2001;77;323;80;243
Radviliškis d. mun.;2001;78;311;99;212
Radviliškis d. mun.;2001;79;246;60;186
Radviliškis d. mun.;2001;80;234;68;166
Radviliškis d. mun.;2001;81;165;46;119
Radviliškis d. mun.;2001;82;130;26;104
Radviliškis d. mun.;2001;83;113;37;76
Radviliškis d. mun.;2001;84;105;26;79
Radviliškis d. mun.;2001;85;667;173;494
Radviliškis d. mun.;2002;-1;51711;24583;27128
Radviliškis d. mun.;2002;0;484;266;218
Radviliškis d. mun.;2002;1;512;260;252
Radviliškis d. mun.;2002;2;552;276;276
Radviliškis d. mun.;2002;3;570;301;269
Radviliškis d. mun.;2002;4;608;286;322
Radviliškis d. mun.;2002;5;641;335;306
Radviliškis d. mun.;2002;6;649;322;327
Radviliškis d. mun.;2002;7;616;321;295
Radviliškis d. mun.;2002;8;739;375;364
Radviliškis d. mun.;2002;9;867;441;426
Radviliškis d. mun.;2002;10;856;414;442
Radviliškis d. mun.;2002;11;854;421;433
Radviliškis d. mun.;2002;12;842;445;397
Radviliškis d. mun.;2002;13;893;478;415
Radviliškis d. mun.;2002;14;866;464;402
Radviliškis d. mun.;2002;15;904;487;417
Radviliškis d. mun.;2002;16;900;431;469
Radviliškis d. mun.;2002;17;879;451;428
Radviliškis d. mun.;2002;18;869;470;399
Radviliškis d. mun.;2002;19;701;383;318
Radviliškis d. mun.;2002;20;635;340;295
Radviliškis d. mun.;2002;21;621;352;269
Radviliškis d. mun.;2002;22;583;329;254
Radviliškis d. mun.;2002;23;572;310;262
Radviliškis d. mun.;2002;24;616;343;273
Radviliškis d. mun.;2002;25;581;297;284
Radviliškis d. mun.;2002;26;562;274;288
Radviliškis d. mun.;2002;27;599;296;303
Radviliškis d. mun.;2002;28;582;297;285
Radviliškis d. mun.;2002;29;694;333;361
Radviliškis d. mun.;2002;30;746;397;349
Radviliškis d. mun.;2002;31;730;394;336
Radviliškis d. mun.;2002;32;687;325;362
Radviliškis d. mun.;2002;33;761;385;376
Radviliškis d. mun.;2002;34;728;364;364
Radviliškis d. mun.;2002;35;770;392;378
Radviliškis d. mun.;2002;36;709;351;358
Radviliškis d. mun.;2002;37;761;393;368
Radviliškis d. mun.;2002;38;783;389;394
Radviliškis d. mun.;2002;39;762;373;389
Radviliškis d. mun.;2002;40;807;417;390
Radviliškis d. mun.;2002;41;785;378;407
Radviliškis d. mun.;2002;42;751;388;363
Radviliškis d. mun.;2002;43;784;422;362
Radviliškis d. mun.;2002;44;730;357;373
Radviliškis d. mun.;2002;45;622;313;309
Radviliškis d. mun.;2002;46;622;316;306
Radviliškis d. mun.;2002;47;649;326;323
Radviliškis d. mun.;2002;48;522;259;263
Radviliškis d. mun.;2002;49;552;253;299
Radviliškis d. mun.;2002;50;574;287;287
Radviliškis d. mun.;2002;51;577;264;313
Radviliškis d. mun.;2002;52;533;256;277
Radviliškis d. mun.;2002;53;505;254;251
Radviliškis d. mun.;2002;54;513;257;256
Radviliškis d. mun.;2002;55;491;220;271
Radviliškis d. mun.;2002;56;554;241;313
Radviliškis d. mun.;2002;57;481;234;247
Radviliškis d. mun.;2002;58;579;258;321
Radviliškis d. mun.;2002;59;641;286;355
Radviliškis d. mun.;2002;60;613;282;331
Radviliškis d. mun.;2002;61;540;246;294
Radviliškis d. mun.;2002;62;556;221;335
Radviliškis d. mun.;2002;63;597;256;341
Radviliškis d. mun.;2002;64;545;235;310
Radviliškis d. mun.;2002;65;607;235;372
Radviliškis d. mun.;2002;66;528;199;329
Radviliškis d. mun.;2002;67;559;211;348
Radviliškis d. mun.;2002;68;525;206;319
Radviliškis d. mun.;2002;69;498;180;318
Radviliškis d. mun.;2002;70;489;181;308
Radviliškis d. mun.;2002;71;498;195;303
Radviliškis d. mun.;2002;72;458;169;289
Radviliškis d. mun.;2002;73;493;159;334
Radviliškis d. mun.;2002;74;432;162;270
Radviliškis d. mun.;2002;75;378;109;269
Radviliškis d. mun.;2002;76;363;103;260
Radviliškis d. mun.;2002;77;377;126;251
Radviliškis d. mun.;2002;78;319;76;243
Radviliškis d. mun.;2002;79;293;91;202
Radviliškis d. mun.;2002;80;234;60;174
Radviliškis d. mun.;2002;81;219;63;156
Radviliškis d. mun.;2002;82;155;47;108
Radviliškis d. mun.;2002;83;125;24;101
Radviliškis d. mun.;2002;84;101;29;72
Radviliškis d. mun.;2002;85;653;171;482
Radviliškis d. mun.;2003;-1;51212;24309;26903
Radviliškis d. mun.;2003;0;484;233;251
Radviliškis d. mun.;2003;1;484;267;217
Radviliškis d. mun.;2003;2;507;256;251
Radviliškis d. mun.;2003;3;545;270;275
Radviliškis d. mun.;2003;4;570;302;268
Radviliškis d. mun.;2003;5;614;287;327
Radviliškis d. mun.;2003;6;642;337;305
Radviliškis d. mun.;2003;7;645;321;324
Radviliškis d. mun.;2003;8;617;319;298
Radviliškis d. mun.;2003;9;741;376;365
Radviliškis d. mun.;2003;10;864;440;424
Radviliškis d. mun.;2003;11;848;409;439
Radviliškis d. mun.;2003;12;842;415;427
Radviliškis d. mun.;2003;13;821;435;386
Radviliškis d. mun.;2003;14;879;466;413
Radviliškis d. mun.;2003;15;841;452;389
Radviliškis d. mun.;2003;16;887;479;408
Radviliškis d. mun.;2003;17;883;423;460
Radviliškis d. mun.;2003;18;869;448;421
Radviliškis d. mun.;2003;19;858;463;395
Radviliškis d. mun.;2003;20;693;383;310
Radviliškis d. mun.;2003;21;632;338;294
Radviliškis d. mun.;2003;22;621;350;271
Radviliškis d. mun.;2003;23;576;324;252
Radviliškis d. mun.;2003;24;563;302;261
Radviliškis d. mun.;2003;25;618;345;273
Radviliškis d. mun.;2003;26;569;296;273
Radviliškis d. mun.;2003;27;551;264;287
Radviliškis d. mun.;2003;28;588;291;297
Radviliškis d. mun.;2003;29;574;298;276
Radviliškis d. mun.;2003;30;682;327;355
Radviliškis d. mun.;2003;31;728;387;341
Radviliškis d. mun.;2003;32;731;393;338
Radviliškis d. mun.;2003;33;679;322;357
Radviliškis d. mun.;2003;34;752;379;373
Radviliškis d. mun.;2003;35;725;364;361
Radviliškis d. mun.;2003;36;752;384;368
Radviliškis d. mun.;2003;37;694;343;351
Radviliškis d. mun.;2003;38;742;386;356
Radviliškis d. mun.;2003;39;775;385;390
Radviliškis d. mun.;2003;40;752;366;386
Radviliškis d. mun.;2003;41;806;417;389
Radviliškis d. mun.;2003;42;776;374;402
Radviliškis d. mun.;2003;43;750;389;361
Radviliškis d. mun.;2003;44;773;416;357
Radviliškis d. mun.;2003;45;724;355;369
Radviliškis d. mun.;2003;46;614;304;310
Radviliškis d. mun.;2003;47;608;308;300
Radviliškis d. mun.;2003;48;640;321;319
Radviliškis d. mun.;2003;49;511;251;260
Radviliškis d. mun.;2003;50;545;248;297
Radviliškis d. mun.;2003;51;565;282;283
Radviliškis d. mun.;2003;52;572;258;314
Radviliškis d. mun.;2003;53;528;254;274
Radviliškis d. mun.;2003;54;494;246;248
Radviliškis d. mun.;2003;55;507;255;252
Radviliškis d. mun.;2003;56;484;213;271
Radviliškis d. mun.;2003;57;550;238;312
Radviliškis d. mun.;2003;58;475;230;245
Radviliškis d. mun.;2003;59;565;250;315
Radviliškis d. mun.;2003;60;628;278;350
Radviliškis d. mun.;2003;61;603;272;331
Radviliškis d. mun.;2003;62;536;243;293
Radviliškis d. mun.;2003;63;550;218;332
Radviliškis d. mun.;2003;64;590;252;338
Radviliškis d. mun.;2003;65;538;230;308
Radviliškis d. mun.;2003;66;600;228;372
Radviliškis d. mun.;2003;67;517;192;325
Radviliškis d. mun.;2003;68;541;194;347
Radviliškis d. mun.;2003;69;507;194;313
Radviliškis d. mun.;2003;70;482;170;312
Radviliškis d. mun.;2003;71;477;178;299
Radviliškis d. mun.;2003;72;480;181;299
Radviliškis d. mun.;2003;73;437;154;283
Radviliškis d. mun.;2003;74;483;156;327
Radviliškis d. mun.;2003;75;408;147;261
Radviliškis d. mun.;2003;76;355;99;256
Radviliškis d. mun.;2003;77;348;96;252
Radviliškis d. mun.;2003;78;346;114;232
Radviliškis d. mun.;2003;79;300;68;232
Radviliškis d. mun.;2003;80;278;79;199
Radviliškis d. mun.;2003;81;213;52;161
Radviliškis d. mun.;2003;82;192;51;141
Radviliškis d. mun.;2003;83;140;42;98
Radviliškis d. mun.;2003;84;111;22;89
Radviliškis d. mun.;2003;85;627;165;462
Radviliškis d. mun.;2004;-1;50638;24014;26624
Radviliškis d. mun.;2004;0;460;236;224
Radviliškis d. mun.;2004;1;480;232;248
Radviliškis d. mun.;2004;2;479;264;215
Radviliškis d. mun.;2004;3;509;256;253
Radviliškis d. mun.;2004;4;547;271;276
Radviliškis d. mun.;2004;5;567;298;269
Radviliškis d. mun.;2004;6;610;286;324
Radviliškis d. mun.;2004;7;637;338;299
Radviliškis d. mun.;2004;8;644;320;324
Radviliškis d. mun.;2004;9;611;316;295
Radviliškis d. mun.;2004;10;745;379;366
Radviliškis d. mun.;2004;11;863;438;425
Radviliškis d. mun.;2004;12;839;409;430
Radviliškis d. mun.;2004;13;838;414;424
Radviliškis d. mun.;2004;14;810;432;378
Radviliškis d. mun.;2004;15;863;457;406
Radviliškis d. mun.;2004;16;828;445;383
Radviliškis d. mun.;2004;17;871;472;399
Radviliškis d. mun.;2004;18;862;413;449
Radviliškis d. mun.;2004;19;858;444;414
Radviliškis d. mun.;2004;20;847;459;388
Radviliškis d. mun.;2004;21;669;371;298
Radviliškis d. mun.;2004;22;609;323;286
Radviliškis d. mun.;2004;23;599;337;262
Radviliškis d. mun.;2004;24;559;317;242
Radviliškis d. mun.;2004;25;548;292;256
Radviliškis d. mun.;2004;26;594;328;266
Radviliškis d. mun.;2004;27;552;284;268
Radviliškis d. mun.;2004;28;528;249;279
Radviliškis d. mun.;2004;29;575;279;296
Radviliškis d. mun.;2004;30;564;291;273
Radviliškis d. mun.;2004;31;666;315;351
Radviliškis d. mun.;2004;32;720;386;334
Radviliškis d. mun.;2004;33;723;391;332
Radviliškis d. mun.;2004;34;670;316;354
Radviliškis d. mun.;2004;35;747;377;370
Radviliškis d. mun.;2004;36;714;357;357
Radviliškis d. mun.;2004;37;745;379;366
Radviliškis d. mun.;2004;38;682;338;344
Radviliškis d. mun.;2004;39;740;386;354
Radviliškis d. mun.;2004;40;763;379;384
Radviliškis d. mun.;2004;41;742;362;380
Radviliškis d. mun.;2004;42;791;410;381
Radviliškis d. mun.;2004;43;768;373;395
Radviliškis d. mun.;2004;44;743;382;361
Radviliškis d. mun.;2004;45;771;414;357
Radviliškis d. mun.;2004;46;714;349;365
Radviliškis d. mun.;2004;47;607;297;310
Radviliškis d. mun.;2004;48;602;307;295
Radviliškis d. mun.;2004;49;632;316;316
Radviliškis d. mun.;2004;50;505;249;256
Radviliškis d. mun.;2004;51;535;243;292
Radviliškis d. mun.;2004;52;556;274;282
Radviliškis d. mun.;2004;53;562;252;310
Radviliškis d. mun.;2004;54;531;257;274
Radviliškis d. mun.;2004;55;487;243;244
Radviliškis d. mun.;2004;56;491;247;244
Radviliškis d. mun.;2004;57;479;212;267
Radviliškis d. mun.;2004;58;543;235;308
Radviliškis d. mun.;2004;59;467;224;243
Radviliškis d. mun.;2004;60;556;245;311
Radviliškis d. mun.;2004;61;610;266;344
Radviliškis d. mun.;2004;62;592;268;324
Radviliškis d. mun.;2004;63;526;237;289
Radviliškis d. mun.;2004;64;545;211;334
Radviliškis d. mun.;2004;65;582;244;338
Radviliškis d. mun.;2004;66;521;218;303
Radviliškis d. mun.;2004;67;597;222;375
Radviliškis d. mun.;2004;68;508;186;322
Radviliškis d. mun.;2004;69;527;192;335
Radviliškis d. mun.;2004;70;493;185;308
Radviliškis d. mun.;2004;71;471;161;310
Radviliškis d. mun.;2004;72;461;167;294
Radviliškis d. mun.;2004;73;468;173;295
Radviliškis d. mun.;2004;74;416;144;272
Radviliškis d. mun.;2004;75;462;146;316
Radviliškis d. mun.;2004;76;383;134;249
Radviliškis d. mun.;2004;77;344;97;247
Radviliškis d. mun.;2004;78;336;90;246
Radviliškis d. mun.;2004;79;329;108;221
Radviliškis d. mun.;2004;80;281;63;218
Radviliškis d. mun.;2004;81;265;72;193
Radviliškis d. mun.;2004;82;198;46;152
Radviliškis d. mun.;2004;83;172;43;129
Radviliškis d. mun.;2004;84;122;31;91
Radviliškis d. mun.;2004;85;612;145;467
Radviliškis d. mun.;2005;-1;49668;23531;26137
Radviliškis d. mun.;2005;0;482;264;218
Radviliškis d. mun.;2005;1;447;227;220
Radviliškis d. mun.;2005;2;474;229;245
Radviliškis d. mun.;2005;3;471;262;209
Radviliškis d. mun.;2005;4;503;252;251
Radviliškis d. mun.;2005;5;540;269;271
Radviliškis d. mun.;2005;6;569;297;272
Radviliškis d. mun.;2005;7;603;285;318
Radviliškis d. mun.;2005;8;631;335;296
Radviliškis d. mun.;2005;9;641;318;323
Radviliškis d. mun.;2005;10;609;314;295
Radviliškis d. mun.;2005;11;737;370;367
Radviliškis d. mun.;2005;12;853;430;423
Radviliškis d. mun.;2005;13;830;402;428
Radviliškis d. mun.;2005;14;825;406;419
Radviliškis d. mun.;2005;15;793;421;372
Radviliškis d. mun.;2005;16;847;448;399
Radviliškis d. mun.;2005;17;812;436;376
Radviliškis d. mun.;2005;18;852;464;388
Radviliškis d. mun.;2005;19;843;402;441
Radviliškis d. mun.;2005;20;838;434;404
Radviliškis d. mun.;2005;21;816;442;374
Radviliškis d. mun.;2005;22;643;359;284
Radviliškis d. mun.;2005;23;583;310;273
Radviliškis d. mun.;2005;24;562;317;245
Radviliškis d. mun.;2005;25;507;293;214
Radviliškis d. mun.;2005;26;524;277;247
Radviliškis d. mun.;2005;27;570;309;261
Radviliškis d. mun.;2005;28;532;272;260
Radviliškis d. mun.;2005;29;506;236;270
Radviliškis d. mun.;2005;30;548;265;283
Radviliškis d. mun.;2005;31;550;280;270
Radviliškis d. mun.;2005;32;654;308;346
Radviliškis d. mun.;2005;33;707;376;331
Radviliškis d. mun.;2005;34;710;382;328
Radviliškis d. mun.;2005;35;655;311;344
Radviliškis d. mun.;2005;36;730;371;359
Radviliškis d. mun.;2005;37;703;350;353
Radviliškis d. mun.;2005;38;730;370;360
Radviliškis d. mun.;2005;39;670;333;337
Radviliškis d. mun.;2005;40;731;380;351
Radviliškis d. mun.;2005;41;752;374;378
Radviliškis d. mun.;2005;42;729;352;377
Radviliškis d. mun.;2005;43;779;400;379
Radviliškis d. mun.;2005;44;758;368;390
Radviliškis d. mun.;2005;45;734;381;353
Radviliškis d. mun.;2005;46;764;409;355
Radviliškis d. mun.;2005;47;708;346;362
Radviliškis d. mun.;2005;48;600;294;306
Radviliškis d. mun.;2005;49;594;302;292
Radviliškis d. mun.;2005;50;623;309;314
Radviliškis d. mun.;2005;51;499;243;256
Radviliškis d. mun.;2005;52;517;234;283
Radviliškis d. mun.;2005;53;545;267;278
Radviliškis d. mun.;2005;54;552;244;308
Radviliškis d. mun.;2005;55;527;252;275
Radviliškis d. mun.;2005;56;479;241;238
Radviliškis d. mun.;2005;57;482;238;244
Radviliškis d. mun.;2005;58;473;210;263
Radviliškis d. mun.;2005;59;530;232;298
Radviliškis d. mun.;2005;60;454;215;239
Radviliškis d. mun.;2005;61;537;231;306
Radviliškis d. mun.;2005;62;596;256;340
Radviliškis d. mun.;2005;63;575;255;320
Radviliškis d. mun.;2005;64;510;227;283
Radviliškis d. mun.;2005;65;527;198;329
Radviliškis d. mun.;2005;66;570;239;331
Radviliškis d. mun.;2005;67;502;208;294
Radviliškis d. mun.;2005;68;576;208;368
Radviliškis d. mun.;2005;69;496;180;316
Radviliškis d. mun.;2005;70;509;177;332
Radviliškis d. mun.;2005;71;469;170;299
Radviliškis d. mun.;2005;72;451;153;298
Radviliškis d. mun.;2005;73;441;158;283
Radviliškis d. mun.;2005;74;445;162;283
Radviliškis d. mun.;2005;75;406;141;265
Radviliškis d. mun.;2005;76;435;138;297
Radviliškis d. mun.;2005;77;354;119;235
Radviliškis d. mun.;2005;78;322;92;230
Radviliškis d. mun.;2005;79;313;85;228
Radviliškis d. mun.;2005;80;302;96;206
Radviliškis d. mun.;2005;81;254;53;201
Radviliškis d. mun.;2005;82;244;66;178
Radviliškis d. mun.;2005;83;179;38;141
Radviliškis d. mun.;2005;84;149;34;115
Radviliškis d. mun.;2005;85;576;130;446
Radviliškis d. mun.;2006;-1;48474;22837;25637
Radviliškis d. mun.;2006;0;427;226;201
Radviliškis d. mun.;2006;1;473;253;220
Radviliškis d. mun.;2006;2;439;223;216
Radviliškis d. mun.;2006;3;465;225;240
Radviliškis d. mun.;2006;4;460;255;205
Radviliškis d. mun.;2006;5;500;250;250
Radviliškis d. mun.;2006;6;531;265;266
Radviliškis d. mun.;2006;7;563;292;271
Radviliškis d. mun.;2006;8;598;280;318
Radviliškis d. mun.;2006;9;626;334;292
Radviliškis d. mun.;2006;10;634;317;317
Radviliškis d. mun.;2006;11;604;310;294
Radviliškis d. mun.;2006;12;734;368;366
Radviliškis d. mun.;2006;13;835;418;417
Radviliškis d. mun.;2006;14;810;392;418
Radviliškis d. mun.;2006;15;803;396;407
Radviliškis d. mun.;2006;16;767;407;360
Radviliškis d. mun.;2006;17;823;434;389
Radviliškis d. mun.;2006;18;778;417;361
Radviliškis d. mun.;2006;19;809;434;375
Radviliškis d. mun.;2006;20;807;381;426
Radviliškis d. mun.;2006;21;780;403;377
Radviliškis d. mun.;2006;22;770;417;353
Radviliškis d. mun.;2006;23;605;334;271
Radviliškis d. mun.;2006;24;544;294;250
Radviliškis d. mun.;2006;25;524;291;233
Radviliškis d. mun.;2006;26;467;267;200
Radviliškis d. mun.;2006;27;488;254;234
Radviliškis d. mun.;2006;28;548;296;252
Radviliškis d. mun.;2006;29;518;263;255
Radviliškis d. mun.;2006;30;495;231;264
Radviliškis d. mun.;2006;31;535;263;272
Radviliškis d. mun.;2006;32;537;271;266
Radviliškis d. mun.;2006;33;634;295;339
Radviliškis d. mun.;2006;34;681;356;325
Radviliškis d. mun.;2006;35;690;372;318
Radviliškis d. mun.;2006;36;639;299;340
Radviliškis d. mun.;2006;37;715;359;356
Radviliškis d. mun.;2006;38;692;339;353
Radviliškis d. mun.;2006;39;712;354;358
Radviliškis d. mun.;2006;40;650;322;328
Radviliškis d. mun.;2006;41;721;373;348
Radviliškis d. mun.;2006;42;731;363;368
Radviliškis d. mun.;2006;43;715;339;376
Radviliškis d. mun.;2006;44;765;390;375
Radviliškis d. mun.;2006;45;742;358;384
Radviliškis d. mun.;2006;46;720;368;352
Radviliškis d. mun.;2006;47;748;397;351
Radviliškis d. mun.;2006;48;703;342;361
Radviliškis d. mun.;2006;49;585;285;300
Radviliškis d. mun.;2006;50;579;291;288
Radviliškis d. mun.;2006;51;610;299;311
Radviliškis d. mun.;2006;52;492;240;252
Radviliškis d. mun.;2006;53;503;223;280
Radviliškis d. mun.;2006;54;537;261;276
Radviliškis d. mun.;2006;55;543;240;303
Radviliškis d. mun.;2006;56;514;242;272
Radviliškis d. mun.;2006;57;466;232;234
Radviliškis d. mun.;2006;58;474;231;243
Radviliškis d. mun.;2006;59;466;208;258
Radviliškis d. mun.;2006;60;517;223;294
Radviliškis d. mun.;2006;61;440;206;234
Radviliškis d. mun.;2006;62;526;221;305
Radviliškis d. mun.;2006;63;581;245;336
Radviliškis d. mun.;2006;64;560;245;315
Radviliškis d. mun.;2006;65;500;216;284
Radviliškis d. mun.;2006;66;521;194;327
Radviliškis d. mun.;2006;67;550;226;324
Radviliškis d. mun.;2006;68;483;195;288
Radviliškis d. mun.;2006;69;565;200;365
Radviliškis d. mun.;2006;70;483;175;308
Radviliškis d. mun.;2006;71;490;170;320
Radviliškis d. mun.;2006;72;450;161;289
Radviliškis d. mun.;2006;73;433;145;288
Radviliškis d. mun.;2006;74;424;150;274
Radviliškis d. mun.;2006;75;419;148;271
Radviliškis d. mun.;2006;76;389;131;258
Radviliškis d. mun.;2006;77;416;124;292
Radviliškis d. mun.;2006;78;323;103;220
Radviliškis d. mun.;2006;79;304;87;217
Radviliškis d. mun.;2006;80;292;75;217
Radviliškis d. mun.;2006;81;272;84;188
Radviliškis d. mun.;2006;82;239;53;186
Radviliškis d. mun.;2006;83;213;55;158
Radviliškis d. mun.;2006;84;162;31;131
Radviliškis d. mun.;2006;85;598;135;463
Radviliškis d. mun.;2007;-1;47500;22296;25204
Radviliškis d. mun.;2007;0;466;236;230
Radviliškis d. mun.;2007;1;424;223;201
Radviliškis d. mun.;2007;2;469;248;221
Radviliškis d. mun.;2007;3;439;221;218
Radviliškis d. mun.;2007;4;455;223;232
Radviliškis d. mun.;2007;5;457;252;205
Radviliškis d. mun.;2007;6;494;245;249
Radviliškis d. mun.;2007;7;522;258;264
Radviliškis d. mun.;2007;8;555;284;271
Radviliškis d. mun.;2007;9;586;279;307
Radviliškis d. mun.;2007;10;620;325;295
Radviliškis d. mun.;2007;11;623;310;313
Radviliškis d. mun.;2007;12;598;308;290
Radviliškis d. mun.;2007;13;727;361;366
Radviliškis d. mun.;2007;14;824;411;413
Radviliškis d. mun.;2007;15;809;389;420
Radviliškis d. mun.;2007;16;786;388;398
Radviliškis d. mun.;2007;17;752;400;352
Radviliškis d. mun.;2007;18;808;423;385
Radviliškis d. mun.;2007;19;764;409;355
Radviliškis d. mun.;2007;20;792;417;375
Radviliškis d. mun.;2007;21;774;362;412
Radviliškis d. mun.;2007;22;746;386;360
Radviliškis d. mun.;2007;23;737;400;337
Radviliškis d. mun.;2007;24;588;323;265
Radviliškis d. mun.;2007;25;526;278;248
Radviliškis d. mun.;2007;26;493;274;219
Radviliškis d. mun.;2007;27;451;263;188
Radviliškis d. mun.;2007;28;472;247;225
Radviliškis d. mun.;2007;29;525;282;243
Radviliškis d. mun.;2007;30;500;256;244
Radviliškis d. mun.;2007;31;481;223;258
Radviliškis d. mun.;2007;32;530;262;268
Radviliškis d. mun.;2007;33;521;264;257
Radviliškis d. mun.;2007;34;623;289;334
Radviliškis d. mun.;2007;35;671;352;319
Radviliškis d. mun.;2007;36;682;364;318
Radviliškis d. mun.;2007;37;630;293;337
Radviliškis d. mun.;2007;38;703;350;353
Radviliškis d. mun.;2007;39;681;337;344
Radviliškis d. mun.;2007;40;696;342;354
Radviliškis d. mun.;2007;41;635;313;322
Radviliškis d. mun.;2007;42;705;363;342
Radviliškis d. mun.;2007;43;716;353;363
Radviliškis d. mun.;2007;44;701;332;369
Radviliškis d. mun.;2007;45;751;383;368
Radviliškis d. mun.;2007;46;732;350;382
Radviliškis d. mun.;2007;47;708;360;348
Radviliškis d. mun.;2007;48;729;384;345
Radviliškis d. mun.;2007;49;688;332;356
Radviliškis d. mun.;2007;50;568;271;297
Radviliškis d. mun.;2007;51;570;285;285
Radviliškis d. mun.;2007;52;593;285;308
Radviliškis d. mun.;2007;53;483;235;248
Radviliškis d. mun.;2007;54;499;221;278
Radviliškis d. mun.;2007;55;525;257;268
Radviliškis d. mun.;2007;56;534;231;303
Radviliškis d. mun.;2007;57;509;238;271
Radviliškis d. mun.;2007;58;460;226;234
Radviliškis d. mun.;2007;59;463;225;238
Radviliškis d. mun.;2007;60;446;194;252
Radviliškis d. mun.;2007;61;505;215;290
Radviliškis d. mun.;2007;62;430;200;230
Radviliškis d. mun.;2007;63;508;212;296
Radviliškis d. mun.;2007;64;565;232;333
Radviliškis d. mun.;2007;65;540;233;307
Radviliškis d. mun.;2007;66;476;198;278
Radviliškis d. mun.;2007;67;497;182;315
Radviliškis d. mun.;2007;68;534;214;320
Radviliškis d. mun.;2007;69;466;186;280
Radviliškis d. mun.;2007;70;533;183;350
Radviliškis d. mun.;2007;71;476;173;303
Radviliškis d. mun.;2007;72;465;157;308
Radviliškis d. mun.;2007;73;424;142;282
Radviliškis d. mun.;2007;74;410;131;279
Radviliškis d. mun.;2007;75;392;134;258
Radviliškis d. mun.;2007;76;401;140;261
Radviliškis d. mun.;2007;77;361;118;243
Radviliškis d. mun.;2007;78;386;113;273
Radviliškis d. mun.;2007;79;299;93;206
Radviliškis d. mun.;2007;80;278;78;200
Radviliškis d. mun.;2007;81;265;68;197
Radviliškis d. mun.;2007;82;247;74;173
Radviliškis d. mun.;2007;83;213;43;170
Radviliškis d. mun.;2007;84;202;53;149
Radviliškis d. mun.;2007;85;612;129;483
Radviliškis d. mun.;2008;-1;46681;21904;24777
Radviliškis d. mun.;2008;0;434;208;226
Radviliškis d. mun.;2008;1;466;239;227
Radviliškis d. mun.;2008;2;416;219;197
Radviliškis d. mun.;2008;3;468;247;221
Radviliškis d. mun.;2008;4;433;219;214
Radviliškis d. mun.;2008;5;448;216;232
Radviliškis d. mun.;2008;6;448;248;200
Radviliškis d. mun.;2008;7;488;246;242
Radviliškis d. mun.;2008;8;520;262;258
Radviliškis d. mun.;2008;9;551;283;268
Radviliškis d. mun.;2008;10;589;280;309
Radviliškis d. mun.;2008;11;621;325;296
Radviliškis d. mun.;2008;12;623;311;312
Radviliškis d. mun.;2008;13;597;305;292
Radviliškis d. mun.;2008;14;726;358;368
Radviliškis d. mun.;2008;15;818;408;410
Radviliškis d. mun.;2008;16;797;380;417
Radviliškis d. mun.;2008;17;778;389;389
Radviliškis d. mun.;2008;18;736;394;342
Radviliškis d. mun.;2008;19;791;415;376
Radviliškis d. mun.;2008;20;751;405;346
Radviliškis d. mun.;2008;21;773;411;362
Radviliškis d. mun.;2008;22;753;350;403
Radviliškis d. mun.;2008;23;713;371;342
Radviliškis d. mun.;2008;24;713;389;324
Radviliškis d. mun.;2008;25;564;315;249
Radviliškis d. mun.;2008;26;503;268;235
Radviliškis d. mun.;2008;27;470;262;208
Radviliškis d. mun.;2008;28;422;242;180
Radviliškis d. mun.;2008;29;449;235;214
Radviliškis d. mun.;2008;30;510;272;238
Radviliškis d. mun.;2008;31;488;244;244
Radviliškis d. mun.;2008;32;471;217;254
Radviliškis d. mun.;2008;33;520;255;265
Radviliškis d. mun.;2008;34;521;264;257
Radviliškis d. mun.;2008;35;619;283;336
Radviliškis d. mun.;2008;36;673;358;315
Radviliškis d. mun.;2008;37;672;355;317
Radviliškis d. mun.;2008;38;623;288;335
Radviliškis d. mun.;2008;39;690;345;345
Radviliškis d. mun.;2008;40;666;333;333
Radviliškis d. mun.;2008;41;683;333;350
Radviliškis d. mun.;2008;42;629;311;318
Radviliškis d. mun.;2008;43;694;358;336
Radviliškis d. mun.;2008;44;703;347;356
Radviliškis d. mun.;2008;45;694;326;368
Radviliškis d. mun.;2008;46;748;380;368
Radviliškis d. mun.;2008;47;731;350;381
Radviliškis d. mun.;2008;48;700;355;345
Radviliškis d. mun.;2008;49;725;379;346
Radviliškis d. mun.;2008;50;671;324;347
Radviliškis d. mun.;2008;51;560;261;299
Radviliškis d. mun.;2008;52;558;278;280
Radviliškis d. mun.;2008;53;580;275;305
Radviliškis d. mun.;2008;54;472;229;243
Radviliškis d. mun.;2008;55;487;213;274
Radviliškis d. mun.;2008;56;512;248;264
Radviliškis d. mun.;2008;57;522;224;298
Radviliškis d. mun.;2008;58;493;226;267
Radviliškis d. mun.;2008;59;451;218;233
Radviliškis d. mun.;2008;60;448;215;233
Radviliškis d. mun.;2008;61;437;190;247
Radviliškis d. mun.;2008;62;497;212;285
Radviliškis d. mun.;2008;63;411;184;227
Radviliškis d. mun.;2008;64;495;205;290
Radviliškis d. mun.;2008;65;554;226;328
Radviliškis d. mun.;2008;66;520;219;301
Radviliškis d. mun.;2008;67;449;180;269
Radviliškis d. mun.;2008;68;479;172;307
Radviliškis d. mun.;2008;69;513;203;310
Radviliškis d. mun.;2008;70;442;170;272
Radviliškis d. mun.;2008;71;518;176;342
Radviliškis d. mun.;2008;72;458;167;291
Radviliškis d. mun.;2008;73;438;144;294
Radviliškis d. mun.;2008;74;402;136;266
Radviliškis d. mun.;2008;75;388;122;266
Radviliškis d. mun.;2008;76;373;124;249
Radviliškis d. mun.;2008;77;381;131;250
Radviliškis d. mun.;2008;78;330;101;229
Radviliškis d. mun.;2008;79;354;100;254
Radviliškis d. mun.;2008;80;279;82;197
Radviliškis d. mun.;2008;81;255;72;183
Radviliškis d. mun.;2008;82;238;57;181
Radviliškis d. mun.;2008;83;222;67;155
Radviliškis d. mun.;2008;84;191;39;152
Radviliškis d. mun.;2008;85;684;161;523
Radviliškis d. mun.;2009;-1;45668;21452;24216
Radviliškis d. mun.;2009;0;409;208;201
Radviliškis d. mun.;2009;1;430;207;223
Radviliškis d. mun.;2009;2;454;231;223
Radviliškis d. mun.;2009;3;397;213;184
Radviliškis d. mun.;2009;4;461;246;215
Radviliškis d. mun.;2009;5;424;213;211
Radviliškis d. mun.;2009;6;445;217;228
Radviliškis d. mun.;2009;7;445;246;199
Radviliškis d. mun.;2009;8;479;240;239
Radviliškis d. mun.;2009;9;505;251;254
Radviliškis d. mun.;2009;10;545;280;265
Radviliškis d. mun.;2009;11;582;276;306
Radviliškis d. mun.;2009;12;620;323;297
Radviliškis d. mun.;2009;13;611;308;303
Radviliškis d. mun.;2009;14;595;303;292
Radviliškis d. mun.;2009;15;728;359;369
Radviliškis d. mun.;2009;16;803;400;403
Radviliškis d. mun.;2009;17;782;373;409
Radviliškis d. mun.;2009;18;770;385;385
Radviliškis d. mun.;2009;19;726;393;333
Radviliškis d. mun.;2009;20;787;410;377
Radviliškis d. mun.;2009;21;736;400;336
Radviliškis d. mun.;2009;22;752;399;353
Radviliškis d. mun.;2009;23;719;337;382
Radviliškis d. mun.;2009;24;672;354;318
Radviliškis d. mun.;2009;25;661;369;292
Radviliškis d. mun.;2009;26;522;291;231
Radviliškis d. mun.;2009;27;467;258;209
Radviliškis d. mun.;2009;28;438;246;192
Radviliškis d. mun.;2009;29;400;234;166
Radviliškis d. mun.;2009;30;430;226;204
Radviliškis d. mun.;2009;31;493;269;224
Radviliškis d. mun.;2009;32;462;230;232
Radviliškis d. mun.;2009;33;453;207;246
Radviliškis d. mun.;2009;34;509;247;262
Radviliškis d. mun.;2009;35;507;257;250
Radviliškis d. mun.;2009;36;591;275;316
Radviliškis d. mun.;2009;37;658;349;309
Radviliškis d. mun.;2009;38;660;349;311
Radviliškis d. mun.;2009;39;618;288;330
Radviliškis d. mun.;2009;40;676;339;337
Radviliškis d. mun.;2009;41;655;327;328
Radviliškis d. mun.;2009;42;680;332;348
Radviliškis d. mun.;2009;43;612;303;309
Radviliškis d. mun.;2009;44;686;355;331
Radviliškis d. mun.;2009;45;699;344;355
Radviliškis d. mun.;2009;46;681;321;360
Radviliškis d. mun.;2009;47;734;369;365
Radviliškis d. mun.;2009;48;712;335;377
Radviliškis d. mun.;2009;49;682;341;341
Radviliškis d. mun.;2009;50;711;372;339
Radviliškis d. mun.;2009;51;665;320;345
Radviliškis d. mun.;2009;52;547;253;294
Radviliškis d. mun.;2009;53;550;275;275
Radviliškis d. mun.;2009;54;563;268;295
Radviliškis d. mun.;2009;55;460;225;235
Radviliškis d. mun.;2009;56;480;211;269
Radviliškis d. mun.;2009;57;503;242;261
Radviliškis d. mun.;2009;58;513;218;295
Radviliškis d. mun.;2009;59;485;222;263
Radviliškis d. mun.;2009;60;438;213;225
Radviliškis d. mun.;2009;61;440;209;231
Radviliškis d. mun.;2009;62;423;179;244
Radviliškis d. mun.;2009;63;484;204;280
Radviliškis d. mun.;2009;64;397;177;220
Radviliškis d. mun.;2009;65;471;188;283
Radviliškis d. mun.;2009;66;539;220;319
Radviliškis d. mun.;2009;67;504;206;298
Radviliškis d. mun.;2009;68;440;173;267
Radviliškis d. mun.;2009;69;457;166;291
Radviliškis d. mun.;2009;70;494;188;306
Radviliškis d. mun.;2009;71;421;154;267
Radviliškis d. mun.;2009;72;506;171;335
Radviliškis d. mun.;2009;73;442;160;282
Radviliškis d. mun.;2009;74;424;136;288
Radviliškis d. mun.;2009;75;381;125;256
Radviliškis d. mun.;2009;76;366;114;252
Radviliškis d. mun.;2009;77;361;116;245
Radviliškis d. mun.;2009;78;364;117;247
Radviliškis d. mun.;2009;79;309;92;217
Radviliškis d. mun.;2009;80;326;94;232
Radviliškis d. mun.;2009;81;262;74;188
Radviliškis d. mun.;2009;82;233;62;171
Radviliškis d. mun.;2009;83;218;50;168
Radviliškis d. mun.;2009;84;204;63;141
Radviliškis d. mun.;2009;85;724;162;562
Radviliškis d. mun.;2010;-1;44518;20840;23678
Radviliškis d. mun.;2010;0;383;204;179
Radviliškis d. mun.;2010;1;395;199;196
Radviliškis d. mun.;2010;2;426;205;221
Radviliškis d. mun.;2010;3;436;219;217
Radviliškis d. mun.;2010;4;397;214;183
Radviliškis d. mun.;2010;5;447;237;210
Radviliškis d. mun.;2010;6;419;213;206
Radviliškis d. mun.;2010;7;434;211;223
Radviliškis d. mun.;2010;8;441;244;197
Radviliškis d. mun.;2010;9;473;237;236
Radviliškis d. mun.;2010;10;505;250;255
Radviliškis d. mun.;2010;11;534;273;261
Radviliškis d. mun.;2010;12;578;272;306
Radviliškis d. mun.;2010;13;622;324;298
Radviliškis d. mun.;2010;14;606;305;301
Radviliškis d. mun.;2010;15;586;296;290
Radviliškis d. mun.;2010;16;722;356;366
Radviliškis d. mun.;2010;17;789;392;397
Radviliškis d. mun.;2010;18;773;368;405
Radviliškis d. mun.;2010;19;754;379;375
Radviliškis d. mun.;2010;20;708;381;327
Radviliškis d. mun.;2010;21;757;393;364
Radviliškis d. mun.;2010;22;706;380;326
Radviliškis d. mun.;2010;23;703;379;324
Radviliškis d. mun.;2010;24;690;325;365
Radviliškis d. mun.;2010;25;632;333;299
Radviliškis d. mun.;2010;26;607;344;263
Radviliškis d. mun.;2010;27;478;268;210
Radviliškis d. mun.;2010;28;426;239;187
Radviliškis d. mun.;2010;29;406;232;174
Radviliškis d. mun.;2010;30;372;215;157
Radviliškis d. mun.;2010;31;400;208;192
Radviliškis d. mun.;2010;32;473;259;214
Radviliškis d. mun.;2010;33;446;224;222
Radviliškis d. mun.;2010;34;433;196;237
Radviliškis d. mun.;2010;35;487;235;252
Radviliškis d. mun.;2010;36;489;246;243
Radviliškis d. mun.;2010;37;573;263;310
Radviliškis d. mun.;2010;38;638;335;303
Radviliškis d. mun.;2010;39;645;338;307
Radviliškis d. mun.;2010;40;609;277;332
Radviliškis d. mun.;2010;41;658;329;329
Radviliškis d. mun.;2010;42;649;320;329
Radviliškis d. mun.;2010;43;672;326;346
Radviliškis d. mun.;2010;44;603;298;305
Radviliškis d. mun.;2010;45;668;344;324
Radviliškis d. mun.;2010;46;686;332;354
Radviliškis d. mun.;2010;47;675;315;360
Radviliškis d. mun.;2010;48;720;357;363
Radviliškis d. mun.;2010;49;702;328;374
Radviliškis d. mun.;2010;50;677;335;342
Radviliškis d. mun.;2010;51;697;363;334
Radviliškis d. mun.;2010;52;649;315;334
Radviliškis d. mun.;2010;53;534;245;289
Radviliškis d. mun.;2010;54;541;268;273
Radviliškis d. mun.;2010;55;552;259;293
Radviliškis d. mun.;2010;56;457;225;232
Radviliškis d. mun.;2010;57;474;205;269
Radviliškis d. mun.;2010;58;491;234;257
Radviliškis d. mun.;2010;59;501;210;291
Radviliškis d. mun.;2010;60;475;216;259
Radviliškis d. mun.;2010;61;423;202;221
Radviliškis d. mun.;2010;62;426;197;229
Radviliškis d. mun.;2010;63;418;179;239
Radviliškis d. mun.;2010;64;470;192;278
Radviliškis d. mun.;2010;65;387;170;217
Radviliškis d. mun.;2010;66;461;182;279
Radviliškis d. mun.;2010;67;528;212;316
Radviliškis d. mun.;2010;68;489;193;296
Radviliškis d. mun.;2010;69;422;161;261
Radviliškis d. mun.;2010;70;439;155;284
Radviliškis d. mun.;2010;71;478;175;303
Radviliškis d. mun.;2010;72;402;145;257
Radviliškis d. mun.;2010;73;490;164;326
Radviliškis d. mun.;2010;74;428;155;273
Radviliškis d. mun.;2010;75;402;130;272
Radviliškis d. mun.;2010;76;368;121;247
Radviliškis d. mun.;2010;77;356;106;250
Radviliškis d. mun.;2010;78;344;111;233
Radviliškis d. mun.;2010;79;330;100;230
Radviliškis d. mun.;2010;80;286;81;205
Radviliškis d. mun.;2010;81;299;83;216
Radviliškis d. mun.;2010;82;228;61;167
Radviliškis d. mun.;2010;83;203;50;153
Radviliškis d. mun.;2010;84;194;45;149
Radviliškis d. mun.;2010;85;768;178;590
Radviliškis d. mun.;2011;-1;42606;19927;22679
Radviliškis d. mun.;2011;0;373;191;182
Radviliškis d. mun.;2011;1;353;185;168
Radviliškis d. mun.;2011;2;381;202;179
Radviliškis d. mun.;2011;3;389;187;202
Radviliškis d. mun.;2011;4;418;210;208
Radviliškis d. mun.;2011;5;371;192;179
Radviliškis d. mun.;2011;6;432;228;204
Radviliškis d. mun.;2011;7;420;219;201
Radviliškis d. mun.;2011;8;424;207;217
Radviliškis d. mun.;2011;9;441;233;208
Radviliškis d. mun.;2011;10;466;239;227
Radviliškis d. mun.;2011;11;505;251;254
Radviliškis d. mun.;2011;12;520;267;253
Radviliškis d. mun.;2011;13;573;271;302
Radviliškis d. mun.;2011;14;608;317;291
Radviliškis d. mun.;2011;15;603;312;291
Radviliškis d. mun.;2011;16;571;297;274
Radviliškis d. mun.;2011;17;705;340;365
Radviliškis d. mun.;2011;18;749;378;371
Radviliškis d. mun.;2011;19;675;340;335
Radviliškis d. mun.;2011;20;588;306;282
Radviliškis d. mun.;2011;21;569;312;257
Radviliškis d. mun.;2011;22;575;304;271
Radviliškis d. mun.;2011;23;553;314;239
Radviliškis d. mun.;2011;24;531;309;222
Radviliškis d. mun.;2011;25;463;241;222
Radviliškis d. mun.;2011;26;443;245;198
Radviliškis d. mun.;2011;27;427;234;193
Radviliškis d. mun.;2011;28;387;216;171
Radviliškis d. mun.;2011;29;371;203;168
Radviliškis d. mun.;2011;30;404;208;196
Radviliškis d. mun.;2011;31;374;197;177
Radviliškis d. mun.;2011;32;370;183;187
Radviliškis d. mun.;2011;33;434;223;211
Radviliškis d. mun.;2011;34;445;207;238
Radviliškis d. mun.;2011;35;445;203;242
Radviliškis d. mun.;2011;36;531;251;280
Radviliškis d. mun.;2011;37;485;239;246
Radviliškis d. mun.;2011;38;587;283;304
Radviliškis d. mun.;2011;39;637;321;316
Radviliškis d. mun.;2011;40;656;347;309
Radviliškis d. mun.;2011;41;636;289;347
Radviliškis d. mun.;2011;42;671;346;325
Radviliškis d. mun.;2011;43;643;319;324
Radviliškis d. mun.;2011;44;672;338;334
Radviliškis d. mun.;2011;45;626;309;317
Radviliškis d. mun.;2011;46;689;354;335
Radviliškis d. mun.;2011;47;686;333;353
Radviliškis d. mun.;2011;48;687;328;359
Radviliškis d. mun.;2011;49;735;368;367
Radviliškis d. mun.;2011;50;674;318;356
Radviliškis d. mun.;2011;51;689;346;343
Radviliškis d. mun.;2011;52;709;365;344
Radviliškis d. mun.;2011;53;635;307;328
Radviliškis d. mun.;2011;54;560;270;290
Radviliškis d. mun.;2011;55;542;266;276
Radviliškis d. mun.;2011;56;569;269;300
Radviliškis d. mun.;2011;57;467;229;238
Radviliškis d. mun.;2011;58;483;208;275
Radviliškis d. mun.;2011;59;494;235;259
Radviliškis d. mun.;2011;60;497;205;292
Radviliškis d. mun.;2011;61;463;207;256
Radviliškis d. mun.;2011;62;431;202;229
Radviliškis d. mun.;2011;63;421;192;229
Radviliškis d. mun.;2011;64;416;173;243
Radviliškis d. mun.;2011;65;463;183;280
Radviliškis d. mun.;2011;66;382;159;223
Radviliškis d. mun.;2011;67;453;179;274
Radviliškis d. mun.;2011;68;517;200;317
Radviliškis d. mun.;2011;69;477;184;293
Radviliškis d. mun.;2011;70;420;162;258
Radviliškis d. mun.;2011;71;421;135;286
Radviliškis d. mun.;2011;72;463;169;294
Radviliškis d. mun.;2011;73;393;142;251
Radviliškis d. mun.;2011;74;467;147;320
Radviliškis d. mun.;2011;75;399;138;261
Radviliškis d. mun.;2011;76;380;119;261
Radviliškis d. mun.;2011;77;358;114;244
Radviliškis d. mun.;2011;78;324;94;230
Radviliškis d. mun.;2011;79;327;106;221
Radviliškis d. mun.;2011;80;312;96;216
Radviliškis d. mun.;2011;81;262;76;186
Radviliškis d. mun.;2011;82;265;73;192
Radviliškis d. mun.;2011;83;197;52;145
Radviliškis d. mun.;2011;84;175;38;137
Radviliškis d. mun.;2011;85;804;173;631
Radviliškis d. mun.;2012;-1;41489;19367;22122
Radviliškis d. mun.;2012;0;387;195;192
Radviliškis d. mun.;2012;1;366;187;179
Radviliškis d. mun.;2012;2;344;187;157
Radviliškis d. mun.;2012;3;378;202;176
Radviliškis d. mun.;2012;4;379;184;195
Radviliškis d. mun.;2012;5;405;201;204
Radviliškis d. mun.;2012;6;363;184;179
Radviliškis d. mun.;2012;7;415;218;197
Radviliškis d. mun.;2012;8;414;214;200
Radviliškis d. mun.;2012;9;425;204;221
Radviliškis d. mun.;2012;10;437;230;207
Radviliškis d. mun.;2012;11;459;237;222
Radviliškis d. mun.;2012;12;498;246;252
Radviliškis d. mun.;2012;13;518;265;253
Radviliškis d. mun.;2012;14;563;266;297
Radviliškis d. mun.;2012;15;602;315;287
Radviliškis d. mun.;2012;16;602;311;291
Radviliškis d. mun.;2012;17;559;293;266
Radviliškis d. mun.;2012;18;695;336;359
Radviliškis d. mun.;2012;19;721;364;357
Radviliškis d. mun.;2012;20;657;330;327
Radviliškis d. mun.;2012;21;565;290;275
Radviliškis d. mun.;2012;22;538;296;242
Radviliškis d. mun.;2012;23;527;276;251
Radviliškis d. mun.;2012;24;517;300;217
Radviliškis d. mun.;2012;25;470;283;187
Radviliškis d. mun.;2012;26;404;214;190
Radviliškis d. mun.;2012;27;407;225;182
Radviliškis d. mun.;2012;28;388;212;176
Radviliškis d. mun.;2012;29;345;193;152
Radviliškis d. mun.;2012;30;349;189;160
Radviliškis d. mun.;2012;31;379;195;184
Radviliškis d. mun.;2012;32;352;188;164
Radviliškis d. mun.;2012;33;348;171;177
Radviliškis d. mun.;2012;34;417;209;208
Radviliškis d. mun.;2012;35;424;197;227
Radviliškis d. mun.;2012;36;435;197;238
Radviliškis d. mun.;2012;37;523;250;273
Radviliškis d. mun.;2012;38;470;236;234
Radviliškis d. mun.;2012;39;567;266;301
Radviliškis d. mun.;2012;40;631;317;314
Radviliškis d. mun.;2012;41;639;335;304
Radviliškis d. mun.;2012;42;620;280;340
Radviliškis d. mun.;2012;43;655;337;318
Radviliškis d. mun.;2012;44;624;310;314
Radviliškis d. mun.;2012;45;655;327;328
Radviliškis d. mun.;2012;46;618;306;312
Radviliškis d. mun.;2012;47;679;348;331
Radviliškis d. mun.;2012;48;671;325;346
Radviliškis d. mun.;2012;49;682;327;355
Radviliškis d. mun.;2012;50;724;358;366
Radviliškis d. mun.;2012;51;656;308;348
Radviliškis d. mun.;2012;52;689;344;345
Radviliškis d. mun.;2012;53;707;364;343
Radviliškis d. mun.;2012;54;623;300;323
Radviliškis d. mun.;2012;55;556;268;288
Radviliškis d. mun.;2012;56;530;259;271
Radviliškis d. mun.;2012;57;555;259;296
Radviliškis d. mun.;2012;58;465;228;237
Radviliškis d. mun.;2012;59;476;205;271
Radviliškis d. mun.;2012;60;480;226;254
Radviliškis d. mun.;2012;61;482;194;288
Radviliškis d. mun.;2012;62;460;200;260
Radviliškis d. mun.;2012;63;423;197;226
Radviliškis d. mun.;2012;64;415;189;226
Radviliškis d. mun.;2012;65;416;172;244
Radviliškis d. mun.;2012;66;452;177;275
Radviliškis d. mun.;2012;67;374;152;222
Radviliškis d. mun.;2012;68;439;170;269
Radviliškis d. mun.;2012;69;504;192;312
Radviliškis d. mun.;2012;70;462;174;288
Radviliškis d. mun.;2012;71;403;154;249
Radviliškis d. mun.;2012;72;403;129;274
Radviliškis d. mun.;2012;73;442;156;286
Radviliškis d. mun.;2012;74;377;133;244
Radviliškis d. mun.;2012;75;438;134;304
Radviliškis d. mun.;2012;76;375;128;247
Radviliškis d. mun.;2012;77;362;113;249
Radviliškis d. mun.;2012;78;343;103;240
Radviliškis d. mun.;2012;79;303;86;217
Radviliškis d. mun.;2012;80;304;100;204
Radviliškis d. mun.;2012;81;288;84;204
Radviliškis d. mun.;2012;82;243;68;175
Radviliškis d. mun.;2012;83;242;64;178
Radviliškis d. mun.;2012;84;173;41;132
Radviliškis d. mun.;2012;85;819;170;649
Radviliškis d. mun.;2013;-1;40567;18990;21577
Radviliškis d. mun.;2013;0;354;187;167
Radviliškis d. mun.;2013;1;378;188;190
Radviliškis d. mun.;2013;2;358;182;176
Radviliškis d. mun.;2013;3;330;182;148
Radviliškis d. mun.;2013;4;370;197;173
Radviliškis d. mun.;2013;5;376;185;191
Radviliškis d. mun.;2013;6;396;200;196
Radviliškis d. mun.;2013;7;360;182;178
Radviliškis d. mun.;2013;8;411;218;193
Radviliškis d. mun.;2013;9;414;215;199
Radviliškis d. mun.;2013;10;423;203;220
Radviliškis d. mun.;2013;11;437;232;205
Radviliškis d. mun.;2013;12;457;240;217
Radviliškis d. mun.;2013;13;498;244;254
Radviliškis d. mun.;2013;14;513;262;251
Radviliškis d. mun.;2013;15;562;266;296
Radviliškis d. mun.;2013;16;602;315;287
Radviliškis d. mun.;2013;17;591;307;284
Radviliškis d. mun.;2013;18;544;289;255
Radviliškis d. mun.;2013;19;655;322;333
Radviliškis d. mun.;2013;20;699;354;345
Radviliškis d. mun.;2013;21;632;317;315
Radviliškis d. mun.;2013;22;535;280;255
Radviliškis d. mun.;2013;23;510;291;219
Radviliškis d. mun.;2013;24;498;269;229
Radviliškis d. mun.;2013;25;501;288;213
Radviliškis d. mun.;2013;26;436;267;169
Radviliškis d. mun.;2013;27;368;202;166
Radviliškis d. mun.;2013;28;378;208;170
Radviliškis d. mun.;2013;29;354;191;163
Radviliškis d. mun.;2013;30;327;185;142
Radviliškis d. mun.;2013;31;336;183;153
Radviliškis d. mun.;2013;32;367;189;178
Radviliškis d. mun.;2013;33;351;187;164
Radviliškis d. mun.;2013;34;343;170;173
Radviliškis d. mun.;2013;35;406;201;205
Radviliškis d. mun.;2013;36;411;191;220
Radviliškis d. mun.;2013;37;428;191;237
Radviliškis d. mun.;2013;38;510;244;266
Radviliškis d. mun.;2013;39;462;230;232
Radviliškis d. mun.;2013;40;565;265;300
Radviliškis d. mun.;2013;41;626;315;311
Radviliškis d. mun.;2013;42;625;328;297
Radviliškis d. mun.;2013;43;618;283;335
Radviliškis d. mun.;2013;44;633;320;313
Radviliškis d. mun.;2013;45;609;301;308
Radviliškis d. mun.;2013;46;646;321;325
Radviliškis d. mun.;2013;47;611;298;313
Radviliškis d. mun.;2013;48;674;348;326
Radviliškis d. mun.;2013;49;667;319;348
Radviliškis d. mun.;2013;50;677;325;352
Radviliškis d. mun.;2013;51;716;355;361
Radviliškis d. mun.;2013;52;651;306;345
Radviliškis d. mun.;2013;53;683;342;341
Radviliškis d. mun.;2013;54;695;356;339
Radviliškis d. mun.;2013;55;616;295;321
Radviliškis d. mun.;2013;56;548;268;280
Radviliškis d. mun.;2013;57;525;257;268
Radviliškis d. mun.;2013;58;549;252;297
Radviliškis d. mun.;2013;59;456;224;232
Radviliškis d. mun.;2013;60;472;202;270
Radviliškis d. mun.;2013;61;472;220;252
Radviliškis d. mun.;2013;62;475;188;287
Radviliškis d. mun.;2013;63;445;186;259
Radviliškis d. mun.;2013;64;418;192;226
Radviliškis d. mun.;2013;65;404;180;224
Radviliškis d. mun.;2013;66;399;160;239
Radviliškis d. mun.;2013;67;438;167;271
Radviliškis d. mun.;2013;68;367;149;218
Radviliškis d. mun.;2013;69;424;160;264
Radviliškis d. mun.;2013;70;485;180;305
Radviliškis d. mun.;2013;71;450;169;281
Radviliškis d. mun.;2013;72;392;149;243
Radviliškis d. mun.;2013;73;387;122;265
Radviliškis d. mun.;2013;74;427;150;277
Radviliškis d. mun.;2013;75;356;125;231
Radviliškis d. mun.;2013;76;411;120;291
Radviliškis d. mun.;2013;77;356;119;237
Radviliškis d. mun.;2013;78;337;101;236
Radviliškis d. mun.;2013;79;318;86;232
Radviliškis d. mun.;2013;80;269;74;195
Radviliškis d. mun.;2013;81;279;90;189
Radviliškis d. mun.;2013;82;258;74;184
Radviliškis d. mun.;2013;83;221;62;159
Radviliškis d. mun.;2013;84;217;60;157
Radviliškis d. mun.;2013;85;819;173;646
Radviliškis d. mun.;2014;-1;39689;18583;21106
Radviliškis d. mun.;2014;0;400;214;186
Radviliškis d. mun.;2014;1;355;186;169
Radviliškis d. mun.;2014;2;375;188;187
Radviliškis d. mun.;2014;3;348;180;168
Radviliškis d. mun.;2014;4;321;181;140
Radviliškis d. mun.;2014;5;373;196;177
Radviliškis d. mun.;2014;6;368;177;191
Radviliškis d. mun.;2014;7;398;198;200
Radviliškis d. mun.;2014;8;357;180;177
Radviliškis d. mun.;2014;9;400;213;187
Radviliškis d. mun.;2014;10;411;217;194
Radviliškis d. mun.;2014;11;415;201;214
Radviliškis d. mun.;2014;12;431;229;202
Radviliškis d. mun.;2014;13;455;240;215
Radviliškis d. mun.;2014;14;490;240;250
Radviliškis d. mun.;2014;15;515;265;250
Radviliškis d. mun.;2014;16;549;259;290
Radviliškis d. mun.;2014;17;602;317;285
Radviliškis d. mun.;2014;18;574;301;273
Radviliškis d. mun.;2014;19;516;279;237
Radviliškis d. mun.;2014;20;636;305;331
Radviliškis d. mun.;2014;21;683;346;337
Radviliškis d. mun.;2014;22;618;325;293
Radviliškis d. mun.;2014;23;507;272;235
Radviliškis d. mun.;2014;24;476;276;200
Radviliškis d. mun.;2014;25;472;262;210
Radviliškis d. mun.;2014;26;470;272;198
Radviliškis d. mun.;2014;27;405;249;156
Radviliškis d. mun.;2014;28;341;195;146
Radviliškis d. mun.;2014;29;353;189;164
Radviliškis d. mun.;2014;30;353;186;167
Radviliškis d. mun.;2014;31;314;175;139
Radviliškis d. mun.;2014;32;326;177;149
Radviliškis d. mun.;2014;33;343;172;171
Radviliškis d. mun.;2014;34;334;181;153
Radviliškis d. mun.;2014;35;338;166;172
Radviliškis d. mun.;2014;36;404;192;212
Radviliškis d. mun.;2014;37;395;179;216
Radviliškis d. mun.;2014;38;414;182;232
Radviliškis d. mun.;2014;39;505;240;265
Radviliškis d. mun.;2014;40;453;229;224
Radviliškis d. mun.;2014;41;556;261;295
Radviliškis d. mun.;2014;42;617;309;308
Radviliškis d. mun.;2014;43;613;321;292
Radviliškis d. mun.;2014;44;611;279;332
Radviliškis d. mun.;2014;45;625;314;311
Radviliškis d. mun.;2014;46;596;295;301
Radviliškis d. mun.;2014;47;641;318;323
Radviliškis d. mun.;2014;48;600;292;308
Radviliškis d. mun.;2014;49;671;347;324
Radviliškis d. mun.;2014;50;660;316;344
Radviliškis d. mun.;2014;51;670;321;349
Radviliškis d. mun.;2014;52;710;347;363
Radviliškis d. mun.;2014;53;637;295;342
Radviliškis d. mun.;2014;54;669;336;333
Radviliškis d. mun.;2014;55;687;351;336
Radviliškis d. mun.;2014;56;607;288;319
Radviliškis d. mun.;2014;57;541;263;278
Radviliškis d. mun.;2014;58;506;246;260
Radviliškis d. mun.;2014;59;531;239;292
Radviliškis d. mun.;2014;60;449;219;230
Radviliškis d. mun.;2014;61;467;199;268
Radviliškis d. mun.;2014;62;458;212;246
Radviliškis d. mun.;2014;63;461;177;284
Radviliškis d. mun.;2014;64;433;181;252
Radviliškis d. mun.;2014;65;402;183;219
Radviliškis d. mun.;2014;66;395;174;221
Radviliškis d. mun.;2014;67;382;149;233
Radviliškis d. mun.;2014;68;430;162;268
Radviliškis d. mun.;2014;69;355;139;216
Radviliškis d. mun.;2014;70;418;158;260
Radviliškis d. mun.;2014;71;466;170;296
Radviliškis d. mun.;2014;72;424;157;267
Radviliškis d. mun.;2014;73;380;142;238
Radviliškis d. mun.;2014;74;366;109;257
Radviliškis d. mun.;2014;75;406;138;268
Radviliškis d. mun.;2014;76;341;115;226
Radviliškis d. mun.;2014;77;385;104;281
Radviliškis d. mun.;2014;78;340;108;232
Radviliškis d. mun.;2014;79;317;90;227
Radviliškis d. mun.;2014;80;301;76;225
Radviliškis d. mun.;2014;81;241;63;178
Radviliškis d. mun.;2014;82;253;82;171
Radviliškis d. mun.;2014;83;237;66;171
Radviliškis d. mun.;2014;84;197;52;145
Radviliškis d. mun.;2014;85;844;189;655
Radviliškis d. mun.;2015;-1;39043;18284;20759
Radviliškis d. mun.;2015;0;361;192;169
Radviliškis d. mun.;2015;1;400;215;185
Radviliškis d. mun.;2015;2;362;189;173
Radviliškis d. mun.;2015;3;379;193;186
Radviliškis d. mun.;2015;4;352;177;175
Radviliškis d. mun.;2015;5;319;181;138
Radviliškis d. mun.;2015;6;374;196;178
Radviliškis d. mun.;2015;7;364;177;187
Radviliškis d. mun.;2015;8;387;191;196
Radviliškis d. mun.;2015;9;354;176;178
Radviliškis d. mun.;2015;10;394;208;186
Radviliškis d. mun.;2015;11;401;210;191
Radviliškis d. mun.;2015;12;407;198;209
Radviliškis d. mun.;2015;13;428;229;199
Radviliškis d. mun.;2015;14;444;236;208
Radviliškis d. mun.;2015;15;485;236;249
Radviliškis d. mun.;2015;16;510;261;249
Radviliškis d. mun.;2015;17;543;257;286
Radviliškis d. mun.;2015;18;595;315;280
Radviliškis d. mun.;2015;19;568;300;268
Radviliškis d. mun.;2015;20;511;280;231
Radviliškis d. mun.;2015;21;631;301;330
Radviliškis d. mun.;2015;22;652;335;317
Radviliškis d. mun.;2015;23;584;315;269
Radviliškis d. mun.;2015;24;483;261;222
Radviliškis d. mun.;2015;25;457;266;191
Radviliškis d. mun.;2015;26;445;254;191
Radviliškis d. mun.;2015;27;431;251;180
Radviliškis d. mun.;2015;28;388;236;152
Radviliškis d. mun.;2015;29;320;191;129
Radviliškis d. mun.;2015;30;321;171;150
Radviliškis d. mun.;2015;31;347;181;166
Radviliškis d. mun.;2015;32;305;168;137
Radviliškis d. mun.;2015;33;315;171;144
Radviliškis d. mun.;2015;34;332;167;165
Radviliškis d. mun.;2015;35;328;179;149
Radviliškis d. mun.;2015;36;333;165;168
Radviliškis d. mun.;2015;37;389;178;211
Radviliškis d. mun.;2015;38;386;171;215
Radviliškis d. mun.;2015;39;409;180;229
Radviliškis d. mun.;2015;40;497;231;266
Radviliškis d. mun.;2015;41;452;230;222
Radviliškis d. mun.;2015;42;549;257;292
Radviliškis d. mun.;2015;43;608;299;309
Radviliškis d. mun.;2015;44;614;322;292
Radviliškis d. mun.;2015;45;605;281;324
Radviliškis d. mun.;2015;46;623;310;313
Radviliškis d. mun.;2015;47;601;299;302
Radviliškis d. mun.;2015;48;637;317;320
Radviliškis d. mun.;2015;49;597;288;309
Radviliškis d. mun.;2015;50;666;344;322
Radviliškis d. mun.;2015;51;665;320;345
Radviliškis d. mun.;2015;52;670;322;348
Radviliškis d. mun.;2015;53;702;344;358
Radviliškis d. mun.;2015;54;630;289;341
Radviliškis d. mun.;2015;55;660;328;332
Radviliškis d. mun.;2015;56;680;345;335
Radviliškis d. mun.;2015;57;604;285;319
Radviliškis d. mun.;2015;58;524;248;276
Radviliškis d. mun.;2015;59;497;240;257
Radviliškis d. mun.;2015;60;525;235;290
Radviliškis d. mun.;2015;61;434;208;226
Radviliškis d. mun.;2015;62;457;193;264
Radviliškis d. mun.;2015;63;458;210;248
Radviliškis d. mun.;2015;64;451;174;277
Radviliškis d. mun.;2015;65;423;174;249
Radviliškis d. mun.;2015;66;393;175;218
Radviliškis d. mun.;2015;67;386;167;219
Radviliškis d. mun.;2015;68;374;143;231
Radviliškis d. mun.;2015;69;415;155;260
Radviliškis d. mun.;2015;70;350;133;217
Radviliškis d. mun.;2015;71;409;152;257
Radviliškis d. mun.;2015;72;453;163;290
Radviliškis d. mun.;2015;73;408;147;261
Radviliškis d. mun.;2015;74;361;132;229
Radviliškis d. mun.;2015;75;355;104;251
Radviliškis d. mun.;2015;76;387;128;259
Radviliškis d. mun.;2015;77;327;106;221
Radviliškis d. mun.;2015;78;366;94;272
Radviliškis d. mun.;2015;79;311;93;218
Radviliškis d. mun.;2015;80;299;87;212
Radviliškis d. mun.;2015;81;278;69;209
Radviliškis d. mun.;2015;82;226;60;166
Radviliškis d. mun.;2015;83;229;72;157
Radviliškis d. mun.;2015;84;213;53;160
Radviliškis d. mun.;2015;85;880;200;680
Radviliškis d. mun.;2016;-1;38253;17895;20358
Radviliškis d. mun.;2016;0;375;195;180
Radviliškis d. mun.;2016;1;364;191;173
Radviliškis d. mun.;2016;2;396;213;183
Radviliškis d. mun.;2016;3;359;192;167
Radviliškis d. mun.;2016;4;383;199;184
Radviliškis d. mun.;2016;5;354;179;175
Radviliškis d. mun.;2016;6;319;179;140
Radviliškis d. mun.;2016;7;376;200;176
Radviliškis d. mun.;2016;8;361;176;185
Radviliškis d. mun.;2016;9;380;188;192
Radviliškis d. mun.;2016;10;353;177;176
Radviliškis d. mun.;2016;11;388;206;182
Radviliškis d. mun.;2016;12;396;205;191
Radviliškis d. mun.;2016;13;401;193;208
Radviliškis d. mun.;2016;14;425;227;198
Radviliškis d. mun.;2016;15;442;237;205
Radviliškis d. mun.;2016;16;479;236;243
Radviliškis d. mun.;2016;17;504;260;244
Radviliškis d. mun.;2016;18;532;256;276
Radviliškis d. mun.;2016;19;573;308;265
Radviliškis d. mun.;2016;20;555;296;259
Radviliškis d. mun.;2016;21;495;265;230
Radviliškis d. mun.;2016;22;621;293;328
Radviliškis d. mun.;2016;23;612;320;292
Radviliškis d. mun.;2016;24;547;293;254
Radviliškis d. mun.;2016;25;443;246;197
Radviliškis d. mun.;2016;26;423;252;171
Radviliškis d. mun.;2016;27;406;234;172
Radviliškis d. mun.;2016;28;419;241;178
Radviliškis d. mun.;2016;29;363;212;151
Radviliškis d. mun.;2016;30;309;183;126
Radviliškis d. mun.;2016;31;317;163;154
Radviliškis d. mun.;2016;32;328;168;160
Radviliškis d. mun.;2016;33;302;169;133
Radviliškis d. mun.;2016;34;300;165;135
Radviliškis d. mun.;2016;35;314;155;159
Radviliškis d. mun.;2016;36;314;169;145
Radviliškis d. mun.;2016;37;321;153;168
Radviliškis d. mun.;2016;38;372;164;208
Radviliškis d. mun.;2016;39;379;165;214
Radviliškis d. mun.;2016;40;394;169;225
Radviliškis d. mun.;2016;41;492;228;264
Radviliškis d. mun.;2016;42;441;224;217
Radviliškis d. mun.;2016;43;538;254;284
Radviliškis d. mun.;2016;44;598;295;303
Radviliškis d. mun.;2016;45;604;319;285
Radviliškis d. mun.;2016;46;599;277;322
Radviliškis d. mun.;2016;47;620;312;308
Radviliškis d. mun.;2016;48;590;296;294
Radviliškis d. mun.;2016;49;635;313;322
Radviliškis d. mun.;2016;50;596;285;311
Radviliškis d. mun.;2016;51;660;340;320
Radviliškis d. mun.;2016;52;653;311;342
Radviliškis d. mun.;2016;53;657;313;344
Radviliškis d. mun.;2016;54;699;339;360
Radviliškis d. mun.;2016;55;622;284;338
Radviliškis d. mun.;2016;56;656;323;333
Radviliškis d. mun.;2016;57;672;338;334
Radviliškis d. mun.;2016;58;595;278;317
Radviliškis d. mun.;2016;59;515;240;275
Radviliškis d. mun.;2016;60;497;241;256
Radviliškis d. mun.;2016;61;513;226;287
Radviliškis d. mun.;2016;62;426;204;222
Radviliškis d. mun.;2016;63;443;181;262
Radviliškis d. mun.;2016;64;449;200;249
Radviliškis d. mun.;2016;65;437;169;268
Radviliškis d. mun.;2016;66;416;169;247
Radviliškis d. mun.;2016;67;379;166;213
Radviliškis d. mun.;2016;68;383;165;218
Radviliškis d. mun.;2016;69;357;134;223
Radviliškis d. mun.;2016;70;403;151;252
Radviliškis d. mun.;2016;71;336;126;210
Radviliškis d. mun.;2016;72;398;145;253
Radviliškis d. mun.;2016;73;434;150;284
Radviliškis d. mun.;2016;74;401;142;259
Radviliškis d. mun.;2016;75;352;128;224
Radviliškis d. mun.;2016;76;338;94;244
Radviliškis d. mun.;2016;77;366;116;250
Radviliškis d. mun.;2016;78;311;96;215
Radviliškis d. mun.;2016;79;343;88;255
Radviliškis d. mun.;2016;80;293;81;212
Radviliškis d. mun.;2016;81;267;71;196
Radviliškis d. mun.;2016;82;253;59;194
Radviliškis d. mun.;2016;83;211;55;156
Radviliškis d. mun.;2016;84;208;63;145
Radviliškis d. mun.;2016;85;903;214;689
Radviliškis d. mun.;2017;-1;37112;17290;19822
Radviliškis d. mun.;2017;0;365;175;190
Radviliškis d. mun.;2017;1;368;185;183
Radviliškis d. mun.;2017;2;351;183;168
Radviliškis d. mun.;2017;3;392;209;183
Radviliškis d. mun.;2017;4;349;190;159
Radviliškis d. mun.;2017;5;379;199;180
Radviliškis d. mun.;2017;6;352;176;176
Radviliškis d. mun.;2017;7;315;173;142
Radviliškis d. mun.;2017;8;372;196;176
Radviliškis d. mun.;2017;9;357;175;182
Radviliškis d. mun.;2017;10;379;188;191
Radviliškis d. mun.;2017;11;343;170;173
Radviliškis d. mun.;2017;12;382;203;179
Radviliškis d. mun.;2017;13;390;200;190
Radviliškis d. mun.;2017;14;396;189;207
Radviliškis d. mun.;2017;15;416;224;192
Radviliškis d. mun.;2017;16;436;233;203
Radviliškis d. mun.;2017;17;475;233;242
Radviliškis d. mun.;2017;18;492;252;240
Radviliškis d. mun.;2017;19;499;239;260
Radviliškis d. mun.;2017;20;558;299;259
Radviliškis d. mun.;2017;21;531;282;249
Radviliškis d. mun.;2017;22;470;253;217
Radviliškis d. mun.;2017;23;588;281;307
Radviliškis d. mun.;2017;24;567;306;261
Radviliškis d. mun.;2017;25;502;268;234
Radviliškis d. mun.;2017;26;392;218;174
Radviliškis d. mun.;2017;27;354;213;141
Radviliškis d. mun.;2017;28;367;222;145
Radviliškis d. mun.;2017;29;383;228;155
Radviliškis d. mun.;2017;30;325;186;139
Radviliškis d. mun.;2017;31;278;159;119
Radviliškis d. mun.;2017;32;287;146;141
Radviliškis d. mun.;2017;33;304;155;149
Radviliškis d. mun.;2017;34;288;157;131
Radviliškis d. mun.;2017;35;277;152;125
Radviliškis d. mun.;2017;36;298;141;157
Radviliškis d. mun.;2017;37;297;156;141
Radviliškis d. mun.;2017;38;315;147;168
Radviliškis d. mun.;2017;39;359;155;204
Radviliškis d. mun.;2017;40;372;164;208
Radviliškis d. mun.;2017;41;385;164;221
Radviliškis d. mun.;2017;42;482;221;261
Radviliškis d. mun.;2017;43;435;219;216
Radviliškis d. mun.;2017;44;529;245;284
Radviliškis d. mun.;2017;45;581;286;295
Radviliškis d. mun.;2017;46;603;319;284
Radviliškis d. mun.;2017;47;591;268;323
Radviliškis d. mun.;2017;48;611;309;302
Radviliškis d. mun.;2017;49;583;292;291
Radviliškis d. mun.;2017;50;624;307;317
Radviliškis d. mun.;2017;51;583;278;305
Radviliškis d. mun.;2017;52;645;333;312
Radviliškis d. mun.;2017;53;637;305;332
Radviliškis d. mun.;2017;54;636;297;339
Radviliškis d. mun.;2017;55;684;328;356
Radviliškis d. mun.;2017;56;618;281;337
Radviliškis d. mun.;2017;57;645;316;329
Radviliškis d. mun.;2017;58;651;325;326
Radviliškis d. mun.;2017;59;589;278;311
Radviliškis d. mun.;2017;60;508;236;272
Radviliškis d. mun.;2017;61;484;233;251
Radviliškis d. mun.;2017;62;503;217;286
Radviliškis d. mun.;2017;63;420;198;222
Radviliškis d. mun.;2017;64;433;174;259
Radviliškis d. mun.;2017;65;443;196;247
Radviliškis d. mun.;2017;66;426;161;265
Radviliškis d. mun.;2017;67;406;163;243
Radviliškis d. mun.;2017;68;370;159;211
Radviliškis d. mun.;2017;69;370;156;214
Radviliškis d. mun.;2017;70;349;128;221
Radviliškis d. mun.;2017;71;394;145;249
Radviliškis d. mun.;2017;72;321;117;204
Radviliškis d. mun.;2017;73;375;132;243
Radviliškis d. mun.;2017;74;417;140;277
Radviliškis d. mun.;2017;75;381;134;247
Radviliškis d. mun.;2017;76;330;116;214
Radviliškis d. mun.;2017;77;314;87;227
Radviliškis d. mun.;2017;78;347;107;240
Radviliškis d. mun.;2017;79;293;83;210
Radviliškis d. mun.;2017;80;324;80;244
Radviliškis d. mun.;2017;81;270;74;196
Radviliškis d. mun.;2017;82;247;65;182
Radviliškis d. mun.;2017;83;236;54;182
Radviliškis d. mun.;2017;84;198;53;145
Radviliškis d. mun.;2017;85;921;231;690
Radviliškis d. mun.;2018;-1;36170;16916;19254
Radviliškis d. mun.;2018;0;293;165;128
Radviliškis d. mun.;2018;1;365;177;188
Radviliškis d. mun.;2018;2;362;186;176
Radviliškis d. mun.;2018;3;347;183;164
Radviliškis d. mun.;2018;4;393;208;185
Radviliškis d. mun.;2018;5;345;185;160
Radviliškis d. mun.;2018;6;375;195;180
Radviliškis d. mun.;2018;7;353;175;178
Radviliškis d. mun.;2018;8;320;178;142
Radviliškis d. mun.;2018;9;368;197;171
Radviliškis d. mun.;2018;10;354;170;184
Radviliškis d. mun.;2018;11;378;186;192
Radviliškis d. mun.;2018;12;341;167;174
Radviliškis d. mun.;2018;13;380;200;180
Radviliškis d. mun.;2018;14;383;199;184
Radviliškis d. mun.;2018;15;388;183;205
Radviliškis d. mun.;2018;16;416;223;193
Radviliškis d. mun.;2018;17;425;224;201
Radviliškis d. mun.;2018;18;467;228;239
Radviliškis d. mun.;2018;19;461;243;218
Radviliškis d. mun.;2018;20;476;227;249
Radviliškis d. mun.;2018;21;524;280;244
Radviliškis d. mun.;2018;22;507;270;237
Radviliškis d. mun.;2018;23;438;237;201
Radviliškis d. mun.;2018;24;549;258;291
Radviliškis d. mun.;2018;25;520;281;239
Radviliškis d. mun.;2018;26;441;239;202
Radviliškis d. mun.;2018;27;339;192;147
Radviliškis d. mun.;2018;28;326;200;126
Radviliškis d. mun.;2018;29;328;203;125
Radviliškis d. mun.;2018;30;352;209;143
Radviliškis d. mun.;2018;31;316;181;135
Radviliškis d. mun.;2018;32;252;146;106
Radviliškis d. mun.;2018;33;261;132;129
Radviliškis d. mun.;2018;34;290;144;146
Radviliškis d. mun.;2018;35;290;159;131
Radviliškis d. mun.;2018;36;269;150;119
Radviliškis d. mun.;2018;37;297;141;156
Radviliškis d. mun.;2018;38;305;160;145
Radviliškis d. mun.;2018;39;316;149;167
Radviliškis d. mun.;2018;40;355;156;199
Radviliškis d. mun.;2018;41;360;162;198
Radviliškis d. mun.;2018;42;375;160;215
Radviliškis d. mun.;2018;43;481;229;252
Radviliškis d. mun.;2018;44;435;221;214
Radviliškis d. mun.;2018;45;523;241;282
Radviliškis d. mun.;2018;46;569;282;287
Radviliškis d. mun.;2018;47;602;326;276
Radviliškis d. mun.;2018;48;577;263;314
Radviliškis d. mun.;2018;49;609;312;297
Radviliškis d. mun.;2018;50;574;288;286
Radviliškis d. mun.;2018;51;616;306;310
Radviliškis d. mun.;2018;52;580;279;301
Radviliškis d. mun.;2018;53;642;331;311
Radviliškis d. mun.;2018;54;630;304;326
Radviliškis d. mun.;2018;55;626;294;332
Radviliškis d. mun.;2018;56;676;328;348
Radviliškis d. mun.;2018;57;610;283;327
Radviliškis d. mun.;2018;58;629;310;319
Radviliškis d. mun.;2018;59;646;325;321
Radviliškis d. mun.;2018;60;581;269;312
Radviliškis d. mun.;2018;61;505;234;271
Radviliškis d. mun.;2018;62;477;227;250
Radviliškis d. mun.;2018;63;493;210;283
Radviliškis d. mun.;2018;64;420;195;225
Radviliškis d. mun.;2018;65;427;171;256
Radviliškis d. mun.;2018;66;433;187;246
Radviliškis d. mun.;2018;67;411;153;258
Radviliškis d. mun.;2018;68;402;161;241
Radviliškis d. mun.;2018;69;358;149;209
Radviliškis d. mun.;2018;70;356;147;209
Radviliškis d. mun.;2018;71;335;118;217
Radviliškis d. mun.;2018;72;381;138;243
Radviliškis d. mun.;2018;73;306;112;194
Radviliškis d. mun.;2018;74;357;120;237
Radviliškis d. mun.;2018;75;395;126;269
Radviliškis d. mun.;2018;76;357;123;234
Radviliškis d. mun.;2018;77;319;111;208
Radviliškis d. mun.;2018;78;296;77;219
Radviliškis d. mun.;2018;79;332;102;230
Radviliškis d. mun.;2018;80;274;76;198
Radviliškis d. mun.;2018;81;302;71;231
Radviliškis d. mun.;2018;82;254;68;186
Radviliškis d. mun.;2018;83;228;57;171
Radviliškis d. mun.;2018;84;218;49;169
Radviliškis d. mun.;2018;85;928;235;693
Raseiniai d. mun.;2001;-1;44177;20844;23333
Raseiniai d. mun.;2001;0;458;227;231
Raseiniai d. mun.;2001;1;472;230;242
Raseiniai d. mun.;2001;2;501;285;216
Raseiniai d. mun.;2001;3;505;248;257
Raseiniai d. mun.;2001;4;504;250;254
Raseiniai d. mun.;2001;5;564;281;283
Raseiniai d. mun.;2001;6;575;296;279
Raseiniai d. mun.;2001;7;624;325;299
Raseiniai d. mun.;2001;8;742;370;372
Raseiniai d. mun.;2001;9;733;364;369
Raseiniai d. mun.;2001;10;687;342;345
Raseiniai d. mun.;2001;11;671;360;311
Raseiniai d. mun.;2001;12;703;346;357
Raseiniai d. mun.;2001;13;748;376;372
Raseiniai d. mun.;2001;14;745;396;349
Raseiniai d. mun.;2001;15;690;351;339
Raseiniai d. mun.;2001;16;727;372;355
Raseiniai d. mun.;2001;17;721;365;356
Raseiniai d. mun.;2001;18;589;323;266
Raseiniai d. mun.;2001;19;458;254;204
Raseiniai d. mun.;2001;20;424;245;179
Raseiniai d. mun.;2001;21;454;261;193
Raseiniai d. mun.;2001;22;450;234;216
Raseiniai d. mun.;2001;23;463;242;221
Raseiniai d. mun.;2001;24;477;254;223
Raseiniai d. mun.;2001;25;519;255;264
Raseiniai d. mun.;2001;26;546;267;279
Raseiniai d. mun.;2001;27;515;266;249
Raseiniai d. mun.;2001;28;571;281;290
Raseiniai d. mun.;2001;29;594;289;305
Raseiniai d. mun.;2001;30;594;327;267
Raseiniai d. mun.;2001;31;568;290;278
Raseiniai d. mun.;2001;32;589;290;299
Raseiniai d. mun.;2001;33;640;332;308
Raseiniai d. mun.;2001;34;603;308;295
Raseiniai d. mun.;2001;35;618;308;310
Raseiniai d. mun.;2001;36;568;295;273
Raseiniai d. mun.;2001;37;576;288;288
Raseiniai d. mun.;2001;38;666;313;353
Raseiniai d. mun.;2001;39;689;349;340
Raseiniai d. mun.;2001;40;670;330;340
Raseiniai d. mun.;2001;41;671;367;304
Raseiniai d. mun.;2001;42;626;318;308
Raseiniai d. mun.;2001;43;603;306;297
Raseiniai d. mun.;2001;44;568;296;272
Raseiniai d. mun.;2001;45;548;261;287
Raseiniai d. mun.;2001;46;505;254;251
Raseiniai d. mun.;2001;47;476;246;230
Raseiniai d. mun.;2001;48;487;224;263
Raseiniai d. mun.;2001;49;534;258;276
Raseiniai d. mun.;2001;50;493;256;237
Raseiniai d. mun.;2001;51;504;256;248
Raseiniai d. mun.;2001;52;452;211;241
Raseiniai d. mun.;2001;53;423;194;229
Raseiniai d. mun.;2001;54;459;219;240
Raseiniai d. mun.;2001;55;477;253;224
Raseiniai d. mun.;2001;56;411;181;230
Raseiniai d. mun.;2001;57;474;199;275
Raseiniai d. mun.;2001;58;610;256;354
Raseiniai d. mun.;2001;59;526;237;289
Raseiniai d. mun.;2001;60;429;190;239
Raseiniai d. mun.;2001;61;471;186;285
Raseiniai d. mun.;2001;62;509;208;301
Raseiniai d. mun.;2001;63;503;186;317
Raseiniai d. mun.;2001;64;527;210;317
Raseiniai d. mun.;2001;65;515;219;296
Raseiniai d. mun.;2001;66;499;200;299
Raseiniai d. mun.;2001;67;536;210;326
Raseiniai d. mun.;2001;68;523;212;311
Raseiniai d. mun.;2001;69;501;204;297
Raseiniai d. mun.;2001;70;453;160;293
Raseiniai d. mun.;2001;71;513;190;323
Raseiniai d. mun.;2001;72;461;154;307
Raseiniai d. mun.;2001;73;412;130;282
Raseiniai d. mun.;2001;74;366;116;250
Raseiniai d. mun.;2001;75;350;130;220
Raseiniai d. mun.;2001;76;314;96;218
Raseiniai d. mun.;2001;77;306;101;205
Raseiniai d. mun.;2001;78;282;81;201
Raseiniai d. mun.;2001;79;288;96;192
Raseiniai d. mun.;2001;80;235;69;166
Raseiniai d. mun.;2001;81;180;60;120
Raseiniai d. mun.;2001;82;120;31;89
Raseiniai d. mun.;2001;83;95;27;68
Raseiniai d. mun.;2001;84;97;24;73
Raseiniai d. mun.;2001;85;634;177;457
Raseiniai d. mun.;2002;-1;43880;20711;23169
Raseiniai d. mun.;2002;0;449;237;212
Raseiniai d. mun.;2002;1;453;226;227
Raseiniai d. mun.;2002;2;472;230;242
Raseiniai d. mun.;2002;3;504;291;213
Raseiniai d. mun.;2002;4;503;248;255
Raseiniai d. mun.;2002;5;506;249;257
Raseiniai d. mun.;2002;6;556;277;279
Raseiniai d. mun.;2002;7;572;294;278
Raseiniai d. mun.;2002;8;627;325;302
Raseiniai d. mun.;2002;9;736;366;370
Raseiniai d. mun.;2002;10;730;363;367
Raseiniai d. mun.;2002;11;679;338;341
Raseiniai d. mun.;2002;12;660;352;308
Raseiniai d. mun.;2002;13;694;343;351
Raseiniai d. mun.;2002;14;739;373;366
Raseiniai d. mun.;2002;15;736;390;346
Raseiniai d. mun.;2002;16;684;348;336
Raseiniai d. mun.;2002;17;715;365;350
Raseiniai d. mun.;2002;18;708;361;347
Raseiniai d. mun.;2002;19;584;321;263
Raseiniai d. mun.;2002;20;463;257;206
Raseiniai d. mun.;2002;21;427;241;186
Raseiniai d. mun.;2002;22;468;260;208
Raseiniai d. mun.;2002;23;446;232;214
Raseiniai d. mun.;2002;24;450;233;217
Raseiniai d. mun.;2002;25;470;250;220
Raseiniai d. mun.;2002;26;506;247;259
Raseiniai d. mun.;2002;27;535;262;273
Raseiniai d. mun.;2002;28;508;261;247
Raseiniai d. mun.;2002;29;566;275;291
Raseiniai d. mun.;2002;30;582;285;297
Raseiniai d. mun.;2002;31;583;323;260
Raseiniai d. mun.;2002;32;557;283;274
Raseiniai d. mun.;2002;33;579;284;295
Raseiniai d. mun.;2002;34;632;328;304
Raseiniai d. mun.;2002;35;591;299;292
Raseiniai d. mun.;2002;36;610;303;307
Raseiniai d. mun.;2002;37;563;294;269
Raseiniai d. mun.;2002;38;567;283;284
Raseiniai d. mun.;2002;39;656;308;348
Raseiniai d. mun.;2002;40;678;342;336
Raseiniai d. mun.;2002;41;659;323;336
Raseiniai d. mun.;2002;42;668;364;304
Raseiniai d. mun.;2002;43;623;316;307
Raseiniai d. mun.;2002;44;593;299;294
Raseiniai d. mun.;2002;45;555;288;267
Raseiniai d. mun.;2002;46;541;260;281
Raseiniai d. mun.;2002;47;503;254;249
Raseiniai d. mun.;2002;48;466;238;228
Raseiniai d. mun.;2002;49;479;220;259
Raseiniai d. mun.;2002;50;528;254;274
Raseiniai d. mun.;2002;51;479;248;231
Raseiniai d. mun.;2002;52;497;255;242
Raseiniai d. mun.;2002;53;447;209;238
Raseiniai d. mun.;2002;54;417;193;224
Raseiniai d. mun.;2002;55;451;217;234
Raseiniai d. mun.;2002;56;465;244;221
Raseiniai d. mun.;2002;57;404;180;224
Raseiniai d. mun.;2002;58;462;193;269
Raseiniai d. mun.;2002;59;602;253;349
Raseiniai d. mun.;2002;60;526;239;287
Raseiniai d. mun.;2002;61;429;191;238
Raseiniai d. mun.;2002;62;468;185;283
Raseiniai d. mun.;2002;63;509;205;304
Raseiniai d. mun.;2002;64;505;184;321
Raseiniai d. mun.;2002;65;522;205;317
Raseiniai d. mun.;2002;66;511;215;296
Raseiniai d. mun.;2002;67;492;196;296
Raseiniai d. mun.;2002;68;527;208;319
Raseiniai d. mun.;2002;69;505;200;305
Raseiniai d. mun.;2002;70;487;198;289
Raseiniai d. mun.;2002;71;430;146;284
Raseiniai d. mun.;2002;72;508;188;320
Raseiniai d. mun.;2002;73;454;154;300
Raseiniai d. mun.;2002;74;412;131;281
Raseiniai d. mun.;2002;75;349;112;237
Raseiniai d. mun.;2002;76;339;125;214
Raseiniai d. mun.;2002;77;307;93;214
Raseiniai d. mun.;2002;78;294;92;202
Raseiniai d. mun.;2002;79;264;75;189
Raseiniai d. mun.;2002;80;265;84;181
Raseiniai d. mun.;2002;81;222;64;158
Raseiniai d. mun.;2002;82;162;51;111
Raseiniai d. mun.;2002;83;110;27;83
Raseiniai d. mun.;2002;84;85;22;63
Raseiniai d. mun.;2002;85;615;166;449
Raseiniai d. mun.;2003;-1;43438;20499;22939
Raseiniai d. mun.;2003;0;376;199;177
Raseiniai d. mun.;2003;1;445;232;213
Raseiniai d. mun.;2003;2;451;224;227
Raseiniai d. mun.;2003;3;469;228;241
Raseiniai d. mun.;2003;4;500;287;213
Raseiniai d. mun.;2003;5;500;245;255
Raseiniai d. mun.;2003;6;502;249;253
Raseiniai d. mun.;2003;7;556;277;279
Raseiniai d. mun.;2003;8;570;296;274
Raseiniai d. mun.;2003;9;624;323;301
Raseiniai d. mun.;2003;10;730;365;365
Raseiniai d. mun.;2003;11;723;361;362
Raseiniai d. mun.;2003;12;663;332;331
Raseiniai d. mun.;2003;13;650;347;303
Raseiniai d. mun.;2003;14;686;338;348
Raseiniai d. mun.;2003;15;727;368;359
Raseiniai d. mun.;2003;16;724;387;337
Raseiniai d. mun.;2003;17;674;342;332
Raseiniai d. mun.;2003;18;707;362;345
Raseiniai d. mun.;2003;19;699;356;343
Raseiniai d. mun.;2003;20;577;319;258
Raseiniai d. mun.;2003;21;457;253;204
Raseiniai d. mun.;2003;22;427;239;188
Raseiniai d. mun.;2003;23;468;260;208
Raseiniai d. mun.;2003;24;446;233;213
Raseiniai d. mun.;2003;25;446;229;217
Raseiniai d. mun.;2003;26;452;243;209
Raseiniai d. mun.;2003;27;494;240;254
Raseiniai d. mun.;2003;28;530;257;273
Raseiniai d. mun.;2003;29;493;254;239
Raseiniai d. mun.;2003;30;562;272;290
Raseiniai d. mun.;2003;31;572;281;291
Raseiniai d. mun.;2003;32;576;317;259
Raseiniai d. mun.;2003;33;549;281;268
Raseiniai d. mun.;2003;34;574;281;293
Raseiniai d. mun.;2003;35;617;319;298
Raseiniai d. mun.;2003;36;584;295;289
Raseiniai d. mun.;2003;37;600;298;302
Raseiniai d. mun.;2003;38;560;295;265
Raseiniai d. mun.;2003;39;562;282;280
Raseiniai d. mun.;2003;40;646;302;344
Raseiniai d. mun.;2003;41;676;340;336
Raseiniai d. mun.;2003;42;648;318;330
Raseiniai d. mun.;2003;43;658;357;301
Raseiniai d. mun.;2003;44;620;314;306
Raseiniai d. mun.;2003;45;583;291;292
Raseiniai d. mun.;2003;46;546;283;263
Raseiniai d. mun.;2003;47;535;255;280
Raseiniai d. mun.;2003;48;496;250;246
Raseiniai d. mun.;2003;49;465;237;228
Raseiniai d. mun.;2003;50;475;218;257
Raseiniai d. mun.;2003;51;523;252;271
Raseiniai d. mun.;2003;52;470;242;228
Raseiniai d. mun.;2003;53;492;250;242
Raseiniai d. mun.;2003;54;441;207;234
Raseiniai d. mun.;2003;55;412;189;223
Raseiniai d. mun.;2003;56;442;212;230
Raseiniai d. mun.;2003;57;454;236;218
Raseiniai d. mun.;2003;58;401;177;224
Raseiniai d. mun.;2003;59;453;190;263
Raseiniai d. mun.;2003;60;592;249;343
Raseiniai d. mun.;2003;61;520;235;285
Raseiniai d. mun.;2003;62;422;188;234
Raseiniai d. mun.;2003;63;464;181;283
Raseiniai d. mun.;2003;64;501;198;303
Raseiniai d. mun.;2003;65;504;182;322
Raseiniai d. mun.;2003;66;513;200;313
Raseiniai d. mun.;2003;67;511;214;297
Raseiniai d. mun.;2003;68;488;191;297
Raseiniai d. mun.;2003;69;513;201;312
Raseiniai d. mun.;2003;70;492;192;300
Raseiniai d. mun.;2003;71;474;189;285
Raseiniai d. mun.;2003;72;424;141;283
Raseiniai d. mun.;2003;73;486;181;305
Raseiniai d. mun.;2003;74;440;147;293
Raseiniai d. mun.;2003;75;402;125;277
Raseiniai d. mun.;2003;76;338;108;230
Raseiniai d. mun.;2003;77;318;113;205
Raseiniai d. mun.;2003;78;292;85;207
Raseiniai d. mun.;2003;79;271;81;190
Raseiniai d. mun.;2003;80;247;70;177
Raseiniai d. mun.;2003;81;242;71;171
Raseiniai d. mun.;2003;82;203;54;149
Raseiniai d. mun.;2003;83;145;45;100
Raseiniai d. mun.;2003;84;108;26;82
Raseiniai d. mun.;2003;85;570;146;424
Raseiniai d. mun.;2004;-1;42958;20248;22710
Raseiniai d. mun.;2004;0;411;209;202
Raseiniai d. mun.;2004;1;378;201;177
Raseiniai d. mun.;2004;2;442;231;211
Raseiniai d. mun.;2004;3;447;224;223
Raseiniai d. mun.;2004;4;468;231;237
Raseiniai d. mun.;2004;5;502;286;216
Raseiniai d. mun.;2004;6;502;248;254
Raseiniai d. mun.;2004;7;504;248;256
Raseiniai d. mun.;2004;8;560;280;280
Raseiniai d. mun.;2004;9;576;299;277
Raseiniai d. mun.;2004;10;619;322;297
Raseiniai d. mun.;2004;11;728;365;363
Raseiniai d. mun.;2004;12;722;360;362
Raseiniai d. mun.;2004;13;664;331;333
Raseiniai d. mun.;2004;14;640;340;300
Raseiniai d. mun.;2004;15;678;335;343
Raseiniai d. mun.;2004;16;719;366;353
Raseiniai d. mun.;2004;17;708;379;329
Raseiniai d. mun.;2004;18;663;337;326
Raseiniai d. mun.;2004;19;692;354;338
Raseiniai d. mun.;2004;20;675;347;328
Raseiniai d. mun.;2004;21;567;314;253
Raseiniai d. mun.;2004;22;455;249;206
Raseiniai d. mun.;2004;23;426;239;187
Raseiniai d. mun.;2004;24;469;256;213
Raseiniai d. mun.;2004;25;429;226;203
Raseiniai d. mun.;2004;26;435;225;210
Raseiniai d. mun.;2004;27;430;233;197
Raseiniai d. mun.;2004;28;482;233;249
Raseiniai d. mun.;2004;29;527;254;273
Raseiniai d. mun.;2004;30;482;248;234
Raseiniai d. mun.;2004;31;547;269;278
Raseiniai d. mun.;2004;32;557;275;282
Raseiniai d. mun.;2004;33;562;306;256
Raseiniai d. mun.;2004;34;538;275;263
Raseiniai d. mun.;2004;35;570;281;289
Raseiniai d. mun.;2004;36;606;311;295
Raseiniai d. mun.;2004;37;576;291;285
Raseiniai d. mun.;2004;38;593;295;298
Raseiniai d. mun.;2004;39;552;290;262
Raseiniai d. mun.;2004;40;557;279;278
Raseiniai d. mun.;2004;41;640;297;343
Raseiniai d. mun.;2004;42;669;333;336
Raseiniai d. mun.;2004;43;640;314;326
Raseiniai d. mun.;2004;44;643;345;298
Raseiniai d. mun.;2004;45;618;311;307
Raseiniai d. mun.;2004;46;585;291;294
Raseiniai d. mun.;2004;47;537;280;257
Raseiniai d. mun.;2004;48;523;250;273
Raseiniai d. mun.;2004;49;489;246;243
Raseiniai d. mun.;2004;50;456;230;226
Raseiniai d. mun.;2004;51;465;212;253
Raseiniai d. mun.;2004;52;516;250;266
Raseiniai d. mun.;2004;53;459;238;221
Raseiniai d. mun.;2004;54;485;244;241
Raseiniai d. mun.;2004;55;434;204;230
Raseiniai d. mun.;2004;56;401;180;221
Raseiniai d. mun.;2004;57;425;201;224
Raseiniai d. mun.;2004;58;445;228;217
Raseiniai d. mun.;2004;59;393;172;221
Raseiniai d. mun.;2004;60;446;187;259
Raseiniai d. mun.;2004;61;583;243;340
Raseiniai d. mun.;2004;62;507;226;281
Raseiniai d. mun.;2004;63;415;182;233
Raseiniai d. mun.;2004;64;452;172;280
Raseiniai d. mun.;2004;65;497;197;300
Raseiniai d. mun.;2004;66;499;179;320
Raseiniai d. mun.;2004;67;503;187;316
Raseiniai d. mun.;2004;68;502;207;295
Raseiniai d. mun.;2004;69;484;188;296
Raseiniai d. mun.;2004;70;498;194;304
Raseiniai d. mun.;2004;71;491;190;301
Raseiniai d. mun.;2004;72;469;183;286
Raseiniai d. mun.;2004;73;414;138;276
Raseiniai d. mun.;2004;74;468;167;301
Raseiniai d. mun.;2004;75;420;138;282
Raseiniai d. mun.;2004;76;380;114;266
Raseiniai d. mun.;2004;77;318;99;219
Raseiniai d. mun.;2004;78;300;102;198
Raseiniai d. mun.;2004;79;278;79;199
Raseiniai d. mun.;2004;80;248;74;174
Raseiniai d. mun.;2004;81;233;63;170
Raseiniai d. mun.;2004;82;220;60;160
Raseiniai d. mun.;2004;83;174;41;133
Raseiniai d. mun.;2004;84;131;38;93
Raseiniai d. mun.;2004;85;547;132;415
Raseiniai d. mun.;2005;-1;42282;19900;22382
Raseiniai d. mun.;2005;0;420;222;198
Raseiniai d. mun.;2005;1;405;206;199
Raseiniai d. mun.;2005;2;379;202;177
Raseiniai d. mun.;2005;3;438;229;209
Raseiniai d. mun.;2005;4;445;222;223
Raseiniai d. mun.;2005;5;466;228;238
Raseiniai d. mun.;2005;6;493;283;210
Raseiniai d. mun.;2005;7;497;244;253
Raseiniai d. mun.;2005;8;501;245;256
Raseiniai d. mun.;2005;9;551;276;275
Raseiniai d. mun.;2005;10;568;293;275
Raseiniai d. mun.;2005;11;613;317;296
Raseiniai d. mun.;2005;12;721;362;359
Raseiniai d. mun.;2005;13;714;359;355
Raseiniai d. mun.;2005;14;654;323;331
Raseiniai d. mun.;2005;15;630;334;296
Raseiniai d. mun.;2005;16;665;331;334
Raseiniai d. mun.;2005;17;707;360;347
Raseiniai d. mun.;2005;18;695;372;323
Raseiniai d. mun.;2005;19;650;331;319
Raseiniai d. mun.;2005;20;675;348;327
Raseiniai d. mun.;2005;21;646;334;312
Raseiniai d. mun.;2005;22;552;312;240
Raseiniai d. mun.;2005;23;441;242;199
Raseiniai d. mun.;2005;24;406;230;176
Raseiniai d. mun.;2005;25;439;234;205
Raseiniai d. mun.;2005;26;420;224;196
Raseiniai d. mun.;2005;27;424;216;208
Raseiniai d. mun.;2005;28;415;229;186
Raseiniai d. mun.;2005;29;467;228;239
Raseiniai d. mun.;2005;30;513;243;270
Raseiniai d. mun.;2005;31;466;234;232
Raseiniai d. mun.;2005;32;517;252;265
Raseiniai d. mun.;2005;33;550;270;280
Raseiniai d. mun.;2005;34;556;300;256
Raseiniai d. mun.;2005;35;527;268;259
Raseiniai d. mun.;2005;36;549;269;280
Raseiniai d. mun.;2005;37;594;304;290
Raseiniai d. mun.;2005;38;564;284;280
Raseiniai d. mun.;2005;39;590;292;298
Raseiniai d. mun.;2005;40;550;292;258
Raseiniai d. mun.;2005;41;551;276;275
Raseiniai d. mun.;2005;42;627;286;341
Raseiniai d. mun.;2005;43;667;332;335
Raseiniai d. mun.;2005;44;634;309;325
Raseiniai d. mun.;2005;45;638;339;299
Raseiniai d. mun.;2005;46;613;305;308
Raseiniai d. mun.;2005;47;574;283;291
Raseiniai d. mun.;2005;48;524;269;255
Raseiniai d. mun.;2005;49;522;246;276
Raseiniai d. mun.;2005;50;486;244;242
Raseiniai d. mun.;2005;51;447;222;225
Raseiniai d. mun.;2005;52;454;208;246
Raseiniai d. mun.;2005;53;509;245;264
Raseiniai d. mun.;2005;54;453;232;221
Raseiniai d. mun.;2005;55;481;241;240
Raseiniai d. mun.;2005;56;423;199;224
Raseiniai d. mun.;2005;57;394;175;219
Raseiniai d. mun.;2005;58;421;201;220
Raseiniai d. mun.;2005;59;442;229;213
Raseiniai d. mun.;2005;60;386;167;219
Raseiniai d. mun.;2005;61;434;175;259
Raseiniai d. mun.;2005;62;569;231;338
Raseiniai d. mun.;2005;63;487;213;274
Raseiniai d. mun.;2005;64;407;176;231
Raseiniai d. mun.;2005;65;446;168;278
Raseiniai d. mun.;2005;66;481;186;295
Raseiniai d. mun.;2005;67;486;174;312
Raseiniai d. mun.;2005;68;488;182;306
Raseiniai d. mun.;2005;69;481;196;285
Raseiniai d. mun.;2005;70;472;181;291
Raseiniai d. mun.;2005;71;481;181;300
Raseiniai d. mun.;2005;72;475;183;292
Raseiniai d. mun.;2005;73;447;171;276
Raseiniai d. mun.;2005;74;394;125;269
Raseiniai d. mun.;2005;75;452;161;291
Raseiniai d. mun.;2005;76;404;132;272
Raseiniai d. mun.;2005;77;366;106;260
Raseiniai d. mun.;2005;78;301;92;209
Raseiniai d. mun.;2005;79;285;95;190
Raseiniai d. mun.;2005;80;259;76;183
Raseiniai d. mun.;2005;81;222;61;161
Raseiniai d. mun.;2005;82;209;54;155
Raseiniai d. mun.;2005;83;198;54;144
Raseiniai d. mun.;2005;84;160;37;123
Raseiniai d. mun.;2005;85;559;138;421
Raseiniai d. mun.;2006;-1;41530;19480;22050
Raseiniai d. mun.;2006;0;368;194;174
Raseiniai d. mun.;2006;1;416;221;195
Raseiniai d. mun.;2006;2;400;205;195
Raseiniai d. mun.;2006;3;373;197;176
Raseiniai d. mun.;2006;4;428;224;204
Raseiniai d. mun.;2006;5;440;218;222
Raseiniai d. mun.;2006;6;461;225;236
Raseiniai d. mun.;2006;7;494;283;211
Raseiniai d. mun.;2006;8;493;242;251
Raseiniai d. mun.;2006;9;499;244;255
Raseiniai d. mun.;2006;10;548;273;275
Raseiniai d. mun.;2006;11;572;296;276
Raseiniai d. mun.;2006;12;610;317;293
Raseiniai d. mun.;2006;13;709;356;353
Raseiniai d. mun.;2006;14;707;356;351
Raseiniai d. mun.;2006;15;642;317;325
Raseiniai d. mun.;2006;16;614;323;291
Raseiniai d. mun.;2006;17;644;318;326
Raseiniai d. mun.;2006;18;685;347;338
Raseiniai d. mun.;2006;19;658;354;304
Raseiniai d. mun.;2006;20;618;314;304
Raseiniai d. mun.;2006;21;642;330;312
Raseiniai d. mun.;2006;22;616;319;297
Raseiniai d. mun.;2006;23;524;302;222
Raseiniai d. mun.;2006;24;423;235;188
Raseiniai d. mun.;2006;25;376;210;166
Raseiniai d. mun.;2006;26;412;221;191
Raseiniai d. mun.;2006;27;405;218;187
Raseiniai d. mun.;2006;28;404;205;199
Raseiniai d. mun.;2006;29;413;226;187
Raseiniai d. mun.;2006;30;458;223;235
Raseiniai d. mun.;2006;31;503;239;264
Raseiniai d. mun.;2006;32;446;222;224
Raseiniai d. mun.;2006;33;508;242;266
Raseiniai d. mun.;2006;34;540;265;275
Raseiniai d. mun.;2006;35;548;296;252
Raseiniai d. mun.;2006;36;514;259;255
Raseiniai d. mun.;2006;37;541;262;279
Raseiniai d. mun.;2006;38;581;294;287
Raseiniai d. mun.;2006;39;557;279;278
Raseiniai d. mun.;2006;40;580;286;294
Raseiniai d. mun.;2006;41;538;282;256
Raseiniai d. mun.;2006;42;542;272;270
Raseiniai d. mun.;2006;43;617;282;335
Raseiniai d. mun.;2006;44;653;323;330
Raseiniai d. mun.;2006;45;625;304;321
Raseiniai d. mun.;2006;46;631;336;295
Raseiniai d. mun.;2006;47;610;300;310
Raseiniai d. mun.;2006;48;567;280;287
Raseiniai d. mun.;2006;49;517;266;251
Raseiniai d. mun.;2006;50;513;237;276
Raseiniai d. mun.;2006;51;482;237;245
Raseiniai d. mun.;2006;52;442;218;224
Raseiniai d. mun.;2006;53;447;202;245
Raseiniai d. mun.;2006;54;504;240;264
Raseiniai d. mun.;2006;55;442;227;215
Raseiniai d. mun.;2006;56;474;233;241
Raseiniai d. mun.;2006;57;418;194;224
Raseiniai d. mun.;2006;58;385;168;217
Raseiniai d. mun.;2006;59;410;194;216
Raseiniai d. mun.;2006;60;432;222;210
Raseiniai d. mun.;2006;61;376;160;216
Raseiniai d. mun.;2006;62;428;171;257
Raseiniai d. mun.;2006;63;556;220;336
Raseiniai d. mun.;2006;64;482;208;274
Raseiniai d. mun.;2006;65;403;172;231
Raseiniai d. mun.;2006;66;430;158;272
Raseiniai d. mun.;2006;67;471;178;293
Raseiniai d. mun.;2006;68;473;167;306
Raseiniai d. mun.;2006;69;479;174;305
Raseiniai d. mun.;2006;70;467;185;282
Raseiniai d. mun.;2006;71;461;175;286
Raseiniai d. mun.;2006;72;465;173;292
Raseiniai d. mun.;2006;73;454;172;282
Raseiniai d. mun.;2006;74;439;166;273
Raseiniai d. mun.;2006;75;378;119;259
Raseiniai d. mun.;2006;76;441;157;284
Raseiniai d. mun.;2006;77;384;128;256
Raseiniai d. mun.;2006;78;346;97;249
Raseiniai d. mun.;2006;79;275;81;194
Raseiniai d. mun.;2006;80;271;86;185
Raseiniai d. mun.;2006;81;241;70;171
Raseiniai d. mun.;2006;82;207;50;157
Raseiniai d. mun.;2006;83;199;52;147
Raseiniai d. mun.;2006;84;177;49;128
Raseiniai d. mun.;2006;85;608;138;470
Raseiniai d. mun.;2007;-1;40996;19173;21823
Raseiniai d. mun.;2007;0;369;182;187
Raseiniai d. mun.;2007;1;366;195;171
Raseiniai d. mun.;2007;2;410;215;195
Raseiniai d. mun.;2007;3;402;207;195
Raseiniai d. mun.;2007;4;375;201;174
Raseiniai d. mun.;2007;5;424;222;202
Raseiniai d. mun.;2007;6;439;220;219
Raseiniai d. mun.;2007;7;459;225;234
Raseiniai d. mun.;2007;8;494;284;210
Raseiniai d. mun.;2007;9;493;241;252
Raseiniai d. mun.;2007;10;503;246;257
Raseiniai d. mun.;2007;11;551;275;276
Raseiniai d. mun.;2007;12;571;298;273
Raseiniai d. mun.;2007;13;611;316;295
Raseiniai d. mun.;2007;14;702;353;349
Raseiniai d. mun.;2007;15;706;352;354
Raseiniai d. mun.;2007;16;636;314;322
Raseiniai d. mun.;2007;17;606;317;289
Raseiniai d. mun.;2007;18;631;310;321
Raseiniai d. mun.;2007;19;675;341;334
Raseiniai d. mun.;2007;20;644;346;298
Raseiniai d. mun.;2007;21;605;306;299
Raseiniai d. mun.;2007;22;621;320;301
Raseiniai d. mun.;2007;23;596;310;286
Raseiniai d. mun.;2007;24;501;290;211
Raseiniai d. mun.;2007;25;410;225;185
Raseiniai d. mun.;2007;26;352;197;155
Raseiniai d. mun.;2007;27;399;214;185
Raseiniai d. mun.;2007;28;394;210;184
Raseiniai d. mun.;2007;29;384;189;195
Raseiniai d. mun.;2007;30;394;215;179
Raseiniai d. mun.;2007;31;457;218;239
Raseiniai d. mun.;2007;32;501;236;265
Raseiniai d. mun.;2007;33;447;221;226
Raseiniai d. mun.;2007;34;498;234;264
Raseiniai d. mun.;2007;35;534;259;275
Raseiniai d. mun.;2007;36;540;289;251
Raseiniai d. mun.;2007;37;510;256;254
Raseiniai d. mun.;2007;38;531;254;277
Raseiniai d. mun.;2007;39;569;291;278
Raseiniai d. mun.;2007;40;545;273;272
Raseiniai d. mun.;2007;41;577;286;291
Raseiniai d. mun.;2007;42;532;281;251
Raseiniai d. mun.;2007;43;532;266;266
Raseiniai d. mun.;2007;44;602;272;330
Raseiniai d. mun.;2007;45;650;321;329
Raseiniai d. mun.;2007;46;622;302;320
Raseiniai d. mun.;2007;47;622;330;292
Raseiniai d. mun.;2007;48;604;294;310
Raseiniai d. mun.;2007;49;558;275;283
Raseiniai d. mun.;2007;50;513;260;253
Raseiniai d. mun.;2007;51;501;228;273
Raseiniai d. mun.;2007;52;476;235;241
Raseiniai d. mun.;2007;53;434;214;220
Raseiniai d. mun.;2007;54;436;194;242
Raseiniai d. mun.;2007;55;499;237;262
Raseiniai d. mun.;2007;56;436;223;213
Raseiniai d. mun.;2007;57;468;227;241
Raseiniai d. mun.;2007;58;416;189;227
Raseiniai d. mun.;2007;59;376;164;212
Raseiniai d. mun.;2007;60;405;190;215
Raseiniai d. mun.;2007;61;422;211;211
Raseiniai d. mun.;2007;62;370;154;216
Raseiniai d. mun.;2007;63;419;166;253
Raseiniai d. mun.;2007;64;542;213;329
Raseiniai d. mun.;2007;65;469;198;271
Raseiniai d. mun.;2007;66;398;169;229
Raseiniai d. mun.;2007;67;419;149;270
Raseiniai d. mun.;2007;68;458;174;284
Raseiniai d. mun.;2007;69;457;160;297
Raseiniai d. mun.;2007;70;468;169;299
Raseiniai d. mun.;2007;71;452;174;278
Raseiniai d. mun.;2007;72;450;171;279
Raseiniai d. mun.;2007;73;449;163;286
Raseiniai d. mun.;2007;74;439;164;275
Raseiniai d. mun.;2007;75;416;155;261
Raseiniai d. mun.;2007;76;364;113;251
Raseiniai d. mun.;2007;77;426;144;282
Raseiniai d. mun.;2007;78;363;120;243
Raseiniai d. mun.;2007;79;320;87;233
Raseiniai d. mun.;2007;80;260;76;184
Raseiniai d. mun.;2007;81;250;77;173
Raseiniai d. mun.;2007;82;223;64;159
Raseiniai d. mun.;2007;83;189;42;147
Raseiniai d. mun.;2007;84;184;43;141
Raseiniai d. mun.;2007;85;675;162;513
Raseiniai d. mun.;2008;-1;40361;18862;21499
Raseiniai d. mun.;2008;0;354;186;168
Raseiniai d. mun.;2008;1;361;179;182
Raseiniai d. mun.;2008;2;357;190;167
Raseiniai d. mun.;2008;3;403;215;188
Raseiniai d. mun.;2008;4;394;205;189
Raseiniai d. mun.;2008;5;375;199;176
Raseiniai d. mun.;2008;6;423;223;200
Raseiniai d. mun.;2008;7;433;216;217
Raseiniai d. mun.;2008;8;450;218;232
Raseiniai d. mun.;2008;9;496;284;212
Raseiniai d. mun.;2008;10;491;239;252
Raseiniai d. mun.;2008;11;502;247;255
Raseiniai d. mun.;2008;12;548;273;275
Raseiniai d. mun.;2008;13;572;297;275
Raseiniai d. mun.;2008;14;608;315;293
Raseiniai d. mun.;2008;15;703;352;351
Raseiniai d. mun.;2008;16;703;351;352
Raseiniai d. mun.;2008;17;633;312;321
Raseiniai d. mun.;2008;18;596;314;282
Raseiniai d. mun.;2008;19;619;306;313
Raseiniai d. mun.;2008;20;660;332;328
Raseiniai d. mun.;2008;21;633;340;293
Raseiniai d. mun.;2008;22;585;298;287
Raseiniai d. mun.;2008;23;600;311;289
Raseiniai d. mun.;2008;24;568;294;274
Raseiniai d. mun.;2008;25;472;275;197
Raseiniai d. mun.;2008;26;393;216;177
Raseiniai d. mun.;2008;27;335;190;145
Raseiniai d. mun.;2008;28;374;197;177
Raseiniai d. mun.;2008;29;376;199;177
Raseiniai d. mun.;2008;30;374;183;191
Raseiniai d. mun.;2008;31;381;199;182
Raseiniai d. mun.;2008;32;443;213;230
Raseiniai d. mun.;2008;33;491;234;257
Raseiniai d. mun.;2008;34;444;217;227
Raseiniai d. mun.;2008;35;490;228;262
Raseiniai d. mun.;2008;36;526;255;271
Raseiniai d. mun.;2008;37;531;281;250
Raseiniai d. mun.;2008;38;504;254;250
Raseiniai d. mun.;2008;39;524;250;274
Raseiniai d. mun.;2008;40;568;291;277
Raseiniai d. mun.;2008;41;546;273;273
Raseiniai d. mun.;2008;42;567;279;288
Raseiniai d. mun.;2008;43;528;277;251
Raseiniai d. mun.;2008;44;523;262;261
Raseiniai d. mun.;2008;45;597;268;329
Raseiniai d. mun.;2008;46;639;315;324
Raseiniai d. mun.;2008;47;612;295;317
Raseiniai d. mun.;2008;48;611;325;286
Raseiniai d. mun.;2008;49;599;292;307
Raseiniai d. mun.;2008;50;548;267;281
Raseiniai d. mun.;2008;51;502;253;249
Raseiniai d. mun.;2008;52;495;223;272
Raseiniai d. mun.;2008;53;471;226;245
Raseiniai d. mun.;2008;54;425;208;217
Raseiniai d. mun.;2008;55;427;184;243
Raseiniai d. mun.;2008;56;495;234;261
Raseiniai d. mun.;2008;57;436;220;216
Raseiniai d. mun.;2008;58;458;220;238
Raseiniai d. mun.;2008;59;407;185;222
Raseiniai d. mun.;2008;60;373;163;210
Raseiniai d. mun.;2008;61;396;185;211
Raseiniai d. mun.;2008;62;410;203;207
Raseiniai d. mun.;2008;63;360;148;212
Raseiniai d. mun.;2008;64;411;164;247
Raseiniai d. mun.;2008;65;533;208;325
Raseiniai d. mun.;2008;66;461;193;268
Raseiniai d. mun.;2008;67;387;161;226
Raseiniai d. mun.;2008;68;409;139;270
Raseiniai d. mun.;2008;69;456;172;284
Raseiniai d. mun.;2008;70;450;156;294
Raseiniai d. mun.;2008;71;452;162;290
Raseiniai d. mun.;2008;72;443;166;277
Raseiniai d. mun.;2008;73;437;165;272
Raseiniai d. mun.;2008;74;437;154;283
Raseiniai d. mun.;2008;75;421;155;266
Raseiniai d. mun.;2008;76;399;145;254
Raseiniai d. mun.;2008;77;349;107;242
Raseiniai d. mun.;2008;78;405;132;273
Raseiniai d. mun.;2008;79;346;115;231
Raseiniai d. mun.;2008;80;302;80;222
Raseiniai d. mun.;2008;81;242;66;176
Raseiniai d. mun.;2008;82;238;72;166
Raseiniai d. mun.;2008;83;191;57;134
Raseiniai d. mun.;2008;84;167;32;135
Raseiniai d. mun.;2008;85;707;178;529
Raseiniai d. mun.;2009;-1;39647;18503;21144
Raseiniai d. mun.;2009;0;364;194;170
Raseiniai d. mun.;2009;1;347;182;165
Raseiniai d. mun.;2009;2;357;179;178
Raseiniai d. mun.;2009;3;355;188;167
Raseiniai d. mun.;2009;4;402;212;190
Raseiniai d. mun.;2009;5;387;202;185
Raseiniai d. mun.;2009;6;369;194;175
Raseiniai d. mun.;2009;7;416;216;200
Raseiniai d. mun.;2009;8;432;217;215
Raseiniai d. mun.;2009;9;447;216;231
Raseiniai d. mun.;2009;10;492;282;210
Raseiniai d. mun.;2009;11;490;242;248
Raseiniai d. mun.;2009;12;491;242;249
Raseiniai d. mun.;2009;13;543;270;273
Raseiniai d. mun.;2009;14;569;294;275
Raseiniai d. mun.;2009;15;607;314;293
Raseiniai d. mun.;2009;16;692;346;346
Raseiniai d. mun.;2009;17;699;347;352
Raseiniai d. mun.;2009;18;621;310;311
Raseiniai d. mun.;2009;19;588;308;280
Raseiniai d. mun.;2009;20;609;303;306
Raseiniai d. mun.;2009;21;653;327;326
Raseiniai d. mun.;2009;22;614;331;283
Raseiniai d. mun.;2009;23;568;292;276
Raseiniai d. mun.;2009;24;581;307;274
Raseiniai d. mun.;2009;25;550;283;267
Raseiniai d. mun.;2009;26;447;265;182
Raseiniai d. mun.;2009;27;366;204;162
Raseiniai d. mun.;2009;28;310;179;131
Raseiniai d. mun.;2009;29;352;187;165
Raseiniai d. mun.;2009;30;359;194;165
Raseiniai d. mun.;2009;31;363;175;188
Raseiniai d. mun.;2009;32;357;189;168
Raseiniai d. mun.;2009;33;429;204;225
Raseiniai d. mun.;2009;34;471;220;251
Raseiniai d. mun.;2009;35;437;212;225
Raseiniai d. mun.;2009;36;484;223;261
Raseiniai d. mun.;2009;37;516;250;266
Raseiniai d. mun.;2009;38;526;276;250
Raseiniai d. mun.;2009;39;491;244;247
Raseiniai d. mun.;2009;40;514;243;271
Raseiniai d. mun.;2009;41;556;285;271
Raseiniai d. mun.;2009;42;537;268;269
Raseiniai d. mun.;2009;43;560;274;286
Raseiniai d. mun.;2009;44;519;270;249
Raseiniai d. mun.;2009;45;512;258;254
Raseiniai d. mun.;2009;46;593;264;329
Raseiniai d. mun.;2009;47;633;311;322
Raseiniai d. mun.;2009;48;604;292;312
Raseiniai d. mun.;2009;49;604;322;282
Raseiniai d. mun.;2009;50;586;280;306
Raseiniai d. mun.;2009;51;542;264;278
Raseiniai d. mun.;2009;52;499;251;248
Raseiniai d. mun.;2009;53;492;218;274
Raseiniai d. mun.;2009;54;462;221;241
Raseiniai d. mun.;2009;55;419;204;215
Raseiniai d. mun.;2009;56;421;181;240
Raseiniai d. mun.;2009;57;485;226;259
Raseiniai d. mun.;2009;58;427;212;215
Raseiniai d. mun.;2009;59;444;208;236
Raseiniai d. mun.;2009;60;402;180;222
Raseiniai d. mun.;2009;61;364;157;207
Raseiniai d. mun.;2009;62;390;182;208
Raseiniai d. mun.;2009;63;397;193;204
Raseiniai d. mun.;2009;64;354;144;210
Raseiniai d. mun.;2009;65;408;162;246
Raseiniai d. mun.;2009;66;519;202;317
Raseiniai d. mun.;2009;67;452;184;268
Raseiniai d. mun.;2009;68;381;156;225
Raseiniai d. mun.;2009;69;400;135;265
Raseiniai d. mun.;2009;70;446;166;280
Raseiniai d. mun.;2009;71;438;152;286
Raseiniai d. mun.;2009;72;443;158;285
Raseiniai d. mun.;2009;73;428;155;273
Raseiniai d. mun.;2009;74;422;155;267
Raseiniai d. mun.;2009;75;416;143;273
Raseiniai d. mun.;2009;76;399;140;259
Raseiniai d. mun.;2009;77;381;139;242
Raseiniai d. mun.;2009;78;335;102;233
Raseiniai d. mun.;2009;79;380;118;262
Raseiniai d. mun.;2009;80;323;103;220
Raseiniai d. mun.;2009;81;281;72;209
Raseiniai d. mun.;2009;82;223;62;161
Raseiniai d. mun.;2009;83;215;65;150
Raseiniai d. mun.;2009;84;174;49;125
Raseiniai d. mun.;2009;85;716;157;559
Raseiniai d. mun.;2010;-1;38852;18092;20760
Raseiniai d. mun.;2010;0;334;162;172
Raseiniai d. mun.;2010;1;353;190;163
Raseiniai d. mun.;2010;2;338;179;159
Raseiniai d. mun.;2010;3;348;174;174
Raseiniai d. mun.;2010;4;351;185;166
Raseiniai d. mun.;2010;5;392;204;188
Raseiniai d. mun.;2010;6;378;197;181
Raseiniai d. mun.;2010;7;366;192;174
Raseiniai d. mun.;2010;8;416;217;199
Raseiniai d. mun.;2010;9;427;213;214
Raseiniai d. mun.;2010;10;442;213;229
Raseiniai d. mun.;2010;11;489;279;210
Raseiniai d. mun.;2010;12;490;238;252
Raseiniai d. mun.;2010;13;482;237;245
Raseiniai d. mun.;2010;14;538;270;268
Raseiniai d. mun.;2010;15;561;290;271
Raseiniai d. mun.;2010;16;600;312;288
Raseiniai d. mun.;2010;17;688;342;346
Raseiniai d. mun.;2010;18;698;345;353
Raseiniai d. mun.;2010;19;618;308;310
Raseiniai d. mun.;2010;20;578;299;279
Raseiniai d. mun.;2010;21;593;295;298
Raseiniai d. mun.;2010;22;626;314;312
Raseiniai d. mun.;2010;23;594;320;274
Raseiniai d. mun.;2010;24;536;274;262
Raseiniai d. mun.;2010;25;544;291;253
Raseiniai d. mun.;2010;26;510;260;250
Raseiniai d. mun.;2010;27;411;247;164
Raseiniai d. mun.;2010;28;346;198;148
Raseiniai d. mun.;2010;29;296;172;124
Raseiniai d. mun.;2010;30;330;178;152
Raseiniai d. mun.;2010;31;339;182;157
Raseiniai d. mun.;2010;32;344;171;173
Raseiniai d. mun.;2010;33;343;184;159
Raseiniai d. mun.;2010;34;413;195;218
Raseiniai d. mun.;2010;35;453;209;244
Raseiniai d. mun.;2010;36;428;209;219
Raseiniai d. mun.;2010;37;474;219;255
Raseiniai d. mun.;2010;38;505;243;262
Raseiniai d. mun.;2010;39;516;270;246
Raseiniai d. mun.;2010;40;479;236;243
Raseiniai d. mun.;2010;41;508;241;267
Raseiniai d. mun.;2010;42;551;279;272
Raseiniai d. mun.;2010;43;538;267;271
Raseiniai d. mun.;2010;44;557;272;285
Raseiniai d. mun.;2010;45;514;264;250
Raseiniai d. mun.;2010;46;502;249;253
Raseiniai d. mun.;2010;47;586;260;326
Raseiniai d. mun.;2010;48;621;306;315
Raseiniai d. mun.;2010;49;593;284;309
Raseiniai d. mun.;2010;50;591;317;274
Raseiniai d. mun.;2010;51;579;277;302
Raseiniai d. mun.;2010;52;543;263;280
Raseiniai d. mun.;2010;53;487;241;246
Raseiniai d. mun.;2010;54;484;214;270
Raseiniai d. mun.;2010;55;445;210;235
Raseiniai d. mun.;2010;56;409;196;213
Raseiniai d. mun.;2010;57;415;176;239
Raseiniai d. mun.;2010;58;476;219;257
Raseiniai d. mun.;2010;59;418;206;212
Raseiniai d. mun.;2010;60;440;208;232
Raseiniai d. mun.;2010;61;390;171;219
Raseiniai d. mun.;2010;62;360;155;205
Raseiniai d. mun.;2010;63;385;179;206
Raseiniai d. mun.;2010;64;384;183;201
Raseiniai d. mun.;2010;65;348;138;210
Raseiniai d. mun.;2010;66;398;152;246
Raseiniai d. mun.;2010;67;503;193;310
Raseiniai d. mun.;2010;68;441;177;264
Raseiniai d. mun.;2010;69;370;146;224
Raseiniai d. mun.;2010;70;390;132;258
Raseiniai d. mun.;2010;71;438;161;277
Raseiniai d. mun.;2010;72;429;148;281
Raseiniai d. mun.;2010;73;426;150;276
Raseiniai d. mun.;2010;74;412;144;268
Raseiniai d. mun.;2010;75;413;150;263
Raseiniai d. mun.;2010;76;408;141;267
Raseiniai d. mun.;2010;77;386;136;250
Raseiniai d. mun.;2010;78;369;134;235
Raseiniai d. mun.;2010;79;318;89;229
Raseiniai d. mun.;2010;80;365;112;253
Raseiniai d. mun.;2010;81;295;94;201
Raseiniai d. mun.;2010;82;261;67;194
Raseiniai d. mun.;2010;83;200;51;149
Raseiniai d. mun.;2010;84;197;58;139
Raseiniai d. mun.;2010;85;742;169;573
Raseiniai d. mun.;2011;-1;37628;17501;20127
Raseiniai d. mun.;2011;0;273;142;131
Raseiniai d. mun.;2011;1;291;144;147
Raseiniai d. mun.;2011;2;307;162;145
Raseiniai d. mun.;2011;3;315;159;156
Raseiniai d. mun.;2011;4;302;144;158
Raseiniai d. mun.;2011;5;335;176;159
Raseiniai d. mun.;2011;6;346;176;170
Raseiniai d. mun.;2011;7;367;196;171
Raseiniai d. mun.;2011;8;348;183;165
Raseiniai d. mun.;2011;9;407;213;194
Raseiniai d. mun.;2011;10;422;212;210
Raseiniai d. mun.;2011;11;455;220;235
Raseiniai d. mun.;2011;12;470;270;200
Raseiniai d. mun.;2011;13;497;243;254
Raseiniai d. mun.;2011;14;487;240;247
Raseiniai d. mun.;2011;15;522;268;254
Raseiniai d. mun.;2011;16;546;275;271
Raseiniai d. mun.;2011;17;576;300;276
Raseiniai d. mun.;2011;18;670;329;341
Raseiniai d. mun.;2011;19;596;307;289
Raseiniai d. mun.;2011;20;534;279;255
Raseiniai d. mun.;2011;21;466;257;209
Raseiniai d. mun.;2011;22;495;260;235
Raseiniai d. mun.;2011;23;524;270;254
Raseiniai d. mun.;2011;24;472;263;209
Raseiniai d. mun.;2011;25;413;211;202
Raseiniai d. mun.;2011;26;385;214;171
Raseiniai d. mun.;2011;27;400;209;191
Raseiniai d. mun.;2011;28;377;204;173
Raseiniai d. mun.;2011;29;365;193;172
Raseiniai d. mun.;2011;30;343;169;174
Raseiniai d. mun.;2011;31;363;189;174
Raseiniai d. mun.;2011;32;370;182;188
Raseiniai d. mun.;2011;33;416;214;202
Raseiniai d. mun.;2011;34;398;201;197
Raseiniai d. mun.;2011;35;444;219;225
Raseiniai d. mun.;2011;36;469;214;255
Raseiniai d. mun.;2011;37;460;232;228
Raseiniai d. mun.;2011;38;504;239;265
Raseiniai d. mun.;2011;39;553;265;288
Raseiniai d. mun.;2011;40;535;295;240
Raseiniai d. mun.;2011;41;523;267;256
Raseiniai d. mun.;2011;42;529;254;275
Raseiniai d. mun.;2011;43;579;292;287
Raseiniai d. mun.;2011;44;538;268;270
Raseiniai d. mun.;2011;45;578;292;286
Raseiniai d. mun.;2011;46;517;265;252
Raseiniai d. mun.;2011;47;519;258;261
Raseiniai d. mun.;2011;48;587;263;324
Raseiniai d. mun.;2011;49;627;309;318
Raseiniai d. mun.;2011;50;599;288;311
Raseiniai d. mun.;2011;51;582;317;265
Raseiniai d. mun.;2011;52;562;267;295
Raseiniai d. mun.;2011;53;522;252;270
Raseiniai d. mun.;2011;54;480;234;246
Raseiniai d. mun.;2011;55;494;229;265
Raseiniai d. mun.;2011;56;445;204;241
Raseiniai d. mun.;2011;57;416;199;217
Raseiniai d. mun.;2011;58;417;175;242
Raseiniai d. mun.;2011;59;478;215;263
Raseiniai d. mun.;2011;60;422;204;218
Raseiniai d. mun.;2011;61;418;190;228
Raseiniai d. mun.;2011;62;397;168;229
Raseiniai d. mun.;2011;63;346;148;198
Raseiniai d. mun.;2011;64;377;169;208
Raseiniai d. mun.;2011;65;393;192;201
Raseiniai d. mun.;2011;66;356;141;215
Raseiniai d. mun.;2011;67;394;145;249
Raseiniai d. mun.;2011;68;475;178;297
Raseiniai d. mun.;2011;69;435;172;263
Raseiniai d. mun.;2011;70;353;143;210
Raseiniai d. mun.;2011;71;377;126;251
Raseiniai d. mun.;2011;72;414;147;267
Raseiniai d. mun.;2011;73;400;132;268
Raseiniai d. mun.;2011;74;402;131;271
Raseiniai d. mun.;2011;75;380;127;253
Raseiniai d. mun.;2011;76;369;126;243
Raseiniai d. mun.;2011;77;383;120;263
Raseiniai d. mun.;2011;78;346;115;231
Raseiniai d. mun.;2011;79;337;112;225
Raseiniai d. mun.;2011;80;289;81;208
Raseiniai d. mun.;2011;81;333;103;230
Raseiniai d. mun.;2011;82;254;74;180
Raseiniai d. mun.;2011;83;229;53;176
Raseiniai d. mun.;2011;84;176;43;133
Raseiniai d. mun.;2011;85;763;175;588
Raseiniai d. mun.;2012;-1;36846;17112;19734
Raseiniai d. mun.;2012;0;324;152;172
Raseiniai d. mun.;2012;1;269;142;127
Raseiniai d. mun.;2012;2;282;137;145
Raseiniai d. mun.;2012;3;298;158;140
Raseiniai d. mun.;2012;4;303;154;149
Raseiniai d. mun.;2012;5;299;141;158
Raseiniai d. mun.;2012;6;322;173;149
Raseiniai d. mun.;2012;7;341;172;169
Raseiniai d. mun.;2012;8;362;193;169
Raseiniai d. mun.;2012;9;345;182;163
Raseiniai d. mun.;2012;10;408;214;194
Raseiniai d. mun.;2012;11;421;212;209
Raseiniai d. mun.;2012;12;450;219;231
Raseiniai d. mun.;2012;13;466;269;197
Raseiniai d. mun.;2012;14;498;244;254
Raseiniai d. mun.;2012;15;486;239;247
Raseiniai d. mun.;2012;16;517;265;252
Raseiniai d. mun.;2012;17;543;274;269
Raseiniai d. mun.;2012;18;572;297;275
Raseiniai d. mun.;2012;19;655;325;330
Raseiniai d. mun.;2012;20;590;302;288
Raseiniai d. mun.;2012;21;503;265;238
Raseiniai d. mun.;2012;22;443;242;201
Raseiniai d. mun.;2012;23;473;252;221
Raseiniai d. mun.;2012;24;492;254;238
Raseiniai d. mun.;2012;25;439;253;186
Raseiniai d. mun.;2012;26;383;193;190
Raseiniai d. mun.;2012;27;339;192;147
Raseiniai d. mun.;2012;28;377;194;183
Raseiniai d. mun.;2012;29;351;194;157
Raseiniai d. mun.;2012;30;348;186;162
Raseiniai d. mun.;2012;31;335;163;172
Raseiniai d. mun.;2012;32;345;179;166
Raseiniai d. mun.;2012;33;352;173;179
Raseiniai d. mun.;2012;34;405;209;196
Raseiniai d. mun.;2012;35;386;193;193
Raseiniai d. mun.;2012;36;431;210;221
Raseiniai d. mun.;2012;37;462;208;254
Raseiniai d. mun.;2012;38;453;230;223
Raseiniai d. mun.;2012;39;497;234;263
Raseiniai d. mun.;2012;40;548;264;284
Raseiniai d. mun.;2012;41;532;294;238
Raseiniai d. mun.;2012;42;518;263;255
Raseiniai d. mun.;2012;43;525;251;274
Raseiniai d. mun.;2012;44;571;285;286
Raseiniai d. mun.;2012;45;531;262;269
Raseiniai d. mun.;2012;46;574;289;285
Raseiniai d. mun.;2012;47;509;262;247
Raseiniai d. mun.;2012;48;513;254;259
Raseiniai d. mun.;2012;49;587;262;325
Raseiniai d. mun.;2012;50;616;302;314
Raseiniai d. mun.;2012;51;597;288;309
Raseiniai d. mun.;2012;52;577;316;261
Raseiniai d. mun.;2012;53;555;264;291
Raseiniai d. mun.;2012;54;514;247;267
Raseiniai d. mun.;2012;55;467;224;243
Raseiniai d. mun.;2012;56;483;223;260
Raseiniai d. mun.;2012;57;431;193;238
Raseiniai d. mun.;2012;58;403;190;213
Raseiniai d. mun.;2012;59;414;172;242
Raseiniai d. mun.;2012;60;474;209;265
Raseiniai d. mun.;2012;61;414;200;214
Raseiniai d. mun.;2012;62;416;189;227
Raseiniai d. mun.;2012;63;396;165;231
Raseiniai d. mun.;2012;64;341;145;196
Raseiniai d. mun.;2012;65;368;162;206
Raseiniai d. mun.;2012;66;386;188;198
Raseiniai d. mun.;2012;67;346;133;213
Raseiniai d. mun.;2012;68;387;141;246
Raseiniai d. mun.;2012;69;466;174;292
Raseiniai d. mun.;2012;70;424;167;257
Raseiniai d. mun.;2012;71;342;137;205
Raseiniai d. mun.;2012;72;369;119;250
Raseiniai d. mun.;2012;73;395;137;258
Raseiniai d. mun.;2012;74;392;127;265
Raseiniai d. mun.;2012;75;384;123;261
Raseiniai d. mun.;2012;76;357;118;239
Raseiniai d. mun.;2012;77;349;115;234
Raseiniai d. mun.;2012;78;358;108;250
Raseiniai d. mun.;2012;79;323;106;217
Raseiniai d. mun.;2012;80;309;100;209
Raseiniai d. mun.;2012;81;267;68;199
Raseiniai d. mun.;2012;82;307;91;216
Raseiniai d. mun.;2012;83;238;69;169
Raseiniai d. mun.;2012;84;202;47;155
Raseiniai d. mun.;2012;85;806;181;625
Raseiniai d. mun.;2013;-1;36056;16790;19266
Raseiniai d. mun.;2013;0;336;161;175
Raseiniai d. mun.;2013;1;318;148;170
Raseiniai d. mun.;2013;2;265;140;125
Raseiniai d. mun.;2013;3;278;135;143
Raseiniai d. mun.;2013;4;294;158;136
Raseiniai d. mun.;2013;5;295;151;144
Raseiniai d. mun.;2013;6;282;133;149
Raseiniai d. mun.;2013;7;316;169;147
Raseiniai d. mun.;2013;8;336;171;165
Raseiniai d. mun.;2013;9;356;190;166
Raseiniai d. mun.;2013;10;341;179;162
Raseiniai d. mun.;2013;11;404;213;191
Raseiniai d. mun.;2013;12;418;210;208
Raseiniai d. mun.;2013;13;447;219;228
Raseiniai d. mun.;2013;14;461;267;194
Raseiniai d. mun.;2013;15;494;244;250
Raseiniai d. mun.;2013;16;481;235;246
Raseiniai d. mun.;2013;17;517;264;253
Raseiniai d. mun.;2013;18;537;269;268
Raseiniai d. mun.;2013;19;550;288;262
Raseiniai d. mun.;2013;20;648;321;327
Raseiniai d. mun.;2013;21;565;289;276
Raseiniai d. mun.;2013;22;481;259;222
Raseiniai d. mun.;2013;23;410;239;171
Raseiniai d. mun.;2013;24;456;248;208
Raseiniai d. mun.;2013;25;461;238;223
Raseiniai d. mun.;2013;26;403;239;164
Raseiniai d. mun.;2013;27;351;182;169
Raseiniai d. mun.;2013;28;299;179;120
Raseiniai d. mun.;2013;29;351;188;163
Raseiniai d. mun.;2013;30;325;176;149
Raseiniai d. mun.;2013;31;337;182;155
Raseiniai d. mun.;2013;32;312;154;158
Raseiniai d. mun.;2013;33;329;173;156
Raseiniai d. mun.;2013;34;346;170;176
Raseiniai d. mun.;2013;35;391;195;196
Raseiniai d. mun.;2013;36;383;189;194
Raseiniai d. mun.;2013;37;425;205;220
Raseiniai d. mun.;2013;38;460;211;249
Raseiniai d. mun.;2013;39;447;226;221
Raseiniai d. mun.;2013;40;495;233;262
Raseiniai d. mun.;2013;41;545;264;281
Raseiniai d. mun.;2013;42;525;290;235
Raseiniai d. mun.;2013;43;511;260;251
Raseiniai d. mun.;2013;44;527;253;274
Raseiniai d. mun.;2013;45;561;283;278
Raseiniai d. mun.;2013;46;522;255;267
Raseiniai d. mun.;2013;47;571;289;282
Raseiniai d. mun.;2013;48;516;265;251
Raseiniai d. mun.;2013;49;501;246;255
Raseiniai d. mun.;2013;50;581;257;324
Raseiniai d. mun.;2013;51;601;292;309
Raseiniai d. mun.;2013;52;598;288;310
Raseiniai d. mun.;2013;53;573;312;261
Raseiniai d. mun.;2013;54;550;260;290
Raseiniai d. mun.;2013;55;505;242;263
Raseiniai d. mun.;2013;56;458;219;239
Raseiniai d. mun.;2013;57;474;218;256
Raseiniai d. mun.;2013;58;428;190;238
Raseiniai d. mun.;2013;59;397;186;211
Raseiniai d. mun.;2013;60;406;166;240
Raseiniai d. mun.;2013;61;468;205;263
Raseiniai d. mun.;2013;62;409;197;212
Raseiniai d. mun.;2013;63;414;188;226
Raseiniai d. mun.;2013;64;386;157;229
Raseiniai d. mun.;2013;65;330;136;194
Raseiniai d. mun.;2013;66;360;155;205
Raseiniai d. mun.;2013;67;376;183;193
Raseiniai d. mun.;2013;68;341;128;213
Raseiniai d. mun.;2013;69;378;135;243
Raseiniai d. mun.;2013;70;458;167;291
Raseiniai d. mun.;2013;71;407;160;247
Raseiniai d. mun.;2013;72;337;135;202
Raseiniai d. mun.;2013;73;357;113;244
Raseiniai d. mun.;2013;74;383;130;253
Raseiniai d. mun.;2013;75;381;122;259
Raseiniai d. mun.;2013;76;366;115;251
Raseiniai d. mun.;2013;77;339;105;234
Raseiniai d. mun.;2013;78;327;102;225
Raseiniai d. mun.;2013;79;328;98;230
Raseiniai d. mun.;2013;80;307;100;207
Raseiniai d. mun.;2013;81;285;90;195
Raseiniai d. mun.;2013;82;247;63;184
Raseiniai d. mun.;2013;83;287;86;201
Raseiniai d. mun.;2013;84;220;58;162
Raseiniai d. mun.;2013;85;814;187;627
Raseiniai d. mun.;2014;-1;35489;16549;18940
Raseiniai d. mun.;2014;0;313;152;161
Raseiniai d. mun.;2014;1;327;155;172
Raseiniai d. mun.;2014;2;314;148;166
Raseiniai d. mun.;2014;3;261;141;120
Raseiniai d. mun.;2014;4;279;133;146
Raseiniai d. mun.;2014;5;290;154;136
Raseiniai d. mun.;2014;6;289;151;138
Raseiniai d. mun.;2014;7;282;133;149
Raseiniai d. mun.;2014;8;310;168;142
Raseiniai d. mun.;2014;9;333;168;165
Raseiniai d. mun.;2014;10;349;189;160
Raseiniai d. mun.;2014;11;343;180;163
Raseiniai d. mun.;2014;12;403;211;192
Raseiniai d. mun.;2014;13;413;208;205
Raseiniai d. mun.;2014;14;442;214;228
Raseiniai d. mun.;2014;15;457;266;191
Raseiniai d. mun.;2014;16;492;242;250
Raseiniai d. mun.;2014;17;479;235;244
Raseiniai d. mun.;2014;18;505;261;244
Raseiniai d. mun.;2014;19;526;263;263
Raseiniai d. mun.;2014;20;533;283;250
Raseiniai d. mun.;2014;21;626;312;314
Raseiniai d. mun.;2014;22;540;288;252
Raseiniai d. mun.;2014;23;462;252;210
Raseiniai d. mun.;2014;24;391;225;166
Raseiniai d. mun.;2014;25;434;239;195
Raseiniai d. mun.;2014;26;436;228;208
Raseiniai d. mun.;2014;27;373;225;148
Raseiniai d. mun.;2014;28;353;185;168
Raseiniai d. mun.;2014;29;304;179;125
Raseiniai d. mun.;2014;30;345;184;161
Raseiniai d. mun.;2014;31;333;177;156
Raseiniai d. mun.;2014;32;321;181;140
Raseiniai d. mun.;2014;33;297;151;146
Raseiniai d. mun.;2014;34;323;170;153
Raseiniai d. mun.;2014;35;348;172;176
Raseiniai d. mun.;2014;36;391;196;195
Raseiniai d. mun.;2014;37;379;184;195
Raseiniai d. mun.;2014;38;421;201;220
Raseiniai d. mun.;2014;39;453;208;245
Raseiniai d. mun.;2014;40;444;224;220
Raseiniai d. mun.;2014;41;492;231;261
Raseiniai d. mun.;2014;42;553;271;282
Raseiniai d. mun.;2014;43;522;290;232
Raseiniai d. mun.;2014;44;507;256;251
Raseiniai d. mun.;2014;45;518;250;268
Raseiniai d. mun.;2014;46;556;280;276
Raseiniai d. mun.;2014;47;516;250;266
Raseiniai d. mun.;2014;48;571;289;282
Raseiniai d. mun.;2014;49;507;259;248
Raseiniai d. mun.;2014;50;495;241;254
Raseiniai d. mun.;2014;51;578;257;321
Raseiniai d. mun.;2014;52;597;291;306
Raseiniai d. mun.;2014;53;593;286;307
Raseiniai d. mun.;2014;54;563;303;260
Raseiniai d. mun.;2014;55;542;255;287
Raseiniai d. mun.;2014;56;500;238;262
Raseiniai d. mun.;2014;57;445;208;237
Raseiniai d. mun.;2014;58;463;210;253
Raseiniai d. mun.;2014;59;421;185;236
Raseiniai d. mun.;2014;60;397;186;211
Raseiniai d. mun.;2014;61;405;164;241
Raseiniai d. mun.;2014;62;462;200;262
Raseiniai d. mun.;2014;63;405;194;211
Raseiniai d. mun.;2014;64;403;182;221
Raseiniai d. mun.;2014;65;382;154;228
Raseiniai d. mun.;2014;66;320;132;188
Raseiniai d. mun.;2014;67;349;146;203
Raseiniai d. mun.;2014;68;366;176;190
Raseiniai d. mun.;2014;69;333;122;211
Raseiniai d. mun.;2014;70;365;126;239
Raseiniai d. mun.;2014;71;454;165;289
Raseiniai d. mun.;2014;72;396;155;241
Raseiniai d. mun.;2014;73;329;130;199
Raseiniai d. mun.;2014;74;337;102;235
Raseiniai d. mun.;2014;75;373;127;246
Raseiniai d. mun.;2014;76;369;113;256
Raseiniai d. mun.;2014;77;348;111;237
Raseiniai d. mun.;2014;78;309;89;220
Raseiniai d. mun.;2014;79;299;89;210
Raseiniai d. mun.;2014;80;311;89;222
Raseiniai d. mun.;2014;81;284;92;192
Raseiniai d. mun.;2014;82;263;78;185
Raseiniai d. mun.;2014;83;232;59;173
Raseiniai d. mun.;2014;84;269;78;191
Raseiniai d. mun.;2014;85;876;204;672
Raseiniai d. mun.;2015;-1;35013;16338;18675
Raseiniai d. mun.;2015;0;354;165;189
Raseiniai d. mun.;2015;1;312;156;156
Raseiniai d. mun.;2015;2;310;144;166
Raseiniai d. mun.;2015;3;310;144;166
Raseiniai d. mun.;2015;4;259;140;119
Raseiniai d. mun.;2015;5;279;134;145
Raseiniai d. mun.;2015;6;295;156;139
Raseiniai d. mun.;2015;7;288;148;140
Raseiniai d. mun.;2015;8;280;131;149
Raseiniai d. mun.;2015;9;308;169;139
Raseiniai d. mun.;2015;10;336;168;168
Raseiniai d. mun.;2015;11;347;188;159
Raseiniai d. mun.;2015;12;347;180;167
Raseiniai d. mun.;2015;13;401;209;192
Raseiniai d. mun.;2015;14;410;207;203
Raseiniai d. mun.;2015;15;444;216;228
Raseiniai d. mun.;2015;16;456;265;191
Raseiniai d. mun.;2015;17;489;243;246
Raseiniai d. mun.;2015;18;476;233;243
Raseiniai d. mun.;2015;19;498;256;242
Raseiniai d. mun.;2015;20;514;260;254
Raseiniai d. mun.;2015;21;519;273;246
Raseiniai d. mun.;2015;22;607;302;305
Raseiniai d. mun.;2015;23;512;279;233
Raseiniai d. mun.;2015;24;448;251;197
Raseiniai d. mun.;2015;25;375;221;154
Raseiniai d. mun.;2015;26;414;227;187
Raseiniai d. mun.;2015;27;421;226;195
Raseiniai d. mun.;2015;28;348;218;130
Raseiniai d. mun.;2015;29;342;185;157
Raseiniai d. mun.;2015;30;289;162;127
Raseiniai d. mun.;2015;31;317;169;148
Raseiniai d. mun.;2015;32;321;169;152
Raseiniai d. mun.;2015;33;296;168;128
Raseiniai d. mun.;2015;34;289;145;144
Raseiniai d. mun.;2015;35;313;167;146
Raseiniai d. mun.;2015;36;349;173;176
Raseiniai d. mun.;2015;37;392;196;196
Raseiniai d. mun.;2015;38;376;181;195
Raseiniai d. mun.;2015;39;415;200;215
Raseiniai d. mun.;2015;40;451;208;243
Raseiniai d. mun.;2015;41;442;224;218
Raseiniai d. mun.;2015;42;494;235;259
Raseiniai d. mun.;2015;43;552;268;284
Raseiniai d. mun.;2015;44;514;286;228
Raseiniai d. mun.;2015;45;511;258;253
Raseiniai d. mun.;2015;46;514;248;266
Raseiniai d. mun.;2015;47;554;279;275
Raseiniai d. mun.;2015;48;509;247;262
Raseiniai d. mun.;2015;49;570;287;283
Raseiniai d. mun.;2015;50;509;259;250
Raseiniai d. mun.;2015;51;498;243;255
Raseiniai d. mun.;2015;52;572;254;318
Raseiniai d. mun.;2015;53;585;286;299
Raseiniai d. mun.;2015;54;593;287;306
Raseiniai d. mun.;2015;55;569;305;264
Raseiniai d. mun.;2015;56;540;253;287
Raseiniai d. mun.;2015;57;493;238;255
Raseiniai d. mun.;2015;58;440;205;235
Raseiniai d. mun.;2015;59;453;203;250
Raseiniai d. mun.;2015;60;414;176;238
Raseiniai d. mun.;2015;61;390;183;207
Raseiniai d. mun.;2015;62;397;157;240
Raseiniai d. mun.;2015;63;460;197;263
Raseiniai d. mun.;2015;64;397;189;208
Raseiniai d. mun.;2015;65;393;175;218
Raseiniai d. mun.;2015;66;375;148;227
Raseiniai d. mun.;2015;67;310;127;183
Raseiniai d. mun.;2015;68;343;143;200
Raseiniai d. mun.;2015;69;362;172;190
Raseiniai d. mun.;2015;70;321;120;201
Raseiniai d. mun.;2015;71;354;117;237
Raseiniai d. mun.;2015;72;436;154;282
Raseiniai d. mun.;2015;73;385;147;238
Raseiniai d. mun.;2015;74;320;125;195
Raseiniai d. mun.;2015;75;318;96;222
Raseiniai d. mun.;2015;76;360;117;243
Raseiniai d. mun.;2015;77;360;108;252
Raseiniai d. mun.;2015;78;337;105;232
Raseiniai d. mun.;2015;79;293;83;210
Raseiniai d. mun.;2015;80;278;77;201
Raseiniai d. mun.;2015;81;291;81;210
Raseiniai d. mun.;2015;82;268;85;183
Raseiniai d. mun.;2015;83;228;68;160
Raseiniai d. mun.;2015;84;209;53;156
Raseiniai d. mun.;2015;85;995;238;757
Raseiniai d. mun.;2016;-1;34294;16044;18250
Raseiniai d. mun.;2016;0;322;170;152
Raseiniai d. mun.;2016;1;348;166;182
Raseiniai d. mun.;2016;2;314;158;156
Raseiniai d. mun.;2016;3;311;148;163
Raseiniai d. mun.;2016;4;308;144;164
Raseiniai d. mun.;2016;5;260;143;117
Raseiniai d. mun.;2016;6;273;129;144
Raseiniai d. mun.;2016;7;298;158;140
Raseiniai d. mun.;2016;8;285;147;138
Raseiniai d. mun.;2016;9;276;130;146
Raseiniai d. mun.;2016;10;305;165;140
Raseiniai d. mun.;2016;11;335;166;169
Raseiniai d. mun.;2016;12;344;187;157
Raseiniai d. mun.;2016;13;345;177;168
Raseiniai d. mun.;2016;14;398;208;190
Raseiniai d. mun.;2016;15;406;205;201
Raseiniai d. mun.;2016;16;445;218;227
Raseiniai d. mun.;2016;17;454;265;189
Raseiniai d. mun.;2016;18;478;238;240
Raseiniai d. mun.;2016;19;470;227;243
Raseiniai d. mun.;2016;20;487;251;236
Raseiniai d. mun.;2016;21;506;253;253
Raseiniai d. mun.;2016;22;497;260;237
Raseiniai d. mun.;2016;23;586;298;288
Raseiniai d. mun.;2016;24;479;264;215
Raseiniai d. mun.;2016;25;418;231;187
Raseiniai d. mun.;2016;26;351;215;136
Raseiniai d. mun.;2016;27;382;213;169
Raseiniai d. mun.;2016;28;394;211;183
Raseiniai d. mun.;2016;29;333;209;124
Raseiniai d. mun.;2016;30;318;165;153
Raseiniai d. mun.;2016;31;277;155;122
Raseiniai d. mun.;2016;32;308;167;141
Raseiniai d. mun.;2016;33;320;166;154
Raseiniai d. mun.;2016;34;293;166;127
Raseiniai d. mun.;2016;35;285;144;141
Raseiniai d. mun.;2016;36;306;163;143
Raseiniai d. mun.;2016;37;339;165;174
Raseiniai d. mun.;2016;38;384;190;194
Raseiniai d. mun.;2016;39;377;184;193
Raseiniai d. mun.;2016;40;407;196;211
Raseiniai d. mun.;2016;41;449;206;243
Raseiniai d. mun.;2016;42;434;220;214
Raseiniai d. mun.;2016;43;499;240;259
Raseiniai d. mun.;2016;44;544;260;284
Raseiniai d. mun.;2016;45;510;278;232
Raseiniai d. mun.;2016;46;501;251;250
Raseiniai d. mun.;2016;47;509;242;267
Raseiniai d. mun.;2016;48;549;277;272
Raseiniai d. mun.;2016;49;504;243;261
Raseiniai d. mun.;2016;50;560;283;277
Raseiniai d. mun.;2016;51;510;261;249
Raseiniai d. mun.;2016;52;493;241;252
Raseiniai d. mun.;2016;53;566;251;315
Raseiniai d. mun.;2016;54;579;283;296
Raseiniai d. mun.;2016;55;582;280;302
Raseiniai d. mun.;2016;56;563;300;263
Raseiniai d. mun.;2016;57;532;246;286
Raseiniai d. mun.;2016;58;486;234;252
Raseiniai d. mun.;2016;59;426;194;232
Raseiniai d. mun.;2016;60;447;201;246
Raseiniai d. mun.;2016;61;408;173;235
Raseiniai d. mun.;2016;62;383;181;202
Raseiniai d. mun.;2016;63;383;147;236
Raseiniai d. mun.;2016;64;453;193;260
Raseiniai d. mun.;2016;65;386;181;205
Raseiniai d. mun.;2016;66;388;168;220
Raseiniai d. mun.;2016;67;367;146;221
Raseiniai d. mun.;2016;68;305;124;181
Raseiniai d. mun.;2016;69;328;137;191
Raseiniai d. mun.;2016;70;355;167;188
Raseiniai d. mun.;2016;71;310;113;197
Raseiniai d. mun.;2016;72;341;111;230
Raseiniai d. mun.;2016;73;420;143;277
Raseiniai d. mun.;2016;74;375;145;230
Raseiniai d. mun.;2016;75;304;118;186
Raseiniai d. mun.;2016;76;307;91;216
Raseiniai d. mun.;2016;77;351;116;235
Raseiniai d. mun.;2016;78;342;101;241
Raseiniai d. mun.;2016;79;318;100;218
Raseiniai d. mun.;2016;80;280;79;201
Raseiniai d. mun.;2016;81;249;66;183
Raseiniai d. mun.;2016;82;267;74;193
Raseiniai d. mun.;2016;83;236;75;161
Raseiniai d. mun.;2016;84;195;55;140
Raseiniai d. mun.;2016;85;978;234;744
Raseiniai d. mun.;2017;-1;33467;15689;17778
Raseiniai d. mun.;2017;0;288;147;141
Raseiniai d. mun.;2017;1;308;163;145
Raseiniai d. mun.;2017;2;336;161;175
Raseiniai d. mun.;2017;3;307;155;152
Raseiniai d. mun.;2017;4;303;147;156
Raseiniai d. mun.;2017;5;298;138;160
Raseiniai d. mun.;2017;6;253;138;115
Raseiniai d. mun.;2017;7;270;127;143
Raseiniai d. mun.;2017;8;302;158;144
Raseiniai d. mun.;2017;9;280;142;138
Raseiniai d. mun.;2017;10;279;131;148
Raseiniai d. mun.;2017;11;310;167;143
Raseiniai d. mun.;2017;12;336;166;170
Raseiniai d. mun.;2017;13;336;181;155
Raseiniai d. mun.;2017;14;344;176;168
Raseiniai d. mun.;2017;15;400;209;191
Raseiniai d. mun.;2017;16;401;203;198
Raseiniai d. mun.;2017;17;445;220;225
Raseiniai d. mun.;2017;18;444;261;183
Raseiniai d. mun.;2017;19;468;236;232
Raseiniai d. mun.;2017;20;455;218;237
Raseiniai d. mun.;2017;21;479;246;233
Raseiniai d. mun.;2017;22;493;251;242
Raseiniai d. mun.;2017;23;465;248;217
Raseiniai d. mun.;2017;24;551;287;264
Raseiniai d. mun.;2017;25;433;245;188
Raseiniai d. mun.;2017;26;382;217;165
Raseiniai d. mun.;2017;27;321;209;112
Raseiniai d. mun.;2017;28;352;201;151
Raseiniai d. mun.;2017;29;379;200;179
Raseiniai d. mun.;2017;30;311;192;119
Raseiniai d. mun.;2017;31;302;162;140
Raseiniai d. mun.;2017;32;265;154;111
Raseiniai d. mun.;2017;33;292;162;130
Raseiniai d. mun.;2017;34;303;151;152
Raseiniai d. mun.;2017;35;280;157;123
Raseiniai d. mun.;2017;36;277;139;138
Raseiniai d. mun.;2017;37;295;158;137
Raseiniai d. mun.;2017;38;337;161;176
Raseiniai d. mun.;2017;39;386;192;194
Raseiniai d. mun.;2017;40;362;178;184
Raseiniai d. mun.;2017;41;395;191;204
Raseiniai d. mun.;2017;42;448;206;242
Raseiniai d. mun.;2017;43;428;216;212
Raseiniai d. mun.;2017;44;493;239;254
Raseiniai d. mun.;2017;45;530;254;276
Raseiniai d. mun.;2017;46;503;271;232
Raseiniai d. mun.;2017;47;497;248;249
Raseiniai d. mun.;2017;48;508;243;265
Raseiniai d. mun.;2017;49;548;278;270
Raseiniai d. mun.;2017;50;500;239;261
Raseiniai d. mun.;2017;51;552;277;275
Raseiniai d. mun.;2017;52;508;258;250
Raseiniai d. mun.;2017;53;489;239;250
Raseiniai d. mun.;2017;54;559;249;310
Raseiniai d. mun.;2017;55;569;277;292
Raseiniai d. mun.;2017;56;575;276;299
Raseiniai d. mun.;2017;57;549;290;259
Raseiniai d. mun.;2017;58;521;238;283
Raseiniai d. mun.;2017;59;477;227;250
Raseiniai d. mun.;2017;60;421;190;231
Raseiniai d. mun.;2017;61;441;196;245
Raseiniai d. mun.;2017;62;396;167;229
Raseiniai d. mun.;2017;63;374;176;198
Raseiniai d. mun.;2017;64;377;140;237
Raseiniai d. mun.;2017;65;445;186;259
Raseiniai d. mun.;2017;66;369;168;201
Raseiniai d. mun.;2017;67;381;165;216
Raseiniai d. mun.;2017;68;353;137;216
Raseiniai d. mun.;2017;69;295;118;177
Raseiniai d. mun.;2017;70;322;134;188
Raseiniai d. mun.;2017;71;337;155;182
Raseiniai d. mun.;2017;72;293;107;186
Raseiniai d. mun.;2017;73;331;106;225
Raseiniai d. mun.;2017;74;408;137;271
Raseiniai d. mun.;2017;75;364;141;223
Raseiniai d. mun.;2017;76;289;109;180
Raseiniai d. mun.;2017;77;294;85;209
Raseiniai d. mun.;2017;78;330;105;225
Raseiniai d. mun.;2017;79;318;93;225
Raseiniai d. mun.;2017;80;299;91;208
Raseiniai d. mun.;2017;81;263;72;191
Raseiniai d. mun.;2017;82;224;58;166
Raseiniai d. mun.;2017;83;248;72;176
Raseiniai d. mun.;2017;84;216;65;151
Raseiniai d. mun.;2017;85;1002;246;756
Raseiniai d. mun.;2018;-1;32510;15238;17272
Raseiniai d. mun.;2018;0;263;117;146
Raseiniai d. mun.;2018;1;276;146;130
Raseiniai d. mun.;2018;2;309;165;144
Raseiniai d. mun.;2018;3;334;160;174
Raseiniai d. mun.;2018;4;312;157;155
Raseiniai d. mun.;2018;5;300;145;155
Raseiniai d. mun.;2018;6;294;139;155
Raseiniai d. mun.;2018;7;247;133;114
Raseiniai d. mun.;2018;8;272;127;145
Raseiniai d. mun.;2018;9;293;155;138
Raseiniai d. mun.;2018;10;281;145;136
Raseiniai d. mun.;2018;11;272;130;142
Raseiniai d. mun.;2018;12;304;162;142
Raseiniai d. mun.;2018;13;330;164;166
Raseiniai d. mun.;2018;14;336;181;155
Raseiniai d. mun.;2018;15;338;173;165
Raseiniai d. mun.;2018;16;398;207;191
Raseiniai d. mun.;2018;17;400;200;200
Raseiniai d. mun.;2018;18;437;217;220
Raseiniai d. mun.;2018;19;431;257;174
Raseiniai d. mun.;2018;20;451;230;221
Raseiniai d. mun.;2018;21;440;209;231
Raseiniai d. mun.;2018;22;435;222;213
Raseiniai d. mun.;2018;23;460;237;223
Raseiniai d. mun.;2018;24;426;235;191
Raseiniai d. mun.;2018;25;495;263;232
Raseiniai d. mun.;2018;26;407;239;168
Raseiniai d. mun.;2018;27;327;187;140
Raseiniai d. mun.;2018;28;291;186;105
Raseiniai d. mun.;2018;29;325;190;135
Raseiniai d. mun.;2018;30;350;184;166
Raseiniai d. mun.;2018;31;286;173;113
Raseiniai d. mun.;2018;32;289;162;127
Raseiniai d. mun.;2018;33;243;140;103
Raseiniai d. mun.;2018;34;282;159;123
Raseiniai d. mun.;2018;35;287;142;145
Raseiniai d. mun.;2018;36;267;148;119
Raseiniai d. mun.;2018;37;270;135;135
Raseiniai d. mun.;2018;38;291;154;137
Raseiniai d. mun.;2018;39;324;155;169
Raseiniai d. mun.;2018;40;378;185;193
Raseiniai d. mun.;2018;41;358;174;184
Raseiniai d. mun.;2018;42;381;182;199
Raseiniai d. mun.;2018;43;442;201;241
Raseiniai d. mun.;2018;44;422;213;209
Raseiniai d. mun.;2018;45;482;234;248
Raseiniai d. mun.;2018;46;520;247;273
Raseiniai d. mun.;2018;47;498;267;231
Raseiniai d. mun.;2018;48;488;243;245
Raseiniai d. mun.;2018;49;510;245;265
Raseiniai d. mun.;2018;50;543;274;269
Raseiniai d. mun.;2018;51;491;232;259
Raseiniai d. mun.;2018;52;552;274;278
Raseiniai d. mun.;2018;53;501;255;246
Raseiniai d. mun.;2018;54;480;230;250
Raseiniai d. mun.;2018;55;549;243;306
Raseiniai d. mun.;2018;56;557;268;289
Raseiniai d. mun.;2018;57;563;267;296
Raseiniai d. mun.;2018;58;544;283;261
Raseiniai d. mun.;2018;59;510;237;273
Raseiniai d. mun.;2018;60;468;220;248
Raseiniai d. mun.;2018;61;420;189;231
Raseiniai d. mun.;2018;62;439;195;244
Raseiniai d. mun.;2018;63;387;161;226
Raseiniai d. mun.;2018;64;367;172;195
Raseiniai d. mun.;2018;65;370;135;235
Raseiniai d. mun.;2018;66;440;184;256
Raseiniai d. mun.;2018;67;358;161;197
Raseiniai d. mun.;2018;68;374;161;213
Raseiniai d. mun.;2018;69;348;135;213
Raseiniai d. mun.;2018;70;287;115;172
Raseiniai d. mun.;2018;71;312;127;185
Raseiniai d. mun.;2018;72;330;151;179
Raseiniai d. mun.;2018;73;286;105;181
Raseiniai d. mun.;2018;74;323;102;221
Raseiniai d. mun.;2018;75;396;131;265
Raseiniai d. mun.;2018;76;337;128;209
Raseiniai d. mun.;2018;77;279;103;176
Raseiniai d. mun.;2018;78;287;78;209
Raseiniai d. mun.;2018;79;309;99;210
Raseiniai d. mun.;2018;80;289;82;207
Raseiniai d. mun.;2018;81;288;85;203
Raseiniai d. mun.;2018;82;248;66;182
Raseiniai d. mun.;2018;83;210;55;155
Raseiniai d. mun.;2018;84;223;65;158
Raseiniai d. mun.;2018;85;993;249;744
Republic of Lithuania;2001;-1;3486998;1630930;1856068
Republic of Lithuania;2001;0;33488;17343;16145
Republic of Lithuania;2001;1;35789;18450;17339
Republic of Lithuania;2001;2;36203;18780;17423
Republic of Lithuania;2001;3;36990;19016;17974
Republic of Lithuania;2001;4;38297;19530;18767
Republic of Lithuania;2001;5;39981;20498;19483
Republic of Lithuania;2001;6;41068;21019;20049
Republic of Lithuania;2001;7;46153;23681;22472
Republic of Lithuania;2001;8;52584;26753;25831
Republic of Lithuania;2001;9;52641;26992;25649
Republic of Lithuania;2001;10;53811;27416;26395
Republic of Lithuania;2001;11;52618;26899;25719
Republic of Lithuania;2001;12;53434;27253;26181
Republic of Lithuania;2001;13;56206;28665;27541
Republic of Lithuania;2001;14;57641;29709;27932
Republic of Lithuania;2001;15;55902;28297;27605
Republic of Lithuania;2001;16;55055;27995;27060
Republic of Lithuania;2001;17;53854;27614;26240
Republic of Lithuania;2001;18;49980;25365;24615
Republic of Lithuania;2001;19;49076;25187;23889
Republic of Lithuania;2001;20;48091;24571;23520
Republic of Lithuania;2001;21;47225;23966;23259
Republic of Lithuania;2001;22;46406;23472;22934
Republic of Lithuania;2001;23;46218;23320;22898
Republic of Lithuania;2001;24;46167;23028;23139
Republic of Lithuania;2001;25;45844;22889;22955
Republic of Lithuania;2001;26;46469;23032;23437
Republic of Lithuania;2001;27;47698;23902;23796
Republic of Lithuania;2001;28;50299;25144;25155
Republic of Lithuania;2001;29;51822;25661;26161
Republic of Lithuania;2001;30;51373;25450;25923
Republic of Lithuania;2001;31;50666;25174;25492
Republic of Lithuania;2001;32;51099;25177;25922
Republic of Lithuania;2001;33;50939;24995;25944
Republic of Lithuania;2001;34;51290;25293;25997
Republic of Lithuania;2001;35;51360;25533;25827
Republic of Lithuania;2001;36;53183;26214;26969
Republic of Lithuania;2001;37;54218;26832;27386
Republic of Lithuania;2001;38;56462;27714;28748
Republic of Lithuania;2001;39;58100;28209;29891
Republic of Lithuania;2001;40;56433;27229;29204
Republic of Lithuania;2001;41;56513;27196;29317
Republic of Lithuania;2001;42;53440;25591;27849
Republic of Lithuania;2001;43;50267;24159;26108
Republic of Lithuania;2001;44;47710;22776;24934
Republic of Lithuania;2001;45;46468;22189;24279
Republic of Lithuania;2001;46;43378;20560;22818
Republic of Lithuania;2001;47;41709;19819;21890
Republic of Lithuania;2001;48;43324;20395;22929
Republic of Lithuania;2001;49;43150;20212;22938
Republic of Lithuania;2001;50;42825;19888;22937
Republic of Lithuania;2001;51;42387;19408;22979
Republic of Lithuania;2001;52;38512;17495;21017
Republic of Lithuania;2001;53;35638;16190;19448
Republic of Lithuania;2001;54;34007;15311;18696
Republic of Lithuania;2001;55;37330;16671;20659
Republic of Lithuania;2001;56;32278;14452;17826
Republic of Lithuania;2001;57;37542;16422;21120
Republic of Lithuania;2001;58;40739;17699;23040
Republic of Lithuania;2001;59;39070;17027;22043
Republic of Lithuania;2001;60;37036;15916;21120
Republic of Lithuania;2001;61;36723;15618;21105
Republic of Lithuania;2001;62;37188;15639;21549
Republic of Lithuania;2001;63;36195;14824;21371
Republic of Lithuania;2001;64;36766;15154;21612
Republic of Lithuania;2001;65;34951;14229;20722
Republic of Lithuania;2001;66;32618;12960;19658
Republic of Lithuania;2001;67;33698;13417;20281
Republic of Lithuania;2001;68;33651;12965;20686
Republic of Lithuania;2001;69;31614;12067;19547
Republic of Lithuania;2001;70;31645;12135;19510
Republic of Lithuania;2001;71;29305;10915;18390
Republic of Lithuania;2001;72;29867;10720;19147
Republic of Lithuania;2001;73;27265;9695;17570
Republic of Lithuania;2001;74;24284;7479;16805
Republic of Lithuania;2001;75;23086;6884;16202
Republic of Lithuania;2001;76;20843;6166;14677
Republic of Lithuania;2001;77;19668;5942;13726
Republic of Lithuania;2001;78;17407;5102;12305
Republic of Lithuania;2001;79;14792;4376;10416
Republic of Lithuania;2001;80;12557;3641;8916
Republic of Lithuania;2001;81;9804;2794;7010
Republic of Lithuania;2001;82;7060;1880;5180
Republic of Lithuania;2001;83;6089;1745;4344
Republic of Lithuania;2001;84;6265;1732;4533
Republic of Lithuania;2001;85;38201;10208;27993
Republic of Lithuania;2002;-1;3454637;1613554;1841083
Republic of Lithuania;2002;0;30885;15756;15129
Republic of Lithuania;2002;1;33281;17240;16041
Republic of Lithuania;2002;2;35607;18327;17280
Republic of Lithuania;2002;3;36030;18716;17314
Republic of Lithuania;2002;4;36790;18904;17886
Republic of Lithuania;2002;5;38129;19445;18684
Republic of Lithuania;2002;6;39797;20386;19411
Republic of Lithuania;2002;7;40949;20966;19983
Republic of Lithuania;2002;8;45938;23569;22369
Republic of Lithuania;2002;9;52207;26452;25755
Republic of Lithuania;2002;10;52424;26866;25558
Republic of Lithuania;2002;11;53262;27085;26177
Republic of Lithuania;2002;12;52018;26581;25437
Republic of Lithuania;2002;13;52566;26770;25796
Republic of Lithuania;2002;14;55545;28239;27306
Republic of Lithuania;2002;15;56885;29192;27693
Republic of Lithuania;2002;16;55282;27967;27315
Republic of Lithuania;2002;17;54218;27486;26732
Republic of Lithuania;2002;18;53133;27168;25965
Republic of Lithuania;2002;19;48937;24748;24189
Republic of Lithuania;2002;20;48230;24609;23621
Republic of Lithuania;2002;21;46993;23903;23090
Republic of Lithuania;2002;22;46213;23330;22883
Republic of Lithuania;2002;23;45536;22967;22569
Republic of Lithuania;2002;24;45173;22692;22481
Republic of Lithuania;2002;25;45476;22721;22755
Republic of Lithuania;2002;26;45081;22417;22664
Republic of Lithuania;2002;27;45802;22543;23259
Republic of Lithuania;2002;28;46921;23318;23603
Republic of Lithuania;2002;29;49306;24537;24769
Republic of Lithuania;2002;30;50845;25174;25671
Republic of Lithuania;2002;31;50433;24988;25445
Republic of Lithuania;2002;32;49792;24637;25155
Republic of Lithuania;2002;33;50348;24698;25650
Republic of Lithuania;2002;34;50269;24599;25670
Republic of Lithuania;2002;35;50469;24738;25731
Republic of Lithuania;2002;36;50703;25173;25530
Republic of Lithuania;2002;37;52345;25676;26669
Republic of Lithuania;2002;38;53340;26260;27080
Republic of Lithuania;2002;39;55339;27006;28333
Republic of Lithuania;2002;40;57067;27542;29525
Republic of Lithuania;2002;41;55743;26851;28892
Republic of Lithuania;2002;42;55880;26877;29003
Republic of Lithuania;2002;43;53081;25480;27601
Republic of Lithuania;2002;44;49663;23856;25807
Republic of Lithuania;2002;45;46733;22257;24476
Republic of Lithuania;2002;46;45725;21788;23937
Republic of Lithuania;2002;47;43154;20510;22644
Republic of Lithuania;2002;48;40867;19357;21510
Republic of Lithuania;2002;49;42450;19918;22532
Republic of Lithuania;2002;50;42504;19703;22801
Republic of Lithuania;2002;51;41913;19388;22525
Republic of Lithuania;2002;52;41996;19162;22834
Republic of Lithuania;2002;53;38072;17324;20748
Republic of Lithuania;2002;54;34922;15898;19024
Republic of Lithuania;2002;55;33249;14939;18310
Republic of Lithuania;2002;56;36396;16195;20201
Republic of Lithuania;2002;57;31597;14148;17449
Republic of Lithuania;2002;58;36585;15956;20629
Republic of Lithuania;2002;59;39770;17179;22591
Republic of Lithuania;2002;60;38550;16725;21825
Republic of Lithuania;2002;61;36715;15691;21024
Republic of Lithuania;2002;62;36448;15397;21051
Republic of Lithuania;2002;63;36811;15331;21480
Republic of Lithuania;2002;64;35850;14559;21291
Republic of Lithuania;2002;65;36315;14875;21440
Republic of Lithuania;2002;66;34364;13850;20514
Republic of Lithuania;2002;67;32036;12665;19371
Republic of Lithuania;2002;68;33136;13069;20067
Republic of Lithuania;2002;69;32977;12539;20438
Republic of Lithuania;2002;70;31112;11781;19331
Republic of Lithuania;2002;71;30955;11699;19256
Republic of Lithuania;2002;72;28641;10546;18095
Republic of Lithuania;2002;73;29098;10367;18731
Republic of Lithuania;2002;74;26529;9328;17201
Republic of Lithuania;2002;75;23553;7145;16408
Republic of Lithuania;2002;76;22218;6538;15680
Republic of Lithuania;2002;77;19962;5788;14174
Republic of Lithuania;2002;78;18847;5586;13261
Republic of Lithuania;2002;79;16594;4777;11817
Republic of Lithuania;2002;80;13961;4045;9916
Republic of Lithuania;2002;81;11620;3290;8330
Republic of Lithuania;2002;82;9003;2535;6468
Republic of Lithuania;2002;83;6483;1709;4774
Republic of Lithuania;2002;84;5548;1550;3998
Republic of Lithuania;2002;85;37447;9992;27455
Republic of Lithuania;2003;-1;3431497;1601098;1830399
Republic of Lithuania;2003;0;29295;15091;14204
Republic of Lithuania;2003;1;30771;15693;15078
Republic of Lithuania;2003;2;33142;17141;16001
Republic of Lithuania;2003;3;35453;18225;17228
Republic of Lithuania;2003;4;35904;18637;17267
Republic of Lithuania;2003;5;36689;18840;17849
Republic of Lithuania;2003;6;38009;19384;18625
Republic of Lithuania;2003;7;39683;20335;19348
Republic of Lithuania;2003;8;40860;20931;19929
Republic of Lithuania;2003;9;45843;23510;22333
Republic of Lithuania;2003;10;51874;26356;25518
Republic of Lithuania;2003;11;52125;26746;25379
Republic of Lithuania;2003;12;52618;26754;25864
Republic of Lithuania;2003;13;51290;26183;25107
Republic of Lithuania;2003;14;51866;26299;25567
Republic of Lithuania;2003;15;54694;27729;26965
Republic of Lithuania;2003;16;56060;28740;27320
Republic of Lithuania;2003;17;54336;27394;26942
Republic of Lithuania;2003;18;53550;27125;26425
Republic of Lithuania;2003;19;52513;26811;25702
Republic of Lithuania;2003;20;48211;24407;23804
Republic of Lithuania;2003;21;47664;24384;23280
Republic of Lithuania;2003;22;46479;23649;22830
Republic of Lithuania;2003;23;45841;23064;22777
Republic of Lithuania;2003;24;45168;22723;22445
Republic of Lithuania;2003;25;44940;22607;22333
Republic of Lithuania;2003;26;45269;22633;22636
Republic of Lithuania;2003;27;44711;22127;22584
Republic of Lithuania;2003;28;45510;22322;23188
Republic of Lithuania;2003;29;46550;23117;23433
Republic of Lithuania;2003;30;48913;24341;24572
Republic of Lithuania;2003;31;50530;25026;25504
Republic of Lithuania;2003;32;50117;24850;25267
Republic of Lithuania;2003;33;49396;24463;24933
Republic of Lithuania;2003;34;49906;24509;25397
Republic of Lithuania;2003;35;49628;24230;25398
Republic of Lithuania;2003;36;49970;24515;25455
Republic of Lithuania;2003;37;50132;24855;25277
Republic of Lithuania;2003;38;51849;25458;26391
Republic of Lithuania;2003;39;52820;26010;26810
Republic of Lithuania;2003;40;54801;26749;28052
Republic of Lithuania;2003;41;56582;27300;29282
Republic of Lithuania;2003;42;55332;26590;28742
Republic of Lithuania;2003;43;55412;26633;28779
Republic of Lithuania;2003;44;52840;25405;27435
Republic of Lithuania;2003;45;49164;23554;25610
Republic of Lithuania;2003;46;46272;21975;24297
Republic of Lithuania;2003;47;45273;21508;23765
Republic of Lithuania;2003;48;42751;20222;22529
Republic of Lithuania;2003;49;40408;19069;21339
Republic of Lithuania;2003;50;41970;19632;22338
Republic of Lithuania;2003;51;41853;19363;22490
Republic of Lithuania;2003;52;41369;19036;22333
Republic of Lithuania;2003;53;41771;19081;22690
Republic of Lithuania;2003;54;37616;16988;20628
Republic of Lithuania;2003;55;34452;15559;18893
Republic of Lithuania;2003;56;32783;14642;18141
Republic of Lithuania;2003;57;35844;15811;20033
Republic of Lithuania;2003;58;31025;13737;17288
Republic of Lithuania;2003;59;36020;15607;20413
Republic of Lithuania;2003;60;39021;16702;22319
Republic of Lithuania;2003;61;37918;16335;21583
Republic of Lithuania;2003;62;36300;15411;20889
Republic of Lithuania;2003;63;35996;15103;20893
Republic of Lithuania;2003;64;36352;15023;21329
Republic of Lithuania;2003;65;35484;14259;21225
Republic of Lithuania;2003;66;35860;14528;21332
Republic of Lithuania;2003;67;33921;13541;20380
Republic of Lithuania;2003;68;31317;12135;19182
Republic of Lithuania;2003;69;32342;12503;19839
Republic of Lithuania;2003;70;32281;12070;20211
Republic of Lithuania;2003;71;30140;11183;18957
Republic of Lithuania;2003;72;30112;11198;18914
Republic of Lithuania;2003;73;27625;9965;17660
Republic of Lithuania;2003;74;28128;9772;18356
Republic of Lithuania;2003;75;25467;8727;16740
Republic of Lithuania;2003;76;22569;6675;15894
Republic of Lithuania;2003;77;21286;6057;15229
Republic of Lithuania;2003;78;18918;5328;13590
Republic of Lithuania;2003;79;17732;5077;12655
Republic of Lithuania;2003;80;15449;4288;11161
Republic of Lithuania;2003;81;12968;3625;9343
Republic of Lithuania;2003;82;10707;2888;7819
Republic of Lithuania;2003;83;8215;2201;6014
Republic of Lithuania;2003;84;5860;1491;4369
Republic of Lithuania;2003;85;35812;9338;26474
Republic of Lithuania;2004;-1;3398929;1584018;1814911
Republic of Lithuania;2004;0;29650;15320;14330
Republic of Lithuania;2004;1;29138;15007;14131
Republic of Lithuania;2004;2;30598;15593;15005
Republic of Lithuania;2004;3;32934;17026;15908
Republic of Lithuania;2004;4;35287;18129;17158
Republic of Lithuania;2004;5;35724;18560;17164
Republic of Lithuania;2004;6;36533;18763;17770
Republic of Lithuania;2004;7;37840;19272;18568
Republic of Lithuania;2004;8;39490;20243;19247
Republic of Lithuania;2004;9;40709;20861;19848
Republic of Lithuania;2004;10;45677;23414;22263
Republic of Lithuania;2004;11;51496;26225;25271
Republic of Lithuania;2004;12;51566;26432;25134
Republic of Lithuania;2004;13;51913;26475;25438
Republic of Lithuania;2004;14;50373;25748;24625
Republic of Lithuania;2004;15;51120;26023;25097
Republic of Lithuania;2004;16;53831;27371;26460
Republic of Lithuania;2004;17;55146;28349;26797
Republic of Lithuania;2004;18;53257;26909;26348
Republic of Lithuania;2004;19;52561;26671;25890
Republic of Lithuania;2004;20;51617;26314;25303
Republic of Lithuania;2004;21;47218;23959;23259
Republic of Lithuania;2004;22;46871;23954;22917
Republic of Lithuania;2004;23;45595;23205;22390
Republic of Lithuania;2004;24;45102;22634;22468
Republic of Lithuania;2004;25;44292;22269;22023
Republic of Lithuania;2004;26;44259;22177;22082
Republic of Lithuania;2004;27;44725;22297;22428
Republic of Lithuania;2004;28;44241;21799;22442
Republic of Lithuania;2004;29;45047;22048;22999
Republic of Lithuania;2004;30;45894;22736;23158
Republic of Lithuania;2004;31;48286;24001;24285
Republic of Lithuania;2004;32;49888;24708;25180
Republic of Lithuania;2004;33;49536;24529;25007
Republic of Lithuania;2004;34;48819;24164;24655
Republic of Lithuania;2004;35;49337;24254;25083
Republic of Lithuania;2004;36;49011;23932;25079
Republic of Lithuania;2004;37;49315;24197;25118
Republic of Lithuania;2004;38;49416;24484;24932
Republic of Lithuania;2004;39;51103;25124;25979
Republic of Lithuania;2004;40;52090;25662;26428
Republic of Lithuania;2004;41;54079;26432;27647
Republic of Lithuania;2004;42;55818;26926;28892
Republic of Lithuania;2004;43;54826;26316;28510
Republic of Lithuania;2004;44;54566;26082;28484
Republic of Lithuania;2004;45;52390;25230;27160
Republic of Lithuania;2004;46;48614;23258;25356
Republic of Lithuania;2004;47;45675;21628;24047
Republic of Lithuania;2004;48;44715;21162;23553
Republic of Lithuania;2004;49;42242;19911;22331
Republic of Lithuania;2004;50;39817;18732;21085
Republic of Lithuania;2004;51;41381;19286;22095
Republic of Lithuania;2004;52;41128;18993;22135
Republic of Lithuania;2004;53;40754;18665;22089
Republic of Lithuania;2004;54;41386;18866;22520
Republic of Lithuania;2004;55;37104;16642;20462
Republic of Lithuania;2004;56;33950;15229;18721
Republic of Lithuania;2004;57;32238;14295;17943
Republic of Lithuania;2004;58;35279;15433;19846
Republic of Lithuania;2004;59;30505;13385;17120
Republic of Lithuania;2004;60;35217;15100;20117
Republic of Lithuania;2004;61;38237;16227;22010
Republic of Lithuania;2004;62;37237;15909;21328
Republic of Lithuania;2004;63;35753;15038;20715
Republic of Lithuania;2004;64;35371;14632;20739
Republic of Lithuania;2004;65;35933;14653;21280
Republic of Lithuania;2004;66;34857;13741;21116
Republic of Lithuania;2004;67;35178;13940;21238
Republic of Lithuania;2004;68;33244;12985;20259
Republic of Lithuania;2004;69;30680;11654;19026
Republic of Lithuania;2004;70;31468;11949;19519
Republic of Lithuania;2004;71;31521;11561;19960
Republic of Lithuania;2004;72;29225;10631;18594
Republic of Lithuania;2004;73;29267;10678;18589
Republic of Lithuania;2004;74;26648;9366;17282
Republic of Lithuania;2004;75;27060;9137;17923
Republic of Lithuania;2004;76;24361;8158;16203
Republic of Lithuania;2004;77;21526;6180;15346
Republic of Lithuania;2004;78;20281;5565;14716
Republic of Lithuania;2004;79;17837;4848;12989
Republic of Lithuania;2004;80;16541;4551;11990
Republic of Lithuania;2004;81;14382;3853;10529
Republic of Lithuania;2004;82;12016;3237;8779
Republic of Lithuania;2004;83;9803;2545;7258
Republic of Lithuania;2004;84;7413;1908;5505
Republic of Lithuania;2004;85;34901;8663;26238
Republic of Lithuania;2005;-1;3355220;1562264;1792956
Republic of Lithuania;2005;0;29338;14915;14423
Republic of Lithuania;2005;1;29381;15180;14201
Republic of Lithuania;2005;2;28933;14911;14022
Republic of Lithuania;2005;3;30335;15488;14847
Republic of Lithuania;2005;4;32617;16869;15748
Republic of Lithuania;2005;5;34963;17991;16972
Republic of Lithuania;2005;6;35454;18437;17017
Republic of Lithuania;2005;7;36286;18648;17638
Republic of Lithuania;2005;8;37657;19182;18475
Republic of Lithuania;2005;9;39271;20135;19136
Republic of Lithuania;2005;10;40518;20757;19761
Republic of Lithuania;2005;11;45412;23276;22136
Republic of Lithuania;2005;12;51055;25988;25067
Republic of Lithuania;2005;13;51156;26223;24933
Republic of Lithuania;2005;14;51245;26131;25114
Republic of Lithuania;2005;15;49695;25397;24298
Republic of Lithuania;2005;16;50185;25520;24665
Republic of Lithuania;2005;17;52832;26816;26016
Republic of Lithuania;2005;18;53891;27645;26246
Republic of Lithuania;2005;19;51917;26240;25677
Republic of Lithuania;2005;20;51269;26030;25239
Republic of Lithuania;2005;21;50316;25612;24704
Republic of Lithuania;2005;22;45949;23341;22608
Republic of Lithuania;2005;23;45633;23403;22230
Republic of Lithuania;2005;24;44489;22649;21840
Republic of Lithuania;2005;25;43572;22021;21551
Republic of Lithuania;2005;26;43410;21785;21625
Republic of Lithuania;2005;27;43511;21720;21791
Republic of Lithuania;2005;28;44105;22000;22105
Republic of Lithuania;2005;29;43729;21553;22176
Republic of Lithuania;2005;30;44392;21743;22649
Republic of Lithuania;2005;31;45134;22300;22834
Republic of Lithuania;2005;32;47425;23459;23966
Republic of Lithuania;2005;33;49205;24361;24844
Republic of Lithuania;2005;34;48807;24126;24681
Republic of Lithuania;2005;35;48043;23739;24304
Republic of Lithuania;2005;36;48508;23838;24670
Republic of Lithuania;2005;37;48210;23490;24720
Republic of Lithuania;2005;38;48599;23784;24815
Republic of Lithuania;2005;39;48652;24113;24539
Republic of Lithuania;2005;40;50273;24655;25618
Republic of Lithuania;2005;41;51250;25162;26088
Republic of Lithuania;2005;42;53211;25922;27289
Republic of Lithuania;2005;43;55103;26510;28593
Republic of Lithuania;2005;44;54249;26011;28238
Republic of Lithuania;2005;45;53745;25680;28065
Republic of Lithuania;2005;46;51827;24894;26933
Republic of Lithuania;2005;47;48021;22895;25126
Republic of Lithuania;2005;48;44870;21165;23705
Republic of Lithuania;2005;49;44114;20801;23313
Republic of Lithuania;2005;50;41709;19597;22112
Republic of Lithuania;2005;51;39154;18336;20818
Republic of Lithuania;2005;52;40690;18880;21810
Republic of Lithuania;2005;53;40404;18552;21852
Republic of Lithuania;2005;54;40097;18306;21791
Republic of Lithuania;2005;55;40759;18429;22330
Republic of Lithuania;2005;56;36553;16258;20295
Republic of Lithuania;2005;57;33418;14876;18542
Republic of Lithuania;2005;58;31656;13946;17710
Republic of Lithuania;2005;59;34680;15078;19602
Republic of Lithuania;2005;60;29960;13027;16933
Republic of Lithuania;2005;61;34460;14642;19818
Republic of Lithuania;2005;62;37440;15731;21709
Republic of Lithuania;2005;63;36428;15365;21063
Republic of Lithuania;2005;64;34928;14532;20396
Republic of Lithuania;2005;65;34589;14138;20451
Republic of Lithuania;2005;66;35103;14127;20976
Republic of Lithuania;2005;67;34040;13246;20794
Republic of Lithuania;2005;68;34273;13373;20900
Republic of Lithuania;2005;69;32294;12397;19897
Republic of Lithuania;2005;70;29811;11151;18660
Republic of Lithuania;2005;71;30439;11363;19076
Republic of Lithuania;2005;72;30406;10929;19477
Republic of Lithuania;2005;73;28169;10043;18126
Republic of Lithuania;2005;74;28087;10044;18043
Republic of Lithuania;2005;75;25466;8757;16709
Republic of Lithuania;2005;76;25794;8541;17253
Republic of Lithuania;2005;77;23150;7556;15594
Republic of Lithuania;2005;78;20354;5728;14626
Republic of Lithuania;2005;79;19052;5107;13945
Republic of Lithuania;2005;80;16669;4442;12227
Republic of Lithuania;2005;81;15304;4097;11207
Republic of Lithuania;2005;82;13161;3419;9742
Republic of Lithuania;2005;83;10935;2868;8067
Republic of Lithuania;2005;84;8814;2244;6570
Republic of Lithuania;2005;85;35212;8628;26584
Republic of Lithuania;2006;-1;3289835;1528463;1761372
Republic of Lithuania;2006;0;28900;14769;14131
Republic of Lithuania;2006;1;28942;14696;14246
Republic of Lithuania;2006;2;28893;14915;13978
Republic of Lithuania;2006;3;28456;14695;13761
Republic of Lithuania;2006;4;29805;15221;14584
Republic of Lithuania;2006;5;32252;16643;15609
Republic of Lithuania;2006;6;34537;17817;16720
Republic of Lithuania;2006;7;35129;18242;16887
Republic of Lithuania;2006;8;35951;18487;17464
Republic of Lithuania;2006;9;37350;19080;18270
Republic of Lithuania;2006;10;39001;20014;18987
Republic of Lithuania;2006;11;40236;20610;19626
Republic of Lithuania;2006;12;45081;23124;21957
Republic of Lithuania;2006;13;50021;25427;24594
Republic of Lithuania;2006;14;50403;25832;24571
Republic of Lithuania;2006;15;49873;25438;24435
Republic of Lithuania;2006;16;48158;24517;23641
Republic of Lithuania;2006;17;48805;24700;24105
Republic of Lithuania;2006;18;51057;25865;25192
Republic of Lithuania;2006;19;51331;26227;25104
Republic of Lithuania;2006;20;49425;24890;24535
Republic of Lithuania;2006;21;48463;24586;23877
Republic of Lithuania;2006;22;47883;24516;23367
Republic of Lithuania;2006;23;44087;22349;21738
Republic of Lithuania;2006;24;43620;22365;21255
Republic of Lithuania;2006;25;42191;21480;20711
Republic of Lithuania;2006;26;41996;21193;20803
Republic of Lithuania;2006;27;42128;21116;21012
Republic of Lithuania;2006;28;42440;21147;21293
Republic of Lithuania;2006;29;43309;21602;21707
Republic of Lithuania;2006;30;43036;21183;21853
Republic of Lithuania;2006;31;43556;21310;22246
Republic of Lithuania;2006;32;44120;21752;22368
Republic of Lithuania;2006;33;46257;22808;23449
Republic of Lithuania;2006;34;47980;23680;24300
Republic of Lithuania;2006;35;47643;23441;24202
Republic of Lithuania;2006;36;46994;23119;23875
Republic of Lithuania;2006;37;47358;23140;24218
Republic of Lithuania;2006;38;47104;22843;24261
Republic of Lithuania;2006;39;47571;23166;24405
Republic of Lithuania;2006;40;47596;23438;24158
Republic of Lithuania;2006;41;49216;24017;25199
Republic of Lithuania;2006;42;50178;24523;25655
Republic of Lithuania;2006;43;52113;25291;26822
Republic of Lithuania;2006;44;54181;25980;28201
Republic of Lithuania;2006;45;53542;25641;27901
Republic of Lithuania;2006;46;52792;25158;27634
Republic of Lithuania;2006;47;51216;24485;26731
Republic of Lithuania;2006;48;47378;22541;24837
Republic of Lithuania;2006;49;44001;20645;23356
Republic of Lithuania;2006;50;43333;20366;22967
Republic of Lithuania;2006;51;41034;19194;21840
Republic of Lithuania;2006;52;38393;17871;20522
Republic of Lithuania;2006;53;39828;18361;21467
Republic of Lithuania;2006;54;39564;18050;21514
Republic of Lithuania;2006;55;39356;17889;21467
Republic of Lithuania;2006;56;40049;17945;22104
Republic of Lithuania;2006;57;35951;15849;20102
Republic of Lithuania;2006;58;32853;14506;18347
Republic of Lithuania;2006;59;31040;13580;17460
Republic of Lithuania;2006;60;33884;14619;19265
Republic of Lithuania;2006;61;29267;12565;16702
Republic of Lithuania;2006;62;33647;14113;19534
Republic of Lithuania;2006;63;36568;15177;21391
Republic of Lithuania;2006;64;35574;14829;20745
Republic of Lithuania;2006;65;34051;13951;20100
Republic of Lithuania;2006;66;33708;13591;20117
Republic of Lithuania;2006;67;34179;13535;20644
Republic of Lithuania;2006;68;33107;12700;20407
Republic of Lithuania;2006;69;33318;12798;20520
Republic of Lithuania;2006;70;31321;11785;19536
Republic of Lithuania;2006;71;28838;10611;18227
Republic of Lithuania;2006;72;29298;10735;18563
Republic of Lithuania;2006;73;29298;10349;18949
Republic of Lithuania;2006;74;27046;9459;17587
Republic of Lithuania;2006;75;26869;9430;17439
Republic of Lithuania;2006;76;24308;8162;16146
Republic of Lithuania;2006;77;24412;7910;16502
Republic of Lithuania;2006;78;21831;6968;14863
Republic of Lithuania;2006;79;19118;5264;13854
Republic of Lithuania;2006;80;17770;4634;13136
Republic of Lithuania;2006;81;15380;3980;11400
Republic of Lithuania;2006;82;14003;3656;10347
Republic of Lithuania;2006;83;11861;2996;8865
Republic of Lithuania;2006;84;9842;2503;7339
Republic of Lithuania;2006;85;36381;8808;27573
Republic of Lithuania;2007;-1;3249983;1506794;1743189
Republic of Lithuania;2007;0;29093;14747;14346
Republic of Lithuania;2007;1;28645;14640;14005
Republic of Lithuania;2007;2;28605;14542;14063
Republic of Lithuania;2007;3;28692;14794;13898
Republic of Lithuania;2007;4;28252;14579;13673
Republic of Lithuania;2007;5;29606;15099;14507
Republic of Lithuania;2007;6;32075;16547;15528
Republic of Lithuania;2007;7;34325;17691;16634
Republic of Lithuania;2007;8;34942;18138;16804
Republic of Lithuania;2007;9;35773;18387;17386
Republic of Lithuania;2007;10;37203;18979;18224
Republic of Lithuania;2007;11;38860;19949;18911
Republic of Lithuania;2007;12;40061;20505;19556
Republic of Lithuania;2007;13;44877;23014;21863
Republic of Lithuania;2007;14;49707;25293;24414
Republic of Lithuania;2007;15;50063;25683;24380
Republic of Lithuania;2007;16;49282;25155;24127
Republic of Lithuania;2007;17;47518;24192;23326
Republic of Lithuania;2007;18;47996;24283;23713
Republic of Lithuania;2007;19;50063;25340;24723
Republic of Lithuania;2007;20;50116;25567;24549
Republic of Lithuania;2007;21;48153;24159;23994
Republic of Lithuania;2007;22;47204;23822;23382
Republic of Lithuania;2007;23;46666;23748;22918
Republic of Lithuania;2007;24;43064;21654;21410
Republic of Lithuania;2007;25;42429;21703;20726
Republic of Lithuania;2007;26;41286;20937;20349
Republic of Lithuania;2007;27;41381;20762;20619
Republic of Lithuania;2007;28;41645;20804;20841
Republic of Lithuania;2007;29;41837;20777;21060
Republic of Lithuania;2007;30;42788;21287;21501
Republic of Lithuania;2007;31;42686;20963;21723
Republic of Lithuania;2007;32;43090;21031;22059
Republic of Lithuania;2007;33;43673;21465;22208
Republic of Lithuania;2007;34;45762;22451;23311
Republic of Lithuania;2007;35;47420;23338;24082
Republic of Lithuania;2007;36;47054;23114;23940
Republic of Lithuania;2007;37;46410;22813;23597
Republic of Lithuania;2007;38;46783;22802;23981
Republic of Lithuania;2007;39;46503;22511;23992
Republic of Lithuania;2007;40;46856;22754;24102
Republic of Lithuania;2007;41;46928;23059;23869
Republic of Lithuania;2007;42;48548;23615;24933
Republic of Lithuania;2007;43;49441;24082;25359
Republic of Lithuania;2007;44;51252;24767;26485
Republic of Lithuania;2007;45;53370;25547;27823
Republic of Lithuania;2007;46;53010;25302;27708
Republic of Lithuania;2007;47;52043;24729;27314
Republic of Lithuania;2007;48;50683;24115;26568
Republic of Lithuania;2007;49;46889;22221;24668
Republic of Lithuania;2007;50;43249;20170;23079
Republic of Lithuania;2007;51;42591;19881;22710
Republic of Lithuania;2007;52;40469;18843;21626
Republic of Lithuania;2007;53;37741;17438;20303
Republic of Lithuania;2007;54;39181;17892;21289
Republic of Lithuania;2007;55;38836;17592;21244
Republic of Lithuania;2007;56;38677;17428;21249
Republic of Lithuania;2007;57;39383;17477;21906
Republic of Lithuania;2007;58;35356;15463;19893
Republic of Lithuania;2007;59;32220;14067;18153
Republic of Lithuania;2007;60;30347;13110;17237
Republic of Lithuania;2007;61;33171;14168;19003
Republic of Lithuania;2007;62;28625;12143;16482
Republic of Lithuania;2007;63;32816;13541;19275
Republic of Lithuania;2007;64;35638;14575;21063
Republic of Lithuania;2007;65;34658;14242;20416
Republic of Lithuania;2007;66;33177;13379;19798
Republic of Lithuania;2007;67;32792;13019;19773
Republic of Lithuania;2007;68;33269;12966;20303
Republic of Lithuania;2007;69;32201;12154;20047
Republic of Lithuania;2007;70;32367;12236;20131
Republic of Lithuania;2007;71;30295;11182;19113
Republic of Lithuania;2007;72;27878;10045;17833
Republic of Lithuania;2007;73;28187;10101;18086
Republic of Lithuania;2007;74;28090;9681;18409
Republic of Lithuania;2007;75;25861;8854;17007
Republic of Lithuania;2007;76;25626;8825;16801
Republic of Lithuania;2007;77;23061;7573;15488
Republic of Lithuania;2007;78;23008;7291;15717
Republic of Lithuania;2007;79;20408;6361;14047
Republic of Lithuania;2007;80;17833;4779;13054
Republic of Lithuania;2007;81;16394;4170;12224
Republic of Lithuania;2007;82;14093;3550;10543
Republic of Lithuania;2007;83;12693;3239;9454
Republic of Lithuania;2007;84;10609;2612;7997
Republic of Lithuania;2007;85;38575;9291;29284
Republic of Lithuania;2008;-1;3212605;1487419;1725186
Republic of Lithuania;2008;0;29482;15114;14368
Republic of Lithuania;2008;1;28818;14596;14222
Republic of Lithuania;2008;2;28415;14527;13888
Republic of Lithuania;2008;3;28370;14437;13933
Republic of Lithuania;2008;4;28482;14684;13798
Republic of Lithuania;2008;5;28026;14459;13567
Republic of Lithuania;2008;6;29331;14963;14368
Republic of Lithuania;2008;7;31865;16432;15433
Republic of Lithuania;2008;8;34147;17607;16540
Republic of Lithuania;2008;9;34793;18062;16731
Republic of Lithuania;2008;10;35597;18300;17297
Republic of Lithuania;2008;11;37017;18884;18133
Republic of Lithuania;2008;12;38684;19859;18825
Republic of Lithuania;2008;13;39894;20398;19496
Republic of Lithuania;2008;14;44650;22902;21748
Republic of Lithuania;2008;15;49381;25113;24268
Republic of Lithuania;2008;16;49729;25501;24228
Republic of Lithuania;2008;17;48771;24945;23826
Republic of Lithuania;2008;18;46871;23878;22993
Republic of Lithuania;2008;19;47216;23889;23327
Republic of Lithuania;2008;20;49181;24964;24217
Republic of Lithuania;2008;21;49069;25072;23997
Republic of Lithuania;2008;22;47063;23609;23454
Republic of Lithuania;2008;23;46280;23371;22909
Republic of Lithuania;2008;24;45845;23234;22611
Republic of Lithuania;2008;25;42196;21142;21054
Republic of Lithuania;2008;26;41653;21213;20440
Republic of Lithuania;2008;27;40583;20545;20038
Republic of Lithuania;2008;28;40746;20421;20325
Republic of Lithuania;2008;29;41043;20523;20520
Republic of Lithuania;2008;30;41398;20548;20850
Republic of Lithuania;2008;31;42244;20955;21289
Republic of Lithuania;2008;32;42304;20778;21526
Republic of Lithuania;2008;33;42681;20808;21873
Republic of Lithuania;2008;34;43210;21215;21995
Republic of Lithuania;2008;35;45266;22128;23138
Republic of Lithuania;2008;36;46869;23047;23822
Republic of Lithuania;2008;37;46512;22808;23704
Republic of Lithuania;2008;38;45862;22522;23340
Republic of Lithuania;2008;39;46198;22484;23714
Republic of Lithuania;2008;40;45920;22183;23737
Republic of Lithuania;2008;41;46272;22424;23848
Republic of Lithuania;2008;42;46313;22722;23591
Republic of Lithuania;2008;43;47823;23219;24604
Republic of Lithuania;2008;44;48653;23602;25051
Republic of Lithuania;2008;45;50428;24289;26139
Republic of Lithuania;2008;46;52608;25122;27486
Republic of Lithuania;2008;47;52332;24868;27464
Republic of Lithuania;2008;48;51376;24272;27104
Republic of Lithuania;2008;49;50073;23681;26392
Republic of Lithuania;2008;50;46264;21813;24451
Republic of Lithuania;2008;51;42613;19737;22876
Republic of Lithuania;2008;52;41969;19497;22472
Republic of Lithuania;2008;53;39852;18410;21442
Republic of Lithuania;2008;54;37071;16987;20084
Republic of Lithuania;2008;55;38491;17437;21054
Republic of Lithuania;2008;56;38075;17121;20954
Republic of Lithuania;2008;57;37919;16959;20960
Republic of Lithuania;2008;58;38625;16932;21693
Republic of Lithuania;2008;59;34688;15016;19672
Republic of Lithuania;2008;60;31473;13565;17908
Republic of Lithuania;2008;61;29675;12654;17021
Republic of Lithuania;2008;62;32458;13689;18769
Republic of Lithuania;2008;63;27943;11676;16267
Republic of Lithuania;2008;64;32012;13028;18984
Republic of Lithuania;2008;65;34751;14002;20749
Republic of Lithuania;2008;66;33776;13641;20135
Republic of Lithuania;2008;67;32263;12790;19473
Republic of Lithuania;2008;68;31910;12465;19445
Republic of Lithuania;2008;69;32337;12398;19939
Republic of Lithuania;2008;70;31185;11536;19649
Republic of Lithuania;2008;71;31328;11636;19692
Republic of Lithuania;2008;72;29243;10579;18664
Republic of Lithuania;2008;73;26883;9495;17388
Republic of Lithuania;2008;74;27016;9477;17539
Republic of Lithuania;2008;75;26916;9078;17838
Republic of Lithuania;2008;76;24648;8238;16410
Republic of Lithuania;2008;77;24314;8176;16138
Republic of Lithuania;2008;78;21743;6955;14788
Republic of Lithuania;2008;79;21617;6669;14948
Republic of Lithuania;2008;80;18994;5766;13228
Republic of Lithuania;2008;81;16598;4305;12293
Republic of Lithuania;2008;82;15020;3703;11317
Republic of Lithuania;2008;83;12781;3141;9640
Republic of Lithuania;2008;84;11350;2806;8544
Republic of Lithuania;2008;85;41264;9723;31541
Republic of Lithuania;2009;-1;3183856;1473352;1710504
Republic of Lithuania;2009;0;31203;16059;15144
Republic of Lithuania;2009;1;29215;14953;14262
Republic of Lithuania;2009;2;28586;14511;14075
Republic of Lithuania;2009;3;28184;14426;13758
Republic of Lithuania;2009;4;28194;14370;13824
Republic of Lithuania;2009;5;28307;14590;13717
Republic of Lithuania;2009;6;27852;14379;13473
Republic of Lithuania;2009;7;29178;14889;14289
Republic of Lithuania;2009;8;31723;16350;15373
Republic of Lithuania;2009;9;34018;17541;16477
Republic of Lithuania;2009;10;34642;17962;16680
Republic of Lithuania;2009;11;35453;18228;17225
Republic of Lithuania;2009;12;36858;18800;18058
Republic of Lithuania;2009;13;38518;19768;18750
Republic of Lithuania;2009;14;39745;20317;19428
Republic of Lithuania;2009;15;44465;22807;21658
Republic of Lithuania;2009;16;49160;24992;24168
Republic of Lithuania;2009;17;49486;25361;24125
Republic of Lithuania;2009;18;48439;24763;23676
Republic of Lithuania;2009;19;46465;23633;22832
Republic of Lithuania;2009;20;46626;23570;23056
Republic of Lithuania;2009;21;48371;24520;23851
Republic of Lithuania;2009;22;48306;24685;23621
Republic of Lithuania;2009;23;46354;23268;23086
Republic of Lithuania;2009;24;45529;23036;22493
Republic of Lithuania;2009;25;45180;22924;22256
Republic of Lithuania;2009;26;41310;20733;20577
Republic of Lithuania;2009;27;40907;20865;20042
Republic of Lithuania;2009;28;39988;20224;19764
Republic of Lithuania;2009;29;40215;20149;20066
Republic of Lithuania;2009;30;40619;20301;20318
Republic of Lithuania;2009;31;40951;20331;20620
Republic of Lithuania;2009;32;41770;20737;21033
Republic of Lithuania;2009;33;41850;20543;21307
Republic of Lithuania;2009;34;42297;20606;21691
Republic of Lithuania;2009;35;42607;20905;21702
Republic of Lithuania;2009;36;44762;21884;22878
Republic of Lithuania;2009;37;46478;22819;23659
Republic of Lithuania;2009;38;46100;22556;23544
Republic of Lithuania;2009;39;45482;22311;23171
Republic of Lithuania;2009;40;45813;22261;23552
Republic of Lithuania;2009;41;45527;21944;23583
Republic of Lithuania;2009;42;45834;22164;23670
Republic of Lithuania;2009;43;45857;22429;23428
Republic of Lithuania;2009;44;47345;22939;24406
Republic of Lithuania;2009;45;48054;23260;24794
Republic of Lithuania;2009;46;49911;23964;25947
Republic of Lithuania;2009;47;52080;24782;27298
Republic of Lithuania;2009;48;51761;24513;27248
Republic of Lithuania;2009;49;50851;23946;26905
Republic of Lithuania;2009;50;49487;23281;26206
Republic of Lithuania;2009;51;45707;21431;24276
Republic of Lithuania;2009;52;42048;19351;22697
Republic of Lithuania;2009;53;41358;19102;22256
Republic of Lithuania;2009;54;39230;18002;21228
Republic of Lithuania;2009;55;36412;16547;19865
Republic of Lithuania;2009;56;37845;17010;20835
Republic of Lithuania;2009;57;37442;16701;20741
Republic of Lithuania;2009;58;37249;16495;20754
Republic of Lithuania;2009;59;37885;16431;21454
Republic of Lithuania;2009;60;34021;14558;19463
Republic of Lithuania;2009;61;30875;13156;17719
Republic of Lithuania;2009;62;29080;12281;16799
Republic of Lithuania;2009;63;31731;13212;18519
Republic of Lithuania;2009;64;27311;11250;16061
Republic of Lithuania;2009;65;31255;12521;18734
Republic of Lithuania;2009;66;33893;13452;20441
Republic of Lithuania;2009;67;32919;13093;19826
Republic of Lithuania;2009;68;31466;12305;19161
Republic of Lithuania;2009;69;31027;11933;19094
Republic of Lithuania;2009;70;31425;11868;19557
Republic of Lithuania;2009;71;30238;10988;19250
Republic of Lithuania;2009;72;30341;11051;19290
Republic of Lithuania;2009;73;28205;10018;18187
Republic of Lithuania;2009;74;25834;8940;16894
Republic of Lithuania;2009;75;25917;8908;17009
Republic of Lithuania;2009;76;25722;8478;17244
Republic of Lithuania;2009;77;23449;7676;15773
Republic of Lithuania;2009;78;23002;7595;15407
Republic of Lithuania;2009;79;20482;6412;14070
Republic of Lithuania;2009;80;20183;6070;14113
Republic of Lithuania;2009;81;17580;5209;12371
Republic of Lithuania;2009;82;15267;3879;11388
Republic of Lithuania;2009;83;13679;3284;10395
Republic of Lithuania;2009;84;11579;2738;8841
Republic of Lithuania;2009;85;44286;10258;34028
Republic of Lithuania;2010;-1;3141976;1450199;1691777
Republic of Lithuania;2010;0;31850;16336;15514
Republic of Lithuania;2010;1;30754;15789;14965
Republic of Lithuania;2010;2;28771;14696;14075
Republic of Lithuania;2010;3;28211;14342;13869
Republic of Lithuania;2010;4;27870;14252;13618
Republic of Lithuania;2010;5;27843;14170;13673
Republic of Lithuania;2010;6;28062;14475;13587
Republic of Lithuania;2010;7;27637;14241;13396
Republic of Lithuania;2010;8;28997;14802;14195
Republic of Lithuania;2010;9;31506;16240;15266
Republic of Lithuania;2010;10;33804;17408;16396
Republic of Lithuania;2010;11;34442;17842;16600
Republic of Lithuania;2010;12;35285;18124;17161
Republic of Lithuania;2010;13;36657;18687;17970
Republic of Lithuania;2010;14;38348;19686;18662
Republic of Lithuania;2010;15;39564;20227;19337
Republic of Lithuania;2010;16;44134;22630;21504
Republic of Lithuania;2010;17;48883;24797;24086
Republic of Lithuania;2010;18;49051;25139;23912
Republic of Lithuania;2010;19;47774;24398;23376
Republic of Lithuania;2010;20;45581;23168;22413
Republic of Lithuania;2010;21;45525;23050;22475
Republic of Lithuania;2010;22;46975;23739;23236
Republic of Lithuania;2010;23;46751;23807;22944
Republic of Lithuania;2010;24;44918;22473;22445
Republic of Lithuania;2010;25;44215;22308;21907
Republic of Lithuania;2010;26;43531;22066;21465
Republic of Lithuania;2010;27;39921;19939;19982
Republic of Lithuania;2010;28;39663;20117;19546
Republic of Lithuania;2010;29;39086;19715;19371
Republic of Lithuania;2010;30;39465;19746;19719
Republic of Lithuania;2010;31;39765;19794;19971
Republic of Lithuania;2010;32;40245;19987;20258
Republic of Lithuania;2010;33;41039;20312;20727
Republic of Lithuania;2010;34;41043;20100;20943
Republic of Lithuania;2010;35;41378;20074;21304
Republic of Lithuania;2010;36;41768;20437;21331
Republic of Lithuania;2010;37;43903;21343;22560
Republic of Lithuania;2010;38;45736;22305;23431
Republic of Lithuania;2010;39;45388;22078;23310
Republic of Lithuania;2010;40;44800;21828;22972
Republic of Lithuania;2010;41;45092;21781;23311
Republic of Lithuania;2010;42;44872;21446;23426
Republic of Lithuania;2010;43;45146;21690;23456
Republic of Lithuania;2010;44;45143;21932;23211
Republic of Lithuania;2010;45;46457;22381;24076
Republic of Lithuania;2010;46;47294;22731;24563
Republic of Lithuania;2010;47;49186;23474;25712
Republic of Lithuania;2010;48;51382;24335;27047
Republic of Lithuania;2010;49;51021;24035;26986
Republic of Lithuania;2010;50;50133;23447;26686
Republic of Lithuania;2010;51;48814;22813;26001
Republic of Lithuania;2010;52;45096;20996;24100
Republic of Lithuania;2010;53;41414;18914;22500
Republic of Lithuania;2010;54;40743;18679;22064
Republic of Lithuania;2010;55;38546;17572;20974
Republic of Lithuania;2010;56;35770;16126;19644
Republic of Lithuania;2010;57;37220;16575;20645
Republic of Lithuania;2010;58;36807;16273;20534
Republic of Lithuania;2010;59;36572;16062;20510
Republic of Lithuania;2010;60;37227;15970;21257
Republic of Lithuania;2010;61;33338;14145;19193
Republic of Lithuania;2010;62;30222;12699;17523
Republic of Lithuania;2010;63;28478;11876;16602
Republic of Lithuania;2010;64;30968;12698;18270
Republic of Lithuania;2010;65;26650;10802;15848
Republic of Lithuania;2010;66;30545;12036;18509
Republic of Lithuania;2010;67;33074;12915;20159
Republic of Lithuania;2010;68;32013;12519;19494
Republic of Lithuania;2010;69;30603;11780;18823
Republic of Lithuania;2010;70;30113;11362;18751
Republic of Lithuania;2010;71;30545;11378;19167
Republic of Lithuania;2010;72;29266;10442;18824
Republic of Lithuania;2010;73;29368;10521;18847
Republic of Lithuania;2010;74;27131;9453;17678
Republic of Lithuania;2010;75;24830;8414;16416
Republic of Lithuania;2010;76;24788;8339;16449
Republic of Lithuania;2010;77;24465;7851;16614
Republic of Lithuania;2010;78;22223;7119;15104
Republic of Lithuania;2010;79;21583;6947;14636
Republic of Lithuania;2010;80;19201;5866;13335
Republic of Lithuania;2010;81;18778;5501;13277
Republic of Lithuania;2010;82;16181;4664;11517
Republic of Lithuania;2010;83;13897;3421;10476
Republic of Lithuania;2010;84;12353;2879;9474
Republic of Lithuania;2010;85;47289;10673;36616
Republic of Lithuania;2011;-1;3052588;1407223;1645365
Republic of Lithuania;2011;0;30580;15671;14909
Republic of Lithuania;2011;1;31538;16165;15373
Republic of Lithuania;2011;2;30019;15427;14592
Republic of Lithuania;2011;3;27976;14315;13661
Republic of Lithuania;2011;4;27522;13991;13531
Republic of Lithuania;2011;5;27266;13930;13336
Republic of Lithuania;2011;6;27264;13890;13374
Republic of Lithuania;2011;7;27494;14198;13296
Republic of Lithuania;2011;8;27135;13989;13146
Republic of Lithuania;2011;9;28527;14552;13975
Republic of Lithuania;2011;10;30996;15977;15019
Republic of Lithuania;2011;11;33265;17125;16140
Republic of Lithuania;2011;12;33917;17575;16342
Republic of Lithuania;2011;13;34779;17870;16909
Republic of Lithuania;2011;14;36140;18415;17725
Republic of Lithuania;2011;15;37787;19396;18391
Republic of Lithuania;2011;16;39070;19958;19112
Republic of Lithuania;2011;17;43668;22382;21286
Republic of Lithuania;2011;18;48157;24439;23718
Republic of Lithuania;2011;19;46940;24178;22762
Republic of Lithuania;2011;20;45811;23444;22367
Republic of Lithuania;2011;21;43333;22037;21296
Republic of Lithuania;2011;22;42923;21859;21064
Republic of Lithuania;2011;23;43604;22268;21336
Republic of Lithuania;2011;24;43093;22231;20862
Republic of Lithuania;2011;25;41165;20802;20363
Republic of Lithuania;2011;26;40008;20372;19636
Republic of Lithuania;2011;27;39675;20235;19440
Republic of Lithuania;2011;28;36741;18409;18332
Republic of Lithuania;2011;29;36601;18641;17960
Republic of Lithuania;2011;30;36401;18386;18015
Republic of Lithuania;2011;31;36905;18430;18475
Republic of Lithuania;2011;32;37392;18585;18807
Republic of Lithuania;2011;33;38113;18900;19213
Republic of Lithuania;2011;34;38893;19211;19682
Republic of Lithuania;2011;35;39010;19024;19986
Republic of Lithuania;2011;36;39656;19168;20488
Republic of Lithuania;2011;37;40245;19590;20655
Republic of Lithuania;2011;38;42396;20512;21884
Republic of Lithuania;2011;39;44272;21490;22782
Republic of Lithuania;2011;40;43998;21322;22676
Republic of Lithuania;2011;41;43504;21110;22394
Republic of Lithuania;2011;42;43844;21095;22749
Republic of Lithuania;2011;43;43696;20770;22926
Republic of Lithuania;2011;44;43905;21012;22893
Republic of Lithuania;2011;45;43800;21226;22574
Republic of Lithuania;2011;46;45316;21784;23532
Republic of Lithuania;2011;47;46084;22105;23979
Republic of Lithuania;2011;48;48020;22894;25126
Republic of Lithuania;2011;49;50121;23647;26474
Republic of Lithuania;2011;50;49857;23414;26443
Republic of Lithuania;2011;51;48947;22823;26124
Republic of Lithuania;2011;52;47717;22197;25520
Republic of Lithuania;2011;53;44110;20466;23644
Republic of Lithuania;2011;54;40510;18424;22086
Republic of Lithuania;2011;55;39778;18152;21626
Republic of Lithuania;2011;56;37642;17065;20577
Republic of Lithuania;2011;57;35004;15686;19318
Republic of Lithuania;2011;58;36454;16087;20367
Republic of Lithuania;2011;59;36080;15806;20274
Republic of Lithuania;2011;60;35885;15576;20309
Republic of Lithuania;2011;61;36534;15489;21045
Republic of Lithuania;2011;62;32748;13745;19003
Republic of Lithuania;2011;63;29608;12282;17326
Republic of Lithuania;2011;64;27842;11431;16411
Republic of Lithuania;2011;65;30258;12207;18051
Republic of Lithuania;2011;66;26054;10409;15645
Republic of Lithuania;2011;67;29781;11551;18230
Republic of Lithuania;2011;68;32230;12394;19836
Republic of Lithuania;2011;69;31176;11982;19194
Republic of Lithuania;2011;70;29775;11285;18490
Republic of Lithuania;2011;71;29202;10800;18402
Republic of Lithuania;2011;72;29578;10831;18747
Republic of Lithuania;2011;73;28322;9929;18393
Republic of Lithuania;2011;74;28338;9905;18433
Republic of Lithuania;2011;75;26033;8880;17153
Republic of Lithuania;2011;76;23676;7832;15844
Republic of Lithuania;2011;77;23629;7804;15825
Republic of Lithuania;2011;78;23234;7286;15948
Republic of Lithuania;2011;79;21019;6577;14442
Republic of Lithuania;2011;80;20196;6351;13845
Republic of Lithuania;2011;81;17835;5324;12511
Republic of Lithuania;2011;82;17277;4930;12347
Republic of Lithuania;2011;83;14798;4171;10627
Republic of Lithuania;2011;84;12568;2991;9577
Republic of Lithuania;2011;85;50328;11139;39189
Republic of Lithuania;2012;-1;3003641;1383511;1620130
Republic of Lithuania;2012;0;30194;15614;14580
Republic of Lithuania;2012;1;30534;15651;14883
Republic of Lithuania;2012;2;31190;15970;15220
Republic of Lithuania;2012;3;29502;15141;14361
Republic of Lithuania;2012;4;27564;14119;13445
Republic of Lithuania;2012;5;27133;13793;13340
Republic of Lithuania;2012;6;26924;13761;13163
Republic of Lithuania;2012;7;26954;13744;13210
Republic of Lithuania;2012;8;27249;14079;13170
Republic of Lithuania;2012;9;26884;13855;13029
Republic of Lithuania;2012;10;28274;14419;13855
Republic of Lithuania;2012;11;30679;15805;14874
Republic of Lithuania;2012;12;32886;16923;15963
Republic of Lithuania;2012;13;33604;17421;16183
Republic of Lithuania;2012;14;34490;17718;16772
Republic of Lithuania;2012;15;35838;18270;17568
Republic of Lithuania;2012;16;37551;19279;18272
Republic of Lithuania;2012;17;38813;19835;18978
Republic of Lithuania;2012;18;43172;22134;21038
Republic of Lithuania;2012;19;46508;23745;22763
Republic of Lithuania;2012;20;45899;23664;22235
Republic of Lithuania;2012;21;44563;22817;21746
Republic of Lithuania;2012;22;41774;21280;20494
Republic of Lithuania;2012;23;40770;20903;19867
Republic of Lithuania;2012;24;41715;21418;20297
Republic of Lithuania;2012;25;41139;21224;19915
Republic of Lithuania;2012;26;39076;19766;19310
Republic of Lithuania;2012;27;38309;19492;18817
Republic of Lithuania;2012;28;38267;19458;18809
Republic of Lithuania;2012;29;35556;17798;17758
Republic of Lithuania;2012;30;35454;18011;17443
Republic of Lithuania;2012;31;35329;17835;17494
Republic of Lithuania;2012;32;35888;17858;18030
Republic of Lithuania;2012;33;36389;18053;18336
Republic of Lithuania;2012;34;37198;18409;18789
Republic of Lithuania;2012;35;37899;18705;19194
Republic of Lithuania;2012;36;38151;18560;19591
Republic of Lithuania;2012;37;38908;18741;20167
Republic of Lithuania;2012;38;39502;19189;20313
Republic of Lithuania;2012;39;41631;20070;21561
Republic of Lithuania;2012;40;43546;21103;22443
Republic of Lithuania;2012;41;43318;20920;22398
Republic of Lithuania;2012;42;42798;20708;22090
Republic of Lithuania;2012;43;43200;20743;22457
Republic of Lithuania;2012;44;42979;20367;22612
Republic of Lithuania;2012;45;43086;20588;22498
Republic of Lithuania;2012;46;43179;20888;22291
Republic of Lithuania;2012;47;44652;21431;23221
Republic of Lithuania;2012;48;45465;21716;23749
Republic of Lithuania;2012;49;47318;22500;24818
Republic of Lithuania;2012;50;49371;23210;26161
Republic of Lithuania;2012;51;49143;22989;26154
Republic of Lithuania;2012;52;48266;22415;25851
Republic of Lithuania;2012;53;47076;21822;25254
Republic of Lithuania;2012;54;43419;20044;23375
Republic of Lithuania;2012;55;39822;18019;21803
Republic of Lithuania;2012;56;39189;17772;21417
Republic of Lithuania;2012;57;37055;16695;20360
Republic of Lithuania;2012;58;34438;15315;19123
Republic of Lithuania;2012;59;35889;15709;20180
Republic of Lithuania;2012;60;35491;15374;20117
Republic of Lithuania;2012;61;35262;15165;20097
Republic of Lithuania;2012;62;35877;15046;20831
Republic of Lithuania;2012;63;32122;13292;18830
Republic of Lithuania;2012;64;28987;11864;17123
Republic of Lithuania;2012;65;27255;11043;16212
Republic of Lithuania;2012;66;29553;11753;17800
Republic of Lithuania;2012;67;25429;9983;15446
Republic of Lithuania;2012;68;29067;11122;17945
Republic of Lithuania;2012;69;31377;11860;19517
Republic of Lithuania;2012;70;30309;11425;18884
Republic of Lithuania;2012;71;28926;10780;18146
Republic of Lithuania;2012;72;28356;10288;18068
Republic of Lithuania;2012;73;28599;10268;18331
Republic of Lithuania;2012;74;27347;9397;17950
Republic of Lithuania;2012;75;27247;9315;17932
Republic of Lithuania;2012;76;24987;8337;16650
Republic of Lithuania;2012;77;22611;7333;15278
Republic of Lithuania;2012;78;22425;7222;15203
Republic of Lithuania;2012;79;21975;6725;15250
Republic of Lithuania;2012;80;19728;6023;13705
Republic of Lithuania;2012;81;18751;5752;12999
Republic of Lithuania;2012;82;16520;4804;11716
Republic of Lithuania;2012;83;15882;4433;11449
Republic of Lithuania;2012;84;13334;3635;9699
Republic of Lithuania;2012;85;53655;11791;41864
Republic of Lithuania;2013;-1;2971905;1368891;1603014
Republic of Lithuania;2013;0;30461;15560;14901
Republic of Lithuania;2013;1;30241;15621;14620
Republic of Lithuania;2013;2;30330;15535;14795
Republic of Lithuania;2013;3;30816;15783;15033
Republic of Lithuania;2013;4;29173;14985;14188
Republic of Lithuania;2013;5;27229;13955;13274
Republic of Lithuania;2013;6;26815;13627;13188
Republic of Lithuania;2013;7;26678;13639;13039
Republic of Lithuania;2013;8;26755;13643;13112
Republic of Lithuania;2013;9;27058;13965;13093
Republic of Lithuania;2013;10;26657;13748;12909
Republic of Lithuania;2013;11;27970;14274;13696
Republic of Lithuania;2013;12;30394;15654;14740
Republic of Lithuania;2013;13;32638;16803;15835
Republic of Lithuania;2013;14;33361;17284;16077
Republic of Lithuania;2013;15;34237;17576;16661
Republic of Lithuania;2013;16;35615;18156;17459
Republic of Lithuania;2013;17;37328;19172;18156
Republic of Lithuania;2013;18;38447;19635;18812
Republic of Lithuania;2013;19;42078;21667;20411
Republic of Lithuania;2013;20;45710;23375;22335
Republic of Lithuania;2013;21;45185;23300;21885
Republic of Lithuania;2013;22;43574;22371;21203
Republic of Lithuania;2013;23;40627;20833;19794
Republic of Lithuania;2013;24;39782;20497;19285
Republic of Lithuania;2013;25;40959;21053;19906
Republic of Lithuania;2013;26;40100;20687;19413
Republic of Lithuania;2013;27;38100;19284;18816
Republic of Lithuania;2013;28;37777;19226;18551
Republic of Lithuania;2013;29;37723;19176;18547
Republic of Lithuania;2013;30;35007;17573;17434
Republic of Lithuania;2013;31;34962;17773;17189
Republic of Lithuania;2013;32;34824;17596;17228
Republic of Lithuania;2013;33;35297;17534;17763
Republic of Lithuania;2013;34;35866;17816;18050
Republic of Lithuania;2013;35;36599;18111;18488
Republic of Lithuania;2013;36;37372;18452;18920
Republic of Lithuania;2013;37;37648;18270;19378
Republic of Lithuania;2013;38;38472;18520;19952
Republic of Lithuania;2013;39;39134;19018;20116
Republic of Lithuania;2013;40;41188;19845;21343
Republic of Lithuania;2013;41;43088;20855;22233
Republic of Lithuania;2013;42;42841;20657;22184
Republic of Lithuania;2013;43;42404;20495;21909
Republic of Lithuania;2013;44;42743;20471;22272
Republic of Lithuania;2013;45;42381;20076;22305
Republic of Lithuania;2013;46;42656;20348;22308
Republic of Lithuania;2013;47;42773;20632;22141
Republic of Lithuania;2013;48;44182;21137;23045
Republic of Lithuania;2013;49;44942;21390;23552
Republic of Lithuania;2013;50;46864;22221;24643
Republic of Lithuania;2013;51;48843;22866;25977
Republic of Lithuania;2013;52;48614;22639;25975
Republic of Lithuania;2013;53;47733;22082;25651
Republic of Lithuania;2013;54;46468;21419;25049
Republic of Lithuania;2013;55;42884;19694;23190
Republic of Lithuania;2013;56;39302;17670;21632
Republic of Lithuania;2013;57;38683;17428;21255
Republic of Lithuania;2013;58;36522;16315;20207
Republic of Lithuania;2013;59;33949;14982;18967
Republic of Lithuania;2013;60;35368;15300;20068
Republic of Lithuania;2013;61;34881;14934;19947
Republic of Lithuania;2013;62;34667;14732;19935
Republic of Lithuania;2013;63;35237;14620;20617
Republic of Lithuania;2013;64;31495;12866;18629
Republic of Lithuania;2013;65;28346;11427;16919
Republic of Lithuania;2013;66;26672;10654;16018
Republic of Lithuania;2013;67;28827;11272;17555
Republic of Lithuania;2013;68;24812;9601;15211
Republic of Lithuania;2013;69;28325;10666;17659
Republic of Lithuania;2013;70;30544;11344;19200
Republic of Lithuania;2013;71;29404;10874;18530
Republic of Lithuania;2013;72;28115;10323;17792
Republic of Lithuania;2013;73;27481;9792;17689
Republic of Lithuania;2013;74;27607;9726;17881
Republic of Lithuania;2013;75;26363;8872;17491
Republic of Lithuania;2013;76;26132;8762;17370
Republic of Lithuania;2013;77;23886;7778;16108
Republic of Lithuania;2013;78;21499;6805;14694
Republic of Lithuania;2013;79;21139;6597;14542
Republic of Lithuania;2013;80;20666;6171;14495
Republic of Lithuania;2013;81;18435;5468;12967
Republic of Lithuania;2013;82;17358;5206;12152
Republic of Lithuania;2013;83;15129;4314;10815
Republic of Lithuania;2013;84;14441;3923;10518
Republic of Lithuania;2013;85;57017;12895;44122
Republic of Lithuania;2014;-1;2943472;1355995;1587477
Republic of Lithuania;2014;0;29863;15195;14668
Republic of Lithuania;2014;1;30586;15630;14956
Republic of Lithuania;2014;2;30105;15551;14554
Republic of Lithuania;2014;3;30027;15368;14659
Republic of Lithuania;2014;4;30521;15672;14849
Republic of Lithuania;2014;5;28857;14816;14041
Republic of Lithuania;2014;6;26920;13780;13140
Republic of Lithuania;2014;7;26584;13491;13093
Republic of Lithuania;2014;8;26484;13537;12947
Republic of Lithuania;2014;9;26576;13555;13021
Republic of Lithuania;2014;10;26794;13824;12970
Republic of Lithuania;2014;11;26377;13600;12777
Republic of Lithuania;2014;12;27743;14159;13584
Republic of Lithuania;2014;13;30200;15550;14650
Republic of Lithuania;2014;14;32451;16695;15756
Republic of Lithuania;2014;15;33163;17203;15960
Republic of Lithuania;2014;16;33996;17443;16553
Republic of Lithuania;2014;17;35400;18052;17348
Republic of Lithuania;2014;18;37036;19031;18005
Republic of Lithuania;2014;19;37601;19273;18328
Republic of Lithuania;2014;20;41333;21250;20083
Republic of Lithuania;2014;21;44991;22963;22028
Republic of Lithuania;2014;22;44381;22980;21401
Republic of Lithuania;2014;23;42472;21946;20526
Republic of Lithuania;2014;24;39882;20570;19312
Republic of Lithuania;2014;25;39300;20227;19073
Republic of Lithuania;2014;26;40327;20709;19618
Republic of Lithuania;2014;27;39510;20352;19158
Republic of Lithuania;2014;28;37884;19219;18665
Republic of Lithuania;2014;29;37425;19058;18367
Republic of Lithuania;2014;30;37356;18979;18377
Republic of Lithuania;2014;31;34660;17457;17203
Republic of Lithuania;2014;32;34530;17559;16971
Republic of Lithuania;2014;33;34425;17427;16998
Republic of Lithuania;2014;34;34876;17316;17560
Republic of Lithuania;2014;35;35325;17526;17799
Republic of Lithuania;2014;36;36165;17870;18295
Republic of Lithuania;2014;37;37036;18248;18788
Republic of Lithuania;2014;38;37323;18113;19210
Republic of Lithuania;2014;39;38064;18337;19727
Republic of Lithuania;2014;40;38752;18809;19943
Republic of Lithuania;2014;41;40815;19653;21162
Republic of Lithuania;2014;42;42718;20672;22046
Republic of Lithuania;2014;43;42433;20430;22003
Republic of Lithuania;2014;44;42076;20308;21768
Republic of Lithuania;2014;45;42141;20142;21999
Republic of Lithuania;2014;46;41914;19790;22124
Republic of Lithuania;2014;47;42265;20116;22149
Republic of Lithuania;2014;48;42341;20346;21995
Republic of Lithuania;2014;49;43819;20919;22900
Republic of Lithuania;2014;50;44564;21147;23417
Republic of Lithuania;2014;51;46424;21927;24497
Republic of Lithuania;2014;52;48335;22524;25811
Republic of Lithuania;2014;53;48059;22292;25767
Republic of Lithuania;2014;54;47148;21710;25438
Republic of Lithuania;2014;55;45887;21041;24846
Republic of Lithuania;2014;56;42340;19314;23026
Republic of Lithuania;2014;57;38777;17332;21445
Republic of Lithuania;2014;58;38156;17051;21105
Republic of Lithuania;2014;59;36006;15946;20060
Republic of Lithuania;2014;60;33502;14647;18855
Republic of Lithuania;2014;61;34848;14927;19921
Republic of Lithuania;2014;62;34271;14526;19745
Republic of Lithuania;2014;63;34030;14306;19724
Republic of Lithuania;2014;64;34563;14172;20391
Republic of Lithuania;2014;65;30819;12426;18393
Republic of Lithuania;2014;66;27732;11019;16713
Republic of Lithuania;2014;67;26044;10278;15766
Republic of Lithuania;2014;68;28113;10812;17301
Republic of Lithuania;2014;69;24140;9181;14959
Republic of Lithuania;2014;70;27545;10186;17359
Republic of Lithuania;2014;71;29702;10838;18864
Republic of Lithuania;2014;72;28504;10353;18151
Republic of Lithuania;2014;73;27219;9807;17412
Republic of Lithuania;2014;74;26544;9289;17255
Republic of Lithuania;2014;75;26584;9190;17394
Republic of Lithuania;2014;76;25353;8346;17007
Republic of Lithuania;2014;77;25002;8209;16793
Republic of Lithuania;2014;78;22754;7225;15529
Republic of Lithuania;2014;79;20365;6305;14060
Republic of Lithuania;2014;80;19851;6055;13796
Republic of Lithuania;2014;81;19269;5636;13633
Republic of Lithuania;2014;82;16998;4883;12115
Republic of Lithuania;2014;83;15870;4655;11215
Republic of Lithuania;2014;84;13686;3801;9885
Republic of Lithuania;2014;85;60645;13923;46722
Republic of Lithuania;2015;-1;2921262;1346257;1575005
Republic of Lithuania;2015;0;30357;15568;14789
Republic of Lithuania;2015;1;30013;15275;14738
Republic of Lithuania;2015;2;30383;15511;14872
Republic of Lithuania;2015;3;29909;15460;14449
Republic of Lithuania;2015;4;29816;15268;14548
Republic of Lithuania;2015;5;30250;15505;14745
Republic of Lithuania;2015;6;28564;14657;13907
Republic of Lithuania;2015;7;26674;13653;13021
Republic of Lithuania;2015;8;26423;13403;13020
Republic of Lithuania;2015;9;26336;13467;12869
Republic of Lithuania;2015;10;26394;13453;12941
Republic of Lithuania;2015;11;26571;13706;12865
Republic of Lithuania;2015;12;26177;13488;12689
Republic of Lithuania;2015;13;27574;14071;13503
Republic of Lithuania;2015;14;30021;15457;14564
Republic of Lithuania;2015;15;32257;16595;15662
Republic of Lithuania;2015;16;32955;17095;15860
Republic of Lithuania;2015;17;33799;17334;16465
Republic of Lithuania;2015;18;35129;17912;17217
Republic of Lithuania;2015;19;36258;18633;17625
Republic of Lithuania;2015;20;36941;18949;17992
Republic of Lithuania;2015;21;40809;20947;19862
Republic of Lithuania;2015;22;44196;22607;21589
Republic of Lithuania;2015;23;43442;22579;20863
Republic of Lithuania;2015;24;41779;21647;20132
Republic of Lithuania;2015;25;39354;20377;18977
Republic of Lithuania;2015;26;38794;19986;18808
Republic of Lithuania;2015;27;39951;20454;19497
Republic of Lithuania;2015;28;39427;20310;19117
Republic of Lithuania;2015;29;37811;19147;18664
Republic of Lithuania;2015;30;37279;18996;18283
Republic of Lithuania;2015;31;37244;18924;18320
Republic of Lithuania;2015;32;34378;17357;17021
Republic of Lithuania;2015;33;34284;17478;16806
Republic of Lithuania;2015;34;34152;17270;16882
Republic of Lithuania;2015;35;34460;17125;17335
Republic of Lithuania;2015;36;35033;17380;17653
Republic of Lithuania;2015;37;35867;17705;18162
Republic of Lithuania;2015;38;36782;18123;18659
Republic of Lithuania;2015;39;37054;17979;19075
Republic of Lithuania;2015;40;37832;18205;19627
Republic of Lithuania;2015;41;38539;18693;19846
Republic of Lithuania;2015;42;40484;19484;21000
Republic of Lithuania;2015;43;42465;20529;21936
Republic of Lithuania;2015;44;42059;20226;21833
Republic of Lithuania;2015;45;41620;20078;21542
Republic of Lithuania;2015;46;41778;19922;21856
Republic of Lithuania;2015;47;41669;19619;22050
Republic of Lithuania;2015;48;41932;19928;22004
Republic of Lithuania;2015;49;42026;20147;21879
Republic of Lithuania;2015;50;43504;20724;22780
Republic of Lithuania;2015;51;44233;20927;23306
Republic of Lithuania;2015;52;45984;21645;24339
Republic of Lithuania;2015;53;47886;22202;25684
Republic of Lithuania;2015;54;47583;21996;25587
Republic of Lithuania;2015;55;46560;21318;25242
Republic of Lithuania;2015;56;45383;20708;24675
Republic of Lithuania;2015;57;41859;18982;22877
Republic of Lithuania;2015;58;38311;17022;21289
Republic of Lithuania;2015;59;37622;16682;20940
Republic of Lithuania;2015;60;35489;15564;19925
Republic of Lithuania;2015;61;33091;14345;18746
Republic of Lithuania;2015;62;34254;14527;19727
Republic of Lithuania;2015;63;33706;14141;19565
Republic of Lithuania;2015;64;33381;13858;19523
Republic of Lithuania;2015;65;33894;13748;20146
Republic of Lithuania;2015;66;30160;11995;18165
Republic of Lithuania;2015;67;27158;10650;16508
Republic of Lithuania;2015;68;25455;9886;15569
Republic of Lithuania;2015;69;27369;10367;17002
Republic of Lithuania;2015;70;23478;8775;14703
Republic of Lithuania;2015;71;26786;9729;17057
Republic of Lithuania;2015;72;28812;10327;18485
Republic of Lithuania;2015;73;27658;9878;17780
Republic of Lithuania;2015;74;26322;9281;17041
Republic of Lithuania;2015;75;25612;8790;16822
Republic of Lithuania;2015;76;25596;8675;16921
Republic of Lithuania;2015;77;24293;7808;16485
Republic of Lithuania;2015;78;23850;7632;16218
Republic of Lithuania;2015;79;21561;6703;14858
Republic of Lithuania;2015;80;19187;5772;13415
Republic of Lithuania;2015;81;18577;5525;13052
Republic of Lithuania;2015;82;17922;5109;12813
Republic of Lithuania;2015;83;15598;4367;11231
Republic of Lithuania;2015;84;14472;4136;10336
Republic of Lithuania;2015;85;63355;14781;48574
Republic of Lithuania;2016;-1;2888558;1329607;1558951
Republic of Lithuania;2016;0;31462;16180;15282
Republic of Lithuania;2016;1;30438;15629;14809
Republic of Lithuania;2016;2;29823;15204;14619
Republic of Lithuania;2016;3;30104;15376;14728
Republic of Lithuania;2016;4;29663;15351;14312
Republic of Lithuania;2016;5;29590;15142;14448
Republic of Lithuania;2016;6;29914;15333;14581
Republic of Lithuania;2016;7;28325;14539;13786
Republic of Lithuania;2016;8;26456;13538;12918
Republic of Lithuania;2016;9;26230;13302;12928
Republic of Lithuania;2016;10;26085;13341;12744
Republic of Lithuania;2016;11;26062;13281;12781
Republic of Lithuania;2016;12;26283;13554;12729
Republic of Lithuania;2016;13;25969;13386;12583
Republic of Lithuania;2016;14;27343;13954;13389
Republic of Lithuania;2016;15;29757;15328;14429
Republic of Lithuania;2016;16;31978;16447;15531
Republic of Lithuania;2016;17;32719;16956;15763
Republic of Lithuania;2016;18;33409;17126;16283
Republic of Lithuania;2016;19;34279;17469;16810
Republic of Lithuania;2016;20;35424;18129;17295
Republic of Lithuania;2016;21;36070;18386;17684
Republic of Lithuania;2016;22;39605;20202;19403
Republic of Lithuania;2016;23;42701;21741;20960
Republic of Lithuania;2016;24;42063;21723;20340
Republic of Lithuania;2016;25;40770;20973;19797
Republic of Lithuania;2016;26;38422;19760;18662
Republic of Lithuania;2016;27;38070;19599;18471
Republic of Lithuania;2016;28;39687;20291;19396
Republic of Lithuania;2016;29;38944;20044;18900
Republic of Lithuania;2016;30;37537;18928;18609
Republic of Lithuania;2016;31;36906;18775;18131
Republic of Lithuania;2016;32;36717;18604;18113
Republic of Lithuania;2016;33;33934;17114;16820
Republic of Lithuania;2016;34;33791;17213;16578
Republic of Lithuania;2016;35;33451;16846;16605
Republic of Lithuania;2016;36;33874;16788;17086
Republic of Lithuania;2016;37;34536;17079;17457
Republic of Lithuania;2016;38;35391;17477;17914
Republic of Lithuania;2016;39;36255;17816;18439
Republic of Lithuania;2016;40;36576;17704;18872
Republic of Lithuania;2016;41;37448;17991;19457
Republic of Lithuania;2016;42;38105;18462;19643
Republic of Lithuania;2016;43;40009;19204;20805
Republic of Lithuania;2016;44;41948;20245;21703
Republic of Lithuania;2016;45;41413;19866;21547
Republic of Lithuania;2016;46;41110;19750;21360
Republic of Lithuania;2016;47;41324;19634;21690
Republic of Lithuania;2016;48;41215;19354;21861
Republic of Lithuania;2016;49;41554;19681;21873
Republic of Lithuania;2016;50;41565;19825;21740
Republic of Lithuania;2016;51;43048;20416;22632
Republic of Lithuania;2016;52;43752;20601;23151
Republic of Lithuania;2016;53;45481;21289;24192
Republic of Lithuania;2016;54;47348;21846;25502
Republic of Lithuania;2016;55;46881;21534;25347
Republic of Lithuania;2016;56;45933;20886;25047
Republic of Lithuania;2016;57;44791;20312;24479
Republic of Lithuania;2016;58;41361;18632;22729
Republic of Lithuania;2016;59;37776;16646;21130
Republic of Lithuania;2016;60;37058;16294;20764
Republic of Lithuania;2016;61;35006;15182;19824
Republic of Lithuania;2016;62;32574;13969;18605
Republic of Lithuania;2016;63;33671;14134;19537
Republic of Lithuania;2016;64;33047;13697;19350
Republic of Lithuania;2016;65;32648;13379;19269
Republic of Lithuania;2016;66;33108;13233;19875
Republic of Lithuania;2016;67;29442;11526;17916
Republic of Lithuania;2016;68;26472;10206;16266
Republic of Lithuania;2016;69;24812;9491;15321
Republic of Lithuania;2016;70;26620;9897;16723
Republic of Lithuania;2016;71;22816;8361;14455
Republic of Lithuania;2016;72;25979;9240;16739
Republic of Lithuania;2016;73;27855;9783;18072
Republic of Lithuania;2016;74;26736;9365;17371
Republic of Lithuania;2016;75;25358;8753;16605
Republic of Lithuania;2016;76;24596;8248;16348
Republic of Lithuania;2016;77;24438;8105;16333
Republic of Lithuania;2016;78;23172;7272;15900
Republic of Lithuania;2016;79;22602;7064;15538
Republic of Lithuania;2016;80;20348;6190;14158
Republic of Lithuania;2016;81;17893;5264;12629
Republic of Lithuania;2016;82;17262;4971;12291
Republic of Lithuania;2016;83;16470;4578;11892
Republic of Lithuania;2016;84;14136;3860;10276
Republic of Lithuania;2016;85;65764;15743;50021
Republic of Lithuania;2017;-1;2847904;1312186;1535718
Republic of Lithuania;2017;0;30409;15738;14671
Republic of Lithuania;2017;1;31158;16004;15154
Republic of Lithuania;2017;2;30030;15413;14617
Republic of Lithuania;2017;3;29400;14949;14451
Republic of Lithuania;2017;4;29674;15170;14504
Republic of Lithuania;2017;5;29298;15163;14135
Republic of Lithuania;2017;6;29258;14985;14273
Republic of Lithuania;2017;7;29534;15143;14391
Republic of Lithuania;2017;8;27966;14353;13613
Republic of Lithuania;2017;9;26198;13404;12794
Republic of Lithuania;2017;10;25935;13186;12749
Republic of Lithuania;2017;11;25742;13174;12568
Republic of Lithuania;2017;12;25766;13128;12638
Republic of Lithuania;2017;13;26027;13404;12623
Republic of Lithuania;2017;14;25727;13247;12480
Republic of Lithuania;2017;15;27075;13810;13265
Republic of Lithuania;2017;16;29472;15175;14297
Republic of Lithuania;2017;17;31719;16320;15399
Republic of Lithuania;2017;18;32306;16734;15572
Republic of Lithuania;2017;19;32479;16705;15774
Republic of Lithuania;2017;20;33474;17063;16411
Republic of Lithuania;2017;21;34528;17694;16834
Republic of Lithuania;2017;22;35080;17934;17146
Republic of Lithuania;2017;23;38241;19688;18553
Republic of Lithuania;2017;24;41233;21146;20087
Republic of Lithuania;2017;25;40718;21125;19593
Republic of Lithuania;2017;26;39394;20360;19034
Republic of Lithuania;2017;27;37360;19300;18060
Republic of Lithuania;2017;28;37133;19184;17949
Republic of Lithuania;2017;29;38776;19872;18904
Republic of Lithuania;2017;30;38025;19605;18420
Republic of Lithuania;2017;31;36726;18559;18167
Republic of Lithuania;2017;32;36047;18381;17666
Republic of Lithuania;2017;33;35880;18241;17639
Republic of Lithuania;2017;34;33120;16764;16356
Republic of Lithuania;2017;35;32836;16715;16121
Republic of Lithuania;2017;36;32704;16473;16231
Republic of Lithuania;2017;37;33259;16513;16746
Republic of Lithuania;2017;38;33991;16816;17175
Republic of Lithuania;2017;39;34850;17166;17684
Republic of Lithuania;2017;40;35699;17561;18138
Republic of Lithuania;2017;41;36053;17458;18595
Republic of Lithuania;2017;42;36925;17753;19172
Republic of Lithuania;2017;43;37592;18215;19377
Republic of Lithuania;2017;44;39487;18980;20507
Republic of Lithuania;2017;45;41312;19952;21360
Republic of Lithuania;2017;46;40971;19658;21313
Republic of Lithuania;2017;47;40613;19482;21131
Republic of Lithuania;2017;48;40840;19400;21440
Republic of Lithuania;2017;49;40751;19101;21650
Republic of Lithuania;2017;50;41033;19401;21632
Republic of Lithuania;2017;51;41041;19546;21495
Republic of Lithuania;2017;52;42512;20134;22378
Republic of Lithuania;2017;53;43187;20289;22898
Republic of Lithuania;2017;54;44816;20890;23926
Republic of Lithuania;2017;55;46657;21449;25208
Republic of Lithuania;2017;56;46281;21152;25129
Republic of Lithuania;2017;57;45308;20488;24820
Republic of Lithuania;2017;58;44190;19934;24256
Republic of Lithuania;2017;59;40700;18216;22484
Republic of Lithuania;2017;60;37233;16286;20947
Republic of Lithuania;2017;61;36464;15871;20593
Republic of Lithuania;2017;62;34431;14774;19657
Republic of Lithuania;2017;63;32039;13611;18428
Republic of Lithuania;2017;64;33024;13679;19345
Republic of Lithuania;2017;65;32366;13243;19123
Republic of Lithuania;2017;66;31941;12907;19034
Republic of Lithuania;2017;67;32363;12763;19600
Republic of Lithuania;2017;68;28731;11085;17646
Republic of Lithuania;2017;69;25822;9805;16017
Republic of Lithuania;2017;70;24192;9106;15086
Republic of Lithuania;2017;71;25834;9438;16396
Republic of Lithuania;2017;72;22118;7959;14159
Republic of Lithuania;2017;73;25104;8737;16367
Republic of Lithuania;2017;74;26912;9256;17656
Republic of Lithuania;2017;75;25736;8832;16904
Republic of Lithuania;2017;76;24386;8221;16165
Republic of Lithuania;2017;77;23574;7710;15864
Republic of Lithuania;2017;78;23264;7538;15726
Republic of Lithuania;2017;79;21958;6717;15241
Republic of Lithuania;2017;80;21283;6467;14816
Republic of Lithuania;2017;81;19127;5671;13456
Republic of Lithuania;2017;82;16608;4778;11830
Republic of Lithuania;2017;83;15973;4464;11509
Republic of Lithuania;2017;84;15082;4112;10970
Republic of Lithuania;2017;85;67823;16293;51530
Republic of Lithuania;2018;-1;2808901;1297293;1511608
Republic of Lithuania;2018;0;28760;14808;13952
Republic of Lithuania;2018;1;30422;15736;14686
Republic of Lithuania;2018;2;30861;15865;14996
Republic of Lithuania;2018;3;29710;15245;14465
Republic of Lithuania;2018;4;29046;14770;14276
Republic of Lithuania;2018;5;29320;14979;14341
Republic of Lithuania;2018;6;28993;14993;14000
Republic of Lithuania;2018;7;28996;14844;14152
Republic of Lithuania;2018;8;29248;15001;14247
Republic of Lithuania;2018;9;27687;14213;13474
Republic of Lithuania;2018;10;25924;13269;12655
Republic of Lithuania;2018;11;25630;13019;12611
Republic of Lithuania;2018;12;25498;13050;12448
Republic of Lithuania;2018;13;25533;13010;12523
Republic of Lithuania;2018;14;25809;13287;12522
Republic of Lithuania;2018;15;25486;13111;12375
Republic of Lithuania;2018;16;26855;13687;13168
Republic of Lithuania;2018;17;29237;15048;14189
Republic of Lithuania;2018;18;31212;16053;15159
Republic of Lithuania;2018;19;30910;16112;14798
Republic of Lithuania;2018;20;31285;16084;15201
Republic of Lithuania;2018;21;32106;16369;15737
Republic of Lithuania;2018;22;33001;16941;16060
Republic of Lithuania;2018;23;33130;17045;16085
Republic of Lithuania;2018;24;36276;18774;17502
Republic of Lithuania;2018;25;39178;20160;19018
Republic of Lithuania;2018;26;39040;20360;18680
Republic of Lithuania;2018;27;38011;19755;18256
Republic of Lithuania;2018;28;36272;18819;17453
Republic of Lithuania;2018;29;36242;18829;17413
Republic of Lithuania;2018;30;37966;19542;18424
Republic of Lithuania;2018;31;37361;19358;18003
Republic of Lithuania;2018;32;36115;18337;17778
Republic of Lithuania;2018;33;35538;18220;17318
Republic of Lithuania;2018;34;35410;18104;17306
Republic of Lithuania;2018;35;32750;16664;16086
Republic of Lithuania;2018;36;32502;16625;15877
Republic of Lithuania;2018;37;32417;16462;15955
Republic of Lithuania;2018;38;32935;16455;16480
Republic of Lithuania;2018;39;33616;16703;16913
Republic of Lithuania;2018;40;34536;17124;17412
Republic of Lithuania;2018;41;35448;17524;17924
Republic of Lithuania;2018;42;35724;17370;18354
Republic of Lithuania;2018;43;36612;17670;18942
Republic of Lithuania;2018;44;37358;18216;19142
Republic of Lithuania;2018;45;39139;18866;20273
Republic of Lithuania;2018;46;40941;19864;21077
Republic of Lithuania;2018;47;40644;19559;21085
Republic of Lithuania;2018;48;40301;19395;20906
Republic of Lithuania;2018;49;40458;19240;21218
Republic of Lithuania;2018;50;40435;18982;21453
Republic of Lithuania;2018;51;40639;19234;21405
Republic of Lithuania;2018;52;40672;19357;21315
Republic of Lithuania;2018;53;42111;19934;22177
Republic of Lithuania;2018;54;42728;20035;22693
Republic of Lithuania;2018;55;44354;20637;23717
Republic of Lithuania;2018;56;46130;21148;24982
Republic of Lithuania;2018;57;45753;20833;24920
Republic of Lithuania;2018;58;44776;20149;24627
Republic of Lithuania;2018;59;43680;19595;24085
Republic of Lithuania;2018;60;40199;17855;22344
Republic of Lithuania;2018;61;36716;15933;20783
Republic of Lithuania;2018;62;36016;15524;20492
Republic of Lithuania;2018;63;33924;14426;19498
Republic of Lithuania;2018;64;31522;13265;18257
Republic of Lithuania;2018;65;32428;13283;19145
Republic of Lithuania;2018;66;31709;12825;18884
Republic of Lithuania;2018;67;31286;12485;18801
Republic of Lithuania;2018;68;31640;12290;19350
Republic of Lithuania;2018;69;28074;10687;17387
Republic of Lithuania;2018;70;25162;9417;15745
Republic of Lithuania;2018;71;23530;8681;14849
Republic of Lithuania;2018;72;25076;9006;16070
Republic of Lithuania;2018;73;21435;7590;13845
Republic of Lithuania;2018;74;24281;8287;15994
Republic of Lithuania;2018;75;25928;8738;17190
Republic of Lithuania;2018;76;24724;8293;16431
Republic of Lithuania;2018;77;23362;7681;15681
Republic of Lithuania;2018;78;22531;7214;15317
Republic of Lithuania;2018;79;22108;6994;15114
Republic of Lithuania;2018;80;20702;6174;14528
Republic of Lithuania;2018;81;19958;5896;14062
Republic of Lithuania;2018;82;17811;5135;12676
Republic of Lithuania;2018;83;15298;4279;11019
Republic of Lithuania;2018;84;14589;3978;10611
Republic of Lithuania;2018;85;70165;16919;53246
Rietavas mun.;2001;-1;10681;5127;5554
Rietavas mun.;2001;0;114;54;60
Rietavas mun.;2001;1;107;51;56
Rietavas mun.;2001;2;117;56;61
Rietavas mun.;2001;3;136;69;67
Rietavas mun.;2001;4;130;61;69
Rietavas mun.;2001;5;121;62;59
Rietavas mun.;2001;6;162;78;84
Rietavas mun.;2001;7;150;76;74
Rietavas mun.;2001;8;190;96;94
Rietavas mun.;2001;9;231;115;116
Rietavas mun.;2001;10;205;107;98
Rietavas mun.;2001;11;241;132;109
Rietavas mun.;2001;12;181;108;73
Rietavas mun.;2001;13;213;99;114
Rietavas mun.;2001;14;217;88;129
Rietavas mun.;2001;15;195;105;90
Rietavas mun.;2001;16;194;98;96
Rietavas mun.;2001;17;190;94;96
Rietavas mun.;2001;18;203;112;91
Rietavas mun.;2001;19;183;94;89
Rietavas mun.;2001;20;142;75;67
Rietavas mun.;2001;21;113;55;58
Rietavas mun.;2001;22;123;64;59
Rietavas mun.;2001;23;108;56;52
Rietavas mun.;2001;24;110;58;52
Rietavas mun.;2001;25;115;61;54
Rietavas mun.;2001;26;118;67;51
Rietavas mun.;2001;27;106;63;43
Rietavas mun.;2001;28;123;63;60
Rietavas mun.;2001;29;136;71;65
Rietavas mun.;2001;30;127;65;62
Rietavas mun.;2001;31;134;69;65
Rietavas mun.;2001;32;122;66;56
Rietavas mun.;2001;33;149;78;71
Rietavas mun.;2001;34;141;66;75
Rietavas mun.;2001;35;146;88;58
Rietavas mun.;2001;36;143;67;76
Rietavas mun.;2001;37;141;65;76
Rietavas mun.;2001;38;151;74;77
Rietavas mun.;2001;39;185;92;93
Rietavas mun.;2001;40;139;69;70
Rietavas mun.;2001;41;148;87;61
Rietavas mun.;2001;42;156;91;65
Rietavas mun.;2001;43;133;58;75
Rietavas mun.;2001;44;122;63;59
Rietavas mun.;2001;45;106;56;50
Rietavas mun.;2001;46;122;59;63
Rietavas mun.;2001;47;103;62;41
Rietavas mun.;2001;48;116;59;57
Rietavas mun.;2001;49;108;53;55
Rietavas mun.;2001;50;110;59;51
Rietavas mun.;2001;51;115;56;59
Rietavas mun.;2001;52;80;43;37
Rietavas mun.;2001;53;79;38;41
Rietavas mun.;2001;54;83;39;44
Rietavas mun.;2001;55;80;35;45
Rietavas mun.;2001;56;99;46;53
Rietavas mun.;2001;57;102;42;60
Rietavas mun.;2001;58;110;46;64
Rietavas mun.;2001;59;122;56;66
Rietavas mun.;2001;60;119;54;65
Rietavas mun.;2001;61;106;38;68
Rietavas mun.;2001;62;111;51;60
Rietavas mun.;2001;63;121;51;70
Rietavas mun.;2001;64;123;50;73
Rietavas mun.;2001;65;123;51;72
Rietavas mun.;2001;66;124;43;81
Rietavas mun.;2001;67;117;48;69
Rietavas mun.;2001;68;104;41;63
Rietavas mun.;2001;69;115;57;58
Rietavas mun.;2001;70;92;37;55
Rietavas mun.;2001;71;106;42;64
Rietavas mun.;2001;72;106;44;62
Rietavas mun.;2001;73;93;39;54
Rietavas mun.;2001;74;81;27;54
Rietavas mun.;2001;75;84;31;53
Rietavas mun.;2001;76;72;20;52
Rietavas mun.;2001;77;79;26;53
Rietavas mun.;2001;78;64;20;44
Rietavas mun.;2001;79;60;18;42
Rietavas mun.;2001;80;70;27;43
Rietavas mun.;2001;81;38;13;25
Rietavas mun.;2001;82;28;6;22
Rietavas mun.;2001;83;31;7;24
Rietavas mun.;2001;84;30;12;18
Rietavas mun.;2001;85;138;39;99
Rietavas mun.;2002;-1;10588;5048;5540
Rietavas mun.;2002;0;101;53;48
Rietavas mun.;2002;1;114;53;61
Rietavas mun.;2002;2;111;52;59
Rietavas mun.;2002;3;115;55;60
Rietavas mun.;2002;4;134;69;65
Rietavas mun.;2002;5;130;61;69
Rietavas mun.;2002;6;119;61;58
Rietavas mun.;2002;7;160;77;83
Rietavas mun.;2002;8;148;75;73
Rietavas mun.;2002;9;191;95;96
Rietavas mun.;2002;10;230;114;116
Rietavas mun.;2002;11;204;106;98
Rietavas mun.;2002;12;236;128;108
Rietavas mun.;2002;13;177;105;72
Rietavas mun.;2002;14;215;100;115
Rietavas mun.;2002;15;215;87;128
Rietavas mun.;2002;16;194;104;90
Rietavas mun.;2002;17;190;96;94
Rietavas mun.;2002;18;187;92;95
Rietavas mun.;2002;19;204;113;91
Rietavas mun.;2002;20;180;93;87
Rietavas mun.;2002;21;143;73;70
Rietavas mun.;2002;22;113;54;59
Rietavas mun.;2002;23;126;64;62
Rietavas mun.;2002;24;106;53;53
Rietavas mun.;2002;25;108;59;49
Rietavas mun.;2002;26;113;58;55
Rietavas mun.;2002;27;115;66;49
Rietavas mun.;2002;28;102;60;42
Rietavas mun.;2002;29;117;58;59
Rietavas mun.;2002;30;130;67;63
Rietavas mun.;2002;31;126;65;61
Rietavas mun.;2002;32;132;68;64
Rietavas mun.;2002;33;119;64;55
Rietavas mun.;2002;34;142;73;69
Rietavas mun.;2002;35;136;62;74
Rietavas mun.;2002;36;145;86;59
Rietavas mun.;2002;37;140;64;76
Rietavas mun.;2002;38;139;63;76
Rietavas mun.;2002;39;150;74;76
Rietavas mun.;2002;40;180;88;92
Rietavas mun.;2002;41;139;67;72
Rietavas mun.;2002;42;144;84;60
Rietavas mun.;2002;43;155;90;65
Rietavas mun.;2002;44;136;60;76
Rietavas mun.;2002;45;118;61;57
Rietavas mun.;2002;46;106;55;51
Rietavas mun.;2002;47;123;61;62
Rietavas mun.;2002;48;102;61;41
Rietavas mun.;2002;49;114;56;58
Rietavas mun.;2002;50;107;52;55
Rietavas mun.;2002;51;108;58;50
Rietavas mun.;2002;52;114;55;59
Rietavas mun.;2002;53;80;43;37
Rietavas mun.;2002;54;78;38;40
Rietavas mun.;2002;55;82;39;43
Rietavas mun.;2002;56;79;34;45
Rietavas mun.;2002;57;98;45;53
Rietavas mun.;2002;58;101;44;57
Rietavas mun.;2002;59;106;43;63
Rietavas mun.;2002;60;119;53;66
Rietavas mun.;2002;61;117;53;64
Rietavas mun.;2002;62;104;36;68
Rietavas mun.;2002;63;109;49;60
Rietavas mun.;2002;64;118;49;69
Rietavas mun.;2002;65;120;47;73
Rietavas mun.;2002;66;119;49;70
Rietavas mun.;2002;67;121;40;81
Rietavas mun.;2002;68;117;48;69
Rietavas mun.;2002;69;101;38;63
Rietavas mun.;2002;70;114;56;58
Rietavas mun.;2002;71;87;33;54
Rietavas mun.;2002;72;110;45;65
Rietavas mun.;2002;73;102;42;60
Rietavas mun.;2002;74;86;33;53
Rietavas mun.;2002;75;80;25;55
Rietavas mun.;2002;76;81;29;52
Rietavas mun.;2002;77;65;19;46
Rietavas mun.;2002;78;75;24;51
Rietavas mun.;2002;79;60;19;41
Rietavas mun.;2002;80;57;18;39
Rietavas mun.;2002;81;62;23;39
Rietavas mun.;2002;82;37;13;24
Rietavas mun.;2002;83;28;7;21
Rietavas mun.;2002;84;27;6;21
Rietavas mun.;2002;85;145;40;105
Rietavas mun.;2003;-1;10453;4979;5474
Rietavas mun.;2003;0;99;52;47
Rietavas mun.;2003;1;98;52;46
Rietavas mun.;2003;2;114;54;60
Rietavas mun.;2003;3;110;50;60
Rietavas mun.;2003;4;114;54;60
Rietavas mun.;2003;5;133;68;65
Rietavas mun.;2003;6;130;61;69
Rietavas mun.;2003;7;115;59;56
Rietavas mun.;2003;8;161;78;83
Rietavas mun.;2003;9;147;75;72
Rietavas mun.;2003;10;187;95;92
Rietavas mun.;2003;11;227;113;114
Rietavas mun.;2003;12;200;105;95
Rietavas mun.;2003;13;233;126;107
Rietavas mun.;2003;14;172;101;71
Rietavas mun.;2003;15;209;98;111
Rietavas mun.;2003;16;212;86;126
Rietavas mun.;2003;17;188;101;87
Rietavas mun.;2003;18;187;94;93
Rietavas mun.;2003;19;187;93;94
Rietavas mun.;2003;20;202;113;89
Rietavas mun.;2003;21;180;94;86
Rietavas mun.;2003;22;145;73;72
Rietavas mun.;2003;23;109;52;57
Rietavas mun.;2003;24;120;64;56
Rietavas mun.;2003;25;97;49;48
Rietavas mun.;2003;26;103;57;46
Rietavas mun.;2003;27;112;58;54
Rietavas mun.;2003;28;108;59;49
Rietavas mun.;2003;29;97;56;41
Rietavas mun.;2003;30;114;56;58
Rietavas mun.;2003;31;123;63;60
Rietavas mun.;2003;32;124;64;60
Rietavas mun.;2003;33;130;66;64
Rietavas mun.;2003;34;118;65;53
Rietavas mun.;2003;35;140;71;69
Rietavas mun.;2003;36;132;60;72
Rietavas mun.;2003;37;142;86;56
Rietavas mun.;2003;38;136;62;74
Rietavas mun.;2003;39;138;62;76
Rietavas mun.;2003;40;150;76;74
Rietavas mun.;2003;41;176;87;89
Rietavas mun.;2003;42;139;69;70
Rietavas mun.;2003;43;139;83;56
Rietavas mun.;2003;44;154;88;66
Rietavas mun.;2003;45;132;58;74
Rietavas mun.;2003;46;121;61;60
Rietavas mun.;2003;47;104;55;49
Rietavas mun.;2003;48;122;60;62
Rietavas mun.;2003;49;103;62;41
Rietavas mun.;2003;50;113;56;57
Rietavas mun.;2003;51;106;50;56
Rietavas mun.;2003;52;105;54;51
Rietavas mun.;2003;53;114;56;58
Rietavas mun.;2003;54;78;41;37
Rietavas mun.;2003;55;76;37;39
Rietavas mun.;2003;56;78;36;42
Rietavas mun.;2003;57;78;34;44
Rietavas mun.;2003;58;96;45;51
Rietavas mun.;2003;59;101;42;59
Rietavas mun.;2003;60;103;42;61
Rietavas mun.;2003;61;119;52;67
Rietavas mun.;2003;62;117;54;63
Rietavas mun.;2003;63;105;35;70
Rietavas mun.;2003;64;109;49;60
Rietavas mun.;2003;65;114;47;67
Rietavas mun.;2003;66;118;45;73
Rietavas mun.;2003;67;122;50;72
Rietavas mun.;2003;68;119;41;78
Rietavas mun.;2003;69;115;45;70
Rietavas mun.;2003;70;95;32;63
Rietavas mun.;2003;71;110;54;56
Rietavas mun.;2003;72;90;33;57
Rietavas mun.;2003;73;104;41;63
Rietavas mun.;2003;74;100;40;60
Rietavas mun.;2003;75;84;31;53
Rietavas mun.;2003;76;83;28;55
Rietavas mun.;2003;77;75;26;49
Rietavas mun.;2003;78;58;16;42
Rietavas mun.;2003;79;72;22;50
Rietavas mun.;2003;80;58;19;39
Rietavas mun.;2003;81;50;13;37
Rietavas mun.;2003;82;56;21;35
Rietavas mun.;2003;83;32;10;22
Rietavas mun.;2003;84;25;4;21
Rietavas mun.;2003;85;142;34;108
Rietavas mun.;2004;-1;10323;4924;5399
Rietavas mun.;2004;0;121;61;60
Rietavas mun.;2004;1;97;49;48
Rietavas mun.;2004;2;96;52;44
Rietavas mun.;2004;3;113;53;60
Rietavas mun.;2004;4;108;49;59
Rietavas mun.;2004;5;112;54;58
Rietavas mun.;2004;6;136;69;67
Rietavas mun.;2004;7;130;62;68
Rietavas mun.;2004;8;115;61;54
Rietavas mun.;2004;9;162;79;83
Rietavas mun.;2004;10;147;77;70
Rietavas mun.;2004;11;189;99;90
Rietavas mun.;2004;12;223;111;112
Rietavas mun.;2004;13;195;102;93
Rietavas mun.;2004;14;225;123;102
Rietavas mun.;2004;15;165;97;68
Rietavas mun.;2004;16;206;98;108
Rietavas mun.;2004;17;204;85;119
Rietavas mun.;2004;18;187;100;87
Rietavas mun.;2004;19;180;92;88
Rietavas mun.;2004;20;185;93;92
Rietavas mun.;2004;21;195;108;87
Rietavas mun.;2004;22;182;94;88
Rietavas mun.;2004;23;136;70;66
Rietavas mun.;2004;24;106;51;55
Rietavas mun.;2004;25;117;61;56
Rietavas mun.;2004;26;96;48;48
Rietavas mun.;2004;27;90;51;39
Rietavas mun.;2004;28;104;54;50
Rietavas mun.;2004;29;104;58;46
Rietavas mun.;2004;30;89;51;38
Rietavas mun.;2004;31;112;56;56
Rietavas mun.;2004;32;118;60;58
Rietavas mun.;2004;33;128;65;63
Rietavas mun.;2004;34;131;68;63
Rietavas mun.;2004;35;120;64;56
Rietavas mun.;2004;36;141;69;72
Rietavas mun.;2004;37;132;60;72
Rietavas mun.;2004;38;143;86;57
Rietavas mun.;2004;39;139;63;76
Rietavas mun.;2004;40;138;63;75
Rietavas mun.;2004;41;148;75;73
Rietavas mun.;2004;42;172;84;88
Rietavas mun.;2004;43;140;69;71
Rietavas mun.;2004;44;135;80;55
Rietavas mun.;2004;45;150;88;62
Rietavas mun.;2004;46;130;56;74
Rietavas mun.;2004;47;118;60;58
Rietavas mun.;2004;48;104;55;49
Rietavas mun.;2004;49;117;57;60
Rietavas mun.;2004;50;98;61;37
Rietavas mun.;2004;51;108;53;55
Rietavas mun.;2004;52;102;46;56
Rietavas mun.;2004;53;101;52;49
Rietavas mun.;2004;54;115;53;62
Rietavas mun.;2004;55;72;37;35
Rietavas mun.;2004;56;76;36;40
Rietavas mun.;2004;57;70;30;40
Rietavas mun.;2004;58;76;34;42
Rietavas mun.;2004;59;93;43;50
Rietavas mun.;2004;60;96;41;55
Rietavas mun.;2004;61;100;41;59
Rietavas mun.;2004;62;119;53;66
Rietavas mun.;2004;63;113;52;61
Rietavas mun.;2004;64;104;36;68
Rietavas mun.;2004;65;108;48;60
Rietavas mun.;2004;66;113;46;67
Rietavas mun.;2004;67;117;44;73
Rietavas mun.;2004;68;114;47;67
Rietavas mun.;2004;69;115;37;78
Rietavas mun.;2004;70;115;45;70
Rietavas mun.;2004;71;94;32;62
Rietavas mun.;2004;72;102;48;54
Rietavas mun.;2004;73;84;31;53
Rietavas mun.;2004;74;104;42;62
Rietavas mun.;2004;75;97;38;59
Rietavas mun.;2004;76;76;27;49
Rietavas mun.;2004;77;77;24;53
Rietavas mun.;2004;78;69;25;44
Rietavas mun.;2004;79;55;15;40
Rietavas mun.;2004;80;71;19;52
Rietavas mun.;2004;81;57;18;39
Rietavas mun.;2004;82;48;13;35
Rietavas mun.;2004;83;54;19;35
Rietavas mun.;2004;84;30;8;22
Rietavas mun.;2004;85;149;40;109
Rietavas mun.;2005;-1;10151;4841;5310
Rietavas mun.;2005;0;101;56;45
Rietavas mun.;2005;1;120;60;60
Rietavas mun.;2005;2;94;47;47
Rietavas mun.;2005;3;94;50;44
Rietavas mun.;2005;4;108;49;59
Rietavas mun.;2005;5;105;47;58
Rietavas mun.;2005;6;111;53;58
Rietavas mun.;2005;7;135;69;66
Rietavas mun.;2005;8;128;60;68
Rietavas mun.;2005;9;113;60;53
Rietavas mun.;2005;10;163;78;85
Rietavas mun.;2005;11;149;78;71
Rietavas mun.;2005;12;186;98;88
Rietavas mun.;2005;13;217;107;110
Rietavas mun.;2005;14;191;101;90
Rietavas mun.;2005;15;223;121;102
Rietavas mun.;2005;16;165;96;69
Rietavas mun.;2005;17;201;95;106
Rietavas mun.;2005;18;202;86;116
Rietavas mun.;2005;19;181;95;86
Rietavas mun.;2005;20;176;91;85
Rietavas mun.;2005;21;175;89;86
Rietavas mun.;2005;22;186;104;82
Rietavas mun.;2005;23;179;91;88
Rietavas mun.;2005;24;127;63;64
Rietavas mun.;2005;25;104;53;51
Rietavas mun.;2005;26;110;58;52
Rietavas mun.;2005;27;90;44;46
Rietavas mun.;2005;28;85;47;38
Rietavas mun.;2005;29;100;53;47
Rietavas mun.;2005;30;101;57;44
Rietavas mun.;2005;31;83;48;35
Rietavas mun.;2005;32;103;49;54
Rietavas mun.;2005;33;113;56;57
Rietavas mun.;2005;34;126;65;61
Rietavas mun.;2005;35;128;66;62
Rietavas mun.;2005;36;119;65;54
Rietavas mun.;2005;37;133;62;71
Rietavas mun.;2005;38;134;62;72
Rietavas mun.;2005;39;140;82;58
Rietavas mun.;2005;40;139;63;76
Rietavas mun.;2005;41;136;63;73
Rietavas mun.;2005;42;143;72;71
Rietavas mun.;2005;43;173;86;87
Rietavas mun.;2005;44;139;70;69
Rietavas mun.;2005;45;133;80;53
Rietavas mun.;2005;46;152;89;63
Rietavas mun.;2005;47;130;55;75
Rietavas mun.;2005;48;119;60;59
Rietavas mun.;2005;49;103;54;49
Rietavas mun.;2005;50;116;57;59
Rietavas mun.;2005;51;97;60;37
Rietavas mun.;2005;52;106;52;54
Rietavas mun.;2005;53;99;45;54
Rietavas mun.;2005;54;101;50;51
Rietavas mun.;2005;55;113;53;60
Rietavas mun.;2005;56;73;38;35
Rietavas mun.;2005;57;73;35;38
Rietavas mun.;2005;58;68;28;40
Rietavas mun.;2005;59;74;33;41
Rietavas mun.;2005;60;92;43;49
Rietavas mun.;2005;61;98;42;56
Rietavas mun.;2005;62;96;40;56
Rietavas mun.;2005;63;115;51;64
Rietavas mun.;2005;64;110;50;60
Rietavas mun.;2005;65;101;36;65
Rietavas mun.;2005;66;108;48;60
Rietavas mun.;2005;67;112;47;65
Rietavas mun.;2005;68;114;42;72
Rietavas mun.;2005;69;110;44;66
Rietavas mun.;2005;70;106;32;74
Rietavas mun.;2005;71;114;43;71
Rietavas mun.;2005;72;95;31;64
Rietavas mun.;2005;73;101;48;53
Rietavas mun.;2005;74;80;29;51
Rietavas mun.;2005;75;100;40;60
Rietavas mun.;2005;76;96;38;58
Rietavas mun.;2005;77;74;27;47
Rietavas mun.;2005;78;74;22;52
Rietavas mun.;2005;79;63;21;42
Rietavas mun.;2005;80;51;14;37
Rietavas mun.;2005;81;63;16;47
Rietavas mun.;2005;82;51;18;33
Rietavas mun.;2005;83;47;13;34
Rietavas mun.;2005;84;46;16;30
Rietavas mun.;2005;85;148;36;112
Rietavas mun.;2006;-1;9854;4679;5175
Rietavas mun.;2006;0;83;41;42
Rietavas mun.;2006;1;96;52;44
Rietavas mun.;2006;2;113;56;57
Rietavas mun.;2006;3;92;46;46
Rietavas mun.;2006;4;92;49;43
Rietavas mun.;2006;5;105;49;56
Rietavas mun.;2006;6;102;46;56
Rietavas mun.;2006;7;106;51;55
Rietavas mun.;2006;8;134;68;66
Rietavas mun.;2006;9;125;59;66
Rietavas mun.;2006;10;112;60;52
Rietavas mun.;2006;11;162;78;84
Rietavas mun.;2006;12;148;79;69
Rietavas mun.;2006;13;183;94;89
Rietavas mun.;2006;14;214;104;110
Rietavas mun.;2006;15;188;99;89
Rietavas mun.;2006;16;217;116;101
Rietavas mun.;2006;17;159;92;67
Rietavas mun.;2006;18;195;90;105
Rietavas mun.;2006;19;193;82;111
Rietavas mun.;2006;20;175;91;84
Rietavas mun.;2006;21;170;87;83
Rietavas mun.;2006;22;167;87;80
Rietavas mun.;2006;23;173;98;75
Rietavas mun.;2006;24;172;87;85
Rietavas mun.;2006;25;113;56;57
Rietavas mun.;2006;26;98;51;47
Rietavas mun.;2006;27;103;54;49
Rietavas mun.;2006;28;90;43;47
Rietavas mun.;2006;29;78;46;32
Rietavas mun.;2006;30;99;52;47
Rietavas mun.;2006;31;94;54;40
Rietavas mun.;2006;32;82;49;33
Rietavas mun.;2006;33;99;46;53
Rietavas mun.;2006;34;105;51;54
Rietavas mun.;2006;35;121;59;62
Rietavas mun.;2006;36;123;62;61
Rietavas mun.;2006;37;113;61;52
Rietavas mun.;2006;38;136;64;72
Rietavas mun.;2006;39;134;61;73
Rietavas mun.;2006;40;139;82;57
Rietavas mun.;2006;41;136;60;76
Rietavas mun.;2006;42;132;60;72
Rietavas mun.;2006;43;144;72;72
Rietavas mun.;2006;44;171;84;87
Rietavas mun.;2006;45;137;69;68
Rietavas mun.;2006;46;131;77;54
Rietavas mun.;2006;47;150;87;63
Rietavas mun.;2006;48;126;52;74
Rietavas mun.;2006;49;109;54;55
Rietavas mun.;2006;50;100;51;49
Rietavas mun.;2006;51;112;54;58
Rietavas mun.;2006;52;94;57;37
Rietavas mun.;2006;53;99;46;53
Rietavas mun.;2006;54;98;43;55
Rietavas mun.;2006;55;101;50;51
Rietavas mun.;2006;56;110;52;58
Rietavas mun.;2006;57;74;39;35
Rietavas mun.;2006;58;71;33;38
Rietavas mun.;2006;59;64;24;40
Rietavas mun.;2006;60;72;31;41
Rietavas mun.;2006;61;89;42;47
Rietavas mun.;2006;62;94;40;54
Rietavas mun.;2006;63;92;36;56
Rietavas mun.;2006;64;112;48;64
Rietavas mun.;2006;65;107;47;60
Rietavas mun.;2006;66;98;33;65
Rietavas mun.;2006;67;104;47;57
Rietavas mun.;2006;68;109;46;63
Rietavas mun.;2006;69;114;42;72
Rietavas mun.;2006;70;105;41;64
Rietavas mun.;2006;71;104;30;74
Rietavas mun.;2006;72;106;39;67
Rietavas mun.;2006;73;92;31;61
Rietavas mun.;2006;74;98;45;53
Rietavas mun.;2006;75;78;28;50
Rietavas mun.;2006;76;94;37;57
Rietavas mun.;2006;77;91;36;55
Rietavas mun.;2006;78;70;26;44
Rietavas mun.;2006;79;70;21;49
Rietavas mun.;2006;80;60;20;40
Rietavas mun.;2006;81;45;14;31
Rietavas mun.;2006;82;57;12;45
Rietavas mun.;2006;83;42;16;26
Rietavas mun.;2006;84;39;10;29
Rietavas mun.;2006;85;150;45;105
Rietavas mun.;2007;-1;9660;4562;5098
Rietavas mun.;2007;0;107;55;52
Rietavas mun.;2007;1;82;40;42
Rietavas mun.;2007;2;91;49;42
Rietavas mun.;2007;3;109;54;55
Rietavas mun.;2007;4;90;46;44
Rietavas mun.;2007;5;89;48;41
Rietavas mun.;2007;6;105;49;56
Rietavas mun.;2007;7;103;48;55
Rietavas mun.;2007;8;103;49;54
Rietavas mun.;2007;9;132;67;65
Rietavas mun.;2007;10;123;59;64
Rietavas mun.;2007;11;111;59;52
Rietavas mun.;2007;12;157;73;84
Rietavas mun.;2007;13;146;76;70
Rietavas mun.;2007;14;180;93;87
Rietavas mun.;2007;15;208;100;108
Rietavas mun.;2007;16;185;98;87
Rietavas mun.;2007;17;214;114;100
Rietavas mun.;2007;18;156;92;64
Rietavas mun.;2007;19;190;90;100
Rietavas mun.;2007;20;189;79;110
Rietavas mun.;2007;21;172;89;83
Rietavas mun.;2007;22;158;81;77
Rietavas mun.;2007;23;165;86;79
Rietavas mun.;2007;24;167;95;72
Rietavas mun.;2007;25;169;85;84
Rietavas mun.;2007;26;108;56;52
Rietavas mun.;2007;27;98;49;49
Rietavas mun.;2007;28;97;48;49
Rietavas mun.;2007;29;91;44;47
Rietavas mun.;2007;30;71;42;29
Rietavas mun.;2007;31;96;51;45
Rietavas mun.;2007;32;92;53;39
Rietavas mun.;2007;33;77;46;31
Rietavas mun.;2007;34;92;45;47
Rietavas mun.;2007;35;104;51;53
Rietavas mun.;2007;36;118;57;61
Rietavas mun.;2007;37;123;62;61
Rietavas mun.;2007;38;109;60;49
Rietavas mun.;2007;39;133;62;71
Rietavas mun.;2007;40;131;58;73
Rietavas mun.;2007;41;136;80;56
Rietavas mun.;2007;42;133;59;74
Rietavas mun.;2007;43;126;54;72
Rietavas mun.;2007;44;138;68;70
Rietavas mun.;2007;45;167;82;85
Rietavas mun.;2007;46;133;66;67
Rietavas mun.;2007;47;134;76;58
Rietavas mun.;2007;48;149;84;65
Rietavas mun.;2007;49;124;51;73
Rietavas mun.;2007;50;103;49;54
Rietavas mun.;2007;51;98;50;48
Rietavas mun.;2007;52;111;54;57
Rietavas mun.;2007;53;93;55;38
Rietavas mun.;2007;54;97;45;52
Rietavas mun.;2007;55;97;42;55
Rietavas mun.;2007;56;97;47;50
Rietavas mun.;2007;57;108;51;57
Rietavas mun.;2007;58;73;36;37
Rietavas mun.;2007;59;71;33;38
Rietavas mun.;2007;60;61;23;38
Rietavas mun.;2007;61;72;30;42
Rietavas mun.;2007;62;85;37;48
Rietavas mun.;2007;63;92;38;54
Rietavas mun.;2007;64;90;35;55
Rietavas mun.;2007;65;111;47;64
Rietavas mun.;2007;66;105;44;61
Rietavas mun.;2007;67;95;31;64
Rietavas mun.;2007;68;100;43;57
Rietavas mun.;2007;69;105;45;60
Rietavas mun.;2007;70;110;39;71
Rietavas mun.;2007;71;101;40;61
Rietavas mun.;2007;72;101;30;71
Rietavas mun.;2007;73;97;37;60
Rietavas mun.;2007;74;86;27;59
Rietavas mun.;2007;75;96;44;52
Rietavas mun.;2007;76;74;23;51
Rietavas mun.;2007;77;88;32;56
Rietavas mun.;2007;78;86;32;54
Rietavas mun.;2007;79;64;22;42
Rietavas mun.;2007;80;65;16;49
Rietavas mun.;2007;81;60;20;40
Rietavas mun.;2007;82;42;13;29
Rietavas mun.;2007;83;54;14;40
Rietavas mun.;2007;84;38;13;25
Rietavas mun.;2007;85;153;47;106
Rietavas mun.;2008;-1;9437;4473;4964
Rietavas mun.;2008;0;98;49;49
Rietavas mun.;2008;1;105;55;50
Rietavas mun.;2008;2;79;37;42
Rietavas mun.;2008;3;87;46;41
Rietavas mun.;2008;4;108;54;54
Rietavas mun.;2008;5;85;45;40
Rietavas mun.;2008;6;88;49;39
Rietavas mun.;2008;7;104;50;54
Rietavas mun.;2008;8;102;46;56
Rietavas mun.;2008;9;103;49;54
Rietavas mun.;2008;10;132;67;65
Rietavas mun.;2008;11;123;58;65
Rietavas mun.;2008;12;108;58;50
Rietavas mun.;2008;13;159;74;85
Rietavas mun.;2008;14;149;77;72
Rietavas mun.;2008;15;176;92;84
Rietavas mun.;2008;16;203;96;107
Rietavas mun.;2008;17;183;99;84
Rietavas mun.;2008;18;210;110;100
Rietavas mun.;2008;19;151;90;61
Rietavas mun.;2008;20;185;89;96
Rietavas mun.;2008;21;177;75;102
Rietavas mun.;2008;22;167;87;80
Rietavas mun.;2008;23;154;80;74
Rietavas mun.;2008;24;156;82;74
Rietavas mun.;2008;25;158;91;67
Rietavas mun.;2008;26;162;82;80
Rietavas mun.;2008;27;99;52;47
Rietavas mun.;2008;28;87;44;43
Rietavas mun.;2008;29;90;47;43
Rietavas mun.;2008;30;88;44;44
Rietavas mun.;2008;31;65;38;27
Rietavas mun.;2008;32;96;52;44
Rietavas mun.;2008;33;84;47;37
Rietavas mun.;2008;34;69;41;28
Rietavas mun.;2008;35;90;47;43
Rietavas mun.;2008;36;100;49;51
Rietavas mun.;2008;37;115;57;58
Rietavas mun.;2008;38;114;57;57
Rietavas mun.;2008;39;110;59;51
Rietavas mun.;2008;40;132;63;69
Rietavas mun.;2008;41;129;57;72
Rietavas mun.;2008;42;132;78;54
Rietavas mun.;2008;43;129;56;73
Rietavas mun.;2008;44;124;53;71
Rietavas mun.;2008;45;137;68;69
Rietavas mun.;2008;46;166;81;85
Rietavas mun.;2008;47;132;65;67
Rietavas mun.;2008;48;131;72;59
Rietavas mun.;2008;49;151;86;65
Rietavas mun.;2008;50;121;49;72
Rietavas mun.;2008;51;102;48;54
Rietavas mun.;2008;52;99;52;47
Rietavas mun.;2008;53;107;53;54
Rietavas mun.;2008;54;90;53;37
Rietavas mun.;2008;55;92;43;49
Rietavas mun.;2008;56;97;43;54
Rietavas mun.;2008;57;95;45;50
Rietavas mun.;2008;58;102;46;56
Rietavas mun.;2008;59;73;36;37
Rietavas mun.;2008;60;69;31;38
Rietavas mun.;2008;61;60;22;38
Rietavas mun.;2008;62;71;29;42
Rietavas mun.;2008;63;81;34;47
Rietavas mun.;2008;64;90;38;52
Rietavas mun.;2008;65;86;31;55
Rietavas mun.;2008;66;106;43;63
Rietavas mun.;2008;67;104;44;60
Rietavas mun.;2008;68;90;28;62
Rietavas mun.;2008;69;97;41;56
Rietavas mun.;2008;70;100;43;57
Rietavas mun.;2008;71;106;38;68
Rietavas mun.;2008;72;97;38;59
Rietavas mun.;2008;73;93;28;65
Rietavas mun.;2008;74;96;35;61
Rietavas mun.;2008;75;79;26;53
Rietavas mun.;2008;76;93;42;51
Rietavas mun.;2008;77;73;22;51
Rietavas mun.;2008;78;84;31;53
Rietavas mun.;2008;79;81;30;51
Rietavas mun.;2008;80;60;22;38
Rietavas mun.;2008;81;63;15;48
Rietavas mun.;2008;82;59;19;40
Rietavas mun.;2008;83;38;13;25
Rietavas mun.;2008;84;47;11;36
Rietavas mun.;2008;85;154;51;103
Rietavas mun.;2009;-1;9205;4409;4796
Rietavas mun.;2009;0;97;55;42
Rietavas mun.;2009;1;94;48;46
Rietavas mun.;2009;2;106;56;50
Rietavas mun.;2009;3;76;35;41
Rietavas mun.;2009;4;80;43;37
Rietavas mun.;2009;5;106;54;52
Rietavas mun.;2009;6;82;43;39
Rietavas mun.;2009;7;85;47;38
Rietavas mun.;2009;8;103;52;51
Rietavas mun.;2009;9;96;44;52
Rietavas mun.;2009;10;99;46;53
Rietavas mun.;2009;11;129;65;64
Rietavas mun.;2009;12;123;57;66
Rietavas mun.;2009;13;107;58;49
Rietavas mun.;2009;14;158;72;86
Rietavas mun.;2009;15;142;73;69
Rietavas mun.;2009;16;176;92;84
Rietavas mun.;2009;17;198;94;104
Rietavas mun.;2009;18;175;97;78
Rietavas mun.;2009;19;211;113;98
Rietavas mun.;2009;20;148;89;59
Rietavas mun.;2009;21;181;85;96
Rietavas mun.;2009;22;173;73;100
Rietavas mun.;2009;23;159;86;73
Rietavas mun.;2009;24;147;76;71
Rietavas mun.;2009;25;152;81;71
Rietavas mun.;2009;26;151;87;64
Rietavas mun.;2009;27;160;80;80
Rietavas mun.;2009;28;94;48;46
Rietavas mun.;2009;29;81;42;39
Rietavas mun.;2009;30;88;48;40
Rietavas mun.;2009;31;80;41;39
Rietavas mun.;2009;32;62;38;24
Rietavas mun.;2009;33;87;47;40
Rietavas mun.;2009;34;79;46;33
Rietavas mun.;2009;35;65;39;26
Rietavas mun.;2009;36;87;46;41
Rietavas mun.;2009;37;95;46;49
Rietavas mun.;2009;38;115;57;58
Rietavas mun.;2009;39;112;55;57
Rietavas mun.;2009;40;107;58;49
Rietavas mun.;2009;41;130;62;68
Rietavas mun.;2009;42;128;56;72
Rietavas mun.;2009;43;128;77;51
Rietavas mun.;2009;44;126;57;69
Rietavas mun.;2009;45;123;54;69
Rietavas mun.;2009;46;134;67;67
Rietavas mun.;2009;47;161;79;82
Rietavas mun.;2009;48;128;64;64
Rietavas mun.;2009;49;130;71;59
Rietavas mun.;2009;50;149;85;64
Rietavas mun.;2009;51;119;49;70
Rietavas mun.;2009;52;101;48;53
Rietavas mun.;2009;53;97;51;46
Rietavas mun.;2009;54;105;51;54
Rietavas mun.;2009;55;85;49;36
Rietavas mun.;2009;56;88;41;47
Rietavas mun.;2009;57;93;42;51
Rietavas mun.;2009;58;93;45;48
Rietavas mun.;2009;59;100;46;54
Rietavas mun.;2009;60;69;34;35
Rietavas mun.;2009;61;67;29;38
Rietavas mun.;2009;62;57;21;36
Rietavas mun.;2009;63;68;29;39
Rietavas mun.;2009;64;79;34;45
Rietavas mun.;2009;65;91;39;52
Rietavas mun.;2009;66;83;31;52
Rietavas mun.;2009;67;104;44;60
Rietavas mun.;2009;68;103;43;60
Rietavas mun.;2009;69;89;28;61
Rietavas mun.;2009;70;88;37;51
Rietavas mun.;2009;71;96;42;54
Rietavas mun.;2009;72;103;36;67
Rietavas mun.;2009;73;92;36;56
Rietavas mun.;2009;74;90;27;63
Rietavas mun.;2009;75;87;31;56
Rietavas mun.;2009;76;73;26;47
Rietavas mun.;2009;77;87;40;47
Rietavas mun.;2009;78;71;22;49
Rietavas mun.;2009;79;75;28;47
Rietavas mun.;2009;80;76;29;47
Rietavas mun.;2009;81;56;22;34
Rietavas mun.;2009;82;54;14;40
Rietavas mun.;2009;83;53;17;36
Rietavas mun.;2009;84;34;10;24
Rietavas mun.;2009;85;176;54;122
Rietavas mun.;2010;-1;8981;4307;4674
Rietavas mun.;2010;0;78;38;40
Rietavas mun.;2010;1;95;54;41
Rietavas mun.;2010;2;91;45;46
Rietavas mun.;2010;3;101;53;48
Rietavas mun.;2010;4;80;38;42
Rietavas mun.;2010;5;77;41;36
Rietavas mun.;2010;6;101;50;51
Rietavas mun.;2010;7;83;45;38
Rietavas mun.;2010;8;80;46;34
Rietavas mun.;2010;9;102;50;52
Rietavas mun.;2010;10;97;45;52
Rietavas mun.;2010;11;96;45;51
Rietavas mun.;2010;12;126;64;62
Rietavas mun.;2010;13;119;57;62
Rietavas mun.;2010;14;108;59;49
Rietavas mun.;2010;15;156;70;86
Rietavas mun.;2010;16;139;70;69
Rietavas mun.;2010;17;178;93;85
Rietavas mun.;2010;18;195;94;101
Rietavas mun.;2010;19;171;95;76
Rietavas mun.;2010;20;204;111;93
Rietavas mun.;2010;21;141;86;55
Rietavas mun.;2010;22;177;84;93
Rietavas mun.;2010;23;164;69;95
Rietavas mun.;2010;24;148;83;65
Rietavas mun.;2010;25;139;70;69
Rietavas mun.;2010;26;148;78;70
Rietavas mun.;2010;27;141;82;59
Rietavas mun.;2010;28;149;73;76
Rietavas mun.;2010;29;87;45;42
Rietavas mun.;2010;30;76;39;37
Rietavas mun.;2010;31;84;45;39
Rietavas mun.;2010;32;76;39;37
Rietavas mun.;2010;33;55;33;22
Rietavas mun.;2010;34;82;45;37
Rietavas mun.;2010;35;75;44;31
Rietavas mun.;2010;36;61;37;24
Rietavas mun.;2010;37;86;45;41
Rietavas mun.;2010;38;91;44;47
Rietavas mun.;2010;39;113;57;56
Rietavas mun.;2010;40;107;51;56
Rietavas mun.;2010;41;104;55;49
Rietavas mun.;2010;42;128;61;67
Rietavas mun.;2010;43;126;54;72
Rietavas mun.;2010;44;126;76;50
Rietavas mun.;2010;45;125;57;68
Rietavas mun.;2010;46;121;53;68
Rietavas mun.;2010;47;132;67;65
Rietavas mun.;2010;48;154;76;78
Rietavas mun.;2010;49;123;61;62
Rietavas mun.;2010;50;129;71;58
Rietavas mun.;2010;51;149;85;64
Rietavas mun.;2010;52;121;50;71
Rietavas mun.;2010;53;100;48;52
Rietavas mun.;2010;54;97;52;45
Rietavas mun.;2010;55;102;51;51
Rietavas mun.;2010;56;83;48;35
Rietavas mun.;2010;57;87;39;48
Rietavas mun.;2010;58;90;37;53
Rietavas mun.;2010;59;91;43;48
Rietavas mun.;2010;60;97;44;53
Rietavas mun.;2010;61;67;32;35
Rietavas mun.;2010;62;67;29;38
Rietavas mun.;2010;63;58;22;36
Rietavas mun.;2010;64;65;26;39
Rietavas mun.;2010;65;75;31;44
Rietavas mun.;2010;66;90;39;51
Rietavas mun.;2010;67;85;32;53
Rietavas mun.;2010;68;100;40;60
Rietavas mun.;2010;69;102;42;60
Rietavas mun.;2010;70;83;24;59
Rietavas mun.;2010;71;85;35;50
Rietavas mun.;2010;72;93;41;52
Rietavas mun.;2010;73;101;36;65
Rietavas mun.;2010;74;87;35;52
Rietavas mun.;2010;75;91;26;65
Rietavas mun.;2010;76;83;29;54
Rietavas mun.;2010;77;66;23;43
Rietavas mun.;2010;78;80;37;43
Rietavas mun.;2010;79;63;20;43
Rietavas mun.;2010;80;73;27;46
Rietavas mun.;2010;81;67;27;40
Rietavas mun.;2010;82;51;22;29
Rietavas mun.;2010;83;51;14;37
Rietavas mun.;2010;84;50;16;34
Rietavas mun.;2010;85;186;62;124
Rietavas mun.;2011;-1;8717;4175;4542
Rietavas mun.;2011;0;64;37;27
Rietavas mun.;2011;1;67;34;33
Rietavas mun.;2011;2;82;50;32
Rietavas mun.;2011;3;82;42;40
Rietavas mun.;2011;4;77;33;44
Rietavas mun.;2011;5;72;34;38
Rietavas mun.;2011;6;72;38;34
Rietavas mun.;2011;7;91;48;43
Rietavas mun.;2011;8;86;46;40
Rietavas mun.;2011;9;82;40;42
Rietavas mun.;2011;10;114;52;62
Rietavas mun.;2011;11;102;51;51
Rietavas mun.;2011;12;105;49;56
Rietavas mun.;2011;13;128;66;62
Rietavas mun.;2011;14;120;57;63
Rietavas mun.;2011;15;115;63;52
Rietavas mun.;2011;16;162;81;81
Rietavas mun.;2011;17;153;77;76
Rietavas mun.;2011;18;175;90;85
Rietavas mun.;2011;19;179;90;89
Rietavas mun.;2011;20;163;95;68
Rietavas mun.;2011;21;193;110;83
Rietavas mun.;2011;22;127;78;49
Rietavas mun.;2011;23;135;74;61
Rietavas mun.;2011;24;126;55;71
Rietavas mun.;2011;25;111;67;44
Rietavas mun.;2011;26;86;50;36
Rietavas mun.;2011;27;97;53;44
Rietavas mun.;2011;28;71;38;33
Rietavas mun.;2011;29;82;42;40
Rietavas mun.;2011;30;85;44;41
Rietavas mun.;2011;31;78;41;37
Rietavas mun.;2011;32;101;51;50
Rietavas mun.;2011;33;75;35;40
Rietavas mun.;2011;34;76;39;37
Rietavas mun.;2011;35;102;45;57
Rietavas mun.;2011;36;98;54;44
Rietavas mun.;2011;37;89;54;35
Rietavas mun.;2011;38;109;60;49
Rietavas mun.;2011;39;112;58;54
Rietavas mun.;2011;40;122;65;57
Rietavas mun.;2011;41;112;50;62
Rietavas mun.;2011;42;115;56;59
Rietavas mun.;2011;43;132;67;65
Rietavas mun.;2011;44;128;56;72
Rietavas mun.;2011;45;141;85;56
Rietavas mun.;2011;46;135;64;71
Rietavas mun.;2011;47;130;58;72
Rietavas mun.;2011;48;134;68;66
Rietavas mun.;2011;49;163;75;88
Rietavas mun.;2011;50;125;61;64
Rietavas mun.;2011;51;132;67;65
Rietavas mun.;2011;52;151;83;68
Rietavas mun.;2011;53;127;52;75
Rietavas mun.;2011;54;104;50;54
Rietavas mun.;2011;55;100;52;48
Rietavas mun.;2011;56;102;47;55
Rietavas mun.;2011;57;86;49;37
Rietavas mun.;2011;58;94;43;51
Rietavas mun.;2011;59;92;41;51
Rietavas mun.;2011;60;84;37;47
Rietavas mun.;2011;61;95;43;52
Rietavas mun.;2011;62;68;34;34
Rietavas mun.;2011;63;62;25;37
Rietavas mun.;2011;64;61;23;38
Rietavas mun.;2011;65;64;26;38
Rietavas mun.;2011;66;77;31;46
Rietavas mun.;2011;67;83;33;50
Rietavas mun.;2011;68;85;30;55
Rietavas mun.;2011;69;98;40;58
Rietavas mun.;2011;70;96;35;61
Rietavas mun.;2011;71;79;24;55
Rietavas mun.;2011;72;81;29;52
Rietavas mun.;2011;73;93;39;54
Rietavas mun.;2011;74;93;32;61
Rietavas mun.;2011;75;80;34;46
Rietavas mun.;2011;76;88;25;63
Rietavas mun.;2011;77;71;26;45
Rietavas mun.;2011;78;58;18;40
Rietavas mun.;2011;79;77;35;42
Rietavas mun.;2011;80;55;15;40
Rietavas mun.;2011;81;69;26;43
Rietavas mun.;2011;82;66;21;45
Rietavas mun.;2011;83;46;20;26
Rietavas mun.;2011;84;43;11;32
Rietavas mun.;2011;85;176;53;123
Rietavas mun.;2012;-1;8537;4111;4426
Rietavas mun.;2012;0;93;52;41
Rietavas mun.;2012;1;65;38;27
Rietavas mun.;2012;2;67;35;32
Rietavas mun.;2012;3;74;46;28
Rietavas mun.;2012;4;80;41;39
Rietavas mun.;2012;5;77;33;44
Rietavas mun.;2012;6;67;31;36
Rietavas mun.;2012;7;72;39;33
Rietavas mun.;2012;8;91;47;44
Rietavas mun.;2012;9;87;47;40
Rietavas mun.;2012;10;83;39;44
Rietavas mun.;2012;11;116;54;62
Rietavas mun.;2012;12;104;53;51
Rietavas mun.;2012;13;106;51;55
Rietavas mun.;2012;14;128;65;63
Rietavas mun.;2012;15;119;56;63
Rietavas mun.;2012;16;115;63;52
Rietavas mun.;2012;17;162;81;81
Rietavas mun.;2012;18;151;76;75
Rietavas mun.;2012;19;168;87;81
Rietavas mun.;2012;20;174;88;86
Rietavas mun.;2012;21;160;96;64
Rietavas mun.;2012;22;190;108;82
Rietavas mun.;2012;23;121;76;45
Rietavas mun.;2012;24;128;72;56
Rietavas mun.;2012;25;110;55;55
Rietavas mun.;2012;26;100;61;39
Rietavas mun.;2012;27;77;46;31
Rietavas mun.;2012;28;84;46;38
Rietavas mun.;2012;29;62;29;33
Rietavas mun.;2012;30;78;42;36
Rietavas mun.;2012;31;79;40;39
Rietavas mun.;2012;32;75;41;34
Rietavas mun.;2012;33;96;48;48
Rietavas mun.;2012;34;72;33;39
Rietavas mun.;2012;35;76;38;38
Rietavas mun.;2012;36;99;43;56
Rietavas mun.;2012;37;96;54;42
Rietavas mun.;2012;38;90;56;34
Rietavas mun.;2012;39;108;60;48
Rietavas mun.;2012;40;109;57;52
Rietavas mun.;2012;41;118;63;55
Rietavas mun.;2012;42;105;44;61
Rietavas mun.;2012;43;116;57;59
Rietavas mun.;2012;44;130;66;64
Rietavas mun.;2012;45;121;53;68
Rietavas mun.;2012;46;140;85;55
Rietavas mun.;2012;47;134;63;71
Rietavas mun.;2012;48;129;57;72
Rietavas mun.;2012;49;134;68;66
Rietavas mun.;2012;50;160;72;88
Rietavas mun.;2012;51;121;60;61
Rietavas mun.;2012;52;132;67;65
Rietavas mun.;2012;53;150;83;67
Rietavas mun.;2012;54;125;52;73
Rietavas mun.;2012;55;102;49;53
Rietavas mun.;2012;56;98;51;47
Rietavas mun.;2012;57;102;47;55
Rietavas mun.;2012;58;83;46;37
Rietavas mun.;2012;59;92;43;49
Rietavas mun.;2012;60;94;41;53
Rietavas mun.;2012;61;83;36;47
Rietavas mun.;2012;62;91;41;50
Rietavas mun.;2012;63;68;34;34
Rietavas mun.;2012;64;61;24;37
Rietavas mun.;2012;65;61;23;38
Rietavas mun.;2012;66;63;25;38
Rietavas mun.;2012;67;74;29;45
Rietavas mun.;2012;68;83;33;50
Rietavas mun.;2012;69;86;30;56
Rietavas mun.;2012;70;95;39;56
Rietavas mun.;2012;71;93;34;59
Rietavas mun.;2012;72;78;22;56
Rietavas mun.;2012;73;76;27;49
Rietavas mun.;2012;74;91;37;54
Rietavas mun.;2012;75;90;30;60
Rietavas mun.;2012;76;78;32;46
Rietavas mun.;2012;77;83;23;60
Rietavas mun.;2012;78;67;25;42
Rietavas mun.;2012;79;56;18;38
Rietavas mun.;2012;80;73;33;40
Rietavas mun.;2012;81;51;14;37
Rietavas mun.;2012;82;61;23;38
Rietavas mun.;2012;83;63;20;43
Rietavas mun.;2012;84;43;17;26
Rietavas mun.;2012;85;174;52;122
Rietavas mun.;2013;-1;8399;4051;4348
Rietavas mun.;2013;0;105;53;52
Rietavas mun.;2013;1;95;51;44
Rietavas mun.;2013;2;66;38;28
Rietavas mun.;2013;3;63;34;29
Rietavas mun.;2013;4;77;47;30
Rietavas mun.;2013;5;79;41;38
Rietavas mun.;2013;6;76;34;42
Rietavas mun.;2013;7;67;30;37
Rietavas mun.;2013;8;71;37;34
Rietavas mun.;2013;9;89;48;41
Rietavas mun.;2013;10;87;46;41
Rietavas mun.;2013;11;80;38;42
Rietavas mun.;2013;12;112;50;62
Rietavas mun.;2013;13;103;52;51
Rietavas mun.;2013;14;104;50;54
Rietavas mun.;2013;15;126;65;61
Rietavas mun.;2013;16;117;55;62
Rietavas mun.;2013;17;114;63;51
Rietavas mun.;2013;18;159;80;79
Rietavas mun.;2013;19;146;75;71
Rietavas mun.;2013;20;165;87;78
Rietavas mun.;2013;21;172;84;88
Rietavas mun.;2013;22;158;95;63
Rietavas mun.;2013;23;183;102;81
Rietavas mun.;2013;24;118;76;42
Rietavas mun.;2013;25;126;73;53
Rietavas mun.;2013;26;103;54;49
Rietavas mun.;2013;27;97;61;36
Rietavas mun.;2013;28;71;41;30
Rietavas mun.;2013;29;78;42;36
Rietavas mun.;2013;30;60;27;33
Rietavas mun.;2013;31;73;42;31
Rietavas mun.;2013;32;74;39;35
Rietavas mun.;2013;33;72;39;33
Rietavas mun.;2013;34;96;50;46
Rietavas mun.;2013;35;72;33;39
Rietavas mun.;2013;36;73;37;36
Rietavas mun.;2013;37;95;43;52
Rietavas mun.;2013;38;93;53;40
Rietavas mun.;2013;39;85;53;32
Rietavas mun.;2013;40;103;58;45
Rietavas mun.;2013;41;107;55;52
Rietavas mun.;2013;42;118;63;55
Rietavas mun.;2013;43;108;44;64
Rietavas mun.;2013;44;118;58;60
Rietavas mun.;2013;45;128;66;62
Rietavas mun.;2013;46;120;52;68
Rietavas mun.;2013;47;137;82;55
Rietavas mun.;2013;48;133;63;70
Rietavas mun.;2013;49;128;56;72
Rietavas mun.;2013;50;136;70;66
Rietavas mun.;2013;51;159;71;88
Rietavas mun.;2013;52;119;58;61
Rietavas mun.;2013;53;131;66;65
Rietavas mun.;2013;54;148;80;68
Rietavas mun.;2013;55;122;50;72
Rietavas mun.;2013;56;101;49;52
Rietavas mun.;2013;57;99;52;47
Rietavas mun.;2013;58;98;46;52
Rietavas mun.;2013;59;80;44;36
Rietavas mun.;2013;60;94;45;49
Rietavas mun.;2013;61;93;40;53
Rietavas mun.;2013;62;81;35;46
Rietavas mun.;2013;63;86;38;48
Rietavas mun.;2013;64;68;35;33
Rietavas mun.;2013;65;60;24;36
Rietavas mun.;2013;66;57;20;37
Rietavas mun.;2013;67;63;25;38
Rietavas mun.;2013;68;73;28;45
Rietavas mun.;2013;69;81;32;49
Rietavas mun.;2013;70;82;27;55
Rietavas mun.;2013;71;90;38;52
Rietavas mun.;2013;72;90;32;58
Rietavas mun.;2013;73;76;22;54
Rietavas mun.;2013;74;76;27;49
Rietavas mun.;2013;75;89;37;52
Rietavas mun.;2013;76;82;24;58
Rietavas mun.;2013;77;74;30;44
Rietavas mun.;2013;78;80;21;59
Rietavas mun.;2013;79;56;19;37
Rietavas mun.;2013;80;50;16;34
Rietavas mun.;2013;81;68;28;40
Rietavas mun.;2013;82;48;13;35
Rietavas mun.;2013;83;54;19;35
Rietavas mun.;2013;84;58;16;42
Rietavas mun.;2013;85;177;59;118
Rietavas mun.;2014;-1;8255;3979;4276
Rietavas mun.;2014;0;95;49;46
Rietavas mun.;2014;1;105;54;51
Rietavas mun.;2014;2;89;49;40
Rietavas mun.;2014;3;64;37;27
Rietavas mun.;2014;4;66;35;31
Rietavas mun.;2014;5;75;45;30
Rietavas mun.;2014;6;74;39;35
Rietavas mun.;2014;7;73;32;41
Rietavas mun.;2014;8;66;29;37
Rietavas mun.;2014;9;72;37;35
Rietavas mun.;2014;10;84;44;40
Rietavas mun.;2014;11;84;44;40
Rietavas mun.;2014;12;77;36;41
Rietavas mun.;2014;13;108;49;59
Rietavas mun.;2014;14;103;53;50
Rietavas mun.;2014;15;101;48;53
Rietavas mun.;2014;16;124;65;59
Rietavas mun.;2014;17;116;55;61
Rietavas mun.;2014;18;114;63;51
Rietavas mun.;2014;19;158;80;78
Rietavas mun.;2014;20;145;76;69
Rietavas mun.;2014;21;169;87;82
Rietavas mun.;2014;22;165;83;82
Rietavas mun.;2014;23;153;92;61
Rietavas mun.;2014;24;172;97;75
Rietavas mun.;2014;25;115;72;43
Rietavas mun.;2014;26;125;77;48
Rietavas mun.;2014;27;93;49;44
Rietavas mun.;2014;28;93;61;32
Rietavas mun.;2014;29;61;34;27
Rietavas mun.;2014;30;73;40;33
Rietavas mun.;2014;31;53;23;30
Rietavas mun.;2014;32;64;38;26
Rietavas mun.;2014;33;73;40;33
Rietavas mun.;2014;34;69;37;32
Rietavas mun.;2014;35;96;51;45
Rietavas mun.;2014;36;70;33;37
Rietavas mun.;2014;37;76;41;35
Rietavas mun.;2014;38;95;43;52
Rietavas mun.;2014;39;92;54;38
Rietavas mun.;2014;40;87;54;33
Rietavas mun.;2014;41;102;57;45
Rietavas mun.;2014;42;108;55;53
Rietavas mun.;2014;43;119;64;55
Rietavas mun.;2014;44;106;44;62
Rietavas mun.;2014;45;115;55;60
Rietavas mun.;2014;46;127;64;63
Rietavas mun.;2014;47;118;52;66
Rietavas mun.;2014;48;137;83;54
Rietavas mun.;2014;49;133;63;70
Rietavas mun.;2014;50;130;57;73
Rietavas mun.;2014;51;135;69;66
Rietavas mun.;2014;52;156;68;88
Rietavas mun.;2014;53;117;56;61
Rietavas mun.;2014;54;128;65;63
Rietavas mun.;2014;55;146;80;66
Rietavas mun.;2014;56;119;48;71
Rietavas mun.;2014;57;102;48;54
Rietavas mun.;2014;58;98;52;46
Rietavas mun.;2014;59;94;43;51
Rietavas mun.;2014;60;78;42;36
Rietavas mun.;2014;61;93;46;47
Rietavas mun.;2014;62;89;37;52
Rietavas mun.;2014;63;80;34;46
Rietavas mun.;2014;64;84;36;48
Rietavas mun.;2014;65;66;33;33
Rietavas mun.;2014;66;59;24;35
Rietavas mun.;2014;67;55;18;37
Rietavas mun.;2014;68;62;23;39
Rietavas mun.;2014;69;71;26;45
Rietavas mun.;2014;70;80;31;49
Rietavas mun.;2014;71;80;25;55
Rietavas mun.;2014;72;87;35;52
Rietavas mun.;2014;73;87;30;57
Rietavas mun.;2014;74;75;21;54
Rietavas mun.;2014;75;71;23;48
Rietavas mun.;2014;76;86;36;50
Rietavas mun.;2014;77;79;25;54
Rietavas mun.;2014;78;71;29;42
Rietavas mun.;2014;79;72;18;54
Rietavas mun.;2014;80;55;18;37
Rietavas mun.;2014;81;46;13;33
Rietavas mun.;2014;82;62;23;39
Rietavas mun.;2014;83;43;10;33
Rietavas mun.;2014;84;46;15;31
Rietavas mun.;2014;85;201;60;141
Rietavas mun.;2015;-1;8096;3909;4187
Rietavas mun.;2015;0;77;41;36
Rietavas mun.;2015;1;93;48;45
Rietavas mun.;2015;2;101;52;49
Rietavas mun.;2015;3;88;50;38
Rietavas mun.;2015;4;61;34;27
Rietavas mun.;2015;5;64;33;31
Rietavas mun.;2015;6;77;46;31
Rietavas mun.;2015;7;69;34;35
Rietavas mun.;2015;8;70;31;39
Rietavas mun.;2015;9;70;30;40
Rietavas mun.;2015;10;69;36;33
Rietavas mun.;2015;11;83;43;40
Rietavas mun.;2015;12;80;42;38
Rietavas mun.;2015;13;76;34;42
Rietavas mun.;2015;14;110;50;60
Rietavas mun.;2015;15;105;53;52
Rietavas mun.;2015;16;99;46;53
Rietavas mun.;2015;17;122;64;58
Rietavas mun.;2015;18;116;55;61
Rietavas mun.;2015;19;111;62;49
Rietavas mun.;2015;20;155;77;78
Rietavas mun.;2015;21;144;78;66
Rietavas mun.;2015;22;163;85;78
Rietavas mun.;2015;23;159;82;77
Rietavas mun.;2015;24;147;91;56
Rietavas mun.;2015;25;166;98;68
Rietavas mun.;2015;26;113;71;42
Rietavas mun.;2015;27;109;69;40
Rietavas mun.;2015;28;86;46;40
Rietavas mun.;2015;29;93;60;33
Rietavas mun.;2015;30;57;35;22
Rietavas mun.;2015;31;80;42;38
Rietavas mun.;2015;32;53;24;29
Rietavas mun.;2015;33;64;40;24
Rietavas mun.;2015;34;71;40;31
Rietavas mun.;2015;35;65;33;32
Rietavas mun.;2015;36;92;50;42
Rietavas mun.;2015;37;68;32;36
Rietavas mun.;2015;38;76;40;36
Rietavas mun.;2015;39;93;42;51
Rietavas mun.;2015;40;90;53;37
Rietavas mun.;2015;41;84;54;30
Rietavas mun.;2015;42;102;57;45
Rietavas mun.;2015;43;106;53;53
Rietavas mun.;2015;44;119;65;54
Rietavas mun.;2015;45;103;43;60
Rietavas mun.;2015;46;114;54;60
Rietavas mun.;2015;47;130;66;64
Rietavas mun.;2015;48;120;54;66
Rietavas mun.;2015;49;139;84;55
Rietavas mun.;2015;50;132;63;69
Rietavas mun.;2015;51;127;57;70
Rietavas mun.;2015;52;134;68;66
Rietavas mun.;2015;53;157;68;89
Rietavas mun.;2015;54;114;54;60
Rietavas mun.;2015;55;124;61;63
Rietavas mun.;2015;56;144;78;66
Rietavas mun.;2015;57;115;47;68
Rietavas mun.;2015;58;102;48;54
Rietavas mun.;2015;59;97;50;47
Rietavas mun.;2015;60;91;41;50
Rietavas mun.;2015;61;80;42;38
Rietavas mun.;2015;62;90;42;48
Rietavas mun.;2015;63;87;37;50
Rietavas mun.;2015;64;74;29;45
Rietavas mun.;2015;65;84;36;48
Rietavas mun.;2015;66;63;31;32
Rietavas mun.;2015;67;57;22;35
Rietavas mun.;2015;68;53;17;36
Rietavas mun.;2015;69;58;22;36
Rietavas mun.;2015;70;71;27;44
Rietavas mun.;2015;71;79;30;49
Rietavas mun.;2015;72;77;24;53
Rietavas mun.;2015;73;83;33;50
Rietavas mun.;2015;74;86;29;57
Rietavas mun.;2015;75;72;20;52
Rietavas mun.;2015;76;66;19;47
Rietavas mun.;2015;77;83;33;50
Rietavas mun.;2015;78;72;23;49
Rietavas mun.;2015;79;64;26;38
Rietavas mun.;2015;80;69;16;53
Rietavas mun.;2015;81;50;17;33
Rietavas mun.;2015;82;44;12;32
Rietavas mun.;2015;83;54;21;33
Rietavas mun.;2015;84;40;9;31
Rietavas mun.;2015;85;201;55;146
Rietavas mun.;2016;-1;7947;3837;4110
Rietavas mun.;2016;0;89;47;42
Rietavas mun.;2016;1;77;39;38
Rietavas mun.;2016;2;90;47;43
Rietavas mun.;2016;3;100;50;50
Rietavas mun.;2016;4;82;45;37
Rietavas mun.;2016;5;62;37;25
Rietavas mun.;2016;6;61;34;27
Rietavas mun.;2016;7;77;48;29
Rietavas mun.;2016;8;69;36;33
Rietavas mun.;2016;9;69;29;40
Rietavas mun.;2016;10;69;30;39
Rietavas mun.;2016;11;64;32;32
Rietavas mun.;2016;12;82;43;39
Rietavas mun.;2016;13;77;42;35
Rietavas mun.;2016;14;77;35;42
Rietavas mun.;2016;15;109;50;59
Rietavas mun.;2016;16;104;53;51
Rietavas mun.;2016;17;100;46;54
Rietavas mun.;2016;18;122;64;58
Rietavas mun.;2016;19;114;54;60
Rietavas mun.;2016;20;110;62;48
Rietavas mun.;2016;21;148;74;74
Rietavas mun.;2016;22;144;76;68
Rietavas mun.;2016;23;161;80;81
Rietavas mun.;2016;24;149;75;74
Rietavas mun.;2016;25;133;84;49
Rietavas mun.;2016;26;158;95;63
Rietavas mun.;2016;27;108;69;39
Rietavas mun.;2016;28;103;69;34
Rietavas mun.;2016;29;81;43;38
Rietavas mun.;2016;30;85;58;27
Rietavas mun.;2016;31;48;31;17
Rietavas mun.;2016;32;72;39;33
Rietavas mun.;2016;33;54;24;30
Rietavas mun.;2016;34;60;37;23
Rietavas mun.;2016;35;71;41;30
Rietavas mun.;2016;36;68;35;33
Rietavas mun.;2016;37;88;48;40
Rietavas mun.;2016;38;67;32;35
Rietavas mun.;2016;39;70;36;34
Rietavas mun.;2016;40;92;41;51
Rietavas mun.;2016;41;90;52;38
Rietavas mun.;2016;42;87;55;32
Rietavas mun.;2016;43;101;55;46
Rietavas mun.;2016;44;105;52;53
Rietavas mun.;2016;45;121;65;56
Rietavas mun.;2016;46;101;43;58
Rietavas mun.;2016;47;112;53;59
Rietavas mun.;2016;48;129;63;66
Rietavas mun.;2016;49;124;58;66
Rietavas mun.;2016;50;137;82;55
Rietavas mun.;2016;51;127;59;68
Rietavas mun.;2016;52;126;56;70
Rietavas mun.;2016;53;134;69;65
Rietavas mun.;2016;54;154;65;89
Rietavas mun.;2016;55;111;50;61
Rietavas mun.;2016;56;122;60;62
Rietavas mun.;2016;57;141;78;63
Rietavas mun.;2016;58;114;44;70
Rietavas mun.;2016;59;99;47;52
Rietavas mun.;2016;60;95;49;46
Rietavas mun.;2016;61;90;40;50
Rietavas mun.;2016;62;81;43;38
Rietavas mun.;2016;63;89;40;49
Rietavas mun.;2016;64;83;35;48
Rietavas mun.;2016;65;71;27;44
Rietavas mun.;2016;66;87;37;50
Rietavas mun.;2016;67;63;31;32
Rietavas mun.;2016;68;55;20;35
Rietavas mun.;2016;69;54;16;38
Rietavas mun.;2016;70;58;21;37
Rietavas mun.;2016;71;70;26;44
Rietavas mun.;2016;72;77;29;48
Rietavas mun.;2016;73;72;22;50
Rietavas mun.;2016;74;81;32;49
Rietavas mun.;2016;75;81;26;55
Rietavas mun.;2016;76;69;20;49
Rietavas mun.;2016;77;61;16;45
Rietavas mun.;2016;78;82;32;50
Rietavas mun.;2016;79;69;22;47
Rietavas mun.;2016;80;62;26;36
Rietavas mun.;2016;81;62;14;48
Rietavas mun.;2016;82;48;16;32
Rietavas mun.;2016;83;40;10;30
Rietavas mun.;2016;84;45;19;26
Rietavas mun.;2016;85;203;52;151
Rietavas mun.;2017;-1;7727;3735;3992
Rietavas mun.;2017;0;77;38;39
Rietavas mun.;2017;1;88;46;42
Rietavas mun.;2017;2;69;39;30
Rietavas mun.;2017;3;89;45;44
Rietavas mun.;2017;4;94;46;48
Rietavas mun.;2017;5;76;41;35
Rietavas mun.;2017;6;65;40;25
Rietavas mun.;2017;7;58;33;25
Rietavas mun.;2017;8;78;49;29
Rietavas mun.;2017;9;66;32;34
Rietavas mun.;2017;10;67;26;41
Rietavas mun.;2017;11;68;28;40
Rietavas mun.;2017;12;65;34;31
Rietavas mun.;2017;13;84;42;42
Rietavas mun.;2017;14;81;45;36
Rietavas mun.;2017;15;78;35;43
Rietavas mun.;2017;16;110;51;59
Rietavas mun.;2017;17;103;53;50
Rietavas mun.;2017;18;99;45;54
Rietavas mun.;2017;19;119;64;55
Rietavas mun.;2017;20;111;53;58
Rietavas mun.;2017;21;108;61;47
Rietavas mun.;2017;22;144;73;71
Rietavas mun.;2017;23;139;73;66
Rietavas mun.;2017;24;151;78;73
Rietavas mun.;2017;25;129;69;60
Rietavas mun.;2017;26;121;76;45
Rietavas mun.;2017;27;143;85;58
Rietavas mun.;2017;28;103;65;38
Rietavas mun.;2017;29;89;62;27
Rietavas mun.;2017;30;72;38;34
Rietavas mun.;2017;31;80;54;26
Rietavas mun.;2017;32;47;34;13
Rietavas mun.;2017;33;64;35;29
Rietavas mun.;2017;34;52;23;29
Rietavas mun.;2017;35;55;33;22
Rietavas mun.;2017;36;67;35;32
Rietavas mun.;2017;37;67;36;31
Rietavas mun.;2017;38;84;47;37
Rietavas mun.;2017;39;66;32;34
Rietavas mun.;2017;40;66;33;33
Rietavas mun.;2017;41;85;37;48
Rietavas mun.;2017;42;91;53;38
Rietavas mun.;2017;43;87;55;32
Rietavas mun.;2017;44;97;53;44
Rietavas mun.;2017;45;105;53;52
Rietavas mun.;2017;46;118;65;53
Rietavas mun.;2017;47;99;43;56
Rietavas mun.;2017;48;112;53;59
Rietavas mun.;2017;49;128;63;65
Rietavas mun.;2017;50;125;58;67
Rietavas mun.;2017;51;135;78;57
Rietavas mun.;2017;52;124;57;67
Rietavas mun.;2017;53;122;53;69
Rietavas mun.;2017;54;131;67;64
Rietavas mun.;2017;55;153;64;89
Rietavas mun.;2017;56;109;49;60
Rietavas mun.;2017;57;120;60;60
Rietavas mun.;2017;58;139;77;62
Rietavas mun.;2017;59;114;46;68
Rietavas mun.;2017;60;97;46;51
Rietavas mun.;2017;61;94;48;46
Rietavas mun.;2017;62;87;37;50
Rietavas mun.;2017;63;80;41;39
Rietavas mun.;2017;64;87;38;49
Rietavas mun.;2017;65;85;36;49
Rietavas mun.;2017;66;66;24;42
Rietavas mun.;2017;67;88;38;50
Rietavas mun.;2017;68;63;30;33
Rietavas mun.;2017;69;53;18;35
Rietavas mun.;2017;70;53;16;37
Rietavas mun.;2017;71;54;19;35
Rietavas mun.;2017;72;69;26;43
Rietavas mun.;2017;73;75;29;46
Rietavas mun.;2017;74;72;23;49
Rietavas mun.;2017;75;78;30;48
Rietavas mun.;2017;76;75;24;51
Rietavas mun.;2017;77;68;19;49
Rietavas mun.;2017;78;58;15;43
Rietavas mun.;2017;79;79;31;48
Rietavas mun.;2017;80;63;23;40
Rietavas mun.;2017;81;58;25;33
Rietavas mun.;2017;82;56;13;43
Rietavas mun.;2017;83;42;13;29
Rietavas mun.;2017;84;33;6;27
Rietavas mun.;2017;85;208;56;152
Rietavas mun.;2018;-1;7542;3635;3907
Rietavas mun.;2018;0;84;48;36
Rietavas mun.;2018;1;74;34;40
Rietavas mun.;2018;2;87;43;44
Rietavas mun.;2018;3;69;39;30
Rietavas mun.;2018;4;93;46;47
Rietavas mun.;2018;5;92;44;48
Rietavas mun.;2018;6;72;37;35
Rietavas mun.;2018;7;62;38;24
Rietavas mun.;2018;8;65;36;29
Rietavas mun.;2018;9;80;50;30
Rietavas mun.;2018;10;66;31;35
Rietavas mun.;2018;11;63;26;37
Rietavas mun.;2018;12;69;30;39
Rietavas mun.;2018;13;65;33;32
Rietavas mun.;2018;14;85;43;42
Rietavas mun.;2018;15;82;44;38
Rietavas mun.;2018;16;78;35;43
Rietavas mun.;2018;17;110;50;60
Rietavas mun.;2018;18;102;51;51
Rietavas mun.;2018;19;97;44;53
Rietavas mun.;2018;20;110;59;51
Rietavas mun.;2018;21;107;54;53
Rietavas mun.;2018;22;105;59;46
Rietavas mun.;2018;23;136;68;68
Rietavas mun.;2018;24;130;73;57
Rietavas mun.;2018;25;142;74;68
Rietavas mun.;2018;26;116;65;51
Rietavas mun.;2018;27;107;66;41
Rietavas mun.;2018;28;129;80;49
Rietavas mun.;2018;29;88;54;34
Rietavas mun.;2018;30;79;59;20
Rietavas mun.;2018;31;68;36;32
Rietavas mun.;2018;32;76;47;29
Rietavas mun.;2018;33;43;30;13
Rietavas mun.;2018;34;57;28;29
Rietavas mun.;2018;35;49;24;25
Rietavas mun.;2018;36;54;33;21
Rietavas mun.;2018;37;65;36;29
Rietavas mun.;2018;38;64;35;29
Rietavas mun.;2018;39;86;47;39
Rietavas mun.;2018;40;63;30;33
Rietavas mun.;2018;41;63;31;32
Rietavas mun.;2018;42;81;35;46
Rietavas mun.;2018;43;92;53;39
Rietavas mun.;2018;44;88;55;33
Rietavas mun.;2018;45;94;51;43
Rietavas mun.;2018;46;104;52;52
Rietavas mun.;2018;47;114;62;52
Rietavas mun.;2018;48;96;40;56
Rietavas mun.;2018;49;112;53;59
Rietavas mun.;2018;50;126;61;65
Rietavas mun.;2018;51;124;55;69
Rietavas mun.;2018;52;131;76;55
Rietavas mun.;2018;53;122;57;65
Rietavas mun.;2018;54;121;53;68
Rietavas mun.;2018;55;128;65;63
Rietavas mun.;2018;56;150;61;89
Rietavas mun.;2018;57;109;49;60
Rietavas mun.;2018;58;115;57;58
Rietavas mun.;2018;59;137;76;61
Rietavas mun.;2018;60;113;46;67
Rietavas mun.;2018;61;99;47;52
Rietavas mun.;2018;62;95;48;47
Rietavas mun.;2018;63;88;38;50
Rietavas mun.;2018;64;79;41;38
Rietavas mun.;2018;65;87;38;49
Rietavas mun.;2018;66;85;35;50
Rietavas mun.;2018;67;66;23;43
Rietavas mun.;2018;68;88;36;52
Rietavas mun.;2018;69;63;30;33
Rietavas mun.;2018;70;55;19;36
Rietavas mun.;2018;71;51;15;36
Rietavas mun.;2018;72;48;18;30
Rietavas mun.;2018;73;68;26;42
Rietavas mun.;2018;74;72;28;44
Rietavas mun.;2018;75;67;20;47
Rietavas mun.;2018;76;75;27;48
Rietavas mun.;2018;77;71;23;48
Rietavas mun.;2018;78;66;18;48
Rietavas mun.;2018;79;55;15;40
Rietavas mun.;2018;80;74;28;46
Rietavas mun.;2018;81;58;20;38
Rietavas mun.;2018;82;51;23;28
Rietavas mun.;2018;83;52;11;41
Rietavas mun.;2018;84;39;12;27
Rietavas mun.;2018;85;201;49;152
Rokiškis d. mun.;2001;-1;42511;19948;22563
Rokiškis d. mun.;2001;0;349;189;160
Rokiškis d. mun.;2001;1;409;211;198
Rokiškis d. mun.;2001;2;385;194;191
Rokiškis d. mun.;2001;3;461;227;234
Rokiškis d. mun.;2001;4;451;219;232
Rokiškis d. mun.;2001;5;445;231;214
Rokiškis d. mun.;2001;6;488;241;247
Rokiškis d. mun.;2001;7;528;297;231
Rokiškis d. mun.;2001;8;679;357;322
Rokiškis d. mun.;2001;9;640;323;317
Rokiškis d. mun.;2001;10;648;324;324
Rokiškis d. mun.;2001;11;617;302;315
Rokiškis d. mun.;2001;12;675;330;345
Rokiškis d. mun.;2001;13;667;335;332
Rokiškis d. mun.;2001;14;679;345;334
Rokiškis d. mun.;2001;15;665;335;330
Rokiškis d. mun.;2001;16;634;316;318
Rokiškis d. mun.;2001;17;640;330;310
Rokiškis d. mun.;2001;18;500;279;221
Rokiškis d. mun.;2001;19;376;218;158
Rokiškis d. mun.;2001;20;377;223;154
Rokiškis d. mun.;2001;21;430;223;207
Rokiškis d. mun.;2001;22;351;171;180
Rokiškis d. mun.;2001;23;445;232;213
Rokiškis d. mun.;2001;24;450;243;207
Rokiškis d. mun.;2001;25;457;236;221
Rokiškis d. mun.;2001;26;472;225;247
Rokiškis d. mun.;2001;27;527;262;265
Rokiškis d. mun.;2001;28;556;300;256
Rokiškis d. mun.;2001;29;573;272;301
Rokiškis d. mun.;2001;30;572;296;276
Rokiškis d. mun.;2001;31;519;254;265
Rokiškis d. mun.;2001;32;570;277;293
Rokiškis d. mun.;2001;33;622;316;306
Rokiškis d. mun.;2001;34;596;319;277
Rokiškis d. mun.;2001;35;627;323;304
Rokiškis d. mun.;2001;36;590;278;312
Rokiškis d. mun.;2001;37;594;303;291
Rokiškis d. mun.;2001;38;640;340;300
Rokiškis d. mun.;2001;39;662;348;314
Rokiškis d. mun.;2001;40;701;361;340
Rokiškis d. mun.;2001;41;650;329;321
Rokiškis d. mun.;2001;42;608;313;295
Rokiškis d. mun.;2001;43;563;271;292
Rokiškis d. mun.;2001;44;562;294;268
Rokiškis d. mun.;2001;45;495;250;245
Rokiškis d. mun.;2001;46;485;243;242
Rokiškis d. mun.;2001;47;502;263;239
Rokiškis d. mun.;2001;48;524;247;277
Rokiškis d. mun.;2001;49;510;262;248
Rokiškis d. mun.;2001;50;497;251;246
Rokiškis d. mun.;2001;51;437;213;224
Rokiškis d. mun.;2001;52;435;209;226
Rokiškis d. mun.;2001;53;389;180;209
Rokiškis d. mun.;2001;54;374;191;183
Rokiškis d. mun.;2001;55;469;234;235
Rokiškis d. mun.;2001;56;430;207;223
Rokiškis d. mun.;2001;57;512;220;292
Rokiškis d. mun.;2001;58;543;239;304
Rokiškis d. mun.;2001;59;548;244;304
Rokiškis d. mun.;2001;60;527;252;275
Rokiškis d. mun.;2001;61;500;217;283
Rokiškis d. mun.;2001;62;479;206;273
Rokiškis d. mun.;2001;63;549;241;308
Rokiškis d. mun.;2001;64;582;239;343
Rokiškis d. mun.;2001;65;486;212;274
Rokiškis d. mun.;2001;66;512;182;330
Rokiškis d. mun.;2001;67;494;197;297
Rokiškis d. mun.;2001;68;555;219;336
Rokiškis d. mun.;2001;69;487;171;316
Rokiškis d. mun.;2001;70;467;169;298
Rokiškis d. mun.;2001;71;486;178;308
Rokiškis d. mun.;2001;72;496;185;311
Rokiškis d. mun.;2001;73;468;172;296
Rokiškis d. mun.;2001;74;422;128;294
Rokiškis d. mun.;2001;75;414;107;307
Rokiškis d. mun.;2001;76;353;116;237
Rokiškis d. mun.;2001;77;360;107;253
Rokiškis d. mun.;2001;78;336;108;228
Rokiškis d. mun.;2001;79;281;79;202
Rokiškis d. mun.;2001;80;243;66;177
Rokiškis d. mun.;2001;81;161;48;113
Rokiškis d. mun.;2001;82;120;32;88
Rokiškis d. mun.;2001;83;115;35;80
Rokiškis d. mun.;2001;84;102;30;72
Rokiškis d. mun.;2001;85;716;187;529
Rokiškis d. mun.;2002;-1;41888;19644;22244
Rokiškis d. mun.;2002;0;356;180;176
Rokiškis d. mun.;2002;1;347;185;162
Rokiškis d. mun.;2002;2;404;210;194
Rokiškis d. mun.;2002;3;378;194;184
Rokiškis d. mun.;2002;4;453;224;229
Rokiškis d. mun.;2002;5;448;217;231
Rokiškis d. mun.;2002;6;445;231;214
Rokiškis d. mun.;2002;7;485;238;247
Rokiškis d. mun.;2002;8;522;292;230
Rokiškis d. mun.;2002;9;669;348;321
Rokiškis d. mun.;2002;10;637;320;317
Rokiškis d. mun.;2002;11;643;321;322
Rokiškis d. mun.;2002;12;614;300;314
Rokiškis d. mun.;2002;13;661;324;337
Rokiškis d. mun.;2002;14;657;328;329
Rokiškis d. mun.;2002;15;668;339;329
Rokiškis d. mun.;2002;16;660;333;327
Rokiškis d. mun.;2002;17;623;311;312
Rokiškis d. mun.;2002;18;627;325;302
Rokiškis d. mun.;2002;19;481;264;217
Rokiškis d. mun.;2002;20;372;214;158
Rokiškis d. mun.;2002;21;376;221;155
Rokiškis d. mun.;2002;22;418;217;201
Rokiškis d. mun.;2002;23;335;168;167
Rokiškis d. mun.;2002;24;434;224;210
Rokiškis d. mun.;2002;25;439;242;197
Rokiškis d. mun.;2002;26;438;226;212
Rokiškis d. mun.;2002;27;457;219;238
Rokiškis d. mun.;2002;28;516;254;262
Rokiškis d. mun.;2002;29;542;291;251
Rokiškis d. mun.;2002;30;556;265;291
Rokiškis d. mun.;2002;31;562;289;273
Rokiškis d. mun.;2002;32;509;250;259
Rokiškis d. mun.;2002;33;554;270;284
Rokiškis d. mun.;2002;34;612;312;300
Rokiškis d. mun.;2002;35;589;313;276
Rokiškis d. mun.;2002;36;615;316;299
Rokiškis d. mun.;2002;37;585;275;310
Rokiškis d. mun.;2002;38;587;297;290
Rokiškis d. mun.;2002;39;629;333;296
Rokiškis d. mun.;2002;40;654;342;312
Rokiškis d. mun.;2002;41;691;355;336
Rokiškis d. mun.;2002;42;639;325;314
Rokiškis d. mun.;2002;43;608;313;295
Rokiškis d. mun.;2002;44;553;265;288
Rokiškis d. mun.;2002;45;550;288;262
Rokiškis d. mun.;2002;46;483;243;240
Rokiškis d. mun.;2002;47;485;240;245
Rokiškis d. mun.;2002;48;493;258;235
Rokiškis d. mun.;2002;49;512;239;273
Rokiškis d. mun.;2002;50;496;253;243
Rokiškis d. mun.;2002;51;487;245;242
Rokiškis d. mun.;2002;52;430;208;222
Rokiškis d. mun.;2002;53;428;202;226
Rokiškis d. mun.;2002;54;379;180;199
Rokiškis d. mun.;2002;55;369;188;181
Rokiškis d. mun.;2002;56;456;227;229
Rokiškis d. mun.;2002;57;420;201;219
Rokiškis d. mun.;2002;58;490;206;284
Rokiškis d. mun.;2002;59;533;231;302
Rokiškis d. mun.;2002;60;536;237;299
Rokiškis d. mun.;2002;61;522;249;273
Rokiškis d. mun.;2002;62;496;212;284
Rokiškis d. mun.;2002;63;479;206;273
Rokiškis d. mun.;2002;64;547;240;307
Rokiškis d. mun.;2002;65;570;233;337
Rokiškis d. mun.;2002;66;482;207;275
Rokiškis d. mun.;2002;67;497;176;321
Rokiškis d. mun.;2002;68;491;194;297
Rokiškis d. mun.;2002;69;545;213;332
Rokiškis d. mun.;2002;70;473;162;311
Rokiškis d. mun.;2002;71;461;164;297
Rokiškis d. mun.;2002;72;475;169;306
Rokiškis d. mun.;2002;73;485;178;307
Rokiškis d. mun.;2002;74;445;162;283
Rokiškis d. mun.;2002;75;403;118;285
Rokiškis d. mun.;2002;76;401;101;300
Rokiškis d. mun.;2002;77;335;109;226
Rokiškis d. mun.;2002;78;346;106;240
Rokiškis d. mun.;2002;79;321;103;218
Rokiškis d. mun.;2002;80;264;70;194
Rokiškis d. mun.;2002;81;217;57;160
Rokiškis d. mun.;2002;82;146;44;102
Rokiškis d. mun.;2002;83;105;30;75
Rokiškis d. mun.;2002;84;106;31;75
Rokiškis d. mun.;2002;85;681;184;497
Rokiškis d. mun.;2003;-1;41434;19425;22009
Rokiškis d. mun.;2003;0;320;156;164
Rokiškis d. mun.;2003;1;348;177;171
Rokiškis d. mun.;2003;2;345;185;160
Rokiškis d. mun.;2003;3;406;210;196
Rokiškis d. mun.;2003;4;375;192;183
Rokiškis d. mun.;2003;5;453;223;230
Rokiškis d. mun.;2003;6;447;216;231
Rokiškis d. mun.;2003;7;444;230;214
Rokiškis d. mun.;2003;8;487;239;248
Rokiškis d. mun.;2003;9;520;290;230
Rokiškis d. mun.;2003;10;671;351;320
Rokiškis d. mun.;2003;11;635;319;316
Rokiškis d. mun.;2003;12;631;315;316
Rokiškis d. mun.;2003;13;609;296;313
Rokiškis d. mun.;2003;14;650;319;331
Rokiškis d. mun.;2003;15;645;321;324
Rokiškis d. mun.;2003;16;660;332;328
Rokiškis d. mun.;2003;17;648;325;323
Rokiškis d. mun.;2003;18;608;305;303
Rokiškis d. mun.;2003;19;606;318;288
Rokiškis d. mun.;2003;20;468;259;209
Rokiškis d. mun.;2003;21;368;214;154
Rokiškis d. mun.;2003;22;368;220;148
Rokiškis d. mun.;2003;23;415;215;200
Rokiškis d. mun.;2003;24;331;169;162
Rokiškis d. mun.;2003;25;422;219;203
Rokiškis d. mun.;2003;26;438;243;195
Rokiškis d. mun.;2003;27;426;220;206
Rokiškis d. mun.;2003;28;453;220;233
Rokiškis d. mun.;2003;29;503;244;259
Rokiškis d. mun.;2003;30;536;287;249
Rokiškis d. mun.;2003;31;558;267;291
Rokiškis d. mun.;2003;32;555;284;271
Rokiškis d. mun.;2003;33;503;246;257
Rokiškis d. mun.;2003;34;552;268;284
Rokiškis d. mun.;2003;35;602;305;297
Rokiškis d. mun.;2003;36;577;306;271
Rokiškis d. mun.;2003;37;607;309;298
Rokiškis d. mun.;2003;38;579;272;307
Rokiškis d. mun.;2003;39;576;291;285
Rokiškis d. mun.;2003;40;622;329;293
Rokiškis d. mun.;2003;41;645;336;309
Rokiškis d. mun.;2003;42;692;355;337
Rokiškis d. mun.;2003;43;639;325;314
Rokiškis d. mun.;2003;44;603;313;290
Rokiškis d. mun.;2003;45;550;266;284
Rokiškis d. mun.;2003;46;551;288;263
Rokiškis d. mun.;2003;47;482;244;238
Rokiškis d. mun.;2003;48;482;239;243
Rokiškis d. mun.;2003;49;491;256;235
Rokiškis d. mun.;2003;50;501;232;269
Rokiškis d. mun.;2003;51;488;248;240
Rokiškis d. mun.;2003;52;484;243;241
Rokiškis d. mun.;2003;53;427;207;220
Rokiškis d. mun.;2003;54;425;199;226
Rokiškis d. mun.;2003;55;376;178;198
Rokiškis d. mun.;2003;56;362;186;176
Rokiškis d. mun.;2003;57;452;224;228
Rokiškis d. mun.;2003;58;416;199;217
Rokiškis d. mun.;2003;59;480;202;278
Rokiškis d. mun.;2003;60;524;227;297
Rokiškis d. mun.;2003;61;527;234;293
Rokiškis d. mun.;2003;62;515;244;271
Rokiškis d. mun.;2003;63;490;207;283
Rokiškis d. mun.;2003;64;476;204;272
Rokiškis d. mun.;2003;65;547;240;307
Rokiškis d. mun.;2003;66;570;231;339
Rokiškis d. mun.;2003;67;475;201;274
Rokiškis d. mun.;2003;68;491;170;321
Rokiškis d. mun.;2003;69;482;189;293
Rokiškis d. mun.;2003;70;538;207;331
Rokiškis d. mun.;2003;71;455;152;303
Rokiškis d. mun.;2003;72;444;151;293
Rokiškis d. mun.;2003;73;468;167;301
Rokiškis d. mun.;2003;74;467;163;304
Rokiškis d. mun.;2003;75;424;154;270
Rokiškis d. mun.;2003;76;387;113;274
Rokiškis d. mun.;2003;77;385;95;290
Rokiškis d. mun.;2003;78;317;99;218
Rokiškis d. mun.;2003;79;331;97;234
Rokiškis d. mun.;2003;80;295;88;207
Rokiškis d. mun.;2003;81;242;66;176
Rokiškis d. mun.;2003;82;200;51;149
Rokiškis d. mun.;2003;83;119;30;89
Rokiškis d. mun.;2003;84;100;28;72
Rokiškis d. mun.;2003;85;652;171;481
Rokiškis d. mun.;2004;-1;40832;19155;21677
Rokiškis d. mun.;2004;0;314;181;133
Rokiškis d. mun.;2004;1;315;154;161
Rokiškis d. mun.;2004;2;344;174;170
Rokiškis d. mun.;2004;3;340;182;158
Rokiškis d. mun.;2004;4;402;209;193
Rokiškis d. mun.;2004;5;370;189;181
Rokiškis d. mun.;2004;6;452;223;229
Rokiškis d. mun.;2004;7;445;214;231
Rokiškis d. mun.;2004;8;441;230;211
Rokiškis d. mun.;2004;9;483;235;248
Rokiškis d. mun.;2004;10;515;288;227
Rokiškis d. mun.;2004;11;665;349;316
Rokiškis d. mun.;2004;12;628;316;312
Rokiškis d. mun.;2004;13;622;311;311
Rokiškis d. mun.;2004;14;598;291;307
Rokiškis d. mun.;2004;15;638;318;320
Rokiškis d. mun.;2004;16;635;318;317
Rokiškis d. mun.;2004;17;647;328;319
Rokiškis d. mun.;2004;18;635;321;314
Rokiškis d. mun.;2004;19;600;303;297
Rokiškis d. mun.;2004;20;597;311;286
Rokiškis d. mun.;2004;21;458;252;206
Rokiškis d. mun.;2004;22;356;206;150
Rokiškis d. mun.;2004;23;358;214;144
Rokiškis d. mun.;2004;24;408;215;193
Rokiškis d. mun.;2004;25;328;166;162
Rokiškis d. mun.;2004;26;409;210;199
Rokiškis d. mun.;2004;27;418;232;186
Rokiškis d. mun.;2004;28;417;215;202
Rokiškis d. mun.;2004;29;441;217;224
Rokiškis d. mun.;2004;30;489;236;253
Rokiškis d. mun.;2004;31;531;288;243
Rokiškis d. mun.;2004;32;538;258;280
Rokiškis d. mun.;2004;33;539;278;261
Rokiškis d. mun.;2004;34;493;240;253
Rokiškis d. mun.;2004;35;546;265;281
Rokiškis d. mun.;2004;36;584;298;286
Rokiškis d. mun.;2004;37;570;304;266
Rokiškis d. mun.;2004;38;598;305;293
Rokiškis d. mun.;2004;39;576;271;305
Rokiškis d. mun.;2004;40;569;285;284
Rokiškis d. mun.;2004;41;612;324;288
Rokiškis d. mun.;2004;42;637;332;305
Rokiškis d. mun.;2004;43;683;352;331
Rokiškis d. mun.;2004;44;632;323;309
Rokiškis d. mun.;2004;45;597;308;289
Rokiškis d. mun.;2004;46;547;264;283
Rokiškis d. mun.;2004;47;538;281;257
Rokiškis d. mun.;2004;48;480;244;236
Rokiškis d. mun.;2004;49;478;237;241
Rokiškis d. mun.;2004;50;484;251;233
Rokiškis d. mun.;2004;51;499;229;270
Rokiškis d. mun.;2004;52;486;247;239
Rokiškis d. mun.;2004;53;479;242;237
Rokiškis d. mun.;2004;54;422;203;219
Rokiškis d. mun.;2004;55;418;194;224
Rokiškis d. mun.;2004;56;369;171;198
Rokiškis d. mun.;2004;57;362;187;175
Rokiškis d. mun.;2004;58;441;217;224
Rokiškis d. mun.;2004;59;407;197;210
Rokiškis d. mun.;2004;60;468;192;276
Rokiškis d. mun.;2004;61;515;217;298
Rokiškis d. mun.;2004;62;524;233;291
Rokiškis d. mun.;2004;63;508;238;270
Rokiškis d. mun.;2004;64;480;201;279
Rokiškis d. mun.;2004;65;473;202;271
Rokiškis d. mun.;2004;66;535;234;301
Rokiškis d. mun.;2004;67;563;224;339
Rokiškis d. mun.;2004;68;464;192;272
Rokiškis d. mun.;2004;69;488;168;320
Rokiškis d. mun.;2004;70;464;176;288
Rokiškis d. mun.;2004;71;526;198;328
Rokiškis d. mun.;2004;72;438;139;299
Rokiškis d. mun.;2004;73;436;145;291
Rokiškis d. mun.;2004;74;447;155;292
Rokiškis d. mun.;2004;75;442;148;294
Rokiškis d. mun.;2004;76;403;147;256
Rokiškis d. mun.;2004;77;375;105;270
Rokiškis d. mun.;2004;78;362;82;280
Rokiškis d. mun.;2004;79;290;95;195
Rokiškis d. mun.;2004;80;316;88;228
Rokiškis d. mun.;2004;81;277;74;203
Rokiškis d. mun.;2004;82;226;62;164
Rokiškis d. mun.;2004;83;192;48;144
Rokiškis d. mun.;2004;84;103;27;76
Rokiškis d. mun.;2004;85;634;162;472
Rokiškis d. mun.;2005;-1;40097;18791;21306
Rokiškis d. mun.;2005;0;319;161;158
Rokiškis d. mun.;2005;1;314;181;133
Rokiškis d. mun.;2005;2;313;152;161
Rokiškis d. mun.;2005;3;343;172;171
Rokiškis d. mun.;2005;4;336;180;156
Rokiškis d. mun.;2005;5;400;207;193
Rokiškis d. mun.;2005;6;367;187;180
Rokiškis d. mun.;2005;7;448;221;227
Rokiškis d. mun.;2005;8;446;213;233
Rokiškis d. mun.;2005;9;440;229;211
Rokiškis d. mun.;2005;10;479;233;246
Rokiškis d. mun.;2005;11;513;289;224
Rokiškis d. mun.;2005;12;662;347;315
Rokiškis d. mun.;2005;13;620;312;308
Rokiškis d. mun.;2005;14;614;307;307
Rokiškis d. mun.;2005;15;593;288;305
Rokiškis d. mun.;2005;16;625;311;314
Rokiškis d. mun.;2005;17;622;310;312
Rokiškis d. mun.;2005;18;636;323;313
Rokiškis d. mun.;2005;19;615;311;304
Rokiškis d. mun.;2005;20;587;296;291
Rokiškis d. mun.;2005;21;571;301;270
Rokiškis d. mun.;2005;22;440;244;196
Rokiškis d. mun.;2005;23;349;202;147
Rokiškis d. mun.;2005;24;352;211;141
Rokiškis d. mun.;2005;25;395;209;186
Rokiškis d. mun.;2005;26;307;162;145
Rokiškis d. mun.;2005;27;379;190;189
Rokiškis d. mun.;2005;28;406;223;183
Rokiškis d. mun.;2005;29;404;209;195
Rokiškis d. mun.;2005;30;433;213;220
Rokiškis d. mun.;2005;31;471;225;246
Rokiškis d. mun.;2005;32;504;270;234
Rokiškis d. mun.;2005;33;527;250;277
Rokiškis d. mun.;2005;34;530;272;258
Rokiškis d. mun.;2005;35;488;236;252
Rokiškis d. mun.;2005;36;532;255;277
Rokiškis d. mun.;2005;37;582;297;285
Rokiškis d. mun.;2005;38;563;299;264
Rokiškis d. mun.;2005;39;591;306;285
Rokiškis d. mun.;2005;40;574;269;305
Rokiškis d. mun.;2005;41;556;280;276
Rokiškis d. mun.;2005;42;602;320;282
Rokiškis d. mun.;2005;43;628;326;302
Rokiškis d. mun.;2005;44;676;349;327
Rokiškis d. mun.;2005;45;624;319;305
Rokiškis d. mun.;2005;46;590;302;288
Rokiškis d. mun.;2005;47;545;264;281
Rokiškis d. mun.;2005;48;530;278;252
Rokiškis d. mun.;2005;49;472;236;236
Rokiškis d. mun.;2005;50;468;232;236
Rokiškis d. mun.;2005;51;482;251;231
Rokiškis d. mun.;2005;52;494;224;270
Rokiškis d. mun.;2005;53;475;239;236
Rokiškis d. mun.;2005;54;469;236;233
Rokiškis d. mun.;2005;55;417;196;221
Rokiškis d. mun.;2005;56;412;189;223
Rokiškis d. mun.;2005;57;368;170;198
Rokiškis d. mun.;2005;58;355;181;174
Rokiškis d. mun.;2005;59;423;206;217
Rokiškis d. mun.;2005;60;397;192;205
Rokiškis d. mun.;2005;61;459;185;274
Rokiškis d. mun.;2005;62;506;211;295
Rokiškis d. mun.;2005;63;511;224;287
Rokiškis d. mun.;2005;64;499;235;264
Rokiškis d. mun.;2005;65;473;194;279
Rokiškis d. mun.;2005;66;457;191;266
Rokiškis d. mun.;2005;67;519;219;300
Rokiškis d. mun.;2005;68;552;217;335
Rokiškis d. mun.;2005;69;452;189;263
Rokiškis d. mun.;2005;70;481;169;312
Rokiškis d. mun.;2005;71;451;169;282
Rokiškis d. mun.;2005;72;506;182;324
Rokiškis d. mun.;2005;73;428;134;294
Rokiškis d. mun.;2005;74;414;134;280
Rokiškis d. mun.;2005;75;435;150;285
Rokiškis d. mun.;2005;76;422;137;285
Rokiškis d. mun.;2005;77;372;132;240
Rokiškis d. mun.;2005;78;360;101;259
Rokiškis d. mun.;2005;79;333;72;261
Rokiškis d. mun.;2005;80;265;84;181
Rokiškis d. mun.;2005;81;285;78;207
Rokiškis d. mun.;2005;82;254;66;188
Rokiškis d. mun.;2005;83;215;57;158
Rokiškis d. mun.;2005;84;169;43;126
Rokiškis d. mun.;2005;85;606;155;451
Rokiškis d. mun.;2006;-1;39098;18302;20796
Rokiškis d. mun.;2006;0;292;140;152
Rokiškis d. mun.;2006;1;316;158;158
Rokiškis d. mun.;2006;2;310;176;134
Rokiškis d. mun.;2006;3;310;152;158
Rokiškis d. mun.;2006;4;339;171;168
Rokiškis d. mun.;2006;5;331;179;152
Rokiškis d. mun.;2006;6;395;205;190
Rokiškis d. mun.;2006;7;372;190;182
Rokiškis d. mun.;2006;8;445;219;226
Rokiškis d. mun.;2006;9;442;209;233
Rokiškis d. mun.;2006;10;437;227;210
Rokiškis d. mun.;2006;11;478;231;247
Rokiškis d. mun.;2006;12;508;286;222
Rokiškis d. mun.;2006;13;646;337;309
Rokiškis d. mun.;2006;14;614;309;305
Rokiškis d. mun.;2006;15;604;301;303
Rokiškis d. mun.;2006;16;578;282;296
Rokiškis d. mun.;2006;17;610;303;307
Rokiškis d. mun.;2006;18;606;300;306
Rokiškis d. mun.;2006;19;601;306;295
Rokiškis d. mun.;2006;20;581;294;287
Rokiškis d. mun.;2006;21;550;281;269
Rokiškis d. mun.;2006;22;534;285;249
Rokiškis d. mun.;2006;23;413;230;183
Rokiškis d. mun.;2006;24;320;187;133
Rokiškis d. mun.;2006;25;311;191;120
Rokiškis d. mun.;2006;26;382;205;177
Rokiškis d. mun.;2006;27;291;155;136
Rokiškis d. mun.;2006;28;365;187;178
Rokiškis d. mun.;2006;29;392;216;176
Rokiškis d. mun.;2006;30;393;205;188
Rokiškis d. mun.;2006;31;422;208;214
Rokiškis d. mun.;2006;32;455;218;237
Rokiškis d. mun.;2006;33;481;257;224
Rokiškis d. mun.;2006;34;510;245;265
Rokiškis d. mun.;2006;35;519;265;254
Rokiškis d. mun.;2006;36;475;227;248
Rokiškis d. mun.;2006;37;516;243;273
Rokiškis d. mun.;2006;38;572;294;278
Rokiškis d. mun.;2006;39;550;292;258
Rokiškis d. mun.;2006;40;582;298;284
Rokiškis d. mun.;2006;41;564;266;298
Rokiškis d. mun.;2006;42;542;267;275
Rokiškis d. mun.;2006;43;597;312;285
Rokiškis d. mun.;2006;44;620;321;299
Rokiškis d. mun.;2006;45;679;348;331
Rokiškis d. mun.;2006;46;612;311;301
Rokiškis d. mun.;2006;47;580;293;287
Rokiškis d. mun.;2006;48;541;260;281
Rokiškis d. mun.;2006;49;515;270;245
Rokiškis d. mun.;2006;50;467;235;232
Rokiškis d. mun.;2006;51;465;230;235
Rokiškis d. mun.;2006;52;479;248;231
Rokiškis d. mun.;2006;53;485;220;265
Rokiškis d. mun.;2006;54;465;232;233
Rokiškis d. mun.;2006;55;459;230;229
Rokiškis d. mun.;2006;56;415;193;222
Rokiškis d. mun.;2006;57;397;178;219
Rokiškis d. mun.;2006;58;364;167;197
Rokiškis d. mun.;2006;59;348;178;170
Rokiškis d. mun.;2006;60;417;205;212
Rokiškis d. mun.;2006;61;389;187;202
Rokiškis d. mun.;2006;62;443;174;269
Rokiškis d. mun.;2006;63;502;211;291
Rokiškis d. mun.;2006;64;500;217;283
Rokiškis d. mun.;2006;65;483;220;263
Rokiškis d. mun.;2006;66;463;187;276
Rokiškis d. mun.;2006;67;448;181;267
Rokiškis d. mun.;2006;68;508;211;297
Rokiškis d. mun.;2006;69;540;207;333
Rokiškis d. mun.;2006;70;438;179;259
Rokiškis d. mun.;2006;71;465;161;304
Rokiškis d. mun.;2006;72;429;155;274
Rokiškis d. mun.;2006;73;489;176;313
Rokiškis d. mun.;2006;74;406;126;280
Rokiškis d. mun.;2006;75;396;126;270
Rokiškis d. mun.;2006;76;419;145;274
Rokiškis d. mun.;2006;77;401;127;274
Rokiškis d. mun.;2006;78;343;117;226
Rokiškis d. mun.;2006;79;345;95;250
Rokiškis d. mun.;2006;80;307;64;243
Rokiškis d. mun.;2006;81;247;75;172
Rokiškis d. mun.;2006;82;258;70;188
Rokiškis d. mun.;2006;83;225;60;165
Rokiškis d. mun.;2006;84;196;47;149
Rokiškis d. mun.;2006;85;599;156;443
Rokiškis d. mun.;2007;-1;38309;17889;20420
Rokiškis d. mun.;2007;0;275;136;139
Rokiškis d. mun.;2007;1;289;139;150
Rokiškis d. mun.;2007;2;311;156;155
Rokiškis d. mun.;2007;3;309;175;134
Rokiškis d. mun.;2007;4;309;149;160
Rokiškis d. mun.;2007;5;336;168;168
Rokiškis d. mun.;2007;6;329;176;153
Rokiškis d. mun.;2007;7;390;203;187
Rokiškis d. mun.;2007;8;371;190;181
Rokiškis d. mun.;2007;9;440;216;224
Rokiškis d. mun.;2007;10;442;208;234
Rokiškis d. mun.;2007;11;437;227;210
Rokiškis d. mun.;2007;12;480;230;250
Rokiškis d. mun.;2007;13;508;285;223
Rokiškis d. mun.;2007;14;641;336;305
Rokiškis d. mun.;2007;15;612;306;306
Rokiškis d. mun.;2007;16;597;297;300
Rokiškis d. mun.;2007;17;570;278;292
Rokiškis d. mun.;2007;18;592;290;302
Rokiškis d. mun.;2007;19;587;290;297
Rokiškis d. mun.;2007;20;581;294;287
Rokiškis d. mun.;2007;21;560;284;276
Rokiškis d. mun.;2007;22;535;271;264
Rokiškis d. mun.;2007;23;513;274;239
Rokiškis d. mun.;2007;24;400;224;176
Rokiškis d. mun.;2007;25;292;171;121
Rokiškis d. mun.;2007;26;296;184;112
Rokiškis d. mun.;2007;27;359;191;168
Rokiškis d. mun.;2007;28;279;147;132
Rokiškis d. mun.;2007;29;351;179;172
Rokiškis d. mun.;2007;30;379;209;170
Rokiškis d. mun.;2007;31;386;202;184
Rokiškis d. mun.;2007;32;410;198;212
Rokiškis d. mun.;2007;33;443;211;232
Rokiškis d. mun.;2007;34;474;253;221
Rokiškis d. mun.;2007;35;503;244;259
Rokiškis d. mun.;2007;36;509;258;251
Rokiškis d. mun.;2007;37;464;223;241
Rokiškis d. mun.;2007;38;505;238;267
Rokiškis d. mun.;2007;39;558;284;274
Rokiškis d. mun.;2007;40;545;289;256
Rokiškis d. mun.;2007;41;572;289;283
Rokiškis d. mun.;2007;42;555;261;294
Rokiškis d. mun.;2007;43;531;258;273
Rokiškis d. mun.;2007;44;581;303;278
Rokiškis d. mun.;2007;45;608;316;292
Rokiškis d. mun.;2007;46;675;344;331
Rokiškis d. mun.;2007;47;602;305;297
Rokiškis d. mun.;2007;48;575;291;284
Rokiškis d. mun.;2007;49;529;252;277
Rokiškis d. mun.;2007;50;506;264;242
Rokiškis d. mun.;2007;51;460;230;230
Rokiškis d. mun.;2007;52;457;224;233
Rokiškis d. mun.;2007;53;469;242;227
Rokiškis d. mun.;2007;54;475;213;262
Rokiškis d. mun.;2007;55;458;225;233
Rokiškis d. mun.;2007;56;452;225;227
Rokiškis d. mun.;2007;57;408;186;222
Rokiškis d. mun.;2007;58;391;176;215
Rokiškis d. mun.;2007;59;356;162;194
Rokiškis d. mun.;2007;60;341;169;172
Rokiškis d. mun.;2007;61;408;199;209
Rokiškis d. mun.;2007;62;384;183;201
Rokiškis d. mun.;2007;63;436;171;265
Rokiškis d. mun.;2007;64;490;202;288
Rokiškis d. mun.;2007;65;490;211;279
Rokiškis d. mun.;2007;66;476;215;261
Rokiškis d. mun.;2007;67;451;178;273
Rokiškis d. mun.;2007;68;443;177;266
Rokiškis d. mun.;2007;69;498;202;296
Rokiškis d. mun.;2007;70;530;198;332
Rokiškis d. mun.;2007;71;422;169;253
Rokiškis d. mun.;2007;72;453;152;301
Rokiškis d. mun.;2007;73;404;141;263
Rokiškis d. mun.;2007;74;476;167;309
Rokiškis d. mun.;2007;75;384;115;269
Rokiškis d. mun.;2007;76;383;123;260
Rokiškis d. mun.;2007;77;399;137;262
Rokiškis d. mun.;2007;78;379;116;263
Rokiškis d. mun.;2007;79;316;106;210
Rokiškis d. mun.;2007;80;320;87;233
Rokiškis d. mun.;2007;81;279;58;221
Rokiškis d. mun.;2007;82;224;72;152
Rokiškis d. mun.;2007;83;237;67;170
Rokiškis d. mun.;2007;84;197;50;147
Rokiškis d. mun.;2007;85;662;175;487
Rokiškis d. mun.;2008;-1;37549;17512;20037
Rokiškis d. mun.;2008;0;257;125;132
Rokiškis d. mun.;2008;1;270;135;135
Rokiškis d. mun.;2008;2;287;139;148
Rokiškis d. mun.;2008;3;308;155;153
Rokiškis d. mun.;2008;4;308;175;133
Rokiškis d. mun.;2008;5;305;149;156
Rokiškis d. mun.;2008;6;332;163;169
Rokiškis d. mun.;2008;7;328;175;153
Rokiškis d. mun.;2008;8;390;203;187
Rokiškis d. mun.;2008;9;370;190;180
Rokiškis d. mun.;2008;10;443;218;225
Rokiškis d. mun.;2008;11;442;208;234
Rokiškis d. mun.;2008;12;429;221;208
Rokiškis d. mun.;2008;13;481;231;250
Rokiškis d. mun.;2008;14;499;281;218
Rokiškis d. mun.;2008;15;638;333;305
Rokiškis d. mun.;2008;16;611;304;307
Rokiškis d. mun.;2008;17;596;296;300
Rokiškis d. mun.;2008;18;558;274;284
Rokiškis d. mun.;2008;19;586;291;295
Rokiškis d. mun.;2008;20;578;287;291
Rokiškis d. mun.;2008;21;565;286;279
Rokiškis d. mun.;2008;22;543;277;266
Rokiškis d. mun.;2008;23;511;267;244
Rokiškis d. mun.;2008;24;494;264;230
Rokiškis d. mun.;2008;25;393;219;174
Rokiškis d. mun.;2008;26;282;165;117
Rokiškis d. mun.;2008;27;286;178;108
Rokiškis d. mun.;2008;28;339;184;155
Rokiškis d. mun.;2008;29;269;142;127
Rokiškis d. mun.;2008;30;342;174;168
Rokiškis d. mun.;2008;31;372;204;168
Rokiškis d. mun.;2008;32;373;197;176
Rokiškis d. mun.;2008;33;402;191;211
Rokiškis d. mun.;2008;34;441;205;236
Rokiškis d. mun.;2008;35;467;253;214
Rokiškis d. mun.;2008;36;497;238;259
Rokiškis d. mun.;2008;37;495;250;245
Rokiškis d. mun.;2008;38;461;223;238
Rokiškis d. mun.;2008;39;496;231;265
Rokiškis d. mun.;2008;40;552;280;272
Rokiškis d. mun.;2008;41;537;284;253
Rokiškis d. mun.;2008;42;559;284;275
Rokiškis d. mun.;2008;43;551;261;290
Rokiškis d. mun.;2008;44;527;252;275
Rokiškis d. mun.;2008;45;575;300;275
Rokiškis d. mun.;2008;46;605;316;289
Rokiškis d. mun.;2008;47;662;335;327
Rokiškis d. mun.;2008;48;588;294;294
Rokiškis d. mun.;2008;49;564;280;284
Rokiškis d. mun.;2008;50;513;244;269
Rokiškis d. mun.;2008;51;505;263;242
Rokiškis d. mun.;2008;52;453;227;226
Rokiškis d. mun.;2008;53;452;221;231
Rokiškis d. mun.;2008;54;456;239;217
Rokiškis d. mun.;2008;55;463;202;261
Rokiškis d. mun.;2008;56;448;221;227
Rokiškis d. mun.;2008;57;443;220;223
Rokiškis d. mun.;2008;58;401;181;220
Rokiškis d. mun.;2008;59;385;171;214
Rokiškis d. mun.;2008;60;347;156;191
Rokiškis d. mun.;2008;61;332;163;169
Rokiškis d. mun.;2008;62;397;191;206
Rokiškis d. mun.;2008;63;365;175;190
Rokiškis d. mun.;2008;64;423;161;262
Rokiškis d. mun.;2008;65;480;198;282
Rokiškis d. mun.;2008;66;481;203;278
Rokiškis d. mun.;2008;67;457;200;257
Rokiškis d. mun.;2008;68;439;170;269
Rokiškis d. mun.;2008;69;440;172;268
Rokiškis d. mun.;2008;70;482;197;285
Rokiškis d. mun.;2008;71;511;189;322
Rokiškis d. mun.;2008;72;411;163;248
Rokiškis d. mun.;2008;73;444;146;298
Rokiškis d. mun.;2008;74;391;132;259
Rokiškis d. mun.;2008;75;456;152;304
Rokiškis d. mun.;2008;76;369;107;262
Rokiškis d. mun.;2008;77;357;113;244
Rokiškis d. mun.;2008;78;373;124;249
Rokiškis d. mun.;2008;79;362;108;254
Rokiškis d. mun.;2008;80;291;87;204
Rokiškis d. mun.;2008;81;295;77;218
Rokiškis d. mun.;2008;82;253;50;203
Rokiškis d. mun.;2008;83;196;63;133
Rokiškis d. mun.;2008;84;208;51;157
Rokiškis d. mun.;2008;85;706;188;518
Rokiškis d. mun.;2009;-1;36768;17144;19624
Rokiškis d. mun.;2009;0;306;156;150
Rokiškis d. mun.;2009;1;255;124;131
Rokiškis d. mun.;2009;2;271;136;135
Rokiškis d. mun.;2009;3;284;137;147
Rokiškis d. mun.;2009;4;306;154;152
Rokiškis d. mun.;2009;5;305;175;130
Rokiškis d. mun.;2009;6;305;148;157
Rokiškis d. mun.;2009;7;329;162;167
Rokiškis d. mun.;2009;8;325;176;149
Rokiškis d. mun.;2009;9;388;201;187
Rokiškis d. mun.;2009;10;368;191;177
Rokiškis d. mun.;2009;11;438;215;223
Rokiškis d. mun.;2009;12;439;205;234
Rokiškis d. mun.;2009;13;430;221;209
Rokiškis d. mun.;2009;14;477;229;248
Rokiškis d. mun.;2009;15;500;283;217
Rokiškis d. mun.;2009;16;631;330;301
Rokiškis d. mun.;2009;17;606;303;303
Rokiškis d. mun.;2009;18;587;292;295
Rokiškis d. mun.;2009;19;556;275;281
Rokiškis d. mun.;2009;20;577;288;289
Rokiškis d. mun.;2009;21;568;282;286
Rokiškis d. mun.;2009;22;549;282;267
Rokiškis d. mun.;2009;23;534;272;262
Rokiškis d. mun.;2009;24;485;253;232
Rokiškis d. mun.;2009;25;477;255;222
Rokiškis d. mun.;2009;26;371;211;160
Rokiškis d. mun.;2009;27;265;161;104
Rokiškis d. mun.;2009;28;264;167;97
Rokiškis d. mun.;2009;29;320;174;146
Rokiškis d. mun.;2009;30;247;129;118
Rokiškis d. mun.;2009;31;329;172;157
Rokiškis d. mun.;2009;32;364;199;165
Rokiškis d. mun.;2009;33;363;192;171
Rokiškis d. mun.;2009;34;396;186;210
Rokiškis d. mun.;2009;35;431;202;229
Rokiškis d. mun.;2009;36;460;251;209
Rokiškis d. mun.;2009;37;486;233;253
Rokiškis d. mun.;2009;38;490;249;241
Rokiškis d. mun.;2009;39;450;215;235
Rokiškis d. mun.;2009;40;490;228;262
Rokiškis d. mun.;2009;41;548;278;270
Rokiškis d. mun.;2009;42;531;280;251
Rokiškis d. mun.;2009;43;547;275;272
Rokiškis d. mun.;2009;44;546;256;290
Rokiškis d. mun.;2009;45;521;250;271
Rokiškis d. mun.;2009;46;563;290;273
Rokiškis d. mun.;2009;47;599;311;288
Rokiškis d. mun.;2009;48;650;326;324
Rokiškis d. mun.;2009;49;585;292;293
Rokiškis d. mun.;2009;50;550;271;279
Rokiškis d. mun.;2009;51;508;240;268
Rokiškis d. mun.;2009;52;495;254;241
Rokiškis d. mun.;2009;53;445;221;224
Rokiškis d. mun.;2009;54;442;216;226
Rokiškis d. mun.;2009;55;448;236;212
Rokiškis d. mun.;2009;56;452;199;253
Rokiškis d. mun.;2009;57;439;212;227
Rokiškis d. mun.;2009;58;436;211;225
Rokiškis d. mun.;2009;59;398;178;220
Rokiškis d. mun.;2009;60;378;165;213
Rokiškis d. mun.;2009;61;338;151;187
Rokiškis d. mun.;2009;62;324;158;166
Rokiškis d. mun.;2009;63;374;178;196
Rokiškis d. mun.;2009;64;352;163;189
Rokiškis d. mun.;2009;65;408;153;255
Rokiškis d. mun.;2009;66;468;188;280
Rokiškis d. mun.;2009;67;465;194;271
Rokiškis d. mun.;2009;68;440;186;254
Rokiškis d. mun.;2009;69;423;161;262
Rokiškis d. mun.;2009;70;423;160;263
Rokiškis d. mun.;2009;71;464;186;278
Rokiškis d. mun.;2009;72;487;175;312
Rokiškis d. mun.;2009;73;390;149;241
Rokiškis d. mun.;2009;74;433;141;292
Rokiškis d. mun.;2009;75;377;127;250
Rokiškis d. mun.;2009;76;432;138;294
Rokiškis d. mun.;2009;77;344;96;248
Rokiškis d. mun.;2009;78;341;107;234
Rokiškis d. mun.;2009;79;349;114;235
Rokiškis d. mun.;2009;80;338;96;242
Rokiškis d. mun.;2009;81;259;70;189
Rokiškis d. mun.;2009;82;275;74;201
Rokiškis d. mun.;2009;83;229;46;183
Rokiškis d. mun.;2009;84;180;56;124
Rokiškis d. mun.;2009;85;752;202;550
Rokiškis d. mun.;2010;-1;35993;16764;19229
Rokiškis d. mun.;2010;0;266;146;120
Rokiškis d. mun.;2010;1;303;154;149
Rokiškis d. mun.;2010;2;251;124;127
Rokiškis d. mun.;2010;3;273;134;139
Rokiškis d. mun.;2010;4;286;138;148
Rokiškis d. mun.;2010;5;298;151;147
Rokiškis d. mun.;2010;6;304;176;128
Rokiškis d. mun.;2010;7;302;146;156
Rokiškis d. mun.;2010;8;325;161;164
Rokiškis d. mun.;2010;9;323;174;149
Rokiškis d. mun.;2010;10;390;203;187
Rokiškis d. mun.;2010;11;368;190;178
Rokiškis d. mun.;2010;12;435;214;221
Rokiškis d. mun.;2010;13;434;203;231
Rokiškis d. mun.;2010;14;431;221;210
Rokiškis d. mun.;2010;15;477;229;248
Rokiškis d. mun.;2010;16;497;282;215
Rokiškis d. mun.;2010;17;624;328;296
Rokiškis d. mun.;2010;18;601;303;298
Rokiškis d. mun.;2010;19;572;285;287
Rokiškis d. mun.;2010;20;540;266;274
Rokiškis d. mun.;2010;21;565;281;284
Rokiškis d. mun.;2010;22;551;276;275
Rokiškis d. mun.;2010;23;517;267;250
Rokiškis d. mun.;2010;24;513;257;256
Rokiškis d. mun.;2010;25;466;242;224
Rokiškis d. mun.;2010;26;452;246;206
Rokiškis d. mun.;2010;27;352;205;147
Rokiškis d. mun.;2010;28;244;150;94
Rokiškis d. mun.;2010;29;257;167;90
Rokiškis d. mun.;2010;30;304;167;137
Rokiškis d. mun.;2010;31;242;127;115
Rokiškis d. mun.;2010;32;328;171;157
Rokiškis d. mun.;2010;33;354;194;160
Rokiškis d. mun.;2010;34;351;185;166
Rokiškis d. mun.;2010;35;390;181;209
Rokiškis d. mun.;2010;36;422;196;226
Rokiškis d. mun.;2010;37;454;243;211
Rokiškis d. mun.;2010;38;481;227;254
Rokiškis d. mun.;2010;39;481;243;238
Rokiškis d. mun.;2010;40;441;212;229
Rokiškis d. mun.;2010;41;485;226;259
Rokiškis d. mun.;2010;42;538;271;267
Rokiškis d. mun.;2010;43;524;276;248
Rokiškis d. mun.;2010;44;541;271;270
Rokiškis d. mun.;2010;45;535;248;287
Rokiškis d. mun.;2010;46;516;248;268
Rokiškis d. mun.;2010;47;555;285;270
Rokiškis d. mun.;2010;48;592;309;283
Rokiškis d. mun.;2010;49;637;319;318
Rokiškis d. mun.;2010;50;576;285;291
Rokiškis d. mun.;2010;51;545;265;280
Rokiškis d. mun.;2010;52;499;234;265
Rokiškis d. mun.;2010;53;487;249;238
Rokiškis d. mun.;2010;54;439;217;222
Rokiškis d. mun.;2010;55;440;218;222
Rokiškis d. mun.;2010;56;440;231;209
Rokiškis d. mun.;2010;57;436;191;245
Rokiškis d. mun.;2010;58;424;202;222
Rokiškis d. mun.;2010;59;425;204;221
Rokiškis d. mun.;2010;60;389;172;217
Rokiškis d. mun.;2010;61;370;161;209
Rokiškis d. mun.;2010;62;323;141;182
Rokiškis d. mun.;2010;63;315;153;162
Rokiškis d. mun.;2010;64;360;169;191
Rokiškis d. mun.;2010;65;341;156;185
Rokiškis d. mun.;2010;66;398;146;252
Rokiškis d. mun.;2010;67;461;183;278
Rokiškis d. mun.;2010;68;454;187;267
Rokiškis d. mun.;2010;69;427;174;253
Rokiškis d. mun.;2010;70;414;157;257
Rokiškis d. mun.;2010;71;411;152;259
Rokiškis d. mun.;2010;72;447;178;269
Rokiškis d. mun.;2010;73;477;169;308
Rokiškis d. mun.;2010;74;378;142;236
Rokiškis d. mun.;2010;75;418;130;288
Rokiškis d. mun.;2010;76;357;115;242
Rokiškis d. mun.;2010;77;413;127;286
Rokiškis d. mun.;2010;78;321;88;233
Rokiškis d. mun.;2010;79;320;92;228
Rokiškis d. mun.;2010;80;323;101;222
Rokiškis d. mun.;2010;81;309;79;230
Rokiškis d. mun.;2010;82;232;61;171
Rokiškis d. mun.;2010;83;249;68;181
Rokiškis d. mun.;2010;84;202;38;164
Rokiškis d. mun.;2010;85;785;211;574
Rokiškis d. mun.;2011;-1;35022;16309;18713
Rokiškis d. mun.;2011;0;262;123;139
Rokiškis d. mun.;2011;1;235;125;110
Rokiškis d. mun.;2011;2;251;131;120
Rokiškis d. mun.;2011;3;230;110;120
Rokiškis d. mun.;2011;4;249;123;126
Rokiškis d. mun.;2011;5;259;124;135
Rokiškis d. mun.;2011;6;287;149;138
Rokiškis d. mun.;2011;7;286;165;121
Rokiškis d. mun.;2011;8;282;135;147
Rokiškis d. mun.;2011;9;321;157;164
Rokiškis d. mun.;2011;10;324;184;140
Rokiškis d. mun.;2011;11;393;205;188
Rokiškis d. mun.;2011;12;356;183;173
Rokiškis d. mun.;2011;13;454;222;232
Rokiškis d. mun.;2011;14;434;200;234
Rokiškis d. mun.;2011;15;421;216;205
Rokiškis d. mun.;2011;16;468;221;247
Rokiškis d. mun.;2011;17;513;282;231
Rokiškis d. mun.;2011;18;627;332;295
Rokiškis d. mun.;2011;19;473;245;228
Rokiškis d. mun.;2011;20;426;229;197
Rokiškis d. mun.;2011;21;423;223;200
Rokiškis d. mun.;2011;22;430;238;192
Rokiškis d. mun.;2011;23;417;229;188
Rokiškis d. mun.;2011;24;405;235;170
Rokiškis d. mun.;2011;25;373;199;174
Rokiškis d. mun.;2011;26;344;187;157
Rokiškis d. mun.;2011;27;313;189;124
Rokiškis d. mun.;2011;28;329;186;143
Rokiškis d. mun.;2011;29;273;158;115
Rokiškis d. mun.;2011;30;297;168;129
Rokiškis d. mun.;2011;31;340;171;169
Rokiškis d. mun.;2011;32;288;140;148
Rokiškis d. mun.;2011;33;344;179;165
Rokiškis d. mun.;2011;34;381;193;188
Rokiškis d. mun.;2011;35;377;183;194
Rokiškis d. mun.;2011;36;429;200;229
Rokiškis d. mun.;2011;37;454;218;236
Rokiškis d. mun.;2011;38;492;255;237
Rokiškis d. mun.;2011;39;525;263;262
Rokiškis d. mun.;2011;40;546;279;267
Rokiškis d. mun.;2011;41;480;234;246
Rokiškis d. mun.;2011;42;519;248;271
Rokiškis d. mun.;2011;43;579;288;291
Rokiškis d. mun.;2011;44;551;292;259
Rokiškis d. mun.;2011;45;566;287;279
Rokiškis d. mun.;2011;46;546;251;295
Rokiškis d. mun.;2011;47;510;254;256
Rokiškis d. mun.;2011;48;571;300;271
Rokiškis d. mun.;2011;49;586;297;289
Rokiškis d. mun.;2011;50;658;325;333
Rokiškis d. mun.;2011;51;573;274;299
Rokiškis d. mun.;2011;52;541;267;274
Rokiškis d. mun.;2011;53;492;230;262
Rokiškis d. mun.;2011;54;504;253;251
Rokiškis d. mun.;2011;55;452;224;228
Rokiškis d. mun.;2011;56;448;224;224
Rokiškis d. mun.;2011;57;439;228;211
Rokiškis d. mun.;2011;58;465;206;259
Rokiškis d. mun.;2011;59;430;204;226
Rokiškis d. mun.;2011;60;415;186;229
Rokiškis d. mun.;2011;61;377;162;215
Rokiškis d. mun.;2011;62;356;150;206
Rokiškis d. mun.;2011;63;329;144;185
Rokiškis d. mun.;2011;64;314;146;168
Rokiškis d. mun.;2011;65;361;162;199
Rokiškis d. mun.;2011;66;337;152;185
Rokiškis d. mun.;2011;67;399;139;260
Rokiškis d. mun.;2011;68;460;174;286
Rokiškis d. mun.;2011;69;437;175;262
Rokiškis d. mun.;2011;70;411;162;249
Rokiškis d. mun.;2011;71;393;140;253
Rokiškis d. mun.;2011;72;393;145;248
Rokiškis d. mun.;2011;73;422;159;263
Rokiškis d. mun.;2011;74;460;159;301
Rokiškis d. mun.;2011;75;352;127;225
Rokiškis d. mun.;2011;76;394;119;275
Rokiškis d. mun.;2011;77;351;114;237
Rokiškis d. mun.;2011;78;373;113;260
Rokiškis d. mun.;2011;79;300;81;219
Rokiškis d. mun.;2011;80;292;83;209
Rokiškis d. mun.;2011;81;298;89;209
Rokiškis d. mun.;2011;82;288;75;213
Rokiškis d. mun.;2011;83;206;55;151
Rokiškis d. mun.;2011;84;214;56;158
Rokiškis d. mun.;2011;85;849;202;647
Rokiškis d. mun.;2012;-1;34218;15917;18301
Rokiškis d. mun.;2012;0;269;145;124
Rokiškis d. mun.;2012;1;256;121;135
Rokiškis d. mun.;2012;2;233;123;110
Rokiškis d. mun.;2012;3;254;134;120
Rokiškis d. mun.;2012;4;230;109;121
Rokiškis d. mun.;2012;5;248;126;122
Rokiškis d. mun.;2012;6;251;117;134
Rokiškis d. mun.;2012;7;284;149;135
Rokiškis d. mun.;2012;8;281;161;120
Rokiškis d. mun.;2012;9;283;136;147
Rokiškis d. mun.;2012;10;318;155;163
Rokiškis d. mun.;2012;11;319;179;140
Rokiškis d. mun.;2012;12;391;205;186
Rokiškis d. mun.;2012;13;347;178;169
Rokiškis d. mun.;2012;14;451;222;229
Rokiškis d. mun.;2012;15;429;197;232
Rokiškis d. mun.;2012;16;418;216;202
Rokiškis d. mun.;2012;17;464;218;246
Rokiškis d. mun.;2012;18;509;281;228
Rokiškis d. mun.;2012;19;615;322;293
Rokiškis d. mun.;2012;20;468;245;223
Rokiškis d. mun.;2012;21;412;221;191
Rokiškis d. mun.;2012;22;403;212;191
Rokiškis d. mun.;2012;23;409;229;180
Rokiškis d. mun.;2012;24;399;221;178
Rokiškis d. mun.;2012;25;370;218;152
Rokiškis d. mun.;2012;26;338;183;155
Rokiškis d. mun.;2012;27;317;175;142
Rokiškis d. mun.;2012;28;277;176;101
Rokiškis d. mun.;2012;29;317;184;133
Rokiškis d. mun.;2012;30;261;154;107
Rokiškis d. mun.;2012;31;278;157;121
Rokiškis d. mun.;2012;32;332;166;166
Rokiškis d. mun.;2012;33;266;126;140
Rokiškis d. mun.;2012;34;328;174;154
Rokiškis d. mun.;2012;35;376;190;186
Rokiškis d. mun.;2012;36;366;173;193
Rokiškis d. mun.;2012;37;426;200;226
Rokiškis d. mun.;2012;38;453;218;235
Rokiškis d. mun.;2012;39;486;250;236
Rokiškis d. mun.;2012;40;516;259;257
Rokiškis d. mun.;2012;41;533;266;267
Rokiškis d. mun.;2012;42;478;237;241
Rokiškis d. mun.;2012;43;507;240;267
Rokiškis d. mun.;2012;44;567;277;290
Rokiškis d. mun.;2012;45;542;285;257
Rokiškis d. mun.;2012;46;563;289;274
Rokiškis d. mun.;2012;47;538;251;287
Rokiškis d. mun.;2012;48;509;253;256
Rokiškis d. mun.;2012;49;556;290;266
Rokiškis d. mun.;2012;50;580;293;287
Rokiškis d. mun.;2012;51;645;319;326
Rokiškis d. mun.;2012;52;564;269;295
Rokiškis d. mun.;2012;53;533;260;273
Rokiškis d. mun.;2012;54;485;228;257
Rokiškis d. mun.;2012;55;499;248;251
Rokiškis d. mun.;2012;56;447;219;228
Rokiškis d. mun.;2012;57;442;222;220
Rokiškis d. mun.;2012;58;432;223;209
Rokiškis d. mun.;2012;59;455;199;256
Rokiškis d. mun.;2012;60;426;198;228
Rokiškis d. mun.;2012;61;404;176;228
Rokiškis d. mun.;2012;62;368;157;211
Rokiškis d. mun.;2012;63;348;145;203
Rokiškis d. mun.;2012;64;317;134;183
Rokiškis d. mun.;2012;65;306;140;166
Rokiškis d. mun.;2012;66;348;151;197
Rokiškis d. mun.;2012;67;329;144;185
Rokiškis d. mun.;2012;68;387;133;254
Rokiškis d. mun.;2012;69;444;163;281
Rokiškis d. mun.;2012;70;423;163;260
Rokiškis d. mun.;2012;71;391;148;243
Rokiškis d. mun.;2012;72;382;134;248
Rokiškis d. mun.;2012;73;380;137;243
Rokiškis d. mun.;2012;74;403;148;255
Rokiškis d. mun.;2012;75;449;157;292
Rokiškis d. mun.;2012;76;332;116;216
Rokiškis d. mun.;2012;77;375;111;264
Rokiškis d. mun.;2012;78;337;106;231
Rokiškis d. mun.;2012;79;350;106;244
Rokiškis d. mun.;2012;80;284;73;211
Rokiškis d. mun.;2012;81;274;76;198
Rokiškis d. mun.;2012;82;275;75;200
Rokiškis d. mun.;2012;83;273;68;205
Rokiškis d. mun.;2012;84;191;51;140
Rokiškis d. mun.;2012;85;899;214;685
Rokiškis d. mun.;2013;-1;33434;15537;17897
Rokiškis d. mun.;2013;0;228;99;129
Rokiškis d. mun.;2013;1;264;141;123
Rokiškis d. mun.;2013;2;252;118;134
Rokiškis d. mun.;2013;3;236;126;110
Rokiškis d. mun.;2013;4;258;138;120
Rokiškis d. mun.;2013;5;221;105;116
Rokiškis d. mun.;2013;6;244;127;117
Rokiškis d. mun.;2013;7;253;118;135
Rokiškis d. mun.;2013;8;275;145;130
Rokiškis d. mun.;2013;9;279;159;120
Rokiškis d. mun.;2013;10;281;134;147
Rokiškis d. mun.;2013;11;322;158;164
Rokiškis d. mun.;2013;12;319;180;139
Rokiškis d. mun.;2013;13;390;206;184
Rokiškis d. mun.;2013;14;345;177;168
Rokiškis d. mun.;2013;15;449;223;226
Rokiškis d. mun.;2013;16;427;197;230
Rokiškis d. mun.;2013;17;415;216;199
Rokiškis d. mun.;2013;18;459;215;244
Rokiškis d. mun.;2013;19;498;276;222
Rokiškis d. mun.;2013;20;600;316;284
Rokiškis d. mun.;2013;21;449;231;218
Rokiškis d. mun.;2013;22;389;208;181
Rokiškis d. mun.;2013;23;374;202;172
Rokiškis d. mun.;2013;24;370;212;158
Rokiškis d. mun.;2013;25;368;210;158
Rokiškis d. mun.;2013;26;354;213;141
Rokiškis d. mun.;2013;27;298;163;135
Rokiškis d. mun.;2013;28;284;164;120
Rokiškis d. mun.;2013;29;270;172;98
Rokiškis d. mun.;2013;30;307;175;132
Rokiškis d. mun.;2013;31;250;143;107
Rokiškis d. mun.;2013;32;268;151;117
Rokiškis d. mun.;2013;33;318;153;165
Rokiškis d. mun.;2013;34;261;125;136
Rokiškis d. mun.;2013;35;320;168;152
Rokiškis d. mun.;2013;36;366;184;182
Rokiškis d. mun.;2013;37;362;172;190
Rokiškis d. mun.;2013;38;421;192;229
Rokiškis d. mun.;2013;39;439;210;229
Rokiškis d. mun.;2013;40;478;245;233
Rokiškis d. mun.;2013;41;512;255;257
Rokiškis d. mun.;2013;42;526;264;262
Rokiškis d. mun.;2013;43;467;229;238
Rokiškis d. mun.;2013;44;507;240;267
Rokiškis d. mun.;2013;45;569;278;291
Rokiškis d. mun.;2013;46;534;281;253
Rokiškis d. mun.;2013;47;557;285;272
Rokiškis d. mun.;2013;48;530;245;285
Rokiškis d. mun.;2013;49;505;252;253
Rokiškis d. mun.;2013;50;556;289;267
Rokiškis d. mun.;2013;51;570;286;284
Rokiškis d. mun.;2013;52;642;316;326
Rokiškis d. mun.;2013;53;560;267;293
Rokiškis d. mun.;2013;54;528;254;274
Rokiškis d. mun.;2013;55;479;224;255
Rokiškis d. mun.;2013;56;492;245;247
Rokiškis d. mun.;2013;57;444;215;229
Rokiškis d. mun.;2013;58;433;217;216
Rokiškis d. mun.;2013;59;421;215;206
Rokiškis d. mun.;2013;60;448;196;252
Rokiškis d. mun.;2013;61;413;186;227
Rokiškis d. mun.;2013;62;393;168;225
Rokiškis d. mun.;2013;63;359;150;209
Rokiškis d. mun.;2013;64;342;140;202
Rokiškis d. mun.;2013;65;309;127;182
Rokiškis d. mun.;2013;66;302;135;167
Rokiškis d. mun.;2013;67;340;145;195
Rokiškis d. mun.;2013;68;320;137;183
Rokiškis d. mun.;2013;69;377;125;252
Rokiškis d. mun.;2013;70;433;160;273
Rokiškis d. mun.;2013;71;410;159;251
Rokiškis d. mun.;2013;72;379;140;239
Rokiškis d. mun.;2013;73;369;126;243
Rokiškis d. mun.;2013;74;370;131;239
Rokiškis d. mun.;2013;75;391;144;247
Rokiškis d. mun.;2013;76;423;149;274
Rokiškis d. mun.;2013;77;312;105;207
Rokiškis d. mun.;2013;78;363;107;256
Rokiškis d. mun.;2013;79;323;99;224
Rokiškis d. mun.;2013;80;334;98;236
Rokiškis d. mun.;2013;81;260;69;191
Rokiškis d. mun.;2013;82;248;68;180
Rokiškis d. mun.;2013;83;248;64;184
Rokiškis d. mun.;2013;84;250;63;187
Rokiškis d. mun.;2013;85;925;222;703
Rokiškis d. mun.;2014;-1;32748;15233;17515
Rokiškis d. mun.;2014;0;257;136;121
Rokiškis d. mun.;2014;1;232;98;134
Rokiškis d. mun.;2014;2;263;142;121
Rokiškis d. mun.;2014;3;243;110;133
Rokiškis d. mun.;2014;4;231;123;108
Rokiškis d. mun.;2014;5;253;130;123
Rokiškis d. mun.;2014;6;215;101;114
Rokiškis d. mun.;2014;7;245;126;119
Rokiškis d. mun.;2014;8;243;115;128
Rokiškis d. mun.;2014;9;280;148;132
Rokiškis d. mun.;2014;10;275;156;119
Rokiškis d. mun.;2014;11;279;135;144
Rokiškis d. mun.;2014;12;317;153;164
Rokiškis d. mun.;2014;13;315;176;139
Rokiškis d. mun.;2014;14;391;207;184
Rokiškis d. mun.;2014;15;344;178;166
Rokiškis d. mun.;2014;16;446;223;223
Rokiškis d. mun.;2014;17;425;195;230
Rokiškis d. mun.;2014;18;403;207;196
Rokiškis d. mun.;2014;19;452;212;240
Rokiškis d. mun.;2014;20;490;275;215
Rokiškis d. mun.;2014;21;592;310;282
Rokiškis d. mun.;2014;22;445;230;215
Rokiškis d. mun.;2014;23;363;203;160
Rokiškis d. mun.;2014;24;358;197;161
Rokiškis d. mun.;2014;25;356;212;144
Rokiškis d. mun.;2014;26;347;206;141
Rokiškis d. mun.;2014;27;332;201;131
Rokiškis d. mun.;2014;28;271;153;118
Rokiškis d. mun.;2014;29;252;149;103
Rokiškis d. mun.;2014;30;256;166;90
Rokiškis d. mun.;2014;31;288;168;120
Rokiškis d. mun.;2014;32;239;140;99
Rokiškis d. mun.;2014;33;258;144;114
Rokiškis d. mun.;2014;34;304;147;157
Rokiškis d. mun.;2014;35;250;119;131
Rokiškis d. mun.;2014;36;321;168;153
Rokiškis d. mun.;2014;37;366;184;182
Rokiškis d. mun.;2014;38;362;173;189
Rokiškis d. mun.;2014;39;414;188;226
Rokiškis d. mun.;2014;40;426;200;226
Rokiškis d. mun.;2014;41;470;238;232
Rokiškis d. mun.;2014;42;508;252;256
Rokiškis d. mun.;2014;43;520;259;261
Rokiškis d. mun.;2014;44;463;225;238
Rokiškis d. mun.;2014;45;506;244;262
Rokiškis d. mun.;2014;46;561;271;290
Rokiškis d. mun.;2014;47;527;278;249
Rokiškis d. mun.;2014;48;557;283;274
Rokiškis d. mun.;2014;49;530;242;288
Rokiškis d. mun.;2014;50;503;250;253
Rokiškis d. mun.;2014;51;553;286;267
Rokiškis d. mun.;2014;52;564;281;283
Rokiškis d. mun.;2014;53;636;312;324
Rokiškis d. mun.;2014;54;561;267;294
Rokiškis d. mun.;2014;55;526;252;274
Rokiškis d. mun.;2014;56;473;223;250
Rokiškis d. mun.;2014;57;485;237;248
Rokiškis d. mun.;2014;58;438;211;227
Rokiškis d. mun.;2014;59;431;215;216
Rokiškis d. mun.;2014;60;416;212;204
Rokiškis d. mun.;2014;61;436;188;248
Rokiškis d. mun.;2014;62;408;185;223
Rokiškis d. mun.;2014;63;383;163;220
Rokiškis d. mun.;2014;64;348;140;208
Rokiškis d. mun.;2014;65;334;135;199
Rokiškis d. mun.;2014;66;304;123;181
Rokiškis d. mun.;2014;67;293;128;165
Rokiškis d. mun.;2014;68;333;138;195
Rokiškis d. mun.;2014;69;314;133;181
Rokiškis d. mun.;2014;70;371;120;251
Rokiškis d. mun.;2014;71;420;154;266
Rokiškis d. mun.;2014;72;393;148;245
Rokiškis d. mun.;2014;73;365;129;236
Rokiškis d. mun.;2014;74;365;124;241
Rokiškis d. mun.;2014;75;353;121;232
Rokiškis d. mun.;2014;76;376;135;241
Rokiškis d. mun.;2014;77;412;143;269
Rokiškis d. mun.;2014;78;297;98;199
Rokiškis d. mun.;2014;79;343;99;244
Rokiškis d. mun.;2014;80;299;90;209
Rokiškis d. mun.;2014;81;309;89;220
Rokiškis d. mun.;2014;82;237;64;173
Rokiškis d. mun.;2014;83;227;62;165
Rokiškis d. mun.;2014;84;221;55;166
Rokiškis d. mun.;2014;85;980;227;753
Rokiškis d. mun.;2015;-1;32191;15025;17166
Rokiškis d. mun.;2015;0;269;146;123
Rokiškis d. mun.;2015;1;260;136;124
Rokiškis d. mun.;2015;2;229;95;134
Rokiškis d. mun.;2015;3;262;140;122
Rokiškis d. mun.;2015;4;239;110;129
Rokiškis d. mun.;2015;5;235;126;109
Rokiškis d. mun.;2015;6;253;130;123
Rokiškis d. mun.;2015;7;213;99;114
Rokiškis d. mun.;2015;8;242;125;117
Rokiškis d. mun.;2015;9;243;113;130
Rokiškis d. mun.;2015;10;276;146;130
Rokiškis d. mun.;2015;11;278;154;124
Rokiškis d. mun.;2015;12;282;135;147
Rokiškis d. mun.;2015;13;316;153;163
Rokiškis d. mun.;2015;14;311;174;137
Rokiškis d. mun.;2015;15;386;203;183
Rokiškis d. mun.;2015;16;340;178;162
Rokiškis d. mun.;2015;17;447;225;222
Rokiškis d. mun.;2015;18;425;195;230
Rokiškis d. mun.;2015;19;395;201;194
Rokiškis d. mun.;2015;20;437;205;232
Rokiškis d. mun.;2015;21;491;271;220
Rokiškis d. mun.;2015;22;572;304;268
Rokiškis d. mun.;2015;23;437;232;205
Rokiškis d. mun.;2015;24;346;198;148
Rokiškis d. mun.;2015;25;347;198;149
Rokiškis d. mun.;2015;26;344;211;133
Rokiškis d. mun.;2015;27;324;199;125
Rokiškis d. mun.;2015;28;325;205;120
Rokiškis d. mun.;2015;29;257;146;111
Rokiškis d. mun.;2015;30;233;140;93
Rokiškis d. mun.;2015;31;236;158;78
Rokiškis d. mun.;2015;32;278;167;111
Rokiškis d. mun.;2015;33;227;136;91
Rokiškis d. mun.;2015;34;254;144;110
Rokiškis d. mun.;2015;35;302;144;158
Rokiškis d. mun.;2015;36;250;116;134
Rokiškis d. mun.;2015;37;319;170;149
Rokiškis d. mun.;2015;38;361;181;180
Rokiškis d. mun.;2015;39;368;175;193
Rokiškis d. mun.;2015;40;408;185;223
Rokiškis d. mun.;2015;41;423;199;224
Rokiškis d. mun.;2015;42;471;241;230
Rokiškis d. mun.;2015;43;505;252;253
Rokiškis d. mun.;2015;44;518;261;257
Rokiškis d. mun.;2015;45;457;224;233
Rokiškis d. mun.;2015;46;508;244;264
Rokiškis d. mun.;2015;47;556;264;292
Rokiškis d. mun.;2015;48;520;273;247
Rokiškis d. mun.;2015;49;554;283;271
Rokiškis d. mun.;2015;50;526;239;287
Rokiškis d. mun.;2015;51;498;248;250
Rokiškis d. mun.;2015;52;549;283;266
Rokiškis d. mun.;2015;53;562;278;284
Rokiškis d. mun.;2015;54;630;306;324
Rokiškis d. mun.;2015;55;555;262;293
Rokiškis d. mun.;2015;56;523;254;269
Rokiškis d. mun.;2015;57;470;217;253
Rokiškis d. mun.;2015;58;481;233;248
Rokiškis d. mun.;2015;59;432;207;225
Rokiškis d. mun.;2015;60;423;209;214
Rokiškis d. mun.;2015;61;411;208;203
Rokiškis d. mun.;2015;62;427;183;244
Rokiškis d. mun.;2015;63;400;181;219
Rokiškis d. mun.;2015;64;380;161;219
Rokiškis d. mun.;2015;65;341;137;204
Rokiškis d. mun.;2015;66;329;134;195
Rokiškis d. mun.;2015;67;299;120;179
Rokiškis d. mun.;2015;68;287;126;161
Rokiškis d. mun.;2015;69;321;131;190
Rokiškis d. mun.;2015;70;304;128;176
Rokiškis d. mun.;2015;71;365;117;248
Rokiškis d. mun.;2015;72;409;145;264
Rokiškis d. mun.;2015;73;378;140;238
Rokiškis d. mun.;2015;74;355;119;236
Rokiškis d. mun.;2015;75;350;114;236
Rokiškis d. mun.;2015;76;338;114;224
Rokiškis d. mun.;2015;77;356;123;233
Rokiškis d. mun.;2015;78;387;130;257
Rokiškis d. mun.;2015;79;279;92;187
Rokiškis d. mun.;2015;80;315;89;226
Rokiškis d. mun.;2015;81;282;81;201
Rokiškis d. mun.;2015;82;285;74;211
Rokiškis d. mun.;2015;83;216;54;162
Rokiškis d. mun.;2015;84;201;53;148
Rokiškis d. mun.;2015;85;998;225;773
Rokiškis d. mun.;2016;-1;31454;14693;16761
Rokiškis d. mun.;2016;0;246;125;121
Rokiškis d. mun.;2016;1;269;147;122
Rokiškis d. mun.;2016;2;258;131;127
Rokiškis d. mun.;2016;3;227;93;134
Rokiškis d. mun.;2016;4;262;141;121
Rokiškis d. mun.;2016;5;239;113;126
Rokiškis d. mun.;2016;6;229;125;104
Rokiškis d. mun.;2016;7;251;128;123
Rokiškis d. mun.;2016;8;214;98;116
Rokiškis d. mun.;2016;9;238;123;115
Rokiškis d. mun.;2016;10;239;111;128
Rokiškis d. mun.;2016;11;276;146;130
Rokiškis d. mun.;2016;12;280;159;121
Rokiškis d. mun.;2016;13;280;134;146
Rokiškis d. mun.;2016;14;317;156;161
Rokiškis d. mun.;2016;15;304;171;133
Rokiškis d. mun.;2016;16;387;204;183
Rokiškis d. mun.;2016;17;336;177;159
Rokiškis d. mun.;2016;18;446;223;223
Rokiškis d. mun.;2016;19;411;186;225
Rokiškis d. mun.;2016;20;396;202;194
Rokiškis d. mun.;2016;21;436;208;228
Rokiškis d. mun.;2016;22;480;261;219
Rokiškis d. mun.;2016;23;552;293;259
Rokiškis d. mun.;2016;24;409;221;188
Rokiškis d. mun.;2016;25;313;182;131
Rokiškis d. mun.;2016;26;321;186;135
Rokiškis d. mun.;2016;27;321;199;122
Rokiškis d. mun.;2016;28;285;179;106
Rokiškis d. mun.;2016;29;310;202;108
Rokiškis d. mun.;2016;30;246;137;109
Rokiškis d. mun.;2016;31;214;126;88
Rokiškis d. mun.;2016;32;222;148;74
Rokiškis d. mun.;2016;33;263;160;103
Rokiškis d. mun.;2016;34;224;131;93
Rokiškis d. mun.;2016;35;242;136;106
Rokiškis d. mun.;2016;36;288;141;147
Rokiškis d. mun.;2016;37;241;111;130
Rokiškis d. mun.;2016;38;316;168;148
Rokiškis d. mun.;2016;39;355;176;179
Rokiškis d. mun.;2016;40;363;177;186
Rokiškis d. mun.;2016;41;402;181;221
Rokiškis d. mun.;2016;42;416;194;222
Rokiškis d. mun.;2016;43;475;246;229
Rokiškis d. mun.;2016;44;490;243;247
Rokiškis d. mun.;2016;45;510;259;251
Rokiškis d. mun.;2016;46;451;220;231
Rokiškis d. mun.;2016;47;499;240;259
Rokiškis d. mun.;2016;48;554;266;288
Rokiškis d. mun.;2016;49;516;268;248
Rokiškis d. mun.;2016;50;548;279;269
Rokiškis d. mun.;2016;51;521;237;284
Rokiškis d. mun.;2016;52;494;246;248
Rokiškis d. mun.;2016;53;544;283;261
Rokiškis d. mun.;2016;54;555;274;281
Rokiškis d. mun.;2016;55;622;300;322
Rokiškis d. mun.;2016;56;550;257;293
Rokiškis d. mun.;2016;57;513;247;266
Rokiškis d. mun.;2016;58;463;212;251
Rokiškis d. mun.;2016;59;475;228;247
Rokiškis d. mun.;2016;60;430;206;224
Rokiškis d. mun.;2016;61;414;203;211
Rokiškis d. mun.;2016;62;406;204;202
Rokiškis d. mun.;2016;63;420;178;242
Rokiškis d. mun.;2016;64;392;173;219
Rokiškis d. mun.;2016;65;367;153;214
Rokiškis d. mun.;2016;66;332;132;200
Rokiškis d. mun.;2016;67;320;128;192
Rokiškis d. mun.;2016;68;287;114;173
Rokiškis d. mun.;2016;69;279;120;159
Rokiškis d. mun.;2016;70;309;124;185
Rokiškis d. mun.;2016;71;295;124;171
Rokiškis d. mun.;2016;72;354;111;243
Rokiškis d. mun.;2016;73;393;135;258
Rokiškis d. mun.;2016;74;363;130;233
Rokiškis d. mun.;2016;75;341;112;229
Rokiškis d. mun.;2016;76;344;108;236
Rokiškis d. mun.;2016;77;316;106;210
Rokiškis d. mun.;2016;78;341;114;227
Rokiškis d. mun.;2016;79;370;124;246
Rokiškis d. mun.;2016;80;260;81;179
Rokiškis d. mun.;2016;81;298;84;214
Rokiškis d. mun.;2016;82;256;70;186
Rokiškis d. mun.;2016;83;261;68;193
Rokiškis d. mun.;2016;84;194;48;146
Rokiškis d. mun.;2016;85;1008;228;780
Rokiškis d. mun.;2017;-1;30451;14239;16212
Rokiškis d. mun.;2017;0;211;98;113
Rokiškis d. mun.;2017;1;244;126;118
Rokiškis d. mun.;2017;2;255;141;114
Rokiškis d. mun.;2017;3;254;129;125
Rokiškis d. mun.;2017;4;226;91;135
Rokiškis d. mun.;2017;5;258;141;117
Rokiškis d. mun.;2017;6;242;115;127
Rokiškis d. mun.;2017;7;225;120;105
Rokiškis d. mun.;2017;8;251;130;121
Rokiškis d. mun.;2017;9;212;98;114
Rokiškis d. mun.;2017;10;236;124;112
Rokiškis d. mun.;2017;11;234;108;126
Rokiškis d. mun.;2017;12;277;147;130
Rokiškis d. mun.;2017;13;279;157;122
Rokiškis d. mun.;2017;14;279;133;146
Rokiškis d. mun.;2017;15;317;156;161
Rokiškis d. mun.;2017;16;305;174;131
Rokiškis d. mun.;2017;17;385;204;181
Rokiškis d. mun.;2017;18;331;173;158
Rokiškis d. mun.;2017;19;428;216;212
Rokiškis d. mun.;2017;20;395;178;217
Rokiškis d. mun.;2017;21;381;192;189
Rokiškis d. mun.;2017;22;417;200;217
Rokiškis d. mun.;2017;23;454;250;204
Rokiškis d. mun.;2017;24;524;283;241
Rokiškis d. mun.;2017;25;373;211;162
Rokiškis d. mun.;2017;26;279;175;104
Rokiškis d. mun.;2017;27;283;165;118
Rokiškis d. mun.;2017;28;275;179;96
Rokiškis d. mun.;2017;29;239;154;85
Rokiškis d. mun.;2017;30;267;185;82
Rokiškis d. mun.;2017;31;222;129;93
Rokiškis d. mun.;2017;32;189;112;77
Rokiškis d. mun.;2017;33;196;130;66
Rokiškis d. mun.;2017;34;244;151;93
Rokiškis d. mun.;2017;35;200;117;83
Rokiškis d. mun.;2017;36;230;128;102
Rokiškis d. mun.;2017;37;269;132;137
Rokiškis d. mun.;2017;38;231;104;127
Rokiškis d. mun.;2017;39;308;157;151
Rokiškis d. mun.;2017;40;345;170;175
Rokiškis d. mun.;2017;41;360;173;187
Rokiškis d. mun.;2017;42;398;177;221
Rokiškis d. mun.;2017;43;409;190;219
Rokiškis d. mun.;2017;44;468;240;228
Rokiškis d. mun.;2017;45;487;240;247
Rokiškis d. mun.;2017;46;510;262;248
Rokiškis d. mun.;2017;47;454;222;232
Rokiškis d. mun.;2017;48;495;239;256
Rokiškis d. mun.;2017;49;539;257;282
Rokiškis d. mun.;2017;50;515;265;250
Rokiškis d. mun.;2017;51;542;273;269
Rokiškis d. mun.;2017;52;510;231;279
Rokiškis d. mun.;2017;53;484;244;240
Rokiškis d. mun.;2017;54;533;279;254
Rokiškis d. mun.;2017;55;554;273;281
Rokiškis d. mun.;2017;56;618;297;321
Rokiškis d. mun.;2017;57;540;249;291
Rokiškis d. mun.;2017;58;509;245;264
Rokiškis d. mun.;2017;59;454;207;247
Rokiškis d. mun.;2017;60;468;222;246
Rokiškis d. mun.;2017;61;420;197;223
Rokiškis d. mun.;2017;62;406;199;207
Rokiškis d. mun.;2017;63;399;199;200
Rokiškis d. mun.;2017;64;415;175;240
Rokiškis d. mun.;2017;65;379;163;216
Rokiškis d. mun.;2017;66;361;149;212
Rokiškis d. mun.;2017;67;322;125;197
Rokiškis d. mun.;2017;68;310;119;191
Rokiškis d. mun.;2017;69;284;115;169
Rokiškis d. mun.;2017;70;271;115;156
Rokiškis d. mun.;2017;71;301;121;180
Rokiškis d. mun.;2017;72;285;120;165
Rokiškis d. mun.;2017;73;337;104;233
Rokiškis d. mun.;2017;74;379;127;252
Rokiškis d. mun.;2017;75;346;118;228
Rokiškis d. mun.;2017;76;324;102;222
Rokiškis d. mun.;2017;77;327;100;227
Rokiškis d. mun.;2017;78;295;97;198
Rokiškis d. mun.;2017;79;331;112;219
Rokiškis d. mun.;2017;80;353;112;241
Rokiškis d. mun.;2017;81;246;77;169
Rokiškis d. mun.;2017;82;278;79;199
Rokiškis d. mun.;2017;83;242;66;176
Rokiškis d. mun.;2017;84;238;63;175
Rokiškis d. mun.;2017;85;985;217;768
Rokiškis d. mun.;2018;-1;29472;13818;15654
Rokiškis d. mun.;2018;0;222;115;107
Rokiškis d. mun.;2018;1;215;101;114
Rokiškis d. mun.;2018;2;241;124;117
Rokiškis d. mun.;2018;3;243;134;109
Rokiškis d. mun.;2018;4;250;126;124
Rokiškis d. mun.;2018;5;217;90;127
Rokiškis d. mun.;2018;6;250;136;114
Rokiškis d. mun.;2018;7;241;116;125
Rokiškis d. mun.;2018;8;222;119;103
Rokiškis d. mun.;2018;9;250;129;121
Rokiškis d. mun.;2018;10;211;99;112
Rokiškis d. mun.;2018;11;236;126;110
Rokiškis d. mun.;2018;12;232;107;125
Rokiškis d. mun.;2018;13;271;144;127
Rokiškis d. mun.;2018;14;273;153;120
Rokiškis d. mun.;2018;15;274;132;142
Rokiškis d. mun.;2018;16;314;155;159
Rokiškis d. mun.;2018;17;304;174;130
Rokiškis d. mun.;2018;18;375;198;177
Rokiškis d. mun.;2018;19;308;163;145
Rokiškis d. mun.;2018;20;404;200;204
Rokiškis d. mun.;2018;21;369;168;201
Rokiškis d. mun.;2018;22;365;183;182
Rokiškis d. mun.;2018;23;388;189;199
Rokiškis d. mun.;2018;24;431;241;190
Rokiškis d. mun.;2018;25;494;269;225
Rokiškis d. mun.;2018;26;323;194;129
Rokiškis d. mun.;2018;27;257;169;88
Rokiškis d. mun.;2018;28;255;153;102
Rokiškis d. mun.;2018;29;244;169;75
Rokiškis d. mun.;2018;30;207;135;72
Rokiškis d. mun.;2018;31;251;174;77
Rokiškis d. mun.;2018;32;191;113;78
Rokiškis d. mun.;2018;33;174;104;70
Rokiškis d. mun.;2018;34;180;119;61
Rokiškis d. mun.;2018;35;228;143;85
Rokiškis d. mun.;2018;36;194;114;80
Rokiškis d. mun.;2018;37;217;119;98
Rokiškis d. mun.;2018;38;263;128;135
Rokiškis d. mun.;2018;39;223;100;123
Rokiškis d. mun.;2018;40;292;150;142
Rokiškis d. mun.;2018;41;341;168;173
Rokiškis d. mun.;2018;42;355;166;189
Rokiškis d. mun.;2018;43;389;169;220
Rokiškis d. mun.;2018;44;412;192;220
Rokiškis d. mun.;2018;45;461;240;221
Rokiškis d. mun.;2018;46;475;230;245
Rokiškis d. mun.;2018;47;509;265;244
Rokiškis d. mun.;2018;48;450;218;232
Rokiškis d. mun.;2018;49;489;234;255
Rokiškis d. mun.;2018;50;525;251;274
Rokiškis d. mun.;2018;51;509;260;249
Rokiškis d. mun.;2018;52;538;272;266
Rokiškis d. mun.;2018;53;500;226;274
Rokiškis d. mun.;2018;54;487;247;240
Rokiškis d. mun.;2018;55;532;275;257
Rokiškis d. mun.;2018;56;548;269;279
Rokiškis d. mun.;2018;57;613;294;319
Rokiškis d. mun.;2018;58;528;242;286
Rokiškis d. mun.;2018;59;496;239;257
Rokiškis d. mun.;2018;60;447;205;242
Rokiškis d. mun.;2018;61;462;216;246
Rokiškis d. mun.;2018;62;410;191;219
Rokiškis d. mun.;2018;63;397;195;202
Rokiškis d. mun.;2018;64;392;194;198
Rokiškis d. mun.;2018;65;408;171;237
Rokiškis d. mun.;2018;66;365;154;211
Rokiškis d. mun.;2018;67;350;141;209
Rokiškis d. mun.;2018;68;317;121;196
Rokiškis d. mun.;2018;69;299;112;187
Rokiškis d. mun.;2018;70;276;111;165
Rokiškis d. mun.;2018;71;262;110;152
Rokiškis d. mun.;2018;72;289;114;175
Rokiškis d. mun.;2018;73;277;114;163
Rokiškis d. mun.;2018;74;317;94;223
Rokiškis d. mun.;2018;75;368;119;249
Rokiškis d. mun.;2018;76;332;109;223
Rokiškis d. mun.;2018;77;307;95;212
Rokiškis d. mun.;2018;78;308;93;215
Rokiškis d. mun.;2018;79;279;90;189
Rokiškis d. mun.;2018;80;319;109;210
Rokiškis d. mun.;2018;81;328;98;230
Rokiškis d. mun.;2018;82;224;66;158
Rokiškis d. mun.;2018;83;253;70;183
Rokiškis d. mun.;2018;84;223;59;164
Rokiškis d. mun.;2018;85;1007;235;772
Šakiai d. mun.;2001;-1;38788;18507;20281
Šakiai d. mun.;2001;0;451;228;223
Šakiai d. mun.;2001;1;456;244;212
Šakiai d. mun.;2001;2;475;258;217
Šakiai d. mun.;2001;3;452;239;213
Šakiai d. mun.;2001;4;497;246;251
Šakiai d. mun.;2001;5;509;263;246
Šakiai d. mun.;2001;6;541;279;262
Šakiai d. mun.;2001;7;595;293;302
Šakiai d. mun.;2001;8;632;313;319
Šakiai d. mun.;2001;9;638;323;315
Šakiai d. mun.;2001;10;665;343;322
Šakiai d. mun.;2001;11;625;309;316
Šakiai d. mun.;2001;12;628;323;305
Šakiai d. mun.;2001;13;655;354;301
Šakiai d. mun.;2001;14;663;347;316
Šakiai d. mun.;2001;15;657;358;299
Šakiai d. mun.;2001;16;573;290;283
Šakiai d. mun.;2001;17;582;294;288
Šakiai d. mun.;2001;18;543;285;258
Šakiai d. mun.;2001;19;419;241;178
Šakiai d. mun.;2001;20;371;233;138
Šakiai d. mun.;2001;21;388;219;169
Šakiai d. mun.;2001;22;383;208;175
Šakiai d. mun.;2001;23;433;239;194
Šakiai d. mun.;2001;24;411;226;185
Šakiai d. mun.;2001;25;448;231;217
Šakiai d. mun.;2001;26;461;240;221
Šakiai d. mun.;2001;27;460;209;251
Šakiai d. mun.;2001;28;480;245;235
Šakiai d. mun.;2001;29;524;273;251
Šakiai d. mun.;2001;30;502;251;251
Šakiai d. mun.;2001;31;524;253;271
Šakiai d. mun.;2001;32;537;267;270
Šakiai d. mun.;2001;33;524;274;250
Šakiai d. mun.;2001;34;537;264;273
Šakiai d. mun.;2001;35;529;268;261
Šakiai d. mun.;2001;36;514;282;232
Šakiai d. mun.;2001;37;557;293;264
Šakiai d. mun.;2001;38;590;312;278
Šakiai d. mun.;2001;39;594;326;268
Šakiai d. mun.;2001;40;630;348;282
Šakiai d. mun.;2001;41;579;283;296
Šakiai d. mun.;2001;42;538;275;263
Šakiai d. mun.;2001;43;494;257;237
Šakiai d. mun.;2001;44;483;245;238
Šakiai d. mun.;2001;45;443;213;230
Šakiai d. mun.;2001;46;404;224;180
Šakiai d. mun.;2001;47;398;195;203
Šakiai d. mun.;2001;48;379;197;182
Šakiai d. mun.;2001;49;383;211;172
Šakiai d. mun.;2001;50;424;207;217
Šakiai d. mun.;2001;51;406;205;201
Šakiai d. mun.;2001;52;337;158;179
Šakiai d. mun.;2001;53;336;147;189
Šakiai d. mun.;2001;54;300;138;162
Šakiai d. mun.;2001;55;357;172;185
Šakiai d. mun.;2001;56;296;130;166
Šakiai d. mun.;2001;57;410;164;246
Šakiai d. mun.;2001;58;489;212;277
Šakiai d. mun.;2001;59;518;223;295
Šakiai d. mun.;2001;60;501;207;294
Šakiai d. mun.;2001;61;407;164;243
Šakiai d. mun.;2001;62;424;194;230
Šakiai d. mun.;2001;63;417;180;237
Šakiai d. mun.;2001;64;469;203;266
Šakiai d. mun.;2001;65;405;171;234
Šakiai d. mun.;2001;66;481;213;268
Šakiai d. mun.;2001;67;506;205;301
Šakiai d. mun.;2001;68;493;182;311
Šakiai d. mun.;2001;69;437;159;278
Šakiai d. mun.;2001;70;500;189;311
Šakiai d. mun.;2001;71;458;182;276
Šakiai d. mun.;2001;72;411;145;266
Šakiai d. mun.;2001;73;341;119;222
Šakiai d. mun.;2001;74;317;91;226
Šakiai d. mun.;2001;75;318;99;219
Šakiai d. mun.;2001;76;287;84;203
Šakiai d. mun.;2001;77;260;71;189
Šakiai d. mun.;2001;78;255;77;178
Šakiai d. mun.;2001;79;174;59;115
Šakiai d. mun.;2001;80;187;62;125
Šakiai d. mun.;2001;81;156;44;112
Šakiai d. mun.;2001;82;118;25;93
Šakiai d. mun.;2001;83;107;33;74
Šakiai d. mun.;2001;84;105;29;76
Šakiai d. mun.;2001;85;627;173;454
Šakiai d. mun.;2002;-1;38438;18329;20109
Šakiai d. mun.;2002;0;398;206;192
Šakiai d. mun.;2002;1;448;225;223
Šakiai d. mun.;2002;2;454;239;215
Šakiai d. mun.;2002;3;471;256;215
Šakiai d. mun.;2002;4;456;237;219
Šakiai d. mun.;2002;5;495;243;252
Šakiai d. mun.;2002;6;509;264;245
Šakiai d. mun.;2002;7;537;280;257
Šakiai d. mun.;2002;8;595;295;300
Šakiai d. mun.;2002;9;628;308;320
Šakiai d. mun.;2002;10;633;319;314
Šakiai d. mun.;2002;11;658;341;317
Šakiai d. mun.;2002;12;618;306;312
Šakiai d. mun.;2002;13;620;319;301
Šakiai d. mun.;2002;14;646;349;297
Šakiai d. mun.;2002;15;651;340;311
Šakiai d. mun.;2002;16;652;355;297
Šakiai d. mun.;2002;17;563;287;276
Šakiai d. mun.;2002;18;570;290;280
Šakiai d. mun.;2002;19;523;280;243
Šakiai d. mun.;2002;20;405;233;172
Šakiai d. mun.;2002;21;372;233;139
Šakiai d. mun.;2002;22;379;214;165
Šakiai d. mun.;2002;23;386;205;181
Šakiai d. mun.;2002;24;422;230;192
Šakiai d. mun.;2002;25;404;221;183
Šakiai d. mun.;2002;26;434;220;214
Šakiai d. mun.;2002;27;452;234;218
Šakiai d. mun.;2002;28;447;200;247
Šakiai d. mun.;2002;29;468;240;228
Šakiai d. mun.;2002;30;516;270;246
Šakiai d. mun.;2002;31;488;246;242
Šakiai d. mun.;2002;32;521;247;274
Šakiai d. mun.;2002;33;524;259;265
Šakiai d. mun.;2002;34;513;266;247
Šakiai d. mun.;2002;35;524;254;270
Šakiai d. mun.;2002;36;523;267;256
Šakiai d. mun.;2002;37;504;274;230
Šakiai d. mun.;2002;38;547;285;262
Šakiai d. mun.;2002;39;572;301;271
Šakiai d. mun.;2002;40;583;317;266
Šakiai d. mun.;2002;41;626;346;280
Šakiai d. mun.;2002;42;577;283;294
Šakiai d. mun.;2002;43;536;274;262
Šakiai d. mun.;2002;44;489;255;234
Šakiai d. mun.;2002;45;474;239;235
Šakiai d. mun.;2002;46;437;209;228
Šakiai d. mun.;2002;47;408;226;182
Šakiai d. mun.;2002;48;390;193;197
Šakiai d. mun.;2002;49;372;193;179
Šakiai d. mun.;2002;50;379;207;172
Šakiai d. mun.;2002;51;419;204;215
Šakiai d. mun.;2002;52;401;200;201
Šakiai d. mun.;2002;53;331;154;177
Šakiai d. mun.;2002;54;332;147;185
Šakiai d. mun.;2002;55;299;140;159
Šakiai d. mun.;2002;56;348;169;179
Šakiai d. mun.;2002;57;291;129;162
Šakiai d. mun.;2002;58;398;159;239
Šakiai d. mun.;2002;59;475;203;272
Šakiai d. mun.;2002;60;509;218;291
Šakiai d. mun.;2002;61;494;204;290
Šakiai d. mun.;2002;62;407;167;240
Šakiai d. mun.;2002;63;417;187;230
Šakiai d. mun.;2002;64;411;174;237
Šakiai d. mun.;2002;65;462;200;262
Šakiai d. mun.;2002;66;398;166;232
Šakiai d. mun.;2002;67;473;205;268
Šakiai d. mun.;2002;68;503;200;303
Šakiai d. mun.;2002;69;485;178;307
Šakiai d. mun.;2002;70;430;156;274
Šakiai d. mun.;2002;71;488;181;307
Šakiai d. mun.;2002;72;448;177;271
Šakiai d. mun.;2002;73;401;141;260
Šakiai d. mun.;2002;74;328;112;216
Šakiai d. mun.;2002;75;305;87;218
Šakiai d. mun.;2002;76;309;95;214
Šakiai d. mun.;2002;77;273;76;197
Šakiai d. mun.;2002;78;252;68;184
Šakiai d. mun.;2002;79;244;71;173
Šakiai d. mun.;2002;80;165;56;109
Šakiai d. mun.;2002;81;177;57;120
Šakiai d. mun.;2002;82;136;42;94
Šakiai d. mun.;2002;83;109;22;87
Šakiai d. mun.;2002;84;97;32;65
Šakiai d. mun.;2002;85;626;172;454
Šakiai d. mun.;2003;-1;38158;18194;19964
Šakiai d. mun.;2003;0;380;195;185
Šakiai d. mun.;2003;1;396;208;188
Šakiai d. mun.;2003;2;445;224;221
Šakiai d. mun.;2003;3;451;237;214
Šakiai d. mun.;2003;4;467;254;213
Šakiai d. mun.;2003;5;451;235;216
Šakiai d. mun.;2003;6;493;244;249
Šakiai d. mun.;2003;7;506;263;243
Šakiai d. mun.;2003;8;536;281;255
Šakiai d. mun.;2003;9;595;295;300
Šakiai d. mun.;2003;10;622;308;314
Šakiai d. mun.;2003;11;629;318;311
Šakiai d. mun.;2003;12;649;336;313
Šakiai d. mun.;2003;13;608;301;307
Šakiai d. mun.;2003;14;611;313;298
Šakiai d. mun.;2003;15;635;343;292
Šakiai d. mun.;2003;16;639;335;304
Šakiai d. mun.;2003;17;638;344;294
Šakiai d. mun.;2003;18;562;285;277
Šakiai d. mun.;2003;19;560;280;280
Šakiai d. mun.;2003;20;519;277;242
Šakiai d. mun.;2003;21;407;235;172
Šakiai d. mun.;2003;22;372;233;139
Šakiai d. mun.;2003;23;381;213;168
Šakiai d. mun.;2003;24;391;210;181
Šakiai d. mun.;2003;25;421;233;188
Šakiai d. mun.;2003;26;399;220;179
Šakiai d. mun.;2003;27;426;216;210
Šakiai d. mun.;2003;28;438;224;214
Šakiai d. mun.;2003;29;439;194;245
Šakiai d. mun.;2003;30;460;237;223
Šakiai d. mun.;2003;31;502;263;239
Šakiai d. mun.;2003;32;482;242;240
Šakiai d. mun.;2003;33;518;244;274
Šakiai d. mun.;2003;34;525;259;266
Šakiai d. mun.;2003;35;509;264;245
Šakiai d. mun.;2003;36;518;251;267
Šakiai d. mun.;2003;37;521;262;259
Šakiai d. mun.;2003;38;502;273;229
Šakiai d. mun.;2003;39;544;282;262
Šakiai d. mun.;2003;40;568;301;267
Šakiai d. mun.;2003;41;579;314;265
Šakiai d. mun.;2003;42;621;343;278
Šakiai d. mun.;2003;43;574;283;291
Šakiai d. mun.;2003;44;535;276;259
Šakiai d. mun.;2003;45;492;257;235
Šakiai d. mun.;2003;46;462;233;229
Šakiai d. mun.;2003;47;435;208;227
Šakiai d. mun.;2003;48;397;222;175
Šakiai d. mun.;2003;49;388;192;196
Šakiai d. mun.;2003;50;367;190;177
Šakiai d. mun.;2003;51;369;200;169
Šakiai d. mun.;2003;52;417;200;217
Šakiai d. mun.;2003;53;401;200;201
Šakiai d. mun.;2003;54;329;151;178
Šakiai d. mun.;2003;55;322;142;180
Šakiai d. mun.;2003;56;296;139;157
Šakiai d. mun.;2003;57;344;165;179
Šakiai d. mun.;2003;58;289;128;161
Šakiai d. mun.;2003;59;398;158;240
Šakiai d. mun.;2003;60;470;198;272
Šakiai d. mun.;2003;61;499;213;286
Šakiai d. mun.;2003;62;485;197;288
Šakiai d. mun.;2003;63;401;166;235
Šakiai d. mun.;2003;64;412;183;229
Šakiai d. mun.;2003;65;409;171;238
Šakiai d. mun.;2003;66;457;196;261
Šakiai d. mun.;2003;67;389;160;229
Šakiai d. mun.;2003;68;467;198;269
Šakiai d. mun.;2003;69;489;191;298
Šakiai d. mun.;2003;70;477;173;304
Šakiai d. mun.;2003;71;414;150;264
Šakiai d. mun.;2003;72;474;174;300
Šakiai d. mun.;2003;73;437;170;267
Šakiai d. mun.;2003;74;381;132;249
Šakiai d. mun.;2003;75;315;104;211
Šakiai d. mun.;2003;76;292;80;212
Šakiai d. mun.;2003;77;292;88;204
Šakiai d. mun.;2003;78;260;66;194
Šakiai d. mun.;2003;79;234;60;174
Šakiai d. mun.;2003;80;230;70;160
Šakiai d. mun.;2003;81;155;50;105
Šakiai d. mun.;2003;82;164;51;113
Šakiai d. mun.;2003;83;121;35;86
Šakiai d. mun.;2003;84;105;24;81
Šakiai d. mun.;2003;85;599;161;438
Šakiai d. mun.;2004;-1;37575;17883;19692
Šakiai d. mun.;2004;0;366;201;165
Šakiai d. mun.;2004;1;374;192;182
Šakiai d. mun.;2004;2;388;203;185
Šakiai d. mun.;2004;3;437;220;217
Šakiai d. mun.;2004;4;446;234;212
Šakiai d. mun.;2004;5;457;250;207
Šakiai d. mun.;2004;6;447;233;214
Šakiai d. mun.;2004;7;484;240;244
Šakiai d. mun.;2004;8;499;260;239
Šakiai d. mun.;2004;9;532;279;253
Šakiai d. mun.;2004;10;588;289;299
Šakiai d. mun.;2004;11;614;302;312
Šakiai d. mun.;2004;12;620;312;308
Šakiai d. mun.;2004;13;636;330;306
Šakiai d. mun.;2004;14;597;296;301
Šakiai d. mun.;2004;15;599;310;289
Šakiai d. mun.;2004;16;621;336;285
Šakiai d. mun.;2004;17;629;329;300
Šakiai d. mun.;2004;18;624;340;284
Šakiai d. mun.;2004;19;550;277;273
Šakiai d. mun.;2004;20;550;279;271
Šakiai d. mun.;2004;21;503;271;232
Šakiai d. mun.;2004;22;393;225;168
Šakiai d. mun.;2004;23;360;229;131
Šakiai d. mun.;2004;24;378;208;170
Šakiai d. mun.;2004;25;388;210;178
Šakiai d. mun.;2004;26;412;227;185
Šakiai d. mun.;2004;27;386;215;171
Šakiai d. mun.;2004;28;418;204;214
Šakiai d. mun.;2004;29;427;222;205
Šakiai d. mun.;2004;30;421;182;239
Šakiai d. mun.;2004;31;448;231;217
Šakiai d. mun.;2004;32;491;259;232
Šakiai d. mun.;2004;33;476;238;238
Šakiai d. mun.;2004;34;509;239;270
Šakiai d. mun.;2004;35;514;254;260
Šakiai d. mun.;2004;36;495;256;239
Šakiai d. mun.;2004;37;509;245;264
Šakiai d. mun.;2004;38;507;252;255
Šakiai d. mun.;2004;39;488;265;223
Šakiai d. mun.;2004;40;533;276;257
Šakiai d. mun.;2004;41;560;301;259
Šakiai d. mun.;2004;42;569;311;258
Šakiai d. mun.;2004;43;613;337;276
Šakiai d. mun.;2004;44;563;275;288
Šakiai d. mun.;2004;45;535;274;261
Šakiai d. mun.;2004;46;481;248;233
Šakiai d. mun.;2004;47;457;232;225
Šakiai d. mun.;2004;48;435;206;229
Šakiai d. mun.;2004;49;394;219;175
Šakiai d. mun.;2004;50;379;187;192
Šakiai d. mun.;2004;51;357;180;177
Šakiai d. mun.;2004;52;366;198;168
Šakiai d. mun.;2004;53;416;198;218
Šakiai d. mun.;2004;54;402;202;200
Šakiai d. mun.;2004;55;324;147;177
Šakiai d. mun.;2004;56;316;138;178
Šakiai d. mun.;2004;57;292;135;157
Šakiai d. mun.;2004;58;337;161;176
Šakiai d. mun.;2004;59;284;124;160
Šakiai d. mun.;2004;60;396;154;242
Šakiai d. mun.;2004;61;466;194;272
Šakiai d. mun.;2004;62;486;204;282
Šakiai d. mun.;2004;63;479;193;286
Šakiai d. mun.;2004;64;396;162;234
Šakiai d. mun.;2004;65;404;176;228
Šakiai d. mun.;2004;66;395;161;234
Šakiai d. mun.;2004;67;445;188;257
Šakiai d. mun.;2004;68;378;155;223
Šakiai d. mun.;2004;69;451;187;264
Šakiai d. mun.;2004;70;468;178;290
Šakiai d. mun.;2004;71;468;166;302
Šakiai d. mun.;2004;72;395;140;255
Šakiai d. mun.;2004;73;465;169;296
Šakiai d. mun.;2004;74;414;152;262
Šakiai d. mun.;2004;75;367;122;245
Šakiai d. mun.;2004;76;299;95;204
Šakiai d. mun.;2004;77;281;76;205
Šakiai d. mun.;2004;78;279;85;194
Šakiai d. mun.;2004;79;252;60;192
Šakiai d. mun.;2004;80;213;50;163
Šakiai d. mun.;2004;81;223;68;155
Šakiai d. mun.;2004;82;142;44;98
Šakiai d. mun.;2004;83;147;45;102
Šakiai d. mun.;2004;84;115;32;83
Šakiai d. mun.;2004;85;557;134;423
Šakiai d. mun.;2005;-1;37004;17582;19422
Šakiai d. mun.;2005;0;323;155;168
Šakiai d. mun.;2005;1;367;201;166
Šakiai d. mun.;2005;2;371;190;181
Šakiai d. mun.;2005;3;384;203;181
Šakiai d. mun.;2005;4;431;217;214
Šakiai d. mun.;2005;5;447;235;212
Šakiai d. mun.;2005;6;452;247;205
Šakiai d. mun.;2005;7;446;233;213
Šakiai d. mun.;2005;8;485;241;244
Šakiai d. mun.;2005;9;497;259;238
Šakiai d. mun.;2005;10;534;279;255
Šakiai d. mun.;2005;11;587;288;299
Šakiai d. mun.;2005;12;609;298;311
Šakiai d. mun.;2005;13;618;308;310
Šakiai d. mun.;2005;14;630;328;302
Šakiai d. mun.;2005;15;582;286;296
Šakiai d. mun.;2005;16;586;303;283
Šakiai d. mun.;2005;17;611;329;282
Šakiai d. mun.;2005;18;616;319;297
Šakiai d. mun.;2005;19;613;330;283
Šakiai d. mun.;2005;20;534;272;262
Šakiai d. mun.;2005;21;533;268;265
Šakiai d. mun.;2005;22;486;264;222
Šakiai d. mun.;2005;23;380;222;158
Šakiai d. mun.;2005;24;351;225;126
Šakiai d. mun.;2005;25;365;199;166
Šakiai d. mun.;2005;26;368;204;164
Šakiai d. mun.;2005;27;403;228;175
Šakiai d. mun.;2005;28;382;212;170
Šakiai d. mun.;2005;29;414;206;208
Šakiai d. mun.;2005;30;409;212;197
Šakiai d. mun.;2005;31;409;179;230
Šakiai d. mun.;2005;32;436;224;212
Šakiai d. mun.;2005;33;479;251;228
Šakiai d. mun.;2005;34;470;235;235
Šakiai d. mun.;2005;35;498;233;265
Šakiai d. mun.;2005;36;504;252;252
Šakiai d. mun.;2005;37;487;253;234
Šakiai d. mun.;2005;38;499;237;262
Šakiai d. mun.;2005;39;505;251;254
Šakiai d. mun.;2005;40;483;260;223
Šakiai d. mun.;2005;41;526;274;252
Šakiai d. mun.;2005;42;554;297;257
Šakiai d. mun.;2005;43;557;302;255
Šakiai d. mun.;2005;44;610;336;274
Šakiai d. mun.;2005;45;556;272;284
Šakiai d. mun.;2005;46;534;272;262
Šakiai d. mun.;2005;47;474;244;230
Šakiai d. mun.;2005;48;449;225;224
Šakiai d. mun.;2005;49;424;197;227
Šakiai d. mun.;2005;50;384;212;172
Šakiai d. mun.;2005;51;369;179;190
Šakiai d. mun.;2005;52;346;172;174
Šakiai d. mun.;2005;53;357;192;165
Šakiai d. mun.;2005;54;412;196;216
Šakiai d. mun.;2005;55;397;200;197
Šakiai d. mun.;2005;56;326;147;179
Šakiai d. mun.;2005;57;310;135;175
Šakiai d. mun.;2005;58;292;134;158
Šakiai d. mun.;2005;59;329;153;176
Šakiai d. mun.;2005;60;280;122;158
Šakiai d. mun.;2005;61;392;151;241
Šakiai d. mun.;2005;62;454;186;268
Šakiai d. mun.;2005;63;477;195;282
Šakiai d. mun.;2005;64;471;190;281
Šakiai d. mun.;2005;65;390;157;233
Šakiai d. mun.;2005;66;398;171;227
Šakiai d. mun.;2005;67;389;159;230
Šakiai d. mun.;2005;68;436;182;254
Šakiai d. mun.;2005;69;364;144;220
Šakiai d. mun.;2005;70;434;177;257
Šakiai d. mun.;2005;71;460;175;285
Šakiai d. mun.;2005;72;447;152;295
Šakiai d. mun.;2005;73;387;138;249
Šakiai d. mun.;2005;74;440;154;286
Šakiai d. mun.;2005;75;396;142;254
Šakiai d. mun.;2005;76;351;114;237
Šakiai d. mun.;2005;77;282;88;194
Šakiai d. mun.;2005;78;263;69;194
Šakiai d. mun.;2005;79;259;79;180
Šakiai d. mun.;2005;80;230;50;180
Šakiai d. mun.;2005;81;195;46;149
Šakiai d. mun.;2005;82;203;58;145
Šakiai d. mun.;2005;83;129;38;91
Šakiai d. mun.;2005;84;137;41;96
Šakiai d. mun.;2005;85;550;129;421
Šakiai d. mun.;2006;-1;36073;17082;18991
Šakiai d. mun.;2006;0;273;154;119
Šakiai d. mun.;2006;1;315;149;166
Šakiai d. mun.;2006;2;360;195;165
Šakiai d. mun.;2006;3;360;181;179
Šakiai d. mun.;2006;4;378;197;181
Šakiai d. mun.;2006;5;428;216;212
Šakiai d. mun.;2006;6;440;232;208
Šakiai d. mun.;2006;7;451;246;205
Šakiai d. mun.;2006;8;440;231;209
Šakiai d. mun.;2006;9;481;238;243
Šakiai d. mun.;2006;10;495;258;237
Šakiai d. mun.;2006;11;530;275;255
Šakiai d. mun.;2006;12;581;285;296
Šakiai d. mun.;2006;13;594;289;305
Šakiai d. mun.;2006;14;612;304;308
Šakiai d. mun.;2006;15;613;320;293
Šakiai d. mun.;2006;16;562;272;290
Šakiai d. mun.;2006;17;576;296;280
Šakiai d. mun.;2006;18;591;318;273
Šakiai d. mun.;2006;19;589;304;285
Šakiai d. mun.;2006;20;582;316;266
Šakiai d. mun.;2006;21;500;252;248
Šakiai d. mun.;2006;22;507;257;250
Šakiai d. mun.;2006;23;461;254;207
Šakiai d. mun.;2006;24;362;208;154
Šakiai d. mun.;2006;25;317;200;117
Šakiai d. mun.;2006;26;347;186;161
Šakiai d. mun.;2006;27;352;193;159
Šakiai d. mun.;2006;28;376;212;164
Šakiai d. mun.;2006;29;369;203;166
Šakiai d. mun.;2006;30;404;202;202
Šakiai d. mun.;2006;31;398;207;191
Šakiai d. mun.;2006;32;392;167;225
Šakiai d. mun.;2006;33;416;214;202
Šakiai d. mun.;2006;34;453;236;217
Šakiai d. mun.;2006;35;456;226;230
Šakiai d. mun.;2006;36;487;228;259
Šakiai d. mun.;2006;37;487;243;244
Šakiai d. mun.;2006;38;472;241;231
Šakiai d. mun.;2006;39;489;229;260
Šakiai d. mun.;2006;40;489;244;245
Šakiai d. mun.;2006;41;479;258;221
Šakiai d. mun.;2006;42;514;269;245
Šakiai d. mun.;2006;43;543;291;252
Šakiai d. mun.;2006;44;543;295;248
Šakiai d. mun.;2006;45;607;334;273
Šakiai d. mun.;2006;46;552;270;282
Šakiai d. mun.;2006;47;532;268;264
Šakiai d. mun.;2006;48;477;245;232
Šakiai d. mun.;2006;49;444;218;226
Šakiai d. mun.;2006;50;411;188;223
Šakiai d. mun.;2006;51;379;209;170
Šakiai d. mun.;2006;52;364;177;187
Šakiai d. mun.;2006;53;338;165;173
Šakiai d. mun.;2006;54;346;183;163
Šakiai d. mun.;2006;55;412;196;216
Šakiai d. mun.;2006;56;387;195;192
Šakiai d. mun.;2006;57;319;143;176
Šakiai d. mun.;2006;58;304;130;174
Šakiai d. mun.;2006;59;288;130;158
Šakiai d. mun.;2006;60;317;148;169
Šakiai d. mun.;2006;61;276;119;157
Šakiai d. mun.;2006;62;383;144;239
Šakiai d. mun.;2006;63;447;182;265
Šakiai d. mun.;2006;64;467;191;276
Šakiai d. mun.;2006;65;463;183;280
Šakiai d. mun.;2006;66;377;147;230
Šakiai d. mun.;2006;67;389;163;226
Šakiai d. mun.;2006;68;381;153;228
Šakiai d. mun.;2006;69;423;169;254
Šakiai d. mun.;2006;70;351;137;214
Šakiai d. mun.;2006;71;427;172;255
Šakiai d. mun.;2006;72;438;159;279
Šakiai d. mun.;2006;73;415;138;277
Šakiai d. mun.;2006;74;373;130;243
Šakiai d. mun.;2006;75;417;143;274
Šakiai d. mun.;2006;76;373;130;243
Šakiai d. mun.;2006;77;328;102;226
Šakiai d. mun.;2006;78;268;85;183
Šakiai d. mun.;2006;79;245;62;183
Šakiai d. mun.;2006;80;240;70;170
Šakiai d. mun.;2006;81;206;42;164
Šakiai d. mun.;2006;82;180;43;137
Šakiai d. mun.;2006;83;187;54;133
Šakiai d. mun.;2006;84;120;36;84
Šakiai d. mun.;2006;85;558;138;420
Šakiai d. mun.;2007;-1;35435;16703;18732
Šakiai d. mun.;2007;0;315;164;151
Šakiai d. mun.;2007;1;270;151;119
Šakiai d. mun.;2007;2;315;149;166
Šakiai d. mun.;2007;3;349;190;159
Šakiai d. mun.;2007;4;357;180;177
Šakiai d. mun.;2007;5;369;192;177
Šakiai d. mun.;2007;6;422;212;210
Šakiai d. mun.;2007;7;438;229;209
Šakiai d. mun.;2007;8;448;244;204
Šakiai d. mun.;2007;9;438;229;209
Šakiai d. mun.;2007;10;478;237;241
Šakiai d. mun.;2007;11;493;256;237
Šakiai d. mun.;2007;12;530;277;253
Šakiai d. mun.;2007;13;581;285;296
Šakiai d. mun.;2007;14;585;286;299
Šakiai d. mun.;2007;15;607;304;303
Šakiai d. mun.;2007;16;608;318;290
Šakiai d. mun.;2007;17;561;273;288
Šakiai d. mun.;2007;18;571;292;279
Šakiai d. mun.;2007;19;592;316;276
Šakiai d. mun.;2007;20;580;297;283
Šakiai d. mun.;2007;21;565;306;259
Šakiai d. mun.;2007;22;480;238;242
Šakiai d. mun.;2007;23;482;244;238
Šakiai d. mun.;2007;24;431;239;192
Šakiai d. mun.;2007;25;339;200;139
Šakiai d. mun.;2007;26;296;186;110
Šakiai d. mun.;2007;27;329;175;154
Šakiai d. mun.;2007;28;345;191;154
Šakiai d. mun.;2007;29;366;202;164
Šakiai d. mun.;2007;30;352;193;159
Šakiai d. mun.;2007;31;398;198;200
Šakiai d. mun.;2007;32;387;197;190
Šakiai d. mun.;2007;33;381;160;221
Šakiai d. mun.;2007;34;408;207;201
Šakiai d. mun.;2007;35;442;232;210
Šakiai d. mun.;2007;36;446;218;228
Šakiai d. mun.;2007;37;477;223;254
Šakiai d. mun.;2007;38;480;239;241
Šakiai d. mun.;2007;39;463;236;227
Šakiai d. mun.;2007;40;483;223;260
Šakiai d. mun.;2007;41;480;236;244
Šakiai d. mun.;2007;42;470;254;216
Šakiai d. mun.;2007;43;510;264;246
Šakiai d. mun.;2007;44;532;285;247
Šakiai d. mun.;2007;45;525;281;244
Šakiai d. mun.;2007;46;598;328;270
Šakiai d. mun.;2007;47;540;262;278
Šakiai d. mun.;2007;48;536;268;268
Šakiai d. mun.;2007;49;470;239;231
Šakiai d. mun.;2007;50;436;214;222
Šakiai d. mun.;2007;51;399;179;220
Šakiai d. mun.;2007;52;375;205;170
Šakiai d. mun.;2007;53;363;176;187
Šakiai d. mun.;2007;54;332;159;173
Šakiai d. mun.;2007;55;337;174;163
Šakiai d. mun.;2007;56;409;193;216
Šakiai d. mun.;2007;57;381;188;193
Šakiai d. mun.;2007;58;311;138;173
Šakiai d. mun.;2007;59;296;123;173
Šakiai d. mun.;2007;60;283;126;157
Šakiai d. mun.;2007;61;305;137;168
Šakiai d. mun.;2007;62;271;116;155
Šakiai d. mun.;2007;63;373;137;236
Šakiai d. mun.;2007;64;438;176;262
Šakiai d. mun.;2007;65;448;177;271
Šakiai d. mun.;2007;66;451;172;279
Šakiai d. mun.;2007;67;379;148;231
Šakiai d. mun.;2007;68;381;155;226
Šakiai d. mun.;2007;69;371;146;225
Šakiai d. mun.;2007;70;412;161;251
Šakiai d. mun.;2007;71;332;125;207
Šakiai d. mun.;2007;72;410;162;248
Šakiai d. mun.;2007;73;428;153;275
Šakiai d. mun.;2007;74;400;129;271
Šakiai d. mun.;2007;75;354;125;229
Šakiai d. mun.;2007;76;401;137;264
Šakiai d. mun.;2007;77;358;122;236
Šakiai d. mun.;2007;78;316;99;217
Šakiai d. mun.;2007;79;253;78;175
Šakiai d. mun.;2007;80;233;59;174
Šakiai d. mun.;2007;81;215;60;155
Šakiai d. mun.;2007;82;183;32;151
Šakiai d. mun.;2007;83;162;37;125
Šakiai d. mun.;2007;84;168;45;123
Šakiai d. mun.;2007;85;553;135;418
Šakiai d. mun.;2008;-1;34784;16369;18415
Šakiai d. mun.;2008;0;268;136;132
Šakiai d. mun.;2008;1;312;162;150
Šakiai d. mun.;2008;2;271;152;119
Šakiai d. mun.;2008;3;312;147;165
Šakiai d. mun.;2008;4;346;188;158
Šakiai d. mun.;2008;5;354;179;175
Šakiai d. mun.;2008;6;366;192;174
Šakiai d. mun.;2008;7;422;210;212
Šakiai d. mun.;2008;8;436;227;209
Šakiai d. mun.;2008;9;444;242;202
Šakiai d. mun.;2008;10;436;228;208
Šakiai d. mun.;2008;11;473;234;239
Šakiai d. mun.;2008;12;486;254;232
Šakiai d. mun.;2008;13;531;275;256
Šakiai d. mun.;2008;14;581;286;295
Šakiai d. mun.;2008;15;581;282;299
Šakiai d. mun.;2008;16;606;304;302
Šakiai d. mun.;2008;17;602;315;287
Šakiai d. mun.;2008;18;549;270;279
Šakiai d. mun.;2008;19;555;284;271
Šakiai d. mun.;2008;20;579;312;267
Šakiai d. mun.;2008;21;563;290;273
Šakiai d. mun.;2008;22;548;296;252
Šakiai d. mun.;2008;23;466;233;233
Šakiai d. mun.;2008;24;468;238;230
Šakiai d. mun.;2008;25;419;231;188
Šakiai d. mun.;2008;26;328;190;138
Šakiai d. mun.;2008;27;283;177;106
Šakiai d. mun.;2008;28;316;165;151
Šakiai d. mun.;2008;29;338;185;153
Šakiai d. mun.;2008;30;357;200;157
Šakiai d. mun.;2008;31;339;188;151
Šakiai d. mun.;2008;32;382;190;192
Šakiai d. mun.;2008;33;381;194;187
Šakiai d. mun.;2008;34;374;157;217
Šakiai d. mun.;2008;35;393;193;200
Šakiai d. mun.;2008;36;430;224;206
Šakiai d. mun.;2008;37;434;209;225
Šakiai d. mun.;2008;38;470;217;253
Šakiai d. mun.;2008;39;471;231;240
Šakiai d. mun.;2008;40;456;231;225
Šakiai d. mun.;2008;41;476;217;259
Šakiai d. mun.;2008;42;473;234;239
Šakiai d. mun.;2008;43;459;249;210
Šakiai d. mun.;2008;44;498;258;240
Šakiai d. mun.;2008;45;521;277;244
Šakiai d. mun.;2008;46;520;278;242
Šakiai d. mun.;2008;47;591;322;269
Šakiai d. mun.;2008;48;532;256;276
Šakiai d. mun.;2008;49;530;263;267
Šakiai d. mun.;2008;50;459;231;228
Šakiai d. mun.;2008;51;434;214;220
Šakiai d. mun.;2008;52;392;176;216
Šakiai d. mun.;2008;53;368;202;166
Šakiai d. mun.;2008;54;355;169;186
Šakiai d. mun.;2008;55;326;156;170
Šakiai d. mun.;2008;56;323;166;157
Šakiai d. mun.;2008;57;400;189;211
Šakiai d. mun.;2008;58;378;185;193
Šakiai d. mun.;2008;59;303;132;171
Šakiai d. mun.;2008;60;290;121;169
Šakiai d. mun.;2008;61;278;121;157
Šakiai d. mun.;2008;62;301;135;166
Šakiai d. mun.;2008;63;265;110;155
Šakiai d. mun.;2008;64;359;128;231
Šakiai d. mun.;2008;65;428;169;259
Šakiai d. mun.;2008;66;445;177;268
Šakiai d. mun.;2008;67;443;171;272
Šakiai d. mun.;2008;68;373;141;232
Šakiai d. mun.;2008;69;371;150;221
Šakiai d. mun.;2008;70;351;135;216
Šakiai d. mun.;2008;71;405;156;249
Šakiai d. mun.;2008;72;320;115;205
Šakiai d. mun.;2008;73;396;154;242
Šakiai d. mun.;2008;74;415;144;271
Šakiai d. mun.;2008;75;377;119;258
Šakiai d. mun.;2008;76;338;117;221
Šakiai d. mun.;2008;77;382;129;253
Šakiai d. mun.;2008;78;328;108;220
Šakiai d. mun.;2008;79;286;85;201
Šakiai d. mun.;2008;80;230;69;161
Šakiai d. mun.;2008;81;214;52;162
Šakiai d. mun.;2008;82;193;51;142
Šakiai d. mun.;2008;83;166;29;137
Šakiai d. mun.;2008;84;149;35;114
Šakiai d. mun.;2008;85;617;156;461
Šakiai d. mun.;2009;-1;34110;16096;18014
Šakiai d. mun.;2009;0;292;156;136
Šakiai d. mun.;2009;1;266;134;132
Šakiai d. mun.;2009;2;310;162;148
Šakiai d. mun.;2009;3;269;152;117
Šakiai d. mun.;2009;4;300;137;163
Šakiai d. mun.;2009;5;346;189;157
Šakiai d. mun.;2009;6;349;175;174
Šakiai d. mun.;2009;7;361;191;170
Šakiai d. mun.;2009;8;413;206;207
Šakiai d. mun.;2009;9;432;226;206
Šakiai d. mun.;2009;10;438;238;200
Šakiai d. mun.;2009;11;425;221;204
Šakiai d. mun.;2009;12;469;232;237
Šakiai d. mun.;2009;13;486;255;231
Šakiai d. mun.;2009;14;524;271;253
Šakiai d. mun.;2009;15;577;285;292
Šakiai d. mun.;2009;16;580;284;296
Šakiai d. mun.;2009;17;600;301;299
Šakiai d. mun.;2009;18;594;313;281
Šakiai d. mun.;2009;19;544;266;278
Šakiai d. mun.;2009;20;547;280;267
Šakiai d. mun.;2009;21;567;309;258
Šakiai d. mun.;2009;22;554;288;266
Šakiai d. mun.;2009;23;527;285;242
Šakiai d. mun.;2009;24;459;229;230
Šakiai d. mun.;2009;25;453;236;217
Šakiai d. mun.;2009;26;389;220;169
Šakiai d. mun.;2009;27;309;182;127
Šakiai d. mun.;2009;28;269;171;98
Šakiai d. mun.;2009;29;289;149;140
Šakiai d. mun.;2009;30;322;179;143
Šakiai d. mun.;2009;31;342;190;152
Šakiai d. mun.;2009;32;335;184;151
Šakiai d. mun.;2009;33;366;184;182
Šakiai d. mun.;2009;34;373;190;183
Šakiai d. mun.;2009;35;361;151;210
Šakiai d. mun.;2009;36;386;192;194
Šakiai d. mun.;2009;37;421;221;200
Šakiai d. mun.;2009;38;423;204;219
Šakiai d. mun.;2009;39;465;216;249
Šakiai d. mun.;2009;40;463;227;236
Šakiai d. mun.;2009;41;449;225;224
Šakiai d. mun.;2009;42;471;217;254
Šakiai d. mun.;2009;43;468;233;235
Šakiai d. mun.;2009;44;453;246;207
Šakiai d. mun.;2009;45;492;255;237
Šakiai d. mun.;2009;46;516;271;245
Šakiai d. mun.;2009;47;513;271;242
Šakiai d. mun.;2009;48;585;318;267
Šakiai d. mun.;2009;49;526;254;272
Šakiai d. mun.;2009;50;523;258;265
Šakiai d. mun.;2009;51;459;232;227
Šakiai d. mun.;2009;52;424;210;214
Šakiai d. mun.;2009;53;391;178;213
Šakiai d. mun.;2009;54;362;200;162
Šakiai d. mun.;2009;55;348;165;183
Šakiai d. mun.;2009;56;317;149;168
Šakiai d. mun.;2009;57;313;160;153
Šakiai d. mun.;2009;58;391;186;205
Šakiai d. mun.;2009;59;369;178;191
Šakiai d. mun.;2009;60;295;123;172
Šakiai d. mun.;2009;61;288;121;167
Šakiai d. mun.;2009;62;269;117;152
Šakiai d. mun.;2009;63;296;130;166
Šakiai d. mun.;2009;64;260;105;155
Šakiai d. mun.;2009;65;350;122;228
Šakiai d. mun.;2009;66;419;162;257
Šakiai d. mun.;2009;67;432;169;263
Šakiai d. mun.;2009;68;429;163;266
Šakiai d. mun.;2009;69;353;131;222
Šakiai d. mun.;2009;70;362;142;220
Šakiai d. mun.;2009;71;349;138;211
Šakiai d. mun.;2009;72;385;149;236
Šakiai d. mun.;2009;73;306;108;198
Šakiai d. mun.;2009;74;380;146;234
Šakiai d. mun.;2009;75;399;136;263
Šakiai d. mun.;2009;76;356;110;246
Šakiai d. mun.;2009;77;320;111;209
Šakiai d. mun.;2009;78;353;120;233
Šakiai d. mun.;2009;79;309;100;209
Šakiai d. mun.;2009;80;270;78;192
Šakiai d. mun.;2009;81;210;64;146
Šakiai d. mun.;2009;82;204;48;156
Šakiai d. mun.;2009;83;173;42;131
Šakiai d. mun.;2009;84;147;24;123
Šakiai d. mun.;2009;85;631;150;481
Šakiai d. mun.;2010;-1;33486;15779;17707
Šakiai d. mun.;2010;0;301;155;146
Šakiai d. mun.;2010;1;282;148;134
Šakiai d. mun.;2010;2;258;130;128
Šakiai d. mun.;2010;3;305;160;145
Šakiai d. mun.;2010;4;268;153;115
Šakiai d. mun.;2010;5;295;135;160
Šakiai d. mun.;2010;6;336;182;154
Šakiai d. mun.;2010;7;344;171;173
Šakiai d. mun.;2010;8;353;184;169
Šakiai d. mun.;2010;9;409;206;203
Šakiai d. mun.;2010;10;430;225;205
Šakiai d. mun.;2010;11;432;236;196
Šakiai d. mun.;2010;12;426;221;205
Šakiai d. mun.;2010;13;465;231;234
Šakiai d. mun.;2010;14;484;253;231
Šakiai d. mun.;2010;15;522;270;252
Šakiai d. mun.;2010;16;572;285;287
Šakiai d. mun.;2010;17;573;280;293
Šakiai d. mun.;2010;18;598;298;300
Šakiai d. mun.;2010;19;590;312;278
Šakiai d. mun.;2010;20;529;255;274
Šakiai d. mun.;2010;21;532;272;260
Šakiai d. mun.;2010;22;553;300;253
Šakiai d. mun.;2010;23;531;277;254
Šakiai d. mun.;2010;24;503;273;230
Šakiai d. mun.;2010;25;442;223;219
Šakiai d. mun.;2010;26;431;228;203
Šakiai d. mun.;2010;27;374;212;162
Šakiai d. mun.;2010;28;292;173;119
Šakiai d. mun.;2010;29;252;162;90
Šakiai d. mun.;2010;30;278;143;135
Šakiai d. mun.;2010;31;312;175;137
Šakiai d. mun.;2010;32;329;183;146
Šakiai d. mun.;2010;33;325;178;147
Šakiai d. mun.;2010;34;358;178;180
Šakiai d. mun.;2010;35;363;185;178
Šakiai d. mun.;2010;36;358;150;208
Šakiai d. mun.;2010;37;381;188;193
Šakiai d. mun.;2010;38;417;219;198
Šakiai d. mun.;2010;39;419;202;217
Šakiai d. mun.;2010;40;452;209;243
Šakiai d. mun.;2010;41;456;223;233
Šakiai d. mun.;2010;42;442;220;222
Šakiai d. mun.;2010;43;465;214;251
Šakiai d. mun.;2010;44;460;226;234
Šakiai d. mun.;2010;45;451;245;206
Šakiai d. mun.;2010;46;479;246;233
Šakiai d. mun.;2010;47;510;267;243
Šakiai d. mun.;2010;48;507;267;240
Šakiai d. mun.;2010;49;576;313;263
Šakiai d. mun.;2010;50;520;250;270
Šakiai d. mun.;2010;51;513;253;260
Šakiai d. mun.;2010;52;450;225;225
Šakiai d. mun.;2010;53;415;202;213
Šakiai d. mun.;2010;54;390;176;214
Šakiai d. mun.;2010;55;354;195;159
Šakiai d. mun.;2010;56;346;165;181
Šakiai d. mun.;2010;57;311;145;166
Šakiai d. mun.;2010;58;306;157;149
Šakiai d. mun.;2010;59;379;179;200
Šakiai d. mun.;2010;60;362;171;191
Šakiai d. mun.;2010;61;293;124;169
Šakiai d. mun.;2010;62;287;120;167
Šakiai d. mun.;2010;63;263;115;148
Šakiai d. mun.;2010;64;292;127;165
Šakiai d. mun.;2010;65;253;99;154
Šakiai d. mun.;2010;66;333;114;219
Šakiai d. mun.;2010;67;395;147;248
Šakiai d. mun.;2010;68;415;158;257
Šakiai d. mun.;2010;69;427;161;266
Šakiai d. mun.;2010;70;341;126;215
Šakiai d. mun.;2010;71;351;135;216
Šakiai d. mun.;2010;72;334;124;210
Šakiai d. mun.;2010;73;376;142;234
Šakiai d. mun.;2010;74;294;100;194
Šakiai d. mun.;2010;75;365;140;225
Šakiai d. mun.;2010;76;380;129;251
Šakiai d. mun.;2010;77;342;101;241
Šakiai d. mun.;2010;78;300;101;199
Šakiai d. mun.;2010;79;340;112;228
Šakiai d. mun.;2010;80;290;94;196
Šakiai d. mun.;2010;81;252;74;178
Šakiai d. mun.;2010;82;196;56;140
Šakiai d. mun.;2010;83;181;39;142
Šakiai d. mun.;2010;84;157;39;118
Šakiai d. mun.;2010;85;663;143;520
Šakiai d. mun.;2011;-1;32590;15339;17251
Šakiai d. mun.;2011;0;238;108;130
Šakiai d. mun.;2011;1;267;137;130
Šakiai d. mun.;2011;2;265;139;126
Šakiai d. mun.;2011;3;240;125;115
Šakiai d. mun.;2011;4;301;158;143
Šakiai d. mun.;2011;5;250;135;115
Šakiai d. mun.;2011;6;284;137;147
Šakiai d. mun.;2011;7;326;171;155
Šakiai d. mun.;2011;8;340;176;164
Šakiai d. mun.;2011;9;353;171;182
Šakiai d. mun.;2011;10;410;204;206
Šakiai d. mun.;2011;11;427;221;206
Šakiai d. mun.;2011;12;445;236;209
Šakiai d. mun.;2011;13;430;238;192
Šakiai d. mun.;2011;14;458;235;223
Šakiai d. mun.;2011;15;480;241;239
Šakiai d. mun.;2011;16;527;273;254
Šakiai d. mun.;2011;17;572;284;288
Šakiai d. mun.;2011;18;584;294;290
Šakiai d. mun.;2011;19;513;264;249
Šakiai d. mun.;2011;20;515;277;238
Šakiai d. mun.;2011;21;434;225;209
Šakiai d. mun.;2011;22;426;229;197
Šakiai d. mun.;2011;23;438;240;198
Šakiai d. mun.;2011;24;417;247;170
Šakiai d. mun.;2011;25;364;198;166
Šakiai d. mun.;2011;26;323;169;154
Šakiai d. mun.;2011;27;318;187;131
Šakiai d. mun.;2011;28;335;171;164
Šakiai d. mun.;2011;29;308;149;159
Šakiai d. mun.;2011;30;272;157;115
Šakiai d. mun.;2011;31;314;160;154
Šakiai d. mun.;2011;32;324;168;156
Šakiai d. mun.;2011;33;356;183;173
Šakiai d. mun.;2011;34;326;166;160
Šakiai d. mun.;2011;35;375;182;193
Šakiai d. mun.;2011;36;389;202;187
Šakiai d. mun.;2011;37;392;176;216
Šakiai d. mun.;2011;38;421;216;205
Šakiai d. mun.;2011;39;456;223;233
Šakiai d. mun.;2011;40;437;211;226
Šakiai d. mun.;2011;41;469;223;246
Šakiai d. mun.;2011;42;484;228;256
Šakiai d. mun.;2011;43;458;232;226
Šakiai d. mun.;2011;44;489;237;252
Šakiai d. mun.;2011;45;472;227;245
Šakiai d. mun.;2011;46;476;255;221
Šakiai d. mun.;2011;47;501;257;244
Šakiai d. mun.;2011;48;518;268;250
Šakiai d. mun.;2011;49;517;267;250
Šakiai d. mun.;2011;50;568;306;262
Šakiai d. mun.;2011;51;515;253;262
Šakiai d. mun.;2011;52;494;241;253
Šakiai d. mun.;2011;53;432;217;215
Šakiai d. mun.;2011;54;424;204;220
Šakiai d. mun.;2011;55;391;173;218
Šakiai d. mun.;2011;56;350;187;163
Šakiai d. mun.;2011;57;356;164;192
Šakiai d. mun.;2011;58;324;154;170
Šakiai d. mun.;2011;59;317;160;157
Šakiai d. mun.;2011;60;365;168;197
Šakiai d. mun.;2011;61;354;162;192
Šakiai d. mun.;2011;62;287;118;169
Šakiai d. mun.;2011;63;293;118;175
Šakiai d. mun.;2011;64;255;107;148
Šakiai d. mun.;2011;65;309;141;168
Šakiai d. mun.;2011;66;254;96;158
Šakiai d. mun.;2011;67;337;118;219
Šakiai d. mun.;2011;68;385;139;246
Šakiai d. mun.;2011;69;410;161;249
Šakiai d. mun.;2011;70;425;168;257
Šakiai d. mun.;2011;71;335;128;207
Šakiai d. mun.;2011;72;330;125;205
Šakiai d. mun.;2011;73;337;126;211
Šakiai d. mun.;2011;74;358;131;227
Šakiai d. mun.;2011;75;287;91;196
Šakiai d. mun.;2011;76;347;133;214
Šakiai d. mun.;2011;77;360;124;236
Šakiai d. mun.;2011;78;314;91;223
Šakiai d. mun.;2011;79;283;94;189
Šakiai d. mun.;2011;80;311;98;213
Šakiai d. mun.;2011;81;263;80;183
Šakiai d. mun.;2011;82;226;61;165
Šakiai d. mun.;2011;83;174;50;124
Šakiai d. mun.;2011;84;159;35;124
Šakiai d. mun.;2011;85;627;140;487
Šakiai d. mun.;2012;-1;32026;15099;16927
Šakiai d. mun.;2012;0;314;169;145
Šakiai d. mun.;2012;1;231;105;126
Šakiai d. mun.;2012;2;260;134;126
Šakiai d. mun.;2012;3;260;139;121
Šakiai d. mun.;2012;4;236;123;113
Šakiai d. mun.;2012;5;301;159;142
Šakiai d. mun.;2012;6;250;135;115
Šakiai d. mun.;2012;7;286;139;147
Šakiai d. mun.;2012;8;326;172;154
Šakiai d. mun.;2012;9;338;171;167
Šakiai d. mun.;2012;10;353;171;182
Šakiai d. mun.;2012;11;408;204;204
Šakiai d. mun.;2012;12;426;220;206
Šakiai d. mun.;2012;13;443;233;210
Šakiai d. mun.;2012;14;430;238;192
Šakiai d. mun.;2012;15;456;234;222
Šakiai d. mun.;2012;16;477;241;236
Šakiai d. mun.;2012;17;519;270;249
Šakiai d. mun.;2012;18;563;280;283
Šakiai d. mun.;2012;19;565;286;279
Šakiai d. mun.;2012;20;494;256;238
Šakiai d. mun.;2012;21;503;270;233
Šakiai d. mun.;2012;22;423;220;203
Šakiai d. mun.;2012;23;404;225;179
Šakiai d. mun.;2012;24;408;222;186
Šakiai d. mun.;2012;25;390;236;154
Šakiai d. mun.;2012;26;323;177;146
Šakiai d. mun.;2012;27;311;167;144
Šakiai d. mun.;2012;28;304;177;127
Šakiai d. mun.;2012;29;314;156;158
Šakiai d. mun.;2012;30;298;144;154
Šakiai d. mun.;2012;31;260;152;108
Šakiai d. mun.;2012;32;307;155;152
Šakiai d. mun.;2012;33;321;165;156
Šakiai d. mun.;2012;34;339;176;163
Šakiai d. mun.;2012;35;306;155;151
Šakiai d. mun.;2012;36;373;176;197
Šakiai d. mun.;2012;37;376;195;181
Šakiai d. mun.;2012;38;389;178;211
Šakiai d. mun.;2012;39;417;215;202
Šakiai d. mun.;2012;40;448;219;229
Šakiai d. mun.;2012;41;435;209;226
Šakiai d. mun.;2012;42;467;222;245
Šakiai d. mun.;2012;43;484;225;259
Šakiai d. mun.;2012;44;455;227;228
Šakiai d. mun.;2012;45;484;236;248
Šakiai d. mun.;2012;46;467;223;244
Šakiai d. mun.;2012;47;475;254;221
Šakiai d. mun.;2012;48;493;253;240
Šakiai d. mun.;2012;49;506;259;247
Šakiai d. mun.;2012;50;511;264;247
Šakiai d. mun.;2012;51;558;297;261
Šakiai d. mun.;2012;52;509;249;260
Šakiai d. mun.;2012;53;489;238;251
Šakiai d. mun.;2012;54;430;216;214
Šakiai d. mun.;2012;55;414;197;217
Šakiai d. mun.;2012;56;386;168;218
Šakiai d. mun.;2012;57;350;186;164
Šakiai d. mun.;2012;58;347;156;191
Šakiai d. mun.;2012;59;323;151;172
Šakiai d. mun.;2012;60;313;157;156
Šakiai d. mun.;2012;61;364;166;198
Šakiai d. mun.;2012;62;343;158;185
Šakiai d. mun.;2012;63;282;117;165
Šakiai d. mun.;2012;64;289;117;172
Šakiai d. mun.;2012;65;249;102;147
Šakiai d. mun.;2012;66;303;138;165
Šakiai d. mun.;2012;67;246;91;155
Šakiai d. mun.;2012;68;328;115;213
Šakiai d. mun.;2012;69;373;131;242
Šakiai d. mun.;2012;70;397;154;243
Šakiai d. mun.;2012;71;414;162;252
Šakiai d. mun.;2012;72;326;123;203
Šakiai d. mun.;2012;73;323;123;200
Šakiai d. mun.;2012;74;330;121;209
Šakiai d. mun.;2012;75;342;122;220
Šakiai d. mun.;2012;76;278;84;194
Šakiai d. mun.;2012;77;333;126;207
Šakiai d. mun.;2012;78;336;115;221
Šakiai d. mun.;2012;79;291;83;208
Šakiai d. mun.;2012;80;270;89;181
Šakiai d. mun.;2012;81;287;93;194
Šakiai d. mun.;2012;82;245;74;171
Šakiai d. mun.;2012;83;206;58;148
Šakiai d. mun.;2012;84;164;46;118
Šakiai d. mun.;2012;85;661;145;516
Šakiai d. mun.;2013;-1;31402;14811;16591
Šakiai d. mun.;2013;0;302;152;150
Šakiai d. mun.;2013;1;310;168;142
Šakiai d. mun.;2013;2;217;99;118
Šakiai d. mun.;2013;3;252;131;121
Šakiai d. mun.;2013;4;254;132;122
Šakiai d. mun.;2013;5;233;120;113
Šakiai d. mun.;2013;6;300;159;141
Šakiai d. mun.;2013;7;245;134;111
Šakiai d. mun.;2013;8;288;140;148
Šakiai d. mun.;2013;9;324;172;152
Šakiai d. mun.;2013;10;332;168;164
Šakiai d. mun.;2013;11;348;168;180
Šakiai d. mun.;2013;12;409;203;206
Šakiai d. mun.;2013;13;423;218;205
Šakiai d. mun.;2013;14;442;232;210
Šakiai d. mun.;2013;15;429;237;192
Šakiai d. mun.;2013;16;453;231;222
Šakiai d. mun.;2013;17;476;242;234
Šakiai d. mun.;2013;18;518;270;248
Šakiai d. mun.;2013;19;550;273;277
Šakiai d. mun.;2013;20;552;279;273
Šakiai d. mun.;2013;21;485;252;233
Šakiai d. mun.;2013;22;488;258;230
Šakiai d. mun.;2013;23;395;206;189
Šakiai d. mun.;2013;24;382;215;167
Šakiai d. mun.;2013;25;391;217;174
Šakiai d. mun.;2013;26;376;232;144
Šakiai d. mun.;2013;27;295;165;130
Šakiai d. mun.;2013;28;291;159;132
Šakiai d. mun.;2013;29;284;166;118
Šakiai d. mun.;2013;30;296;149;147
Šakiai d. mun.;2013;31;280;138;142
Šakiai d. mun.;2013;32;253;149;104
Šakiai d. mun.;2013;33;299;149;150
Šakiai d. mun.;2013;34;318;164;154
Šakiai d. mun.;2013;35;328;171;157
Šakiai d. mun.;2013;36;290;145;145
Šakiai d. mun.;2013;37;365;172;193
Šakiai d. mun.;2013;38;376;197;179
Šakiai d. mun.;2013;39;377;171;206
Šakiai d. mun.;2013;40;411;208;203
Šakiai d. mun.;2013;41;440;213;227
Šakiai d. mun.;2013;42;431;207;224
Šakiai d. mun.;2013;43;463;218;245
Šakiai d. mun.;2013;44;476;223;253
Šakiai d. mun.;2013;45;447;222;225
Šakiai d. mun.;2013;46;480;235;245
Šakiai d. mun.;2013;47;460;218;242
Šakiai d. mun.;2013;48;473;253;220
Šakiai d. mun.;2013;49;493;252;241
Šakiai d. mun.;2013;50;506;257;249
Šakiai d. mun.;2013;51;503;258;245
Šakiai d. mun.;2013;52;553;290;263
Šakiai d. mun.;2013;53;507;246;261
Šakiai d. mun.;2013;54;484;235;249
Šakiai d. mun.;2013;55;427;214;213
Šakiai d. mun.;2013;56;409;197;212
Šakiai d. mun.;2013;57;375;160;215
Šakiai d. mun.;2013;58;340;177;163
Šakiai d. mun.;2013;59;342;152;190
Šakiai d. mun.;2013;60;316;144;172
Šakiai d. mun.;2013;61;301;153;148
Šakiai d. mun.;2013;62;357;159;198
Šakiai d. mun.;2013;63;330;149;181
Šakiai d. mun.;2013;64;275;111;164
Šakiai d. mun.;2013;65;285;116;169
Šakiai d. mun.;2013;66;242;98;144
Šakiai d. mun.;2013;67;298;134;164
Šakiai d. mun.;2013;68;243;89;154
Šakiai d. mun.;2013;69;325;112;213
Šakiai d. mun.;2013;70;363;125;238
Šakiai d. mun.;2013;71;388;149;239
Šakiai d. mun.;2013;72;393;150;243
Šakiai d. mun.;2013;73;311;115;196
Šakiai d. mun.;2013;74;311;119;192
Šakiai d. mun.;2013;75;320;116;204
Šakiai d. mun.;2013;76;322;111;211
Šakiai d. mun.;2013;77;261;77;184
Šakiai d. mun.;2013;78;319;119;200
Šakiai d. mun.;2013;79;312;106;206
Šakiai d. mun.;2013;80;277;79;198
Šakiai d. mun.;2013;81;247;79;168
Šakiai d. mun.;2013;82;271;91;180
Šakiai d. mun.;2013;83;221;64;157
Šakiai d. mun.;2013;84;181;47;134
Šakiai d. mun.;2013;85;687;161;526
Šakiai d. mun.;2014;-1;30861;14579;16282
Šakiai d. mun.;2014;0;320;160;160
Šakiai d. mun.;2014;1;302;153;149
Šakiai d. mun.;2014;2;302;163;139
Šakiai d. mun.;2014;3;199;91;108
Šakiai d. mun.;2014;4;249;132;117
Šakiai d. mun.;2014;5;250;130;120
Šakiai d. mun.;2014;6;227;118;109
Šakiai d. mun.;2014;7;292;155;137
Šakiai d. mun.;2014;8;243;133;110
Šakiai d. mun.;2014;9;287;141;146
Šakiai d. mun.;2014;10;321;171;150
Šakiai d. mun.;2014;11;331;169;162
Šakiai d. mun.;2014;12;347;169;178
Šakiai d. mun.;2014;13;406;201;205
Šakiai d. mun.;2014;14;423;215;208
Šakiai d. mun.;2014;15;442;232;210
Šakiai d. mun.;2014;16;425;236;189
Šakiai d. mun.;2014;17;452;232;220
Šakiai d. mun.;2014;18;474;241;233
Šakiai d. mun.;2014;19;511;269;242
Šakiai d. mun.;2014;20;549;274;275
Šakiai d. mun.;2014;21;540;273;267
Šakiai d. mun.;2014;22;483;249;234
Šakiai d. mun.;2014;23;474;254;220
Šakiai d. mun.;2014;24;378;201;177
Šakiai d. mun.;2014;25;361;204;157
Šakiai d. mun.;2014;26;373;214;159
Šakiai d. mun.;2014;27;355;223;132
Šakiai d. mun.;2014;28;272;155;117
Šakiai d. mun.;2014;29;271;154;117
Šakiai d. mun.;2014;30;287;167;120
Šakiai d. mun.;2014;31;269;140;129
Šakiai d. mun.;2014;32;266;132;134
Šakiai d. mun.;2014;33;233;138;95
Šakiai d. mun.;2014;34;287;147;140
Šakiai d. mun.;2014;35;308;151;157
Šakiai d. mun.;2014;36;316;166;150
Šakiai d. mun.;2014;37;280;138;142
Šakiai d. mun.;2014;38;361;171;190
Šakiai d. mun.;2014;39;368;196;172
Šakiai d. mun.;2014;40;371;165;206
Šakiai d. mun.;2014;41;403;205;198
Šakiai d. mun.;2014;42;434;206;228
Šakiai d. mun.;2014;43;423;201;222
Šakiai d. mun.;2014;44;457;215;242
Šakiai d. mun.;2014;45;470;219;251
Šakiai d. mun.;2014;46;445;222;223
Šakiai d. mun.;2014;47;476;230;246
Šakiai d. mun.;2014;48;459;216;243
Šakiai d. mun.;2014;49;472;252;220
Šakiai d. mun.;2014;50;489;250;239
Šakiai d. mun.;2014;51;508;260;248
Šakiai d. mun.;2014;52;496;253;243
Šakiai d. mun.;2014;53;552;289;263
Šakiai d. mun.;2014;54;496;242;254
Šakiai d. mun.;2014;55;481;234;247
Šakiai d. mun.;2014;56;419;207;212
Šakiai d. mun.;2014;57;407;196;211
Šakiai d. mun.;2014;58;374;158;216
Šakiai d. mun.;2014;59;337;175;162
Šakiai d. mun.;2014;60;343;150;193
Šakiai d. mun.;2014;61;309;137;172
Šakiai d. mun.;2014;62;293;146;147
Šakiai d. mun.;2014;63;355;157;198
Šakiai d. mun.;2014;64;326;146;180
Šakiai d. mun.;2014;65;271;109;162
Šakiai d. mun.;2014;66;278;111;167
Šakiai d. mun.;2014;67;237;95;142
Šakiai d. mun.;2014;68;289;127;162
Šakiai d. mun.;2014;69;237;84;153
Šakiai d. mun.;2014;70;313;102;211
Šakiai d. mun.;2014;71;354;119;235
Šakiai d. mun.;2014;72;371;141;230
Šakiai d. mun.;2014;73;381;145;236
Šakiai d. mun.;2014;74;302;108;194
Šakiai d. mun.;2014;75;299;110;189
Šakiai d. mun.;2014;76;303;110;193
Šakiai d. mun.;2014;77;308;105;203
Šakiai d. mun.;2014;78;243;70;173
Šakiai d. mun.;2014;79;301;109;192
Šakiai d. mun.;2014;80;288;96;192
Šakiai d. mun.;2014;81;265;73;192
Šakiai d. mun.;2014;82;229;70;159
Šakiai d. mun.;2014;83;241;82;159
Šakiai d. mun.;2014;84;199;53;146
Šakiai d. mun.;2014;85;723;171;552
Šakiai d. mun.;2015;-1;30321;14372;15949
Šakiai d. mun.;2015;0;283;138;145
Šakiai d. mun.;2015;1;311;154;157
Šakiai d. mun.;2015;2;310;158;152
Šakiai d. mun.;2015;3;293;157;136
Šakiai d. mun.;2015;4;200;93;107
Šakiai d. mun.;2015;5;243;129;114
Šakiai d. mun.;2015;6;246;130;116
Šakiai d. mun.;2015;7;226;118;108
Šakiai d. mun.;2015;8;292;154;138
Šakiai d. mun.;2015;9;245;137;108
Šakiai d. mun.;2015;10;287;141;146
Šakiai d. mun.;2015;11;317;172;145
Šakiai d. mun.;2015;12;324;165;159
Šakiai d. mun.;2015;13;346;167;179
Šakiai d. mun.;2015;14;403;197;206
Šakiai d. mun.;2015;15;423;215;208
Šakiai d. mun.;2015;16;442;232;210
Šakiai d. mun.;2015;17;422;236;186
Šakiai d. mun.;2015;18;449;232;217
Šakiai d. mun.;2015;19;468;240;228
Šakiai d. mun.;2015;20;504;267;237
Šakiai d. mun.;2015;21;546;274;272
Šakiai d. mun.;2015;22;534;270;264
Šakiai d. mun.;2015;23;473;244;229
Šakiai d. mun.;2015;24;452;249;203
Šakiai d. mun.;2015;25;355;195;160
Šakiai d. mun.;2015;26;347;197;150
Šakiai d. mun.;2015;27;348;207;141
Šakiai d. mun.;2015;28;327;211;116
Šakiai d. mun.;2015;29;248;140;108
Šakiai d. mun.;2015;30;252;149;103
Šakiai d. mun.;2015;31;268;158;110
Šakiai d. mun.;2015;32;257;137;120
Šakiai d. mun.;2015;33;264;133;131
Šakiai d. mun.;2015;34;230;132;98
Šakiai d. mun.;2015;35;283;145;138
Šakiai d. mun.;2015;36;304;149;155
Šakiai d. mun.;2015;37;315;168;147
Šakiai d. mun.;2015;38;286;141;145
Šakiai d. mun.;2015;39;352;169;183
Šakiai d. mun.;2015;40;370;197;173
Šakiai d. mun.;2015;41;369;163;206
Šakiai d. mun.;2015;42;402;201;201
Šakiai d. mun.;2015;43;426;200;226
Šakiai d. mun.;2015;44;415;199;216
Šakiai d. mun.;2015;45;452;215;237
Šakiai d. mun.;2015;46;461;211;250
Šakiai d. mun.;2015;47;444;222;222
Šakiai d. mun.;2015;48;473;226;247
Šakiai d. mun.;2015;49;453;213;240
Šakiai d. mun.;2015;50;466;248;218
Šakiai d. mun.;2015;51;488;251;237
Šakiai d. mun.;2015;52;503;257;246
Šakiai d. mun.;2015;53;492;251;241
Šakiai d. mun.;2015;54;550;287;263
Šakiai d. mun.;2015;55;491;238;253
Šakiai d. mun.;2015;56;479;232;247
Šakiai d. mun.;2015;57;411;203;208
Šakiai d. mun.;2015;58;403;194;209
Šakiai d. mun.;2015;59;372;155;217
Šakiai d. mun.;2015;60;337;176;161
Šakiai d. mun.;2015;61;338;145;193
Šakiai d. mun.;2015;62;302;134;168
Šakiai d. mun.;2015;63;286;141;145
Šakiai d. mun.;2015;64;348;149;199
Šakiai d. mun.;2015;65;322;141;181
Šakiai d. mun.;2015;66;268;108;160
Šakiai d. mun.;2015;67;273;109;164
Šakiai d. mun.;2015;68;232;92;140
Šakiai d. mun.;2015;69;269;115;154
Šakiai d. mun.;2015;70;227;77;150
Šakiai d. mun.;2015;71;305;101;204
Šakiai d. mun.;2015;72;344;113;231
Šakiai d. mun.;2015;73;353;130;223
Šakiai d. mun.;2015;74;368;137;231
Šakiai d. mun.;2015;75;293;102;191
Šakiai d. mun.;2015;76;285;103;182
Šakiai d. mun.;2015;77;283;100;183
Šakiai d. mun.;2015;78;296;97;199
Šakiai d. mun.;2015;79;229;64;165
Šakiai d. mun.;2015;80;275;96;179
Šakiai d. mun.;2015;81;266;86;180
Šakiai d. mun.;2015;82;245;69;176
Šakiai d. mun.;2015;83;206;62;144
Šakiai d. mun.;2015;84;221;72;149
Šakiai d. mun.;2015;85;755;190;565
Šakiai d. mun.;2016;-1;29693;14090;15603
Šakiai d. mun.;2016;0;310;154;156
Šakiai d. mun.;2016;1;279;136;143
Šakiai d. mun.;2016;2;295;147;148
Šakiai d. mun.;2016;3;304;156;148
Šakiai d. mun.;2016;4;286;150;136
Šakiai d. mun.;2016;5;197;91;106
Šakiai d. mun.;2016;6;234;124;110
Šakiai d. mun.;2016;7;247;130;117
Šakiai d. mun.;2016;8;228;119;109
Šakiai d. mun.;2016;9;290;155;135
Šakiai d. mun.;2016;10;235;130;105
Šakiai d. mun.;2016;11;288;143;145
Šakiai d. mun.;2016;12;315;170;145
Šakiai d. mun.;2016;13;324;166;158
Šakiai d. mun.;2016;14;350;170;180
Šakiai d. mun.;2016;15;400;197;203
Šakiai d. mun.;2016;16;421;213;208
Šakiai d. mun.;2016;17;438;231;207
Šakiai d. mun.;2016;18;416;233;183
Šakiai d. mun.;2016;19;430;224;206
Šakiai d. mun.;2016;20;459;232;227
Šakiai d. mun.;2016;21;486;254;232
Šakiai d. mun.;2016;22;531;264;267
Šakiai d. mun.;2016;23;524;272;252
Šakiai d. mun.;2016;24;454;236;218
Šakiai d. mun.;2016;25;417;230;187
Šakiai d. mun.;2016;26;327;185;142
Šakiai d. mun.;2016;27;337;200;137
Šakiai d. mun.;2016;28;312;194;118
Šakiai d. mun.;2016;29;298;200;98
Šakiai d. mun.;2016;30;234;129;105
Šakiai d. mun.;2016;31;237;141;96
Šakiai d. mun.;2016;32;248;144;104
Šakiai d. mun.;2016;33;252;132;120
Šakiai d. mun.;2016;34;246;119;127
Šakiai d. mun.;2016;35;219;125;94
Šakiai d. mun.;2016;36;275;141;134
Šakiai d. mun.;2016;37;297;144;153
Šakiai d. mun.;2016;38;309;158;151
Šakiai d. mun.;2016;39;277;135;142
Šakiai d. mun.;2016;40;345;162;183
Šakiai d. mun.;2016;41;360;194;166
Šakiai d. mun.;2016;42;367;163;204
Šakiai d. mun.;2016;43;394;197;197
Šakiai d. mun.;2016;44;429;203;226
Šakiai d. mun.;2016;45;411;198;213
Šakiai d. mun.;2016;46;451;217;234
Šakiai d. mun.;2016;47;459;210;249
Šakiai d. mun.;2016;48;444;224;220
Šakiai d. mun.;2016;49;470;224;246
Šakiai d. mun.;2016;50;454;214;240
Šakiai d. mun.;2016;51;468;251;217
Šakiai d. mun.;2016;52;485;249;236
Šakiai d. mun.;2016;53;500;256;244
Šakiai d. mun.;2016;54;483;243;240
Šakiai d. mun.;2016;55;547;284;263
Šakiai d. mun.;2016;56;490;237;253
Šakiai d. mun.;2016;57;475;230;245
Šakiai d. mun.;2016;58;407;198;209
Šakiai d. mun.;2016;59;390;183;207
Šakiai d. mun.;2016;60;366;153;213
Šakiai d. mun.;2016;61;332;173;159
Šakiai d. mun.;2016;62;328;138;190
Šakiai d. mun.;2016;63;292;128;164
Šakiai d. mun.;2016;64;276;135;141
Šakiai d. mun.;2016;65;341;142;199
Šakiai d. mun.;2016;66;313;137;176
Šakiai d. mun.;2016;67;259;100;159
Šakiai d. mun.;2016;68;265;106;159
Šakiai d. mun.;2016;69;229;89;140
Šakiai d. mun.;2016;70;263;112;151
Šakiai d. mun.;2016;71;218;72;146
Šakiai d. mun.;2016;72;293;94;199
Šakiai d. mun.;2016;73;336;113;223
Šakiai d. mun.;2016;74;346;125;221
Šakiai d. mun.;2016;75;354;129;225
Šakiai d. mun.;2016;76;280;94;186
Šakiai d. mun.;2016;77;271;96;175
Šakiai d. mun.;2016;78;268;92;176
Šakiai d. mun.;2016;79;278;87;191
Šakiai d. mun.;2016;80;211;59;152
Šakiai d. mun.;2016;81;254;88;166
Šakiai d. mun.;2016;82;245;75;170
Šakiai d. mun.;2016;83;228;61;167
Šakiai d. mun.;2016;84;183;55;128
Šakiai d. mun.;2016;85;809;226;583
Šakiai d. mun.;2017;-1;28938;13736;15202
Šakiai d. mun.;2017;0;264;132;132
Šakiai d. mun.;2017;1;302;151;151
Šakiai d. mun.;2017;2;270;130;140
Šakiai d. mun.;2017;3;289;142;147
Šakiai d. mun.;2017;4;302;157;145
Šakiai d. mun.;2017;5;284;150;134
Šakiai d. mun.;2017;6;200;92;108
Šakiai d. mun.;2017;7;233;120;113
Šakiai d. mun.;2017;8;244;131;113
Šakiai d. mun.;2017;9;229;120;109
Šakiai d. mun.;2017;10;285;153;132
Šakiai d. mun.;2017;11;233;129;104
Šakiai d. mun.;2017;12;284;139;145
Šakiai d. mun.;2017;13;316;170;146
Šakiai d. mun.;2017;14;321;165;156
Šakiai d. mun.;2017;15;345;167;178
Šakiai d. mun.;2017;16;397;192;205
Šakiai d. mun.;2017;17;413;211;202
Šakiai d. mun.;2017;18;429;224;205
Šakiai d. mun.;2017;19;410;228;182
Šakiai d. mun.;2017;20;422;217;205
Šakiai d. mun.;2017;21;438;220;218
Šakiai d. mun.;2017;22;461;243;218
Šakiai d. mun.;2017;23;521;260;261
Šakiai d. mun.;2017;24;498;261;237
Šakiai d. mun.;2017;25;410;221;189
Šakiai d. mun.;2017;26;391;222;169
Šakiai d. mun.;2017;27;303;176;127
Šakiai d. mun.;2017;28;307;190;117
Šakiai d. mun.;2017;29;276;175;101
Šakiai d. mun.;2017;30;270;185;85
Šakiai d. mun.;2017;31;211;117;94
Šakiai d. mun.;2017;32;216;127;89
Šakiai d. mun.;2017;33;239;144;95
Šakiai d. mun.;2017;34;249;127;122
Šakiai d. mun.;2017;35;227;109;118
Šakiai d. mun.;2017;36;204;118;86
Šakiai d. mun.;2017;37;277;143;134
Šakiai d. mun.;2017;38;275;130;145
Šakiai d. mun.;2017;39;300;151;149
Šakiai d. mun.;2017;40;267;131;136
Šakiai d. mun.;2017;41;336;155;181
Šakiai d. mun.;2017;42;356;193;163
Šakiai d. mun.;2017;43;365;165;200
Šakiai d. mun.;2017;44;386;189;197
Šakiai d. mun.;2017;45;422;197;225
Šakiai d. mun.;2017;46;401;195;206
Šakiai d. mun.;2017;47;448;215;233
Šakiai d. mun.;2017;48;456;211;245
Šakiai d. mun.;2017;49;437;218;219
Šakiai d. mun.;2017;50;463;221;242
Šakiai d. mun.;2017;51;449;212;237
Šakiai d. mun.;2017;52;462;248;214
Šakiai d. mun.;2017;53;481;247;234
Šakiai d. mun.;2017;54;493;254;239
Šakiai d. mun.;2017;55;480;238;242
Šakiai d. mun.;2017;56;540;278;262
Šakiai d. mun.;2017;57;485;233;252
Šakiai d. mun.;2017;58;474;229;245
Šakiai d. mun.;2017;59;400;193;207
Šakiai d. mun.;2017;60;387;180;207
Šakiai d. mun.;2017;61;359;148;211
Šakiai d. mun.;2017;62;326;169;157
Šakiai d. mun.;2017;63;321;131;190
Šakiai d. mun.;2017;64;286;123;163
Šakiai d. mun.;2017;65;271;132;139
Šakiai d. mun.;2017;66;328;134;194
Šakiai d. mun.;2017;67;310;134;176
Šakiai d. mun.;2017;68;251;95;156
Šakiai d. mun.;2017;69;252;97;155
Šakiai d. mun.;2017;70;222;86;136
Šakiai d. mun.;2017;71;250;105;145
Šakiai d. mun.;2017;72;210;67;143
Šakiai d. mun.;2017;73;283;88;195
Šakiai d. mun.;2017;74;325;107;218
Šakiai d. mun.;2017;75;335;124;211
Šakiai d. mun.;2017;76;335;119;216
Šakiai d. mun.;2017;77;273;88;185
Šakiai d. mun.;2017;78;258;89;169
Šakiai d. mun.;2017;79;254;84;170
Šakiai d. mun.;2017;80;260;77;183
Šakiai d. mun.;2017;81;198;57;141
Šakiai d. mun.;2017;82;237;82;155
Šakiai d. mun.;2017;83;232;69;163
Šakiai d. mun.;2017;84;216;58;158
Šakiai d. mun.;2017;85;813;232;581
Šakiai d. mun.;2018;-1;28039;13338;14701
Šakiai d. mun.;2018;0;246;127;119
Šakiai d. mun.;2018;1;247;123;124
Šakiai d. mun.;2018;2;303;151;152
Šakiai d. mun.;2018;3;266;128;138
Šakiai d. mun.;2018;4;288;142;146
Šakiai d. mun.;2018;5;295;152;143
Šakiai d. mun.;2018;6;282;149;133
Šakiai d. mun.;2018;7;199;95;104
Šakiai d. mun.;2018;8;229;116;113
Šakiai d. mun.;2018;9;237;129;108
Šakiai d. mun.;2018;10;230;120;110
Šakiai d. mun.;2018;11;276;148;128
Šakiai d. mun.;2018;12;235;134;101
Šakiai d. mun.;2018;13;279;137;142
Šakiai d. mun.;2018;14;317;169;148
Šakiai d. mun.;2018;15;324;166;158
Šakiai d. mun.;2018;16;341;167;174
Šakiai d. mun.;2018;17;392;188;204
Šakiai d. mun.;2018;18;394;202;192
Šakiai d. mun.;2018;19;415;217;198
Šakiai d. mun.;2018;20;399;226;173
Šakiai d. mun.;2018;21;405;208;197
Šakiai d. mun.;2018;22;419;208;211
Šakiai d. mun.;2018;23;428;231;197
Šakiai d. mun.;2018;24;477;242;235
Šakiai d. mun.;2018;25;437;239;198
Šakiai d. mun.;2018;26;368;203;165
Šakiai d. mun.;2018;27;338;199;139
Šakiai d. mun.;2018;28;273;171;102
Šakiai d. mun.;2018;29;272;172;100
Šakiai d. mun.;2018;30;248;157;91
Šakiai d. mun.;2018;31;232;163;69
Šakiai d. mun.;2018;32;187;106;81
Šakiai d. mun.;2018;33;205;121;84
Šakiai d. mun.;2018;34;222;134;88
Šakiai d. mun.;2018;35;231;118;113
Šakiai d. mun.;2018;36;218;101;117
Šakiai d. mun.;2018;37;198;119;79
Šakiai d. mun.;2018;38;262;128;134
Šakiai d. mun.;2018;39;267;123;144
Šakiai d. mun.;2018;40;294;149;145
Šakiai d. mun.;2018;41;263;128;135
Šakiai d. mun.;2018;42;327;152;175
Šakiai d. mun.;2018;43;345;186;159
Šakiai d. mun.;2018;44;362;163;199
Šakiai d. mun.;2018;45;377;187;190
Šakiai d. mun.;2018;46;416;195;221
Šakiai d. mun.;2018;47;398;190;208
Šakiai d. mun.;2018;48;436;209;227
Šakiai d. mun.;2018;49;455;209;246
Šakiai d. mun.;2018;50;433;216;217
Šakiai d. mun.;2018;51;457;219;238
Šakiai d. mun.;2018;52;449;213;236
Šakiai d. mun.;2018;53;459;248;211
Šakiai d. mun.;2018;54;477;243;234
Šakiai d. mun.;2018;55;486;252;234
Šakiai d. mun.;2018;56;476;234;242
Šakiai d. mun.;2018;57;534;274;260
Šakiai d. mun.;2018;58;483;233;250
Šakiai d. mun.;2018;59;470;228;242
Šakiai d. mun.;2018;60;395;188;207
Šakiai d. mun.;2018;61;387;180;207
Šakiai d. mun.;2018;62;353;144;209
Šakiai d. mun.;2018;63;321;165;156
Šakiai d. mun.;2018;64;307;122;185
Šakiai d. mun.;2018;65;281;120;161
Šakiai d. mun.;2018;66;262;126;136
Šakiai d. mun.;2018;67;323;129;194
Šakiai d. mun.;2018;68;304;129;175
Šakiai d. mun.;2018;69;247;91;156
Šakiai d. mun.;2018;70;246;93;153
Šakiai d. mun.;2018;71;214;80;134
Šakiai d. mun.;2018;72;240;98;142
Šakiai d. mun.;2018;73;197;62;135
Šakiai d. mun.;2018;74;273;81;192
Šakiai d. mun.;2018;75;310;98;212
Šakiai d. mun.;2018;76;318;112;206
Šakiai d. mun.;2018;77;317;113;204
Šakiai d. mun.;2018;78;263;84;179
Šakiai d. mun.;2018;79;250;86;164
Šakiai d. mun.;2018;80;234;79;155
Šakiai d. mun.;2018;81;241;71;170
Šakiai d. mun.;2018;82;180;52;128
Šakiai d. mun.;2018;83;218;73;145
Šakiai d. mun.;2018;84;212;61;151
Šakiai d. mun.;2018;85;868;244;624
Šalčininkai d. mun.;2001;-1;39384;18933;20451
Šalčininkai d. mun.;2001;0;410;213;197
Šalčininkai d. mun.;2001;1;426;235;191
Šalčininkai d. mun.;2001;2;437;222;215
Šalčininkai d. mun.;2001;3;433;203;230
Šalčininkai d. mun.;2001;4;462;245;217
Šalčininkai d. mun.;2001;5;463;246;217
Šalčininkai d. mun.;2001;6;491;263;228
Šalčininkai d. mun.;2001;7;554;297;257
Šalčininkai d. mun.;2001;8;659;312;347
Šalčininkai d. mun.;2001;9;585;298;287
Šalčininkai d. mun.;2001;10;654;358;296
Šalčininkai d. mun.;2001;11;653;334;319
Šalčininkai d. mun.;2001;12;708;347;361
Šalčininkai d. mun.;2001;13;646;330;316
Šalčininkai d. mun.;2001;14;668;366;302
Šalčininkai d. mun.;2001;15;636;337;299
Šalčininkai d. mun.;2001;16;671;368;303
Šalčininkai d. mun.;2001;17;576;316;260
Šalčininkai d. mun.;2001;18;538;293;245
Šalčininkai d. mun.;2001;19;498;273;225
Šalčininkai d. mun.;2001;20;501;287;214
Šalčininkai d. mun.;2001;21;495;251;244
Šalčininkai d. mun.;2001;22;476;248;228
Šalčininkai d. mun.;2001;23;492;267;225
Šalčininkai d. mun.;2001;24;540;274;266
Šalčininkai d. mun.;2001;25;500;260;240
Šalčininkai d. mun.;2001;26;537;273;264
Šalčininkai d. mun.;2001;27;560;282;278
Šalčininkai d. mun.;2001;28;562;294;268
Šalčininkai d. mun.;2001;29;567;292;275
Šalčininkai d. mun.;2001;30;533;279;254
Šalčininkai d. mun.;2001;31;519;265;254
Šalčininkai d. mun.;2001;32;577;296;281
Šalčininkai d. mun.;2001;33;593;296;297
Šalčininkai d. mun.;2001;34;540;296;244
Šalčininkai d. mun.;2001;35;562;282;280
Šalčininkai d. mun.;2001;36;573;306;267
Šalčininkai d. mun.;2001;37;649;311;338
Šalčininkai d. mun.;2001;38;574;306;268
Šalčininkai d. mun.;2001;39;645;335;310
Šalčininkai d. mun.;2001;40;641;329;312
Šalčininkai d. mun.;2001;41;608;298;310
Šalčininkai d. mun.;2001;42;602;333;269
Šalčininkai d. mun.;2001;43;533;284;249
Šalčininkai d. mun.;2001;44;454;222;232
Šalčininkai d. mun.;2001;45;473;251;222
Šalčininkai d. mun.;2001;46;458;239;219
Šalčininkai d. mun.;2001;47;444;231;213
Šalčininkai d. mun.;2001;48;454;231;223
Šalčininkai d. mun.;2001;49;474;241;233
Šalčininkai d. mun.;2001;50;466;237;229
Šalčininkai d. mun.;2001;51;441;222;219
Šalčininkai d. mun.;2001;52;425;209;216
Šalčininkai d. mun.;2001;53;333;175;158
Šalčininkai d. mun.;2001;54;387;195;192
Šalčininkai d. mun.;2001;55;365;188;177
Šalčininkai d. mun.;2001;56;328;155;173
Šalčininkai d. mun.;2001;57;382;156;226
Šalčininkai d. mun.;2001;58;450;203;247
Šalčininkai d. mun.;2001;59;339;130;209
Šalčininkai d. mun.;2001;60;433;164;269
Šalčininkai d. mun.;2001;61;443;179;264
Šalčininkai d. mun.;2001;62;447;177;270
Šalčininkai d. mun.;2001;63;464;192;272
Šalčininkai d. mun.;2001;64;492;204;288
Šalčininkai d. mun.;2001;65;454;208;246
Šalčininkai d. mun.;2001;66;427;161;266
Šalčininkai d. mun.;2001;67;402;147;255
Šalčininkai d. mun.;2001;68;432;162;270
Šalčininkai d. mun.;2001;69;382;118;264
Šalčininkai d. mun.;2001;70;448;178;270
Šalčininkai d. mun.;2001;71;425;145;280
Šalčininkai d. mun.;2001;72;346;113;233
Šalčininkai d. mun.;2001;73;320;90;230
Šalčininkai d. mun.;2001;74;280;87;193
Šalčininkai d. mun.;2001;75;280;92;188
Šalčininkai d. mun.;2001;76;258;72;186
Šalčininkai d. mun.;2001;77;243;54;189
Šalčininkai d. mun.;2001;78;182;61;121
Šalčininkai d. mun.;2001;79;183;39;144
Šalčininkai d. mun.;2001;80;141;32;109
Šalčininkai d. mun.;2001;81;104;28;76
Šalčininkai d. mun.;2001;82;63;20;43
Šalčininkai d. mun.;2001;83;41;10;31
Šalčininkai d. mun.;2001;84;56;10;46
Šalčininkai d. mun.;2001;85;418;105;313
Šalčininkai d. mun.;2002;-1;38903;18670;20233
Šalčininkai d. mun.;2002;0;392;182;210
Šalčininkai d. mun.;2002;1;403;209;194
Šalčininkai d. mun.;2002;2;421;234;187
Šalčininkai d. mun.;2002;3;433;222;211
Šalčininkai d. mun.;2002;4;429;201;228
Šalčininkai d. mun.;2002;5;455;240;215
Šalčininkai d. mun.;2002;6;460;243;217
Šalčininkai d. mun.;2002;7;492;265;227
Šalčininkai d. mun.;2002;8;551;297;254
Šalčininkai d. mun.;2002;9;655;310;345
Šalčininkai d. mun.;2002;10;583;297;286
Šalčininkai d. mun.;2002;11;648;356;292
Šalčininkai d. mun.;2002;12;646;331;315
Šalčininkai d. mun.;2002;13;701;342;359
Šalčininkai d. mun.;2002;14;638;324;314
Šalčininkai d. mun.;2002;15;661;362;299
Šalčininkai d. mun.;2002;16;634;337;297
Šalčininkai d. mun.;2002;17;658;361;297
Šalčininkai d. mun.;2002;18;553;308;245
Šalčininkai d. mun.;2002;19;521;284;237
Šalčininkai d. mun.;2002;20;488;268;220
Šalčininkai d. mun.;2002;21;495;280;215
Šalčininkai d. mun.;2002;22;480;245;235
Šalčininkai d. mun.;2002;23;465;242;223
Šalčininkai d. mun.;2002;24;474;258;216
Šalčininkai d. mun.;2002;25;532;271;261
Šalčininkai d. mun.;2002;26;493;258;235
Šalčininkai d. mun.;2002;27;526;264;262
Šalčininkai d. mun.;2002;28;540;270;270
Šalčininkai d. mun.;2002;29;545;285;260
Šalčininkai d. mun.;2002;30;555;284;271
Šalčininkai d. mun.;2002;31;524;273;251
Šalčininkai d. mun.;2002;32;509;258;251
Šalčininkai d. mun.;2002;33;570;293;277
Šalčininkai d. mun.;2002;34;586;291;295
Šalčininkai d. mun.;2002;35;528;288;240
Šalčininkai d. mun.;2002;36;554;278;276
Šalčininkai d. mun.;2002;37;565;301;264
Šalčininkai d. mun.;2002;38;640;303;337
Šalčininkai d. mun.;2002;39;567;301;266
Šalčininkai d. mun.;2002;40;637;330;307
Šalčininkai d. mun.;2002;41;632;322;310
Šalčininkai d. mun.;2002;42;605;297;308
Šalčininkai d. mun.;2002;43;602;334;268
Šalčininkai d. mun.;2002;44;525;280;245
Šalčininkai d. mun.;2002;45;441;216;225
Šalčininkai d. mun.;2002;46;466;247;219
Šalčininkai d. mun.;2002;47;451;235;216
Šalčininkai d. mun.;2002;48;434;225;209
Šalčininkai d. mun.;2002;49;442;222;220
Šalčininkai d. mun.;2002;50;465;232;233
Šalčininkai d. mun.;2002;51;454;227;227
Šalčininkai d. mun.;2002;52;438;220;218
Šalčininkai d. mun.;2002;53;423;209;214
Šalčininkai d. mun.;2002;54;328;170;158
Šalčininkai d. mun.;2002;55;376;187;189
Šalčininkai d. mun.;2002;56;356;181;175
Šalčininkai d. mun.;2002;57;319;149;170
Šalčininkai d. mun.;2002;58;372;153;219
Šalčininkai d. mun.;2002;59;435;196;239
Šalčininkai d. mun.;2002;60;335;128;207
Šalčininkai d. mun.;2002;61;433;163;270
Šalčininkai d. mun.;2002;62;437;171;266
Šalčininkai d. mun.;2002;63;438;167;271
Šalčininkai d. mun.;2002;64;454;181;273
Šalčininkai d. mun.;2002;65;481;197;284
Šalčininkai d. mun.;2002;66;444;201;243
Šalčininkai d. mun.;2002;67;410;152;258
Šalčininkai d. mun.;2002;68;387;137;250
Šalčininkai d. mun.;2002;69;415;155;260
Šalčininkai d. mun.;2002;70;371;115;256
Šalčininkai d. mun.;2002;71;422;167;255
Šalčininkai d. mun.;2002;72;410;138;272
Šalčininkai d. mun.;2002;73;334;110;224
Šalčininkai d. mun.;2002;74;304;84;220
Šalčininkai d. mun.;2002;75;273;85;188
Šalčininkai d. mun.;2002;76;266;88;178
Šalčininkai d. mun.;2002;77;248;67;181
Šalčininkai d. mun.;2002;78;227;48;179
Šalčininkai d. mun.;2002;79;164;54;110
Šalčininkai d. mun.;2002;80;175;39;136
Šalčininkai d. mun.;2002;81;128;27;101
Šalčininkai d. mun.;2002;82;94;25;69
Šalčininkai d. mun.;2002;83;57;21;36
Šalčininkai d. mun.;2002;84;37;10;27
Šalčininkai d. mun.;2002;85;388;92;296
Šalčininkai d. mun.;2003;-1;38563;18456;20107
Šalčininkai d. mun.;2003;0;359;170;189
Šalčininkai d. mun.;2003;1;388;179;209
Šalčininkai d. mun.;2003;2;401;208;193
Šalčininkai d. mun.;2003;3;419;233;186
Šalčininkai d. mun.;2003;4;428;218;210
Šalčininkai d. mun.;2003;5;425;199;226
Šalčininkai d. mun.;2003;6;451;237;214
Šalčininkai d. mun.;2003;7;456;242;214
Šalčininkai d. mun.;2003;8;490;263;227
Šalčininkai d. mun.;2003;9;548;295;253
Šalčininkai d. mun.;2003;10;647;306;341
Šalčininkai d. mun.;2003;11;580;296;284
Šalčininkai d. mun.;2003;12;640;352;288
Šalčininkai d. mun.;2003;13;638;328;310
Šalčininkai d. mun.;2003;14;691;337;354
Šalčininkai d. mun.;2003;15;627;318;309
Šalčininkai d. mun.;2003;16;651;356;295
Šalčininkai d. mun.;2003;17;620;329;291
Šalčininkai d. mun.;2003;18;652;355;297
Šalčininkai d. mun.;2003;19;548;301;247
Šalčininkai d. mun.;2003;20;514;279;235
Šalčininkai d. mun.;2003;21;488;263;225
Šalčininkai d. mun.;2003;22;500;283;217
Šalčininkai d. mun.;2003;23;484;244;240
Šalčininkai d. mun.;2003;24;466;242;224
Šalčininkai d. mun.;2003;25;475;262;213
Šalčininkai d. mun.;2003;26;527;271;256
Šalčininkai d. mun.;2003;27;476;249;227
Šalčininkai d. mun.;2003;28;518;259;259
Šalčininkai d. mun.;2003;29;530;265;265
Šalčininkai d. mun.;2003;30;535;275;260
Šalčininkai d. mun.;2003;31;551;280;271
Šalčininkai d. mun.;2003;32;525;273;252
Šalčininkai d. mun.;2003;33;502;254;248
Šalčininkai d. mun.;2003;34;567;289;278
Šalčininkai d. mun.;2003;35;578;287;291
Šalčininkai d. mun.;2003;36;523;284;239
Šalčininkai d. mun.;2003;37;542;273;269
Šalčininkai d. mun.;2003;38;553;299;254
Šalčininkai d. mun.;2003;39;630;300;330
Šalčininkai d. mun.;2003;40;557;296;261
Šalčininkai d. mun.;2003;41;637;332;305
Šalčininkai d. mun.;2003;42;631;324;307
Šalčininkai d. mun.;2003;43;598;291;307
Šalčininkai d. mun.;2003;44;602;333;269
Šalčininkai d. mun.;2003;45;522;278;244
Šalčininkai d. mun.;2003;46;439;215;224
Šalčininkai d. mun.;2003;47;458;245;213
Šalčininkai d. mun.;2003;48;450;232;218
Šalčininkai d. mun.;2003;49;429;222;207
Šalčininkai d. mun.;2003;50;438;220;218
Šalčininkai d. mun.;2003;51;461;229;232
Šalčininkai d. mun.;2003;52;447;222;225
Šalčininkai d. mun.;2003;53;435;219;216
Šalčininkai d. mun.;2003;54;414;200;214
Šalčininkai d. mun.;2003;55;328;168;160
Šalčininkai d. mun.;2003;56;370;183;187
Šalčininkai d. mun.;2003;57;353;178;175
Šalčininkai d. mun.;2003;58;310;143;167
Šalčininkai d. mun.;2003;59;367;150;217
Šalčininkai d. mun.;2003;60;423;190;233
Šalčininkai d. mun.;2003;61;328;125;203
Šalčininkai d. mun.;2003;62;429;159;270
Šalčininkai d. mun.;2003;63;427;162;265
Šalčininkai d. mun.;2003;64;426;160;266
Šalčininkai d. mun.;2003;65;446;175;271
Šalčininkai d. mun.;2003;66;465;185;280
Šalčininkai d. mun.;2003;67;436;200;236
Šalčininkai d. mun.;2003;68;394;144;250
Šalčininkai d. mun.;2003;69;375;128;247
Šalčininkai d. mun.;2003;70;403;145;258
Šalčininkai d. mun.;2003;71;355;106;249
Šalčininkai d. mun.;2003;72;408;159;249
Šalčininkai d. mun.;2003;73;380;125;255
Šalčininkai d. mun.;2003;74;322;103;219
Šalčininkai d. mun.;2003;75;291;72;219
Šalčininkai d. mun.;2003;76;266;84;182
Šalčininkai d. mun.;2003;77;257;83;174
Šalčininkai d. mun.;2003;78;229;59;170
Šalčininkai d. mun.;2003;79;220;45;175
Šalčininkai d. mun.;2003;80;160;55;105
Šalčininkai d. mun.;2003;81;161;32;129
Šalčininkai d. mun.;2003;82;124;30;94
Šalčininkai d. mun.;2003;83;80;19;61
Šalčininkai d. mun.;2003;84;50;17;33
Šalčininkai d. mun.;2003;85;319;61;258
Šalčininkai d. mun.;2004;-1;38205;18264;19941
Šalčininkai d. mun.;2004;0;391;191;200
Šalčininkai d. mun.;2004;1;356;168;188
Šalčininkai d. mun.;2004;2;386;177;209
Šalčininkai d. mun.;2004;3;400;208;192
Šalčininkai d. mun.;2004;4;415;231;184
Šalčininkai d. mun.;2004;5;426;217;209
Šalčininkai d. mun.;2004;6;425;199;226
Šalčininkai d. mun.;2004;7;450;238;212
Šalčininkai d. mun.;2004;8;455;240;215
Šalčininkai d. mun.;2004;9;488;263;225
Šalčininkai d. mun.;2004;10;548;295;253
Šalčininkai d. mun.;2004;11;643;305;338
Šalčininkai d. mun.;2004;12;574;293;281
Šalčininkai d. mun.;2004;13;631;348;283
Šalčininkai d. mun.;2004;14;628;323;305
Šalčininkai d. mun.;2004;15;684;336;348
Šalčininkai d. mun.;2004;16;619;315;304
Šalčininkai d. mun.;2004;17;637;350;287
Šalčininkai d. mun.;2004;18;608;324;284
Šalčininkai d. mun.;2004;19;637;348;289
Šalčininkai d. mun.;2004;20;543;297;246
Šalčininkai d. mun.;2004;21;502;273;229
Šalčininkai d. mun.;2004;22;484;264;220
Šalčininkai d. mun.;2004;23;480;271;209
Šalčininkai d. mun.;2004;24;483;245;238
Šalčininkai d. mun.;2004;25;457;236;221
Šalčininkai d. mun.;2004;26;459;254;205
Šalčininkai d. mun.;2004;27;525;270;255
Šalčininkai d. mun.;2004;28;467;245;222
Šalčininkai d. mun.;2004;29;523;263;260
Šalčininkai d. mun.;2004;30;525;261;264
Šalčininkai d. mun.;2004;31;531;277;254
Šalčininkai d. mun.;2004;32;540;272;268
Šalčininkai d. mun.;2004;33;518;272;246
Šalčininkai d. mun.;2004;34;504;255;249
Šalčininkai d. mun.;2004;35;561;287;274
Šalčininkai d. mun.;2004;36;575;280;295
Šalčininkai d. mun.;2004;37;515;285;230
Šalčininkai d. mun.;2004;38;543;274;269
Šalčininkai d. mun.;2004;39;555;297;258
Šalčininkai d. mun.;2004;40;625;296;329
Šalčininkai d. mun.;2004;41;558;299;259
Šalčininkai d. mun.;2004;42;625;322;303
Šalčininkai d. mun.;2004;43;631;324;307
Šalčininkai d. mun.;2004;44;585;285;300
Šalčininkai d. mun.;2004;45;599;331;268
Šalčininkai d. mun.;2004;46;509;270;239
Šalčininkai d. mun.;2004;47;438;215;223
Šalčininkai d. mun.;2004;48;453;241;212
Šalčininkai d. mun.;2004;49;443;229;214
Šalčininkai d. mun.;2004;50;425;221;204
Šalčininkai d. mun.;2004;51;429;213;216
Šalčininkai d. mun.;2004;52;448;222;226
Šalčininkai d. mun.;2004;53;440;218;222
Šalčininkai d. mun.;2004;54;437;216;221
Šalčininkai d. mun.;2004;55;411;197;214
Šalčininkai d. mun.;2004;56;322;164;158
Šalčininkai d. mun.;2004;57;367;180;187
Šalčininkai d. mun.;2004;58;353;177;176
Šalčininkai d. mun.;2004;59;298;134;164
Šalčininkai d. mun.;2004;60;358;142;216
Šalčininkai d. mun.;2004;61;415;184;231
Šalčininkai d. mun.;2004;62;327;123;204
Šalčininkai d. mun.;2004;63;420;153;267
Šalčininkai d. mun.;2004;64;421;161;260
Šalčininkai d. mun.;2004;65;420;154;266
Šalčininkai d. mun.;2004;66;437;167;270
Šalčininkai d. mun.;2004;67;448;171;277
Šalčininkai d. mun.;2004;68;427;191;236
Šalčininkai d. mun.;2004;69;386;135;251
Šalčininkai d. mun.;2004;70;369;125;244
Šalčininkai d. mun.;2004;71;396;138;258
Šalčininkai d. mun.;2004;72;338;95;243
Šalčininkai d. mun.;2004;73;385;145;240
Šalčininkai d. mun.;2004;74;350;111;239
Šalčininkai d. mun.;2004;75;312;99;213
Šalčininkai d. mun.;2004;76;273;63;210
Šalčininkai d. mun.;2004;77;247;75;172
Šalčininkai d. mun.;2004;78;238;75;163
Šalčininkai d. mun.;2004;79;214;53;161
Šalčininkai d. mun.;2004;80;197;37;160
Šalčininkai d. mun.;2004;81;137;46;91
Šalčininkai d. mun.;2004;82;146;27;119
Šalčininkai d. mun.;2004;83;106;23;83
Šalčininkai d. mun.;2004;84;69;13;56
Šalčininkai d. mun.;2004;85;282;57;225
Šalčininkai d. mun.;2005;-1;37727;17981;19746
Šalčininkai d. mun.;2005;0;373;169;204
Šalčininkai d. mun.;2005;1;386;187;199
Šalčininkai d. mun.;2005;2;352;167;185
Šalčininkai d. mun.;2005;3;384;176;208
Šalčininkai d. mun.;2005;4;393;203;190
Šalčininkai d. mun.;2005;5;411;229;182
Šalčininkai d. mun.;2005;6;424;215;209
Šalčininkai d. mun.;2005;7;423;198;225
Šalčininkai d. mun.;2005;8;451;237;214
Šalčininkai d. mun.;2005;9;454;239;215
Šalčininkai d. mun.;2005;10;490;260;230
Šalčininkai d. mun.;2005;11;547;296;251
Šalčininkai d. mun.;2005;12;639;303;336
Šalčininkai d. mun.;2005;13;572;292;280
Šalčininkai d. mun.;2005;14;625;346;279
Šalčininkai d. mun.;2005;15;620;319;301
Šalčininkai d. mun.;2005;16;669;329;340
Šalčininkai d. mun.;2005;17;605;306;299
Šalčininkai d. mun.;2005;18;622;338;284
Šalčininkai d. mun.;2005;19;600;319;281
Šalčininkai d. mun.;2005;20;621;341;280
Šalčininkai d. mun.;2005;21;527;289;238
Šalčininkai d. mun.;2005;22;485;264;221
Šalčininkai d. mun.;2005;23;470;259;211
Šalčininkai d. mun.;2005;24;474;261;213
Šalčininkai d. mun.;2005;25;475;244;231
Šalčininkai d. mun.;2005;26;458;240;218
Šalčininkai d. mun.;2005;27;448;244;204
Šalčininkai d. mun.;2005;28;512;264;248
Šalčininkai d. mun.;2005;29;463;247;216
Šalčininkai d. mun.;2005;30;510;255;255
Šalčininkai d. mun.;2005;31;520;256;264
Šalčininkai d. mun.;2005;32;526;271;255
Šalčininkai d. mun.;2005;33;533;269;264
Šalčininkai d. mun.;2005;34;516;274;242
Šalčininkai d. mun.;2005;35;501;253;248
Šalčininkai d. mun.;2005;36;551;281;270
Šalčininkai d. mun.;2005;37;563;270;293
Šalčininkai d. mun.;2005;38;505;282;223
Šalčininkai d. mun.;2005;39;544;274;270
Šalčininkai d. mun.;2005;40;542;290;252
Šalčininkai d. mun.;2005;41;616;294;322
Šalčininkai d. mun.;2005;42;549;291;258
Šalčininkai d. mun.;2005;43;622;321;301
Šalčininkai d. mun.;2005;44;612;307;305
Šalčininkai d. mun.;2005;45;580;282;298
Šalčininkai d. mun.;2005;46;595;324;271
Šalčininkai d. mun.;2005;47;505;266;239
Šalčininkai d. mun.;2005;48;436;211;225
Šalčininkai d. mun.;2005;49;448;241;207
Šalčininkai d. mun.;2005;50;434;222;212
Šalčininkai d. mun.;2005;51;414;214;200
Šalčininkai d. mun.;2005;52;416;202;214
Šalčininkai d. mun.;2005;53;429;212;217
Šalčininkai d. mun.;2005;54;428;213;215
Šalčininkai d. mun.;2005;55;427;210;217
Šalčininkai d. mun.;2005;56;401;190;211
Šalčininkai d. mun.;2005;57;321;163;158
Šalčininkai d. mun.;2005;58;360;173;187
Šalčininkai d. mun.;2005;59;348;172;176
Šalčininkai d. mun.;2005;60;294;135;159
Šalčininkai d. mun.;2005;61;348;135;213
Šalčininkai d. mun.;2005;62;403;177;226
Šalčininkai d. mun.;2005;63;315;117;198
Šalčininkai d. mun.;2005;64;408;147;261
Šalčininkai d. mun.;2005;65;409;153;256
Šalčininkai d. mun.;2005;66;408;143;265
Šalčininkai d. mun.;2005;67;431;164;267
Šalčininkai d. mun.;2005;68;429;160;269
Šalčininkai d. mun.;2005;69;415;182;233
Šalčininkai d. mun.;2005;70;380;131;249
Šalčininkai d. mun.;2005;71;354;115;239
Šalčininkai d. mun.;2005;72;374;126;248
Šalčininkai d. mun.;2005;73;323;88;235
Šalčininkai d. mun.;2005;74;367;135;232
Šalčininkai d. mun.;2005;75;328;99;229
Šalčininkai d. mun.;2005;76;283;85;198
Šalčininkai d. mun.;2005;77;255;55;200
Šalčininkai d. mun.;2005;78;228;67;161
Šalčininkai d. mun.;2005;79;223;68;155
Šalčininkai d. mun.;2005;80;198;50;148
Šalčininkai d. mun.;2005;81;175;31;144
Šalčininkai d. mun.;2005;82;120;38;82
Šalčininkai d. mun.;2005;83;131;23;108
Šalčininkai d. mun.;2005;84;93;21;72
Šalčininkai d. mun.;2005;85;310;72;238
Šalčininkai d. mun.;2006;-1;37016;17589;19427
Šalčininkai d. mun.;2006;0;398;197;201
Šalčininkai d. mun.;2006;1;366;165;201
Šalčininkai d. mun.;2006;2;384;186;198
Šalčininkai d. mun.;2006;3;347;164;183
Šalčininkai d. mun.;2006;4;377;174;203
Šalčininkai d. mun.;2006;5;385;198;187
Šalčininkai d. mun.;2006;6;407;227;180
Šalčininkai d. mun.;2006;7;420;213;207
Šalčininkai d. mun.;2006;8;421;197;224
Šalčininkai d. mun.;2006;9;445;235;210
Šalčininkai d. mun.;2006;10;454;241;213
Šalčininkai d. mun.;2006;11;489;259;230
Šalčininkai d. mun.;2006;12;544;293;251
Šalčininkai d. mun.;2006;13;628;296;332
Šalčininkai d. mun.;2006;14;564;288;276
Šalčininkai d. mun.;2006;15;615;343;272
Šalčininkai d. mun.;2006;16;604;309;295
Šalčininkai d. mun.;2006;17;649;319;330
Šalčininkai d. mun.;2006;18;590;299;291
Šalčininkai d. mun.;2006;19;593;321;272
Šalčininkai d. mun.;2006;20;570;299;271
Šalčininkai d. mun.;2006;21;594;328;266
Šalčininkai d. mun.;2006;22;504;278;226
Šalčininkai d. mun.;2006;23;475;259;216
Šalčininkai d. mun.;2006;24;452;250;202
Šalčininkai d. mun.;2006;25;456;252;204
Šalčininkai d. mun.;2006;26;454;230;224
Šalčininkai d. mun.;2006;27;440;231;209
Šalčininkai d. mun.;2006;28;437;239;198
Šalčininkai d. mun.;2006;29;508;266;242
Šalčininkai d. mun.;2006;30;458;245;213
Šalčininkai d. mun.;2006;31;507;256;251
Šalčininkai d. mun.;2006;32;507;249;258
Šalčininkai d. mun.;2006;33;509;259;250
Šalčininkai d. mun.;2006;34;522;267;255
Šalčininkai d. mun.;2006;35;504;269;235
Šalčininkai d. mun.;2006;36;488;243;245
Šalčininkai d. mun.;2006;37;538;271;267
Šalčininkai d. mun.;2006;38;554;263;291
Šalčininkai d. mun.;2006;39;491;270;221
Šalčininkai d. mun.;2006;40;536;270;266
Šalčininkai d. mun.;2006;41;537;286;251
Šalčininkai d. mun.;2006;42;603;284;319
Šalčininkai d. mun.;2006;43;536;282;254
Šalčininkai d. mun.;2006;44;611;313;298
Šalčininkai d. mun.;2006;45;611;303;308
Šalčininkai d. mun.;2006;46;578;281;297
Šalčininkai d. mun.;2006;47;591;325;266
Šalčininkai d. mun.;2006;48;501;259;242
Šalčininkai d. mun.;2006;49;429;204;225
Šalčininkai d. mun.;2006;50;439;235;204
Šalčininkai d. mun.;2006;51;430;220;210
Šalčininkai d. mun.;2006;52;407;206;201
Šalčininkai d. mun.;2006;53;409;194;215
Šalčininkai d. mun.;2006;54;421;204;217
Šalčininkai d. mun.;2006;55;412;203;209
Šalčininkai d. mun.;2006;56;420;203;217
Šalčininkai d. mun.;2006;57;393;185;208
Šalčininkai d. mun.;2006;58;311;156;155
Šalčininkai d. mun.;2006;59;347;163;184
Šalčininkai d. mun.;2006;60;341;166;175
Šalčininkai d. mun.;2006;61;288;134;154
Šalčininkai d. mun.;2006;62;339;131;208
Šalčininkai d. mun.;2006;63;389;168;221
Šalčininkai d. mun.;2006;64;308;116;192
Šalčininkai d. mun.;2006;65;399;142;257
Šalčininkai d. mun.;2006;66;391;142;249
Šalčininkai d. mun.;2006;67;394;135;259
Šalčininkai d. mun.;2006;68;417;154;263
Šalčininkai d. mun.;2006;69;408;145;263
Šalčininkai d. mun.;2006;70;398;170;228
Šalčininkai d. mun.;2006;71;363;122;241
Šalčininkai d. mun.;2006;72;342;108;234
Šalčininkai d. mun.;2006;73;358;119;239
Šalčininkai d. mun.;2006;74;304;81;223
Šalčininkai d. mun.;2006;75;343;120;223
Šalčininkai d. mun.;2006;76;308;88;220
Šalčininkai d. mun.;2006;77;265;79;186
Šalčininkai d. mun.;2006;78;229;49;180
Šalčininkai d. mun.;2006;79;208;61;147
Šalčininkai d. mun.;2006;80;197;59;138
Šalčininkai d. mun.;2006;81;183;39;144
Šalčininkai d. mun.;2006;82;164;24;140
Šalčininkai d. mun.;2006;83;98;30;68
Šalčininkai d. mun.;2006;84;113;19;94
Šalčininkai d. mun.;2006;85;299;64;235
Šalčininkai d. mun.;2007;-1;36566;17337;19229
Šalčininkai d. mun.;2007;0;355;183;172
Šalčininkai d. mun.;2007;1;396;196;200
Šalčininkai d. mun.;2007;2;367;165;202
Šalčininkai d. mun.;2007;3;379;183;196
Šalčininkai d. mun.;2007;4;350;166;184
Šalčininkai d. mun.;2007;5;375;171;204
Šalčininkai d. mun.;2007;6;386;197;189
Šalčininkai d. mun.;2007;7;402;224;178
Šalčininkai d. mun.;2007;8;422;213;209
Šalčininkai d. mun.;2007;9;426;201;225
Šalčininkai d. mun.;2007;10;446;233;213
Šalčininkai d. mun.;2007;11;456;242;214
Šalčininkai d. mun.;2007;12;490;259;231
Šalčininkai d. mun.;2007;13;545;295;250
Šalčininkai d. mun.;2007;14;621;293;328
Šalčininkai d. mun.;2007;15;561;285;276
Šalčininkai d. mun.;2007;16;609;339;270
Šalčininkai d. mun.;2007;17;600;308;292
Šalčininkai d. mun.;2007;18;640;317;323
Šalčininkai d. mun.;2007;19;577;294;283
Šalčininkai d. mun.;2007;20;578;310;268
Šalčininkai d. mun.;2007;21;555;288;267
Šalčininkai d. mun.;2007;22;580;321;259
Šalčininkai d. mun.;2007;23;488;270;218
Šalčininkai d. mun.;2007;24;461;253;208
Šalčininkai d. mun.;2007;25;437;240;197
Šalčininkai d. mun.;2007;26;439;242;197
Šalčininkai d. mun.;2007;27;453;230;223
Šalčininkai d. mun.;2007;28;445;234;211
Šalčininkai d. mun.;2007;29;435;239;196
Šalčininkai d. mun.;2007;30;506;260;246
Šalčininkai d. mun.;2007;31;450;242;208
Šalčininkai d. mun.;2007;32;506;255;251
Šalčininkai d. mun.;2007;33;496;243;253
Šalčininkai d. mun.;2007;34;504;254;250
Šalčininkai d. mun.;2007;35;511;257;254
Šalčininkai d. mun.;2007;36;499;266;233
Šalčininkai d. mun.;2007;37;484;242;242
Šalčininkai d. mun.;2007;38;536;270;266
Šalčininkai d. mun.;2007;39;548;259;289
Šalčininkai d. mun.;2007;40;491;267;224
Šalčininkai d. mun.;2007;41;523;259;264
Šalčininkai d. mun.;2007;42;533;283;250
Šalčininkai d. mun.;2007;43;594;280;314
Šalčininkai d. mun.;2007;44;529;275;254
Šalčininkai d. mun.;2007;45;606;309;297
Šalčininkai d. mun.;2007;46;598;296;302
Šalčininkai d. mun.;2007;47;569;276;293
Šalčininkai d. mun.;2007;48;588;318;270
Šalčininkai d. mun.;2007;49;496;254;242
Šalčininkai d. mun.;2007;50;421;197;224
Šalčininkai d. mun.;2007;51;428;229;199
Šalčininkai d. mun.;2007;52;424;216;208
Šalčininkai d. mun.;2007;53;403;204;199
Šalčininkai d. mun.;2007;54;395;184;211
Šalčininkai d. mun.;2007;55;411;197;214
Šalčininkai d. mun.;2007;56;406;199;207
Šalčininkai d. mun.;2007;57;411;197;214
Šalčininkai d. mun.;2007;58;386;179;207
Šalčininkai d. mun.;2007;59;305;149;156
Šalčininkai d. mun.;2007;60;339;159;180
Šalčininkai d. mun.;2007;61;335;163;172
Šalčininkai d. mun.;2007;62;276;127;149
Šalčininkai d. mun.;2007;63;326;123;203
Šalčininkai d. mun.;2007;64;377;162;215
Šalčininkai d. mun.;2007;65;296;108;188
Šalčininkai d. mun.;2007;66;390;132;258
Šalčininkai d. mun.;2007;67;378;137;241
Šalčininkai d. mun.;2007;68;381;125;256
Šalčininkai d. mun.;2007;69;400;144;256
Šalčininkai d. mun.;2007;70;395;139;256
Šalčininkai d. mun.;2007;71;378;154;224
Šalčininkai d. mun.;2007;72;354;116;238
Šalčininkai d. mun.;2007;73;333;104;229
Šalčininkai d. mun.;2007;74;340;113;227
Šalčininkai d. mun.;2007;75;280;75;205
Šalčininkai d. mun.;2007;76;314;104;210
Šalčininkai d. mun.;2007;77;278;74;204
Šalčininkai d. mun.;2007;78;250;74;176
Šalčininkai d. mun.;2007;79;203;41;162
Šalčininkai d. mun.;2007;80;187;52;135
Šalčininkai d. mun.;2007;81;176;52;124
Šalčininkai d. mun.;2007;82;161;33;128
Šalčininkai d. mun.;2007;83;140;20;120
Šalčininkai d. mun.;2007;84;88;25;63
Šalčininkai d. mun.;2007;85;360;74;286
Šalčininkai d. mun.;2008;-1;36145;17089;19056
Šalčininkai d. mun.;2008;0;390;190;200
Šalčininkai d. mun.;2008;1;353;182;171
Šalčininkai d. mun.;2008;2;397;195;202
Šalčininkai d. mun.;2008;3;364;164;200
Šalčininkai d. mun.;2008;4;378;184;194
Šalčininkai d. mun.;2008;5;348;166;182
Šalčininkai d. mun.;2008;6;372;170;202
Šalčininkai d. mun.;2008;7;383;193;190
Šalčininkai d. mun.;2008;8;404;228;176
Šalčininkai d. mun.;2008;9;424;214;210
Šalčininkai d. mun.;2008;10;428;200;228
Šalčininkai d. mun.;2008;11;444;231;213
Šalčininkai d. mun.;2008;12;458;244;214
Šalčininkai d. mun.;2008;13;487;257;230
Šalčininkai d. mun.;2008;14;549;298;251
Šalčininkai d. mun.;2008;15;627;293;334
Šalčininkai d. mun.;2008;16;560;286;274
Šalčininkai d. mun.;2008;17;603;334;269
Šalčininkai d. mun.;2008;18;599;307;292
Šalčininkai d. mun.;2008;19;628;311;317
Šalčininkai d. mun.;2008;20;570;292;278
Šalčininkai d. mun.;2008;21;574;309;265
Šalčininkai d. mun.;2008;22;548;283;265
Šalčininkai d. mun.;2008;23;569;316;253
Šalčininkai d. mun.;2008;24;482;265;217
Šalčininkai d. mun.;2008;25;450;247;203
Šalčininkai d. mun.;2008;26;430;235;195
Šalčininkai d. mun.;2008;27;427;234;193
Šalčininkai d. mun.;2008;28;439;225;214
Šalčininkai d. mun.;2008;29;433;228;205
Šalčininkai d. mun.;2008;30;434;237;197
Šalčininkai d. mun.;2008;31;496;254;242
Šalčininkai d. mun.;2008;32;447;243;204
Šalčininkai d. mun.;2008;33;503;251;252
Šalčininkai d. mun.;2008;34;487;235;252
Šalčininkai d. mun.;2008;35;490;247;243
Šalčininkai d. mun.;2008;36;511;258;253
Šalčininkai d. mun.;2008;37;493;261;232
Šalčininkai d. mun.;2008;38;479;237;242
Šalčininkai d. mun.;2008;39;524;262;262
Šalčininkai d. mun.;2008;40;543;255;288
Šalčininkai d. mun.;2008;41;485;262;223
Šalčininkai d. mun.;2008;42;509;248;261
Šalčininkai d. mun.;2008;43;534;283;251
Šalčininkai d. mun.;2008;44;587;276;311
Šalčininkai d. mun.;2008;45;525;271;254
Šalčininkai d. mun.;2008;46;596;298;298
Šalčininkai d. mun.;2008;47;588;288;300
Šalčininkai d. mun.;2008;48;558;268;290
Šalčininkai d. mun.;2008;49;585;314;271
Šalčininkai d. mun.;2008;50;486;248;238
Šalčininkai d. mun.;2008;51;419;196;223
Šalčininkai d. mun.;2008;52;428;230;198
Šalčininkai d. mun.;2008;53;419;214;205
Šalčininkai d. mun.;2008;54;391;195;196
Šalčininkai d. mun.;2008;55;392;183;209
Šalčininkai d. mun.;2008;56;403;194;209
Šalčininkai d. mun.;2008;57;392;191;201
Šalčininkai d. mun.;2008;58;402;190;212
Šalčininkai d. mun.;2008;59;377;172;205
Šalčininkai d. mun.;2008;60;298;143;155
Šalčininkai d. mun.;2008;61;324;148;176
Šalčininkai d. mun.;2008;62;326;155;171
Šalčininkai d. mun.;2008;63;268;119;149
Šalčininkai d. mun.;2008;64;318;117;201
Šalčininkai d. mun.;2008;65;364;149;215
Šalčininkai d. mun.;2008;66;294;107;187
Šalčininkai d. mun.;2008;67;375;124;251
Šalčininkai d. mun.;2008;68;358;125;233
Šalčininkai d. mun.;2008;69;374;118;256
Šalčininkai d. mun.;2008;70;382;133;249
Šalčininkai d. mun.;2008;71;376;127;249
Šalčininkai d. mun.;2008;72;359;138;221
Šalčininkai d. mun.;2008;73;340;110;230
Šalčininkai d. mun.;2008;74;311;90;221
Šalčininkai d. mun.;2008;75;327;107;220
Šalčininkai d. mun.;2008;76;265;69;196
Šalčininkai d. mun.;2008;77;299;98;201
Šalčininkai d. mun.;2008;78;254;67;187
Šalčininkai d. mun.;2008;79;231;71;160
Šalčininkai d. mun.;2008;80;189;34;155
Šalčininkai d. mun.;2008;81;174;46;128
Šalčininkai d. mun.;2008;82;154;45;109
Šalčininkai d. mun.;2008;83;139;28;111
Šalčininkai d. mun.;2008;84;123;14;109
Šalčininkai d. mun.;2008;85;322;65;257
Šalčininkai d. mun.;2009;-1;35802;16942;18860
Šalčininkai d. mun.;2009;0;416;216;200
Šalčininkai d. mun.;2009;1;388;191;197
Šalčininkai d. mun.;2009;2;353;182;171
Šalčininkai d. mun.;2009;3;396;197;199
Šalčininkai d. mun.;2009;4;361;164;197
Šalčininkai d. mun.;2009;5;380;183;197
Šalčininkai d. mun.;2009;6;346;165;181
Šalčininkai d. mun.;2009;7;373;172;201
Šalčininkai d. mun.;2009;8;382;191;191
Šalčininkai d. mun.;2009;9;404;226;178
Šalčininkai d. mun.;2009;10;425;215;210
Šalčininkai d. mun.;2009;11;432;202;230
Šalčininkai d. mun.;2009;12;443;230;213
Šalčininkai d. mun.;2009;13;456;244;212
Šalčininkai d. mun.;2009;14;487;258;229
Šalčininkai d. mun.;2009;15;546;296;250
Šalčininkai d. mun.;2009;16;622;292;330
Šalčininkai d. mun.;2009;17;556;281;275
Šalčininkai d. mun.;2009;18;598;330;268
Šalčininkai d. mun.;2009;19;598;304;294
Šalčininkai d. mun.;2009;20;624;309;315
Šalčininkai d. mun.;2009;21;565;290;275
Šalčininkai d. mun.;2009;22;562;303;259
Šalčininkai d. mun.;2009;23;536;276;260
Šalčininkai d. mun.;2009;24;568;315;253
Šalčininkai d. mun.;2009;25;471;263;208
Šalčininkai d. mun.;2009;26;435;240;195
Šalčininkai d. mun.;2009;27;414;227;187
Šalčininkai d. mun.;2009;28;420;231;189
Šalčininkai d. mun.;2009;29;432;221;211
Šalčininkai d. mun.;2009;30;429;229;200
Šalčininkai d. mun.;2009;31;430;234;196
Šalčininkai d. mun.;2009;32;495;255;240
Šalčininkai d. mun.;2009;33;438;235;203
Šalčininkai d. mun.;2009;34;498;246;252
Šalčininkai d. mun.;2009;35;480;231;249
Šalčininkai d. mun.;2009;36;486;243;243
Šalčininkai d. mun.;2009;37;506;253;253
Šalčininkai d. mun.;2009;38;492;262;230
Šalčininkai d. mun.;2009;39;469;233;236
Šalčininkai d. mun.;2009;40;525;261;264
Šalčininkai d. mun.;2009;41;535;251;284
Šalčininkai d. mun.;2009;42;474;255;219
Šalčininkai d. mun.;2009;43;500;243;257
Šalčininkai d. mun.;2009;44;528;283;245
Šalčininkai d. mun.;2009;45;577;270;307
Šalčininkai d. mun.;2009;46;521;268;253
Šalčininkai d. mun.;2009;47;589;294;295
Šalčininkai d. mun.;2009;48;582;284;298
Šalčininkai d. mun.;2009;49;546;262;284
Šalčininkai d. mun.;2009;50;579;310;269
Šalčininkai d. mun.;2009;51;482;243;239
Šalčininkai d. mun.;2009;52;413;190;223
Šalčininkai d. mun.;2009;53;419;225;194
Šalčininkai d. mun.;2009;54;410;202;208
Šalčininkai d. mun.;2009;55;385;190;195
Šalčininkai d. mun.;2009;56;387;179;208
Šalčininkai d. mun.;2009;57;395;190;205
Šalčininkai d. mun.;2009;58;382;186;196
Šalčininkai d. mun.;2009;59;399;185;214
Šalčininkai d. mun.;2009;60;367;168;199
Šalčininkai d. mun.;2009;61;294;140;154
Šalčininkai d. mun.;2009;62;322;144;178
Šalčininkai d. mun.;2009;63;320;151;169
Šalčininkai d. mun.;2009;64;258;111;147
Šalčininkai d. mun.;2009;65;303;105;198
Šalčininkai d. mun.;2009;66;349;144;205
Šalčininkai d. mun.;2009;67;281;101;180
Šalčininkai d. mun.;2009;68;362;117;245
Šalčininkai d. mun.;2009;69;342;111;231
Šalčininkai d. mun.;2009;70;361;109;252
Šalčininkai d. mun.;2009;71;363;120;243
Šalčininkai d. mun.;2009;72;360;119;241
Šalčininkai d. mun.;2009;73;346;135;211
Šalčininkai d. mun.;2009;74;328;104;224
Šalčininkai d. mun.;2009;75;293;81;212
Šalčininkai d. mun.;2009;76;305;98;207
Šalčininkai d. mun.;2009;77;247;64;183
Šalčininkai d. mun.;2009;78;278;90;188
Šalčininkai d. mun.;2009;79;239;60;179
Šalčininkai d. mun.;2009;80;211;60;151
Šalčininkai d. mun.;2009;81;166;30;136
Šalčininkai d. mun.;2009;82;152;40;112
Šalčininkai d. mun.;2009;83;133;37;96
Šalčininkai d. mun.;2009;84;124;25;99
Šalčininkai d. mun.;2009;85;358;72;286
Šalčininkai d. mun.;2010;-1;35357;16759;18598
Šalčininkai d. mun.;2010;0;394;211;183
Šalčininkai d. mun.;2010;1;410;210;200
Šalčininkai d. mun.;2010;2;384;190;194
Šalčininkai d. mun.;2010;3;353;184;169
Šalčininkai d. mun.;2010;4;396;196;200
Šalčininkai d. mun.;2010;5;360;166;194
Šalčininkai d. mun.;2010;6;375;182;193
Šalčininkai d. mun.;2010;7;345;164;181
Šalčininkai d. mun.;2010;8;373;172;201
Šalčininkai d. mun.;2010;9;385;193;192
Šalčininkai d. mun.;2010;10;403;226;177
Šalčininkai d. mun.;2010;11;423;215;208
Šalčininkai d. mun.;2010;12;432;202;230
Šalčininkai d. mun.;2010;13;444;233;211
Šalčininkai d. mun.;2010;14;459;245;214
Šalčininkai d. mun.;2010;15;491;261;230
Šalčininkai d. mun.;2010;16;546;297;249
Šalčininkai d. mun.;2010;17;620;291;329
Šalčininkai d. mun.;2010;18;554;282;272
Šalčininkai d. mun.;2010;19;594;329;265
Šalčininkai d. mun.;2010;20;593;305;288
Šalčininkai d. mun.;2010;21;605;303;302
Šalčininkai d. mun.;2010;22;553;284;269
Šalčininkai d. mun.;2010;23;544;299;245
Šalčininkai d. mun.;2010;24;514;268;246
Šalčininkai d. mun.;2010;25;555;310;245
Šalčininkai d. mun.;2010;26;451;256;195
Šalčininkai d. mun.;2010;27;421;229;192
Šalčininkai d. mun.;2010;28;403;220;183
Šalčininkai d. mun.;2010;29;411;226;185
Šalčininkai d. mun.;2010;30;425;221;204
Šalčininkai d. mun.;2010;31;418;222;196
Šalčininkai d. mun.;2010;32;426;235;191
Šalčininkai d. mun.;2010;33;485;250;235
Šalčininkai d. mun.;2010;34;426;228;198
Šalčininkai d. mun.;2010;35;490;242;248
Šalčininkai d. mun.;2010;36;471;225;246
Šalčininkai d. mun.;2010;37;475;240;235
Šalčininkai d. mun.;2010;38;499;250;249
Šalčininkai d. mun.;2010;39;482;254;228
Šalčininkai d. mun.;2010;40;457;224;233
Šalčininkai d. mun.;2010;41;514;253;261
Šalčininkai d. mun.;2010;42;529;248;281
Šalčininkai d. mun.;2010;43;475;256;219
Šalčininkai d. mun.;2010;44;494;241;253
Šalčininkai d. mun.;2010;45;519;275;244
Šalčininkai d. mun.;2010;46;571;269;302
Šalčininkai d. mun.;2010;47;508;258;250
Šalčininkai d. mun.;2010;48;582;291;291
Šalčininkai d. mun.;2010;49;573;278;295
Šalčininkai d. mun.;2010;50;538;256;282
Šalčininkai d. mun.;2010;51;571;306;265
Šalčininkai d. mun.;2010;52;481;239;242
Šalčininkai d. mun.;2010;53;412;188;224
Šalčininkai d. mun.;2010;54;410;218;192
Šalčininkai d. mun.;2010;55;404;197;207
Šalčininkai d. mun.;2010;56;380;185;195
Šalčininkai d. mun.;2010;57;386;178;208
Šalčininkai d. mun.;2010;58;382;180;202
Šalčininkai d. mun.;2010;59;376;184;192
Šalčininkai d. mun.;2010;60;393;182;211
Šalčininkai d. mun.;2010;61;357;163;194
Šalčininkai d. mun.;2010;62;287;136;151
Šalčininkai d. mun.;2010;63;310;138;172
Šalčininkai d. mun.;2010;64;305;141;164
Šalčininkai d. mun.;2010;65;248;105;143
Šalčininkai d. mun.;2010;66;297;101;196
Šalčininkai d. mun.;2010;67;333;135;198
Šalčininkai d. mun.;2010;68;270;97;173
Šalčininkai d. mun.;2010;69;347;108;239
Šalčininkai d. mun.;2010;70;334;107;227
Šalčininkai d. mun.;2010;71;345;104;241
Šalčininkai d. mun.;2010;72;351;112;239
Šalčininkai d. mun.;2010;73;338;106;232
Šalčininkai d. mun.;2010;74;324;119;205
Šalčininkai d. mun.;2010;75;317;97;220
Šalčininkai d. mun.;2010;76;278;73;205
Šalčininkai d. mun.;2010;77;286;89;197
Šalčininkai d. mun.;2010;78;231;56;175
Šalčininkai d. mun.;2010;79;260;80;180
Šalčininkai d. mun.;2010;80;217;49;168
Šalčininkai d. mun.;2010;81;188;49;139
Šalčininkai d. mun.;2010;82;162;30;132
Šalčininkai d. mun.;2010;83;135;34;101
Šalčininkai d. mun.;2010;84;116;34;82
Šalčininkai d. mun.;2010;85;378;74;304
Šalčininkai d. mun.;2011;-1;34671;16459;18212
Šalčininkai d. mun.;2011;0;339;192;147
Šalčininkai d. mun.;2011;1;378;193;185
Šalčininkai d. mun.;2011;2;374;192;182
Šalčininkai d. mun.;2011;3;355;185;170
Šalčininkai d. mun.;2011;4;334;172;162
Šalčininkai d. mun.;2011;5;371;188;183
Šalčininkai d. mun.;2011;6;335;156;179
Šalčininkai d. mun.;2011;7;353;174;179
Šalčininkai d. mun.;2011;8;324;164;160
Šalčininkai d. mun.;2011;9;356;164;192
Šalčininkai d. mun.;2011;10;383;197;186
Šalčininkai d. mun.;2011;11;380;206;174
Šalčininkai d. mun.;2011;12;405;212;193
Šalčininkai d. mun.;2011;13;414;198;216
Šalčininkai d. mun.;2011;14;434;223;211
Šalčininkai d. mun.;2011;15;438;234;204
Šalčininkai d. mun.;2011;16;470;251;219
Šalčininkai d. mun.;2011;17;516;281;235
Šalčininkai d. mun.;2011;18;576;268;308
Šalčininkai d. mun.;2011;19;498;262;236
Šalčininkai d. mun.;2011;20;560;315;245
Šalčininkai d. mun.;2011;21;564;292;272
Šalčininkai d. mun.;2011;22;569;292;277
Šalčininkai d. mun.;2011;23;492;267;225
Šalčininkai d. mun.;2011;24;491;280;211
Šalčininkai d. mun.;2011;25;454;247;207
Šalčininkai d. mun.;2011;26;459;249;210
Šalčininkai d. mun.;2011;27;422;229;193
Šalčininkai d. mun.;2011;28;408;209;199
Šalčininkai d. mun.;2011;29;410;211;199
Šalčininkai d. mun.;2011;30;442;235;207
Šalčininkai d. mun.;2011;31;443;230;213
Šalčininkai d. mun.;2011;32;420;207;213
Šalčininkai d. mun.;2011;33;438;249;189
Šalčininkai d. mun.;2011;34;487;245;242
Šalčininkai d. mun.;2011;35;439;221;218
Šalčininkai d. mun.;2011;36;523;258;265
Šalčininkai d. mun.;2011;37;519;252;267
Šalčininkai d. mun.;2011;38;501;258;243
Šalčininkai d. mun.;2011;39;530;266;264
Šalčininkai d. mun.;2011;40;505;266;239
Šalčininkai d. mun.;2011;41;479;239;240
Šalčininkai d. mun.;2011;42;537;270;267
Šalčininkai d. mun.;2011;43;545;259;286
Šalčininkai d. mun.;2011;44;502;264;238
Šalčininkai d. mun.;2011;45;521;259;262
Šalčininkai d. mun.;2011;46;541;287;254
Šalčininkai d. mun.;2011;47;593;276;317
Šalčininkai d. mun.;2011;48;514;264;250
Šalčininkai d. mun.;2011;49;570;286;284
Šalčininkai d. mun.;2011;50;567;285;282
Šalčininkai d. mun.;2011;51;554;258;296
Šalčininkai d. mun.;2011;52;540;282;258
Šalčininkai d. mun.;2011;53;461;231;230
Šalčininkai d. mun.;2011;54;405;186;219
Šalčininkai d. mun.;2011;55;402;204;198
Šalčininkai d. mun.;2011;56;398;191;207
Šalčininkai d. mun.;2011;57;362;168;194
Šalčininkai d. mun.;2011;58;394;178;216
Šalčininkai d. mun.;2011;59;397;184;213
Šalčininkai d. mun.;2011;60;391;191;200
Šalčininkai d. mun.;2011;61;371;163;208
Šalčininkai d. mun.;2011;62;332;145;187
Šalčininkai d. mun.;2011;63;266;126;140
Šalčininkai d. mun.;2011;64;285;124;161
Šalčininkai d. mun.;2011;65;290;137;153
Šalčininkai d. mun.;2011;66;247;100;147
Šalčininkai d. mun.;2011;67;274;95;179
Šalčininkai d. mun.;2011;68;317;124;193
Šalčininkai d. mun.;2011;69;261;94;167
Šalčininkai d. mun.;2011;70;338;108;230
Šalčininkai d. mun.;2011;71;331;109;222
Šalčininkai d. mun.;2011;72;324;102;222
Šalčininkai d. mun.;2011;73;330;107;223
Šalčininkai d. mun.;2011;74;315;100;215
Šalčininkai d. mun.;2011;75;292;101;191
Šalčininkai d. mun.;2011;76;284;87;197
Šalčininkai d. mun.;2011;77;261;66;195
Šalčininkai d. mun.;2011;78;258;78;180
Šalčininkai d. mun.;2011;79;212;54;158
Šalčininkai d. mun.;2011;80;228;67;161
Šalčininkai d. mun.;2011;81;193;43;150
Šalčininkai d. mun.;2011;82;173;45;128
Šalčininkai d. mun.;2011;83;139;27;112
Šalčininkai d. mun.;2011;84;123;33;90
Šalčininkai d. mun.;2011;85;445;72;373
Šalčininkai d. mun.;2012;-1;34175;16220;17955
Šalčininkai d. mun.;2012;0;383;190;193
Šalčininkai d. mun.;2012;1;341;192;149
Šalčininkai d. mun.;2012;2;372;192;180
Šalčininkai d. mun.;2012;3;372;190;182
Šalčininkai d. mun.;2012;4;352;183;169
Šalčininkai d. mun.;2012;5;337;172;165
Šalčininkai d. mun.;2012;6;369;188;181
Šalčininkai d. mun.;2012;7;331;152;179
Šalčininkai d. mun.;2012;8;349;171;178
Šalčininkai d. mun.;2012;9;321;163;158
Šalčininkai d. mun.;2012;10;357;165;192
Šalčininkai d. mun.;2012;11;381;196;185
Šalčininkai d. mun.;2012;12;379;204;175
Šalčininkai d. mun.;2012;13;407;214;193
Šalčininkai d. mun.;2012;14;415;199;216
Šalčininkai d. mun.;2012;15;433;222;211
Šalčininkai d. mun.;2012;16;439;237;202
Šalčininkai d. mun.;2012;17;472;253;219
Šalčininkai d. mun.;2012;18;515;281;234
Šalčininkai d. mun.;2012;19;564;262;302
Šalčininkai d. mun.;2012;20;487;256;231
Šalčininkai d. mun.;2012;21;546;307;239
Šalčininkai d. mun.;2012;22;549;283;266
Šalčininkai d. mun.;2012;23;545;279;266
Šalčininkai d. mun.;2012;24;471;259;212
Šalčininkai d. mun.;2012;25;472;274;198
Šalčininkai d. mun.;2012;26;429;231;198
Šalčininkai d. mun.;2012;27;444;243;201
Šalčininkai d. mun.;2012;28;408;222;186
Šalčininkai d. mun.;2012;29;378;194;184
Šalčininkai d. mun.;2012;30;398;208;190
Šalčininkai d. mun.;2012;31;431;235;196
Šalčininkai d. mun.;2012;32;438;228;210
Šalčininkai d. mun.;2012;33;412;201;211
Šalčininkai d. mun.;2012;34;433;247;186
Šalčininkai d. mun.;2012;35;478;239;239
Šalčininkai d. mun.;2012;36;431;218;213
Šalčininkai d. mun.;2012;37;521;255;266
Šalčininkai d. mun.;2012;38;513;248;265
Šalčininkai d. mun.;2012;39;495;257;238
Šalčininkai d. mun.;2012;40;516;257;259
Šalčininkai d. mun.;2012;41;496;259;237
Šalčininkai d. mun.;2012;42;472;236;236
Šalčininkai d. mun.;2012;43;526;261;265
Šalčininkai d. mun.;2012;44;542;255;287
Šalčininkai d. mun.;2012;45;488;254;234
Šalčininkai d. mun.;2012;46;516;256;260
Šalčininkai d. mun.;2012;47;538;287;251
Šalčininkai d. mun.;2012;48;587;274;313
Šalčininkai d. mun.;2012;49;495;248;247
Šalčininkai d. mun.;2012;50;563;281;282
Šalčininkai d. mun.;2012;51;561;280;281
Šalčininkai d. mun.;2012;52;544;251;293
Šalčininkai d. mun.;2012;53;533;279;254
Šalčininkai d. mun.;2012;54;453;227;226
Šalčininkai d. mun.;2012;55;400;187;213
Šalčininkai d. mun.;2012;56;393;196;197
Šalčininkai d. mun.;2012;57;387;183;204
Šalčininkai d. mun.;2012;58;353;163;190
Šalčininkai d. mun.;2012;59;389;174;215
Šalčininkai d. mun.;2012;60;397;182;215
Šalčininkai d. mun.;2012;61;381;184;197
Šalčininkai d. mun.;2012;62;357;155;202
Šalčininkai d. mun.;2012;63;326;140;186
Šalčininkai d. mun.;2012;64;263;122;141
Šalčininkai d. mun.;2012;65;278;121;157
Šalčininkai d. mun.;2012;66;278;129;149
Šalčininkai d. mun.;2012;67;231;90;141
Šalčininkai d. mun.;2012;68;269;93;176
Šalčininkai d. mun.;2012;69;304;117;187
Šalčininkai d. mun.;2012;70;248;83;165
Šalčininkai d. mun.;2012;71;326;99;227
Šalčininkai d. mun.;2012;72;323;104;219
Šalčininkai d. mun.;2012;73;311;96;215
Šalčininkai d. mun.;2012;74;311;100;211
Šalčininkai d. mun.;2012;75;297;91;206
Šalčininkai d. mun.;2012;76;280;94;186
Šalčininkai d. mun.;2012;77;269;81;188
Šalčininkai d. mun.;2012;78;247;57;190
Šalčininkai d. mun.;2012;79;236;67;169
Šalčininkai d. mun.;2012;80;200;50;150
Šalčininkai d. mun.;2012;81;204;57;147
Šalčininkai d. mun.;2012;82;181;39;142
Šalčininkai d. mun.;2012;83;158;40;118
Šalčininkai d. mun.;2012;84;115;23;92
Šalčininkai d. mun.;2012;85;465;88;377
Šalčininkai d. mun.;2013;-1;33710;16009;17701
Šalčininkai d. mun.;2013;0;395;196;199
Šalčininkai d. mun.;2013;1;378;190;188
Šalčininkai d. mun.;2013;2;337;189;148
Šalčininkai d. mun.;2013;3;365;189;176
Šalčininkai d. mun.;2013;4;355;180;175
Šalčininkai d. mun.;2013;5;344;180;164
Šalčininkai d. mun.;2013;6;326;167;159
Šalčininkai d. mun.;2013;7;368;186;182
Šalčininkai d. mun.;2013;8;322;147;175
Šalčininkai d. mun.;2013;9;345;169;176
Šalčininkai d. mun.;2013;10;317;158;159
Šalčininkai d. mun.;2013;11;353;163;190
Šalčininkai d. mun.;2013;12;376;195;181
Šalčininkai d. mun.;2013;13;376;204;172
Šalčininkai d. mun.;2013;14;409;217;192
Šalčininkai d. mun.;2013;15;416;201;215
Šalčininkai d. mun.;2013;16;434;222;212
Šalčininkai d. mun.;2013;17;435;235;200
Šalčininkai d. mun.;2013;18;469;253;216
Šalčininkai d. mun.;2013;19;509;280;229
Šalčininkai d. mun.;2013;20;556;261;295
Šalčininkai d. mun.;2013;21;473;249;224
Šalčininkai d. mun.;2013;22;533;303;230
Šalčininkai d. mun.;2013;23;527;277;250
Šalčininkai d. mun.;2013;24;516;264;252
Šalčininkai d. mun.;2013;25;452;251;201
Šalčininkai d. mun.;2013;26;454;275;179
Šalčininkai d. mun.;2013;27;415;233;182
Šalčininkai d. mun.;2013;28;424;231;193
Šalčininkai d. mun.;2013;29;394;220;174
Šalčininkai d. mun.;2013;30;360;188;172
Šalčininkai d. mun.;2013;31;400;209;191
Šalčininkai d. mun.;2013;32;409;221;188
Šalčininkai d. mun.;2013;33;419;219;200
Šalčininkai d. mun.;2013;34;403;195;208
Šalčininkai d. mun.;2013;35;423;237;186
Šalčininkai d. mun.;2013;36;465;230;235
Šalčininkai d. mun.;2013;37;417;206;211
Šalčininkai d. mun.;2013;38;509;249;260
Šalčininkai d. mun.;2013;39;508;248;260
Šalčininkai d. mun.;2013;40;497;259;238
Šalčininkai d. mun.;2013;41;513;254;259
Šalčininkai d. mun.;2013;42;485;250;235
Šalčininkai d. mun.;2013;43;465;231;234
Šalčininkai d. mun.;2013;44;512;249;263
Šalčininkai d. mun.;2013;45;537;257;280
Šalčininkai d. mun.;2013;46;483;254;229
Šalčininkai d. mun.;2013;47;513;253;260
Šalčininkai d. mun.;2013;48;530;282;248
Šalčininkai d. mun.;2013;49;578;268;310
Šalčininkai d. mun.;2013;50;494;245;249
Šalčininkai d. mun.;2013;51;554;276;278
Šalčininkai d. mun.;2013;52;556;276;280
Šalčininkai d. mun.;2013;53;530;243;287
Šalčininkai d. mun.;2013;54;528;275;253
Šalčininkai d. mun.;2013;55;444;221;223
Šalčininkai d. mun.;2013;56;400;185;215
Šalčininkai d. mun.;2013;57;394;193;201
Šalčininkai d. mun.;2013;58;379;175;204
Šalčininkai d. mun.;2013;59;346;158;188
Šalčininkai d. mun.;2013;60;383;167;216
Šalčininkai d. mun.;2013;61;392;179;213
Šalčininkai d. mun.;2013;62;377;181;196
Šalčininkai d. mun.;2013;63;342;145;197
Šalčininkai d. mun.;2013;64;320;135;185
Šalčininkai d. mun.;2013;65;251;113;138
Šalčininkai d. mun.;2013;66;271;117;154
Šalčininkai d. mun.;2013;67;275;126;149
Šalčininkai d. mun.;2013;68;222;86;136
Šalčininkai d. mun.;2013;69;259;87;172
Šalčininkai d. mun.;2013;70;294;111;183
Šalčininkai d. mun.;2013;71;244;80;164
Šalčininkai d. mun.;2013;72;321;97;224
Šalčininkai d. mun.;2013;73;307;95;212
Šalčininkai d. mun.;2013;74;302;91;211
Šalčininkai d. mun.;2013;75;301;92;209
Šalčininkai d. mun.;2013;76;290;89;201
Šalčininkai d. mun.;2013;77;260;81;179
Šalčininkai d. mun.;2013;78;254;76;178
Šalčininkai d. mun.;2013;79;230;48;182
Šalčininkai d. mun.;2013;80;218;60;158
Šalčininkai d. mun.;2013;81;185;46;139
Šalčininkai d. mun.;2013;82;186;51;135
Šalčininkai d. mun.;2013;83;168;38;130
Šalčininkai d. mun.;2013;84;142;35;107
Šalčininkai d. mun.;2013;85;492;92;400
Šalčininkai d. mun.;2014;-1;33172;15775;17397
Šalčininkai d. mun.;2014;0;350;196;154
Šalčininkai d. mun.;2014;1;391;194;197
Šalčininkai d. mun.;2014;2;369;184;185
Šalčininkai d. mun.;2014;3;332;188;144
Šalčininkai d. mun.;2014;4;365;192;173
Šalčininkai d. mun.;2014;5;354;180;174
Šalčininkai d. mun.;2014;6;340;176;164
Šalčininkai d. mun.;2014;7;320;163;157
Šalčininkai d. mun.;2014;8;370;188;182
Šalčininkai d. mun.;2014;9;324;149;175
Šalčininkai d. mun.;2014;10;340;167;173
Šalčininkai d. mun.;2014;11;316;159;157
Šalčininkai d. mun.;2014;12;350;161;189
Šalčininkai d. mun.;2014;13;372;194;178
Šalčininkai d. mun.;2014;14;377;205;172
Šalčininkai d. mun.;2014;15;404;212;192
Šalčininkai d. mun.;2014;16;413;201;212
Šalčininkai d. mun.;2014;17;431;220;211
Šalčininkai d. mun.;2014;18;429;230;199
Šalčininkai d. mun.;2014;19;463;249;214
Šalčininkai d. mun.;2014;20;504;274;230
Šalčininkai d. mun.;2014;21;537;255;282
Šalčininkai d. mun.;2014;22;461;246;215
Šalčininkai d. mun.;2014;23;526;301;225
Šalčininkai d. mun.;2014;24;516;276;240
Šalčininkai d. mun.;2014;25;489;251;238
Šalčininkai d. mun.;2014;26;457;251;206
Šalčininkai d. mun.;2014;27;434;268;166
Šalčininkai d. mun.;2014;28;408;239;169
Šalčininkai d. mun.;2014;29;411;226;185
Šalčininkai d. mun.;2014;30;376;209;167
Šalčininkai d. mun.;2014;31;349;181;168
Šalčininkai d. mun.;2014;32;391;205;186
Šalčininkai d. mun.;2014;33;402;222;180
Šalčininkai d. mun.;2014;34;409;212;197
Šalčininkai d. mun.;2014;35;386;184;202
Šalčininkai d. mun.;2014;36;411;227;184
Šalčininkai d. mun.;2014;37;454;225;229
Šalčininkai d. mun.;2014;38;410;201;209
Šalčininkai d. mun.;2014;39;508;249;259
Šalčininkai d. mun.;2014;40;490;238;252
Šalčininkai d. mun.;2014;41;483;251;232
Šalčininkai d. mun.;2014;42;507;254;253
Šalčininkai d. mun.;2014;43;482;250;232
Šalčininkai d. mun.;2014;44;460;226;234
Šalčininkai d. mun.;2014;45;500;243;257
Šalčininkai d. mun.;2014;46;530;254;276
Šalčininkai d. mun.;2014;47;473;246;227
Šalčininkai d. mun.;2014;48;504;247;257
Šalčininkai d. mun.;2014;49;522;272;250
Šalčininkai d. mun.;2014;50;565;257;308
Šalčininkai d. mun.;2014;51;488;239;249
Šalčininkai d. mun.;2014;52;543;268;275
Šalčininkai d. mun.;2014;53;554;272;282
Šalčininkai d. mun.;2014;54;519;233;286
Šalčininkai d. mun.;2014;55;518;267;251
Šalčininkai d. mun.;2014;56;435;213;222
Šalčininkai d. mun.;2014;57;393;180;213
Šalčininkai d. mun.;2014;58;392;190;202
Šalčininkai d. mun.;2014;59;367;165;202
Šalčininkai d. mun.;2014;60;342;153;189
Šalčininkai d. mun.;2014;61;378;163;215
Šalčininkai d. mun.;2014;62;378;170;208
Šalčininkai d. mun.;2014;63;363;172;191
Šalčininkai d. mun.;2014;64;339;143;196
Šalčininkai d. mun.;2014;65;314;131;183
Šalčininkai d. mun.;2014;66;250;112;138
Šalčininkai d. mun.;2014;67;256;105;151
Šalčininkai d. mun.;2014;68;266;119;147
Šalčininkai d. mun.;2014;69;213;79;134
Šalčininkai d. mun.;2014;70;256;85;171
Šalčininkai d. mun.;2014;71;279;101;178
Šalčininkai d. mun.;2014;72;239;77;162
Šalčininkai d. mun.;2014;73;308;91;217
Šalčininkai d. mun.;2014;74;284;82;202
Šalčininkai d. mun.;2014;75;294;89;205
Šalčininkai d. mun.;2014;76;287;88;199
Šalčininkai d. mun.;2014;77;266;80;186
Šalčininkai d. mun.;2014;78;237;75;162
Šalčininkai d. mun.;2014;79;236;68;168
Šalčininkai d. mun.;2014;80;216;46;170
Šalčininkai d. mun.;2014;81;202;52;150
Šalčininkai d. mun.;2014;82;167;39;128
Šalčininkai d. mun.;2014;83;172;47;125
Šalčininkai d. mun.;2014;84;141;31;110
Šalčininkai d. mun.;2014;85;515;102;413
Šalčininkai d. mun.;2015;-1;32705;15608;17097
Šalčininkai d. mun.;2015;0;357;188;169
Šalčininkai d. mun.;2015;1;345;194;151
Šalčininkai d. mun.;2015;2;379;192;187
Šalčininkai d. mun.;2015;3;363;182;181
Šalčininkai d. mun.;2015;4;329;187;142
Šalčininkai d. mun.;2015;5;363;190;173
Šalčininkai d. mun.;2015;6;350;177;173
Šalčininkai d. mun.;2015;7;335;175;160
Šalčininkai d. mun.;2015;8;325;168;157
Šalčininkai d. mun.;2015;9;369;189;180
Šalčininkai d. mun.;2015;10;320;148;172
Šalčininkai d. mun.;2015;11;337;164;173
Šalčininkai d. mun.;2015;12;312;158;154
Šalčininkai d. mun.;2015;13;348;160;188
Šalčininkai d. mun.;2015;14;372;195;177
Šalčininkai d. mun.;2015;15;375;204;171
Šalčininkai d. mun.;2015;16;402;211;191
Šalčininkai d. mun.;2015;17;410;200;210
Šalčininkai d. mun.;2015;18;427;219;208
Šalčininkai d. mun.;2015;19;425;228;197
Šalčininkai d. mun.;2015;20;455;245;210
Šalčininkai d. mun.;2015;21;498;270;228
Šalčininkai d. mun.;2015;22;525;248;277
Šalčininkai d. mun.;2015;23;454;247;207
Šalčininkai d. mun.;2015;24;508;293;215
Šalčininkai d. mun.;2015;25;507;274;233
Šalčininkai d. mun.;2015;26;473;251;222
Šalčininkai d. mun.;2015;27;437;245;192
Šalčininkai d. mun.;2015;28;411;255;156
Šalčininkai d. mun.;2015;29;376;221;155
Šalčininkai d. mun.;2015;30;405;225;180
Šalčininkai d. mun.;2015;31;357;199;158
Šalčininkai d. mun.;2015;32;337;174;163
Šalčininkai d. mun.;2015;33;377;199;178
Šalčininkai d. mun.;2015;34;397;219;178
Šalčininkai d. mun.;2015;35;400;210;190
Šalčininkai d. mun.;2015;36;381;182;199
Šalčininkai d. mun.;2015;37;405;222;183
Šalčininkai d. mun.;2015;38;446;221;225
Šalčininkai d. mun.;2015;39;397;195;202
Šalčininkai d. mun.;2015;40;509;250;259
Šalčininkai d. mun.;2015;41;497;245;252
Šalčininkai d. mun.;2015;42;475;242;233
Šalčininkai d. mun.;2015;43;500;252;248
Šalčininkai d. mun.;2015;44;476;246;230
Šalčininkai d. mun.;2015;45;455;224;231
Šalčininkai d. mun.;2015;46;504;244;260
Šalčininkai d. mun.;2015;47;523;250;273
Šalčininkai d. mun.;2015;48;471;244;227
Šalčininkai d. mun.;2015;49;499;245;254
Šalčininkai d. mun.;2015;50;518;271;247
Šalčininkai d. mun.;2015;51;557;252;305
Šalčininkai d. mun.;2015;52;482;236;246
Šalčininkai d. mun.;2015;53;536;264;272
Šalčininkai d. mun.;2015;54;542;267;275
Šalčininkai d. mun.;2015;55;505;227;278
Šalčininkai d. mun.;2015;56;511;264;247
Šalčininkai d. mun.;2015;57;431;208;223
Šalčininkai d. mun.;2015;58;387;176;211
Šalčininkai d. mun.;2015;59;383;184;199
Šalčininkai d. mun.;2015;60;362;161;201
Šalčininkai d. mun.;2015;61;331;146;185
Šalčininkai d. mun.;2015;62;366;154;212
Šalčininkai d. mun.;2015;63;366;164;202
Šalčininkai d. mun.;2015;64;359;168;191
Šalčininkai d. mun.;2015;65;334;140;194
Šalčininkai d. mun.;2015;66;305;125;180
Šalčininkai d. mun.;2015;67;243;105;138
Šalčininkai d. mun.;2015;68;246;98;148
Šalčininkai d. mun.;2015;69;254;113;141
Šalčininkai d. mun.;2015;70;203;73;130
Šalčininkai d. mun.;2015;71;247;82;165
Šalčininkai d. mun.;2015;72;266;92;174
Šalčininkai d. mun.;2015;73;234;73;161
Šalčininkai d. mun.;2015;74;291;81;210
Šalčininkai d. mun.;2015;75;265;76;189
Šalčininkai d. mun.;2015;76;281;85;196
Šalčininkai d. mun.;2015;77;270;79;191
Šalčininkai d. mun.;2015;78;251;72;179
Šalčininkai d. mun.;2015;79;223;69;154
Šalčininkai d. mun.;2015;80;220;62;158
Šalčininkai d. mun.;2015;81;198;41;157
Šalčininkai d. mun.;2015;82;191;48;143
Šalčininkai d. mun.;2015;83;150;31;119
Šalčininkai d. mun.;2015;84;155;41;114
Šalčininkai d. mun.;2015;85;544;114;430
Šalčininkai d. mun.;2016;-1;32305;15409;16896
Šalčininkai d. mun.;2016;0;375;198;177
Šalčininkai d. mun.;2016;1;359;188;171
Šalčininkai d. mun.;2016;2;345;192;153
Šalčininkai d. mun.;2016;3;377;192;185
Šalčininkai d. mun.;2016;4;360;182;178
Šalčininkai d. mun.;2016;5;325;184;141
Šalčininkai d. mun.;2016;6;358;187;171
Šalčininkai d. mun.;2016;7;353;179;174
Šalčininkai d. mun.;2016;8;336;174;162
Šalčininkai d. mun.;2016;9;324;168;156
Šalčininkai d. mun.;2016;10;372;191;181
Šalčininkai d. mun.;2016;11;317;144;173
Šalčininkai d. mun.;2016;12;337;168;169
Šalčininkai d. mun.;2016;13;309;156;153
Šalčininkai d. mun.;2016;14;344;158;186
Šalčininkai d. mun.;2016;15;369;192;177
Šalčininkai d. mun.;2016;16;369;197;172
Šalčininkai d. mun.;2016;17;401;211;190
Šalčininkai d. mun.;2016;18;410;199;211
Šalčininkai d. mun.;2016;19;419;214;205
Šalčininkai d. mun.;2016;20;423;228;195
Šalčininkai d. mun.;2016;21;457;245;212
Šalčininkai d. mun.;2016;22;490;266;224
Šalčininkai d. mun.;2016;23;506;243;263
Šalčininkai d. mun.;2016;24;442;244;198
Šalčininkai d. mun.;2016;25;485;278;207
Šalčininkai d. mun.;2016;26;491;265;226
Šalčininkai d. mun.;2016;27;456;247;209
Šalčininkai d. mun.;2016;28;432;246;186
Šalčininkai d. mun.;2016;29;397;246;151
Šalčininkai d. mun.;2016;30;369;218;151
Šalčininkai d. mun.;2016;31;397;221;176
Šalčininkai d. mun.;2016;32;353;200;153
Šalčininkai d. mun.;2016;33;329;165;164
Šalčininkai d. mun.;2016;34;366;192;174
Šalčininkai d. mun.;2016;35;387;214;173
Šalčininkai d. mun.;2016;36;389;204;185
Šalčininkai d. mun.;2016;37;373;179;194
Šalčininkai d. mun.;2016;38;405;223;182
Šalčininkai d. mun.;2016;39;440;217;223
Šalčininkai d. mun.;2016;40;390;186;204
Šalčininkai d. mun.;2016;41;501;243;258
Šalčininkai d. mun.;2016;42;488;244;244
Šalčininkai d. mun.;2016;43;471;243;228
Šalčininkai d. mun.;2016;44;494;246;248
Šalčininkai d. mun.;2016;45;465;237;228
Šalčininkai d. mun.;2016;46;441;213;228
Šalčininkai d. mun.;2016;47;490;233;257
Šalčininkai d. mun.;2016;48;517;243;274
Šalčininkai d. mun.;2016;49;470;241;229
Šalčininkai d. mun.;2016;50;491;237;254
Šalčininkai d. mun.;2016;51;516;270;246
Šalčininkai d. mun.;2016;52;552;246;306
Šalčininkai d. mun.;2016;53;477;229;248
Šalčininkai d. mun.;2016;54;530;258;272
Šalčininkai d. mun.;2016;55;539;262;277
Šalčininkai d. mun.;2016;56;502;224;278
Šalčininkai d. mun.;2016;57;500;258;242
Šalčininkai d. mun.;2016;58;426;207;219
Šalčininkai d. mun.;2016;59;380;171;209
Šalčininkai d. mun.;2016;60;374;177;197
Šalčininkai d. mun.;2016;61;350;155;195
Šalčininkai d. mun.;2016;62;318;138;180
Šalčininkai d. mun.;2016;63;357;147;210
Šalčininkai d. mun.;2016;64;357;158;199
Šalčininkai d. mun.;2016;65;351;160;191
Šalčininkai d. mun.;2016;66;323;133;190
Šalčininkai d. mun.;2016;67;296;120;176
Šalčininkai d. mun.;2016;68;235;101;134
Šalčininkai d. mun.;2016;69;235;92;143
Šalčininkai d. mun.;2016;70;247;109;138
Šalčininkai d. mun.;2016;71;197;70;127
Šalčininkai d. mun.;2016;72;236;75;161
Šalčininkai d. mun.;2016;73;253;85;168
Šalčininkai d. mun.;2016;74;226;66;160
Šalčininkai d. mun.;2016;75;283;79;204
Šalčininkai d. mun.;2016;76;254;71;183
Šalčininkai d. mun.;2016;77;269;81;188
Šalčininkai d. mun.;2016;78;258;73;185
Šalčininkai d. mun.;2016;79;234;65;169
Šalčininkai d. mun.;2016;80;209;63;146
Šalčininkai d. mun.;2016;81;206;54;152
Šalčininkai d. mun.;2016;82;185;38;147
Šalčininkai d. mun.;2016;83;176;45;131
Šalčininkai d. mun.;2016;84;125;25;100
Šalčininkai d. mun.;2016;85;565;123;442
Šalčininkai d. mun.;2017;-1;31789;15181;16608
Šalčininkai d. mun.;2017;0;378;198;180
Šalčininkai d. mun.;2017;1;372;197;175
Šalčininkai d. mun.;2017;2;351;183;168
Šalčininkai d. mun.;2017;3;345;193;152
Šalčininkai d. mun.;2017;4;378;194;184
Šalčininkai d. mun.;2017;5;360;182;178
Šalčininkai d. mun.;2017;6;319;179;140
Šalčininkai d. mun.;2017;7;358;186;172
Šalčininkai d. mun.;2017;8;355;182;173
Šalčininkai d. mun.;2017;9;334;172;162
Šalčininkai d. mun.;2017;10;321;165;156
Šalčininkai d. mun.;2017;11;375;195;180
Šalčininkai d. mun.;2017;12;314;141;173
Šalčininkai d. mun.;2017;13;332;165;167
Šalčininkai d. mun.;2017;14;312;160;152
Šalčininkai d. mun.;2017;15;343;157;186
Šalčininkai d. mun.;2017;16;371;194;177
Šalčininkai d. mun.;2017;17;371;199;172
Šalčininkai d. mun.;2017;18;394;205;189
Šalčininkai d. mun.;2017;19;402;191;211
Šalčininkai d. mun.;2017;20;410;211;199
Šalčininkai d. mun.;2017;21;416;225;191
Šalčininkai d. mun.;2017;22;445;239;206
Šalčininkai d. mun.;2017;23;462;255;207
Šalčininkai d. mun.;2017;24;481;233;248
Šalčininkai d. mun.;2017;25;419;234;185
Šalčininkai d. mun.;2017;26;453;262;191
Šalčininkai d. mun.;2017;27;473;262;211
Šalčininkai d. mun.;2017;28;446;244;202
Šalčininkai d. mun.;2017;29;417;242;175
Šalčininkai d. mun.;2017;30;379;238;141
Šalčininkai d. mun.;2017;31;351;212;139
Šalčininkai d. mun.;2017;32;382;212;170
Šalčininkai d. mun.;2017;33;339;191;148
Šalčininkai d. mun.;2017;34;310;155;155
Šalčininkai d. mun.;2017;35;348;182;166
Šalčininkai d. mun.;2017;36;382;212;170
Šalčininkai d. mun.;2017;37;375;197;178
Šalčininkai d. mun.;2017;38;365;175;190
Šalčininkai d. mun.;2017;39;402;220;182
Šalčininkai d. mun.;2017;40;438;220;218
Šalčininkai d. mun.;2017;41;389;184;205
Šalčininkai d. mun.;2017;42;494;244;250
Šalčininkai d. mun.;2017;43;482;241;241
Šalčininkai d. mun.;2017;44;468;243;225
Šalčininkai d. mun.;2017;45;491;245;246
Šalčininkai d. mun.;2017;46;448;229;219
Šalčininkai d. mun.;2017;47;432;209;223
Šalčininkai d. mun.;2017;48;482;224;258
Šalčininkai d. mun.;2017;49;512;240;272
Šalčininkai d. mun.;2017;50;462;240;222
Šalčininkai d. mun.;2017;51;485;232;253
Šalčininkai d. mun.;2017;52;506;260;246
Šalčininkai d. mun.;2017;53;545;241;304
Šalčininkai d. mun.;2017;54;465;220;245
Šalčininkai d. mun.;2017;55;519;249;270
Šalčininkai d. mun.;2017;56;527;257;270
Šalčininkai d. mun.;2017;57;495;216;279
Šalčininkai d. mun.;2017;58;490;250;240
Šalčininkai d. mun.;2017;59;422;201;221
Šalčininkai d. mun.;2017;60;372;166;206
Šalčininkai d. mun.;2017;61;365;169;196
Šalčininkai d. mun.;2017;62;342;150;192
Šalčininkai d. mun.;2017;63;311;129;182
Šalčininkai d. mun.;2017;64;351;143;208
Šalčininkai d. mun.;2017;65;343;145;198
Šalčininkai d. mun.;2017;66;347;159;188
Šalčininkai d. mun.;2017;67;315;127;188
Šalčininkai d. mun.;2017;68;281;111;170
Šalčininkai d. mun.;2017;69;232;100;132
Šalčininkai d. mun.;2017;70;233;91;142
Šalčininkai d. mun.;2017;71;230;102;128
Šalčininkai d. mun.;2017;72;192;68;124
Šalčininkai d. mun.;2017;73;227;70;157
Šalčininkai d. mun.;2017;74;237;73;164
Šalčininkai d. mun.;2017;75;220;64;156
Šalčininkai d. mun.;2017;76;263;68;195
Šalčininkai d. mun.;2017;77;248;67;181
Šalčininkai d. mun.;2017;78;258;78;180
Šalčininkai d. mun.;2017;79;246;67;179
Šalčininkai d. mun.;2017;80;219;57;162
Šalčininkai d. mun.;2017;81;194;56;138
Šalčininkai d. mun.;2017;82;188;50;138
Šalčininkai d. mun.;2017;83;165;32;133
Šalčininkai d. mun.;2017;84;155;39;116
Šalčininkai d. mun.;2017;85;563;116;447
Šalčininkai d. mun.;2018;-1;31265;14969;16296
Šalčininkai d. mun.;2018;0;296;152;144
Šalčininkai d. mun.;2018;1;377;196;181
Šalčininkai d. mun.;2018;2;363;193;170
Šalčininkai d. mun.;2018;3;350;182;168
Šalčininkai d. mun.;2018;4;340;193;147
Šalčininkai d. mun.;2018;5;377;192;185
Šalčininkai d. mun.;2018;6;362;182;180
Šalčininkai d. mun.;2018;7;313;176;137
Šalčininkai d. mun.;2018;8;358;184;174
Šalčininkai d. mun.;2018;9;354;181;173
Šalčininkai d. mun.;2018;10;333;169;164
Šalčininkai d. mun.;2018;11;317;164;153
Šalčininkai d. mun.;2018;12;373;194;179
Šalčininkai d. mun.;2018;13;314;140;174
Šalčininkai d. mun.;2018;14;336;166;170
Šalčininkai d. mun.;2018;15;309;159;150
Šalčininkai d. mun.;2018;16;343;159;184
Šalčininkai d. mun.;2018;17;368;193;175
Šalčininkai d. mun.;2018;18;371;197;174
Šalčininkai d. mun.;2018;19;394;202;192
Šalčininkai d. mun.;2018;20;398;191;207
Šalčininkai d. mun.;2018;21;394;206;188
Šalčininkai d. mun.;2018;22;405;216;189
Šalčininkai d. mun.;2018;23;430;234;196
Šalčininkai d. mun.;2018;24;451;253;198
Šalčininkai d. mun.;2018;25;465;233;232
Šalčininkai d. mun.;2018;26;387;219;168
Šalčininkai d. mun.;2018;27;437;251;186
Šalčininkai d. mun.;2018;28;454;255;199
Šalčininkai d. mun.;2018;29;423;241;182
Šalčininkai d. mun.;2018;30;401;229;172
Šalčininkai d. mun.;2018;31;355;226;129
Šalčininkai d. mun.;2018;32;328;199;129
Šalčininkai d. mun.;2018;33;366;204;162
Šalčininkai d. mun.;2018;34;319;179;140
Šalčininkai d. mun.;2018;35;310;161;149
Šalčininkai d. mun.;2018;36;349;184;165
Šalčininkai d. mun.;2018;37;381;212;169
Šalčininkai d. mun.;2018;38;378;202;176
Šalčininkai d. mun.;2018;39;345;164;181
Šalčininkai d. mun.;2018;40;394;216;178
Šalčininkai d. mun.;2018;41;429;214;215
Šalčininkai d. mun.;2018;42;381;183;198
Šalčininkai d. mun.;2018;43;485;241;244
Šalčininkai d. mun.;2018;44;478;239;239
Šalčininkai d. mun.;2018;45;464;241;223
Šalčininkai d. mun.;2018;46;482;241;241
Šalčininkai d. mun.;2018;47;448;229;219
Šalčininkai d. mun.;2018;48;426;206;220
Šalčininkai d. mun.;2018;49;478;223;255
Šalčininkai d. mun.;2018;50;507;236;271
Šalčininkai d. mun.;2018;51;460;240;220
Šalčininkai d. mun.;2018;52;482;230;252
Šalčininkai d. mun.;2018;53;496;255;241
Šalčininkai d. mun.;2018;54;540;238;302
Šalčininkai d. mun.;2018;55;460;215;245
Šalčininkai d. mun.;2018;56;515;247;268
Šalčininkai d. mun.;2018;57;523;254;269
Šalčininkai d. mun.;2018;58;484;209;275
Šalčininkai d. mun.;2018;59;485;245;240
Šalčininkai d. mun.;2018;60;416;198;218
Šalčininkai d. mun.;2018;61;364;159;205
Šalčininkai d. mun.;2018;62;362;166;196
Šalčininkai d. mun.;2018;63;333;146;187
Šalčininkai d. mun.;2018;64;307;124;183
Šalčininkai d. mun.;2018;65;341;134;207
Šalčininkai d. mun.;2018;66;333;140;193
Šalčininkai d. mun.;2018;67;341;154;187
Šalčininkai d. mun.;2018;68;305;124;181
Šalčininkai d. mun.;2018;69;273;107;166
Šalčininkai d. mun.;2018;70;222;92;130
Šalčininkai d. mun.;2018;71;225;88;137
Šalčininkai d. mun.;2018;72;220;97;123
Šalčininkai d. mun.;2018;73;182;63;119
Šalčininkai d. mun.;2018;74;215;64;151
Šalčininkai d. mun.;2018;75;232;70;162
Šalčininkai d. mun.;2018;76;204;57;147
Šalčininkai d. mun.;2018;77;253;63;190
Šalčininkai d. mun.;2018;78;230;60;170
Šalčininkai d. mun.;2018;79;245;71;174
Šalčininkai d. mun.;2018;80;228;61;167
Šalčininkai d. mun.;2018;81;203;52;151
Šalčininkai d. mun.;2018;82;176;51;125
Šalčininkai d. mun.;2018;83;174;46;128
Šalčininkai d. mun.;2018;84;150;29;121
Šalčininkai d. mun.;2018;85;590;118;472
Šiauliai c. mun.;2001;-1;134032;61289;72743
Šiauliai c. mun.;2001;0;1179;620;559
Šiauliai c. mun.;2001;1;1248;635;613
Šiauliai c. mun.;2001;2;1303;692;611
Šiauliai c. mun.;2001;3;1420;722;698
Šiauliai c. mun.;2001;4;1422;746;676
Šiauliai c. mun.;2001;5;1442;723;719
Šiauliai c. mun.;2001;6;1505;787;718
Šiauliai c. mun.;2001;7;1784;906;878
Šiauliai c. mun.;2001;8;2059;1011;1048
Šiauliai c. mun.;2001;9;2002;1038;964
Šiauliai c. mun.;2001;10;2068;1053;1015
Šiauliai c. mun.;2001;11;1925;946;979
Šiauliai c. mun.;2001;12;1950;986;964
Šiauliai c. mun.;2001;13;2173;1095;1078
Šiauliai c. mun.;2001;14;2151;1148;1003
Šiauliai c. mun.;2001;15;2172;1089;1083
Šiauliai c. mun.;2001;16;2265;1129;1136
Šiauliai c. mun.;2001;17;2136;1109;1027
Šiauliai c. mun.;2001;18;2058;987;1071
Šiauliai c. mun.;2001;19;2006;924;1082
Šiauliai c. mun.;2001;20;2044;956;1088
Šiauliai c. mun.;2001;21;2053;952;1101
Šiauliai c. mun.;2001;22;1898;923;975
Šiauliai c. mun.;2001;23;1923;943;980
Šiauliai c. mun.;2001;24;1953;971;982
Šiauliai c. mun.;2001;25;1963;944;1019
Šiauliai c. mun.;2001;26;1957;960;997
Šiauliai c. mun.;2001;27;2050;969;1081
Šiauliai c. mun.;2001;28;2121;1033;1088
Šiauliai c. mun.;2001;29;2140;1039;1101
Šiauliai c. mun.;2001;30;2123;1019;1104
Šiauliai c. mun.;2001;31;2058;998;1060
Šiauliai c. mun.;2001;32;2130;1013;1117
Šiauliai c. mun.;2001;33;2109;1026;1083
Šiauliai c. mun.;2001;34;2138;1058;1080
Šiauliai c. mun.;2001;35;2178;1043;1135
Šiauliai c. mun.;2001;36;2218;1001;1217
Šiauliai c. mun.;2001;37;2236;1055;1181
Šiauliai c. mun.;2001;38;2353;1048;1305
Šiauliai c. mun.;2001;39;2468;1174;1294
Šiauliai c. mun.;2001;40;2384;1056;1328
Šiauliai c. mun.;2001;41;2336;1085;1251
Šiauliai c. mun.;2001;42;2292;1073;1219
Šiauliai c. mun.;2001;43;2133;971;1162
Šiauliai c. mun.;2001;44;1975;942;1033
Šiauliai c. mun.;2001;45;1862;848;1014
Šiauliai c. mun.;2001;46;1715;780;935
Šiauliai c. mun.;2001;47;1631;702;929
Šiauliai c. mun.;2001;48;1648;755;893
Šiauliai c. mun.;2001;49;1691;764;927
Šiauliai c. mun.;2001;50;1565;671;894
Šiauliai c. mun.;2001;51;1558;660;898
Šiauliai c. mun.;2001;52;1350;575;775
Šiauliai c. mun.;2001;53;1413;589;824
Šiauliai c. mun.;2001;54;1338;588;750
Šiauliai c. mun.;2001;55;1433;615;818
Šiauliai c. mun.;2001;56;1178;508;670
Šiauliai c. mun.;2001;57;1376;590;786
Šiauliai c. mun.;2001;58;1462;643;819
Šiauliai c. mun.;2001;59;1357;564;793
Šiauliai c. mun.;2001;60;1249;522;727
Šiauliai c. mun.;2001;61;1284;521;763
Šiauliai c. mun.;2001;62;1307;529;778
Šiauliai c. mun.;2001;63;1281;497;784
Šiauliai c. mun.;2001;64;1224;482;742
Šiauliai c. mun.;2001;65;1172;435;737
Šiauliai c. mun.;2001;66;1083;404;679
Šiauliai c. mun.;2001;67;1165;467;698
Šiauliai c. mun.;2001;68;1112;421;691
Šiauliai c. mun.;2001;69;1028;378;650
Šiauliai c. mun.;2001;70;952;360;592
Šiauliai c. mun.;2001;71;942;345;597
Šiauliai c. mun.;2001;72;990;342;648
Šiauliai c. mun.;2001;73;855;304;551
Šiauliai c. mun.;2001;74;756;220;536
Šiauliai c. mun.;2001;75;743;242;501
Šiauliai c. mun.;2001;76;708;204;504
Šiauliai c. mun.;2001;77;659;204;455
Šiauliai c. mun.;2001;78;526;177;349
Šiauliai c. mun.;2001;79;467;138;329
Šiauliai c. mun.;2001;80;396;109;287
Šiauliai c. mun.;2001;81;292;84;208
Šiauliai c. mun.;2001;82;219;51;168
Šiauliai c. mun.;2001;83;202;60;142
Šiauliai c. mun.;2001;84;190;57;133
Šiauliai c. mun.;2001;85;1152;286;866
Šiauliai c. mun.;2002;-1;131977;60002;71975
Šiauliai c. mun.;2002;0;1085;532;553
Šiauliai c. mun.;2002;1;1181;623;558
Šiauliai c. mun.;2002;2;1243;626;617
Šiauliai c. mun.;2002;3;1292;684;608
Šiauliai c. mun.;2002;4;1422;719;703
Šiauliai c. mun.;2002;5;1405;730;675
Šiauliai c. mun.;2002;6;1424;713;711
Šiauliai c. mun.;2002;7;1494;777;717
Šiauliai c. mun.;2002;8;1753;885;868
Šiauliai c. mun.;2002;9;2034;992;1042
Šiauliai c. mun.;2002;10;1974;1018;956
Šiauliai c. mun.;2002;11;2037;1030;1007
Šiauliai c. mun.;2002;12;1877;916;961
Šiauliai c. mun.;2002;13;1887;944;943
Šiauliai c. mun.;2002;14;2129;1070;1059
Šiauliai c. mun.;2002;15;2093;1107;986
Šiauliai c. mun.;2002;16;2134;1065;1069
Šiauliai c. mun.;2002;17;2214;1093;1121
Šiauliai c. mun.;2002;18;2083;1073;1010
Šiauliai c. mun.;2002;19;1994;951;1043
Šiauliai c. mun.;2002;20;1967;894;1073
Šiauliai c. mun.;2002;21;1974;918;1056
Šiauliai c. mun.;2002;22;1966;909;1057
Šiauliai c. mun.;2002;23;1835;891;944
Šiauliai c. mun.;2002;24;1874;907;967
Šiauliai c. mun.;2002;25;1909;946;963
Šiauliai c. mun.;2002;26;1919;915;1004
Šiauliai c. mun.;2002;27;1935;936;999
Šiauliai c. mun.;2002;28;2014;938;1076
Šiauliai c. mun.;2002;29;2067;1001;1066
Šiauliai c. mun.;2002;30;2099;1017;1082
Šiauliai c. mun.;2002;31;2069;986;1083
Šiauliai c. mun.;2002;32;2017;977;1040
Šiauliai c. mun.;2002;33;2098;991;1107
Šiauliai c. mun.;2002;34;2077;1008;1069
Šiauliai c. mun.;2002;35;2095;1024;1071
Šiauliai c. mun.;2002;36;2142;1026;1116
Šiauliai c. mun.;2002;37;2167;975;1192
Šiauliai c. mun.;2002;38;2175;1011;1164
Šiauliai c. mun.;2002;39;2300;1011;1289
Šiauliai c. mun.;2002;40;2411;1133;1278
Šiauliai c. mun.;2002;41;2347;1036;1311
Šiauliai c. mun.;2002;42;2295;1058;1237
Šiauliai c. mun.;2002;43;2241;1043;1198
Šiauliai c. mun.;2002;44;2097;958;1139
Šiauliai c. mun.;2002;45;1919;913;1006
Šiauliai c. mun.;2002;46;1830;825;1005
Šiauliai c. mun.;2002;47;1690;769;921
Šiauliai c. mun.;2002;48;1586;677;909
Šiauliai c. mun.;2002;49;1593;725;868
Šiauliai c. mun.;2002;50;1646;730;916
Šiauliai c. mun.;2002;51;1526;652;874
Šiauliai c. mun.;2002;52;1530;639;891
Šiauliai c. mun.;2002;53;1315;557;758
Šiauliai c. mun.;2002;54;1388;581;807
Šiauliai c. mun.;2002;55;1288;565;723
Šiauliai c. mun.;2002;56;1393;595;798
Šiauliai c. mun.;2002;57;1139;484;655
Šiauliai c. mun.;2002;58;1338;572;766
Šiauliai c. mun.;2002;59;1420;621;799
Šiauliai c. mun.;2002;60;1337;547;790
Šiauliai c. mun.;2002;61;1231;508;723
Šiauliai c. mun.;2002;62;1257;504;753
Šiauliai c. mun.;2002;63;1282;513;769
Šiauliai c. mun.;2002;64;1267;486;781
Šiauliai c. mun.;2002;65;1208;475;733
Šiauliai c. mun.;2002;66;1159;428;731
Šiauliai c. mun.;2002;67;1060;395;665
Šiauliai c. mun.;2002;68;1146;452;694
Šiauliai c. mun.;2002;69;1075;398;677
Šiauliai c. mun.;2002;70;996;359;637
Šiauliai c. mun.;2002;71;923;340;583
Šiauliai c. mun.;2002;72;916;330;586
Šiauliai c. mun.;2002;73;965;331;634
Šiauliai c. mun.;2002;74;841;297;544
Šiauliai c. mun.;2002;75;748;214;534
Šiauliai c. mun.;2002;76;707;226;481
Šiauliai c. mun.;2002;77;676;188;488
Šiauliai c. mun.;2002;78;641;196;445
Šiauliai c. mun.;2002;79;493;157;336
Šiauliai c. mun.;2002;80;431;122;309
Šiauliai c. mun.;2002;81;379;103;276
Šiauliai c. mun.;2002;82;267;73;194
Šiauliai c. mun.;2002;83;198;50;148
Šiauliai c. mun.;2002;84;180;56;124
Šiauliai c. mun.;2002;85;1148;292;856
Šiauliai c. mun.;2003;-1;130366;59110;71256
Šiauliai c. mun.;2003;0;950;492;458
Šiauliai c. mun.;2003;1;1054;510;544
Šiauliai c. mun.;2003;2;1165;610;555
Šiauliai c. mun.;2003;3;1214;612;602
Šiauliai c. mun.;2003;4;1267;670;597
Šiauliai c. mun.;2003;5;1399;703;696
Šiauliai c. mun.;2003;6;1375;711;664
Šiauliai c. mun.;2003;7;1399;701;698
Šiauliai c. mun.;2003;8;1475;768;707
Šiauliai c. mun.;2003;9;1732;871;861
Šiauliai c. mun.;2003;10;2005;978;1027
Šiauliai c. mun.;2003;11;1941;1000;941
Šiauliai c. mun.;2003;12;1987;1002;985
Šiauliai c. mun.;2003;13;1830;889;941
Šiauliai c. mun.;2003;14;1840;916;924
Šiauliai c. mun.;2003;15;2088;1044;1044
Šiauliai c. mun.;2003;16;2053;1084;969
Šiauliai c. mun.;2003;17;2082;1039;1043
Šiauliai c. mun.;2003;18;2181;1074;1107
Šiauliai c. mun.;2003;19;2040;1045;995
Šiauliai c. mun.;2003;20;1975;941;1034
Šiauliai c. mun.;2003;21;1922;879;1043
Šiauliai c. mun.;2003;22;1933;903;1030
Šiauliai c. mun.;2003;23;1907;880;1027
Šiauliai c. mun.;2003;24;1795;871;924
Šiauliai c. mun.;2003;25;1848;888;960
Šiauliai c. mun.;2003;26;1909;952;957
Šiauliai c. mun.;2003;27;1906;899;1007
Šiauliai c. mun.;2003;28;1919;922;997
Šiauliai c. mun.;2003;29;1981;928;1053
Šiauliai c. mun.;2003;30;2046;989;1057
Šiauliai c. mun.;2003;31;2080;1007;1073
Šiauliai c. mun.;2003;32;2052;979;1073
Šiauliai c. mun.;2003;33;1996;968;1028
Šiauliai c. mun.;2003;34;2065;972;1093
Šiauliai c. mun.;2003;35;2034;985;1049
Šiauliai c. mun.;2003;36;2069;1011;1058
Šiauliai c. mun.;2003;37;2107;1007;1100
Šiauliai c. mun.;2003;38;2136;954;1182
Šiauliai c. mun.;2003;39;2137;994;1143
Šiauliai c. mun.;2003;40;2267;993;1274
Šiauliai c. mun.;2003;41;2361;1106;1255
Šiauliai c. mun.;2003;42;2311;1015;1296
Šiauliai c. mun.;2003;43;2266;1038;1228
Šiauliai c. mun.;2003;44;2224;1033;1191
Šiauliai c. mun.;2003;45;2062;935;1127
Šiauliai c. mun.;2003;46;1897;902;995
Šiauliai c. mun.;2003;47;1809;815;994
Šiauliai c. mun.;2003;48;1673;757;916
Šiauliai c. mun.;2003;49;1565;666;899
Šiauliai c. mun.;2003;50;1574;712;862
Šiauliai c. mun.;2003;51;1612;710;902
Šiauliai c. mun.;2003;52;1500;638;862
Šiauliai c. mun.;2003;53;1513;632;881
Šiauliai c. mun.;2003;54;1297;545;752
Šiauliai c. mun.;2003;55;1365;566;799
Šiauliai c. mun.;2003;56;1259;545;714
Šiauliai c. mun.;2003;57;1369;581;788
Šiauliai c. mun.;2003;58;1106;461;645
Šiauliai c. mun.;2003;59;1315;560;755
Šiauliai c. mun.;2003;60;1387;599;788
Šiauliai c. mun.;2003;61;1318;540;778
Šiauliai c. mun.;2003;62;1216;499;717
Šiauliai c. mun.;2003;63;1235;485;750
Šiauliai c. mun.;2003;64;1271;506;765
Šiauliai c. mun.;2003;65;1266;482;784
Šiauliai c. mun.;2003;66;1186;460;726
Šiauliai c. mun.;2003;67;1138;411;727
Šiauliai c. mun.;2003;68;1029;380;649
Šiauliai c. mun.;2003;69;1118;428;690
Šiauliai c. mun.;2003;70;1051;378;673
Šiauliai c. mun.;2003;71;967;342;625
Šiauliai c. mun.;2003;72;913;333;580
Šiauliai c. mun.;2003;73;901;319;582
Šiauliai c. mun.;2003;74;932;313;619
Šiauliai c. mun.;2003;75;811;280;531
Šiauliai c. mun.;2003;76;726;202;524
Šiauliai c. mun.;2003;77;668;196;472
Šiauliai c. mun.;2003;78;642;172;470
Šiauliai c. mun.;2003;79;608;183;425
Šiauliai c. mun.;2003;80;446;136;310
Šiauliai c. mun.;2003;81;398;107;291
Šiauliai c. mun.;2003;82;345;89;256
Šiauliai c. mun.;2003;83;244;63;181
Šiauliai c. mun.;2003;84;179;45;134
Šiauliai c. mun.;2003;85;1132;304;828
Šiauliai c. mun.;2004;-1;127805;57805;70000
Šiauliai c. mun.;2004;0;962;502;460
Šiauliai c. mun.;2004;1;924;473;451
Šiauliai c. mun.;2004;2;1017;493;524
Šiauliai c. mun.;2004;3;1127;590;537
Šiauliai c. mun.;2004;4;1170;587;583
Šiauliai c. mun.;2004;5;1238;654;584
Šiauliai c. mun.;2004;6;1364;686;678
Šiauliai c. mun.;2004;7;1340;689;651
Šiauliai c. mun.;2004;8;1373;688;685
Šiauliai c. mun.;2004;9;1446;755;691
Šiauliai c. mun.;2004;10;1699;851;848
Šiauliai c. mun.;2004;11;1945;956;989
Šiauliai c. mun.;2004;12;1884;966;918
Šiauliai c. mun.;2004;13;1933;982;951
Šiauliai c. mun.;2004;14;1775;864;911
Šiauliai c. mun.;2004;15;1794;899;895
Šiauliai c. mun.;2004;16;2030;1011;1019
Šiauliai c. mun.;2004;17;2018;1068;950
Šiauliai c. mun.;2004;18;2033;1020;1013
Šiauliai c. mun.;2004;19;2125;1041;1084
Šiauliai c. mun.;2004;20;2006;1020;986
Šiauliai c. mun.;2004;21;1936;921;1015
Šiauliai c. mun.;2004;22;1871;851;1020
Šiauliai c. mun.;2004;23;1887;868;1019
Šiauliai c. mun.;2004;24;1859;860;999
Šiauliai c. mun.;2004;25;1731;854;877
Šiauliai c. mun.;2004;26;1793;860;933
Šiauliai c. mun.;2004;27;1867;932;935
Šiauliai c. mun.;2004;28;1875;882;993
Šiauliai c. mun.;2004;29;1894;915;979
Šiauliai c. mun.;2004;30;1939;899;1040
Šiauliai c. mun.;2004;31;2021;977;1044
Šiauliai c. mun.;2004;32;2037;989;1048
Šiauliai c. mun.;2004;33;2014;959;1055
Šiauliai c. mun.;2004;34;1935;944;991
Šiauliai c. mun.;2004;35;2020;956;1064
Šiauliai c. mun.;2004;36;1982;959;1023
Šiauliai c. mun.;2004;37;2017;982;1035
Šiauliai c. mun.;2004;38;2062;983;1079
Šiauliai c. mun.;2004;39;2072;923;1149
Šiauliai c. mun.;2004;40;2068;960;1108
Šiauliai c. mun.;2004;41;2209;972;1237
Šiauliai c. mun.;2004;42;2308;1079;1229
Šiauliai c. mun.;2004;43;2252;980;1272
Šiauliai c. mun.;2004;44;2214;1007;1207
Šiauliai c. mun.;2004;45;2167;1009;1158
Šiauliai c. mun.;2004;46;2014;916;1098
Šiauliai c. mun.;2004;47;1857;880;977
Šiauliai c. mun.;2004;48;1767;791;976
Šiauliai c. mun.;2004;49;1632;740;892
Šiauliai c. mun.;2004;50;1514;634;880
Šiauliai c. mun.;2004;51;1533;685;848
Šiauliai c. mun.;2004;52;1579;697;882
Šiauliai c. mun.;2004;53;1467;616;851
Šiauliai c. mun.;2004;54;1478;615;863
Šiauliai c. mun.;2004;55;1265;523;742
Šiauliai c. mun.;2004;56;1327;548;779
Šiauliai c. mun.;2004;57;1236;536;700
Šiauliai c. mun.;2004;58;1339;561;778
Šiauliai c. mun.;2004;59;1080;445;635
Šiauliai c. mun.;2004;60;1274;534;740
Šiauliai c. mun.;2004;61;1349;579;770
Šiauliai c. mun.;2004;62;1286;521;765
Šiauliai c. mun.;2004;63;1185;481;704
Šiauliai c. mun.;2004;64;1212;467;745
Šiauliai c. mun.;2004;65;1253;488;765
Šiauliai c. mun.;2004;66;1243;463;780
Šiauliai c. mun.;2004;67;1160;434;726
Šiauliai c. mun.;2004;68;1111;399;712
Šiauliai c. mun.;2004;69;1000;359;641
Šiauliai c. mun.;2004;70;1086;410;676
Šiauliai c. mun.;2004;71;1027;363;664
Šiauliai c. mun.;2004;72;932;324;608
Šiauliai c. mun.;2004;73;884;313;571
Šiauliai c. mun.;2004;74;879;302;577
Šiauliai c. mun.;2004;75;891;290;601
Šiauliai c. mun.;2004;76;778;264;514
Šiauliai c. mun.;2004;77;704;188;516
Šiauliai c. mun.;2004;78;635;184;451
Šiauliai c. mun.;2004;79;591;155;436
Šiauliai c. mun.;2004;80;569;158;411
Šiauliai c. mun.;2004;81;411;118;293
Šiauliai c. mun.;2004;82;373;97;276
Šiauliai c. mun.;2004;83;317;79;238
Šiauliai c. mun.;2004;84;206;47;159
Šiauliai c. mun.;2004;85;1128;285;843
Šiauliai c. mun.;2005;-1;125360;56517;68843
Šiauliai c. mun.;2005;0;1044;507;537
Šiauliai c. mun.;2005;1;946;488;458
Šiauliai c. mun.;2005;2;913;471;442
Šiauliai c. mun.;2005;3;1006;490;516
Šiauliai c. mun.;2005;4;1116;584;532
Šiauliai c. mun.;2005;5;1154;575;579
Šiauliai c. mun.;2005;6;1227;646;581
Šiauliai c. mun.;2005;7;1358;682;676
Šiauliai c. mun.;2005;8;1322;679;643
Šiauliai c. mun.;2005;9;1366;682;684
Šiauliai c. mun.;2005;10;1432;749;683
Šiauliai c. mun.;2005;11;1691;843;848
Šiauliai c. mun.;2005;12;1911;937;974
Šiauliai c. mun.;2005;13;1851;948;903
Šiauliai c. mun.;2005;14;1898;966;932
Šiauliai c. mun.;2005;15;1738;841;897
Šiauliai c. mun.;2005;16;1747;873;874
Šiauliai c. mun.;2005;17;1975;980;995
Šiauliai c. mun.;2005;18;1950;1020;930
Šiauliai c. mun.;2005;19;1962;983;979
Šiauliai c. mun.;2005;20;2056;1014;1042
Šiauliai c. mun.;2005;21;1943;978;965
Šiauliai c. mun.;2005;22;1877;886;991
Šiauliai c. mun.;2005;23;1829;824;1005
Šiauliai c. mun.;2005;24;1838;851;987
Šiauliai c. mun.;2005;25;1776;828;948
Šiauliai c. mun.;2005;26;1672;818;854
Šiauliai c. mun.;2005;27;1772;847;925
Šiauliai c. mun.;2005;28;1837;922;915
Šiauliai c. mun.;2005;29;1849;867;982
Šiauliai c. mun.;2005;30;1864;905;959
Šiauliai c. mun.;2005;31;1890;870;1020
Šiauliai c. mun.;2005;32;1965;944;1021
Šiauliai c. mun.;2005;33;1995;974;1021
Šiauliai c. mun.;2005;34;1972;939;1033
Šiauliai c. mun.;2005;35;1887;916;971
Šiauliai c. mun.;2005;36;1955;930;1025
Šiauliai c. mun.;2005;37;1946;931;1015
Šiauliai c. mun.;2005;38;1969;955;1014
Šiauliai c. mun.;2005;39;2002;962;1040
Šiauliai c. mun.;2005;40;2023;898;1125
Šiauliai c. mun.;2005;41;2013;926;1087
Šiauliai c. mun.;2005;42;2152;942;1210
Šiauliai c. mun.;2005;43;2256;1050;1206
Šiauliai c. mun.;2005;44;2205;955;1250
Šiauliai c. mun.;2005;45;2149;973;1176
Šiauliai c. mun.;2005;46;2118;982;1136
Šiauliai c. mun.;2005;47;1974;890;1084
Šiauliai c. mun.;2005;48;1789;840;949
Šiauliai c. mun.;2005;49;1737;771;966
Šiauliai c. mun.;2005;50;1606;723;883
Šiauliai c. mun.;2005;51;1469;611;858
Šiauliai c. mun.;2005;52;1498;658;840
Šiauliai c. mun.;2005;53;1531;672;859
Šiauliai c. mun.;2005;54;1434;602;832
Šiauliai c. mun.;2005;55;1442;599;843
Šiauliai c. mun.;2005;56;1228;503;725
Šiauliai c. mun.;2005;57;1298;534;764
Šiauliai c. mun.;2005;58;1205;520;685
Šiauliai c. mun.;2005;59;1311;542;769
Šiauliai c. mun.;2005;60;1052;424;628
Šiauliai c. mun.;2005;61;1243;519;724
Šiauliai c. mun.;2005;62;1312;558;754
Šiauliai c. mun.;2005;63;1243;495;748
Šiauliai c. mun.;2005;64;1144;461;683
Šiauliai c. mun.;2005;65;1172;446;726
Šiauliai c. mun.;2005;66;1216;466;750
Šiauliai c. mun.;2005;67;1213;447;766
Šiauliai c. mun.;2005;68;1137;419;718
Šiauliai c. mun.;2005;69;1082;383;699
Šiauliai c. mun.;2005;70;974;343;631
Šiauliai c. mun.;2005;71;1036;383;653
Šiauliai c. mun.;2005;72;986;333;653
Šiauliai c. mun.;2005;73;902;305;597
Šiauliai c. mun.;2005;74;849;292;557
Šiauliai c. mun.;2005;75;831;274;557
Šiauliai c. mun.;2005;76;857;278;579
Šiauliai c. mun.;2005;77;732;240;492
Šiauliai c. mun.;2005;78;664;176;488
Šiauliai c. mun.;2005;79;605;171;434
Šiauliai c. mun.;2005;80;553;138;415
Šiauliai c. mun.;2005;81;513;142;371
Šiauliai c. mun.;2005;82;371;102;269
Šiauliai c. mun.;2005;83;334;83;251
Šiauliai c. mun.;2005;84;284;72;212
Šiauliai c. mun.;2005;85;1116;271;845
Šiauliai c. mun.;2006;-1;122236;54917;67319
Šiauliai c. mun.;2006;0;983;458;525
Šiauliai c. mun.;2006;1;1029;496;533
Šiauliai c. mun.;2006;2;928;480;448
Šiauliai c. mun.;2006;3;888;457;431
Šiauliai c. mun.;2006;4;978;475;503
Šiauliai c. mun.;2006;5;1107;575;532
Šiauliai c. mun.;2006;6;1139;571;568
Šiauliai c. mun.;2006;7;1207;636;571
Šiauliai c. mun.;2006;8;1339;675;664
Šiauliai c. mun.;2006;9;1306;671;635
Šiauliai c. mun.;2006;10;1349;673;676
Šiauliai c. mun.;2006;11;1412;740;672
Šiauliai c. mun.;2006;12;1663;824;839
Šiauliai c. mun.;2006;13;1861;917;944
Šiauliai c. mun.;2006;14;1819;933;886
Šiauliai c. mun.;2006;15;1840;934;906
Šiauliai c. mun.;2006;16;1663;799;864
Šiauliai c. mun.;2006;17;1682;838;844
Šiauliai c. mun.;2006;18;1900;931;969
Šiauliai c. mun.;2006;19;1852;967;885
Šiauliai c. mun.;2006;20;1856;929;927
Šiauliai c. mun.;2006;21;1930;947;983
Šiauliai c. mun.;2006;22;1844;932;912
Šiauliai c. mun.;2006;23;1792;841;951
Šiauliai c. mun.;2006;24;1748;785;963
Šiauliai c. mun.;2006;25;1733;808;925
Šiauliai c. mun.;2006;26;1715;797;918
Šiauliai c. mun.;2006;27;1631;793;838
Šiauliai c. mun.;2006;28;1722;824;898
Šiauliai c. mun.;2006;29;1804;910;894
Šiauliai c. mun.;2006;30;1820;855;965
Šiauliai c. mun.;2006;31;1832;886;946
Šiauliai c. mun.;2006;32;1845;853;992
Šiauliai c. mun.;2006;33;1904;918;986
Šiauliai c. mun.;2006;34;1925;934;991
Šiauliai c. mun.;2006;35;1908;904;1004
Šiauliai c. mun.;2006;36;1830;884;946
Šiauliai c. mun.;2006;37;1891;899;992
Šiauliai c. mun.;2006;38;1887;906;981
Šiauliai c. mun.;2006;39;1921;932;989
Šiauliai c. mun.;2006;40;1928;917;1011
Šiauliai c. mun.;2006;41;1962;866;1096
Šiauliai c. mun.;2006;42;1960;898;1062
Šiauliai c. mun.;2006;43;2092;916;1176
Šiauliai c. mun.;2006;44;2209;1024;1185
Šiauliai c. mun.;2006;45;2150;930;1220
Šiauliai c. mun.;2006;46;2089;940;1149
Šiauliai c. mun.;2006;47;2087;964;1123
Šiauliai c. mun.;2006;48;1922;860;1062
Šiauliai c. mun.;2006;49;1747;820;927
Šiauliai c. mun.;2006;50;1687;744;943
Šiauliai c. mun.;2006;51;1575;705;870
Šiauliai c. mun.;2006;52;1433;591;842
Šiauliai c. mun.;2006;53;1460;639;821
Šiauliai c. mun.;2006;54;1481;644;837
Šiauliai c. mun.;2006;55;1406;590;816
Šiauliai c. mun.;2006;56;1406;579;827
Šiauliai c. mun.;2006;57;1194;488;706
Šiauliai c. mun.;2006;58;1267;515;752
Šiauliai c. mun.;2006;59;1167;496;671
Šiauliai c. mun.;2006;60;1277;520;757
Šiauliai c. mun.;2006;61;1023;403;620
Šiauliai c. mun.;2006;62;1201;493;708
Šiauliai c. mun.;2006;63;1265;531;734
Šiauliai c. mun.;2006;64;1200;475;725
Šiauliai c. mun.;2006;65;1114;451;663
Šiauliai c. mun.;2006;66;1138;426;712
Šiauliai c. mun.;2006;67;1177;443;734
Šiauliai c. mun.;2006;68;1174;422;752
Šiauliai c. mun.;2006;69;1095;394;701
Šiauliai c. mun.;2006;70;1040;354;686
Šiauliai c. mun.;2006;71;929;314;615
Šiauliai c. mun.;2006;72;1007;369;638
Šiauliai c. mun.;2006;73;946;314;632
Šiauliai c. mun.;2006;74;855;279;576
Šiauliai c. mun.;2006;75;817;276;541
Šiauliai c. mun.;2006;76;789;245;544
Šiauliai c. mun.;2006;77;797;245;552
Šiauliai c. mun.;2006;78;692;223;469
Šiauliai c. mun.;2006;79;622;162;460
Šiauliai c. mun.;2006;80;563;157;406
Šiauliai c. mun.;2006;81;506;124;382
Šiauliai c. mun.;2006;82;467;132;335
Šiauliai c. mun.;2006;83;344;92;252
Šiauliai c. mun.;2006;84;298;72;226
Šiauliai c. mun.;2006;85;1195;288;907
Šiauliai c. mun.;2007;-1;120272;53970;66302
Šiauliai c. mun.;2007;0;954;490;464
Šiauliai c. mun.;2007;1;957;449;508
Šiauliai c. mun.;2007;2;1021;497;524
Šiauliai c. mun.;2007;3;930;485;445
Šiauliai c. mun.;2007;4;872;446;426
Šiauliai c. mun.;2007;5;968;466;502
Šiauliai c. mun.;2007;6;1098;568;530
Šiauliai c. mun.;2007;7;1113;557;556
Šiauliai c. mun.;2007;8;1189;627;562
Šiauliai c. mun.;2007;9;1315;662;653
Šiauliai c. mun.;2007;10;1294;666;628
Šiauliai c. mun.;2007;11;1343;670;673
Šiauliai c. mun.;2007;12;1402;738;664
Šiauliai c. mun.;2007;13;1638;816;822
Šiauliai c. mun.;2007;14;1843;906;937
Šiauliai c. mun.;2007;15;1796;921;875
Šiauliai c. mun.;2007;16;1806;916;890
Šiauliai c. mun.;2007;17;1632;785;847
Šiauliai c. mun.;2007;18;1646;822;824
Šiauliai c. mun.;2007;19;1851;906;945
Šiauliai c. mun.;2007;20;1798;940;858
Šiauliai c. mun.;2007;21;1806;897;909
Šiauliai c. mun.;2007;22;1902;914;988
Šiauliai c. mun.;2007;23;1814;903;911
Šiauliai c. mun.;2007;24;1759;820;939
Šiauliai c. mun.;2007;25;1691;764;927
Šiauliai c. mun.;2007;26;1699;793;906
Šiauliai c. mun.;2007;27;1697;777;920
Šiauliai c. mun.;2007;28;1631;800;831
Šiauliai c. mun.;2007;29;1714;811;903
Šiauliai c. mun.;2007;30;1792;904;888
Šiauliai c. mun.;2007;31;1787;832;955
Šiauliai c. mun.;2007;32;1804;863;941
Šiauliai c. mun.;2007;33;1814;841;973
Šiauliai c. mun.;2007;34;1885;904;981
Šiauliai c. mun.;2007;35;1899;923;976
Šiauliai c. mun.;2007;36;1883;902;981
Šiauliai c. mun.;2007;37;1808;876;932
Šiauliai c. mun.;2007;38;1850;878;972
Šiauliai c. mun.;2007;39;1854;890;964
Šiauliai c. mun.;2007;40;1876;902;974
Šiauliai c. mun.;2007;41;1889;901;988
Šiauliai c. mun.;2007;42;1919;843;1076
Šiauliai c. mun.;2007;43;1913;876;1037
Šiauliai c. mun.;2007;44;2056;900;1156
Šiauliai c. mun.;2007;45;2157;996;1161
Šiauliai c. mun.;2007;46;2112;913;1199
Šiauliai c. mun.;2007;47;2053;920;1133
Šiauliai c. mun.;2007;48;2056;951;1105
Šiauliai c. mun.;2007;49;1881;842;1039
Šiauliai c. mun.;2007;50;1706;798;908
Šiauliai c. mun.;2007;51;1653;725;928
Šiauliai c. mun.;2007;52;1536;690;846
Šiauliai c. mun.;2007;53;1399;573;826
Šiauliai c. mun.;2007;54;1420;611;809
Šiauliai c. mun.;2007;55;1447;628;819
Šiauliai c. mun.;2007;56;1364;565;799
Šiauliai c. mun.;2007;57;1373;556;817
Šiauliai c. mun.;2007;58;1167;474;693
Šiauliai c. mun.;2007;59;1235;493;742
Šiauliai c. mun.;2007;60;1133;472;661
Šiauliai c. mun.;2007;61;1245;503;742
Šiauliai c. mun.;2007;62;989;380;609
Šiauliai c. mun.;2007;63;1158;466;692
Šiauliai c. mun.;2007;64;1228;507;721
Šiauliai c. mun.;2007;65;1162;454;708
Šiauliai c. mun.;2007;66;1078;430;648
Šiauliai c. mun.;2007;67;1100;406;694
Šiauliai c. mun.;2007;68;1141;422;719
Šiauliai c. mun.;2007;69;1129;399;730
Šiauliai c. mun.;2007;70;1069;382;687
Šiauliai c. mun.;2007;71;1005;340;665
Šiauliai c. mun.;2007;72;897;300;597
Šiauliai c. mun.;2007;73;975;355;620
Šiauliai c. mun.;2007;74;905;291;614
Šiauliai c. mun.;2007;75;816;265;551
Šiauliai c. mun.;2007;76;792;268;524
Šiauliai c. mun.;2007;77;752;232;520
Šiauliai c. mun.;2007;78;754;228;526
Šiauliai c. mun.;2007;79;639;200;439
Šiauliai c. mun.;2007;80;583;144;439
Šiauliai c. mun.;2007;81;530;144;386
Šiauliai c. mun.;2007;82;465;113;352
Šiauliai c. mun.;2007;83;420;118;302
Šiauliai c. mun.;2007;84;297;81;216
Šiauliai c. mun.;2007;85;1243;288;955
Šiauliai c. mun.;2008;-1;117829;52751;65078
Šiauliai c. mun.;2008;0;1037;511;526
Šiauliai c. mun.;2008;1;922;469;453
Šiauliai c. mun.;2008;2;924;433;491
Šiauliai c. mun.;2008;3;985;478;507
Šiauliai c. mun.;2008;4;916;475;441
Šiauliai c. mun.;2008;5;838;427;411
Šiauliai c. mun.;2008;6;930;443;487
Šiauliai c. mun.;2008;7;1080;559;521
Šiauliai c. mun.;2008;8;1072;534;538
Šiauliai c. mun.;2008;9;1164;616;548
Šiauliai c. mun.;2008;10;1284;641;643
Šiauliai c. mun.;2008;11;1273;654;619
Šiauliai c. mun.;2008;12;1327;664;663
Šiauliai c. mun.;2008;13;1377;718;659
Šiauliai c. mun.;2008;14;1614;802;812
Šiauliai c. mun.;2008;15;1806;886;920
Šiauliai c. mun.;2008;16;1763;911;852
Šiauliai c. mun.;2008;17;1768;893;875
Šiauliai c. mun.;2008;18;1595;769;826
Šiauliai c. mun.;2008;19;1605;801;804
Šiauliai c. mun.;2008;20;1794;880;914
Šiauliai c. mun.;2008;21;1738;911;827
Šiauliai c. mun.;2008;22;1744;866;878
Šiauliai c. mun.;2008;23;1860;895;965
Šiauliai c. mun.;2008;24;1783;873;910
Šiauliai c. mun.;2008;25;1708;801;907
Šiauliai c. mun.;2008;26;1642;740;902
Šiauliai c. mun.;2008;27;1650;779;871
Šiauliai c. mun.;2008;28;1678;764;914
Šiauliai c. mun.;2008;29;1578;780;798
Šiauliai c. mun.;2008;30;1672;793;879
Šiauliai c. mun.;2008;31;1756;895;861
Šiauliai c. mun.;2008;32;1765;826;939
Šiauliai c. mun.;2008;33;1765;843;922
Šiauliai c. mun.;2008;34;1777;821;956
Šiauliai c. mun.;2008;35;1828;879;949
Šiauliai c. mun.;2008;36;1841;894;947
Šiauliai c. mun.;2008;37;1840;888;952
Šiauliai c. mun.;2008;38;1750;844;906
Šiauliai c. mun.;2008;39;1809;863;946
Šiauliai c. mun.;2008;40;1812;866;946
Šiauliai c. mun.;2008;41;1841;880;961
Šiauliai c. mun.;2008;42;1859;887;972
Šiauliai c. mun.;2008;43;1875;825;1050
Šiauliai c. mun.;2008;44;1884;858;1026
Šiauliai c. mun.;2008;45;2000;871;1129
Šiauliai c. mun.;2008;46;2110;976;1134
Šiauliai c. mun.;2008;47;2067;889;1178
Šiauliai c. mun.;2008;48;2007;892;1115
Šiauliai c. mun.;2008;49;2015;922;1093
Šiauliai c. mun.;2008;50;1828;807;1021
Šiauliai c. mun.;2008;51;1663;772;891
Šiauliai c. mun.;2008;52;1606;704;902
Šiauliai c. mun.;2008;53;1505;671;834
Šiauliai c. mun.;2008;54;1365;554;811
Šiauliai c. mun.;2008;55;1383;591;792
Šiauliai c. mun.;2008;56;1402;606;796
Šiauliai c. mun.;2008;57;1319;536;783
Šiauliai c. mun.;2008;58;1325;526;799
Šiauliai c. mun.;2008;59;1136;461;675
Šiauliai c. mun.;2008;60;1201;469;732
Šiauliai c. mun.;2008;61;1101;455;646
Šiauliai c. mun.;2008;62;1195;475;720
Šiauliai c. mun.;2008;63;971;367;604
Šiauliai c. mun.;2008;64;1114;436;678
Šiauliai c. mun.;2008;65;1198;490;708
Šiauliai c. mun.;2008;66;1126;433;693
Šiauliai c. mun.;2008;67;1054;418;636
Šiauliai c. mun.;2008;68;1060;384;676
Šiauliai c. mun.;2008;69;1106;403;703
Šiauliai c. mun.;2008;70;1104;381;723
Šiauliai c. mun.;2008;71;1026;361;665
Šiauliai c. mun.;2008;72;958;319;639
Šiauliai c. mun.;2008;73;859;280;579
Šiauliai c. mun.;2008;74;933;332;601
Šiauliai c. mun.;2008;75;868;270;598
Šiauliai c. mun.;2008;76;768;242;526
Šiauliai c. mun.;2008;77;742;240;502
Šiauliai c. mun.;2008;78;710;214;496
Šiauliai c. mun.;2008;79;722;216;506
Šiauliai c. mun.;2008;80;597;182;415
Šiauliai c. mun.;2008;81;554;135;419
Šiauliai c. mun.;2008;82;482;132;350
Šiauliai c. mun.;2008;83;429;99;330
Šiauliai c. mun.;2008;84;369;101;268
Šiauliai c. mun.;2008;85;1322;304;1018
Šiauliai c. mun.;2009;-1;116196;51944;64252
Šiauliai c. mun.;2009;0;1108;570;538
Šiauliai c. mun.;2009;1;1016;503;513
Šiauliai c. mun.;2009;2;902;461;441
Šiauliai c. mun.;2009;3;914;430;484
Šiauliai c. mun.;2009;4;964;458;506
Šiauliai c. mun.;2009;5;902;463;439
Šiauliai c. mun.;2009;6;816;417;399
Šiauliai c. mun.;2009;7;916;438;478
Šiauliai c. mun.;2009;8;1065;551;514
Šiauliai c. mun.;2009;9;1068;533;535
Šiauliai c. mun.;2009;10;1152;614;538
Šiauliai c. mun.;2009;11;1266;630;636
Šiauliai c. mun.;2009;12;1252;644;608
Šiauliai c. mun.;2009;13;1309;656;653
Šiauliai c. mun.;2009;14;1346;705;641
Šiauliai c. mun.;2009;15;1590;791;799
Šiauliai c. mun.;2009;16;1797;879;918
Šiauliai c. mun.;2009;17;1749;899;850
Šiauliai c. mun.;2009;18;1736;873;863
Šiauliai c. mun.;2009;19;1572;757;815
Šiauliai c. mun.;2009;20;1577;780;797
Šiauliai c. mun.;2009;21;1754;852;902
Šiauliai c. mun.;2009;22;1711;897;814
Šiauliai c. mun.;2009;23;1709;847;862
Šiauliai c. mun.;2009;24;1814;876;938
Šiauliai c. mun.;2009;25;1747;854;893
Šiauliai c. mun.;2009;26;1658;790;868
Šiauliai c. mun.;2009;27;1601;727;874
Šiauliai c. mun.;2009;28;1610;759;851
Šiauliai c. mun.;2009;29;1656;755;901
Šiauliai c. mun.;2009;30;1548;768;780
Šiauliai c. mun.;2009;31;1642;782;860
Šiauliai c. mun.;2009;32;1724;880;844
Šiauliai c. mun.;2009;33;1743;810;933
Šiauliai c. mun.;2009;34;1749;836;913
Šiauliai c. mun.;2009;35;1746;808;938
Šiauliai c. mun.;2009;36;1798;862;936
Šiauliai c. mun.;2009;37;1822;883;939
Šiauliai c. mun.;2009;38;1825;876;949
Šiauliai c. mun.;2009;39;1714;819;895
Šiauliai c. mun.;2009;40;1786;848;938
Šiauliai c. mun.;2009;41;1783;846;937
Šiauliai c. mun.;2009;42;1812;863;949
Šiauliai c. mun.;2009;43;1824;871;953
Šiauliai c. mun.;2009;44;1842;807;1035
Šiauliai c. mun.;2009;45;1852;839;1013
Šiauliai c. mun.;2009;46;1968;853;1115
Šiauliai c. mun.;2009;47;2074;955;1119
Šiauliai c. mun.;2009;48;2027;862;1165
Šiauliai c. mun.;2009;49;1960;867;1093
Šiauliai c. mun.;2009;50;1974;904;1070
Šiauliai c. mun.;2009;51;1791;779;1012
Šiauliai c. mun.;2009;52;1630;750;880
Šiauliai c. mun.;2009;53;1580;684;896
Šiauliai c. mun.;2009;54;1480;655;825
Šiauliai c. mun.;2009;55;1331;535;796
Šiauliai c. mun.;2009;56;1352;573;779
Šiauliai c. mun.;2009;57;1375;588;787
Šiauliai c. mun.;2009;58;1294;523;771
Šiauliai c. mun.;2009;59;1303;516;787
Šiauliai c. mun.;2009;60;1108;445;663
Šiauliai c. mun.;2009;61;1177;456;721
Šiauliai c. mun.;2009;62;1067;438;629
Šiauliai c. mun.;2009;63;1161;449;712
Šiauliai c. mun.;2009;64;948;354;594
Šiauliai c. mun.;2009;65;1077;412;665
Šiauliai c. mun.;2009;66;1168;473;695
Šiauliai c. mun.;2009;67;1092;416;676
Šiauliai c. mun.;2009;68;1026;399;627
Šiauliai c. mun.;2009;69;1026;366;660
Šiauliai c. mun.;2009;70;1080;395;685
Šiauliai c. mun.;2009;71;1067;359;708
Šiauliai c. mun.;2009;72;983;330;653
Šiauliai c. mun.;2009;73;921;306;615
Šiauliai c. mun.;2009;74;823;262;561
Šiauliai c. mun.;2009;75;888;307;581
Šiauliai c. mun.;2009;76;838;258;580
Šiauliai c. mun.;2009;77;727;226;501
Šiauliai c. mun.;2009;78;697;221;476
Šiauliai c. mun.;2009;79;670;189;481
Šiauliai c. mun.;2009;80;683;201;482
Šiauliai c. mun.;2009;81;551;161;390
Šiauliai c. mun.;2009;82;510;127;383
Šiauliai c. mun.;2009;83;440;118;322
Šiauliai c. mun.;2009;84;378;84;294
Šiauliai c. mun.;2009;85;1464;341;1123
Šiauliai c. mun.;2010;-1;114506;51048;63458
Šiauliai c. mun.;2010;0;1149;575;574
Šiauliai c. mun.;2010;1;1092;564;528
Šiauliai c. mun.;2010;2;1039;503;536
Šiauliai c. mun.;2010;3;887;453;434
Šiauliai c. mun.;2010;4;904;425;479
Šiauliai c. mun.;2010;5;967;460;507
Šiauliai c. mun.;2010;6;897;469;428
Šiauliai c. mun.;2010;7;803;412;391
Šiauliai c. mun.;2010;8;907;434;473
Šiauliai c. mun.;2010;9;1054;552;502
Šiauliai c. mun.;2010;10;1063;525;538
Šiauliai c. mun.;2010;11;1139;602;537
Šiauliai c. mun.;2010;12;1245;622;623
Šiauliai c. mun.;2010;13;1231;627;604
Šiauliai c. mun.;2010;14;1304;656;648
Šiauliai c. mun.;2010;15;1331;699;632
Šiauliai c. mun.;2010;16;1567;781;786
Šiauliai c. mun.;2010;17;1782;869;913
Šiauliai c. mun.;2010;18;1724;879;845
Šiauliai c. mun.;2010;19;1705;848;857
Šiauliai c. mun.;2010;20;1533;739;794
Šiauliai c. mun.;2010;21;1526;756;770
Šiauliai c. mun.;2010;22;1707;822;885
Šiauliai c. mun.;2010;23;1666;870;796
Šiauliai c. mun.;2010;24;1638;817;821
Šiauliai c. mun.;2010;25;1765;852;913
Šiauliai c. mun.;2010;26;1695;830;865
Šiauliai c. mun.;2010;27;1611;753;858
Šiauliai c. mun.;2010;28;1544;697;847
Šiauliai c. mun.;2010;29;1589;742;847
Šiauliai c. mun.;2010;30;1616;728;888
Šiauliai c. mun.;2010;31;1514;752;762
Šiauliai c. mun.;2010;32;1586;757;829
Šiauliai c. mun.;2010;33;1690;865;825
Šiauliai c. mun.;2010;34;1687;783;904
Šiauliai c. mun.;2010;35;1707;814;893
Šiauliai c. mun.;2010;36;1712;797;915
Šiauliai c. mun.;2010;37;1758;843;915
Šiauliai c. mun.;2010;38;1772;852;920
Šiauliai c. mun.;2010;39;1789;855;934
Šiauliai c. mun.;2010;40;1676;800;876
Šiauliai c. mun.;2010;41;1747;818;929
Šiauliai c. mun.;2010;42;1754;826;928
Šiauliai c. mun.;2010;43;1776;845;931
Šiauliai c. mun.;2010;44;1779;849;930
Šiauliai c. mun.;2010;45;1802;784;1018
Šiauliai c. mun.;2010;46;1814;814;1000
Šiauliai c. mun.;2010;47;1931;829;1102
Šiauliai c. mun.;2010;48;2045;937;1108
Šiauliai c. mun.;2010;49;2002;844;1158
Šiauliai c. mun.;2010;50;1922;846;1076
Šiauliai c. mun.;2010;51;1940;882;1058
Šiauliai c. mun.;2010;52;1765;763;1002
Šiauliai c. mun.;2010;53;1590;726;864
Šiauliai c. mun.;2010;54;1561;672;889
Šiauliai c. mun.;2010;55;1446;637;809
Šiauliai c. mun.;2010;56;1306;521;785
Šiauliai c. mun.;2010;57;1320;561;759
Šiauliai c. mun.;2010;58;1342;570;772
Šiauliai c. mun.;2010;59;1266;508;758
Šiauliai c. mun.;2010;60;1287;505;782
Šiauliai c. mun.;2010;61;1071;422;649
Šiauliai c. mun.;2010;62;1154;444;710
Šiauliai c. mun.;2010;63;1041;416;625
Šiauliai c. mun.;2010;64;1127;424;703
Šiauliai c. mun.;2010;65;927;343;584
Šiauliai c. mun.;2010;66;1053;399;654
Šiauliai c. mun.;2010;67;1133;449;684
Šiauliai c. mun.;2010;68;1056;391;665
Šiauliai c. mun.;2010;69;999;388;611
Šiauliai c. mun.;2010;70;992;351;641
Šiauliai c. mun.;2010;71;1053;379;674
Šiauliai c. mun.;2010;72;1038;346;692
Šiauliai c. mun.;2010;73;941;316;625
Šiauliai c. mun.;2010;74;885;288;597
Šiauliai c. mun.;2010;75;792;245;547
Šiauliai c. mun.;2010;76;856;292;564
Šiauliai c. mun.;2010;77;798;236;562
Šiauliai c. mun.;2010;78;688;206;482
Šiauliai c. mun.;2010;79;656;205;451
Šiauliai c. mun.;2010;80;644;180;464
Šiauliai c. mun.;2010;81;633;179;454
Šiauliai c. mun.;2010;82;518;147;371
Šiauliai c. mun.;2010;83;467;114;353
Šiauliai c. mun.;2010;84;407;110;297
Šiauliai c. mun.;2010;85;1611;362;1249
Šiauliai c. mun.;2011;-1;109748;48756;60992
Šiauliai c. mun.;2011;0;1104;565;539
Šiauliai c. mun.;2011;1;1179;605;574
Šiauliai c. mun.;2011;2;1118;562;556
Šiauliai c. mun.;2011;3;1010;497;513
Šiauliai c. mun.;2011;4;913;482;431
Šiauliai c. mun.;2011;5;929;447;482
Šiauliai c. mun.;2011;6;945;456;489
Šiauliai c. mun.;2011;7;932;495;437
Šiauliai c. mun.;2011;8;903;474;429
Šiauliai c. mun.;2011;9;910;446;464
Šiauliai c. mun.;2011;10;1022;523;499
Šiauliai c. mun.;2011;11;1071;543;528
Šiauliai c. mun.;2011;12;1125;585;540
Šiauliai c. mun.;2011;13;1256;626;630
Šiauliai c. mun.;2011;14;1262;642;620
Šiauliai c. mun.;2011;15;1314;654;660
Šiauliai c. mun.;2011;16;1361;730;631
Šiauliai c. mun.;2011;17;1633;824;809
Šiauliai c. mun.;2011;18;1755;874;881
Šiauliai c. mun.;2011;19;1631;831;800
Šiauliai c. mun.;2011;20;1592;768;824
Šiauliai c. mun.;2011;21;1491;695;796
Šiauliai c. mun.;2011;22;1516;751;765
Šiauliai c. mun.;2011;23;1558;752;806
Šiauliai c. mun.;2011;24;1525;789;736
Šiauliai c. mun.;2011;25;1516;785;731
Šiauliai c. mun.;2011;26;1530;741;789
Šiauliai c. mun.;2011;27;1464;731;733
Šiauliai c. mun.;2011;28;1334;667;667
Šiauliai c. mun.;2011;29;1277;639;638
Šiauliai c. mun.;2011;30;1339;645;694
Šiauliai c. mun.;2011;31;1341;623;718
Šiauliai c. mun.;2011;32;1251;607;644
Šiauliai c. mun.;2011;33;1323;621;702
Šiauliai c. mun.;2011;34;1395;705;690
Šiauliai c. mun.;2011;35;1424;666;758
Šiauliai c. mun.;2011;36;1414;674;740
Šiauliai c. mun.;2011;37;1480;673;807
Šiauliai c. mun.;2011;38;1556;720;836
Šiauliai c. mun.;2011;39;1560;719;841
Šiauliai c. mun.;2011;40;1601;746;855
Šiauliai c. mun.;2011;41;1530;701;829
Šiauliai c. mun.;2011;42;1595;722;873
Šiauliai c. mun.;2011;43;1616;760;856
Šiauliai c. mun.;2011;44;1668;770;898
Šiauliai c. mun.;2011;45;1661;765;896
Šiauliai c. mun.;2011;46;1680;720;960
Šiauliai c. mun.;2011;47;1726;777;949
Šiauliai c. mun.;2011;48;1828;784;1044
Šiauliai c. mun.;2011;49;1970;891;1079
Šiauliai c. mun.;2011;50;1991;844;1147
Šiauliai c. mun.;2011;51;1876;831;1045
Šiauliai c. mun.;2011;52;1928;874;1054
Šiauliai c. mun.;2011;53;1728;737;991
Šiauliai c. mun.;2011;54;1569;700;869
Šiauliai c. mun.;2011;55;1524;647;877
Šiauliai c. mun.;2011;56;1435;622;813
Šiauliai c. mun.;2011;57;1287;512;775
Šiauliai c. mun.;2011;58;1264;527;737
Šiauliai c. mun.;2011;59;1303;554;749
Šiauliai c. mun.;2011;60;1276;496;780
Šiauliai c. mun.;2011;61;1303;507;796
Šiauliai c. mun.;2011;62;1067;416;651
Šiauliai c. mun.;2011;63;1105;413;692
Šiauliai c. mun.;2011;64;1046;403;643
Šiauliai c. mun.;2011;65;1155;427;728
Šiauliai c. mun.;2011;66;911;343;568
Šiauliai c. mun.;2011;67;1064;404;660
Šiauliai c. mun.;2011;68;1154;455;699
Šiauliai c. mun.;2011;69;1090;410;680
Šiauliai c. mun.;2011;70;986;358;628
Šiauliai c. mun.;2011;71;1000;352;648
Šiauliai c. mun.;2011;72;1021;355;666
Šiauliai c. mun.;2011;73;1018;338;680
Šiauliai c. mun.;2011;74;932;304;628
Šiauliai c. mun.;2011;75;896;286;610
Šiauliai c. mun.;2011;76;785;234;551
Šiauliai c. mun.;2011;77;845;277;568
Šiauliai c. mun.;2011;78;802;236;566
Šiauliai c. mun.;2011;79;717;219;498
Šiauliai c. mun.;2011;80;640;204;436
Šiauliai c. mun.;2011;81;618;172;446
Šiauliai c. mun.;2011;82;606;172;434
Šiauliai c. mun.;2011;83;489;133;356
Šiauliai c. mun.;2011;84;448;113;335
Šiauliai c. mun.;2011;85;1735;413;1322
Šiauliai c. mun.;2012;-1;107689;47683;60006
Šiauliai c. mun.;2012;0;1098;564;534
Šiauliai c. mun.;2012;1;1150;586;564
Šiauliai c. mun.;2012;2;1229;626;603
Šiauliai c. mun.;2012;3;1112;565;547
Šiauliai c. mun.;2012;4;987;483;504
Šiauliai c. mun.;2012;5;892;474;418
Šiauliai c. mun.;2012;6;905;434;471
Šiauliai c. mun.;2012;7;922;451;471
Šiauliai c. mun.;2012;8;912;480;432
Šiauliai c. mun.;2012;9;891;468;423
Šiauliai c. mun.;2012;10;888;438;450
Šiauliai c. mun.;2012;11;997;510;487
Šiauliai c. mun.;2012;12;1044;531;513
Šiauliai c. mun.;2012;13;1110;574;536
Šiauliai c. mun.;2012;14;1232;612;620
Šiauliai c. mun.;2012;15;1239;629;610
Šiauliai c. mun.;2012;16;1286;640;646
Šiauliai c. mun.;2012;17;1342;723;619
Šiauliai c. mun.;2012;18;1609;808;801
Šiauliai c. mun.;2012;19;1637;814;823
Šiauliai c. mun.;2012;20;1570;794;776
Šiauliai c. mun.;2012;21;1562;749;813
Šiauliai c. mun.;2012;22;1451;672;779
Šiauliai c. mun.;2012;23;1445;715;730
Šiauliai c. mun.;2012;24;1489;714;775
Šiauliai c. mun.;2012;25;1449;730;719
Šiauliai c. mun.;2012;26;1430;723;707
Šiauliai c. mun.;2012;27;1462;696;766
Šiauliai c. mun.;2012;28;1408;702;706
Šiauliai c. mun.;2012;29;1283;645;638
Šiauliai c. mun.;2012;30;1231;611;620
Šiauliai c. mun.;2012;31;1274;603;671
Šiauliai c. mun.;2012;32;1288;592;696
Šiauliai c. mun.;2012;33;1211;587;624
Šiauliai c. mun.;2012;34;1288;600;688
Šiauliai c. mun.;2012;35;1358;683;675
Šiauliai c. mun.;2012;36;1385;643;742
Šiauliai c. mun.;2012;37;1378;655;723
Šiauliai c. mun.;2012;38;1458;666;792
Šiauliai c. mun.;2012;39;1513;706;807
Šiauliai c. mun.;2012;40;1529;703;826
Šiauliai c. mun.;2012;41;1544;709;835
Šiauliai c. mun.;2012;42;1492;681;811
Šiauliai c. mun.;2012;43;1566;705;861
Šiauliai c. mun.;2012;44;1565;740;825
Šiauliai c. mun.;2012;45;1615;745;870
Šiauliai c. mun.;2012;46;1637;753;884
Šiauliai c. mun.;2012;47;1649;707;942
Šiauliai c. mun.;2012;48;1695;763;932
Šiauliai c. mun.;2012;49;1805;780;1025
Šiauliai c. mun.;2012;50;1938;876;1062
Šiauliai c. mun.;2012;51;1945;820;1125
Šiauliai c. mun.;2012;52;1840;812;1028
Šiauliai c. mun.;2012;53;1890;852;1038
Šiauliai c. mun.;2012;54;1683;713;970
Šiauliai c. mun.;2012;55;1532;682;850
Šiauliai c. mun.;2012;56;1497;626;871
Šiauliai c. mun.;2012;57;1404;607;797
Šiauliai c. mun.;2012;58;1265;496;769
Šiauliai c. mun.;2012;59;1240;514;726
Šiauliai c. mun.;2012;60;1276;532;744
Šiauliai c. mun.;2012;61;1244;482;762
Šiauliai c. mun.;2012;62;1277;488;789
Šiauliai c. mun.;2012;63;1056;404;652
Šiauliai c. mun.;2012;64;1084;399;685
Šiauliai c. mun.;2012;65;1024;391;633
Šiauliai c. mun.;2012;66;1127;408;719
Šiauliai c. mun.;2012;67;896;332;564
Šiauliai c. mun.;2012;68;1030;385;645
Šiauliai c. mun.;2012;69;1113;426;687
Šiauliai c. mun.;2012;70;1068;394;674
Šiauliai c. mun.;2012;71;954;339;615
Šiauliai c. mun.;2012;72;974;337;637
Šiauliai c. mun.;2012;73;991;337;654
Šiauliai c. mun.;2012;74;993;325;668
Šiauliai c. mun.;2012;75;907;291;616
Šiauliai c. mun.;2012;76;854;264;590
Šiauliai c. mun.;2012;77;760;220;540
Šiauliai c. mun.;2012;78;810;263;547
Šiauliai c. mun.;2012;79;761;219;542
Šiauliai c. mun.;2012;80;675;201;474
Šiauliai c. mun.;2012;81;614;190;424
Šiauliai c. mun.;2012;82;585;158;427
Šiauliai c. mun.;2012;83;555;155;400
Šiauliai c. mun.;2012;84;437;113;324
Šiauliai c. mun.;2012;85;1878;450;1428
Šiauliai c. mun.;2013;-1;106470;47133;59337
Šiauliai c. mun.;2013;0;1130;594;536
Šiauliai c. mun.;2013;1;1118;569;549
Šiauliai c. mun.;2013;2;1196;614;582
Šiauliai c. mun.;2013;3;1212;620;592
Šiauliai c. mun.;2013;4;1080;548;532
Šiauliai c. mun.;2013;5;972;484;488
Šiauliai c. mun.;2013;6;892;470;422
Šiauliai c. mun.;2013;7;890;430;460
Šiauliai c. mun.;2013;8;925;449;476
Šiauliai c. mun.;2013;9;895;476;419
Šiauliai c. mun.;2013;10;890;465;425
Šiauliai c. mun.;2013;11;873;429;444
Šiauliai c. mun.;2013;12;988;510;478
Šiauliai c. mun.;2013;13;1024;524;500
Šiauliai c. mun.;2013;14;1100;569;531
Šiauliai c. mun.;2013;15;1214;605;609
Šiauliai c. mun.;2013;16;1226;625;601
Šiauliai c. mun.;2013;17;1263;628;635
Šiauliai c. mun.;2013;18;1337;714;623
Šiauliai c. mun.;2013;19;1537;779;758
Šiauliai c. mun.;2013;20;1602;799;803
Šiauliai c. mun.;2013;21;1562;789;773
Šiauliai c. mun.;2013;22;1530;720;810
Šiauliai c. mun.;2013;23;1390;649;741
Šiauliai c. mun.;2013;24;1402;695;707
Šiauliai c. mun.;2013;25;1462;710;752
Šiauliai c. mun.;2013;26;1406;689;717
Šiauliai c. mun.;2013;27;1410;695;715
Šiauliai c. mun.;2013;28;1474;705;769
Šiauliai c. mun.;2013;29;1361;682;679
Šiauliai c. mun.;2013;30;1249;626;623
Šiauliai c. mun.;2013;31;1231;616;615
Šiauliai c. mun.;2013;32;1241;587;654
Šiauliai c. mun.;2013;33;1245;572;673
Šiauliai c. mun.;2013;34;1179;566;613
Šiauliai c. mun.;2013;35;1250;586;664
Šiauliai c. mun.;2013;36;1329;663;666
Šiauliai c. mun.;2013;37;1366;633;733
Šiauliai c. mun.;2013;38;1352;645;707
Šiauliai c. mun.;2013;39;1442;659;783
Šiauliai c. mun.;2013;40;1481;692;789
Šiauliai c. mun.;2013;41;1510;697;813
Šiauliai c. mun.;2013;42;1520;696;824
Šiauliai c. mun.;2013;43;1470;675;795
Šiauliai c. mun.;2013;44;1524;688;836
Šiauliai c. mun.;2013;45;1532;723;809
Šiauliai c. mun.;2013;46;1591;724;867
Šiauliai c. mun.;2013;47;1616;745;871
Šiauliai c. mun.;2013;48;1619;684;935
Šiauliai c. mun.;2013;49;1679;755;924
Šiauliai c. mun.;2013;50;1789;774;1015
Šiauliai c. mun.;2013;51;1916;863;1053
Šiauliai c. mun.;2013;52;1934;816;1118
Šiauliai c. mun.;2013;53;1814;800;1014
Šiauliai c. mun.;2013;54;1862;832;1030
Šiauliai c. mun.;2013;55;1663;699;964
Šiauliai c. mun.;2013;56;1512;665;847
Šiauliai c. mun.;2013;57;1480;614;866
Šiauliai c. mun.;2013;58;1382;595;787
Šiauliai c. mun.;2013;59;1248;487;761
Šiauliai c. mun.;2013;60;1220;500;720
Šiauliai c. mun.;2013;61;1253;514;739
Šiauliai c. mun.;2013;62;1221;463;758
Šiauliai c. mun.;2013;63;1251;473;778
Šiauliai c. mun.;2013;64;1033;392;641
Šiauliai c. mun.;2013;65;1063;388;675
Šiauliai c. mun.;2013;66;1003;378;625
Šiauliai c. mun.;2013;67;1100;386;714
Šiauliai c. mun.;2013;68;872;313;559
Šiauliai c. mun.;2013;69;1006;373;633
Šiauliai c. mun.;2013;70;1100;418;682
Šiauliai c. mun.;2013;71;1027;371;656
Šiauliai c. mun.;2013;72;930;327;603
Šiauliai c. mun.;2013;73;954;325;629
Šiauliai c. mun.;2013;74;961;317;644
Šiauliai c. mun.;2013;75;967;310;657
Šiauliai c. mun.;2013;76;870;274;596
Šiauliai c. mun.;2013;77;819;247;572
Šiauliai c. mun.;2013;78;725;201;524
Šiauliai c. mun.;2013;79;753;240;513
Šiauliai c. mun.;2013;80;724;204;520
Šiauliai c. mun.;2013;81;645;186;459
Šiauliai c. mun.;2013;82;574;173;401
Šiauliai c. mun.;2013;83;546;145;401
Šiauliai c. mun.;2013;84;498;133;365
Šiauliai c. mun.;2013;85;1968;470;1498
Šiauliai c. mun.;2014;-1;105610;46756;58854
Šiauliai c. mun.;2014;0;1064;519;545
Šiauliai c. mun.;2014;1;1146;601;545
Šiauliai c. mun.;2014;2;1161;591;570
Šiauliai c. mun.;2014;3;1194;604;590
Šiauliai c. mun.;2014;4;1191;599;592
Šiauliai c. mun.;2014;5;1088;563;525
Šiauliai c. mun.;2014;6;953;475;478
Šiauliai c. mun.;2014;7;878;459;419
Šiauliai c. mun.;2014;8;888;435;453
Šiauliai c. mun.;2014;9;919;441;478
Šiauliai c. mun.;2014;10;895;476;419
Šiauliai c. mun.;2014;11;876;454;422
Šiauliai c. mun.;2014;12;873;433;440
Šiauliai c. mun.;2014;13;981;505;476
Šiauliai c. mun.;2014;14;1021;520;501
Šiauliai c. mun.;2014;15;1096;560;536
Šiauliai c. mun.;2014;16;1200;597;603
Šiauliai c. mun.;2014;17;1221;623;598
Šiauliai c. mun.;2014;18;1248;626;622
Šiauliai c. mun.;2014;19;1274;686;588
Šiauliai c. mun.;2014;20;1531;774;757
Šiauliai c. mun.;2014;21;1571;778;793
Šiauliai c. mun.;2014;22;1531;773;758
Šiauliai c. mun.;2014;23;1484;695;789
Šiauliai c. mun.;2014;24;1378;635;743
Šiauliai c. mun.;2014;25;1419;697;722
Šiauliai c. mun.;2014;26;1475;714;761
Šiauliai c. mun.;2014;27;1389;694;695
Šiauliai c. mun.;2014;28;1427;713;714
Šiauliai c. mun.;2014;29;1456;686;770
Šiauliai c. mun.;2014;30;1360;682;678
Šiauliai c. mun.;2014;31;1241;626;615
Šiauliai c. mun.;2014;32;1237;623;614
Šiauliai c. mun.;2014;33;1232;590;642
Šiauliai c. mun.;2014;34;1229;570;659
Šiauliai c. mun.;2014;35;1168;562;606
Šiauliai c. mun.;2014;36;1245;593;652
Šiauliai c. mun.;2014;37;1317;658;659
Šiauliai c. mun.;2014;38;1341;621;720
Šiauliai c. mun.;2014;39;1347;645;702
Šiauliai c. mun.;2014;40;1428;651;777
Šiauliai c. mun.;2014;41;1467;685;782
Šiauliai c. mun.;2014;42;1489;687;802
Šiauliai c. mun.;2014;43;1508;692;816
Šiauliai c. mun.;2014;44;1448;666;782
Šiauliai c. mun.;2014;45;1487;671;816
Šiauliai c. mun.;2014;46;1508;711;797
Šiauliai c. mun.;2014;47;1575;711;864
Šiauliai c. mun.;2014;48;1584;726;858
Šiauliai c. mun.;2014;49;1601;681;920
Šiauliai c. mun.;2014;50;1655;741;914
Šiauliai c. mun.;2014;51;1758;757;1001
Šiauliai c. mun.;2014;52;1894;846;1048
Šiauliai c. mun.;2014;53;1906;803;1103
Šiauliai c. mun.;2014;54;1788;783;1005
Šiauliai c. mun.;2014;55;1830;818;1012
Šiauliai c. mun.;2014;56;1628;685;943
Šiauliai c. mun.;2014;57;1486;647;839
Šiauliai c. mun.;2014;58;1469;611;858
Šiauliai c. mun.;2014;59;1357;580;777
Šiauliai c. mun.;2014;60;1231;474;757
Šiauliai c. mun.;2014;61;1195;492;703
Šiauliai c. mun.;2014;62;1221;492;729
Šiauliai c. mun.;2014;63;1200;450;750
Šiauliai c. mun.;2014;64;1224;453;771
Šiauliai c. mun.;2014;65;1009;370;639
Šiauliai c. mun.;2014;66;1040;374;666
Šiauliai c. mun.;2014;67;979;367;612
Šiauliai c. mun.;2014;68;1078;374;704
Šiauliai c. mun.;2014;69;847;294;553
Šiauliai c. mun.;2014;70;980;356;624
Šiauliai c. mun.;2014;71;1073;395;678
Šiauliai c. mun.;2014;72;991;353;638
Šiauliai c. mun.;2014;73;906;309;597
Šiauliai c. mun.;2014;74;914;302;612
Šiauliai c. mun.;2014;75;925;303;622
Šiauliai c. mun.;2014;76;945;293;652
Šiauliai c. mun.;2014;77;837;262;575
Šiauliai c. mun.;2014;78;792;230;562
Šiauliai c. mun.;2014;79;683;184;499
Šiauliai c. mun.;2014;80;711;226;485
Šiauliai c. mun.;2014;81;678;191;487
Šiauliai c. mun.;2014;82;588;166;422
Šiauliai c. mun.;2014;83;539;162;377
Šiauliai c. mun.;2014;84;506;128;378
Šiauliai c. mun.;2014;85;2107;508;1599
Šiauliai c. mun.;2015;-1;104569;46136;58433
Šiauliai c. mun.;2015;0;1124;568;556
Šiauliai c. mun.;2015;1;1088;534;554
Šiauliai c. mun.;2015;2;1180;622;558
Šiauliai c. mun.;2015;3;1177;593;584
Šiauliai c. mun.;2015;4;1168;594;574
Šiauliai c. mun.;2015;5;1160;582;578
Šiauliai c. mun.;2015;6;1066;546;520
Šiauliai c. mun.;2015;7;918;447;471
Šiauliai c. mun.;2015;8;858;450;408
Šiauliai c. mun.;2015;9;873;427;446
Šiauliai c. mun.;2015;10;902;425;477
Šiauliai c. mun.;2015;11;879;464;415
Šiauliai c. mun.;2015;12;870;447;423
Šiauliai c. mun.;2015;13;859;429;430
Šiauliai c. mun.;2015;14;969;494;475
Šiauliai c. mun.;2015;15;996;509;487
Šiauliai c. mun.;2015;16;1085;551;534
Šiauliai c. mun.;2015;17;1185;593;592
Šiauliai c. mun.;2015;18;1214;613;601
Šiauliai c. mun.;2015;19;1202;602;600
Šiauliai c. mun.;2015;20;1234;663;571
Šiauliai c. mun.;2015;21;1502;743;759
Šiauliai c. mun.;2015;22;1535;758;777
Šiauliai c. mun.;2015;23;1499;750;749
Šiauliai c. mun.;2015;24;1478;695;783
Šiauliai c. mun.;2015;25;1377;632;745
Šiauliai c. mun.;2015;26;1415;685;730
Šiauliai c. mun.;2015;27;1500;711;789
Šiauliai c. mun.;2015;28;1404;688;716
Šiauliai c. mun.;2015;29;1432;719;713
Šiauliai c. mun.;2015;30;1454;684;770
Šiauliai c. mun.;2015;31;1355;667;688
Šiauliai c. mun.;2015;32;1251;632;619
Šiauliai c. mun.;2015;33;1221;618;603
Šiauliai c. mun.;2015;34;1210;579;631
Šiauliai c. mun.;2015;35;1205;554;651
Šiauliai c. mun.;2015;36;1148;554;594
Šiauliai c. mun.;2015;37;1249;598;651
Šiauliai c. mun.;2015;38;1300;644;656
Šiauliai c. mun.;2015;39;1327;611;716
Šiauliai c. mun.;2015;40;1325;640;685
Šiauliai c. mun.;2015;41;1396;634;762
Šiauliai c. mun.;2015;42;1432;667;765
Šiauliai c. mun.;2015;43;1462;666;796
Šiauliai c. mun.;2015;44;1477;675;802
Šiauliai c. mun.;2015;45;1411;644;767
Šiauliai c. mun.;2015;46;1455;661;794
Šiauliai c. mun.;2015;47;1486;692;794
Šiauliai c. mun.;2015;48;1539;692;847
Šiauliai c. mun.;2015;49;1552;706;846
Šiauliai c. mun.;2015;50;1597;686;911
Šiauliai c. mun.;2015;51;1628;722;906
Šiauliai c. mun.;2015;52;1713;732;981
Šiauliai c. mun.;2015;53;1853;818;1035
Šiauliai c. mun.;2015;54;1867;778;1089
Šiauliai c. mun.;2015;55;1759;764;995
Šiauliai c. mun.;2015;56;1789;794;995
Šiauliai c. mun.;2015;57;1615;679;936
Šiauliai c. mun.;2015;58;1455;631;824
Šiauliai c. mun.;2015;59;1424;582;842
Šiauliai c. mun.;2015;60;1328;562;766
Šiauliai c. mun.;2015;61;1217;463;754
Šiauliai c. mun.;2015;62;1168;477;691
Šiauliai c. mun.;2015;63;1204;483;721
Šiauliai c. mun.;2015;64;1170;432;738
Šiauliai c. mun.;2015;65;1209;441;768
Šiauliai c. mun.;2015;66;979;345;634
Šiauliai c. mun.;2015;67;1010;352;658
Šiauliai c. mun.;2015;68;955;343;612
Šiauliai c. mun.;2015;69;1053;363;690
Šiauliai c. mun.;2015;70;832;285;547
Šiauliai c. mun.;2015;71;942;331;611
Šiauliai c. mun.;2015;72;1042;384;658
Šiauliai c. mun.;2015;73;971;343;628
Šiauliai c. mun.;2015;74;878;294;584
Šiauliai c. mun.;2015;75;895;288;607
Šiauliai c. mun.;2015;76;892;285;607
Šiauliai c. mun.;2015;77;913;277;636
Šiauliai c. mun.;2015;78;801;241;560
Šiauliai c. mun.;2015;79;759;219;540
Šiauliai c. mun.;2015;80;643;167;476
Šiauliai c. mun.;2015;81;672;210;462
Šiauliai c. mun.;2015;82;637;178;459
Šiauliai c. mun.;2015;83;543;146;397
Šiauliai c. mun.;2015;84;498;147;351
Šiauliai c. mun.;2015;85;2254;542;1712
Šiauliai c. mun.;2016;-1;102981;45315;57666
Šiauliai c. mun.;2016;0;1186;621;565
Šiauliai c. mun.;2016;1;1123;570;553
Šiauliai c. mun.;2016;2;1117;562;555
Šiauliai c. mun.;2016;3;1177;617;560
Šiauliai c. mun.;2016;4;1144;578;566
Šiauliai c. mun.;2016;5;1146;580;566
Šiauliai c. mun.;2016;6;1149;570;579
Šiauliai c. mun.;2016;7;1016;519;497
Šiauliai c. mun.;2016;8;887;426;461
Šiauliai c. mun.;2016;9;834;435;399
Šiauliai c. mun.;2016;10;849;410;439
Šiauliai c. mun.;2016;11;881;422;459
Šiauliai c. mun.;2016;12;864;457;407
Šiauliai c. mun.;2016;13;834;429;405
Šiauliai c. mun.;2016;14;841;422;419
Šiauliai c. mun.;2016;15;948;476;472
Šiauliai c. mun.;2016;16;978;503;475
Šiauliai c. mun.;2016;17;1062;534;528
Šiauliai c. mun.;2016;18;1176;581;595
Šiauliai c. mun.;2016;19;1161;582;579
Šiauliai c. mun.;2016;20;1164;573;591
Šiauliai c. mun.;2016;21;1202;639;563
Šiauliai c. mun.;2016;22;1462;713;749
Šiauliai c. mun.;2016;23;1482;728;754
Šiauliai c. mun.;2016;24;1428;693;735
Šiauliai c. mun.;2016;25;1451;674;777
Šiauliai c. mun.;2016;26;1318;594;724
Šiauliai c. mun.;2016;27;1402;694;708
Šiauliai c. mun.;2016;28;1517;729;788
Šiauliai c. mun.;2016;29;1382;685;697
Šiauliai c. mun.;2016;30;1419;711;708
Šiauliai c. mun.;2016;31;1425;652;773
Šiauliai c. mun.;2016;32;1316;645;671
Šiauliai c. mun.;2016;33;1219;603;616
Šiauliai c. mun.;2016;34;1188;591;597
Šiauliai c. mun.;2016;35;1181;561;620
Šiauliai c. mun.;2016;36;1175;538;637
Šiauliai c. mun.;2016;37;1147;553;594
Šiauliai c. mun.;2016;38;1202;582;620
Šiauliai c. mun.;2016;39;1278;626;652
Šiauliai c. mun.;2016;40;1291;589;702
Šiauliai c. mun.;2016;41;1283;619;664
Šiauliai c. mun.;2016;42;1381;632;749
Šiauliai c. mun.;2016;43;1394;649;745
Šiauliai c. mun.;2016;44;1460;673;787
Šiauliai c. mun.;2016;45;1448;669;779
Šiauliai c. mun.;2016;46;1396;635;761
Šiauliai c. mun.;2016;47;1426;644;782
Šiauliai c. mun.;2016;48;1451;674;777
Šiauliai c. mun.;2016;49;1511;673;838
Šiauliai c. mun.;2016;50;1534;694;840
Šiauliai c. mun.;2016;51;1571;671;900
Šiauliai c. mun.;2016;52;1597;702;895
Šiauliai c. mun.;2016;53;1671;705;966
Šiauliai c. mun.;2016;54;1819;804;1015
Šiauliai c. mun.;2016;55;1832;759;1073
Šiauliai c. mun.;2016;56;1732;744;988
Šiauliai c. mun.;2016;57;1752;770;982
Šiauliai c. mun.;2016;58;1586;655;931
Šiauliai c. mun.;2016;59;1433;621;812
Šiauliai c. mun.;2016;60;1380;560;820
Šiauliai c. mun.;2016;61;1305;540;765
Šiauliai c. mun.;2016;62;1190;444;746
Šiauliai c. mun.;2016;63;1131;453;678
Šiauliai c. mun.;2016;64;1165;455;710
Šiauliai c. mun.;2016;65;1141;413;728
Šiauliai c. mun.;2016;66;1185;433;752
Šiauliai c. mun.;2016;67;947;335;612
Šiauliai c. mun.;2016;68;973;332;641
Šiauliai c. mun.;2016;69;936;332;604
Šiauliai c. mun.;2016;70;1025;347;678
Šiauliai c. mun.;2016;71;803;268;535
Šiauliai c. mun.;2016;72;921;321;600
Šiauliai c. mun.;2016;73;1011;373;638
Šiauliai c. mun.;2016;74;951;329;622
Šiauliai c. mun.;2016;75;849;273;576
Šiauliai c. mun.;2016;76;870;271;599
Šiauliai c. mun.;2016;77;845;263;582
Šiauliai c. mun.;2016;78;875;263;612
Šiauliai c. mun.;2016;79;771;228;543
Šiauliai c. mun.;2016;80;711;198;513
Šiauliai c. mun.;2016;81;597;151;446
Šiauliai c. mun.;2016;82;629;187;442
Šiauliai c. mun.;2016;83;590;162;428
Šiauliai c. mun.;2016;84;499;135;364
Šiauliai c. mun.;2016;85;2382;589;1793
Šiauliai c. mun.;2017;-1;101214;44801;56413
Šiauliai c. mun.;2017;0;1122;574;548
Šiauliai c. mun.;2017;1;1155;604;551
Šiauliai c. mun.;2017;2;1114;571;543
Šiauliai c. mun.;2017;3;1067;532;535
Šiauliai c. mun.;2017;4;1127;585;542
Šiauliai c. mun.;2017;5;1117;570;547
Šiauliai c. mun.;2017;6;1108;565;543
Šiauliai c. mun.;2017;7;1099;550;549
Šiauliai c. mun.;2017;8;968;491;477
Šiauliai c. mun.;2017;9;858;407;451
Šiauliai c. mun.;2017;10;795;414;381
Šiauliai c. mun.;2017;11;814;391;423
Šiauliai c. mun.;2017;12;847;407;440
Šiauliai c. mun.;2017;13;828;442;386
Šiauliai c. mun.;2017;14;815;420;395
Šiauliai c. mun.;2017;15;819;412;407
Šiauliai c. mun.;2017;16;925;465;460
Šiauliai c. mun.;2017;17;950;488;462
Šiauliai c. mun.;2017;18;1045;524;521
Šiauliai c. mun.;2017;19;1102;547;555
Šiauliai c. mun.;2017;20;1107;545;562
Šiauliai c. mun.;2017;21;1132;555;577
Šiauliai c. mun.;2017;22;1160;610;550
Šiauliai c. mun.;2017;23;1393;683;710
Šiauliai c. mun.;2017;24;1404;691;713
Šiauliai c. mun.;2017;25;1390;684;706
Šiauliai c. mun.;2017;26;1414;649;765
Šiauliai c. mun.;2017;27;1282;592;690
Šiauliai c. mun.;2017;28;1374;690;684
Šiauliai c. mun.;2017;29;1484;719;765
Šiauliai c. mun.;2017;30;1371;687;684
Šiauliai c. mun.;2017;31;1383;691;692
Šiauliai c. mun.;2017;32;1404;662;742
Šiauliai c. mun.;2017;33;1255;627;628
Šiauliai c. mun.;2017;34;1222;616;606
Šiauliai c. mun.;2017;35;1151;589;562
Šiauliai c. mun.;2017;36;1147;550;597
Šiauliai c. mun.;2017;37;1137;527;610
Šiauliai c. mun.;2017;38;1137;557;580
Šiauliai c. mun.;2017;39;1174;579;595
Šiauliai c. mun.;2017;40;1279;650;629
Šiauliai c. mun.;2017;41;1272;598;674
Šiauliai c. mun.;2017;42;1277;631;646
Šiauliai c. mun.;2017;43;1392;647;745
Šiauliai c. mun.;2017;44;1391;672;719
Šiauliai c. mun.;2017;45;1428;671;757
Šiauliai c. mun.;2017;46;1451;686;765
Šiauliai c. mun.;2017;47;1396;654;742
Šiauliai c. mun.;2017;48;1399;633;766
Šiauliai c. mun.;2017;49;1456;686;770
Šiauliai c. mun.;2017;50;1490;667;823
Šiauliai c. mun.;2017;51;1527;698;829
Šiauliai c. mun.;2017;52;1551;673;878
Šiauliai c. mun.;2017;53;1577;701;876
Šiauliai c. mun.;2017;54;1648;693;955
Šiauliai c. mun.;2017;55;1798;795;1003
Šiauliai c. mun.;2017;56;1797;737;1060
Šiauliai c. mun.;2017;57;1693;720;973
Šiauliai c. mun.;2017;58;1718;752;966
Šiauliai c. mun.;2017;59;1545;636;909
Šiauliai c. mun.;2017;60;1408;610;798
Šiauliai c. mun.;2017;61;1351;540;811
Šiauliai c. mun.;2017;62;1283;525;758
Šiauliai c. mun.;2017;63;1155;423;732
Šiauliai c. mun.;2017;64;1093;425;668
Šiauliai c. mun.;2017;65;1136;438;698
Šiauliai c. mun.;2017;66;1114;394;720
Šiauliai c. mun.;2017;67;1153;413;740
Šiauliai c. mun.;2017;68;915;311;604
Šiauliai c. mun.;2017;69;947;320;627
Šiauliai c. mun.;2017;70;909;319;590
Šiauliai c. mun.;2017;71;993;333;660
Šiauliai c. mun.;2017;72;780;255;525
Šiauliai c. mun.;2017;73;906;313;593
Šiauliai c. mun.;2017;74;982;358;624
Šiauliai c. mun.;2017;75;914;310;604
Šiauliai c. mun.;2017;76;825;254;571
Šiauliai c. mun.;2017;77;837;249;588
Šiauliai c. mun.;2017;78;819;253;566
Šiauliai c. mun.;2017;79;841;250;591
Šiauliai c. mun.;2017;80;731;207;524
Šiauliai c. mun.;2017;81;659;177;482
Šiauliai c. mun.;2017;82;555;135;420
Šiauliai c. mun.;2017;83;579;167;412
Šiauliai c. mun.;2017;84;556;147;409
Šiauliai c. mun.;2017;85;2492;613;1879
Šiauliai c. mun.;2018;-1;100575;45457;55118
Šiauliai c. mun.;2018;0;1101;546;555
Šiauliai c. mun.;2018;1;1145;589;556
Šiauliai c. mun.;2018;2;1166;610;556
Šiauliai c. mun.;2018;3;1094;559;535
Šiauliai c. mun.;2018;4;1039;519;520
Šiauliai c. mun.;2018;5;1094;559;535
Šiauliai c. mun.;2018;6;1063;539;524
Šiauliai c. mun.;2018;7;1059;543;516
Šiauliai c. mun.;2018;8;1022;510;512
Šiauliai c. mun.;2018;9;919;459;460
Šiauliai c. mun.;2018;10;831;387;444
Šiauliai c. mun.;2018;11;759;396;363
Šiauliai c. mun.;2018;12;810;390;420
Šiauliai c. mun.;2018;13;830;403;427
Šiauliai c. mun.;2018;14;813;430;383
Šiauliai c. mun.;2018;15;798;411;387
Šiauliai c. mun.;2018;16;796;395;401
Šiauliai c. mun.;2018;17;909;459;450
Šiauliai c. mun.;2018;18;937;479;458
Šiauliai c. mun.;2018;19;958;476;482
Šiauliai c. mun.;2018;20;1042;512;530
Šiauliai c. mun.;2018;21;1052;518;534
Šiauliai c. mun.;2018;22;1077;518;559
Šiauliai c. mun.;2018;23;1064;561;503
Šiauliai c. mun.;2018;24;1303;645;658
Šiauliai c. mun.;2018;25;1353;676;677
Šiauliai c. mun.;2018;26;1344;668;676
Šiauliai c. mun.;2018;27;1389;658;731
Šiauliai c. mun.;2018;28;1265;602;663
Šiauliai c. mun.;2018;29;1387;717;670
Šiauliai c. mun.;2018;30;1477;741;736
Šiauliai c. mun.;2018;31;1396;746;650
Šiauliai c. mun.;2018;32;1366;725;641
Šiauliai c. mun.;2018;33;1413;708;705
Šiauliai c. mun.;2018;34;1284;672;612
Šiauliai c. mun.;2018;35;1234;654;580
Šiauliai c. mun.;2018;36;1185;638;547
Šiauliai c. mun.;2018;37;1192;607;585
Šiauliai c. mun.;2018;38;1183;586;597
Šiauliai c. mun.;2018;39;1183;622;561
Šiauliai c. mun.;2018;40;1231;645;586
Šiauliai c. mun.;2018;41;1320;705;615
Šiauliai c. mun.;2018;42;1322;659;663
Šiauliai c. mun.;2018;43;1301;679;622
Šiauliai c. mun.;2018;44;1415;697;718
Šiauliai c. mun.;2018;45;1443;745;698
Šiauliai c. mun.;2018;46;1473;730;743
Šiauliai c. mun.;2018;47;1493;741;752
Šiauliai c. mun.;2018;48;1436;705;731
Šiauliai c. mun.;2018;49;1412;668;744
Šiauliai c. mun.;2018;50;1454;703;751
Šiauliai c. mun.;2018;51;1492;691;801
Šiauliai c. mun.;2018;52;1534;720;814
Šiauliai c. mun.;2018;53;1542;687;855
Šiauliai c. mun.;2018;54;1568;705;863
Šiauliai c. mun.;2018;55;1625;690;935
Šiauliai c. mun.;2018;56;1771;795;976
Šiauliai c. mun.;2018;57;1773;730;1043
Šiauliai c. mun.;2018;58;1671;707;964
Šiauliai c. mun.;2018;59;1679;731;948
Šiauliai c. mun.;2018;60;1518;614;904
Šiauliai c. mun.;2018;61;1375;594;781
Šiauliai c. mun.;2018;62;1339;528;811
Šiauliai c. mun.;2018;63;1278;521;757
Šiauliai c. mun.;2018;64;1123;405;718
Šiauliai c. mun.;2018;65;1064;407;657
Šiauliai c. mun.;2018;66;1108;422;686
Šiauliai c. mun.;2018;67;1095;382;713
Šiauliai c. mun.;2018;68;1128;397;731
Šiauliai c. mun.;2018;69;886;302;584
Šiauliai c. mun.;2018;70;918;300;618
Šiauliai c. mun.;2018;71;883;307;576
Šiauliai c. mun.;2018;72;977;330;647
Šiauliai c. mun.;2018;73;753;242;511
Šiauliai c. mun.;2018;74;881;301;580
Šiauliai c. mun.;2018;75;955;338;617
Šiauliai c. mun.;2018;76;885;297;588
Šiauliai c. mun.;2018;77;794;239;555
Šiauliai c. mun.;2018;78;800;234;566
Šiauliai c. mun.;2018;79;771;233;538
Šiauliai c. mun.;2018;80;792;233;559
Šiauliai c. mun.;2018;81;686;192;494
Šiauliai c. mun.;2018;82;625;165;460
Šiauliai c. mun.;2018;83;514;121;393
Šiauliai c. mun.;2018;84;526;147;379
Šiauliai c. mun.;2018;85;2614;640;1974
Šiauliai county;2001;-1;370444;173631;196813
Šiauliai county;2001;0;3539;1841;1698
Šiauliai county;2001;1;3853;1988;1865
Šiauliai county;2001;2;3975;2092;1883
Šiauliai county;2001;3;4135;2062;2073
Šiauliai county;2001;4;4328;2299;2029
Šiauliai county;2001;5;4392;2214;2178
Šiauliai county;2001;6;4588;2352;2236
Šiauliai county;2001;7;5324;2723;2601
Šiauliai county;2001;8;6150;3073;3077
Šiauliai county;2001;9;6012;3116;2896
Šiauliai county;2001;10;6007;3032;2975
Šiauliai county;2001;11;5929;2972;2957
Šiauliai county;2001;12;5896;3031;2865
Šiauliai county;2001;13;6245;3131;3114
Šiauliai county;2001;14;6373;3362;3011
Šiauliai county;2001;15;6314;3106;3208
Šiauliai county;2001;16;6261;3189;3072
Šiauliai county;2001;17;6027;3094;2933
Šiauliai county;2001;18;5226;2678;2548
Šiauliai county;2001;19;4778;2458;2320
Šiauliai county;2001;20;4724;2439;2285
Šiauliai county;2001;21;4603;2378;2225
Šiauliai county;2001;22;4553;2334;2219
Šiauliai county;2001;23;4556;2287;2269
Šiauliai county;2001;24;4668;2389;2279
Šiauliai county;2001;25;4758;2378;2380
Šiauliai county;2001;26;4712;2346;2366
Šiauliai county;2001;27;4888;2424;2464
Šiauliai county;2001;28;5148;2544;2604
Šiauliai county;2001;29;5366;2635;2731
Šiauliai county;2001;30;5431;2717;2714
Šiauliai county;2001;31;5217;2578;2639
Šiauliai county;2001;32;5455;2690;2765
Šiauliai county;2001;33;5396;2672;2724
Šiauliai county;2001;34;5431;2714;2717
Šiauliai county;2001;35;5438;2673;2765
Šiauliai county;2001;36;5583;2714;2869
Šiauliai county;2001;37;5657;2801;2856
Šiauliai county;2001;38;5832;2831;3001
Šiauliai county;2001;39;6085;3028;3057
Šiauliai county;2001;40;6018;2845;3173
Šiauliai county;2001;41;5896;2891;3005
Šiauliai county;2001;42;5813;2891;2922
Šiauliai county;2001;43;5361;2614;2747
Šiauliai county;2001;44;5020;2513;2507
Šiauliai county;2001;45;4781;2315;2466
Šiauliai county;2001;46;4637;2249;2388
Šiauliai county;2001;47;4173;1966;2207
Šiauliai county;2001;48;4329;2070;2259
Šiauliai county;2001;49;4486;2153;2333
Šiauliai county;2001;50;4436;2018;2418
Šiauliai county;2001;51;4200;1960;2240
Šiauliai county;2001;52;3842;1781;2061
Šiauliai county;2001;53;3746;1723;2023
Šiauliai county;2001;54;3575;1607;1968
Šiauliai county;2001;55;4023;1780;2243
Šiauliai county;2001;56;3356;1534;1822
Šiauliai county;2001;57;3985;1771;2214
Šiauliai county;2001;58;4467;1950;2517
Šiauliai county;2001;59;4202;1825;2377
Šiauliai county;2001;60;3760;1623;2137
Šiauliai county;2001;61;3811;1600;2211
Šiauliai county;2001;62;3853;1636;2217
Šiauliai county;2001;63;3836;1551;2285
Šiauliai county;2001;64;3952;1589;2363
Šiauliai county;2001;65;3731;1459;2272
Šiauliai county;2001;66;3576;1348;2228
Šiauliai county;2001;67;3659;1460;2199
Šiauliai county;2001;68;3566;1360;2206
Šiauliai county;2001;69;3369;1308;2061
Šiauliai county;2001;70;3220;1193;2027
Šiauliai county;2001;71;3035;1123;1912
Šiauliai county;2001;72;3246;1156;2090
Šiauliai county;2001;73;2888;1045;1843
Šiauliai county;2001;74;2543;753;1790
Šiauliai county;2001;75;2484;772;1712
Šiauliai county;2001;76;2305;715;1590
Šiauliai county;2001;77;2209;657;1552
Šiauliai county;2001;78;1862;612;1250
Šiauliai county;2001;79;1655;493;1162
Šiauliai county;2001;80;1455;406;1049
Šiauliai county;2001;81;1051;298;753
Šiauliai county;2001;82;747;178;569
Šiauliai county;2001;83;728;223;505
Šiauliai county;2001;84;666;192;474
Šiauliai county;2001;85;4038;1040;2998
Šiauliai county;2002;-1;366330;171284;195046
Šiauliai county;2002;0;3275;1671;1604
Šiauliai county;2002;1;3519;1833;1686
Šiauliai county;2002;2;3828;1969;1859
Šiauliai county;2002;3;3942;2071;1871
Šiauliai county;2002;4;4124;2053;2071
Šiauliai county;2002;5;4286;2276;2010
Šiauliai county;2002;6;4370;2197;2173
Šiauliai county;2002;7;4562;2331;2231
Šiauliai county;2002;8;5281;2703;2578
Šiauliai county;2002;9;6093;3030;3063
Šiauliai county;2002;10;5963;3091;2872
Šiauliai county;2002;11;5948;2991;2957
Šiauliai county;2002;12;5842;2921;2921
Šiauliai county;2002;13;5785;2959;2826
Šiauliai county;2002;14;6158;3075;3083
Šiauliai county;2002;15;6278;3292;2986
Šiauliai county;2002;16;6233;3061;3172
Šiauliai county;2002;17;6165;3126;3039
Šiauliai county;2002;18;5918;3033;2885
Šiauliai county;2002;19;5084;2595;2489
Šiauliai county;2002;20;4686;2400;2286
Šiauliai county;2002;21;4617;2375;2242
Šiauliai county;2002;22;4508;2328;2180
Šiauliai county;2002;23;4461;2294;2167
Šiauliai county;2002;24;4466;2228;2238
Šiauliai county;2002;25;4604;2357;2247
Šiauliai county;2002;26;4656;2317;2339
Šiauliai county;2002;27;4624;2275;2349
Šiauliai county;2002;28;4805;2353;2452
Šiauliai county;2002;29;5036;2475;2561
Šiauliai county;2002;30;5256;2578;2678
Šiauliai county;2002;31;5295;2647;2648
Šiauliai county;2002;32;5112;2512;2600
Šiauliai county;2002;33;5367;2631;2736
Šiauliai county;2002;34;5296;2610;2686
Šiauliai county;2002;35;5333;2644;2689
Šiauliai county;2002;36;5360;2631;2729
Šiauliai county;2002;37;5483;2654;2829
Šiauliai county;2002;38;5537;2720;2817
Šiauliai county;2002;39;5714;2752;2962
Šiauliai county;2002;40;5964;2951;3013
Šiauliai county;2002;41;5949;2807;3142
Šiauliai county;2002;42;5818;2851;2967
Šiauliai county;2002;43;5758;2866;2892
Šiauliai county;2002;44;5295;2588;2707
Šiauliai county;2002;45;4907;2447;2460
Šiauliai county;2002;46;4698;2265;2433
Šiauliai county;2002;47;4612;2236;2376
Šiauliai county;2002;48;4066;1905;2161
Šiauliai county;2002;49;4233;2016;2217
Šiauliai county;2002;50;4416;2098;2318
Šiauliai county;2002;51;4346;1965;2381
Šiauliai county;2002;52;4146;1920;2226
Šiauliai county;2002;53;3779;1753;2026
Šiauliai county;2002;54;3680;1693;1987
Šiauliai county;2002;55;3485;1565;1920
Šiauliai county;2002;56;3919;1723;2196
Šiauliai county;2002;57;3275;1490;1785
Šiauliai county;2002;58;3879;1717;2162
Šiauliai county;2002;59;4358;1887;2471
Šiauliai county;2002;60;4130;1774;2356
Šiauliai county;2002;61;3705;1588;2117
Šiauliai county;2002;62;3769;1569;2200
Šiauliai county;2002;63;3803;1594;2209
Šiauliai county;2002;64;3784;1512;2272
Šiauliai county;2002;65;3887;1557;2330
Šiauliai county;2002;66;3679;1432;2247
Šiauliai county;2002;67;3508;1324;2184
Šiauliai county;2002;68;3592;1417;2175
Šiauliai county;2002;69;3479;1306;2173
Šiauliai county;2002;70;3316;1280;2036
Šiauliai county;2002;71;3142;1140;2002
Šiauliai county;2002;72;2950;1074;1876
Šiauliai county;2002;73;3170;1124;2046
Šiauliai county;2002;74;2798;1006;1792
Šiauliai county;2002;75;2497;730;1767
Šiauliai county;2002;76;2387;729;1658
Šiauliai county;2002;77;2192;659;1533
Šiauliai county;2002;78;2143;629;1514
Šiauliai county;2002;79;1774;567;1207
Šiauliai county;2002;80;1536;445;1091
Šiauliai county;2002;81;1362;377;985
Šiauliai county;2002;82;967;274;693
Šiauliai county;2002;83;685;169;516
Šiauliai county;2002;84;664;200;464
Šiauliai county;2002;85;3958;1006;2952
Šiauliai county;2003;-1;362783;169378;193405
Šiauliai county;2003;0;3130;1611;1519
Šiauliai county;2003;1;3247;1653;1594
Šiauliai county;2003;2;3499;1814;1685
Šiauliai county;2003;3;3799;1950;1849
Šiauliai county;2003;4;3927;2070;1857
Šiauliai county;2003;5;4112;2043;2069
Šiauliai county;2003;6;4260;2263;1997
Šiauliai county;2003;7;4353;2192;2161
Šiauliai county;2003;8;4547;2319;2228
Šiauliai county;2003;9;5264;2690;2574
Šiauliai county;2003;10;6052;3021;3031
Šiauliai county;2003;11;5914;3067;2847
Šiauliai county;2003;12;5857;2937;2920
Šiauliai county;2003;13;5744;2872;2872
Šiauliai county;2003;14;5698;2895;2803
Šiauliai county;2003;15;6040;3008;3032
Šiauliai county;2003;16;6167;3232;2935
Šiauliai county;2003;17;6125;3002;3123
Šiauliai county;2003;18;6076;3079;2997
Šiauliai county;2003;19;5832;2986;2846
Šiauliai county;2003;20;5005;2560;2445
Šiauliai county;2003;21;4608;2364;2244
Šiauliai county;2003;22;4556;2348;2208
Šiauliai county;2003;23;4440;2293;2147
Šiauliai county;2003;24;4407;2263;2144
Šiauliai county;2003;25;4427;2213;2214
Šiauliai county;2003;26;4527;2325;2202
Šiauliai county;2003;27;4590;2269;2321
Šiauliai county;2003;28;4555;2233;2322
Šiauliai county;2003;29;4721;2319;2402
Šiauliai county;2003;30;4975;2448;2527
Šiauliai county;2003;31;5172;2531;2641
Šiauliai county;2003;32;5259;2628;2631
Šiauliai county;2003;33;5049;2479;2570
Šiauliai county;2003;34;5306;2595;2711
Šiauliai county;2003;35;5219;2575;2644
Šiauliai county;2003;36;5257;2612;2645
Šiauliai county;2003;37;5281;2584;2697
Šiauliai county;2003;38;5397;2606;2791
Šiauliai county;2003;39;5463;2680;2783
Šiauliai county;2003;40;5635;2711;2924
Šiauliai county;2003;41;5878;2899;2979
Šiauliai county;2003;42;5879;2755;3124
Šiauliai county;2003;43;5759;2820;2939
Šiauliai county;2003;44;5713;2841;2872
Šiauliai county;2003;45;5241;2556;2685
Šiauliai county;2003;46;4868;2421;2447
Šiauliai county;2003;47;4636;2229;2407
Šiauliai county;2003;48;4569;2207;2362
Šiauliai county;2003;49;4013;1870;2143
Šiauliai county;2003;50;4185;1984;2201
Šiauliai county;2003;51;4340;2056;2284
Šiauliai county;2003;52;4289;1928;2361
Šiauliai county;2003;53;4119;1910;2209
Šiauliai county;2003;54;3726;1712;2014
Šiauliai county;2003;55;3630;1657;1973
Šiauliai county;2003;56;3430;1531;1899
Šiauliai county;2003;57;3856;1683;2173
Šiauliai county;2003;58;3199;1443;1756
Šiauliai county;2003;59;3807;1666;2141
Šiauliai county;2003;60;4264;1825;2439
Šiauliai county;2003;61;4071;1740;2331
Šiauliai county;2003;62;3652;1549;2103
Šiauliai county;2003;63;3706;1529;2177
Šiauliai county;2003;64;3757;1567;2190
Šiauliai county;2003;65;3752;1485;2267
Šiauliai county;2003;66;3839;1516;2323
Šiauliai county;2003;67;3619;1395;2224
Šiauliai county;2003;68;3410;1251;2159
Šiauliai county;2003;69;3503;1352;2151
Šiauliai county;2003;70;3395;1241;2154
Šiauliai county;2003;71;3217;1224;1993
Šiauliai county;2003;72;3054;1086;1968
Šiauliai county;2003;73;2864;1018;1846
Šiauliai county;2003;74;3061;1063;1998
Šiauliai county;2003;75;2681;946;1735
Šiauliai county;2003;76;2384;670;1714
Šiauliai county;2003;77;2264;656;1608
Šiauliai county;2003;78;2066;612;1454
Šiauliai county;2003;79;2008;568;1440
Šiauliai county;2003;80;1643;499;1144
Šiauliai county;2003;81;1425;396;1029
Šiauliai county;2003;82;1220;322;898
Šiauliai county;2003;83;869;233;636
Šiauliai county;2003;84;606;144;462
Šiauliai county;2003;85;3824;983;2841
Šiauliai county;2004;-1;357441;166629;190812
Šiauliai county;2004;0;3134;1623;1511
Šiauliai county;2004;1;3098;1596;1502
Šiauliai county;2004;2;3210;1632;1578
Šiauliai county;2004;3;3462;1788;1674
Šiauliai county;2004;4;3770;1933;1837
Šiauliai county;2004;5;3907;2056;1851
Šiauliai county;2004;6;4071;2019;2052
Šiauliai county;2004;7;4236;2247;1989
Šiauliai county;2004;8;4328;2179;2149
Šiauliai county;2004;9;4517;2308;2209
Šiauliai county;2004;10;5234;2668;2566
Šiauliai county;2004;11;5989;2998;2991
Šiauliai county;2004;12;5828;3015;2813
Šiauliai county;2004;13;5769;2901;2868
Šiauliai county;2004;14;5630;2821;2809
Šiauliai county;2004;15;5594;2854;2740
Šiauliai county;2004;16;5923;2954;2969
Šiauliai county;2004;17;6049;3178;2871
Šiauliai county;2004;18;5977;2936;3041
Šiauliai county;2004;19;5917;3004;2913
Šiauliai county;2004;20;5702;2917;2785
Šiauliai county;2004;21;4865;2491;2374
Šiauliai county;2004;22;4468;2298;2170
Šiauliai county;2004;23;4425;2263;2162
Šiauliai county;2004;24;4330;2239;2091
Šiauliai county;2004;25;4203;2171;2032
Šiauliai county;2004;26;4268;2119;2149
Šiauliai county;2004;27;4379;2242;2137
Šiauliai county;2004;28;4469;2203;2266
Šiauliai county;2004;29;4444;2183;2261
Šiauliai county;2004;30;4596;2239;2357
Šiauliai county;2004;31;4864;2386;2478
Šiauliai county;2004;32;5064;2474;2590
Šiauliai county;2004;33;5176;2584;2592
Šiauliai county;2004;34;4941;2422;2519
Šiauliai county;2004;35;5200;2547;2653
Šiauliai county;2004;36;5135;2539;2596
Šiauliai county;2004;37;5158;2561;2597
Šiauliai county;2004;38;5188;2537;2651
Šiauliai county;2004;39;5288;2559;2729
Šiauliai county;2004;40;5353;2628;2725
Šiauliai county;2004;41;5525;2661;2864
Šiauliai county;2004;42;5772;2852;2920
Šiauliai county;2004;43;5785;2707;3078
Šiauliai county;2004;44;5651;2751;2900
Šiauliai county;2004;45;5634;2805;2829
Šiauliai county;2004;46;5151;2512;2639
Šiauliai county;2004;47;4787;2371;2416
Šiauliai county;2004;48;4565;2183;2382
Šiauliai county;2004;49;4501;2169;2332
Šiauliai county;2004;50;3931;1823;2108
Šiauliai county;2004;51;4116;1945;2171
Šiauliai county;2004;52;4260;2011;2249
Šiauliai county;2004;53;4215;1883;2332
Šiauliai county;2004;54;4061;1874;2187
Šiauliai county;2004;55;3670;1675;1995
Šiauliai county;2004;56;3564;1625;1939
Šiauliai county;2004;57;3370;1501;1869
Šiauliai county;2004;58;3798;1643;2155
Šiauliai county;2004;59;3132;1394;1738
Šiauliai county;2004;60;3719;1609;2110
Šiauliai county;2004;61;4154;1766;2388
Šiauliai county;2004;62;4003;1702;2301
Šiauliai county;2004;63;3595;1518;2077
Šiauliai county;2004;64;3652;1484;2168
Šiauliai county;2004;65;3710;1518;2192
Šiauliai county;2004;66;3681;1429;2252
Šiauliai county;2004;67;3770;1454;2316
Šiauliai county;2004;68;3529;1339;2190
Šiauliai county;2004;69;3324;1198;2126
Šiauliai county;2004;70;3399;1289;2110
Šiauliai county;2004;71;3281;1167;2114
Šiauliai county;2004;72;3106;1159;1947
Šiauliai county;2004;73;2962;1028;1934
Šiauliai county;2004;74;2755;958;1797
Šiauliai county;2004;75;2929;984;1945
Šiauliai county;2004;76;2549;885;1664
Šiauliai county;2004;77;2276;623;1653
Šiauliai county;2004;78;2154;600;1554
Šiauliai county;2004;79;1930;555;1375
Šiauliai county;2004;80;1890;518;1372
Šiauliai county;2004;81;1524;439;1085
Šiauliai county;2004;82;1330;356;974
Šiauliai county;2004;83;1109;274;835
Šiauliai county;2004;84;766;187;579
Šiauliai county;2004;85;3697;893;2804
Šiauliai county;2005;-1;350938;163306;187632
Šiauliai county;2005;0;3094;1537;1557
Šiauliai county;2005;1;3077;1586;1491
Šiauliai county;2005;2;3070;1585;1485
Šiauliai county;2005;3;3178;1622;1556
Šiauliai county;2005;4;3426;1767;1659
Šiauliai county;2005;5;3719;1910;1809
Šiauliai county;2005;6;3875;2040;1835
Šiauliai county;2005;7;4039;2012;2027
Šiauliai county;2005;8;4197;2226;1971
Šiauliai county;2005;9;4300;2161;2139
Šiauliai county;2005;10;4484;2292;2192
Šiauliai county;2005;11;5200;2643;2557
Šiauliai county;2005;12;5926;2961;2965
Šiauliai county;2005;13;5772;2984;2788
Šiauliai county;2005;14;5680;2858;2822
Šiauliai county;2005;15;5534;2763;2771
Šiauliai county;2005;16;5495;2799;2696
Šiauliai county;2005;17;5787;2883;2904
Šiauliai county;2005;18;5884;3079;2805
Šiauliai county;2005;19;5794;2846;2948
Šiauliai county;2005;20;5739;2918;2821
Šiauliai county;2005;21;5490;2815;2675
Šiauliai county;2005;22;4681;2411;2270
Šiauliai county;2005;23;4322;2234;2088
Šiauliai county;2005;24;4262;2179;2083
Šiauliai county;2005;25;4069;2125;1944
Šiauliai county;2005;26;4038;2078;1960
Šiauliai county;2005;27;4107;2027;2080
Šiauliai county;2005;28;4254;2183;2071
Šiauliai county;2005;29;4348;2130;2218
Šiauliai county;2005;30;4314;2114;2200
Šiauliai county;2005;31;4456;2154;2302
Šiauliai county;2005;32;4721;2299;2422
Šiauliai county;2005;33;4937;2407;2530
Šiauliai county;2005;34;5068;2531;2537
Šiauliai county;2005;35;4834;2362;2472
Šiauliai county;2005;36;5093;2508;2585
Šiauliai county;2005;37;5038;2474;2564
Šiauliai county;2005;38;5051;2498;2553
Šiauliai county;2005;39;5094;2493;2601
Šiauliai county;2005;40;5195;2506;2689
Šiauliai county;2005;41;5253;2567;2686
Šiauliai county;2005;42;5418;2605;2813
Šiauliai county;2005;43;5666;2789;2877
Šiauliai county;2005;44;5710;2674;3036
Šiauliai county;2005;45;5555;2709;2846
Šiauliai county;2005;46;5555;2757;2798
Šiauliai county;2005;47;5064;2454;2610
Šiauliai county;2005;48;4672;2302;2370
Šiauliai county;2005;49;4494;2138;2356
Šiauliai county;2005;50;4444;2131;2313
Šiauliai county;2005;51;3856;1779;2077
Šiauliai county;2005;52;4014;1883;2131
Šiauliai county;2005;53;4166;1957;2209
Šiauliai county;2005;54;4128;1838;2290
Šiauliai county;2005;55;3997;1830;2167
Šiauliai county;2005;56;3594;1626;1968
Šiauliai county;2005;57;3500;1582;1918
Šiauliai county;2005;58;3307;1462;1845
Šiauliai county;2005;59;3704;1590;2114
Šiauliai county;2005;60;3060;1342;1718
Šiauliai county;2005;61;3608;1540;2068
Šiauliai county;2005;62;4058;1709;2349
Šiauliai county;2005;63;3902;1637;2265
Šiauliai county;2005;64;3488;1458;2030
Šiauliai county;2005;65;3547;1422;2125
Šiauliai county;2005;66;3605;1461;2144
Šiauliai county;2005;67;3587;1381;2206
Šiauliai county;2005;68;3687;1401;2286
Šiauliai county;2005;69;3428;1279;2149
Šiauliai county;2005;70;3208;1121;2087
Šiauliai county;2005;71;3277;1225;2052
Šiauliai county;2005;72;3162;1104;2058
Šiauliai county;2005;73;2998;1099;1899
Šiauliai county;2005;74;2847;976;1871
Šiauliai county;2005;75;2623;889;1734
Šiauliai county;2005;76;2773;915;1858
Šiauliai county;2005;77;2393;808;1585
Šiauliai county;2005;78;2142;581;1561
Šiauliai county;2005;79;2036;551;1485
Šiauliai county;2005;80;1803;504;1299
Šiauliai county;2005;81;1736;474;1262
Šiauliai county;2005;82;1394;385;1009
Šiauliai county;2005;83;1187;300;887
Šiauliai county;2005;84;981;238;743
Šiauliai county;2005;85;3669;833;2836
Šiauliai county;2006;-1;341761;158492;183269
Šiauliai county;2006;0;2861;1406;1455
Šiauliai county;2006;1;3023;1491;1532
Šiauliai county;2006;2;3013;1545;1468
Šiauliai county;2006;3;3006;1552;1454
Šiauliai county;2006;4;3111;1586;1525
Šiauliai county;2006;5;3379;1738;1641
Šiauliai county;2006;6;3653;1879;1774
Šiauliai county;2006;7;3822;2006;1816
Šiauliai county;2006;8;3989;1986;2003
Šiauliai county;2006;9;4148;2206;1942
Šiauliai county;2006;10;4251;2144;2107
Šiauliai county;2006;11;4430;2262;2168
Šiauliai county;2006;12;5134;2617;2517
Šiauliai county;2006;13;5780;2887;2893
Šiauliai county;2006;14;5668;2929;2739
Šiauliai county;2006;15;5512;2774;2738
Šiauliai county;2006;16;5340;2655;2685
Šiauliai county;2006;17;5336;2707;2629
Šiauliai county;2006;18;5568;2759;2809
Šiauliai county;2006;19;5563;2896;2667
Šiauliai county;2006;20;5475;2686;2789
Šiauliai county;2006;21;5383;2734;2649
Šiauliai county;2006;22;5178;2670;2508
Šiauliai county;2006;23;4421;2267;2154
Šiauliai county;2006;24;4055;2104;1951
Šiauliai county;2006;25;3969;2033;1936
Šiauliai county;2006;26;3862;2012;1850
Šiauliai county;2006;27;3844;1978;1866
Šiauliai county;2006;28;3928;1930;1998
Šiauliai county;2006;29;4123;2111;2012
Šiauliai county;2006;30;4236;2074;2162
Šiauliai county;2006;31;4195;2058;2137
Šiauliai county;2006;32;4330;2085;2245
Šiauliai county;2006;33;4562;2208;2354
Šiauliai county;2006;34;4775;2309;2466
Šiauliai county;2006;35;4902;2439;2463
Šiauliai county;2006;36;4695;2278;2417
Šiauliai county;2006;37;4957;2429;2528
Šiauliai county;2006;38;4902;2383;2519
Šiauliai county;2006;39;4923;2423;2500
Šiauliai county;2006;40;4956;2406;2550
Šiauliai county;2006;41;5066;2425;2641
Šiauliai county;2006;42;5122;2491;2631
Šiauliai county;2006;43;5277;2527;2750
Šiauliai county;2006;44;5549;2710;2839
Šiauliai county;2006;45;5588;2605;2983
Šiauliai county;2006;46;5410;2621;2789
Šiauliai county;2006;47;5464;2696;2768
Šiauliai county;2006;48;4972;2401;2571
Šiauliai county;2006;49;4565;2243;2322
Šiauliai county;2006;50;4383;2074;2309
Šiauliai county;2006;51;4335;2063;2272
Šiauliai county;2006;52;3763;1725;2038
Šiauliai county;2006;53;3904;1820;2084
Šiauliai county;2006;54;4057;1890;2167
Šiauliai county;2006;55;4039;1795;2244
Šiauliai county;2006;56;3909;1773;2136
Šiauliai county;2006;57;3517;1582;1935
Šiauliai county;2006;58;3425;1532;1893
Šiauliai county;2006;59;3231;1419;1812
Šiauliai county;2006;60;3602;1533;2069
Šiauliai county;2006;61;2972;1281;1691
Šiauliai county;2006;62;3504;1468;2036
Šiauliai county;2006;63;3944;1643;2301
Šiauliai county;2006;64;3786;1573;2213
Šiauliai county;2006;65;3393;1401;1992
Šiauliai county;2006;66;3451;1363;2088
Šiauliai county;2006;67;3482;1397;2085
Šiauliai county;2006;68;3475;1317;2158
Šiauliai county;2006;69;3576;1335;2241
Šiauliai county;2006;70;3295;1193;2102
Šiauliai county;2006;71;3074;1051;2023
Šiauliai county;2006;72;3151;1160;1991
Šiauliai county;2006;73;3028;1034;1994
Šiauliai county;2006;74;2859;1020;1839
Šiauliai county;2006;75;2712;914;1798
Šiauliai county;2006;76;2498;814;1684
Šiauliai county;2006;77;2617;830;1787
Šiauliai county;2006;78;2240;740;1500
Šiauliai county;2006;79;2002;532;1470
Šiauliai county;2006;80;1871;500;1371
Šiauliai county;2006;81;1641;446;1195
Šiauliai county;2006;82;1575;430;1145
Šiauliai county;2006;83;1241;333;908
Šiauliai county;2006;84;1066;261;805
Šiauliai county;2006;85;3872;889;2983
Šiauliai county;2007;-1;335221;155145;180076
Šiauliai county;2007;0;2811;1414;1397
Šiauliai county;2007;1;2814;1383;1431
Šiauliai county;2007;2;2985;1478;1507
Šiauliai county;2007;3;2976;1521;1455
Šiauliai county;2007;4;2962;1533;1429
Šiauliai county;2007;5;3082;1566;1516
Šiauliai county;2007;6;3347;1715;1632
Šiauliai county;2007;7;3586;1842;1744
Šiauliai county;2007;8;3782;1978;1804
Šiauliai county;2007;9;3927;1955;1972
Šiauliai county;2007;10;4113;2183;1930
Šiauliai county;2007;11;4208;2128;2080
Šiauliai county;2007;12;4383;2243;2140
Šiauliai county;2007;13;5085;2590;2495
Šiauliai county;2007;14;5714;2854;2860
Šiauliai county;2007;15;5623;2909;2714
Šiauliai county;2007;16;5421;2734;2687
Šiauliai county;2007;17;5251;2608;2643
Šiauliai county;2007;18;5222;2651;2571
Šiauliai county;2007;19;5425;2689;2736
Šiauliai county;2007;20;5396;2800;2596
Šiauliai county;2007;21;5296;2583;2713
Šiauliai county;2007;22;5197;2632;2565
Šiauliai county;2007;23;4989;2563;2426
Šiauliai county;2007;24;4271;2178;2093
Šiauliai county;2007;25;3851;1996;1855
Šiauliai county;2007;26;3818;1947;1871
Šiauliai county;2007;27;3747;1948;1799
Šiauliai county;2007;28;3777;1947;1830
Šiauliai county;2007;29;3832;1875;1957
Šiauliai county;2007;30;4038;2067;1971
Šiauliai county;2007;31;4138;2020;2118
Šiauliai county;2007;32;4126;2009;2117
Šiauliai county;2007;33;4221;2031;2190
Šiauliai county;2007;34;4495;2158;2337
Šiauliai county;2007;35;4691;2267;2424
Šiauliai county;2007;36;4835;2410;2425
Šiauliai county;2007;37;4619;2244;2375
Šiauliai county;2007;38;4868;2390;2478
Šiauliai county;2007;39;4823;2348;2475
Šiauliai county;2007;40;4825;2360;2465
Šiauliai county;2007;41;4862;2361;2501
Šiauliai county;2007;42;4978;2373;2605
Šiauliai county;2007;43;5022;2433;2589
Šiauliai county;2007;44;5166;2465;2701
Šiauliai county;2007;45;5429;2642;2787
Šiauliai county;2007;46;5492;2547;2945
Šiauliai county;2007;47;5308;2564;2744
Šiauliai county;2007;48;5369;2643;2726
Šiauliai county;2007;49;4895;2357;2538
Šiauliai county;2007;50;4463;2180;2283
Šiauliai county;2007;51;4290;2015;2275
Šiauliai county;2007;52;4253;2018;2235
Šiauliai county;2007;53;3684;1678;2006
Šiauliai county;2007;54;3821;1758;2063
Šiauliai county;2007;55;3984;1854;2130
Šiauliai county;2007;56;3949;1732;2217
Šiauliai county;2007;57;3835;1718;2117
Šiauliai county;2007;58;3451;1540;1911
Šiauliai county;2007;59;3336;1469;1867
Šiauliai county;2007;60;3140;1347;1793
Šiauliai county;2007;61;3506;1474;2032
Šiauliai county;2007;62;2901;1239;1662
Šiauliai county;2007;63;3383;1393;1990
Šiauliai county;2007;64;3846;1580;2266
Šiauliai county;2007;65;3680;1510;2170
Šiauliai county;2007;66;3283;1326;1957
Šiauliai county;2007;67;3336;1299;2037
Šiauliai county;2007;68;3361;1322;2039
Šiauliai county;2007;69;3359;1258;2101
Šiauliai county;2007;70;3454;1267;2187
Šiauliai county;2007;71;3188;1137;2051
Šiauliai county;2007;72;2956;990;1966
Šiauliai county;2007;73;3009;1081;1928
Šiauliai county;2007;74;2883;956;1927
Šiauliai county;2007;75;2717;952;1765
Šiauliai county;2007;76;2587;857;1730
Šiauliai county;2007;77;2340;748;1592
Šiauliai county;2007;78;2452;770;1682
Šiauliai county;2007;79;2079;666;1413
Šiauliai county;2007;80;1853;472;1381
Šiauliai county;2007;81;1707;442;1265
Šiauliai county;2007;82;1496;394;1102
Šiauliai county;2007;83;1418;374;1044
Šiauliai county;2007;84;1092;285;807
Šiauliai county;2007;85;4038;912;3126
Šiauliai county;2008;-1;328699;151764;176935
Šiauliai county;2008;0;2908;1418;1490
Šiauliai county;2008;1;2756;1382;1374
Šiauliai county;2008;2;2768;1359;1409
Šiauliai county;2008;3;2933;1453;1480
Šiauliai county;2008;4;2931;1498;1433
Šiauliai county;2008;5;2905;1500;1405
Šiauliai county;2008;6;3014;1527;1487
Šiauliai county;2008;7;3295;1692;1603
Šiauliai county;2008;8;3526;1809;1717
Šiauliai county;2008;9;3743;1963;1780
Šiauliai county;2008;10;3894;1936;1958
Šiauliai county;2008;11;4078;2161;1917
Šiauliai county;2008;12;4177;2115;2062
Šiauliai county;2008;13;4338;2208;2130
Šiauliai county;2008;14;5041;2562;2479
Šiauliai county;2008;15;5649;2818;2831
Šiauliai county;2008;16;5552;2869;2683
Šiauliai county;2008;17;5346;2698;2648
Šiauliai county;2008;18;5152;2563;2589
Šiauliai county;2008;19;5101;2586;2515
Šiauliai county;2008;20;5289;2627;2662
Šiauliai county;2008;21;5238;2730;2508
Šiauliai county;2008;22;5117;2500;2617
Šiauliai county;2008;23;5044;2560;2484
Šiauliai county;2008;24;4846;2483;2363
Šiauliai county;2008;25;4104;2102;2002
Šiauliai county;2008;26;3661;1908;1753
Šiauliai county;2008;27;3664;1879;1785
Šiauliai county;2008;28;3623;1872;1751
Šiauliai county;2008;29;3613;1865;1748
Šiauliai county;2008;30;3721;1817;1904
Šiauliai county;2008;31;3919;2001;1918
Šiauliai county;2008;32;4063;1987;2076
Šiauliai county;2008;33;4048;1971;2077
Šiauliai county;2008;34;4150;1989;2161
Šiauliai county;2008;35;4395;2097;2298
Šiauliai county;2008;36;4616;2230;2386
Šiauliai county;2008;37;4724;2350;2374
Šiauliai county;2008;38;4528;2196;2332
Šiauliai county;2008;39;4782;2347;2435
Šiauliai county;2008;40;4728;2299;2429
Šiauliai county;2008;41;4752;2322;2430
Šiauliai county;2008;42;4786;2320;2466
Šiauliai county;2008;43;4876;2324;2552
Šiauliai county;2008;44;4927;2374;2553
Šiauliai county;2008;45;5059;2404;2655
Šiauliai county;2008;46;5349;2601;2748
Šiauliai county;2008;47;5407;2499;2908
Šiauliai county;2008;48;5220;2508;2712
Šiauliai county;2008;49;5282;2574;2708
Šiauliai county;2008;50;4795;2294;2501
Šiauliai county;2008;51;4376;2118;2258
Šiauliai county;2008;52;4190;1960;2230
Šiauliai county;2008;53;4170;1954;2216
Šiauliai county;2008;54;3594;1612;1982
Šiauliai county;2008;55;3738;1706;2032
Šiauliai county;2008;56;3880;1794;2086
Šiauliai county;2008;57;3848;1673;2175
Šiauliai county;2008;58;3732;1645;2087
Šiauliai county;2008;59;3364;1486;1878
Šiauliai county;2008;60;3237;1403;1834
Šiauliai county;2008;61;3069;1295;1774
Šiauliai county;2008;62;3413;1410;2003
Šiauliai county;2008;63;2814;1177;1637
Šiauliai county;2008;64;3279;1330;1949
Šiauliai county;2008;65;3752;1526;2226
Šiauliai county;2008;66;3573;1437;2136
Šiauliai county;2008;67;3171;1252;1919
Šiauliai county;2008;68;3217;1235;1982
Šiauliai county;2008;69;3258;1262;1996
Šiauliai county;2008;70;3243;1185;2058
Šiauliai county;2008;71;3325;1194;2131
Šiauliai county;2008;72;3058;1073;1985
Šiauliai county;2008;73;2822;928;1894
Šiauliai county;2008;74;2866;1008;1858
Šiauliai county;2008;75;2750;885;1865
Šiauliai county;2008;76;2559;875;1684
Šiauliai county;2008;77;2426;773;1653
Šiauliai county;2008;78;2188;683;1505
Šiauliai county;2008;79;2303;700;1603
Šiauliai county;2008;80;1926;596;1330
Šiauliai county;2008;81;1712;424;1288
Šiauliai county;2008;82;1547;392;1155
Šiauliai county;2008;83;1350;344;1006
Šiauliai county;2008;84;1238;311;927
Šiauliai county;2008;85;4278;971;3307
Šiauliai county;2009;-1;323353;149292;174061
Šiauliai county;2009;0;2965;1538;1427
Šiauliai county;2009;1;2855;1388;1467
Šiauliai county;2009;2;2714;1363;1351
Šiauliai county;2009;3;2719;1338;1381
Šiauliai county;2009;4;2896;1432;1464
Šiauliai county;2009;5;2884;1474;1410
Šiauliai county;2009;6;2863;1486;1377
Šiauliai county;2009;7;2986;1512;1474
Šiauliai county;2009;8;3272;1679;1593
Šiauliai county;2009;9;3494;1788;1706
Šiauliai county;2009;10;3701;1942;1759
Šiauliai county;2009;11;3856;1913;1943
Šiauliai county;2009;12;4051;2147;1904
Šiauliai county;2009;13;4139;2098;2041
Šiauliai county;2009;14;4316;2198;2118
Šiauliai county;2009;15;5008;2544;2464
Šiauliai county;2009;16;5613;2797;2816
Šiauliai county;2009;17;5509;2846;2663
Šiauliai county;2009;18;5277;2660;2617
Šiauliai county;2009;19;5086;2531;2555
Šiauliai county;2009;20;5015;2536;2479
Šiauliai county;2009;21;5164;2563;2601
Šiauliai county;2009;22;5124;2680;2444
Šiauliai county;2009;23;4963;2438;2525
Šiauliai county;2009;24;4852;2475;2377
Šiauliai county;2009;25;4661;2408;2253
Šiauliai county;2009;26;3915;2026;1889
Šiauliai county;2009;27;3506;1837;1669
Šiauliai county;2009;28;3499;1804;1695
Šiauliai county;2009;29;3501;1813;1688
Šiauliai county;2009;30;3503;1812;1691
Šiauliai county;2009;31;3610;1771;1839
Šiauliai county;2009;32;3809;1942;1867
Šiauliai county;2009;33;3979;1946;2033
Šiauliai county;2009;34;3980;1936;2044
Šiauliai county;2009;35;4071;1947;2124
Šiauliai county;2009;36;4309;2057;2252
Šiauliai county;2009;37;4547;2186;2361
Šiauliai county;2009;38;4656;2314;2342
Šiauliai county;2009;39;4453;2151;2302
Šiauliai county;2009;40;4714;2311;2403
Šiauliai county;2009;41;4660;2260;2400
Šiauliai county;2009;42;4690;2285;2405
Šiauliai county;2009;43;4711;2287;2424
Šiauliai county;2009;44;4817;2297;2520
Šiauliai county;2009;45;4848;2337;2511
Šiauliai county;2009;46;4980;2358;2622
Šiauliai county;2009;47;5267;2539;2728
Šiauliai county;2009;48;5314;2437;2877
Šiauliai county;2009;49;5124;2455;2669
Šiauliai county;2009;50;5202;2539;2663
Šiauliai county;2009;51;4730;2253;2477
Šiauliai county;2009;52;4296;2062;2234
Šiauliai county;2009;53;4122;1919;2203
Šiauliai county;2009;54;4105;1916;2189
Šiauliai county;2009;55;3506;1563;1943
Šiauliai county;2009;56;3655;1651;2004
Šiauliai county;2009;57;3799;1734;2065
Šiauliai county;2009;58;3773;1625;2148
Šiauliai county;2009;59;3662;1609;2053
Šiauliai county;2009;60;3288;1444;1844
Šiauliai county;2009;61;3170;1357;1813
Šiauliai county;2009;62;2996;1255;1741
Šiauliai county;2009;63;3327;1353;1974
Šiauliai county;2009;64;2744;1132;1612
Šiauliai county;2009;65;3189;1269;1920
Šiauliai county;2009;66;3650;1461;2189
Šiauliai county;2009;67;3490;1386;2104
Šiauliai county;2009;68;3082;1197;1885
Šiauliai county;2009;69;3117;1186;1931
Šiauliai county;2009;70;3169;1215;1954
Šiauliai county;2009;71;3132;1120;2012
Šiauliai county;2009;72;3226;1132;2094
Šiauliai county;2009;73;2941;1024;1917
Šiauliai county;2009;74;2706;864;1842
Šiauliai county;2009;75;2739;933;1806
Šiauliai county;2009;76;2625;833;1792
Šiauliai county;2009;77;2426;812;1614
Šiauliai county;2009;78;2272;703;1569
Šiauliai county;2009;79;2058;618;1440
Šiauliai county;2009;80;2127;632;1495
Šiauliai county;2009;81;1775;531;1244
Šiauliai county;2009;82;1557;378;1179
Šiauliai county;2009;83;1411;346;1065
Šiauliai county;2009;84;1217;305;912
Šiauliai county;2009;85;4623;1053;3570
Šiauliai county;2010;-1;316278;145729;170549
Šiauliai county;2010;0;2955;1523;1432
Šiauliai county;2010;1;2890;1502;1388
Šiauliai county;2010;2;2794;1344;1450
Šiauliai county;2010;3;2636;1322;1314
Šiauliai county;2010;4;2671;1313;1358
Šiauliai county;2010;5;2837;1408;1429
Šiauliai county;2010;6;2842;1467;1375
Šiauliai county;2010;7;2817;1465;1352
Šiauliai county;2010;8;2939;1488;1451
Šiauliai county;2010;9;3221;1659;1562
Šiauliai county;2010;10;3455;1767;1688
Šiauliai county;2010;11;3655;1915;1740
Šiauliai county;2010;12;3815;1886;1929
Šiauliai county;2010;13;4010;2121;1889
Šiauliai county;2010;14;4093;2074;2019
Šiauliai county;2010;15;4268;2174;2094
Šiauliai county;2010;16;4950;2519;2431
Šiauliai county;2010;17;5561;2761;2800
Šiauliai county;2010;18;5421;2799;2622
Šiauliai county;2010;19;5155;2590;2565
Šiauliai county;2010;20;4936;2458;2478
Šiauliai county;2010;21;4835;2462;2373
Šiauliai county;2010;22;4961;2461;2500
Šiauliai county;2010;23;4890;2559;2331
Šiauliai county;2010;24;4713;2327;2386
Šiauliai county;2010;25;4621;2371;2250
Šiauliai county;2010;26;4354;2252;2102
Šiauliai county;2010;27;3690;1908;1782
Šiauliai county;2010;28;3307;1743;1564
Šiauliai county;2010;29;3341;1719;1622
Šiauliai county;2010;30;3340;1725;1615
Šiauliai county;2010;31;3346;1720;1626
Šiauliai county;2010;32;3453;1700;1753
Šiauliai county;2010;33;3692;1882;1810
Šiauliai county;2010;34;3855;1888;1967
Šiauliai county;2010;35;3844;1865;1979
Šiauliai county;2010;36;3951;1889;2062
Šiauliai county;2010;37;4189;1991;2198
Šiauliai county;2010;38;4415;2099;2316
Šiauliai county;2010;39;4557;2247;2310
Šiauliai county;2010;40;4358;2087;2271
Šiauliai county;2010;41;4600;2235;2365
Šiauliai county;2010;42;4593;2213;2380
Šiauliai county;2010;43;4603;2234;2369
Šiauliai county;2010;44;4622;2229;2393
Šiauliai county;2010;45;4704;2233;2471
Šiauliai county;2010;46;4762;2283;2479
Šiauliai county;2010;47;4892;2301;2591
Šiauliai county;2010;48;5163;2473;2690
Šiauliai county;2010;49;5231;2384;2847
Šiauliai county;2010;50;5038;2400;2638
Šiauliai county;2010;51;5100;2467;2633
Šiauliai county;2010;52;4652;2207;2445
Šiauliai county;2010;53;4198;2005;2193
Šiauliai county;2010;54;4050;1871;2179
Šiauliai county;2010;55;4010;1859;2151
Šiauliai county;2010;56;3444;1519;1925
Šiauliai county;2010;57;3577;1606;1971
Šiauliai county;2010;58;3714;1687;2027
Šiauliai county;2010;59;3691;1581;2110
Šiauliai county;2010;60;3602;1567;2035
Šiauliai county;2010;61;3197;1389;1808
Šiauliai county;2010;62;3097;1306;1791
Šiauliai county;2010;63;2923;1205;1718
Šiauliai county;2010;64;3230;1290;1940
Šiauliai county;2010;65;2670;1089;1581
Šiauliai county;2010;66;3123;1231;1892
Šiauliai county;2010;67;3549;1394;2155
Šiauliai county;2010;68;3373;1308;2065
Šiauliai county;2010;69;2985;1142;1843
Šiauliai county;2010;70;3012;1129;1883
Šiauliai county;2010;71;3078;1161;1917
Šiauliai county;2010;72;3022;1060;1962
Šiauliai county;2010;73;3108;1080;2028
Šiauliai county;2010;74;2831;975;1856
Šiauliai county;2010;75;2578;813;1765
Šiauliai county;2010;76;2604;865;1739
Šiauliai county;2010;77;2487;759;1728
Šiauliai county;2010;78;2274;742;1532
Šiauliai county;2010;79;2126;640;1486
Šiauliai county;2010;80;1935;569;1366
Šiauliai county;2010;81;1968;560;1408
Šiauliai county;2010;82;1619;468;1151
Šiauliai county;2010;83;1416;335;1081
Šiauliai county;2010;84;1272;309;963
Šiauliai county;2010;85;4922;1106;3816
Šiauliai county;2011;-1;303110;139467;163643
Šiauliai county;2011;0;2639;1350;1289
Šiauliai county;2011;1;2828;1489;1339
Šiauliai county;2011;2;2782;1447;1335
Šiauliai county;2011;3;2581;1261;1320
Šiauliai county;2011;4;2529;1277;1252
Šiauliai county;2011;5;2568;1273;1295
Šiauliai county;2011;6;2770;1371;1399
Šiauliai county;2011;7;2810;1474;1336
Šiauliai county;2011;8;2766;1463;1303
Šiauliai county;2011;9;2930;1474;1456
Šiauliai county;2011;10;3148;1625;1523
Šiauliai county;2011;11;3439;1765;1674
Šiauliai county;2011;12;3616;1904;1712
Šiauliai county;2011;13;3761;1876;1885
Šiauliai county;2011;14;3990;2104;1886
Šiauliai county;2011;15;4082;2084;1998
Šiauliai county;2011;16;4241;2179;2062
Šiauliai county;2011;17;4946;2522;2424
Šiauliai county;2011;18;5373;2699;2674
Šiauliai county;2011;19;4705;2505;2200
Šiauliai county;2011;20;4315;2195;2120
Šiauliai county;2011;21;4061;2041;2020
Šiauliai county;2011;22;3990;2116;1874
Šiauliai county;2011;23;3946;2028;1918
Šiauliai county;2011;24;3792;2052;1740
Šiauliai county;2011;25;3627;1856;1771
Šiauliai county;2011;26;3461;1808;1653
Šiauliai county;2011;27;3325;1718;1607
Šiauliai county;2011;28;3086;1579;1507
Šiauliai county;2011;29;2986;1545;1441
Šiauliai county;2011;30;3129;1573;1556
Šiauliai county;2011;31;3159;1573;1586
Šiauliai county;2011;32;3113;1545;1568
Šiauliai county;2011;33;3310;1586;1724
Šiauliai county;2011;34;3516;1735;1781
Šiauliai county;2011;35;3645;1751;1894
Šiauliai county;2011;36;3699;1765;1934
Šiauliai county;2011;37;3866;1844;2022
Šiauliai county;2011;38;4172;1963;2209
Šiauliai county;2011;39;4279;2003;2276
Šiauliai county;2011;40;4505;2190;2315
Šiauliai county;2011;41;4285;2051;2234
Šiauliai county;2011;42;4602;2251;2351
Šiauliai county;2011;43;4532;2196;2336
Šiauliai county;2011;44;4576;2220;2356
Šiauliai county;2011;45;4573;2213;2360
Šiauliai county;2011;46;4706;2268;2438
Šiauliai county;2011;47;4679;2241;2438
Šiauliai county;2011;48;4882;2323;2559
Šiauliai county;2011;49;5148;2467;2681
Šiauliai county;2011;50;5198;2385;2813
Šiauliai county;2011;51;4985;2386;2599
Šiauliai county;2011;52;5041;2448;2593
Šiauliai county;2011;53;4567;2131;2436
Šiauliai county;2011;54;4191;2009;2182
Šiauliai county;2011;55;4013;1837;2176
Šiauliai county;2011;56;3939;1812;2127
Šiauliai county;2011;57;3481;1547;1934
Šiauliai county;2011;58;3585;1599;1986
Šiauliai county;2011;59;3690;1687;2003
Šiauliai county;2011;60;3722;1572;2150
Šiauliai county;2011;61;3554;1530;2024
Šiauliai county;2011;62;3190;1370;1820
Šiauliai county;2011;63;3044;1261;1783
Šiauliai county;2011;64;2920;1190;1730
Šiauliai county;2011;65;3242;1262;1980
Šiauliai county;2011;66;2648;1061;1587
Šiauliai county;2011;67;3135;1225;1910
Šiauliai county;2011;68;3548;1393;2155
Šiauliai county;2011;69;3337;1270;2067
Šiauliai county;2011;70;2941;1107;1834
Šiauliai county;2011;71;2925;1047;1878
Šiauliai county;2011;72;2972;1093;1879
Šiauliai county;2011;73;2952;1024;1928
Šiauliai county;2011;74;2996;1008;1988
Šiauliai county;2011;75;2714;905;1809
Šiauliai county;2011;76;2473;754;1719
Šiauliai county;2011;77;2508;817;1691
Šiauliai county;2011;78;2356;697;1659
Šiauliai county;2011;79;2219;713;1506
Šiauliai county;2011;80;1977;600;1377
Šiauliai county;2011;81;1805;522;1283
Šiauliai county;2011;82;1802;495;1307
Šiauliai county;2011;83;1473;416;1057
Šiauliai county;2011;84;1274;298;976
Šiauliai county;2011;85;5224;1158;4066
Šiauliai county;2012;-1;295824;135906;159918
Šiauliai county;2012;0;2786;1460;1326
Šiauliai county;2012;1;2637;1344;1293
Šiauliai county;2012;2;2764;1451;1313
Šiauliai county;2012;3;2714;1402;1312
Šiauliai county;2012;4;2521;1247;1274
Šiauliai county;2012;5;2495;1252;1243
Šiauliai county;2012;6;2509;1246;1263
Šiauliai county;2012;7;2702;1341;1361
Šiauliai county;2012;8;2768;1439;1329
Šiauliai county;2012;9;2721;1434;1287
Šiauliai county;2012;10;2867;1444;1423
Šiauliai county;2012;11;3098;1602;1496
Šiauliai county;2012;12;3389;1741;1648
Šiauliai county;2012;13;3584;1886;1698
Šiauliai county;2012;14;3707;1852;1855
Šiauliai county;2012;15;3943;2076;1867
Šiauliai county;2012;16;4045;2067;1978
Šiauliai county;2012;17;4200;2163;2037
Šiauliai county;2012;18;4867;2482;2385
Šiauliai county;2012;19;5100;2577;2523
Šiauliai county;2012;20;4516;2402;2114
Šiauliai county;2012;21;4136;2106;2030
Šiauliai county;2012;22;3825;1924;1901
Šiauliai county;2012;23;3675;1961;1714
Šiauliai county;2012;24;3669;1901;1768
Šiauliai county;2012;25;3476;1882;1594
Šiauliai county;2012;26;3270;1691;1579
Šiauliai county;2012;27;3200;1662;1538
Šiauliai county;2012;28;3087;1591;1496
Šiauliai county;2012;29;2880;1477;1403
Šiauliai county;2012;30;2832;1452;1380
Šiauliai county;2012;31;2957;1473;1484
Šiauliai county;2012;32;3007;1498;1509
Šiauliai county;2012;33;2992;1473;1519
Šiauliai county;2012;34;3195;1519;1676
Šiauliai county;2012;35;3393;1668;1725
Šiauliai county;2012;36;3527;1689;1838
Šiauliai county;2012;37;3612;1714;1898
Šiauliai county;2012;38;3790;1810;1980
Šiauliai county;2012;39;4079;1919;2160
Šiauliai county;2012;40;4197;1964;2233
Šiauliai county;2012;41;4409;2133;2276
Šiauliai county;2012;42;4189;1997;2192
Šiauliai county;2012;43;4517;2196;2321
Šiauliai county;2012;44;4417;2135;2282
Šiauliai county;2012;45;4465;2166;2299
Šiauliai county;2012;46;4500;2178;2322
Šiauliai county;2012;47;4636;2232;2404
Šiauliai county;2012;48;4589;2190;2399
Šiauliai county;2012;49;4824;2291;2533
Šiauliai county;2012;50;5067;2420;2647
Šiauliai county;2012;51;5095;2326;2769
Šiauliai county;2012;52;4914;2338;2576
Šiauliai county;2012;53;4960;2408;2552
Šiauliai county;2012;54;4478;2074;2404
Šiauliai county;2012;55;4108;1964;2144
Šiauliai county;2012;56;3939;1794;2145
Šiauliai county;2012;57;3874;1776;2098
Šiauliai county;2012;58;3419;1502;1917
Šiauliai county;2012;59;3523;1565;1958
Šiauliai county;2012;60;3617;1635;1982
Šiauliai county;2012;61;3628;1515;2113
Šiauliai county;2012;62;3481;1475;2006
Šiauliai county;2012;63;3124;1321;1803
Šiauliai county;2012;64;2984;1222;1762
Šiauliai county;2012;65;2881;1169;1712
Šiauliai county;2012;66;3162;1219;1943
Šiauliai county;2012;67;2597;1021;1576
Šiauliai county;2012;68;3046;1177;1869
Šiauliai county;2012;69;3458;1339;2119
Šiauliai county;2012;70;3243;1201;2042
Šiauliai county;2012;71;2847;1057;1790
Šiauliai county;2012;72;2830;1000;1830
Šiauliai county;2012;73;2855;1028;1827
Šiauliai county;2012;74;2853;970;1883
Šiauliai county;2012;75;2881;946;1935
Šiauliai county;2012;76;2579;840;1739
Šiauliai county;2012;77;2369;709;1660
Šiauliai county;2012;78;2376;760;1616
Šiauliai county;2012;79;2230;643;1587
Šiauliai county;2012;80;2076;657;1419
Šiauliai county;2012;81;1859;546;1313
Šiauliai county;2012;82;1695;480;1215
Šiauliai county;2012;83;1651;439;1212
Šiauliai county;2012;84;1318;355;963
Šiauliai county;2012;85;5529;1215;4314
Šiauliai county;2013;-1;290471;133568;156903
Šiauliai county;2013;0;2755;1438;1317
Šiauliai county;2013;1;2780;1453;1327
Šiauliai county;2013;2;2616;1338;1278
Šiauliai county;2013;3;2688;1413;1275
Šiauliai county;2013;4;2658;1380;1278
Šiauliai county;2013;5;2467;1229;1238
Šiauliai county;2013;6;2468;1230;1238
Šiauliai county;2013;7;2469;1227;1242
Šiauliai county;2013;8;2684;1333;1351
Šiauliai county;2013;9;2740;1426;1314
Šiauliai county;2013;10;2692;1420;1272
Šiauliai county;2013;11;2838;1435;1403
Šiauliai county;2013;12;3063;1588;1475
Šiauliai county;2013;13;3352;1727;1625
Šiauliai county;2013;14;3552;1870;1682
Šiauliai county;2013;15;3667;1838;1829
Šiauliai county;2013;16;3912;2061;1851
Šiauliai county;2013;17;4004;2044;1960
Šiauliai county;2013;18;4148;2138;2010
Šiauliai county;2013;19;4662;2398;2264
Šiauliai county;2013;20;4968;2531;2437
Šiauliai county;2013;21;4397;2345;2052
Šiauliai county;2013;22;3963;2032;1931
Šiauliai county;2013;23;3611;1867;1744
Šiauliai county;2013;24;3492;1890;1602
Šiauliai county;2013;25;3533;1831;1702
Šiauliai county;2013;26;3218;1751;1467
Šiauliai county;2013;27;3069;1578;1491
Šiauliai county;2013;28;3062;1582;1480
Šiauliai county;2013;29;2910;1505;1405
Šiauliai county;2013;30;2771;1419;1352
Šiauliai county;2013;31;2748;1403;1345
Šiauliai county;2013;32;2887;1441;1446
Šiauliai county;2013;33;2928;1458;1470
Šiauliai county;2013;34;2901;1419;1482
Šiauliai county;2013;35;3121;1493;1628
Šiauliai county;2013;36;3312;1629;1683
Šiauliai county;2013;37;3472;1654;1818
Šiauliai county;2013;38;3544;1675;1869
Šiauliai county;2013;39;3750;1786;1964
Šiauliai county;2013;40;4028;1895;2133
Šiauliai county;2013;41;4157;1954;2203
Šiauliai county;2013;42;4334;2089;2245
Šiauliai county;2013;43;4166;1994;2172
Šiauliai county;2013;44;4438;2159;2279
Šiauliai county;2013;45;4339;2096;2243
Šiauliai county;2013;46;4418;2139;2279
Šiauliai county;2013;47;4455;2153;2302
Šiauliai county;2013;48;4576;2197;2379
Šiauliai county;2013;49;4539;2166;2373
Šiauliai county;2013;50;4778;2270;2508
Šiauliai county;2013;51;5027;2394;2633
Šiauliai county;2013;52;5048;2297;2751
Šiauliai county;2013;53;4849;2295;2554
Šiauliai county;2013;54;4885;2355;2530
Šiauliai county;2013;55;4425;2042;2383
Šiauliai county;2013;56;4049;1928;2121
Šiauliai county;2013;57;3887;1764;2123
Šiauliai county;2013;58;3820;1739;2081
Šiauliai county;2013;59;3370;1466;1904
Šiauliai county;2013;60;3479;1530;1949
Šiauliai county;2013;61;3564;1597;1967
Šiauliai county;2013;62;3569;1466;2103
Šiauliai county;2013;63;3417;1426;1991
Šiauliai county;2013;64;3058;1276;1782
Šiauliai county;2013;65;2914;1178;1736
Šiauliai county;2013;66;2798;1124;1674
Šiauliai county;2013;67;3077;1158;1919
Šiauliai county;2013;68;2524;966;1558
Šiauliai county;2013;69;2965;1123;1842
Šiauliai county;2013;70;3372;1284;2088
Šiauliai county;2013;71;3156;1154;2002
Šiauliai county;2013;72;2776;1018;1758
Šiauliai county;2013;73;2725;949;1776
Šiauliai county;2013;74;2749;974;1775
Šiauliai county;2013;75;2746;914;1832
Šiauliai county;2013;76;2737;884;1853
Šiauliai county;2013;77;2470;779;1691
Šiauliai county;2013;78;2223;643;1580
Šiauliai county;2013;79;2214;681;1533
Šiauliai county;2013;80;2067;584;1483
Šiauliai county;2013;81;1944;596;1348
Šiauliai county;2013;82;1707;494;1213
Šiauliai county;2013;83;1543;432;1111
Šiauliai county;2013;84;1483;384;1099
Šiauliai county;2013;85;5734;1287;4447
Šiauliai county;2014;-1;285763;131479;154284
Šiauliai county;2014;0;2754;1384;1370
Šiauliai county;2014;1;2751;1431;1320
Šiauliai county;2014;2;2755;1443;1312
Šiauliai county;2014;3;2577;1314;1263
Šiauliai county;2014;4;2651;1396;1255
Šiauliai county;2014;5;2671;1393;1278
Šiauliai county;2014;6;2422;1203;1219
Šiauliai county;2014;7;2439;1204;1235
Šiauliai county;2014;8;2448;1216;1232
Šiauliai county;2014;9;2656;1320;1336
Šiauliai county;2014;10;2709;1411;1298
Šiauliai county;2014;11;2637;1386;1251
Šiauliai county;2014;12;2808;1418;1390
Šiauliai county;2014;13;3037;1574;1463
Šiauliai county;2014;14;3335;1716;1619
Šiauliai county;2014;15;3542;1869;1673
Šiauliai county;2014;16;3628;1817;1811
Šiauliai county;2014;17;3884;2057;1827
Šiauliai county;2014;18;3940;2019;1921
Šiauliai county;2014;19;3985;2072;1913
Šiauliai county;2014;20;4565;2339;2226
Šiauliai county;2014;21;4832;2455;2377
Šiauliai county;2014;22;4266;2303;1963
Šiauliai county;2014;23;3771;1956;1815
Šiauliai county;2014;24;3437;1794;1643
Šiauliai county;2014;25;3364;1838;1526
Šiauliai county;2014;26;3368;1758;1610
Šiauliai county;2014;27;3056;1663;1393
Šiauliai county;2014;28;2970;1541;1429
Šiauliai county;2014;29;2932;1508;1424
Šiauliai county;2014;30;2837;1467;1370
Šiauliai county;2014;31;2685;1372;1313
Šiauliai county;2014;32;2691;1375;1316
Šiauliai county;2014;33;2800;1393;1407
Šiauliai county;2014;34;2869;1442;1427
Šiauliai county;2014;35;2849;1395;1454
Šiauliai county;2014;36;3070;1473;1597
Šiauliai county;2014;37;3274;1601;1673
Šiauliai county;2014;38;3419;1623;1796
Šiauliai county;2014;39;3509;1652;1857
Šiauliai county;2014;40;3695;1753;1942
Šiauliai county;2014;41;3979;1875;2104
Šiauliai county;2014;42;4116;1937;2179
Šiauliai county;2014;43;4279;2057;2222
Šiauliai county;2014;44;4110;1966;2144
Šiauliai county;2014;45;4371;2125;2246
Šiauliai county;2014;46;4286;2067;2219
Šiauliai county;2014;47;4381;2111;2270
Šiauliai county;2014;48;4412;2131;2281
Šiauliai county;2014;49;4549;2185;2364
Šiauliai county;2014;50;4508;2155;2353
Šiauliai county;2014;51;4718;2235;2483
Šiauliai county;2014;52;4973;2349;2624
Šiauliai county;2014;53;4974;2248;2726
Šiauliai county;2014;54;4791;2263;2528
Šiauliai county;2014;55;4828;2322;2506
Šiauliai county;2014;56;4370;2010;2360
Šiauliai county;2014;57;3990;1884;2106
Šiauliai county;2014;58;3835;1735;2100
Šiauliai county;2014;59;3750;1686;2064
Šiauliai county;2014;60;3328;1435;1893
Šiauliai county;2014;61;3421;1499;1922
Šiauliai county;2014;62;3488;1548;1940
Šiauliai county;2014;63;3497;1418;2079
Šiauliai county;2014;64;3337;1370;1967
Šiauliai county;2014;65;2983;1222;1761
Šiauliai county;2014;66;2845;1136;1709
Šiauliai county;2014;67;2713;1078;1635
Šiauliai county;2014;68;3012;1125;1887
Šiauliai county;2014;69;2453;920;1533
Šiauliai county;2014;70;2878;1075;1803
Šiauliai county;2014;71;3274;1219;2055
Šiauliai county;2014;72;3037;1094;1943
Šiauliai county;2014;73;2686;968;1718
Šiauliai county;2014;74;2614;880;1734
Šiauliai county;2014;75;2640;924;1716
Šiauliai county;2014;76;2627;852;1775
Šiauliai county;2014;77;2613;828;1785
Šiauliai county;2014;78;2354;720;1634
Šiauliai county;2014;79;2093;592;1501
Šiauliai county;2014;80;2085;635;1450
Šiauliai county;2014;81;1914;535;1379
Šiauliai county;2014;82;1789;539;1250
Šiauliai county;2014;83;1564;448;1116
Šiauliai county;2014;84;1395;372;1023
Šiauliai county;2014;85;6015;1362;4653
Šiauliai county;2015;-1;281632;129495;152137
Šiauliai county;2015;0;2711;1380;1331
Šiauliai county;2015;1;2739;1384;1355
Šiauliai county;2015;2;2718;1417;1301
Šiauliai county;2015;3;2756;1438;1318
Šiauliai county;2015;4;2563;1302;1261
Šiauliai county;2015;5;2613;1370;1243
Šiauliai county;2015;6;2650;1372;1278
Šiauliai county;2015;7;2390;1184;1206
Šiauliai county;2015;8;2420;1197;1223
Šiauliai county;2015;9;2414;1196;1218
Šiauliai county;2015;10;2620;1297;1323
Šiauliai county;2015;11;2676;1390;1286
Šiauliai county;2015;12;2614;1374;1240
Šiauliai county;2015;13;2783;1406;1377
Šiauliai county;2015;14;3001;1554;1447
Šiauliai county;2015;15;3297;1693;1604
Šiauliai county;2015;16;3521;1853;1668
Šiauliai county;2015;17;3602;1808;1794
Šiauliai county;2015;18;3841;2031;1810
Šiauliai county;2015;19;3782;1949;1833
Šiauliai county;2015;20;3879;2021;1858
Šiauliai county;2015;21;4452;2274;2178
Šiauliai county;2015;22;4651;2365;2286
Šiauliai county;2015;23;4078;2217;1861
Šiauliai county;2015;24;3616;1899;1717
Šiauliai county;2015;25;3326;1739;1587
Šiauliai county;2015;26;3256;1788;1468
Šiauliai county;2015;27;3266;1707;1559
Šiauliai county;2015;28;2992;1622;1370
Šiauliai county;2015;29;2877;1493;1384
Šiauliai county;2015;30;2829;1451;1378
Šiauliai county;2015;31;2779;1431;1348
Šiauliai county;2015;32;2632;1343;1289
Šiauliai county;2015;33;2642;1348;1294
Šiauliai county;2015;34;2731;1338;1393
Šiauliai county;2015;35;2813;1413;1400
Šiauliai county;2015;36;2800;1376;1424
Šiauliai county;2015;37;3031;1448;1583
Šiauliai county;2015;38;3247;1587;1660
Šiauliai county;2015;39;3365;1590;1775
Šiauliai county;2015;40;3480;1640;1840
Šiauliai county;2015;41;3665;1744;1921
Šiauliai county;2015;42;3929;1847;2082
Šiauliai county;2015;43;4101;1923;2178
Šiauliai county;2015;44;4230;2028;2202
Šiauliai county;2015;45;4051;1942;2109
Šiauliai county;2015;46;4338;2109;2229
Šiauliai county;2015;47;4260;2047;2213
Šiauliai county;2015;48;4335;2090;2245
Šiauliai county;2015;49;4355;2092;2263
Šiauliai county;2015;50;4529;2177;2352
Šiauliai county;2015;51;4468;2126;2342
Šiauliai county;2015;52;4660;2204;2456
Šiauliai county;2015;53;4911;2312;2599
Šiauliai county;2015;54;4913;2216;2697
Šiauliai county;2015;55;4714;2208;2506
Šiauliai county;2015;56;4746;2279;2467
Šiauliai county;2015;57;4327;1977;2350
Šiauliai county;2015;58;3916;1831;2085
Šiauliai county;2015;59;3758;1681;2077
Šiauliai county;2015;60;3687;1649;2038
Šiauliai county;2015;61;3296;1405;1891
Šiauliai county;2015;62;3350;1454;1896
Šiauliai county;2015;63;3434;1511;1923
Šiauliai county;2015;64;3425;1377;2048
Šiauliai county;2015;65;3279;1333;1946
Šiauliai county;2015;66;2904;1166;1738
Šiauliai county;2015;67;2778;1092;1686
Šiauliai county;2015;68;2641;1022;1619
Šiauliai county;2015;69;2918;1076;1842
Šiauliai county;2015;70;2402;887;1515
Šiauliai county;2015;71;2799;1025;1774
Šiauliai county;2015;72;3170;1164;2006
Šiauliai county;2015;73;2955;1047;1908
Šiauliai county;2015;74;2574;904;1670
Šiauliai county;2015;75;2526;834;1692
Šiauliai county;2015;76;2538;867;1671
Šiauliai county;2015;77;2514;800;1714
Šiauliai county;2015;78;2485;772;1713
Šiauliai county;2015;79;2223;662;1561
Šiauliai county;2015;80;1961;537;1424
Šiauliai county;2015;81;1948;579;1369
Šiauliai county;2015;82;1787;490;1297
Šiauliai county;2015;83;1626;469;1157
Šiauliai county;2015;84;1421;397;1024
Šiauliai county;2015;85;6332;1458;4874
Šiauliai county;2016;-1;276329;126908;149421
Šiauliai county;2016;0;2757;1417;1340
Šiauliai county;2016;1;2715;1387;1328
Šiauliai county;2016;2;2710;1369;1341
Šiauliai county;2016;3;2691;1410;1281
Šiauliai county;2016;4;2721;1423;1298
Šiauliai county;2016;5;2530;1277;1253
Šiauliai county;2016;6;2561;1342;1219
Šiauliai county;2016;7;2603;1350;1253
Šiauliai county;2016;8;2339;1155;1184
Šiauliai county;2016;9;2383;1175;1208
Šiauliai county;2016;10;2387;1178;1209
Šiauliai county;2016;11;2583;1279;1304
Šiauliai county;2016;12;2647;1374;1273
Šiauliai county;2016;13;2579;1354;1225
Šiauliai county;2016;14;2744;1384;1360
Šiauliai county;2016;15;2960;1530;1430
Šiauliai county;2016;16;3265;1674;1591
Šiauliai county;2016;17;3478;1824;1654
Šiauliai county;2016;18;3532;1777;1755
Šiauliai county;2016;19;3692;1953;1739
Šiauliai county;2016;20;3663;1880;1783
Šiauliai county;2016;21;3752;1943;1809
Šiauliai county;2016;22;4274;2167;2107
Šiauliai county;2016;23;4459;2278;2181
Šiauliai county;2016;24;3836;2074;1762
Šiauliai county;2016;25;3435;1794;1641
Šiauliai county;2016;26;3108;1609;1499
Šiauliai county;2016;27;3096;1719;1377
Šiauliai county;2016;28;3167;1665;1502
Šiauliai county;2016;29;2847;1541;1306
Šiauliai county;2016;30;2788;1436;1352
Šiauliai county;2016;31;2721;1387;1334
Šiauliai county;2016;32;2680;1372;1308
Šiauliai county;2016;33;2546;1286;1260
Šiauliai county;2016;34;2559;1303;1256
Šiauliai county;2016;35;2655;1298;1357
Šiauliai county;2016;36;2729;1365;1364
Šiauliai county;2016;37;2760;1343;1417
Šiauliai county;2016;38;2954;1411;1543
Šiauliai county;2016;39;3200;1553;1647
Šiauliai county;2016;40;3288;1543;1745
Šiauliai county;2016;41;3417;1605;1812
Šiauliai county;2016;42;3625;1735;1890
Šiauliai county;2016;43;3879;1829;2050
Šiauliai county;2016;44;4056;1911;2145
Šiauliai county;2016;45;4168;2007;2161
Šiauliai county;2016;46;4014;1919;2095
Šiauliai county;2016;47;4289;2086;2203
Šiauliai county;2016;48;4186;2018;2168
Šiauliai county;2016;49;4298;2060;2238
Šiauliai county;2016;50;4305;2062;2243
Šiauliai county;2016;51;4483;2157;2326
Šiauliai county;2016;52;4409;2088;2321
Šiauliai county;2016;53;4586;2148;2438
Šiauliai county;2016;54;4856;2280;2576
Šiauliai county;2016;55;4861;2188;2673
Šiauliai county;2016;56;4656;2170;2486
Šiauliai county;2016;57;4670;2231;2439
Šiauliai county;2016;58;4262;1935;2327
Šiauliai county;2016;59;3869;1804;2065
Šiauliai county;2016;60;3679;1631;2048
Šiauliai county;2016;61;3622;1599;2023
Šiauliai county;2016;62;3245;1375;1870
Šiauliai county;2016;63;3274;1405;1869
Šiauliai county;2016;64;3332;1442;1890
Šiauliai county;2016;65;3354;1333;2021
Šiauliai county;2016;66;3212;1304;1908
Šiauliai county;2016;67;2818;1123;1695
Šiauliai county;2016;68;2704;1041;1663
Šiauliai county;2016;69;2577;986;1591
Šiauliai county;2016;70;2837;1030;1807
Šiauliai county;2016;71;2323;844;1479
Šiauliai county;2016;72;2717;982;1735
Šiauliai county;2016;73;3039;1099;1940
Šiauliai county;2016;74;2869;991;1878
Šiauliai county;2016;75;2480;847;1633
Šiauliai county;2016;76;2424;779;1645
Šiauliai county;2016;77;2408;800;1608
Šiauliai county;2016;78;2395;742;1653
Šiauliai county;2016;79;2364;717;1647
Šiauliai county;2016;80;2092;600;1492
Šiauliai county;2016;81;1814;480;1334
Šiauliai county;2016;82;1804;513;1291
Šiauliai county;2016;83;1643;436;1207
Šiauliai county;2016;84;1475;424;1051
Šiauliai county;2016;85;6545;1553;4992
Šiauliai county;2017;-1;270482;124442;146040
Šiauliai county;2017;0;2686;1382;1304
Šiauliai county;2017;1;2678;1375;1303
Šiauliai county;2017;2;2653;1354;1299
Šiauliai county;2017;3;2645;1330;1315
Šiauliai county;2017;4;2624;1376;1248
Šiauliai county;2017;5;2676;1407;1269
Šiauliai county;2017;6;2498;1267;1231
Šiauliai county;2017;7;2506;1308;1198
Šiauliai county;2017;8;2554;1326;1228
Šiauliai county;2017;9;2307;1132;1175
Šiauliai county;2017;10;2341;1161;1180
Šiauliai county;2017;11;2336;1145;1191
Šiauliai county;2017;12;2531;1256;1275
Šiauliai county;2017;13;2614;1359;1255
Šiauliai county;2017;14;2538;1328;1210
Šiauliai county;2017;15;2709;1371;1338
Šiauliai county;2017;16;2928;1517;1411
Šiauliai county;2017;17;3235;1657;1578
Šiauliai county;2017;18;3412;1785;1627
Šiauliai county;2017;19;3383;1713;1670
Šiauliai county;2017;20;3567;1879;1688
Šiauliai county;2017;21;3517;1804;1713
Šiauliai county;2017;22;3574;1860;1714
Šiauliai county;2017;23;4079;2081;1998
Šiauliai county;2017;24;4193;2169;2024
Šiauliai county;2017;25;3610;1978;1632
Šiauliai county;2017;26;3196;1676;1520
Šiauliai county;2017;27;2915;1529;1386
Šiauliai county;2017;28;2899;1637;1262
Šiauliai county;2017;29;3019;1610;1409
Šiauliai county;2017;30;2684;1468;1216
Šiauliai county;2017;31;2640;1352;1288
Šiauliai county;2017;32;2594;1329;1265
Šiauliai county;2017;33;2535;1307;1228
Šiauliai county;2017;34;2474;1260;1214
Šiauliai county;2017;35;2447;1250;1197
Šiauliai county;2017;36;2562;1245;1317
Šiauliai county;2017;37;2668;1342;1326
Šiauliai county;2017;38;2718;1327;1391
Šiauliai county;2017;39;2901;1390;1511
Šiauliai county;2017;40;3169;1558;1611
Šiauliai county;2017;41;3260;1547;1713
Šiauliai county;2017;42;3389;1599;1790
Šiauliai county;2017;43;3608;1736;1872
Šiauliai county;2017;44;3854;1835;2019
Šiauliai county;2017;45;3983;1886;2097
Šiauliai county;2017;46;4141;2008;2133
Šiauliai county;2017;47;3988;1916;2072
Šiauliai county;2017;48;4237;2067;2170
Šiauliai county;2017;49;4137;1995;2142
Šiauliai county;2017;50;4240;2028;2212
Šiauliai county;2017;51;4266;2048;2218
Šiauliai county;2017;52;4428;2135;2293
Šiauliai county;2017;53;4354;2065;2289
Šiauliai county;2017;54;4521;2106;2415
Šiauliai county;2017;55;4797;2245;2552
Šiauliai county;2017;56;4803;2149;2654
Šiauliai county;2017;57;4574;2120;2454
Šiauliai county;2017;58;4596;2190;2406
Šiauliai county;2017;59;4175;1888;2287
Šiauliai county;2017;60;3801;1759;2042
Šiauliai county;2017;61;3613;1588;2025
Šiauliai county;2017;62;3557;1556;2001
Šiauliai county;2017;63;3185;1332;1853
Šiauliai county;2017;64;3194;1348;1846
Šiauliai county;2017;65;3263;1401;1862
Šiauliai county;2017;66;3281;1279;2002
Šiauliai county;2017;67;3139;1260;1879
Šiauliai county;2017;68;2732;1067;1665
Šiauliai county;2017;69;2623;986;1637
Šiauliai county;2017;70;2504;945;1559
Šiauliai county;2017;71;2766;993;1773
Šiauliai county;2017;72;2234;794;1440
Šiauliai county;2017;73;2625;929;1696
Šiauliai county;2017;74;2924;1037;1887
Šiauliai county;2017;75;2752;935;1817
Šiauliai county;2017;76;2372;786;1586
Šiauliai county;2017;77;2311;716;1595
Šiauliai county;2017;78;2304;752;1552
Šiauliai county;2017;79;2266;681;1585
Šiauliai county;2017;80;2241;657;1584
Šiauliai county;2017;81;1947;541;1406
Šiauliai county;2017;82;1681;434;1247
Šiauliai county;2017;83;1665;461;1204
Šiauliai county;2017;84;1524;391;1133
Šiauliai county;2017;85;6812;1651;5161
Šiauliai county;2018;-1;265467;123094;142373
Šiauliai county;2018;0;2505;1276;1229
Šiauliai county;2018;1;2681;1377;1304
Šiauliai county;2018;2;2643;1364;1279
Šiauliai county;2018;3;2615;1331;1284
Šiauliai county;2018;4;2604;1307;1297
Šiauliai county;2018;5;2593;1351;1242
Šiauliai county;2018;6;2633;1382;1251
Šiauliai county;2018;7;2468;1250;1218
Šiauliai county;2018;8;2464;1292;1172
Šiauliai county;2018;9;2516;1305;1211
Šiauliai county;2018;10;2279;1116;1163
Šiauliai county;2018;11;2309;1140;1169
Šiauliai county;2018;12;2317;1133;1184
Šiauliai county;2018;13;2508;1243;1265
Šiauliai county;2018;14;2583;1342;1241
Šiauliai county;2018;15;2505;1309;1196
Šiauliai county;2018;16;2691;1362;1329
Šiauliai county;2018;17;2887;1498;1389
Šiauliai county;2018;18;3165;1619;1546
Šiauliai county;2018;19;3185;1670;1515
Šiauliai county;2018;20;3181;1618;1563
Šiauliai county;2018;21;3357;1781;1576
Šiauliai county;2018;22;3293;1684;1609
Šiauliai county;2018;23;3307;1738;1569
Šiauliai county;2018;24;3760;1927;1833
Šiauliai county;2018;25;3878;2020;1858
Šiauliai county;2018;26;3334;1873;1461
Šiauliai county;2018;27;2967;1582;1385
Šiauliai county;2018;28;2720;1442;1278
Šiauliai county;2018;29;2764;1582;1182
Šiauliai county;2018;30;2891;1575;1316
Šiauliai county;2018;31;2623;1467;1156
Šiauliai county;2018;32;2546;1329;1217
Šiauliai county;2018;33;2539;1338;1201
Šiauliai county;2018;34;2502;1312;1190
Šiauliai county;2018;35;2475;1294;1181
Šiauliai county;2018;36;2442;1274;1168
Šiauliai county;2018;37;2583;1296;1287
Šiauliai county;2018;38;2690;1385;1305
Šiauliai county;2018;39;2753;1378;1375
Šiauliai county;2018;40;2932;1440;1492
Šiauliai county;2018;41;3190;1610;1580
Šiauliai county;2018;42;3273;1594;1679
Šiauliai county;2018;43;3405;1652;1753
Šiauliai county;2018;44;3620;1785;1835
Šiauliai county;2018;45;3883;1896;1987
Šiauliai county;2018;46;3988;1927;2061
Šiauliai county;2018;47;4157;2050;2107
Šiauliai county;2018;48;3985;1948;2037
Šiauliai county;2018;49;4223;2095;2128
Šiauliai county;2018;50;4103;2000;2103
Šiauliai county;2018;51;4210;2037;2173
Šiauliai county;2018;52;4243;2058;2185
Šiauliai county;2018;53;4388;2135;2253
Šiauliai county;2018;54;4320;2063;2257
Šiauliai county;2018;55;4463;2081;2382
Šiauliai county;2018;56;4732;2226;2506
Šiauliai county;2018;57;4746;2122;2624
Šiauliai county;2018;58;4498;2072;2426
Šiauliai county;2018;59;4532;2154;2378
Šiauliai county;2018;60;4118;1844;2274
Šiauliai county;2018;61;3732;1721;2011
Šiauliai county;2018;62;3568;1554;2014
Šiauliai county;2018;63;3513;1526;1987
Šiauliai county;2018;64;3133;1298;1835
Šiauliai county;2018;65;3134;1305;1829
Šiauliai county;2018;66;3189;1352;1837
Šiauliai county;2018;67;3205;1232;1973
Šiauliai county;2018;68;3067;1212;1855
Šiauliai county;2018;69;2649;1023;1626
Šiauliai county;2018;70;2544;941;1603
Šiauliai county;2018;71;2424;895;1529
Šiauliai county;2018;72;2686;949;1737
Šiauliai county;2018;73;2143;744;1399
Šiauliai county;2018;74;2532;876;1656
Šiauliai county;2018;75;2805;975;1830
Šiauliai county;2018;76;2625;877;1748
Šiauliai county;2018;77;2272;736;1536
Šiauliai county;2018;78;2196;661;1535
Šiauliai county;2018;79;2182;691;1491
Šiauliai county;2018;80;2122;617;1505
Šiauliai county;2018;81;2088;593;1495
Šiauliai county;2018;82;1815;492;1323
Šiauliai county;2018;83;1546;382;1164
Šiauliai county;2018;84;1539;412;1127
Šiauliai county;2018;85;6993;1679;5314
Šiauliai d. mun.;2001;-1;51617;24600;27017
Šiauliai d. mun.;2001;0;505;265;240
Šiauliai d. mun.;2001;1;585;306;279
Šiauliai d. mun.;2001;2;587;311;276
Šiauliai d. mun.;2001;3;562;291;271
Šiauliai d. mun.;2001;4;662;342;320
Šiauliai d. mun.;2001;5;652;347;305
Šiauliai d. mun.;2001;6;705;326;379
Šiauliai d. mun.;2001;7;767;411;356
Šiauliai d. mun.;2001;8;931;455;476
Šiauliai d. mun.;2001;9;921;464;457
Šiauliai d. mun.;2001;10;897;462;435
Šiauliai d. mun.;2001;11;882;429;453
Šiauliai d. mun.;2001;12;891;465;426
Šiauliai d. mun.;2001;13;896;460;436
Šiauliai d. mun.;2001;14;924;490;434
Šiauliai d. mun.;2001;15;859;428;431
Šiauliai d. mun.;2001;16;862;448;414
Šiauliai d. mun.;2001;17;847;418;429
Šiauliai d. mun.;2001;18;686;373;313
Šiauliai d. mun.;2001;19;661;363;298
Šiauliai d. mun.;2001;20;633;335;298
Šiauliai d. mun.;2001;21;574;323;251
Šiauliai d. mun.;2001;22;571;304;267
Šiauliai d. mun.;2001;23;509;259;250
Šiauliai d. mun.;2001;24;615;306;309
Šiauliai d. mun.;2001;25;629;318;311
Šiauliai d. mun.;2001;26;610;284;326
Šiauliai d. mun.;2001;27;636;320;316
Šiauliai d. mun.;2001;28;638;308;330
Šiauliai d. mun.;2001;29;690;343;347
Šiauliai d. mun.;2001;30;741;407;334
Šiauliai d. mun.;2001;31;733;365;368
Šiauliai d. mun.;2001;32;700;340;360
Šiauliai d. mun.;2001;33;712;337;375
Šiauliai d. mun.;2001;34;743;366;377
Šiauliai d. mun.;2001;35;739;356;383
Šiauliai d. mun.;2001;36;695;363;332
Šiauliai d. mun.;2001;37;720;371;349
Šiauliai d. mun.;2001;38;781;388;393
Šiauliai d. mun.;2001;39;851;415;436
Šiauliai d. mun.;2001;40;808;396;412
Šiauliai d. mun.;2001;41;814;423;391
Šiauliai d. mun.;2001;42;779;404;375
Šiauliai d. mun.;2001;43;720;357;363
Šiauliai d. mun.;2001;44;669;361;308
Šiauliai d. mun.;2001;45;652;324;328
Šiauliai d. mun.;2001;46;664;370;294
Šiauliai d. mun.;2001;47;521;251;270
Šiauliai d. mun.;2001;48;583;274;309
Šiauliai d. mun.;2001;49;603;299;304
Šiauliai d. mun.;2001;50;655;311;344
Šiauliai d. mun.;2001;51;570;273;297
Šiauliai d. mun.;2001;52;550;264;286
Šiauliai d. mun.;2001;53;486;237;249
Šiauliai d. mun.;2001;54;531;251;280
Šiauliai d. mun.;2001;55;570;267;303
Šiauliai d. mun.;2001;56;443;217;226
Šiauliai d. mun.;2001;57;535;246;289
Šiauliai d. mun.;2001;58;659;269;390
Šiauliai d. mun.;2001;59;598;253;345
Šiauliai d. mun.;2001;60;521;232;289
Šiauliai d. mun.;2001;61;560;247;313
Šiauliai d. mun.;2001;62;535;240;295
Šiauliai d. mun.;2001;63;578;234;344
Šiauliai d. mun.;2001;64;550;214;336
Šiauliai d. mun.;2001;65;536;244;292
Šiauliai d. mun.;2001;66;537;210;327
Šiauliai d. mun.;2001;67;501;202;299
Šiauliai d. mun.;2001;68;551;216;335
Šiauliai d. mun.;2001;69;515;217;298
Šiauliai d. mun.;2001;70;476;170;306
Šiauliai d. mun.;2001;71;456;175;281
Šiauliai d. mun.;2001;72;467;170;297
Šiauliai d. mun.;2001;73;423;159;264
Šiauliai d. mun.;2001;74;354;106;248
Šiauliai d. mun.;2001;75;341;103;238
Šiauliai d. mun.;2001;76;343;112;231
Šiauliai d. mun.;2001;77;338;113;225
Šiauliai d. mun.;2001;78;292;103;189
Šiauliai d. mun.;2001;79;241;77;164
Šiauliai d. mun.;2001;80;234;60;174
Šiauliai d. mun.;2001;81;153;42;111
Šiauliai d. mun.;2001;82;97;26;71
Šiauliai d. mun.;2001;83;98;26;72
Šiauliai d. mun.;2001;84;94;29;65
Šiauliai d. mun.;2001;85;614;164;450
Šiauliai d. mun.;2002;-1;51427;24516;26911
Šiauliai d. mun.;2002;0;498;261;237
Šiauliai d. mun.;2002;1;496;259;237
Šiauliai d. mun.;2002;2;588;309;279
Šiauliai d. mun.;2002;3;584;309;275
Šiauliai d. mun.;2002;4;566;292;274
Šiauliai d. mun.;2002;5;660;347;313
Šiauliai d. mun.;2002;6;652;343;309
Šiauliai d. mun.;2002;7;702;323;379
Šiauliai d. mun.;2002;8;778;422;356
Šiauliai d. mun.;2002;9;928;451;477
Šiauliai d. mun.;2002;10;918;464;454
Šiauliai d. mun.;2002;11;888;460;428
Šiauliai d. mun.;2002;12;888;434;454
Šiauliai d. mun.;2002;13;888;464;424
Šiauliai d. mun.;2002;14;888;450;438
Šiauliai d. mun.;2002;15;932;490;442
Šiauliai d. mun.;2002;16;853;425;428
Šiauliai d. mun.;2002;17;855;445;410
Šiauliai d. mun.;2002;18;846;417;429
Šiauliai d. mun.;2002;19;653;362;291
Šiauliai d. mun.;2002;20;632;352;280
Šiauliai d. mun.;2002;21;613;323;290
Šiauliai d. mun.;2002;22;563;318;245
Šiauliai d. mun.;2002;23;567;305;262
Šiauliai d. mun.;2002;24;508;260;248
Šiauliai d. mun.;2002;25;620;308;312
Šiauliai d. mun.;2002;26;618;311;307
Šiauliai d. mun.;2002;27;609;282;327
Šiauliai d. mun.;2002;28;620;309;311
Šiauliai d. mun.;2002;29;642;305;337
Šiauliai d. mun.;2002;30;674;335;339
Šiauliai d. mun.;2002;31;732;404;328
Šiauliai d. mun.;2002;32;724;358;366
Šiauliai d. mun.;2002;33;681;325;356
Šiauliai d. mun.;2002;34;695;328;367
Šiauliai d. mun.;2002;35;729;359;370
Šiauliai d. mun.;2002;36;728;349;379
Šiauliai d. mun.;2002;37;700;363;337
Šiauliai d. mun.;2002;38;707;362;345
Šiauliai d. mun.;2002;39;771;382;389
Šiauliai d. mun.;2002;40;838;411;427
Šiauliai d. mun.;2002;41;806;393;413
Šiauliai d. mun.;2002;42;812;426;386
Šiauliai d. mun.;2002;43;789;414;375
Šiauliai d. mun.;2002;44;718;353;365
Šiauliai d. mun.;2002;45;658;351;307
Šiauliai d. mun.;2002;46;634;316;318
Šiauliai d. mun.;2002;47;671;373;298
Šiauliai d. mun.;2002;48;514;248;266
Šiauliai d. mun.;2002;49;576;269;307
Šiauliai d. mun.;2002;50;599;295;304
Šiauliai d. mun.;2002;51;652;307;345
Šiauliai d. mun.;2002;52;569;272;297
Šiauliai d. mun.;2002;53;542;260;282
Šiauliai d. mun.;2002;54;478;232;246
Šiauliai d. mun.;2002;55;521;246;275
Šiauliai d. mun.;2002;56;562;259;303
Šiauliai d. mun.;2002;57;435;213;222
Šiauliai d. mun.;2002;58;524;241;283
Šiauliai d. mun.;2002;59;644;259;385
Šiauliai d. mun.;2002;60;593;254;339
Šiauliai d. mun.;2002;61;517;232;285
Šiauliai d. mun.;2002;62;569;251;318
Šiauliai d. mun.;2002;63;528;234;294
Šiauliai d. mun.;2002;64;576;228;348
Šiauliai d. mun.;2002;65;542;210;332
Šiauliai d. mun.;2002;66;529;239;290
Šiauliai d. mun.;2002;67;528;207;321
Šiauliai d. mun.;2002;68;494;198;296
Šiauliai d. mun.;2002;69;549;211;338
Šiauliai d. mun.;2002;70;511;214;297
Šiauliai d. mun.;2002;71;472;167;305
Šiauliai d. mun.;2002;72;437;163;274
Šiauliai d. mun.;2002;73;460;168;292
Šiauliai d. mun.;2002;74;403;151;252
Šiauliai d. mun.;2002;75;347;104;243
Šiauliai d. mun.;2002;76;334;101;233
Šiauliai d. mun.;2002;77;321;104;217
Šiauliai d. mun.;2002;78;329;108;221
Šiauliai d. mun.;2002;79;286;97;189
Šiauliai d. mun.;2002;80;228;72;156
Šiauliai d. mun.;2002;81;214;58;156
Šiauliai d. mun.;2002;82;138;38;100
Šiauliai d. mun.;2002;83;90;24;66
Šiauliai d. mun.;2002;84;93;24;69
Šiauliai d. mun.;2002;85;603;156;447
Šiauliai d. mun.;2003;-1;51234;24402;26832
Šiauliai d. mun.;2003;0;464;226;238
Šiauliai d. mun.;2003;1;506;267;239
Šiauliai d. mun.;2003;2;499;263;236
Šiauliai d. mun.;2003;3;593;309;284
Šiauliai d. mun.;2003;4;591;314;277
Šiauliai d. mun.;2003;5;572;295;277
Šiauliai d. mun.;2003;6;668;351;317
Šiauliai d. mun.;2003;7;665;351;314
Šiauliai d. mun.;2003;8;709;325;384
Šiauliai d. mun.;2003;9;779;423;356
Šiauliai d. mun.;2003;10;935;461;474
Šiauliai d. mun.;2003;11;920;466;454
Šiauliai d. mun.;2003;12;884;456;428
Šiauliai d. mun.;2003;13;881;435;446
Šiauliai d. mun.;2003;14;887;461;426
Šiauliai d. mun.;2003;15;879;445;434
Šiauliai d. mun.;2003;16;919;485;434
Šiauliai d. mun.;2003;17;854;421;433
Šiauliai d. mun.;2003;18;845;439;406
Šiauliai d. mun.;2003;19;834;418;416
Šiauliai d. mun.;2003;20;626;349;277
Šiauliai d. mun.;2003;21;616;344;272
Šiauliai d. mun.;2003;22;602;320;282
Šiauliai d. mun.;2003;23;562;318;244
Šiauliai d. mun.;2003;24;571;308;263
Šiauliai d. mun.;2003;25;523;271;252
Šiauliai d. mun.;2003;26;610;297;313
Šiauliai d. mun.;2003;27;614;308;306
Šiauliai d. mun.;2003;28;592;274;318
Šiauliai d. mun.;2003;29;619;308;311
Šiauliai d. mun.;2003;30;636;304;332
Šiauliai d. mun.;2003;31;664;327;337
Šiauliai d. mun.;2003;32;727;399;328
Šiauliai d. mun.;2003;33;712;352;360
Šiauliai d. mun.;2003;34;678;320;358
Šiauliai d. mun.;2003;35;684;326;358
Šiauliai d. mun.;2003;36;719;358;361
Šiauliai d. mun.;2003;37;721;343;378
Šiauliai d. mun.;2003;38;694;358;336
Šiauliai d. mun.;2003;39;703;356;347
Šiauliai d. mun.;2003;40;758;377;381
Šiauliai d. mun.;2003;41;839;414;425
Šiauliai d. mun.;2003;42;807;388;419
Šiauliai d. mun.;2003;43;812;430;382
Šiauliai d. mun.;2003;44;783;413;370
Šiauliai d. mun.;2003;45;723;357;366
Šiauliai d. mun.;2003;46;662;351;311
Šiauliai d. mun.;2003;47;630;312;318
Šiauliai d. mun.;2003;48;665;368;297
Šiauliai d. mun.;2003;49;509;246;263
Šiauliai d. mun.;2003;50;572;266;306
Šiauliai d. mun.;2003;51;591;290;301
Šiauliai d. mun.;2003;52;651;306;345
Šiauliai d. mun.;2003;53;569;275;294
Šiauliai d. mun.;2003;54;538;252;286
Šiauliai d. mun.;2003;55;476;226;250
Šiauliai d. mun.;2003;56;516;245;271
Šiauliai d. mun.;2003;57;553;254;299
Šiauliai d. mun.;2003;58;428;208;220
Šiauliai d. mun.;2003;59;521;236;285
Šiauliai d. mun.;2003;60;630;252;378
Šiauliai d. mun.;2003;61;588;250;338
Šiauliai d. mun.;2003;62;507;224;283
Šiauliai d. mun.;2003;63;568;247;321
Šiauliai d. mun.;2003;64;523;231;292
Šiauliai d. mun.;2003;65;567;222;345
Šiauliai d. mun.;2003;66;532;203;329
Šiauliai d. mun.;2003;67;526;236;290
Šiauliai d. mun.;2003;68;513;195;318
Šiauliai d. mun.;2003;69;485;193;292
Šiauliai d. mun.;2003;70;530;197;333
Šiauliai d. mun.;2003;71;493;202;291
Šiauliai d. mun.;2003;72;456;159;297
Šiauliai d. mun.;2003;73;417;149;268
Šiauliai d. mun.;2003;74;444;155;289
Šiauliai d. mun.;2003;75;384;138;246
Šiauliai d. mun.;2003;76;332;92;240
Šiauliai d. mun.;2003;77;317;88;229
Šiauliai d. mun.;2003;78;305;101;204
Šiauliai d. mun.;2003;79;307;96;211
Šiauliai d. mun.;2003;80;270;92;178
Šiauliai d. mun.;2003;81;206;64;142
Šiauliai d. mun.;2003;82;188;50;138
Šiauliai d. mun.;2003;83;130;34;96
Šiauliai d. mun.;2003;84;79;18;61
Šiauliai d. mun.;2003;85;577;149;428
Šiauliai d. mun.;2004;-1;51002;24261;26741
Šiauliai d. mun.;2004;0;509;272;237
Šiauliai d. mun.;2004;1;473;233;240
Šiauliai d. mun.;2004;2;515;270;245
Šiauliai d. mun.;2004;3;501;262;239
Šiauliai d. mun.;2004;4;612;319;293
Šiauliai d. mun.;2004;5;605;320;285
Šiauliai d. mun.;2004;6;580;296;284
Šiauliai d. mun.;2004;7;679;354;325
Šiauliai d. mun.;2004;8;676;357;319
Šiauliai d. mun.;2004;9;718;331;387
Šiauliai d. mun.;2004;10;789;424;365
Šiauliai d. mun.;2004;11;944;467;477
Šiauliai d. mun.;2004;12;931;472;459
Šiauliai d. mun.;2004;13;888;453;435
Šiauliai d. mun.;2004;14;882;433;449
Šiauliai d. mun.;2004;15;883;459;424
Šiauliai d. mun.;2004;16;872;441;431
Šiauliai d. mun.;2004;17;901;477;424
Šiauliai d. mun.;2004;18;841;412;429
Šiauliai d. mun.;2004;19;822;431;391
Šiauliai d. mun.;2004;20;812;408;404
Šiauliai d. mun.;2004;21;599;333;266
Šiauliai d. mun.;2004;22;595;336;259
Šiauliai d. mun.;2004;23;578;307;271
Šiauliai d. mun.;2004;24;559;321;238
Šiauliai d. mun.;2004;25;527;284;243
Šiauliai d. mun.;2004;26;505;259;246
Šiauliai d. mun.;2004;27;576;281;295
Šiauliai d. mun.;2004;28;598;298;300
Šiauliai d. mun.;2004;29;577;269;308
Šiauliai d. mun.;2004;30;604;300;304
Šiauliai d. mun.;2004;31;612;289;323
Šiauliai d. mun.;2004;32;639;314;325
Šiauliai d. mun.;2004;33;723;395;328
Šiauliai d. mun.;2004;34;706;345;361
Šiauliai d. mun.;2004;35;664;312;352
Šiauliai d. mun.;2004;36;688;330;358
Šiauliai d. mun.;2004;37;719;362;357
Šiauliai d. mun.;2004;38;722;342;380
Šiauliai d. mun.;2004;39;687;358;329
Šiauliai d. mun.;2004;40;703;358;345
Šiauliai d. mun.;2004;41;751;372;379
Šiauliai d. mun.;2004;42;832;413;419
Šiauliai d. mun.;2004;43;805;387;418
Šiauliai d. mun.;2004;44;796;421;375
Šiauliai d. mun.;2004;45;786;414;372
Šiauliai d. mun.;2004;46;716;349;367
Šiauliai d. mun.;2004;47;658;349;309
Šiauliai d. mun.;2004;48;626;305;321
Šiauliai d. mun.;2004;49;668;370;298
Šiauliai d. mun.;2004;50;510;246;264
Šiauliai d. mun.;2004;51;579;272;307
Šiauliai d. mun.;2004;52;591;288;303
Šiauliai d. mun.;2004;53;638;300;338
Šiauliai d. mun.;2004;54;564;270;294
Šiauliai d. mun.;2004;55;540;253;287
Šiauliai d. mun.;2004;56;477;228;249
Šiauliai d. mun.;2004;57;510;242;268
Šiauliai d. mun.;2004;58;549;249;300
Šiauliai d. mun.;2004;59;418;202;216
Šiauliai d. mun.;2004;60;517;232;285
Šiauliai d. mun.;2004;61;619;246;373
Šiauliai d. mun.;2004;62;583;250;333
Šiauliai d. mun.;2004;63;507;223;284
Šiauliai d. mun.;2004;64;565;248;317
Šiauliai d. mun.;2004;65;525;230;295
Šiauliai d. mun.;2004;66;563;215;348
Šiauliai d. mun.;2004;67;520;191;329
Šiauliai d. mun.;2004;68;514;225;289
Šiauliai d. mun.;2004;69;506;189;317
Šiauliai d. mun.;2004;70;471;185;286
Šiauliai d. mun.;2004;71;508;180;328
Šiauliai d. mun.;2004;72;485;200;285
Šiauliai d. mun.;2004;73;443;146;297
Šiauliai d. mun.;2004;74;405;145;260
Šiauliai d. mun.;2004;75;426;141;285
Šiauliai d. mun.;2004;76;371;134;237
Šiauliai d. mun.;2004;77;314;86;228
Šiauliai d. mun.;2004;78;299;77;222
Šiauliai d. mun.;2004;79;285;91;194
Šiauliai d. mun.;2004;80;289;91;198
Šiauliai d. mun.;2004;81;246;76;170
Šiauliai d. mun.;2004;82;195;58;137
Šiauliai d. mun.;2004;83;166;42;124
Šiauliai d. mun.;2004;84;115;26;89
Šiauliai d. mun.;2004;85;537;120;417
Šiauliai d. mun.;2005;-1;50559;24050;26509
Šiauliai d. mun.;2005;0;446;219;227
Šiauliai d. mun.;2005;1;504;269;235
Šiauliai d. mun.;2005;2;470;231;239
Šiauliai d. mun.;2005;3;515;268;247
Šiauliai d. mun.;2005;4;496;256;240
Šiauliai d. mun.;2005;5;609;320;289
Šiauliai d. mun.;2005;6;598;321;277
Šiauliai d. mun.;2005;7;576;296;280
Šiauliai d. mun.;2005;8;681;355;326
Šiauliai d. mun.;2005;9;675;355;320
Šiauliai d. mun.;2005;10;719;333;386
Šiauliai d. mun.;2005;11;789;424;365
Šiauliai d. mun.;2005;12;954;471;483
Šiauliai d. mun.;2005;13;937;476;461
Šiauliai d. mun.;2005;14;881;449;432
Šiauliai d. mun.;2005;15;872;430;442
Šiauliai d. mun.;2005;16;873;451;422
Šiauliai d. mun.;2005;17;861;436;425
Šiauliai d. mun.;2005;18;892;473;419
Šiauliai d. mun.;2005;19;823;400;423
Šiauliai d. mun.;2005;20;796;418;378
Šiauliai d. mun.;2005;21;782;399;383
Šiauliai d. mun.;2005;22;570;325;245
Šiauliai d. mun.;2005;23;581;333;248
Šiauliai d. mun.;2005;24;556;296;260
Šiauliai d. mun.;2005;25;522;308;214
Šiauliai d. mun.;2005;26;511;273;238
Šiauliai d. mun.;2005;27;480;244;236
Šiauliai d. mun.;2005;28;559;273;286
Šiauliai d. mun.;2005;29;580;291;289
Šiauliai d. mun.;2005;30;559;260;299
Šiauliai d. mun.;2005;31;583;284;299
Šiauliai d. mun.;2005;32;606;286;320
Šiauliai d. mun.;2005;33;627;308;319
Šiauliai d. mun.;2005;34;718;391;327
Šiauliai d. mun.;2005;35;703;344;359
Šiauliai d. mun.;2005;36;668;313;355
Šiauliai d. mun.;2005;37;680;330;350
Šiauliai d. mun.;2005;38;714;362;352
Šiauliai d. mun.;2005;39;725;344;381
Šiauliai d. mun.;2005;40;685;354;331
Šiauliai d. mun.;2005;41;697;355;342
Šiauliai d. mun.;2005;42;751;374;377
Šiauliai d. mun.;2005;43;823;405;418
Šiauliai d. mun.;2005;44;810;390;420
Šiauliai d. mun.;2005;45;805;427;378
Šiauliai d. mun.;2005;46;784;415;369
Šiauliai d. mun.;2005;47;719;344;375
Šiauliai d. mun.;2005;48;653;346;307
Šiauliai d. mun.;2005;49;622;300;322
Šiauliai d. mun.;2005;50;673;368;305
Šiauliai d. mun.;2005;51;512;248;264
Šiauliai d. mun.;2005;52;571;269;302
Šiauliai d. mun.;2005;53;591;286;305
Šiauliai d. mun.;2005;54;631;297;334
Šiauliai d. mun.;2005;55;569;268;301
Šiauliai d. mun.;2005;56;539;250;289
Šiauliai d. mun.;2005;57;474;228;246
Šiauliai d. mun.;2005;58;509;238;271
Šiauliai d. mun.;2005;59;541;244;297
Šiauliai d. mun.;2005;60;416;201;215
Šiauliai d. mun.;2005;61;504;222;282
Šiauliai d. mun.;2005;62;619;246;373
Šiauliai d. mun.;2005;63;579;250;329
Šiauliai d. mun.;2005;64;497;217;280
Šiauliai d. mun.;2005;65;560;242;318
Šiauliai d. mun.;2005;66;508;222;286
Šiauliai d. mun.;2005;67;552;210;342
Šiauliai d. mun.;2005;68;517;190;327
Šiauliai d. mun.;2005;69;498;213;285
Šiauliai d. mun.;2005;70;488;179;309
Šiauliai d. mun.;2005;71;462;183;279
Šiauliai d. mun.;2005;72;485;172;313
Šiauliai d. mun.;2005;73;471;190;281
Šiauliai d. mun.;2005;74;428;144;284
Šiauliai d. mun.;2005;75;379;130;249
Šiauliai d. mun.;2005;76;401;124;277
Šiauliai d. mun.;2005;77;349;120;229
Šiauliai d. mun.;2005;78;289;77;212
Šiauliai d. mun.;2005;79;279;65;214
Šiauliai d. mun.;2005;80;267;83;184
Šiauliai d. mun.;2005;81;273;84;189
Šiauliai d. mun.;2005;82;235;69;166
Šiauliai d. mun.;2005;83;164;48;116
Šiauliai d. mun.;2005;84;142;34;108
Šiauliai d. mun.;2005;85;547;114;433
Šiauliai d. mun.;2006;-1;49342;23405;25937
Šiauliai d. mun.;2006;0;409;206;203
Šiauliai d. mun.;2006;1;434;218;216
Šiauliai d. mun.;2006;2;496;266;230
Šiauliai d. mun.;2006;3;458;224;234
Šiauliai d. mun.;2006;4;511;267;244
Šiauliai d. mun.;2006;5;482;251;231
Šiauliai d. mun.;2006;6;602;316;286
Šiauliai d. mun.;2006;7;597;319;278
Šiauliai d. mun.;2006;8;566;288;278
Šiauliai d. mun.;2006;9;667;348;319
Šiauliai d. mun.;2006;10;664;349;315
Šiauliai d. mun.;2006;11;706;327;379
Šiauliai d. mun.;2006;12;775;419;356
Šiauliai d. mun.;2006;13;934;462;472
Šiauliai d. mun.;2006;14;920;466;454
Šiauliai d. mun.;2006;15;854;437;417
Šiauliai d. mun.;2006;16;851;419;432
Šiauliai d. mun.;2006;17;852;441;411
Šiauliai d. mun.;2006;18;833;419;414
Šiauliai d. mun.;2006;19;837;446;391
Šiauliai d. mun.;2006;20;781;377;404
Šiauliai d. mun.;2006;21;751;390;361
Šiauliai d. mun.;2006;22;730;372;358
Šiauliai d. mun.;2006;23;547;312;235
Šiauliai d. mun.;2006;24;543;313;230
Šiauliai d. mun.;2006;25;525;279;246
Šiauliai d. mun.;2006;26;496;291;205
Šiauliai d. mun.;2006;27;482;258;224
Šiauliai d. mun.;2006;28;455;228;227
Šiauliai d. mun.;2006;29;535;260;275
Šiauliai d. mun.;2006;30;559;279;280
Šiauliai d. mun.;2006;31;526;244;282
Šiauliai d. mun.;2006;32;575;277;298
Šiauliai d. mun.;2006;33;585;271;314
Šiauliai d. mun.;2006;34;622;301;321
Šiauliai d. mun.;2006;35;695;376;319
Šiauliai d. mun.;2006;36;685;333;352
Šiauliai d. mun.;2006;37;653;307;346
Šiauliai d. mun.;2006;38;669;316;353
Šiauliai d. mun.;2006;39;702;355;347
Šiauliai d. mun.;2006;40;713;336;377
Šiauliai d. mun.;2006;41;672;345;327
Šiauliai d. mun.;2006;42;685;347;338
Šiauliai d. mun.;2006;43;726;360;366
Šiauliai d. mun.;2006;44;818;401;417
Šiauliai d. mun.;2006;45;797;374;423
Šiauliai d. mun.;2006;46;792;418;374
Šiauliai d. mun.;2006;47;773;409;364
Šiauliai d. mun.;2006;48;718;348;370
Šiauliai d. mun.;2006;49;642;338;304
Šiauliai d. mun.;2006;50;616;296;320
Šiauliai d. mun.;2006;51;653;352;301
Šiauliai d. mun.;2006;52;510;245;265
Šiauliai d. mun.;2006;53;556;263;293
Šiauliai d. mun.;2006;54;586;279;307
Šiauliai d. mun.;2006;55;621;287;334
Šiauliai d. mun.;2006;56;558;266;292
Šiauliai d. mun.;2006;57;539;249;290
Šiauliai d. mun.;2006;58;464;219;245
Šiauliai d. mun.;2006;59;503;235;268
Šiauliai d. mun.;2006;60;516;232;284
Šiauliai d. mun.;2006;61;405;192;213
Šiauliai d. mun.;2006;62;490;213;277
Šiauliai d. mun.;2006;63;601;239;362
Šiauliai d. mun.;2006;64;571;245;326
Šiauliai d. mun.;2006;65;481;207;274
Šiauliai d. mun.;2006;66;550;237;313
Šiauliai d. mun.;2006;67;491;216;275
Šiauliai d. mun.;2006;68;529;198;331
Šiauliai d. mun.;2006;69;500;181;319
Šiauliai d. mun.;2006;70;480;195;285
Šiauliai d. mun.;2006;71;467;168;299
Šiauliai d. mun.;2006;72;447;171;276
Šiauliai d. mun.;2006;73;468;159;309
Šiauliai d. mun.;2006;74;449;178;271
Šiauliai d. mun.;2006;75;403;133;270
Šiauliai d. mun.;2006;76;360;119;241
Šiauliai d. mun.;2006;77;376;113;263
Šiauliai d. mun.;2006;78;327;109;218
Šiauliai d. mun.;2006;79;268;72;196
Šiauliai d. mun.;2006;80;258;60;198
Šiauliai d. mun.;2006;81;240;68;172
Šiauliai d. mun.;2006;82;240;75;165
Šiauliai d. mun.;2006;83;209;60;149
Šiauliai d. mun.;2006;84;158;43;115
Šiauliai d. mun.;2006;85;552;128;424
Šiauliai d. mun.;2007;-1;48624;23061;25563
Šiauliai d. mun.;2007;0;411;221;190
Šiauliai d. mun.;2007;1;409;205;204
Šiauliai d. mun.;2007;2;424;211;213
Šiauliai d. mun.;2007;3;488;260;228
Šiauliai d. mun.;2007;4;455;226;229
Šiauliai d. mun.;2007;5;507;265;242
Šiauliai d. mun.;2007;6;477;247;230
Šiauliai d. mun.;2007;7;594;313;281
Šiauliai d. mun.;2007;8;597;318;279
Šiauliai d. mun.;2007;9;563;289;274
Šiauliai d. mun.;2007;10;667;347;320
Šiauliai d. mun.;2007;11;661;349;312
Šiauliai d. mun.;2007;12;699;326;373
Šiauliai d. mun.;2007;13;777;421;356
Šiauliai d. mun.;2007;14;923;460;463
Šiauliai d. mun.;2007;15;914;466;448
Šiauliai d. mun.;2007;16;842;435;407
Šiauliai d. mun.;2007;17;837;410;427
Šiauliai d. mun.;2007;18;832;430;402
Šiauliai d. mun.;2007;19;816;410;406
Šiauliai d. mun.;2007;20;817;434;383
Šiauliai d. mun.;2007;21;762;366;396
Šiauliai d. mun.;2007;22;728;381;347
Šiauliai d. mun.;2007;23;699;351;348
Šiauliai d. mun.;2007;24;533;303;230
Šiauliai d. mun.;2007;25;506;293;213
Šiauliai d. mun.;2007;26;518;274;244
Šiauliai d. mun.;2007;27;486;285;201
Šiauliai d. mun.;2007;28;472;255;217
Šiauliai d. mun.;2007;29;439;222;217
Šiauliai d. mun.;2007;30;529;257;272
Šiauliai d. mun.;2007;31;550;275;275
Šiauliai d. mun.;2007;32;514;239;275
Šiauliai d. mun.;2007;33;560;274;286
Šiauliai d. mun.;2007;34;582;268;314
Šiauliai d. mun.;2007;35;615;295;320
Šiauliai d. mun.;2007;36;685;369;316
Šiauliai d. mun.;2007;37;672;331;341
Šiauliai d. mun.;2007;38;647;309;338
Šiauliai d. mun.;2007;39;671;316;355
Šiauliai d. mun.;2007;40;695;354;341
Šiauliai d. mun.;2007;41;705;331;374
Šiauliai d. mun.;2007;42;670;343;327
Šiauliai d. mun.;2007;43;678;344;334
Šiauliai d. mun.;2007;44;720;355;365
Šiauliai d. mun.;2007;45;811;399;412
Šiauliai d. mun.;2007;46;789;366;423
Šiauliai d. mun.;2007;47;779;411;368
Šiauliai d. mun.;2007;48;764;402;362
Šiauliai d. mun.;2007;49;710;340;370
Šiauliai d. mun.;2007;50;633;330;303
Šiauliai d. mun.;2007;51;602;286;316
Šiauliai d. mun.;2007;52;652;348;304
Šiauliai d. mun.;2007;53;500;240;260
Šiauliai d. mun.;2007;54;546;256;290
Šiauliai d. mun.;2007;55;581;276;305
Šiauliai d. mun.;2007;56;608;277;331
Šiauliai d. mun.;2007;57;547;256;291
Šiauliai d. mun.;2007;58;529;241;288
Šiauliai d. mun.;2007;59;458;218;240
Šiauliai d. mun.;2007;60;493;226;267
Šiauliai d. mun.;2007;61;500;223;277
Šiauliai d. mun.;2007;62;396;188;208
Šiauliai d. mun.;2007;63;474;203;271
Šiauliai d. mun.;2007;64;592;233;359
Šiauliai d. mun.;2007;65;561;237;324
Šiauliai d. mun.;2007;66;467;197;270
Šiauliai d. mun.;2007;67;536;225;311
Šiauliai d. mun.;2007;68;470;205;265
Šiauliai d. mun.;2007;69;516;191;325
Šiauliai d. mun.;2007;70;485;174;311
Šiauliai d. mun.;2007;71;468;184;284
Šiauliai d. mun.;2007;72;453;163;290
Šiauliai d. mun.;2007;73;420;157;263
Šiauliai d. mun.;2007;74;445;150;295
Šiauliai d. mun.;2007;75;436;171;265
Šiauliai d. mun.;2007;76;381;121;260
Šiauliai d. mun.;2007;77;340;108;232
Šiauliai d. mun.;2007;78;352;106;246
Šiauliai d. mun.;2007;79;307;99;208
Šiauliai d. mun.;2007;80;244;60;184
Šiauliai d. mun.;2007;81;230;54;176
Šiauliai d. mun.;2007;82;219;58;161
Šiauliai d. mun.;2007;83;222;67;155
Šiauliai d. mun.;2007;84;183;47;136
Šiauliai d. mun.;2007;85;579;135;444
Šiauliai d. mun.;2008;-1;48124;22783;25341
Šiauliai d. mun.;2008;0;441;225;216
Šiauliai d. mun.;2008;1;408;221;187
Šiauliai d. mun.;2008;2;416;205;211
Šiauliai d. mun.;2008;3;426;215;211
Šiauliai d. mun.;2008;4;485;259;226
Šiauliai d. mun.;2008;5;457;227;230
Šiauliai d. mun.;2008;6;506;265;241
Šiauliai d. mun.;2008;7;464;240;224
Šiauliai d. mun.;2008;8;595;310;285
Šiauliai d. mun.;2008;9;605;323;282
Šiauliai d. mun.;2008;10;562;288;274
Šiauliai d. mun.;2008;11;660;344;316
Šiauliai d. mun.;2008;12;663;351;312
Šiauliai d. mun.;2008;13;694;321;373
Šiauliai d. mun.;2008;14;771;418;353
Šiauliai d. mun.;2008;15;921;458;463
Šiauliai d. mun.;2008;16;908;459;449
Šiauliai d. mun.;2008;17;839;432;407
Šiauliai d. mun.;2008;18;827;406;421
Šiauliai d. mun.;2008;19;807;418;389
Šiauliai d. mun.;2008;20;800;401;399
Šiauliai d. mun.;2008;21;799;425;374
Šiauliai d. mun.;2008;22;732;354;378
Šiauliai d. mun.;2008;23;719;374;345
Šiauliai d. mun.;2008;24;691;345;346
Šiauliai d. mun.;2008;25;527;296;231
Šiauliai d. mun.;2008;26;486;286;200
Šiauliai d. mun.;2008;27;497;262;235
Šiauliai d. mun.;2008;28;468;277;191
Šiauliai d. mun.;2008;29;462;250;212
Šiauliai d. mun.;2008;30;440;218;222
Šiauliai d. mun.;2008;31;509;243;266
Šiauliai d. mun.;2008;32;549;274;275
Šiauliai d. mun.;2008;33;511;237;274
Šiauliai d. mun.;2008;34;557;275;282
Šiauliai d. mun.;2008;35;581;264;317
Šiauliai d. mun.;2008;36;621;298;323
Šiauliai d. mun.;2008;37;671;363;308
Šiauliai d. mun.;2008;38;682;339;343
Šiauliai d. mun.;2008;39;645;308;337
Šiauliai d. mun.;2008;40;662;314;348
Šiauliai d. mun.;2008;41;693;357;336
Šiauliai d. mun.;2008;42;702;330;372
Šiauliai d. mun.;2008;43;656;336;320
Šiauliai d. mun.;2008;44;663;335;328
Šiauliai d. mun.;2008;45;713;356;357
Šiauliai d. mun.;2008;46;802;393;409
Šiauliai d. mun.;2008;47;781;363;418
Šiauliai d. mun.;2008;48;771;405;366
Šiauliai d. mun.;2008;49;756;395;361
Šiauliai d. mun.;2008;50;708;340;368
Šiauliai d. mun.;2008;51;633;329;304
Šiauliai d. mun.;2008;52;593;278;315
Šiauliai d. mun.;2008;53;646;340;306
Šiauliai d. mun.;2008;54;494;230;264
Šiauliai d. mun.;2008;55;546;253;293
Šiauliai d. mun.;2008;56;574;270;304
Šiauliai d. mun.;2008;57;605;277;328
Šiauliai d. mun.;2008;58;545;256;289
Šiauliai d. mun.;2008;59;530;238;292
Šiauliai d. mun.;2008;60;444;210;234
Šiauliai d. mun.;2008;61;485;216;269
Šiauliai d. mun.;2008;62;491;215;276
Šiauliai d. mun.;2008;63;385;184;201
Šiauliai d. mun.;2008;64;460;194;266
Šiauliai d. mun.;2008;65;576;226;350
Šiauliai d. mun.;2008;66;548;226;322
Šiauliai d. mun.;2008;67;451;184;267
Šiauliai d. mun.;2008;68;514;213;301
Šiauliai d. mun.;2008;69;463;197;266
Šiauliai d. mun.;2008;70;502;184;318
Šiauliai d. mun.;2008;71;466;161;305
Šiauliai d. mun.;2008;72;447;169;278
Šiauliai d. mun.;2008;73;435;148;287
Šiauliai d. mun.;2008;74;401;146;255
Šiauliai d. mun.;2008;75;415;131;284
Šiauliai d. mun.;2008;76;408;158;250
Šiauliai d. mun.;2008;77;369;119;250
Šiauliai d. mun.;2008;78;310;92;218
Šiauliai d. mun.;2008;79;329;98;231
Šiauliai d. mun.;2008;80;287;90;197
Šiauliai d. mun.;2008;81;232;58;174
Šiauliai d. mun.;2008;82;209;44;165
Šiauliai d. mun.;2008;83;206;54;152
Šiauliai d. mun.;2008;84;195;59;136
Šiauliai d. mun.;2008;85;621;138;483
Šiauliai d. mun.;2009;-1;47883;22688;25195
Šiauliai d. mun.;2009;0;456;242;214
Šiauliai d. mun.;2009;1;440;223;217
Šiauliai d. mun.;2009;2;412;221;191
Šiauliai d. mun.;2009;3;417;204;213
Šiauliai d. mun.;2009;4;432;220;212
Šiauliai d. mun.;2009;5;483;261;222
Šiauliai d. mun.;2009;6;466;235;231
Šiauliai d. mun.;2009;7;508;262;246
Šiauliai d. mun.;2009;8;469;246;223
Šiauliai d. mun.;2009;9;598;313;285
Šiauliai d. mun.;2009;10;601;316;285
Šiauliai d. mun.;2009;11;570;291;279
Šiauliai d. mun.;2009;12;668;348;320
Šiauliai d. mun.;2009;13;666;354;312
Šiauliai d. mun.;2009;14;713;332;381
Šiauliai d. mun.;2009;15;773;418;355
Šiauliai d. mun.;2009;16;921;458;463
Šiauliai d. mun.;2009;17;911;466;445
Šiauliai d. mun.;2009;18;843;435;408
Šiauliai d. mun.;2009;19;822;403;419
Šiauliai d. mun.;2009;20;805;418;387
Šiauliai d. mun.;2009;21;787;398;389
Šiauliai d. mun.;2009;22;792;424;368
Šiauliai d. mun.;2009;23;716;346;370
Šiauliai d. mun.;2009;24;701;368;333
Šiauliai d. mun.;2009;25;666;343;323
Šiauliai d. mun.;2009;26;521;294;227
Šiauliai d. mun.;2009;27;483;284;199
Šiauliai d. mun.;2009;28;482;255;227
Šiauliai d. mun.;2009;29;467;274;193
Šiauliai d. mun.;2009;30;453;248;205
Šiauliai d. mun.;2009;31;434;215;219
Šiauliai d. mun.;2009;32;501;235;266
Šiauliai d. mun.;2009;33;554;279;275
Šiauliai d. mun.;2009;34;513;239;274
Šiauliai d. mun.;2009;35;553;271;282
Šiauliai d. mun.;2009;36;576;262;314
Šiauliai d. mun.;2009;37;620;294;326
Šiauliai d. mun.;2009;38;667;358;309
Šiauliai d. mun.;2009;39;677;339;338
Šiauliai d. mun.;2009;40;640;306;334
Šiauliai d. mun.;2009;41;655;311;344
Šiauliai d. mun.;2009;42;691;356;335
Šiauliai d. mun.;2009;43;706;331;375
Šiauliai d. mun.;2009;44;647;332;315
Šiauliai d. mun.;2009;45;659;337;322
Šiauliai d. mun.;2009;46;710;352;358
Šiauliai d. mun.;2009;47;795;384;411
Šiauliai d. mun.;2009;48;781;362;419
Šiauliai d. mun.;2009;49;764;398;366
Šiauliai d. mun.;2009;50;756;394;362
Šiauliai d. mun.;2009;51;710;344;366
Šiauliai d. mun.;2009;52;630;323;307
Šiauliai d. mun.;2009;53;579;270;309
Šiauliai d. mun.;2009;54;638;334;304
Šiauliai d. mun.;2009;55;483;223;260
Šiauliai d. mun.;2009;56;541;251;290
Šiauliai d. mun.;2009;57;558;258;300
Šiauliai d. mun.;2009;58;593;269;324
Šiauliai d. mun.;2009;59;537;252;285
Šiauliai d. mun.;2009;60;521;231;290
Šiauliai d. mun.;2009;61;434;203;231
Šiauliai d. mun.;2009;62;486;215;271
Šiauliai d. mun.;2009;63;483;211;272
Šiauliai d. mun.;2009;64;373;175;198
Šiauliai d. mun.;2009;65;454;188;266
Šiauliai d. mun.;2009;66;558;212;346
Šiauliai d. mun.;2009;67;547;225;322
Šiauliai d. mun.;2009;68;436;174;262
Šiauliai d. mun.;2009;69;503;207;296
Šiauliai d. mun.;2009;70;457;193;264
Šiauliai d. mun.;2009;71;492;180;312
Šiauliai d. mun.;2009;72;452;155;297
Šiauliai d. mun.;2009;73;433;160;273
Šiauliai d. mun.;2009;74;414;136;278
Šiauliai d. mun.;2009;75;385;137;248
Šiauliai d. mun.;2009;76;405;127;278
Šiauliai d. mun.;2009;77;375;139;236
Šiauliai d. mun.;2009;78;341;103;238
Šiauliai d. mun.;2009;79;297;86;211
Šiauliai d. mun.;2009;80;296;82;214
Šiauliai d. mun.;2009;81;265;84;181
Šiauliai d. mun.;2009;82;202;48;154
Šiauliai d. mun.;2009;83;189;37;152
Šiauliai d. mun.;2009;84;185;44;141
Šiauliai d. mun.;2009;85;690;157;533
Šiauliai d. mun.;2010;-1;46779;22206;24573
Šiauliai d. mun.;2010;0;436;228;208
Šiauliai d. mun.;2010;1;438;239;199
Šiauliai d. mun.;2010;2;400;206;194
Šiauliai d. mun.;2010;3;403;217;186
Šiauliai d. mun.;2010;4;406;197;209
Šiauliai d. mun.;2010;5;405;211;194
Šiauliai d. mun.;2010;6;470;257;213
Šiauliai d. mun.;2010;7;460;233;227
Šiauliai d. mun.;2010;8;500;262;238
Šiauliai d. mun.;2010;9;460;241;219
Šiauliai d. mun.;2010;10;582;308;274
Šiauliai d. mun.;2010;11;597;315;282
Šiauliai d. mun.;2010;12;571;290;281
Šiauliai d. mun.;2010;13;662;349;313
Šiauliai d. mun.;2010;14;649;341;308
Šiauliai d. mun.;2010;15;719;338;381
Šiauliai d. mun.;2010;16;777;422;355
Šiauliai d. mun.;2010;17;906;448;458
Šiauliai d. mun.;2010;18;900;462;438
Šiauliai d. mun.;2010;19;824;423;401
Šiauliai d. mun.;2010;20;802;398;404
Šiauliai d. mun.;2010;21;785;410;375
Šiauliai d. mun.;2010;22;752;384;368
Šiauliai d. mun.;2010;23;753;400;353
Šiauliai d. mun.;2010;24;673;329;344
Šiauliai d. mun.;2010;25;665;353;312
Šiauliai d. mun.;2010;26;595;302;293
Šiauliai d. mun.;2010;27;486;277;209
Šiauliai d. mun.;2010;28;446;266;180
Šiauliai d. mun.;2010;29;454;246;208
Šiauliai d. mun.;2010;30;431;259;172
Šiauliai d. mun.;2010;31;432;230;202
Šiauliai d. mun.;2010;32;404;208;196
Šiauliai d. mun.;2010;33;483;226;257
Šiauliai d. mun.;2010;34;535;276;259
Šiauliai d. mun.;2010;35;500;234;266
Šiauliai d. mun.;2010;36;534;267;267
Šiauliai d. mun.;2010;37;556;252;304
Šiauliai d. mun.;2010;38;601;286;315
Šiauliai d. mun.;2010;39;646;344;302
Šiauliai d. mun.;2010;40;665;330;335
Šiauliai d. mun.;2010;41;625;296;329
Šiauliai d. mun.;2010;42;649;307;342
Šiauliai d. mun.;2010;43;681;349;332
Šiauliai d. mun.;2010;44;697;322;375
Šiauliai d. mun.;2010;45;631;323;308
Šiauliai d. mun.;2010;46;653;336;317
Šiauliai d. mun.;2010;47;694;340;354
Šiauliai d. mun.;2010;48;784;378;406
Šiauliai d. mun.;2010;49;769;359;410
Šiauliai d. mun.;2010;50;757;393;364
Šiauliai d. mun.;2010;51;744;381;363
Šiauliai d. mun.;2010;52;699;338;361
Šiauliai d. mun.;2010;53;615;318;297
Šiauliai d. mun.;2010;54;574;266;308
Šiauliai d. mun.;2010;55;623;325;298
Šiauliai d. mun.;2010;56;472;212;260
Šiauliai d. mun.;2010;57;538;246;292
Šiauliai d. mun.;2010;58;551;255;296
Šiauliai d. mun.;2010;59;584;267;317
Šiauliai d. mun.;2010;60;529;245;284
Šiauliai d. mun.;2010;61;511;228;283
Šiauliai d. mun.;2010;62;427;198;229
Šiauliai d. mun.;2010;63;478;210;268
Šiauliai d. mun.;2010;64;467;202;265
Šiauliai d. mun.;2010;65;360;168;192
Šiauliai d. mun.;2010;66;445;180;265
Šiauliai d. mun.;2010;67;549;207;342
Šiauliai d. mun.;2010;68;535;217;318
Šiauliai d. mun.;2010;69;423;163;260
Šiauliai d. mun.;2010;70;486;197;289
Šiauliai d. mun.;2010;71;443;186;257
Šiauliai d. mun.;2010;72;479;174;305
Šiauliai d. mun.;2010;73;435;148;287
Šiauliai d. mun.;2010;74;420;156;264
Šiauliai d. mun.;2010;75;394;130;264
Šiauliai d. mun.;2010;76;361;125;236
Šiauliai d. mun.;2010;77;378;116;262
Šiauliai d. mun.;2010;78;352;129;223
Šiauliai d. mun.;2010;79;319;92;227
Šiauliai d. mun.;2010;80;278;81;197
Šiauliai d. mun.;2010;81;273;68;205
Šiauliai d. mun.;2010;82;247;74;173
Šiauliai d. mun.;2010;83;190;40;150
Šiauliai d. mun.;2010;84;177;34;143
Šiauliai d. mun.;2010;85;720;163;557
Šiauliai d. mun.;2011;-1;44561;21167;23394
Šiauliai d. mun.;2011;0;357;170;187
Šiauliai d. mun.;2011;1;422;227;195
Šiauliai d. mun.;2011;2;422;231;191
Šiauliai d. mun.;2011;3;377;190;187
Šiauliai d. mun.;2011;4;381;212;169
Šiauliai d. mun.;2011;5;385;182;203
Šiauliai d. mun.;2011;6;413;210;203
Šiauliai d. mun.;2011;7;427;244;183
Šiauliai d. mun.;2011;8;400;210;190
Šiauliai d. mun.;2011;9;492;252;240
Šiauliai d. mun.;2011;10;470;241;229
Šiauliai d. mun.;2011;11;562;286;276
Šiauliai d. mun.;2011;12;587;320;267
Šiauliai d. mun.;2011;13;541;286;255
Šiauliai d. mun.;2011;14;629;336;293
Šiauliai d. mun.;2011;15;646;353;293
Šiauliai d. mun.;2011;16;683;321;362
Šiauliai d. mun.;2011;17;753;412;341
Šiauliai d. mun.;2011;18;840;414;426
Šiauliai d. mun.;2011;19;724;383;341
Šiauliai d. mun.;2011;20;646;350;296
Šiauliai d. mun.;2011;21;583;297;286
Šiauliai d. mun.;2011;22;571;319;252
Šiauliai d. mun.;2011;23;533;293;240
Šiauliai d. mun.;2011;24;506;269;237
Šiauliai d. mun.;2011;25;472;231;241
Šiauliai d. mun.;2011;26;457;250;207
Šiauliai d. mun.;2011;27;458;228;230
Šiauliai d. mun.;2011;28;464;239;225
Šiauliai d. mun.;2011;29;472;240;232
Šiauliai d. mun.;2011;30;481;242;239
Šiauliai d. mun.;2011;31;467;242;225
Šiauliai d. mun.;2011;32;447;225;222
Šiauliai d. mun.;2011;33;441;226;215
Šiauliai d. mun.;2011;34;533;251;282
Šiauliai d. mun.;2011;35;552;263;289
Šiauliai d. mun.;2011;36;538;248;290
Šiauliai d. mun.;2011;37;599;307;292
Šiauliai d. mun.;2011;38;610;275;335
Šiauliai d. mun.;2011;39;606;299;307
Šiauliai d. mun.;2011;40;702;360;342
Šiauliai d. mun.;2011;41;675;340;335
Šiauliai d. mun.;2011;42;690;346;344
Šiauliai d. mun.;2011;43;679;316;363
Šiauliai d. mun.;2011;44;695;345;350
Šiauliai d. mun.;2011;45;715;358;357
Šiauliai d. mun.;2011;46;660;352;308
Šiauliai d. mun.;2011;47;634;329;305
Šiauliai d. mun.;2011;48;696;351;345
Šiauliai d. mun.;2011;49;779;381;398
Šiauliai d. mun.;2011;50;738;346;392
Šiauliai d. mun.;2011;51;758;388;370
Šiauliai d. mun.;2011;52;707;361;346
Šiauliai d. mun.;2011;53;683;319;364
Šiauliai d. mun.;2011;54;596;314;282
Šiauliai d. mun.;2011;55;570;279;291
Šiauliai d. mun.;2011;56;572;305;267
Šiauliai d. mun.;2011;57;476;222;254
Šiauliai d. mun.;2011;58;541;242;299
Šiauliai d. mun.;2011;59;535;255;280
Šiauliai d. mun.;2011;60;583;264;319
Šiauliai d. mun.;2011;61;494;226;268
Šiauliai d. mun.;2011;62;493;220;273
Šiauliai d. mun.;2011;63;432;203;229
Šiauliai d. mun.;2011;64;470;209;261
Šiauliai d. mun.;2011;65;455;191;264
Šiauliai d. mun.;2011;66;362;165;197
Šiauliai d. mun.;2011;67;429;173;256
Šiauliai d. mun.;2011;68;531;208;323
Šiauliai d. mun.;2011;69;499;190;309
Šiauliai d. mun.;2011;70;407;158;249
Šiauliai d. mun.;2011;71;441;167;274
Šiauliai d. mun.;2011;72;409;165;244
Šiauliai d. mun.;2011;73;446;158;288
Šiauliai d. mun.;2011;74;414;131;283
Šiauliai d. mun.;2011;75;390;141;249
Šiauliai d. mun.;2011;76;368;119;249
Šiauliai d. mun.;2011;77;344;122;222
Šiauliai d. mun.;2011;78;341;103;238
Šiauliai d. mun.;2011;79;322;115;207
Šiauliai d. mun.;2011;80;286;86;200
Šiauliai d. mun.;2011;81;251;71;180
Šiauliai d. mun.;2011;82;248;61;187
Šiauliai d. mun.;2011;83;214;57;157
Šiauliai d. mun.;2011;84;172;35;137
Šiauliai d. mun.;2011;85;712;146;566
Šiauliai d. mun.;2012;-1;43374;20596;22778
Šiauliai d. mun.;2012;0;360;205;155
Šiauliai d. mun.;2012;1;337;157;180
Šiauliai d. mun.;2012;2;372;197;175
Šiauliai d. mun.;2012;3;403;211;192
Šiauliai d. mun.;2012;4;368;193;175
Šiauliai d. mun.;2012;5;390;215;175
Šiauliai d. mun.;2012;6;379;184;195
Šiauliai d. mun.;2012;7;402;201;201
Šiauliai d. mun.;2012;8;417;236;181
Šiauliai d. mun.;2012;9;384;199;185
Šiauliai d. mun.;2012;10;480;245;235
Šiauliai d. mun.;2012;11;466;237;229
Šiauliai d. mun.;2012;12;559;283;276
Šiauliai d. mun.;2012;13;578;316;262
Šiauliai d. mun.;2012;14;538;289;249
Šiauliai d. mun.;2012;15;622;333;289
Šiauliai d. mun.;2012;16;649;356;293
Šiauliai d. mun.;2012;17;685;321;364
Šiauliai d. mun.;2012;18;732;404;328
Šiauliai d. mun.;2012;19;796;406;390
Šiauliai d. mun.;2012;20;690;360;330
Šiauliai d. mun.;2012;21;609;333;276
Šiauliai d. mun.;2012;22;530;268;262
Šiauliai d. mun.;2012;23;506;284;222
Šiauliai d. mun.;2012;24;485;270;215
Šiauliai d. mun.;2012;25;457;247;210
Šiauliai d. mun.;2012;26;420;215;205
Šiauliai d. mun.;2012;27;412;231;181
Šiauliai d. mun.;2012;28;420;208;212
Šiauliai d. mun.;2012;29;434;225;209
Šiauliai d. mun.;2012;30;452;230;222
Šiauliai d. mun.;2012;31;450;222;228
Šiauliai d. mun.;2012;32;442;232;210
Šiauliai d. mun.;2012;33;428;211;217
Šiauliai d. mun.;2012;34;413;206;207
Šiauliai d. mun.;2012;35;510;236;274
Šiauliai d. mun.;2012;36;536;257;279
Šiauliai d. mun.;2012;37;527;238;289
Šiauliai d. mun.;2012;38;588;298;290
Šiauliai d. mun.;2012;39;610;275;335
Šiauliai d. mun.;2012;40;601;303;298
Šiauliai d. mun.;2012;41;700;356;344
Šiauliai d. mun.;2012;42;662;333;329
Šiauliai d. mun.;2012;43;682;339;343
Šiauliai d. mun.;2012;44;657;297;360
Šiauliai d. mun.;2012;45;684;340;344
Šiauliai d. mun.;2012;46;707;357;350
Šiauliai d. mun.;2012;47;657;349;308
Šiauliai d. mun.;2012;48;625;324;301
Šiauliai d. mun.;2012;49;679;338;341
Šiauliai d. mun.;2012;50;764;372;392
Šiauliai d. mun.;2012;51;733;339;394
Šiauliai d. mun.;2012;52;748;377;371
Šiauliai d. mun.;2012;53;693;357;336
Šiauliai d. mun.;2012;54;680;317;363
Šiauliai d. mun.;2012;55;587;308;279
Šiauliai d. mun.;2012;56;559;279;280
Šiauliai d. mun.;2012;57;568;304;264
Šiauliai d. mun.;2012;58;468;217;251
Šiauliai d. mun.;2012;59;535;240;295
Šiauliai d. mun.;2012;60;524;250;274
Šiauliai d. mun.;2012;61;571;254;317
Šiauliai d. mun.;2012;62;480;217;263
Šiauliai d. mun.;2012;63;482;212;270
Šiauliai d. mun.;2012;64;424;198;226
Šiauliai d. mun.;2012;65;463;208;255
Šiauliai d. mun.;2012;66;440;185;255
Šiauliai d. mun.;2012;67;360;163;197
Šiauliai d. mun.;2012;68;418;169;249
Šiauliai d. mun.;2012;69;530;209;321
Šiauliai d. mun.;2012;70;479;175;304
Šiauliai d. mun.;2012;71;394;150;244
Šiauliai d. mun.;2012;72;430;162;268
Šiauliai d. mun.;2012;73;387;154;233
Šiauliai d. mun.;2012;74;425;147;278
Šiauliai d. mun.;2012;75;399;123;276
Šiauliai d. mun.;2012;76;369;129;240
Šiauliai d. mun.;2012;77;353;115;238
Šiauliai d. mun.;2012;78;327;112;215
Šiauliai d. mun.;2012;79;326;95;231
Šiauliai d. mun.;2012;80;302;103;199
Šiauliai d. mun.;2012;81;263;76;187
Šiauliai d. mun.;2012;82;233;67;166
Šiauliai d. mun.;2012;83;228;51;177
Šiauliai d. mun.;2012;84;190;46;144
Šiauliai d. mun.;2012;85;752;146;606
Šiauliai d. mun.;2013;-1;42748;20308;22440
Šiauliai d. mun.;2013;0;396;202;194
Šiauliai d. mun.;2013;1;356;198;158
Šiauliai d. mun.;2013;2;311;143;168
Šiauliai d. mun.;2013;3;362;192;170
Šiauliai d. mun.;2013;4;410;213;197
Šiauliai d. mun.;2013;5;366;188;178
Šiauliai d. mun.;2013;6;384;205;179
Šiauliai d. mun.;2013;7;379;180;199
Šiauliai d. mun.;2013;8;393;197;196
Šiauliai d. mun.;2013;9;423;237;186
Šiauliai d. mun.;2013;10;369;194;175
Šiauliai d. mun.;2013;11;473;242;231
Šiauliai d. mun.;2013;12;458;229;229
Šiauliai d. mun.;2013;13;560;281;279
Šiauliai d. mun.;2013;14;565;306;259
Šiauliai d. mun.;2013;15;532;289;243
Šiauliai d. mun.;2013;16;620;330;290
Šiauliai d. mun.;2013;17;653;356;297
Šiauliai d. mun.;2013;18;663;311;352
Šiauliai d. mun.;2013;19;707;390;317
Šiauliai d. mun.;2013;20;780;407;373
Šiauliai d. mun.;2013;21;663;343;320
Šiauliai d. mun.;2013;22;571;308;263
Šiauliai d. mun.;2013;23;501;260;241
Šiauliai d. mun.;2013;24;475;272;203
Šiauliai d. mun.;2013;25;459;249;210
Šiauliai d. mun.;2013;26;416;228;188
Šiauliai d. mun.;2013;27;387;197;190
Šiauliai d. mun.;2013;28;387;214;173
Šiauliai d. mun.;2013;29;403;204;199
Šiauliai d. mun.;2013;30;421;220;201
Šiauliai d. mun.;2013;31;438;220;218
Šiauliai d. mun.;2013;32;454;230;224
Šiauliai d. mun.;2013;33;446;237;209
Šiauliai d. mun.;2013;34;416;208;208
Šiauliai d. mun.;2013;35;417;211;206
Šiauliai d. mun.;2013;36;504;239;265
Šiauliai d. mun.;2013;37;537;259;278
Šiauliai d. mun.;2013;38;515;225;290
Šiauliai d. mun.;2013;39;590;301;289
Šiauliai d. mun.;2013;40;615;279;336
Šiauliai d. mun.;2013;41;599;305;294
Šiauliai d. mun.;2013;42;692;351;341
Šiauliai d. mun.;2013;43;668;333;335
Šiauliai d. mun.;2013;44;688;343;345
Šiauliai d. mun.;2013;45;657;301;356
Šiauliai d. mun.;2013;46;681;344;337
Šiauliai d. mun.;2013;47;707;358;349
Šiauliai d. mun.;2013;48;652;353;299
Šiauliai d. mun.;2013;49;622;322;300
Šiauliai d. mun.;2013;50;677;332;345
Šiauliai d. mun.;2013;51;766;373;393
Šiauliai d. mun.;2013;52;723;333;390
Šiauliai d. mun.;2013;53;741;368;373
Šiauliai d. mun.;2013;54;687;354;333
Šiauliai d. mun.;2013;55;676;316;360
Šiauliai d. mun.;2013;56;581;301;280
Šiauliai d. mun.;2013;57;552;275;277
Šiauliai d. mun.;2013;58;564;305;259
Šiauliai d. mun.;2013;59;463;210;253
Šiauliai d. mun.;2013;60;529;233;296
Šiauliai d. mun.;2013;61;517;245;272
Šiauliai d. mun.;2013;62;561;245;316
Šiauliai d. mun.;2013;63;483;220;263
Šiauliai d. mun.;2013;64;478;207;271
Šiauliai d. mun.;2013;65;413;191;222
Šiauliai d. mun.;2013;66;454;208;246
Šiauliai d. mun.;2013;67;427;178;249
Šiauliai d. mun.;2013;68;354;156;198
Šiauliai d. mun.;2013;69;406;160;246
Šiauliai d. mun.;2013;70;517;201;316
Šiauliai d. mun.;2013;71;476;170;306
Šiauliai d. mun.;2013;72;383;144;239
Šiauliai d. mun.;2013;73;411;151;260
Šiauliai d. mun.;2013;74;375;149;226
Šiauliai d. mun.;2013;75;408;135;273
Šiauliai d. mun.;2013;76;376;112;264
Šiauliai d. mun.;2013;77;354;120;234
Šiauliai d. mun.;2013;78;326;104;222
Šiauliai d. mun.;2013;79;305;100;205
Šiauliai d. mun.;2013;80;301;84;217
Šiauliai d. mun.;2013;81;278;94;184
Šiauliai d. mun.;2013;82;242;68;174
Šiauliai d. mun.;2013;83;206;63;143
Šiauliai d. mun.;2013;84;210;47;163
Šiauliai d. mun.;2013;85;787;152;635
Šiauliai d. mun.;2014;-1;42197;20096;22101
Šiauliai d. mun.;2014;0;379;188;191
Šiauliai d. mun.;2014;1;395;201;194
Šiauliai d. mun.;2014;2;331;185;146
Šiauliai d. mun.;2014;3;318;150;168
Šiauliai d. mun.;2014;4;362;197;165
Šiauliai d. mun.;2014;5;417;210;207
Šiauliai d. mun.;2014;6;357;181;176
Šiauliai d. mun.;2014;7;382;203;179
Šiauliai d. mun.;2014;8;378;179;199
Šiauliai d. mun.;2014;9;388;196;192
Šiauliai d. mun.;2014;10;411;232;179
Šiauliai d. mun.;2014;11;356;185;171
Šiauliai d. mun.;2014;12;466;237;229
Šiauliai d. mun.;2014;13;461;233;228
Šiauliai d. mun.;2014;14;553;279;274
Šiauliai d. mun.;2014;15;565;312;253
Šiauliai d. mun.;2014;16;534;291;243
Šiauliai d. mun.;2014;17;613;330;283
Šiauliai d. mun.;2014;18;643;350;293
Šiauliai d. mun.;2014;19;653;308;345
Šiauliai d. mun.;2014;20;690;375;315
Šiauliai d. mun.;2014;21;755;394;361
Šiauliai d. mun.;2014;22;653;348;305
Šiauliai d. mun.;2014;23;550;302;248
Šiauliai d. mun.;2014;24;488;259;229
Šiauliai d. mun.;2014;25;447;264;183
Šiauliai d. mun.;2014;26;422;232;190
Šiauliai d. mun.;2014;27;388;216;172
Šiauliai d. mun.;2014;28;362;183;179
Šiauliai d. mun.;2014;29;359;203;156
Šiauliai d. mun.;2014;30;386;191;195
Šiauliai d. mun.;2014;31;424;223;201
Šiauliai d. mun.;2014;32;429;218;211
Šiauliai d. mun.;2014;33;437;223;214
Šiauliai d. mun.;2014;34;446;237;209
Šiauliai d. mun.;2014;35;416;211;205
Šiauliai d. mun.;2014;36;398;200;198
Šiauliai d. mun.;2014;37;501;229;272
Šiauliai d. mun.;2014;38;539;264;275
Šiauliai d. mun.;2014;39;514;223;291
Šiauliai d. mun.;2014;40;575;289;286
Šiauliai d. mun.;2014;41;608;277;331
Šiauliai d. mun.;2014;42;602;309;293
Šiauliai d. mun.;2014;43;680;345;335
Šiauliai d. mun.;2014;44;663;331;332
Šiauliai d. mun.;2014;45;684;342;342
Šiauliai d. mun.;2014;46;657;302;355
Šiauliai d. mun.;2014;47;671;336;335
Šiauliai d. mun.;2014;48;714;365;349
Šiauliai d. mun.;2014;49;650;347;303
Šiauliai d. mun.;2014;50;627;327;300
Šiauliai d. mun.;2014;51;679;334;345
Šiauliai d. mun.;2014;52;756;370;386
Šiauliai d. mun.;2014;53;710;323;387
Šiauliai d. mun.;2014;54;742;370;372
Šiauliai d. mun.;2014;55;687;351;336
Šiauliai d. mun.;2014;56;682;314;368
Šiauliai d. mun.;2014;57;583;302;281
Šiauliai d. mun.;2014;58;543;270;273
Šiauliai d. mun.;2014;59;556;294;262
Šiauliai d. mun.;2014;60;465;208;257
Šiauliai d. mun.;2014;61;519;227;292
Šiauliai d. mun.;2014;62;508;238;270
Šiauliai d. mun.;2014;63;550;238;312
Šiauliai d. mun.;2014;64;471;207;264
Šiauliai d. mun.;2014;65;477;206;271
Šiauliai d. mun.;2014;66;401;183;218
Šiauliai d. mun.;2014;67;440;200;240
Šiauliai d. mun.;2014;68;417;176;241
Šiauliai d. mun.;2014;69;347;153;194
Šiauliai d. mun.;2014;70;401;160;241
Šiauliai d. mun.;2014;71;507;194;313
Šiauliai d. mun.;2014;72;461;163;298
Šiauliai d. mun.;2014;73;375;143;232
Šiauliai d. mun.;2014;74;394;141;253
Šiauliai d. mun.;2014;75;363;145;218
Šiauliai d. mun.;2014;76;380;126;254
Šiauliai d. mun.;2014;77;366;108;258
Šiauliai d. mun.;2014;78;339;113;226
Šiauliai d. mun.;2014;79;306;95;211
Šiauliai d. mun.;2014;80;285;94;191
Šiauliai d. mun.;2014;81;278;75;203
Šiauliai d. mun.;2014;82;262;86;176
Šiauliai d. mun.;2014;83;218;63;155
Šiauliai d. mun.;2014;84;194;55;139
Šiauliai d. mun.;2014;85;838;159;679
Šiauliai d. mun.;2015;-1;41767;19917;21850
Šiauliai d. mun.;2015;0;361;189;172
Šiauliai d. mun.;2015;1;364;180;184
Šiauliai d. mun.;2015;2;344;171;173
Šiauliai d. mun.;2015;3;328;182;146
Šiauliai d. mun.;2015;4;324;148;176
Šiauliai d. mun.;2015;5;376;203;173
Šiauliai d. mun.;2015;6;412;206;206
Šiauliai d. mun.;2015;7;369;190;179
Šiauliai d. mun.;2015;8;398;215;183
Šiauliai d. mun.;2015;9;372;175;197
Šiauliai d. mun.;2015;10;393;201;192
Šiauliai d. mun.;2015;11;409;231;178
Šiauliai d. mun.;2015;12;356;188;168
Šiauliai d. mun.;2015;13;465;237;228
Šiauliai d. mun.;2015;14;457;232;225
Šiauliai d. mun.;2015;15;555;278;277
Šiauliai d. mun.;2015;16;566;313;253
Šiauliai d. mun.;2015;17;543;290;253
Šiauliai d. mun.;2015;18;599;324;275
Šiauliai d. mun.;2015;19;615;338;277
Šiauliai d. mun.;2015;20;642;304;338
Šiauliai d. mun.;2015;21;679;377;302
Šiauliai d. mun.;2015;22;734;394;340
Šiauliai d. mun.;2015;23;630;330;300
Šiauliai d. mun.;2015;24;520;294;226
Šiauliai d. mun.;2015;25;461;247;214
Šiauliai d. mun.;2015;26;441;259;182
Šiauliai d. mun.;2015;27;406;229;177
Šiauliai d. mun.;2015;28;366;213;153
Šiauliai d. mun.;2015;29;352;171;181
Šiauliai d. mun.;2015;30;338;180;158
Šiauliai d. mun.;2015;31;364;183;181
Šiauliai d. mun.;2015;32;404;223;181
Šiauliai d. mun.;2015;33;428;220;208
Šiauliai d. mun.;2015;34;434;215;219
Šiauliai d. mun.;2015;35;440;231;209
Šiauliai d. mun.;2015;36;420;215;205
Šiauliai d. mun.;2015;37;396;198;198
Šiauliai d. mun.;2015;38;500;230;270
Šiauliai d. mun.;2015;39;520;254;266
Šiauliai d. mun.;2015;40;523;226;297
Šiauliai d. mun.;2015;41;577;289;288
Šiauliai d. mun.;2015;42;609;273;336
Šiauliai d. mun.;2015;43;620;324;296
Šiauliai d. mun.;2015;44;683;344;339
Šiauliai d. mun.;2015;45;665;334;331
Šiauliai d. mun.;2015;46;692;345;347
Šiauliai d. mun.;2015;47;661;308;353
Šiauliai d. mun.;2015;48;671;337;334
Šiauliai d. mun.;2015;49;711;362;349
Šiauliai d. mun.;2015;50;643;338;305
Šiauliai d. mun.;2015;51;619;317;302
Šiauliai d. mun.;2015;52;685;334;351
Šiauliai d. mun.;2015;53;763;376;387
Šiauliai d. mun.;2015;54;710;326;384
Šiauliai d. mun.;2015;55;739;367;372
Šiauliai d. mun.;2015;56;679;347;332
Šiauliai d. mun.;2015;57;677;309;368
Šiauliai d. mun.;2015;58;586;304;282
Šiauliai d. mun.;2015;59;544;271;273
Šiauliai d. mun.;2015;60;548;288;260
Šiauliai d. mun.;2015;61;468;206;262
Šiauliai d. mun.;2015;62;505;217;288
Šiauliai d. mun.;2015;63;502;234;268
Šiauliai d. mun.;2015;64;533;225;308
Šiauliai d. mun.;2015;65;464;204;260
Šiauliai d. mun.;2015;66;464;198;266
Šiauliai d. mun.;2015;67;401;185;216
Šiauliai d. mun.;2015;68;428;190;238
Šiauliai d. mun.;2015;69;399;166;233
Šiauliai d. mun.;2015;70;333;144;189
Šiauliai d. mun.;2015;71;391;156;235
Šiauliai d. mun.;2015;72;486;182;304
Šiauliai d. mun.;2015;73;446;155;291
Šiauliai d. mun.;2015;74;357;133;224
Šiauliai d. mun.;2015;75;374;128;246
Šiauliai d. mun.;2015;76;348;134;214
Šiauliai d. mun.;2015;77;360;118;242
Šiauliai d. mun.;2015;78;352;104;248
Šiauliai d. mun.;2015;79;328;107;221
Šiauliai d. mun.;2015;80;286;85;201
Šiauliai d. mun.;2015;81;265;89;176
Šiauliai d. mun.;2015;82;269;71;198
Šiauliai d. mun.;2015;83;229;69;160
Šiauliai d. mun.;2015;84;204;61;143
Šiauliai d. mun.;2015;85;889;179;710
Šiauliai d. mun.;2016;-1;41521;19840;21681
Šiauliai d. mun.;2016;0;410;209;201
Šiauliai d. mun.;2016;1;363;195;168
Šiauliai d. mun.;2016;2;341;161;180
Šiauliai d. mun.;2016;3;340;173;167
Šiauliai d. mun.;2016;4;341;189;152
Šiauliai d. mun.;2016;5;331;149;182
Šiauliai d. mun.;2016;6;377;204;173
Šiauliai d. mun.;2016;7;423;214;209
Šiauliai d. mun.;2016;8;378;197;181
Šiauliai d. mun.;2016;9;401;218;183
Šiauliai d. mun.;2016;10;375;181;194
Šiauliai d. mun.;2016;11;397;199;198
Šiauliai d. mun.;2016;12;400;230;170
Šiauliai d. mun.;2016;13;366;195;171
Šiauliai d. mun.;2016;14;463;233;230
Šiauliai d. mun.;2016;15;461;236;225
Šiauliai d. mun.;2016;16;564;279;285
Šiauliai d. mun.;2016;17;574;320;254
Šiauliai d. mun.;2016;18;531;288;243
Šiauliai d. mun.;2016;19;581;317;264
Šiauliai d. mun.;2016;20;603;328;275
Šiauliai d. mun.;2016;21;611;290;321
Šiauliai d. mun.;2016;22;640;353;287
Šiauliai d. mun.;2016;23;712;383;329
Šiauliai d. mun.;2016;24;592;321;271
Šiauliai d. mun.;2016;25;494;275;219
Šiauliai d. mun.;2016;26;436;227;209
Šiauliai d. mun.;2016;27;429;252;177
Šiauliai d. mun.;2016;28;397;227;170
Šiauliai d. mun.;2016;29;363;205;158
Šiauliai d. mun.;2016;30;346;163;183
Šiauliai d. mun.;2016;31;341;183;158
Šiauliai d. mun.;2016;32;365;180;185
Šiauliai d. mun.;2016;33;389;210;179
Šiauliai d. mun.;2016;34;430;231;199
Šiauliai d. mun.;2016;35;439;222;217
Šiauliai d. mun.;2016;36;437;230;207
Šiauliai d. mun.;2016;37;412;211;201
Šiauliai d. mun.;2016;38;402;192;210
Šiauliai d. mun.;2016;39;504;233;271
Šiauliai d. mun.;2016;40;520;253;267
Šiauliai d. mun.;2016;41;532;231;301
Šiauliai d. mun.;2016;42;576;291;285
Šiauliai d. mun.;2016;43;621;278;343
Šiauliai d. mun.;2016;44;618;328;290
Šiauliai d. mun.;2016;45;680;340;340
Šiauliai d. mun.;2016;46;666;337;329
Šiauliai d. mun.;2016;47;701;353;348
Šiauliai d. mun.;2016;48;656;309;347
Šiauliai d. mun.;2016;49;675;338;337
Šiauliai d. mun.;2016;50;700;355;345
Šiauliai d. mun.;2016;51;653;346;307
Šiauliai d. mun.;2016;52;622;318;304
Šiauliai d. mun.;2016;53;689;335;354
Šiauliai d. mun.;2016;54;769;382;387
Šiauliai d. mun.;2016;55;713;325;388
Šiauliai d. mun.;2016;56;742;368;374
Šiauliai d. mun.;2016;57;673;346;327
Šiauliai d. mun.;2016;58;671;309;362
Šiauliai d. mun.;2016;59;582;301;281
Šiauliai d. mun.;2016;60;540;265;275
Šiauliai d. mun.;2016;61;541;281;260
Šiauliai d. mun.;2016;62;470;210;260
Šiauliai d. mun.;2016;63;502;217;285
Šiauliai d. mun.;2016;64;489;226;263
Šiauliai d. mun.;2016;65;531;222;309
Šiauliai d. mun.;2016;66;453;200;253
Šiauliai d. mun.;2016;67;451;188;263
Šiauliai d. mun.;2016;68;388;175;213
Šiauliai d. mun.;2016;69;418;184;234
Šiauliai d. mun.;2016;70;387;158;229
Šiauliai d. mun.;2016;71;324;139;185
Šiauliai d. mun.;2016;72;373;145;228
Šiauliai d. mun.;2016;73;469;172;297
Šiauliai d. mun.;2016;74;438;149;289
Šiauliai d. mun.;2016;75;344;124;220
Šiauliai d. mun.;2016;76;361;123;238
Šiauliai d. mun.;2016;77;334;126;208
Šiauliai d. mun.;2016;78;346;111;235
Šiauliai d. mun.;2016;79;332;95;237
Šiauliai d. mun.;2016;80;316;99;217
Šiauliai d. mun.;2016;81;271;81;190
Šiauliai d. mun.;2016;82;237;78;159
Šiauliai d. mun.;2016;83;242;61;181
Šiauliai d. mun.;2016;84;205;65;140
Šiauliai d. mun.;2016;85;941;200;741
Šiauliai d. mun.;2017;-1;41441;19820;21621
Šiauliai d. mun.;2017;0;359;175;184
Šiauliai d. mun.;2017;1;396;205;191
Šiauliai d. mun.;2017;2;353;186;167
Šiauliai d. mun.;2017;3;359;177;182
Šiauliai d. mun.;2017;4;354;186;168
Šiauliai d. mun.;2017;5;350;190;160
Šiauliai d. mun.;2017;6;354;159;195
Šiauliai d. mun.;2017;7;402;213;189
Šiauliai d. mun.;2017;8;445;223;222
Šiauliai d. mun.;2017;9;386;200;186
Šiauliai d. mun.;2017;10;412;229;183
Šiauliai d. mun.;2017;11;391;183;208
Šiauliai d. mun.;2017;12;405;207;198
Šiauliai d. mun.;2017;13;422;241;181
Šiauliai d. mun.;2017;14;371;197;174
Šiauliai d. mun.;2017;15;476;240;236
Šiauliai d. mun.;2017;16;472;241;231
Šiauliai d. mun.;2017;17;573;285;288
Šiauliai d. mun.;2017;18;562;313;249
Šiauliai d. mun.;2017;19;525;285;240
Šiauliai d. mun.;2017;20;567;310;257
Šiauliai d. mun.;2017;21;573;312;261
Šiauliai d. mun.;2017;22;576;277;299
Šiauliai d. mun.;2017;23;630;350;280
Šiauliai d. mun.;2017;24;666;367;299
Šiauliai d. mun.;2017;25;573;313;260
Šiauliai d. mun.;2017;26;482;270;212
Šiauliai d. mun.;2017;27;427;223;204
Šiauliai d. mun.;2017;28;403;238;165
Šiauliai d. mun.;2017;29;396;229;167
Šiauliai d. mun.;2017;30;360;210;150
Šiauliai d. mun.;2017;31;332;157;175
Šiauliai d. mun.;2017;32;325;166;159
Šiauliai d. mun.;2017;33;372;182;190
Šiauliai d. mun.;2017;34;392;216;176
Šiauliai d. mun.;2017;35;420;218;202
Šiauliai d. mun.;2017;36;446;224;222
Šiauliai d. mun.;2017;37;457;242;215
Šiauliai d. mun.;2017;38;414;210;204
Šiauliai d. mun.;2017;39;415;196;219
Šiauliai d. mun.;2017;40;511;231;280
Šiauliai d. mun.;2017;41;542;263;279
Šiauliai d. mun.;2017;42;539;233;306
Šiauliai d. mun.;2017;43;586;296;290
Šiauliai d. mun.;2017;44;614;276;338
Šiauliai d. mun.;2017;45;619;324;295
Šiauliai d. mun.;2017;46;683;339;344
Šiauliai d. mun.;2017;47;671;340;331
Šiauliai d. mun.;2017;48;705;355;350
Šiauliai d. mun.;2017;49;649;306;343
Šiauliai d. mun.;2017;50;693;346;347
Šiauliai d. mun.;2017;51;702;359;343
Šiauliai d. mun.;2017;52;667;347;320
Šiauliai d. mun.;2017;53;629;319;310
Šiauliai d. mun.;2017;54;691;339;352
Šiauliai d. mun.;2017;55;762;382;380
Šiauliai d. mun.;2017;56;709;321;388
Šiauliai d. mun.;2017;57;738;369;369
Šiauliai d. mun.;2017;58;666;342;324
Šiauliai d. mun.;2017;59;669;307;362
Šiauliai d. mun.;2017;60;569;293;276
Šiauliai d. mun.;2017;61;545;264;281
Šiauliai d. mun.;2017;62;532;275;257
Šiauliai d. mun.;2017;63;464;207;257
Šiauliai d. mun.;2017;64;497;216;281
Šiauliai d. mun.;2017;65;488;225;263
Šiauliai d. mun.;2017;66;526;221;305
Šiauliai d. mun.;2017;67;448;195;253
Šiauliai d. mun.;2017;68;444;185;259
Šiauliai d. mun.;2017;69;375;164;211
Šiauliai d. mun.;2017;70;404;176;228
Šiauliai d. mun.;2017;71;374;151;223
Šiauliai d. mun.;2017;72;309;131;178
Šiauliai d. mun.;2017;73;356;133;223
Šiauliai d. mun.;2017;74;454;162;292
Šiauliai d. mun.;2017;75;417;140;277
Šiauliai d. mun.;2017;76;330;117;213
Šiauliai d. mun.;2017;77;338;104;234
Šiauliai d. mun.;2017;78;316;119;197
Šiauliai d. mun.;2017;79;324;101;223
Šiauliai d. mun.;2017;80;316;91;225
Šiauliai d. mun.;2017;81;299;93;206
Šiauliai d. mun.;2017;82;256;76;180
Šiauliai d. mun.;2017;83;226;73;153
Šiauliai d. mun.;2017;84;220;53;167
Šiauliai d. mun.;2017;85;976;216;760
Šiauliai d. mun.;2018;-1;41209;19732;21477
Šiauliai d. mun.;2018;0;364;192;172
Šiauliai d. mun.;2018;1;354;170;184
Šiauliai d. mun.;2018;2;382;203;179
Šiauliai d. mun.;2018;3;350;185;165
Šiauliai d. mun.;2018;4;360;173;187
Šiauliai d. mun.;2018;5;369;195;174
Šiauliai d. mun.;2018;6;372;205;167
Šiauliai d. mun.;2018;7;376;174;202
Šiauliai d. mun.;2018;8;436;232;204
Šiauliai d. mun.;2018;9;465;233;232
Šiauliai d. mun.;2018;10;396;209;187
Šiauliai d. mun.;2018;11;427;232;195
Šiauliai d. mun.;2018;12;397;187;210
Šiauliai d. mun.;2018;13;416;211;205
Šiauliai d. mun.;2018;14;425;241;184
Šiauliai d. mun.;2018;15;383;202;181
Šiauliai d. mun.;2018;16;489;251;238
Šiauliai d. mun.;2018;17;477;247;230
Šiauliai d. mun.;2018;18;561;281;280
Šiauliai d. mun.;2018;19;541;294;247
Šiauliai d. mun.;2018;20;504;272;232
Šiauliai d. mun.;2018;21;551;306;245
Šiauliai d. mun.;2018;22;538;295;243
Šiauliai d. mun.;2018;23;534;264;270
Šiauliai d. mun.;2018;24;588;325;263
Šiauliai d. mun.;2018;25;608;331;277
Šiauliai d. mun.;2018;26;540;300;240
Šiauliai d. mun.;2018;27;455;248;207
Šiauliai d. mun.;2018;28;395;201;194
Šiauliai d. mun.;2018;29;394;234;160
Šiauliai d. mun.;2018;30;379;222;157
Šiauliai d. mun.;2018;31;352;203;149
Šiauliai d. mun.;2018;32;340;157;183
Šiauliai d. mun.;2018;33;339;172;167
Šiauliai d. mun.;2018;34;369;183;186
Šiauliai d. mun.;2018;35;410;222;188
Šiauliai d. mun.;2018;36;421;219;202
Šiauliai d. mun.;2018;37;458;232;226
Šiauliai d. mun.;2018;38;457;242;215
Šiauliai d. mun.;2018;39;427;213;214
Šiauliai d. mun.;2018;40;409;194;215
Šiauliai d. mun.;2018;41;520;235;285
Šiauliai d. mun.;2018;42;549;271;278
Šiauliai d. mun.;2018;43;565;247;318
Šiauliai d. mun.;2018;44;598;304;294
Šiauliai d. mun.;2018;45;625;284;341
Šiauliai d. mun.;2018;46;616;319;297
Šiauliai d. mun.;2018;47;686;339;347
Šiauliai d. mun.;2018;48;666;337;329
Šiauliai d. mun.;2018;49;706;359;347
Šiauliai d. mun.;2018;50;648;307;341
Šiauliai d. mun.;2018;51;692;343;349
Šiauliai d. mun.;2018;52;707;364;343
Šiauliai d. mun.;2018;53;660;347;313
Šiauliai d. mun.;2018;54;626;321;305
Šiauliai d. mun.;2018;55;688;333;355
Šiauliai d. mun.;2018;56;757;377;380
Šiauliai d. mun.;2018;57;704;315;389
Šiauliai d. mun.;2018;58;729;358;371
Šiauliai d. mun.;2018;59;670;341;329
Šiauliai d. mun.;2018;60;671;309;362
Šiauliai d. mun.;2018;61;563;290;273
Šiauliai d. mun.;2018;62;533;259;274
Šiauliai d. mun.;2018;63;530;270;260
Šiauliai d. mun.;2018;64;465;208;257
Šiauliai d. mun.;2018;65;491;211;280
Šiauliai d. mun.;2018;66;484;221;263
Šiauliai d. mun.;2018;67;512;211;301
Šiauliai d. mun.;2018;68;444;190;254
Šiauliai d. mun.;2018;69;439;178;261
Šiauliai d. mun.;2018;70;370;162;208
Šiauliai d. mun.;2018;71;393;167;226
Šiauliai d. mun.;2018;72;360;142;218
Šiauliai d. mun.;2018;73;294;122;172
Šiauliai d. mun.;2018;74;339;122;217
Šiauliai d. mun.;2018;75;432;154;278
Šiauliai d. mun.;2018;76;400;132;268
Šiauliai d. mun.;2018;77;317;112;205
Šiauliai d. mun.;2018;78;321;96;225
Šiauliai d. mun.;2018;79;303;108;195
Šiauliai d. mun.;2018;80;305;93;212
Šiauliai d. mun.;2018;81;295;79;216
Šiauliai d. mun.;2018;82;274;82;192
Šiauliai d. mun.;2018;83;236;69;167
Šiauliai d. mun.;2018;84;204;62;142
Šiauliai d. mun.;2018;85;1014;230;784
Šilalė d. mun.;2001;-1;31538;15336;16202
Šilalė d. mun.;2001;0;385;209;176
Šilalė d. mun.;2001;1;423;227;196
Šilalė d. mun.;2001;2;405;217;188
Šilalė d. mun.;2001;3;391;205;186
Šilalė d. mun.;2001;4;442;244;198
Šilalė d. mun.;2001;5;460;251;209
Šilalė d. mun.;2001;6;536;267;269
Šilalė d. mun.;2001;7;570;283;287
Šilalė d. mun.;2001;8;633;312;321
Šilalė d. mun.;2001;9;600;330;270
Šilalė d. mun.;2001;10;643;310;333
Šilalė d. mun.;2001;11;595;302;293
Šilalė d. mun.;2001;12;561;295;266
Šilalė d. mun.;2001;13;641;319;322
Šilalė d. mun.;2001;14;565;287;278
Šilalė d. mun.;2001;15;607;316;291
Šilalė d. mun.;2001;16;518;265;253
Šilalė d. mun.;2001;17;517;262;255
Šilalė d. mun.;2001;18;463;242;221
Šilalė d. mun.;2001;19;340;206;134
Šilalė d. mun.;2001;20;328;202;126
Šilalė d. mun.;2001;21;360;197;163
Šilalė d. mun.;2001;22;374;199;175
Šilalė d. mun.;2001;23;371;208;163
Šilalė d. mun.;2001;24;359;179;180
Šilalė d. mun.;2001;25;394;203;191
Šilalė d. mun.;2001;26;368;201;167
Šilalė d. mun.;2001;27;363;178;185
Šilalė d. mun.;2001;28;405;214;191
Šilalė d. mun.;2001;29;420;203;217
Šilalė d. mun.;2001;30;447;225;222
Šilalė d. mun.;2001;31;459;250;209
Šilalė d. mun.;2001;32;419;223;196
Šilalė d. mun.;2001;33;388;199;189
Šilalė d. mun.;2001;34;423;216;207
Šilalė d. mun.;2001;35;440;253;187
Šilalė d. mun.;2001;36;462;243;219
Šilalė d. mun.;2001;37;460;233;227
Šilalė d. mun.;2001;38;465;241;224
Šilalė d. mun.;2001;39;498;263;235
Šilalė d. mun.;2001;40;452;247;205
Šilalė d. mun.;2001;41;424;232;192
Šilalė d. mun.;2001;42;439;224;215
Šilalė d. mun.;2001;43;388;180;208
Šilalė d. mun.;2001;44;385;193;192
Šilalė d. mun.;2001;45;375;189;186
Šilalė d. mun.;2001;46;331;163;168
Šilalė d. mun.;2001;47;318;176;142
Šilalė d. mun.;2001;48;291;150;141
Šilalė d. mun.;2001;49;329;148;181
Šilalė d. mun.;2001;50;326;165;161
Šilalė d. mun.;2001;51;314;152;162
Šilalė d. mun.;2001;52;316;148;168
Šilalė d. mun.;2001;53;269;143;126
Šilalė d. mun.;2001;54;248;120;128
Šilalė d. mun.;2001;55;304;151;153
Šilalė d. mun.;2001;56;225;109;116
Šilalė d. mun.;2001;57;286;138;148
Šilalė d. mun.;2001;58;340;127;213
Šilalė d. mun.;2001;59;309;150;159
Šilalė d. mun.;2001;60;292;120;172
Šilalė d. mun.;2001;61;315;148;167
Šilalė d. mun.;2001;62;262;114;148
Šilalė d. mun.;2001;63;301;119;182
Šilalė d. mun.;2001;64;343;143;200
Šilalė d. mun.;2001;65;308;110;198
Šilalė d. mun.;2001;66;292;120;172
Šilalė d. mun.;2001;67;330;144;186
Šilalė d. mun.;2001;68;302;123;179
Šilalė d. mun.;2001;69;310;120;190
Šilalė d. mun.;2001;70;305;116;189
Šilalė d. mun.;2001;71;294;94;200
Šilalė d. mun.;2001;72;309;121;188
Šilalė d. mun.;2001;73;273;90;183
Šilalė d. mun.;2001;74;266;90;176
Šilalė d. mun.;2001;75;235;75;160
Šilalė d. mun.;2001;76;197;70;127
Šilalė d. mun.;2001;77;238;81;157
Šilalė d. mun.;2001;78;193;65;128
Šilalė d. mun.;2001;79;147;43;104
Šilalė d. mun.;2001;80;129;28;101
Šilalė d. mun.;2001;81;99;31;68
Šilalė d. mun.;2001;82;90;30;60
Šilalė d. mun.;2001;83;66;14;52
Šilalė d. mun.;2001;84;68;18;50
Šilalė d. mun.;2001;85;407;125;282
Šilalė d. mun.;2002;-1;31405;15281;16124
Šilalė d. mun.;2002;0;337;168;169
Šilalė d. mun.;2002;1;387;209;178
Šilalė d. mun.;2002;2;420;226;194
Šilalė d. mun.;2002;3;405;218;187
Šilalė d. mun.;2002;4;394;208;186
Šilalė d. mun.;2002;5;444;246;198
Šilalė d. mun.;2002;6;462;250;212
Šilalė d. mun.;2002;7;531;265;266
Šilalė d. mun.;2002;8;566;280;286
Šilalė d. mun.;2002;9;636;313;323
Šilalė d. mun.;2002;10;595;328;267
Šilalė d. mun.;2002;11;636;306;330
Šilalė d. mun.;2002;12;591;301;290
Šilalė d. mun.;2002;13;556;293;263
Šilalė d. mun.;2002;14;637;318;319
Šilalė d. mun.;2002;15;561;287;274
Šilalė d. mun.;2002;16;603;314;289
Šilalė d. mun.;2002;17;520;266;254
Šilalė d. mun.;2002;18;516;261;255
Šilalė d. mun.;2002;19;450;232;218
Šilalė d. mun.;2002;20;345;204;141
Šilalė d. mun.;2002;21;328;199;129
Šilalė d. mun.;2002;22;367;196;171
Šilalė d. mun.;2002;23;373;199;174
Šilalė d. mun.;2002;24;368;206;162
Šilalė d. mun.;2002;25;351;174;177
Šilalė d. mun.;2002;26;388;197;191
Šilalė d. mun.;2002;27;364;196;168
Šilalė d. mun.;2002;28;356;174;182
Šilalė d. mun.;2002;29;395;207;188
Šilalė d. mun.;2002;30;415;202;213
Šilalė d. mun.;2002;31;439;224;215
Šilalė d. mun.;2002;32;453;245;208
Šilalė d. mun.;2002;33;411;220;191
Šilalė d. mun.;2002;34;384;197;187
Šilalė d. mun.;2002;35;418;212;206
Šilalė d. mun.;2002;36;436;250;186
Šilalė d. mun.;2002;37;453;237;216
Šilalė d. mun.;2002;38;455;229;226
Šilalė d. mun.;2002;39;457;235;222
Šilalė d. mun.;2002;40;490;261;229
Šilalė d. mun.;2002;41;449;246;203
Šilalė d. mun.;2002;42;421;230;191
Šilalė d. mun.;2002;43;434;221;213
Šilalė d. mun.;2002;44;383;177;206
Šilalė d. mun.;2002;45;378;191;187
Šilalė d. mun.;2002;46;371;187;184
Šilalė d. mun.;2002;47;332;166;166
Šilalė d. mun.;2002;48;310;173;137
Šilalė d. mun.;2002;49;287;148;139
Šilalė d. mun.;2002;50;327;147;180
Šilalė d. mun.;2002;51;321;163;158
Šilalė d. mun.;2002;52;312;152;160
Šilalė d. mun.;2002;53;318;152;166
Šilalė d. mun.;2002;54;267;141;126
Šilalė d. mun.;2002;55;241;117;124
Šilalė d. mun.;2002;56;299;147;152
Šilalė d. mun.;2002;57;216;105;111
Šilalė d. mun.;2002;58;276;133;143
Šilalė d. mun.;2002;59;333;125;208
Šilalė d. mun.;2002;60;307;151;156
Šilalė d. mun.;2002;61;290;118;172
Šilalė d. mun.;2002;62;311;144;167
Šilalė d. mun.;2002;63;257;112;145
Šilalė d. mun.;2002;64;302;119;183
Šilalė d. mun.;2002;65;337;139;198
Šilalė d. mun.;2002;66;303;105;198
Šilalė d. mun.;2002;67;287;118;169
Šilalė d. mun.;2002;68;328;143;185
Šilalė d. mun.;2002;69;295;119;176
Šilalė d. mun.;2002;70;302;118;184
Šilalė d. mun.;2002;71;298;110;188
Šilalė d. mun.;2002;72;283;88;195
Šilalė d. mun.;2002;73;302;116;186
Šilalė d. mun.;2002;74;261;84;177
Šilalė d. mun.;2002;75;264;90;174
Šilalė d. mun.;2002;76;222;70;152
Šilalė d. mun.;2002;77;193;68;125
Šilalė d. mun.;2002;78;226;78;148
Šilalė d. mun.;2002;79;187;64;123
Šilalė d. mun.;2002;80;137;37;100
Šilalė d. mun.;2002;81;119;28;91
Šilalė d. mun.;2002;82;96;30;66
Šilalė d. mun.;2002;83;84;28;56
Šilalė d. mun.;2002;84;59;11;48
Šilalė d. mun.;2002;85;387;119;268
Šilalė d. mun.;2003;-1;31121;15110;16011
Šilalė d. mun.;2003;0;334;165;169
Šilalė d. mun.;2003;1;337;168;169
Šilalė d. mun.;2003;2;383;206;177
Šilalė d. mun.;2003;3;428;230;198
Šilalė d. mun.;2003;4;406;218;188
Šilalė d. mun.;2003;5;391;205;186
Šilalė d. mun.;2003;6;447;248;199
Šilalė d. mun.;2003;7;462;247;215
Šilalė d. mun.;2003;8;532;266;266
Šilalė d. mun.;2003;9;564;280;284
Šilalė d. mun.;2003;10;628;309;319
Šilalė d. mun.;2003;11;593;327;266
Šilalė d. mun.;2003;12;627;303;324
Šilalė d. mun.;2003;13;581;296;285
Šilalė d. mun.;2003;14;552;289;263
Šilalė d. mun.;2003;15;623;311;312
Šilalė d. mun.;2003;16;549;280;269
Šilalė d. mun.;2003;17;589;306;283
Šilalė d. mun.;2003;18;515;261;254
Šilalė d. mun.;2003;19;506;256;250
Šilalė d. mun.;2003;20;442;229;213
Šilalė d. mun.;2003;21;338;198;140
Šilalė d. mun.;2003;22;322;191;131
Šilalė d. mun.;2003;23;370;193;177
Šilalė d. mun.;2003;24;367;191;176
Šilalė d. mun.;2003;25;362;201;161
Šilalė d. mun.;2003;26;346;171;175
Šilalė d. mun.;2003;27;374;188;186
Šilalė d. mun.;2003;28;352;193;159
Šilalė d. mun.;2003;29;345;169;176
Šilalė d. mun.;2003;30;387;203;184
Šilalė d. mun.;2003;31;410;198;212
Šilalė d. mun.;2003;32;438;223;215
Šilalė d. mun.;2003;33;451;242;209
Šilalė d. mun.;2003;34;400;214;186
Šilalė d. mun.;2003;35;378;192;186
Šilalė d. mun.;2003;36;414;212;202
Šilalė d. mun.;2003;37;430;245;185
Šilalė d. mun.;2003;38;446;233;213
Šilalė d. mun.;2003;39;453;231;222
Šilalė d. mun.;2003;40;447;227;220
Šilalė d. mun.;2003;41;489;261;228
Šilalė d. mun.;2003;42;446;244;202
Šilalė d. mun.;2003;43;418;229;189
Šilalė d. mun.;2003;44;432;221;211
Šilalė d. mun.;2003;45;378;174;204
Šilalė d. mun.;2003;46;371;185;186
Šilalė d. mun.;2003;47;367;186;181
Šilalė d. mun.;2003;48;333;166;167
Šilalė d. mun.;2003;49;303;168;135
Šilalė d. mun.;2003;50;286;146;140
Šilalė d. mun.;2003;51;322;144;178
Šilalė d. mun.;2003;52;316;160;156
Šilalė d. mun.;2003;53;308;151;157
Šilalė d. mun.;2003;54;315;148;167
Šilalė d. mun.;2003;55;264;140;124
Šilalė d. mun.;2003;56;239;115;124
Šilalė d. mun.;2003;57;295;144;151
Šilalė d. mun.;2003;58;205;98;107
Šilalė d. mun.;2003;59;270;127;143
Šilalė d. mun.;2003;60;327;121;206
Šilalė d. mun.;2003;61;302;148;154
Šilalė d. mun.;2003;62;287;117;170
Šilalė d. mun.;2003;63;309;142;167
Šilalė d. mun.;2003;64;256;112;144
Šilalė d. mun.;2003;65;301;119;182
Šilalė d. mun.;2003;66;323;134;189
Šilalė d. mun.;2003;67;296;101;195
Šilalė d. mun.;2003;68;280;114;166
Šilalė d. mun.;2003;69;314;132;182
Šilalė d. mun.;2003;70;289;111;178
Šilalė d. mun.;2003;71;290;112;178
Šilalė d. mun.;2003;72;288;105;183
Šilalė d. mun.;2003;73;275;85;190
Šilalė d. mun.;2003;74;289;110;179
Šilalė d. mun.;2003;75;249;79;170
Šilalė d. mun.;2003;76;249;82;167
Šilalė d. mun.;2003;77;204;65;139
Šilalė d. mun.;2003;78;179;62;117
Šilalė d. mun.;2003;79;214;73;141
Šilalė d. mun.;2003;80;169;57;112
Šilalė d. mun.;2003;81;124;33;91
Šilalė d. mun.;2003;82;112;23;89
Šilalė d. mun.;2003;83;80;25;55
Šilalė d. mun.;2003;84;75;25;50
Šilalė d. mun.;2003;85;364;101;263
Šilalė d. mun.;2004;-1;30768;14934;15834
Šilalė d. mun.;2004;0;349;175;174
Šilalė d. mun.;2004;1;336;166;170
Šilalė d. mun.;2004;2;335;168;167
Šilalė d. mun.;2004;3;384;206;178
Šilalė d. mun.;2004;4;431;232;199
Šilalė d. mun.;2004;5;403;214;189
Šilalė d. mun.;2004;6;389;206;183
Šilalė d. mun.;2004;7;444;245;199
Šilalė d. mun.;2004;8;460;246;214
Šilalė d. mun.;2004;9;532;268;264
Šilalė d. mun.;2004;10;566;281;285
Šilalė d. mun.;2004;11;625;309;316
Šilalė d. mun.;2004;12;585;319;266
Šilalė d. mun.;2004;13;620;300;320
Šilalė d. mun.;2004;14;570;291;279
Šilalė d. mun.;2004;15;548;286;262
Šilalė d. mun.;2004;16;612;306;306
Šilalė d. mun.;2004;17;540;275;265
Šilalė d. mun.;2004;18;578;301;277
Šilalė d. mun.;2004;19;512;259;253
Šilalė d. mun.;2004;20;490;246;244
Šilalė d. mun.;2004;21;427;222;205
Šilalė d. mun.;2004;22;335;197;138
Šilalė d. mun.;2004;23;313;190;123
Šilalė d. mun.;2004;24;369;191;178
Šilalė d. mun.;2004;25;353;186;167
Šilalė d. mun.;2004;26;337;191;146
Šilalė d. mun.;2004;27;323;163;160
Šilalė d. mun.;2004;28;364;187;177
Šilalė d. mun.;2004;29;337;186;151
Šilalė d. mun.;2004;30;339;165;174
Šilalė d. mun.;2004;31;380;198;182
Šilalė d. mun.;2004;32;393;188;205
Šilalė d. mun.;2004;33;428;214;214
Šilalė d. mun.;2004;34;442;237;205
Šilalė d. mun.;2004;35;388;206;182
Šilalė d. mun.;2004;36;375;192;183
Šilalė d. mun.;2004;37;407;209;198
Šilalė d. mun.;2004;38;423;239;184
Šilalė d. mun.;2004;39;441;231;210
Šilalė d. mun.;2004;40;444;226;218
Šilalė d. mun.;2004;41;444;227;217
Šilalė d. mun.;2004;42;483;257;226
Šilalė d. mun.;2004;43;439;238;201
Šilalė d. mun.;2004;44;407;221;186
Šilalė d. mun.;2004;45;427;216;211
Šilalė d. mun.;2004;46;381;176;205
Šilalė d. mun.;2004;47;364;181;183
Šilalė d. mun.;2004;48;365;185;180
Šilalė d. mun.;2004;49;330;165;165
Šilalė d. mun.;2004;50;296;164;132
Šilalė d. mun.;2004;51;278;141;137
Šilalė d. mun.;2004;52;312;137;175
Šilalė d. mun.;2004;53;306;154;152
Šilalė d. mun.;2004;54;311;153;158
Šilalė d. mun.;2004;55;311;146;165
Šilalė d. mun.;2004;56;261;135;126
Šilalė d. mun.;2004;57;234;112;122
Šilalė d. mun.;2004;58;284;137;147
Šilalė d. mun.;2004;59;202;100;102
Šilalė d. mun.;2004;60;266;124;142
Šilalė d. mun.;2004;61;324;120;204
Šilalė d. mun.;2004;62;299;147;152
Šilalė d. mun.;2004;63;282;112;170
Šilalė d. mun.;2004;64;309;141;168
Šilalė d. mun.;2004;65;256;112;144
Šilalė d. mun.;2004;66;296;115;181
Šilalė d. mun.;2004;67;321;131;190
Šilalė d. mun.;2004;68;291;98;193
Šilalė d. mun.;2004;69;273;111;162
Šilalė d. mun.;2004;70;306;126;180
Šilalė d. mun.;2004;71;277;104;173
Šilalė d. mun.;2004;72;275;102;173
Šilalė d. mun.;2004;73;279;99;180
Šilalė d. mun.;2004;74;271;82;189
Šilalė d. mun.;2004;75;267;96;171
Šilalė d. mun.;2004;76;236;74;162
Šilalė d. mun.;2004;77;231;74;157
Šilalė d. mun.;2004;78;195;61;134
Šilalė d. mun.;2004;79;168;59;109
Šilalė d. mun.;2004;80;191;59;132
Šilalė d. mun.;2004;81;148;50;98
Šilalė d. mun.;2004;82;110;31;79
Šilalė d. mun.;2004;83;100;18;82
Šilalė d. mun.;2004;84;75;23;52
Šilalė d. mun.;2004;85;360;103;257
Šilalė d. mun.;2005;-1;30326;14700;15626
Šilalė d. mun.;2005;0;281;143;138
Šilalė d. mun.;2005;1;346;172;174
Šilalė d. mun.;2005;2;336;166;170
Šilalė d. mun.;2005;3;333;167;166
Šilalė d. mun.;2005;4;385;206;179
Šilalė d. mun.;2005;5;429;230;199
Šilalė d. mun.;2005;6;403;215;188
Šilalė d. mun.;2005;7;389;206;183
Šilalė d. mun.;2005;8;442;244;198
Šilalė d. mun.;2005;9;455;245;210
Šilalė d. mun.;2005;10;529;266;263
Šilalė d. mun.;2005;11;561;278;283
Šilalė d. mun.;2005;12;619;302;317
Šilalė d. mun.;2005;13;583;321;262
Šilalė d. mun.;2005;14;611;294;317
Šilalė d. mun.;2005;15;565;288;277
Šilalė d. mun.;2005;16;543;284;259
Šilalė d. mun.;2005;17;601;298;303
Šilalė d. mun.;2005;18;534;271;263
Šilalė d. mun.;2005;19;567;296;271
Šilalė d. mun.;2005;20;502;254;248
Šilalė d. mun.;2005;21;486;245;241
Šilalė d. mun.;2005;22;413;215;198
Šilalė d. mun.;2005;23;322;193;129
Šilalė d. mun.;2005;24;302;185;117
Šilalė d. mun.;2005;25;349;181;168
Šilalė d. mun.;2005;26;335;177;158
Šilalė d. mun.;2005;27;324;183;141
Šilalė d. mun.;2005;28;312;161;151
Šilalė d. mun.;2005;29;349;181;168
Šilalė d. mun.;2005;30;316;178;138
Šilalė d. mun.;2005;31;323;156;167
Šilalė d. mun.;2005;32;372;193;179
Šilalė d. mun.;2005;33;379;180;199
Šilalė d. mun.;2005;34;418;208;210
Šilalė d. mun.;2005;35;426;228;198
Šilalė d. mun.;2005;36;381;204;177
Šilalė d. mun.;2005;37;373;193;180
Šilalė d. mun.;2005;38;405;210;195
Šilalė d. mun.;2005;39;414;235;179
Šilalė d. mun.;2005;40;436;231;205
Šilalė d. mun.;2005;41;443;224;219
Šilalė d. mun.;2005;42;432;218;214
Šilalė d. mun.;2005;43;481;255;226
Šilalė d. mun.;2005;44;430;231;199
Šilalė d. mun.;2005;45;401;216;185
Šilalė d. mun.;2005;46;425;212;213
Šilalė d. mun.;2005;47;377;174;203
Šilalė d. mun.;2005;48;357;176;181
Šilalė d. mun.;2005;49;358;181;177
Šilalė d. mun.;2005;50;325;160;165
Šilalė d. mun.;2005;51;294;161;133
Šilalė d. mun.;2005;52;274;137;137
Šilalė d. mun.;2005;53;308;137;171
Šilalė d. mun.;2005;54;304;153;151
Šilalė d. mun.;2005;55;305;149;156
Šilalė d. mun.;2005;56;309;143;166
Šilalė d. mun.;2005;57;253;129;124
Šilalė d. mun.;2005;58;232;109;123
Šilalė d. mun.;2005;59;280;133;147
Šilalė d. mun.;2005;60;197;96;101
Šilalė d. mun.;2005;61;262;122;140
Šilalė d. mun.;2005;62;316;112;204
Šilalė d. mun.;2005;63;288;137;151
Šilalė d. mun.;2005;64;270;103;167
Šilalė d. mun.;2005;65;300;136;164
Šilalė d. mun.;2005;66;254;112;142
Šilalė d. mun.;2005;67;294;114;180
Šilalė d. mun.;2005;68;316;129;187
Šilalė d. mun.;2005;69;281;92;189
Šilalė d. mun.;2005;70;266;106;160
Šilalė d. mun.;2005;71;291;114;177
Šilalė d. mun.;2005;72;270;99;171
Šilalė d. mun.;2005;73;270;99;171
Šilalė d. mun.;2005;74;264;91;173
Šilalė d. mun.;2005;75;261;78;183
Šilalė d. mun.;2005;76;258;91;167
Šilalė d. mun.;2005;77;231;69;162
Šilalė d. mun.;2005;78;217;71;146
Šilalė d. mun.;2005;79;184;59;125
Šilalė d. mun.;2005;80;160;56;104
Šilalė d. mun.;2005;81;173;51;122
Šilalė d. mun.;2005;82;134;42;92
Šilalė d. mun.;2005;83;95;26;69
Šilalė d. mun.;2005;84;88;16;72
Šilalė d. mun.;2005;85;349;98;251
Šilalė d. mun.;2006;-1;29586;14218;15368
Šilalė d. mun.;2006;0;296;135;161
Šilalė d. mun.;2006;1;277;140;137
Šilalė d. mun.;2006;2;339;167;172
Šilalė d. mun.;2006;3;324;159;165
Šilalė d. mun.;2006;4;327;164;163
Šilalė d. mun.;2006;5;379;202;177
Šilalė d. mun.;2006;6;421;226;195
Šilalė d. mun.;2006;7;395;209;186
Šilalė d. mun.;2006;8;385;204;181
Šilalė d. mun.;2006;9;436;241;195
Šilalė d. mun.;2006;10;450;242;208
Šilalė d. mun.;2006;11;527;262;265
Šilalė d. mun.;2006;12;557;275;282
Šilalė d. mun.;2006;13;607;295;312
Šilalė d. mun.;2006;14;572;314;258
Šilalė d. mun.;2006;15;595;285;310
Šilalė d. mun.;2006;16;546;275;271
Šilalė d. mun.;2006;17;525;272;253
Šilalė d. mun.;2006;18;581;287;294
Šilalė d. mun.;2006;19;507;255;252
Šilalė d. mun.;2006;20;537;277;260
Šilalė d. mun.;2006;21;475;243;232
Šilalė d. mun.;2006;22;469;235;234
Šilalė d. mun.;2006;23;389;202;187
Šilalė d. mun.;2006;24;300;180;120
Šilalė d. mun.;2006;25;279;174;105
Šilalė d. mun.;2006;26;331;172;159
Šilalė d. mun.;2006;27;327;168;159
Šilalė d. mun.;2006;28;304;171;133
Šilalė d. mun.;2006;29;299;153;146
Šilalė d. mun.;2006;30;333;171;162
Šilalė d. mun.;2006;31;300;170;130
Šilalė d. mun.;2006;32;307;147;160
Šilalė d. mun.;2006;33;355;185;170
Šilalė d. mun.;2006;34;365;168;197
Šilalė d. mun.;2006;35;407;201;206
Šilalė d. mun.;2006;36;418;221;197
Šilalė d. mun.;2006;37;374;196;178
Šilalė d. mun.;2006;38;363;187;176
Šilalė d. mun.;2006;39;397;205;192
Šilalė d. mun.;2006;40;396;226;170
Šilalė d. mun.;2006;41;435;230;205
Šilalė d. mun.;2006;42;436;218;218
Šilalė d. mun.;2006;43;424;212;212
Šilalė d. mun.;2006;44;470;247;223
Šilalė d. mun.;2006;45;427;229;198
Šilalė d. mun.;2006;46;394;213;181
Šilalė d. mun.;2006;47;419;210;209
Šilalė d. mun.;2006;48;374;171;203
Šilalė d. mun.;2006;49;345;167;178
Šilalė d. mun.;2006;50;352;178;174
Šilalė d. mun.;2006;51;315;151;164
Šilalė d. mun.;2006;52;287;155;132
Šilalė d. mun.;2006;53;273;136;137
Šilalė d. mun.;2006;54;303;133;170
Šilalė d. mun.;2006;55;295;147;148
Šilalė d. mun.;2006;56;300;143;157
Šilalė d. mun.;2006;57;300;137;163
Šilalė d. mun.;2006;58;245;124;121
Šilalė d. mun.;2006;59;223;103;120
Šilalė d. mun.;2006;60;275;129;146
Šilalė d. mun.;2006;61;192;91;101
Šilalė d. mun.;2006;62;254;116;138
Šilalė d. mun.;2006;63;305;104;201
Šilalė d. mun.;2006;64;282;131;151
Šilalė d. mun.;2006;65;262;96;166
Šilalė d. mun.;2006;66;290;126;164
Šilalė d. mun.;2006;67;243;103;140
Šilalė d. mun.;2006;68;284;106;178
Šilalė d. mun.;2006;69;308;123;185
Šilalė d. mun.;2006;70;277;89;188
Šilalė d. mun.;2006;71;253;97;156
Šilalė d. mun.;2006;72;273;102;171
Šilalė d. mun.;2006;73;257;90;167
Šilalė d. mun.;2006;74;255;91;164
Šilalė d. mun.;2006;75;256;86;170
Šilalė d. mun.;2006;76;235;66;169
Šilalė d. mun.;2006;77;250;88;162
Šilalė d. mun.;2006;78;218;62;156
Šilalė d. mun.;2006;79;199;63;136
Šilalė d. mun.;2006;80;173;54;119
Šilalė d. mun.;2006;81;139;46;93
Šilalė d. mun.;2006;82;167;48;119
Šilalė d. mun.;2006;83;119;34;85
Šilalė d. mun.;2006;84;89;24;65
Šilalė d. mun.;2006;85;343;88;255
Šilalė d. mun.;2007;-1;28930;13888;15042
Šilalė d. mun.;2007;0;255;140;115
Šilalė d. mun.;2007;1;289;132;157
Šilalė d. mun.;2007;2;273;139;134
Šilalė d. mun.;2007;3;332;167;165
Šilalė d. mun.;2007;4;324;158;166
Šilalė d. mun.;2007;5;326;162;164
Šilalė d. mun.;2007;6;375;202;173
Šilalė d. mun.;2007;7;414;222;192
Šilalė d. mun.;2007;8;388;206;182
Šilalė d. mun.;2007;9;380;200;180
Šilalė d. mun.;2007;10;430;237;193
Šilalė d. mun.;2007;11;443;237;206
Šilalė d. mun.;2007;12;523;260;263
Šilalė d. mun.;2007;13;555;274;281
Šilalė d. mun.;2007;14;599;290;309
Šilalė d. mun.;2007;15;562;310;252
Šilalė d. mun.;2007;16;581;278;303
Šilalė d. mun.;2007;17;529;265;264
Šilalė d. mun.;2007;18;515;267;248
Šilalė d. mun.;2007;19;565;277;288
Šilalė d. mun.;2007;20;488;245;243
Šilalė d. mun.;2007;21;517;266;251
Šilalė d. mun.;2007;22;459;235;224
Šilalė d. mun.;2007;23;445;226;219
Šilalė d. mun.;2007;24;370;192;178
Šilalė d. mun.;2007;25;285;169;116
Šilalė d. mun.;2007;26;267;164;103
Šilalė d. mun.;2007;27;326;171;155
Šilalė d. mun.;2007;28;311;157;154
Šilalė d. mun.;2007;29;291;162;129
Šilalė d. mun.;2007;30;289;149;140
Šilalė d. mun.;2007;31;321;168;153
Šilalė d. mun.;2007;32;293;164;129
Šilalė d. mun.;2007;33;305;147;158
Šilalė d. mun.;2007;34;349;181;168
Šilalė d. mun.;2007;35;355;161;194
Šilalė d. mun.;2007;36;395;195;200
Šilalė d. mun.;2007;37;402;209;193
Šilalė d. mun.;2007;38;365;191;174
Šilalė d. mun.;2007;39;354;183;171
Šilalė d. mun.;2007;40;385;197;188
Šilalė d. mun.;2007;41;391;222;169
Šilalė d. mun.;2007;42;423;222;201
Šilalė d. mun.;2007;43;426;211;215
Šilalė d. mun.;2007;44;410;204;206
Šilalė d. mun.;2007;45;459;240;219
Šilalė d. mun.;2007;46;419;225;194
Šilalė d. mun.;2007;47;388;210;178
Šilalė d. mun.;2007;48;407;203;204
Šilalė d. mun.;2007;49;369;169;200
Šilalė d. mun.;2007;50;338;163;175
Šilalė d. mun.;2007;51;343;173;170
Šilalė d. mun.;2007;52;310;147;163
Šilalė d. mun.;2007;53;280;149;131
Šilalė d. mun.;2007;54;267;132;135
Šilalė d. mun.;2007;55;295;129;166
Šilalė d. mun.;2007;56;291;144;147
Šilalė d. mun.;2007;57;292;138;154
Šilalė d. mun.;2007;58;295;135;160
Šilalė d. mun.;2007;59;241;121;120
Šilalė d. mun.;2007;60;219;102;117
Šilalė d. mun.;2007;61;268;125;143
Šilalė d. mun.;2007;62;188;88;100
Šilalė d. mun.;2007;63;244;110;134
Šilalė d. mun.;2007;64;292;98;194
Šilalė d. mun.;2007;65;273;125;148
Šilalė d. mun.;2007;66;246;88;158
Šilalė d. mun.;2007;67;280;120;160
Šilalė d. mun.;2007;68;231;94;137
Šilalė d. mun.;2007;69;278;106;172
Šilalė d. mun.;2007;70;300;119;181
Šilalė d. mun.;2007;71;263;80;183
Šilalė d. mun.;2007;72;243;88;155
Šilalė d. mun.;2007;73;256;93;163
Šilalė d. mun.;2007;74;252;88;164
Šilalė d. mun.;2007;75;247;87;160
Šilalė d. mun.;2007;76;246;83;163
Šilalė d. mun.;2007;77;222;61;161
Šilalė d. mun.;2007;78;227;76;151
Šilalė d. mun.;2007;79;198;54;144
Šilalė d. mun.;2007;80;171;55;116
Šilalė d. mun.;2007;81;160;48;112
Šilalė d. mun.;2007;82;128;39;89
Šilalė d. mun.;2007;83;154;46;108
Šilalė d. mun.;2007;84;104;33;71
Šilalė d. mun.;2007;85;366;90;276
Šilalė d. mun.;2008;-1;28439;13666;14773
Šilalė d. mun.;2008;0;246;132;114
Šilalė d. mun.;2008;1;255;140;115
Šilalė d. mun.;2008;2;289;133;156
Šilalė d. mun.;2008;3;272;140;132
Šilalė d. mun.;2008;4;328;164;164
Šilalė d. mun.;2008;5;318;157;161
Šilalė d. mun.;2008;6;321;159;162
Šilalė d. mun.;2008;7;363;193;170
Šilalė d. mun.;2008;8;407;220;187
Šilalė d. mun.;2008;9;386;204;182
Šilalė d. mun.;2008;10;375;196;179
Šilalė d. mun.;2008;11;424;234;190
Šilalė d. mun.;2008;12;443;238;205
Šilalė d. mun.;2008;13;519;258;261
Šilalė d. mun.;2008;14;549;272;277
Šilalė d. mun.;2008;15;591;286;305
Šilalė d. mun.;2008;16;559;308;251
Šilalė d. mun.;2008;17;570;274;296
Šilalė d. mun.;2008;18;522;263;259
Šilalė d. mun.;2008;19;503;261;242
Šilalė d. mun.;2008;20;555;273;282
Šilalė d. mun.;2008;21;475;242;233
Šilalė d. mun.;2008;22;496;256;240
Šilalė d. mun.;2008;23;454;234;220
Šilalė d. mun.;2008;24;436;223;213
Šilalė d. mun.;2008;25;345;180;165
Šilalė d. mun.;2008;26;264;159;105
Šilalė d. mun.;2008;27;255;158;97
Šilalė d. mun.;2008;28;309;165;144
Šilalė d. mun.;2008;29;297;151;146
Šilalė d. mun.;2008;30;280;162;118
Šilalė d. mun.;2008;31;276;141;135
Šilalė d. mun.;2008;32;312;159;153
Šilalė d. mun.;2008;33;284;161;123
Šilalė d. mun.;2008;34;302;142;160
Šilalė d. mun.;2008;35;345;177;168
Šilalė d. mun.;2008;36;351;157;194
Šilalė d. mun.;2008;37;390;193;197
Šilalė d. mun.;2008;38;393;202;191
Šilalė d. mun.;2008;39;352;182;170
Šilalė d. mun.;2008;40;354;183;171
Šilalė d. mun.;2008;41;381;195;186
Šilalė d. mun.;2008;42;385;218;167
Šilalė d. mun.;2008;43;416;218;198
Šilalė d. mun.;2008;44;422;206;216
Šilalė d. mun.;2008;45;407;204;203
Šilalė d. mun.;2008;46;454;237;217
Šilalė d. mun.;2008;47;408;217;191
Šilalė d. mun.;2008;48;382;206;176
Šilalė d. mun.;2008;49;401;199;202
Šilalė d. mun.;2008;50;364;166;198
Šilalė d. mun.;2008;51;337;162;175
Šilalė d. mun.;2008;52;335;169;166
Šilalė d. mun.;2008;53;309;144;165
Šilalė d. mun.;2008;54;274;145;129
Šilalė d. mun.;2008;55;266;132;134
Šilalė d. mun.;2008;56;289;126;163
Šilalė d. mun.;2008;57;288;144;144
Šilalė d. mun.;2008;58;286;135;151
Šilalė d. mun.;2008;59;291;132;159
Šilalė d. mun.;2008;60;238;118;120
Šilalė d. mun.;2008;61;210;93;117
Šilalė d. mun.;2008;62;268;125;143
Šilalė d. mun.;2008;63;186;86;100
Šilalė d. mun.;2008;64;241;107;134
Šilalė d. mun.;2008;65;290;98;192
Šilalė d. mun.;2008;66;267;119;148
Šilalė d. mun.;2008;67;231;81;150
Šilalė d. mun.;2008;68;277;118;159
Šilalė d. mun.;2008;69;226;92;134
Šilalė d. mun.;2008;70;272;101;171
Šilalė d. mun.;2008;71;294;117;177
Šilalė d. mun.;2008;72;253;78;175
Šilalė d. mun.;2008;73;238;85;153
Šilalė d. mun.;2008;74;240;82;158
Šilalė d. mun.;2008;75;244;85;159
Šilalė d. mun.;2008;76;243;86;157
Šilalė d. mun.;2008;77;241;82;159
Šilalė d. mun.;2008;78;207;55;152
Šilalė d. mun.;2008;79;208;65;143
Šilalė d. mun.;2008;80;181;47;134
Šilalė d. mun.;2008;81;161;51;110
Šilalė d. mun.;2008;82;143;43;100
Šilalė d. mun.;2008;83;112;34;78
Šilalė d. mun.;2008;84;132;35;97
Šilalė d. mun.;2008;85;376;96;280
Šilalė d. mun.;2009;-1;27936;13441;14495
Šilalė d. mun.;2009;0;252;131;121
Šilalė d. mun.;2009;1;243;131;112
Šilalė d. mun.;2009;2;251;136;115
Šilalė d. mun.;2009;3;284;131;153
Šilalė d. mun.;2009;4;273;141;132
Šilalė d. mun.;2009;5;311;157;154
Šilalė d. mun.;2009;6;309;152;157
Šilalė d. mun.;2009;7;317;159;158
Šilalė d. mun.;2009;8;356;191;165
Šilalė d. mun.;2009;9;399;213;186
Šilalė d. mun.;2009;10;378;202;176
Šilalė d. mun.;2009;11;371;193;178
Šilalė d. mun.;2009;12;418;230;188
Šilalė d. mun.;2009;13;440;235;205
Šilalė d. mun.;2009;14;512;251;261
Šilalė d. mun.;2009;15;548;270;278
Šilalė d. mun.;2009;16;590;287;303
Šilalė d. mun.;2009;17;558;306;252
Šilalė d. mun.;2009;18;565;272;293
Šilalė d. mun.;2009;19;519;262;257
Šilalė d. mun.;2009;20;499;260;239
Šilalė d. mun.;2009;21;543;266;277
Šilalė d. mun.;2009;22;464;241;223
Šilalė d. mun.;2009;23;480;246;234
Šilalė d. mun.;2009;24;443;229;214
Šilalė d. mun.;2009;25;423;214;209
Šilalė d. mun.;2009;26;317;170;147
Šilalė d. mun.;2009;27;250;154;96
Šilalė d. mun.;2009;28;239;151;88
Šilalė d. mun.;2009;29;286;155;131
Šilalė d. mun.;2009;30;284;146;138
Šilalė d. mun.;2009;31;265;153;112
Šilalė d. mun.;2009;32;261;133;128
Šilalė d. mun.;2009;33;296;154;142
Šilalė d. mun.;2009;34;279;158;121
Šilalė d. mun.;2009;35;295;139;156
Šilalė d. mun.;2009;36;335;172;163
Šilalė d. mun.;2009;37;349;155;194
Šilalė d. mun.;2009;38;377;184;193
Šilalė d. mun.;2009;39;386;196;190
Šilalė d. mun.;2009;40;347;181;166
Šilalė d. mun.;2009;41;349;179;170
Šilalė d. mun.;2009;42;375;189;186
Šilalė d. mun.;2009;43;385;217;168
Šilalė d. mun.;2009;44;418;219;199
Šilalė d. mun.;2009;45;414;201;213
Šilalė d. mun.;2009;46;403;199;204
Šilalė d. mun.;2009;47;451;235;216
Šilalė d. mun.;2009;48;402;214;188
Šilalė d. mun.;2009;49;378;205;173
Šilalė d. mun.;2009;50;395;195;200
Šilalė d. mun.;2009;51;359;164;195
Šilalė d. mun.;2009;52;334;159;175
Šilalė d. mun.;2009;53;331;167;164
Šilalė d. mun.;2009;54;302;140;162
Šilalė d. mun.;2009;55;267;142;125
Šilalė d. mun.;2009;56;263;129;134
Šilalė d. mun.;2009;57;284;126;158
Šilalė d. mun.;2009;58;283;141;142
Šilalė d. mun.;2009;59;278;131;147
Šilalė d. mun.;2009;60;281;127;154
Šilalė d. mun.;2009;61;231;113;118
Šilalė d. mun.;2009;62;208;92;116
Šilalė d. mun.;2009;63;266;122;144
Šilalė d. mun.;2009;64;181;82;99
Šilalė d. mun.;2009;65;228;100;128
Šilalė d. mun.;2009;66;285;96;189
Šilalė d. mun.;2009;67;263;117;146
Šilalė d. mun.;2009;68;225;78;147
Šilalė d. mun.;2009;69;271;113;158
Šilalė d. mun.;2009;70;219;88;131
Šilalė d. mun.;2009;71;264;95;169
Šilalė d. mun.;2009;72;284;111;173
Šilalė d. mun.;2009;73;248;76;172
Šilalė d. mun.;2009;74;227;80;147
Šilalė d. mun.;2009;75;230;78;152
Šilalė d. mun.;2009;76;241;83;158
Šilalė d. mun.;2009;77;229;80;149
Šilalė d. mun.;2009;78;227;76;151
Šilalė d. mun.;2009;79;187;51;136
Šilalė d. mun.;2009;80;193;56;137
Šilalė d. mun.;2009;81;172;46;126
Šilalė d. mun.;2009;82;142;43;99
Šilalė d. mun.;2009;83;125;37;88
Šilalė d. mun.;2009;84;108;31;77
Šilalė d. mun.;2009;85;418;111;307
Šilalė d. mun.;2010;-1;27416;13181;14235
Šilalė d. mun.;2010;0;276;137;139
Šilalė d. mun.;2010;1;240;124;116
Šilalė d. mun.;2010;2;234;126;108
Šilalė d. mun.;2010;3;250;136;114
Šilalė d. mun.;2010;4;277;127;150
Šilalė d. mun.;2010;5;266;138;128
Šilalė d. mun.;2010;6;306;154;152
Šilalė d. mun.;2010;7;302;146;156
Šilalė d. mun.;2010;8;316;158;158
Šilalė d. mun.;2010;9;355;190;165
Šilalė d. mun.;2010;10;395;211;184
Šilalė d. mun.;2010;11;377;202;175
Šilalė d. mun.;2010;12;369;191;178
Šilalė d. mun.;2010;13;417;231;186
Šilalė d. mun.;2010;14;440;235;205
Šilalė d. mun.;2010;15;509;250;259
Šilalė d. mun.;2010;16;543;269;274
Šilalė d. mun.;2010;17;582;282;300
Šilalė d. mun.;2010;18;552;303;249
Šilalė d. mun.;2010;19;560;269;291
Šilalė d. mun.;2010;20;512;258;254
Šilalė d. mun.;2010;21;477;248;229
Šilalė d. mun.;2010;22;524;258;266
Šilalė d. mun.;2010;23;442;227;215
Šilalė d. mun.;2010;24;458;237;221
Šilalė d. mun.;2010;25;421;219;202
Šilalė d. mun.;2010;26;388;198;190
Šilalė d. mun.;2010;27;294;161;133
Šilalė d. mun.;2010;28;242;149;93
Šilalė d. mun.;2010;29;227;142;85
Šilalė d. mun.;2010;30;275;152;123
Šilalė d. mun.;2010;31;268;136;132
Šilalė d. mun.;2010;32;248;146;102
Šilalė d. mun.;2010;33;255;129;126
Šilalė d. mun.;2010;34;287;147;140
Šilalė d. mun.;2010;35;271;154;117
Šilalė d. mun.;2010;36;293;138;155
Šilalė d. mun.;2010;37;328;168;160
Šilalė d. mun.;2010;38;346;153;193
Šilalė d. mun.;2010;39;370;178;192
Šilalė d. mun.;2010;40;382;194;188
Šilalė d. mun.;2010;41;345;179;166
Šilalė d. mun.;2010;42;343;174;169
Šilalė d. mun.;2010;43;373;189;184
Šilalė d. mun.;2010;44;377;212;165
Šilalė d. mun.;2010;45;409;214;195
Šilalė d. mun.;2010;46;407;197;210
Šilalė d. mun.;2010;47;401;198;203
Šilalė d. mun.;2010;48;441;228;213
Šilalė d. mun.;2010;49;391;205;186
Šilalė d. mun.;2010;50;370;200;170
Šilalė d. mun.;2010;51;387;191;196
Šilalė d. mun.;2010;52;357;163;194
Šilalė d. mun.;2010;53;331;156;175
Šilalė d. mun.;2010;54;325;162;163
Šilalė d. mun.;2010;55;297;136;161
Šilalė d. mun.;2010;56;262;142;120
Šilalė d. mun.;2010;57;254;123;131
Šilalė d. mun.;2010;58;277;120;157
Šilalė d. mun.;2010;59;278;137;141
Šilalė d. mun.;2010;60;275;130;145
Šilalė d. mun.;2010;61;273;123;150
Šilalė d. mun.;2010;62;229;111;118
Šilalė d. mun.;2010;63;203;90;113
Šilalė d. mun.;2010;64;259;116;143
Šilalė d. mun.;2010;65;177;80;97
Šilalė d. mun.;2010;66;224;97;127
Šilalė d. mun.;2010;67;283;95;188
Šilalė d. mun.;2010;68;256;114;142
Šilalė d. mun.;2010;69;221;76;145
Šilalė d. mun.;2010;70;262;105;157
Šilalė d. mun.;2010;71;209;83;126
Šilalė d. mun.;2010;72;251;89;162
Šilalė d. mun.;2010;73;274;105;169
Šilalė d. mun.;2010;74;239;70;169
Šilalė d. mun.;2010;75;221;77;144
Šilalė d. mun.;2010;76;222;73;149
Šilalė d. mun.;2010;77;222;74;148
Šilalė d. mun.;2010;78;210;74;136
Šilalė d. mun.;2010;79;214;70;144
Šilalė d. mun.;2010;80;181;49;132
Šilalė d. mun.;2010;81;177;50;127
Šilalė d. mun.;2010;82;158;39;119
Šilalė d. mun.;2010;83;130;41;89
Šilalė d. mun.;2010;84;117;35;82
Šilalė d. mun.;2010;85;430;118;312
Šilalė d. mun.;2011;-1;26586;12779;13807
Šilalė d. mun.;2011;0;236;117;119
Šilalė d. mun.;2011;1;250;127;123
Šilalė d. mun.;2011;2;201;109;92
Šilalė d. mun.;2011;3;217;113;104
Šilalė d. mun.;2011;4;241;131;110
Šilalė d. mun.;2011;5;244;118;126
Šilalė d. mun.;2011;6;246;125;121
Šilalė d. mun.;2011;7;292;144;148
Šilalė d. mun.;2011;8;284;139;145
Šilalė d. mun.;2011;9;289;145;144
Šilalė d. mun.;2011;10;344;185;159
Šilalė d. mun.;2011;11;372;200;172
Šilalė d. mun.;2011;12;372;202;170
Šilalė d. mun.;2011;13;371;193;178
Šilalė d. mun.;2011;14;408;222;186
Šilalė d. mun.;2011;15;433;238;195
Šilalė d. mun.;2011;16;505;249;256
Šilalė d. mun.;2011;17;547;276;271
Šilalė d. mun.;2011;18;572;282;290
Šilalė d. mun.;2011;19;476;282;194
Šilalė d. mun.;2011;20;461;230;231
Šilalė d. mun.;2011;21;406;218;188
Šilalė d. mun.;2011;22;362;211;151
Šilalė d. mun.;2011;23;389;207;182
Šilalė d. mun.;2011;24;317;170;147
Šilalė d. mun.;2011;25;325;180;145
Šilalė d. mun.;2011;26;283;150;133
Šilalė d. mun.;2011;27;243;130;113
Šilalė d. mun.;2011;28;235;119;116
Šilalė d. mun.;2011;29;265;142;123
Šilalė d. mun.;2011;30;247;132;115
Šilalė d. mun.;2011;31;292;151;141
Šilalė d. mun.;2011;32;299;146;153
Šilalė d. mun.;2011;33;293;157;136
Šilalė d. mun.;2011;34;281;128;153
Šilalė d. mun.;2011;35;328;171;157
Šilalė d. mun.;2011;36;305;155;150
Šilalė d. mun.;2011;37;337;161;176
Šilalė d. mun.;2011;38;357;177;180
Šilalė d. mun.;2011;39;374;168;206
Šilalė d. mun.;2011;40;399;195;204
Šilalė d. mun.;2011;41;400;212;188
Šilalė d. mun.;2011;42;378;196;182
Šilalė d. mun.;2011;43;347;169;178
Šilalė d. mun.;2011;44;388;194;194
Šilalė d. mun.;2011;45;385;211;174
Šilalė d. mun.;2011;46;427;218;209
Šilalė d. mun.;2011;47;424;206;218
Šilalė d. mun.;2011;48;422;211;211
Šilalė d. mun.;2011;49;455;242;213
Šilalė d. mun.;2011;50;402;214;188
Šilalė d. mun.;2011;51;376;200;176
Šilalė d. mun.;2011;52;393;201;192
Šilalė d. mun.;2011;53;361;163;198
Šilalė d. mun.;2011;54;353;172;181
Šilalė d. mun.;2011;55;325;159;166
Šilalė d. mun.;2011;56;311;139;172
Šilalė d. mun.;2011;57;278;149;129
Šilalė d. mun.;2011;58;260;129;131
Šilalė d. mun.;2011;59;290;129;161
Šilalė d. mun.;2011;60;292;144;148
Šilalė d. mun.;2011;61;276;122;154
Šilalė d. mun.;2011;62;275;118;157
Šilalė d. mun.;2011;63;221;109;112
Šilalė d. mun.;2011;64;187;79;108
Šilalė d. mun.;2011;65;257;115;142
Šilalė d. mun.;2011;66;183;77;106
Šilalė d. mun.;2011;67;233;99;134
Šilalė d. mun.;2011;68;283;94;189
Šilalė d. mun.;2011;69;249;107;142
Šilalė d. mun.;2011;70;226;85;141
Šilalė d. mun.;2011;71;253;100;153
Šilalė d. mun.;2011;72;198;73;125
Šilalė d. mun.;2011;73;246;85;161
Šilalė d. mun.;2011;74;265;100;165
Šilalė d. mun.;2011;75;232;65;167
Šilalė d. mun.;2011;76;207;69;138
Šilalė d. mun.;2011;77;214;63;151
Šilalė d. mun.;2011;78;205;64;141
Šilalė d. mun.;2011;79;182;59;123
Šilalė d. mun.;2011;80;199;65;134
Šilalė d. mun.;2011;81;155;39;116
Šilalė d. mun.;2011;82;161;48;113
Šilalė d. mun.;2011;83;139;38;101
Šilalė d. mun.;2011;84;111;31;80
Šilalė d. mun.;2011;85;464;122;342
Šilalė d. mun.;2012;-1;26047;12537;13510
Šilalė d. mun.;2012;0;274;143;131
Šilalė d. mun.;2012;1;235;116;119
Šilalė d. mun.;2012;2;246;127;119
Šilalė d. mun.;2012;3;196;108;88
Šilalė d. mun.;2012;4;213;113;100
Šilalė d. mun.;2012;5;232;130;102
Šilalė d. mun.;2012;6;238;117;121
Šilalė d. mun.;2012;7;242;123;119
Šilalė d. mun.;2012;8;292;144;148
Šilalė d. mun.;2012;9;277;136;141
Šilalė d. mun.;2012;10;285;145;140
Šilalė d. mun.;2012;11;341;183;158
Šilalė d. mun.;2012;12;367;198;169
Šilalė d. mun.;2012;13;368;200;168
Šilalė d. mun.;2012;14;369;192;177
Šilalė d. mun.;2012;15;402;219;183
Šilalė d. mun.;2012;16;430;238;192
Šilalė d. mun.;2012;17;504;250;254
Šilalė d. mun.;2012;18;543;277;266
Šilalė d. mun.;2012;19;561;279;282
Šilalė d. mun.;2012;20;467;277;190
Šilalė d. mun.;2012;21;448;223;225
Šilalė d. mun.;2012;22;392;210;182
Šilalė d. mun.;2012;23;330;199;131
Šilalė d. mun.;2012;24;366;192;174
Šilalė d. mun.;2012;25;276;152;124
Šilalė d. mun.;2012;26;296;169;127
Šilalė d. mun.;2012;27;267;145;122
Šilalė d. mun.;2012;28;222;116;106
Šilalė d. mun.;2012;29;212;113;99
Šilalė d. mun.;2012;30;255;130;125
Šilalė d. mun.;2012;31;235;126;109
Šilalė d. mun.;2012;32;283;144;139
Šilalė d. mun.;2012;33;287;138;149
Šilalė d. mun.;2012;34;283;152;131
Šilalė d. mun.;2012;35;266;122;144
Šilalė d. mun.;2012;36;326;170;156
Šilalė d. mun.;2012;37;294;148;146
Šilalė d. mun.;2012;38;331;156;175
Šilalė d. mun.;2012;39;355;174;181
Šilalė d. mun.;2012;40;370;167;203
Šilalė d. mun.;2012;41;394;194;200
Šilalė d. mun.;2012;42;389;206;183
Šilalė d. mun.;2012;43;377;196;181
Šilalė d. mun.;2012;44;342;165;177
Šilalė d. mun.;2012;45;381;189;192
Šilalė d. mun.;2012;46;378;206;172
Šilalė d. mun.;2012;47;422;215;207
Šilalė d. mun.;2012;48;425;205;220
Šilalė d. mun.;2012;49;417;212;205
Šilalė d. mun.;2012;50;442;235;207
Šilalė d. mun.;2012;51;395;209;186
Šilalė d. mun.;2012;52;368;195;173
Šilalė d. mun.;2012;53;389;198;191
Šilalė d. mun.;2012;54;358;162;196
Šilalė d. mun.;2012;55;350;170;180
Šilalė d. mun.;2012;56;320;156;164
Šilalė d. mun.;2012;57;310;137;173
Šilalė d. mun.;2012;58;273;145;128
Šilalė d. mun.;2012;59;255;126;129
Šilalė d. mun.;2012;60;283;123;160
Šilalė d. mun.;2012;61;288;140;148
Šilalė d. mun.;2012;62;269;116;153
Šilalė d. mun.;2012;63;267;111;156
Šilalė d. mun.;2012;64;220;108;112
Šilalė d. mun.;2012;65;180;76;104
Šilalė d. mun.;2012;66;246;107;139
Šilalė d. mun.;2012;67;180;74;106
Šilalė d. mun.;2012;68;229;97;132
Šilalė d. mun.;2012;69;274;87;187
Šilalė d. mun.;2012;70;241;104;137
Šilalė d. mun.;2012;71;214;80;134
Šilalė d. mun.;2012;72;246;96;150
Šilalė d. mun.;2012;73;191;67;124
Šilalė d. mun.;2012;74;235;84;151
Šilalė d. mun.;2012;75;249;92;157
Šilalė d. mun.;2012;76;222;62;160
Šilalė d. mun.;2012;77;198;63;135
Šilalė d. mun.;2012;78;206;59;147
Šilalė d. mun.;2012;79;196;62;134
Šilalė d. mun.;2012;80;167;54;113
Šilalė d. mun.;2012;81;184;59;125
Šilalė d. mun.;2012;82;140;33;107
Šilalė d. mun.;2012;83;145;44;101
Šilalė d. mun.;2012;84;120;30;90
Šilalė d. mun.;2012;85;496;127;369
Šilalė d. mun.;2013;-1;25533;12309;13224
Šilalė d. mun.;2013;0;286;162;124
Šilalė d. mun.;2013;1;270;143;127
Šilalė d. mun.;2013;2;221;106;115
Šilalė d. mun.;2013;3;242;123;119
Šilalė d. mun.;2013;4;194;108;86
Šilalė d. mun.;2013;5;208;112;96
Šilalė d. mun.;2013;6;230;128;102
Šilalė d. mun.;2013;7;239;115;124
Šilalė d. mun.;2013;8;238;119;119
Šilalė d. mun.;2013;9;284;145;139
Šilalė d. mun.;2013;10;275;135;140
Šilalė d. mun.;2013;11;283;144;139
Šilalė d. mun.;2013;12;344;185;159
Šilalė d. mun.;2013;13;363;198;165
Šilalė d. mun.;2013;14;368;198;170
Šilalė d. mun.;2013;15;367;191;176
Šilalė d. mun.;2013;16;403;219;184
Šilalė d. mun.;2013;17;427;235;192
Šilalė d. mun.;2013;18;499;248;251
Šilalė d. mun.;2013;19;541;272;269
Šilalė d. mun.;2013;20;553;278;275
Šilalė d. mun.;2013;21;457;275;182
Šilalė d. mun.;2013;22;421;213;208
Šilalė d. mun.;2013;23;350;190;160
Šilalė d. mun.;2013;24;311;196;115
Šilalė d. mun.;2013;25;344;193;151
Šilalė d. mun.;2013;26;246;137;109
Šilalė d. mun.;2013;27;260;154;106
Šilalė d. mun.;2013;28;241;134;107
Šilalė d. mun.;2013;29;203;104;99
Šilalė d. mun.;2013;30;195;100;95
Šilalė d. mun.;2013;31;244;121;123
Šilalė d. mun.;2013;32;221;116;105
Šilalė d. mun.;2013;33;266;131;135
Šilalė d. mun.;2013;34;276;134;142
Šilalė d. mun.;2013;35;269;143;126
Šilalė d. mun.;2013;36;261;118;143
Šilalė d. mun.;2013;37;322;162;160
Šilalė d. mun.;2013;38;295;149;146
Šilalė d. mun.;2013;39;326;154;172
Šilalė d. mun.;2013;40;358;177;181
Šilalė d. mun.;2013;41;370;170;200
Šilalė d. mun.;2013;42;384;186;198
Šilalė d. mun.;2013;43;387;205;182
Šilalė d. mun.;2013;44;375;194;181
Šilalė d. mun.;2013;45;341;166;175
Šilalė d. mun.;2013;46;374;185;189
Šilalė d. mun.;2013;47;371;203;168
Šilalė d. mun.;2013;48;415;210;205
Šilalė d. mun.;2013;49;420;201;219
Šilalė d. mun.;2013;50;411;206;205
Šilalė d. mun.;2013;51;439;233;206
Šilalė d. mun.;2013;52;396;210;186
Šilalė d. mun.;2013;53;366;194;172
Šilalė d. mun.;2013;54;385;195;190
Šilalė d. mun.;2013;55;354;163;191
Šilalė d. mun.;2013;56;344;165;179
Šilalė d. mun.;2013;57;316;153;163
Šilalė d. mun.;2013;58;303;130;173
Šilalė d. mun.;2013;59;270;143;127
Šilalė d. mun.;2013;60;248;122;126
Šilalė d. mun.;2013;61;274;116;158
Šilalė d. mun.;2013;62;281;136;145
Šilalė d. mun.;2013;63;264;111;153
Šilalė d. mun.;2013;64;260;106;154
Šilalė d. mun.;2013;65;215;106;109
Šilalė d. mun.;2013;66;175;71;104
Šilalė d. mun.;2013;67;237;101;136
Šilalė d. mun.;2013;68;176;73;103
Šilalė d. mun.;2013;69;222;94;128
Šilalė d. mun.;2013;70;271;83;188
Šilalė d. mun.;2013;71;233;100;133
Šilalė d. mun.;2013;72;207;76;131
Šilalė d. mun.;2013;73;238;90;148
Šilalė d. mun.;2013;74;181;63;118
Šilalė d. mun.;2013;75;225;78;147
Šilalė d. mun.;2013;76;241;86;155
Šilalė d. mun.;2013;77;210;54;156
Šilalė d. mun.;2013;78;185;56;129
Šilalė d. mun.;2013;79;196;56;140
Šilalė d. mun.;2013;80;182;54;128
Šilalė d. mun.;2013;81;151;47;104
Šilalė d. mun.;2013;82;171;53;118
Šilalė d. mun.;2013;83;120;29;91
Šilalė d. mun.;2013;84;126;36;90
Šilalė d. mun.;2013;85;522;135;387
Šilalė d. mun.;2014;-1;25191;12164;13027
Šilalė d. mun.;2014;0;292;156;136
Šilalė d. mun.;2014;1;281;159;122
Šilalė d. mun.;2014;2;270;141;129
Šilalė d. mun.;2014;3;219;104;115
Šilalė d. mun.;2014;4;240;123;117
Šilalė d. mun.;2014;5;187;105;82
Šilalė d. mun.;2014;6;208;112;96
Šilalė d. mun.;2014;7;222;122;100
Šilalė d. mun.;2014;8;241;118;123
Šilalė d. mun.;2014;9;244;120;124
Šilalė d. mun.;2014;10;283;145;138
Šilalė d. mun.;2014;11;272;133;139
Šilalė d. mun.;2014;12;282;142;140
Šilalė d. mun.;2014;13;342;186;156
Šilalė d. mun.;2014;14;364;200;164
Šilalė d. mun.;2014;15;365;196;169
Šilalė d. mun.;2014;16;365;188;177
Šilalė d. mun.;2014;17;398;217;181
Šilalė d. mun.;2014;18;425;234;191
Šilalė d. mun.;2014;19;483;242;241
Šilalė d. mun.;2014;20;533;269;264
Šilalė d. mun.;2014;21;543;275;268
Šilalė d. mun.;2014;22;443;269;174
Šilalė d. mun.;2014;23;403;201;202
Šilalė d. mun.;2014;24;335;191;144
Šilalė d. mun.;2014;25;298;187;111
Šilalė d. mun.;2014;26;329;196;133
Šilalė d. mun.;2014;27;235;140;95
Šilalė d. mun.;2014;28;236;143;93
Šilalė d. mun.;2014;29;234;129;105
Šilalė d. mun.;2014;30;194;102;92
Šilalė d. mun.;2014;31;189;95;94
Šilalė d. mun.;2014;32;243;120;123
Šilalė d. mun.;2014;33;217;111;106
Šilalė d. mun.;2014;34;255;124;131
Šilalė d. mun.;2014;35;270;127;143
Šilalė d. mun.;2014;36;265;140;125
Šilalė d. mun.;2014;37;256;115;141
Šilalė d. mun.;2014;38;322;162;160
Šilalė d. mun.;2014;39;291;145;146
Šilalė d. mun.;2014;40;324;153;171
Šilalė d. mun.;2014;41;350;172;178
Šilalė d. mun.;2014;42;368;170;198
Šilalė d. mun.;2014;43;385;186;199
Šilalė d. mun.;2014;44;385;203;182
Šilalė d. mun.;2014;45;373;194;179
Šilalė d. mun.;2014;46;337;162;175
Šilalė d. mun.;2014;47;378;187;191
Šilalė d. mun.;2014;48;369;200;169
Šilalė d. mun.;2014;49;409;206;203
Šilalė d. mun.;2014;50;418;200;218
Šilalė d. mun.;2014;51;408;204;204
Šilalė d. mun.;2014;52;434;228;206
Šilalė d. mun.;2014;53;393;208;185
Šilalė d. mun.;2014;54;364;194;170
Šilalė d. mun.;2014;55;378;189;189
Šilalė d. mun.;2014;56;353;162;191
Šilalė d. mun.;2014;57;336;161;175
Šilalė d. mun.;2014;58;310;148;162
Šilalė d. mun.;2014;59;300;126;174
Šilalė d. mun.;2014;60;269;140;129
Šilalė d. mun.;2014;61;241;117;124
Šilalė d. mun.;2014;62;269;112;157
Šilalė d. mun.;2014;63;273;128;145
Šilalė d. mun.;2014;64;259;108;151
Šilalė d. mun.;2014;65;256;102;154
Šilalė d. mun.;2014;66;208;99;109
Šilalė d. mun.;2014;67;166;66;100
Šilalė d. mun.;2014;68;234;98;136
Šilalė d. mun.;2014;69;172;71;101
Šilalė d. mun.;2014;70;210;86;124
Šilalė d. mun.;2014;71;265;79;186
Šilalė d. mun.;2014;72;222;95;127
Šilalė d. mun.;2014;73;200;72;128
Šilalė d. mun.;2014;74;229;88;141
Šilalė d. mun.;2014;75;173;60;113
Šilalė d. mun.;2014;76;218;74;144
Šilalė d. mun.;2014;77;234;82;152
Šilalė d. mun.;2014;78;202;51;151
Šilalė d. mun.;2014;79;171;48;123
Šilalė d. mun.;2014;80;178;46;132
Šilalė d. mun.;2014;81;169;50;119
Šilalė d. mun.;2014;82;142;46;96
Šilalė d. mun.;2014;83;154;47;107
Šilalė d. mun.;2014;84;104;26;78
Šilalė d. mun.;2014;85;527;136;391
Šilalė d. mun.;2015;-1;24869;12034;12835
Šilalė d. mun.;2015;0;268;142;126
Šilalė d. mun.;2015;1;291;156;135
Šilalė d. mun.;2015;2;269;154;115
Šilalė d. mun.;2015;3;269;140;129
Šilalė d. mun.;2015;4;212;103;109
Šilalė d. mun.;2015;5;239;122;117
Šilalė d. mun.;2015;6;183;102;81
Šilalė d. mun.;2015;7;210;115;95
Šilalė d. mun.;2015;8;218;121;97
Šilalė d. mun.;2015;9;242;118;124
Šilalė d. mun.;2015;10;238;117;121
Šilalė d. mun.;2015;11;278;144;134
Šilalė d. mun.;2015;12;274;135;139
Šilalė d. mun.;2015;13;281;142;139
Šilalė d. mun.;2015;14;339;184;155
Šilalė d. mun.;2015;15;361;198;163
Šilalė d. mun.;2015;16;361;195;166
Šilalė d. mun.;2015;17;364;187;177
Šilalė d. mun.;2015;18;391;215;176
Šilalė d. mun.;2015;19;421;230;191
Šilalė d. mun.;2015;20;476;239;237
Šilalė d. mun.;2015;21;526;268;258
Šilalė d. mun.;2015;22;540;275;265
Šilalė d. mun.;2015;23;427;262;165
Šilalė d. mun.;2015;24;386;199;187
Šilalė d. mun.;2015;25;318;182;136
Šilalė d. mun.;2015;26;285;183;102
Šilalė d. mun.;2015;27;317;188;129
Šilalė d. mun.;2015;28;217;132;85
Šilalė d. mun.;2015;29;233;139;94
Šilalė d. mun.;2015;30;226;124;102
Šilalė d. mun.;2015;31;186;98;88
Šilalė d. mun.;2015;32;180;89;91
Šilalė d. mun.;2015;33;247;121;126
Šilalė d. mun.;2015;34;207;102;105
Šilalė d. mun.;2015;35;243;123;120
Šilalė d. mun.;2015;36;255;115;140
Šilalė d. mun.;2015;37;257;136;121
Šilalė d. mun.;2015;38;249;113;136
Šilalė d. mun.;2015;39;322;162;160
Šilalė d. mun.;2015;40;287;140;147
Šilalė d. mun.;2015;41;320;151;169
Šilalė d. mun.;2015;42;338;165;173
Šilalė d. mun.;2015;43;364;165;199
Šilalė d. mun.;2015;44;381;182;199
Šilalė d. mun.;2015;45;375;198;177
Šilalė d. mun.;2015;46;371;192;179
Šilalė d. mun.;2015;47;332;160;172
Šilalė d. mun.;2015;48;377;185;192
Šilalė d. mun.;2015;49;373;204;169
Šilalė d. mun.;2015;50;405;203;202
Šilalė d. mun.;2015;51;414;196;218
Šilalė d. mun.;2015;52;410;207;203
Šilalė d. mun.;2015;53;434;230;204
Šilalė d. mun.;2015;54;388;204;184
Šilalė d. mun.;2015;55;362;192;170
Šilalė d. mun.;2015;56;373;188;185
Šilalė d. mun.;2015;57;351;161;190
Šilalė d. mun.;2015;58;333;159;174
Šilalė d. mun.;2015;59;308;144;164
Šilalė d. mun.;2015;60;298;125;173
Šilalė d. mun.;2015;61;266;137;129
Šilalė d. mun.;2015;62;237;113;124
Šilalė d. mun.;2015;63;266;111;155
Šilalė d. mun.;2015;64;265;120;145
Šilalė d. mun.;2015;65;248;105;143
Šilalė d. mun.;2015;66;247;96;151
Šilalė d. mun.;2015;67;209;97;112
Šilalė d. mun.;2015;68;161;62;99
Šilalė d. mun.;2015;69;231;96;135
Šilalė d. mun.;2015;70;169;68;101
Šilalė d. mun.;2015;71;207;83;124
Šilalė d. mun.;2015;72;254;74;180
Šilalė d. mun.;2015;73;219;95;124
Šilalė d. mun.;2015;74;193;69;124
Šilalė d. mun.;2015;75;224;85;139
Šilalė d. mun.;2015;76;165;58;107
Šilalė d. mun.;2015;77;209;70;139
Šilalė d. mun.;2015;78;222;76;146
Šilalė d. mun.;2015;79;190;47;143
Šilalė d. mun.;2015;80;167;46;121
Šilalė d. mun.;2015;81;165;42;123
Šilalė d. mun.;2015;82;151;44;107
Šilalė d. mun.;2015;83;127;39;88
Šilalė d. mun.;2015;84;140;44;96
Šilalė d. mun.;2015;85;537;136;401
Šilalė d. mun.;2016;-1;24433;11851;12582
Šilalė d. mun.;2016;0;291;153;138
Šilalė d. mun.;2016;1;263;139;124
Šilalė d. mun.;2016;2;283;154;129
Šilalė d. mun.;2016;3;268;150;118
Šilalė d. mun.;2016;4;267;142;125
Šilalė d. mun.;2016;5;206;101;105
Šilalė d. mun.;2016;6;236;120;116
Šilalė d. mun.;2016;7;181;106;75
Šilalė d. mun.;2016;8;213;116;97
Šilalė d. mun.;2016;9;219;119;100
Šilalė d. mun.;2016;10;235;115;120
Šilalė d. mun.;2016;11;237;115;122
Šilalė d. mun.;2016;12;277;144;133
Šilalė d. mun.;2016;13;273;134;139
Šilalė d. mun.;2016;14;276;138;138
Šilalė d. mun.;2016;15;335;184;151
Šilalė d. mun.;2016;16;362;198;164
Šilalė d. mun.;2016;17;361;195;166
Šilalė d. mun.;2016;18;365;187;178
Šilalė d. mun.;2016;19;381;211;170
Šilalė d. mun.;2016;20;415;226;189
Šilalė d. mun.;2016;21;472;236;236
Šilalė d. mun.;2016;22;511;259;252
Šilalė d. mun.;2016;23;509;258;251
Šilalė d. mun.;2016;24;391;247;144
Šilalė d. mun.;2016;25;369;195;174
Šilalė d. mun.;2016;26;301;174;127
Šilalė d. mun.;2016;27;263;175;88
Šilalė d. mun.;2016;28;299;182;117
Šilalė d. mun.;2016;29;201;130;71
Šilalė d. mun.;2016;30;215;129;86
Šilalė d. mun.;2016;31;210;118;92
Šilalė d. mun.;2016;32;185;96;89
Šilalė d. mun.;2016;33;173;88;85
Šilalė d. mun.;2016;34;239;122;117
Šilalė d. mun.;2016;35;199;98;101
Šilalė d. mun.;2016;36;243;122;121
Šilalė d. mun.;2016;37;256;119;137
Šilalė d. mun.;2016;38;253;133;120
Šilalė d. mun.;2016;39;237;103;134
Šilalė d. mun.;2016;40;321;163;158
Šilalė d. mun.;2016;41;282;138;144
Šilalė d. mun.;2016;42;312;147;165
Šilalė d. mun.;2016;43;328;156;172
Šilalė d. mun.;2016;44;363;167;196
Šilalė d. mun.;2016;45;377;180;197
Šilalė d. mun.;2016;46;369;193;176
Šilalė d. mun.;2016;47;368;188;180
Šilalė d. mun.;2016;48;331;159;172
Šilalė d. mun.;2016;49;372;182;190
Šilalė d. mun.;2016;50;370;203;167
Šilalė d. mun.;2016;51;405;202;203
Šilalė d. mun.;2016;52;408;192;216
Šilalė d. mun.;2016;53;404;204;200
Šilalė d. mun.;2016;54;424;225;199
Šilalė d. mun.;2016;55;387;204;183
Šilalė d. mun.;2016;56;352;186;166
Šilalė d. mun.;2016;57;368;186;182
Šilalė d. mun.;2016;58;343;155;188
Šilalė d. mun.;2016;59;328;157;171
Šilalė d. mun.;2016;60;306;143;163
Šilalė d. mun.;2016;61;286;117;169
Šilalė d. mun.;2016;62;262;134;128
Šilalė d. mun.;2016;63;236;111;125
Šilalė d. mun.;2016;64;263;109;154
Šilalė d. mun.;2016;65;261;117;144
Šilalė d. mun.;2016;66;246;102;144
Šilalė d. mun.;2016;67;242;91;151
Šilalė d. mun.;2016;68;203;91;112
Šilalė d. mun.;2016;69;157;59;98
Šilalė d. mun.;2016;70;224;91;133
Šilalė d. mun.;2016;71;160;60;100
Šilalė d. mun.;2016;72;201;80;121
Šilalė d. mun.;2016;73;242;67;175
Šilalė d. mun.;2016;74;209;88;121
Šilalė d. mun.;2016;75;185;63;122
Šilalė d. mun.;2016;76;212;77;135
Šilalė d. mun.;2016;77;158;55;103
Šilalė d. mun.;2016;78;201;67;134
Šilalė d. mun.;2016;79;205;71;134
Šilalė d. mun.;2016;80;170;41;129
Šilalė d. mun.;2016;81;154;43;111
Šilalė d. mun.;2016;82;152;39;113
Šilalė d. mun.;2016;83;138;40;98
Šilalė d. mun.;2016;84;120;35;85
Šilalė d. mun.;2016;85;558;142;416
Šilalė d. mun.;2017;-1;23791;11574;12217
Šilalė d. mun.;2017;0;253;126;127
Šilalė d. mun.;2017;1;283;148;135
Šilalė d. mun.;2017;2;249;135;114
Šilalė d. mun.;2017;3;283;153;130
Šilalė d. mun.;2017;4;260;143;117
Šilalė d. mun.;2017;5;263;142;121
Šilalė d. mun.;2017;6;198;100;98
Šilalė d. mun.;2017;7;229;114;115
Šilalė d. mun.;2017;8;176;104;72
Šilalė d. mun.;2017;9;211;115;96
Šilalė d. mun.;2017;10;218;120;98
Šilalė d. mun.;2017;11;231;115;116
Šilalė d. mun.;2017;12;234;115;119
Šilalė d. mun.;2017;13;274;142;132
Šilalė d. mun.;2017;14;265;131;134
Šilalė d. mun.;2017;15;273;136;137
Šilalė d. mun.;2017;16;332;182;150
Šilalė d. mun.;2017;17;355;195;160
Šilalė d. mun.;2017;18;358;197;161
Šilalė d. mun.;2017;19;354;185;169
Šilalė d. mun.;2017;20;371;203;168
Šilalė d. mun.;2017;21;401;218;183
Šilalė d. mun.;2017;22;452;228;224
Šilalė d. mun.;2017;23;485;250;235
Šilalė d. mun.;2017;24;484;250;234
Šilalė d. mun.;2017;25;363;231;132
Šilalė d. mun.;2017;26;339;188;151
Šilalė d. mun.;2017;27;268;155;113
Šilalė d. mun.;2017;28;236;166;70
Šilalė d. mun.;2017;29;273;175;98
Šilalė d. mun.;2017;30;180;113;67
Šilalė d. mun.;2017;31;194;117;77
Šilalė d. mun.;2017;32;200;112;88
Šilalė d. mun.;2017;33;177;91;86
Šilalė d. mun.;2017;34;158;76;82
Šilalė d. mun.;2017;35;226;118;108
Šilalė d. mun.;2017;36;195;95;100
Šilalė d. mun.;2017;37;226;114;112
Šilalė d. mun.;2017;38;247;114;133
Šilalė d. mun.;2017;39;250;132;118
Šilalė d. mun.;2017;40;231;101;130
Šilalė d. mun.;2017;41;314;160;154
Šilalė d. mun.;2017;42;277;137;140
Šilalė d. mun.;2017;43;310;144;166
Šilalė d. mun.;2017;44;325;154;171
Šilalė d. mun.;2017;45;352;163;189
Šilalė d. mun.;2017;46;371;174;197
Šilalė d. mun.;2017;47;366;190;176
Šilalė d. mun.;2017;48;368;188;180
Šilalė d. mun.;2017;49;328;156;172
Šilalė d. mun.;2017;50;368;178;190
Šilalė d. mun.;2017;51;359;196;163
Šilalė d. mun.;2017;52;401;197;204
Šilalė d. mun.;2017;53;402;190;212
Šilalė d. mun.;2017;54;403;203;200
Šilalė d. mun.;2017;55;421;221;200
Šilalė d. mun.;2017;56;378;200;178
Šilalė d. mun.;2017;57;353;187;166
Šilalė d. mun.;2017;58;363;182;181
Šilalė d. mun.;2017;59;340;154;186
Šilalė d. mun.;2017;60;323;153;170
Šilalė d. mun.;2017;61;300;140;160
Šilalė d. mun.;2017;62;282;114;168
Šilalė d. mun.;2017;63;256;131;125
Šilalė d. mun.;2017;64;228;106;122
Šilalė d. mun.;2017;65;261;106;155
Šilalė d. mun.;2017;66;258;115;143
Šilalė d. mun.;2017;67;240;100;140
Šilalė d. mun.;2017;68;237;89;148
Šilalė d. mun.;2017;69;198;88;110
Šilalė d. mun.;2017;70;154;56;98
Šilalė d. mun.;2017;71;215;82;133
Šilalė d. mun.;2017;72;155;57;98
Šilalė d. mun.;2017;73;190;76;114
Šilalė d. mun.;2017;74;224;59;165
Šilalė d. mun.;2017;75;204;82;122
Šilalė d. mun.;2017;76;177;58;119
Šilalė d. mun.;2017;77;199;69;130
Šilalė d. mun.;2017;78;155;53;102
Šilalė d. mun.;2017;79;188;64;124
Šilalė d. mun.;2017;80;181;60;121
Šilalė d. mun.;2017;81;159;40;119
Šilalė d. mun.;2017;82;136;37;99
Šilalė d. mun.;2017;83;136;33;103
Šilalė d. mun.;2017;84;127;37;90
Šilalė d. mun.;2017;85;554;150;404
Šilalė d. mun.;2018;-1;23060;11221;11839
Šilalė d. mun.;2018;0;225;107;118
Šilalė d. mun.;2018;1;246;124;122
Šilalė d. mun.;2018;2;275;144;131
Šilalė d. mun.;2018;3;247;135;112
Šilalė d. mun.;2018;4;277;150;127
Šilalė d. mun.;2018;5;261;148;113
Šilalė d. mun.;2018;6;257;138;119
Šilalė d. mun.;2018;7;195;99;96
Šilalė d. mun.;2018;8;230;116;114
Šilalė d. mun.;2018;9;174;103;71
Šilalė d. mun.;2018;10;205;114;91
Šilalė d. mun.;2018;11;213;119;94
Šilalė d. mun.;2018;12;228;116;112
Šilalė d. mun.;2018;13;231;112;119
Šilalė d. mun.;2018;14;269;141;128
Šilalė d. mun.;2018;15;264;132;132
Šilalė d. mun.;2018;16;271;134;137
Šilalė d. mun.;2018;17;329;179;150
Šilalė d. mun.;2018;18;344;189;155
Šilalė d. mun.;2018;19;338;185;153
Šilalė d. mun.;2018;20;342;179;163
Šilalė d. mun.;2018;21;347;191;156
Šilalė d. mun.;2018;22;381;208;173
Šilalė d. mun.;2018;23;430;219;211
Šilalė d. mun.;2018;24;435;230;205
Šilalė d. mun.;2018;25;423;221;202
Šilalė d. mun.;2018;26;326;212;114
Šilalė d. mun.;2018;27;305;174;131
Šilalė d. mun.;2018;28;238;144;94
Šilalė d. mun.;2018;29;210;149;61
Šilalė d. mun.;2018;30;250;164;86
Šilalė d. mun.;2018;31;166;106;60
Šilalė d. mun.;2018;32;172;103;69
Šilalė d. mun.;2018;33;187;102;85
Šilalė d. mun.;2018;34;160;80;80
Šilalė d. mun.;2018;35;145;70;75
Šilalė d. mun.;2018;36;217;115;102
Šilalė d. mun.;2018;37;187;91;96
Šilalė d. mun.;2018;38;223;114;109
Šilalė d. mun.;2018;39;242;111;131
Šilalė d. mun.;2018;40;243;127;116
Šilalė d. mun.;2018;41;225;97;128
Šilalė d. mun.;2018;42;305;155;150
Šilalė d. mun.;2018;43;266;129;137
Šilalė d. mun.;2018;44;306;141;165
Šilalė d. mun.;2018;45;318;151;167
Šilalė d. mun.;2018;46;346;161;185
Šilalė d. mun.;2018;47;369;172;197
Šilalė d. mun.;2018;48;366;190;176
Šilalė d. mun.;2018;49;363;186;177
Šilalė d. mun.;2018;50;326;154;172
Šilalė d. mun.;2018;51;365;177;188
Šilalė d. mun.;2018;52;356;194;162
Šilalė d. mun.;2018;53;392;194;198
Šilalė d. mun.;2018;54;400;188;212
Šilalė d. mun.;2018;55;397;199;198
Šilalė d. mun.;2018;56;413;213;200
Šilalė d. mun.;2018;57;374;197;177
Šilalė d. mun.;2018;58;347;179;168
Šilalė d. mun.;2018;59;363;181;182
Šilalė d. mun.;2018;60;327;146;181
Šilalė d. mun.;2018;61;320;149;171
Šilalė d. mun.;2018;62;293;137;156
Šilalė d. mun.;2018;63;279;112;167
Šilalė d. mun.;2018;64;244;123;121
Šilalė d. mun.;2018;65;225;105;120
Šilalė d. mun.;2018;66;256;102;154
Šilalė d. mun.;2018;67;254;113;141
Šilalė d. mun.;2018;68;232;94;138
Šilalė d. mun.;2018;69;232;86;146
Šilalė d. mun.;2018;70;196;87;109
Šilalė d. mun.;2018;71;148;53;95
Šilalė d. mun.;2018;72;205;75;130
Šilalė d. mun.;2018;73;149;54;95
Šilalė d. mun.;2018;74;184;71;113
Šilalė d. mun.;2018;75;208;52;156
Šilalė d. mun.;2018;76;197;78;119
Šilalė d. mun.;2018;77;174;57;117
Šilalė d. mun.;2018;78;185;63;122
Šilalė d. mun.;2018;79;149;51;98
Šilalė d. mun.;2018;80;175;60;115
Šilalė d. mun.;2018;81;173;56;117
Šilalė d. mun.;2018;82;146;34;112
Šilalė d. mun.;2018;83;120;30;90
Šilalė d. mun.;2018;84;122;29;93
Šilalė d. mun.;2018;85;562;151;411
Šilutė d. mun.;2001;-1;55352;26686;28666
Šilutė d. mun.;2001;0;616;314;302
Šilutė d. mun.;2001;1;715;382;333
Šilutė d. mun.;2001;2;709;344;365
Šilutė d. mun.;2001;3;724;383;341
Šilutė d. mun.;2001;4;740;359;381
Šilutė d. mun.;2001;5;734;393;341
Šilutė d. mun.;2001;6;750;407;343
Šilutė d. mun.;2001;7;871;445;426
Šilutė d. mun.;2001;8;1020;518;502
Šilutė d. mun.;2001;9;1059;526;533
Šilutė d. mun.;2001;10;1076;561;515
Šilutė d. mun.;2001;11;1029;555;474
Šilutė d. mun.;2001;12;1022;517;505
Šilutė d. mun.;2001;13;1110;564;546
Šilutė d. mun.;2001;14;1129;573;556
Šilutė d. mun.;2001;15;1030;508;522
Šilutė d. mun.;2001;16;983;525;458
Šilutė d. mun.;2001;17;1010;501;509
Šilutė d. mun.;2001;18;784;429;355
Šilutė d. mun.;2001;19;708;399;309
Šilutė d. mun.;2001;20;656;379;277
Šilutė d. mun.;2001;21;676;342;334
Šilutė d. mun.;2001;22;676;365;311
Šilutė d. mun.;2001;23;656;338;318
Šilutė d. mun.;2001;24;681;372;309
Šilutė d. mun.;2001;25;662;329;333
Šilutė d. mun.;2001;26;681;355;326
Šilutė d. mun.;2001;27;770;385;385
Šilutė d. mun.;2001;28;748;378;370
Šilutė d. mun.;2001;29;818;383;435
Šilutė d. mun.;2001;30;816;400;416
Šilutė d. mun.;2001;31;811;395;416
Šilutė d. mun.;2001;32;826;428;398
Šilutė d. mun.;2001;33;767;402;365
Šilutė d. mun.;2001;34;792;385;407
Šilutė d. mun.;2001;35;835;446;389
Šilutė d. mun.;2001;36;821;418;403
Šilutė d. mun.;2001;37;901;464;437
Šilutė d. mun.;2001;38;840;440;400
Šilutė d. mun.;2001;39;900;449;451
Šilutė d. mun.;2001;40;887;425;462
Šilutė d. mun.;2001;41;862;415;447
Šilutė d. mun.;2001;42;836;405;431
Šilutė d. mun.;2001;43;789;371;418
Šilutė d. mun.;2001;44;715;340;375
Šilutė d. mun.;2001;45;693;341;352
Šilutė d. mun.;2001;46;672;339;333
Šilutė d. mun.;2001;47;597;309;288
Šilutė d. mun.;2001;48;601;310;291
Šilutė d. mun.;2001;49;562;280;282
Šilutė d. mun.;2001;50;617;311;306
Šilutė d. mun.;2001;51;637;300;337
Šilutė d. mun.;2001;52;589;295;294
Šilutė d. mun.;2001;53;479;209;270
Šilutė d. mun.;2001;54;432;201;231
Šilutė d. mun.;2001;55;504;229;275
Šilutė d. mun.;2001;56;413;198;215
Šilutė d. mun.;2001;57;495;226;269
Šilutė d. mun.;2001;58;513;228;285
Šilutė d. mun.;2001;59;581;238;343
Šilutė d. mun.;2001;60;530;228;302
Šilutė d. mun.;2001;61;558;228;330
Šilutė d. mun.;2001;62;544;234;310
Šilutė d. mun.;2001;63;539;233;306
Šilutė d. mun.;2001;64;566;224;342
Šilutė d. mun.;2001;65;560;234;326
Šilutė d. mun.;2001;66;507;210;297
Šilutė d. mun.;2001;67;516;202;314
Šilutė d. mun.;2001;68;524;194;330
Šilutė d. mun.;2001;69;496;184;312
Šilutė d. mun.;2001;70;471;189;282
Šilutė d. mun.;2001;71;412;157;255
Šilutė d. mun.;2001;72;420;147;273
Šilutė d. mun.;2001;73;402;152;250
Šilutė d. mun.;2001;74;369;125;244
Šilutė d. mun.;2001;75;310;100;210
Šilutė d. mun.;2001;76;285;77;208
Šilutė d. mun.;2001;77;268;78;190
Šilutė d. mun.;2001;78;247;85;162
Šilutė d. mun.;2001;79;204;66;138
Šilutė d. mun.;2001;80;154;41;113
Šilutė d. mun.;2001;81;140;45;95
Šilutė d. mun.;2001;82;92;29;63
Šilutė d. mun.;2001;83;84;29;55
Šilutė d. mun.;2001;84;76;26;50
Šilutė d. mun.;2001;85;452;143;309
Šilutė d. mun.;2002;-1;54449;26079;28370
Šilutė d. mun.;2002;0;578;276;302
Šilutė d. mun.;2002;1;598;304;294
Šilutė d. mun.;2002;2;697;373;324
Šilutė d. mun.;2002;3;694;334;360
Šilutė d. mun.;2002;4;709;375;334
Šilutė d. mun.;2002;5;732;354;378
Šilutė d. mun.;2002;6;730;390;340
Šilutė d. mun.;2002;7;738;400;338
Šilutė d. mun.;2002;8;860;438;422
Šilutė d. mun.;2002;9;1001;502;499
Šilutė d. mun.;2002;10;1048;518;530
Šilutė d. mun.;2002;11;1060;547;513
Šilutė d. mun.;2002;12;1011;542;469
Šilutė d. mun.;2002;13;991;497;494
Šilutė d. mun.;2002;14;1089;551;538
Šilutė d. mun.;2002;15;1102;549;553
Šilutė d. mun.;2002;16;1014;497;517
Šilutė d. mun.;2002;17;962;511;451
Šilutė d. mun.;2002;18;974;484;490
Šilutė d. mun.;2002;19;751;411;340
Šilutė d. mun.;2002;20;684;381;303
Šilutė d. mun.;2002;21;626;361;265
Šilutė d. mun.;2002;22;654;329;325
Šilutė d. mun.;2002;23;653;355;298
Šilutė d. mun.;2002;24;622;322;300
Šilutė d. mun.;2002;25;661;356;305
Šilutė d. mun.;2002;26;642;314;328
Šilutė d. mun.;2002;27;657;340;317
Šilutė d. mun.;2002;28;751;376;375
Šilutė d. mun.;2002;29;724;364;360
Šilutė d. mun.;2002;30;791;369;422
Šilutė d. mun.;2002;31;800;390;410
Šilutė d. mun.;2002;32;782;375;407
Šilutė d. mun.;2002;33;811;418;393
Šilutė d. mun.;2002;34;752;391;361
Šilutė d. mun.;2002;35;773;373;400
Šilutė d. mun.;2002;36;814;435;379
Šilutė d. mun.;2002;37;802;405;397
Šilutė d. mun.;2002;38;881;449;432
Šilutė d. mun.;2002;39;817;423;394
Šilutė d. mun.;2002;40;878;437;441
Šilutė d. mun.;2002;41;868;414;454
Šilutė d. mun.;2002;42;845;406;439
Šilutė d. mun.;2002;43;827;399;428
Šilutė d. mun.;2002;44;778;364;414
Šilutė d. mun.;2002;45;694;328;366
Šilutė d. mun.;2002;46;676;331;345
Šilutė d. mun.;2002;47;665;334;331
Šilutė d. mun.;2002;48;581;297;284
Šilutė d. mun.;2002;49;582;296;286
Šilutė d. mun.;2002;50;547;268;279
Šilutė d. mun.;2002;51;598;300;298
Šilutė d. mun.;2002;52;624;290;334
Šilutė d. mun.;2002;53;577;291;286
Šilutė d. mun.;2002;54;465;202;263
Šilutė d. mun.;2002;55;422;196;226
Šilutė d. mun.;2002;56;492;221;271
Šilutė d. mun.;2002;57;402;190;212
Šilutė d. mun.;2002;58;477;214;263
Šilutė d. mun.;2002;59;495;216;279
Šilutė d. mun.;2002;60;568;228;340
Šilutė d. mun.;2002;61;522;221;301
Šilutė d. mun.;2002;62;548;221;327
Šilutė d. mun.;2002;63;539;227;312
Šilutė d. mun.;2002;64;527;222;305
Šilutė d. mun.;2002;65;560;220;340
Šilutė d. mun.;2002;66;545;223;322
Šilutė d. mun.;2002;67;487;196;291
Šilutė d. mun.;2002;68;501;189;312
Šilutė d. mun.;2002;69;513;190;323
Šilutė d. mun.;2002;70;483;178;305
Šilutė d. mun.;2002;71;463;184;279
Šilutė d. mun.;2002;72;409;153;256
Šilutė d. mun.;2002;73;401;136;265
Šilutė d. mun.;2002;74;389;143;246
Šilutė d. mun.;2002;75;361;119;242
Šilutė d. mun.;2002;76;290;92;198
Šilutė d. mun.;2002;77;275;76;199
Šilutė d. mun.;2002;78;254;72;182
Šilutė d. mun.;2002;79;235;81;154
Šilutė d. mun.;2002;80;193;62;131
Šilutė d. mun.;2002;81;130;36;94
Šilutė d. mun.;2002;82;132;39;93
Šilutė d. mun.;2002;83;83;29;54
Šilutė d. mun.;2002;84;76;27;49
Šilutė d. mun.;2002;85;436;142;294
Šilutė d. mun.;2003;-1;53906;25784;28122
Šilutė d. mun.;2003;0;553;287;266
Šilutė d. mun.;2003;1;560;269;291
Šilutė d. mun.;2003;2;589;299;290
Šilutė d. mun.;2003;3;685;366;319
Šilutė d. mun.;2003;4;682;331;351
Šilutė d. mun.;2003;5;700;369;331
Šilutė d. mun.;2003;6;725;351;374
Šilutė d. mun.;2003;7;722;386;336
Šilutė d. mun.;2003;8;730;397;333
Šilutė d. mun.;2003;9;853;434;419
Šilutė d. mun.;2003;10;993;499;494
Šilutė d. mun.;2003;11;1037;515;522
Šilutė d. mun.;2003;12;1042;540;502
Šilutė d. mun.;2003;13;992;531;461
Šilutė d. mun.;2003;14;977;489;488
Šilutė d. mun.;2003;15;1069;540;529
Šilutė d. mun.;2003;16;1079;540;539
Šilutė d. mun.;2003;17;1004;492;512
Šilutė d. mun.;2003;18;948;501;447
Šilutė d. mun.;2003;19;959;474;485
Šilutė d. mun.;2003;20;738;406;332
Šilutė d. mun.;2003;21;687;384;303
Šilutė d. mun.;2003;22;621;358;263
Šilutė d. mun.;2003;23;641;326;315
Šilutė d. mun.;2003;24;645;351;294
Šilutė d. mun.;2003;25;610;318;292
Šilutė d. mun.;2003;26;642;345;297
Šilutė d. mun.;2003;27;631;308;323
Šilutė d. mun.;2003;28;645;337;308
Šilutė d. mun.;2003;29;742;371;371
Šilutė d. mun.;2003;30;716;360;356
Šilutė d. mun.;2003;31;782;370;412
Šilutė d. mun.;2003;32;785;382;403
Šilutė d. mun.;2003;33;770;370;400
Šilutė d. mun.;2003;34;794;408;386
Šilutė d. mun.;2003;35;740;386;354
Šilutė d. mun.;2003;36;763;366;397
Šilutė d. mun.;2003;37;801;426;375
Šilutė d. mun.;2003;38;788;402;386
Šilutė d. mun.;2003;39;870;444;426
Šilutė d. mun.;2003;40;805;416;389
Šilutė d. mun.;2003;41;870;428;442
Šilutė d. mun.;2003;42;863;409;454
Šilutė d. mun.;2003;43;826;395;431
Šilutė d. mun.;2003;44;820;396;424
Šilutė d. mun.;2003;45;763;355;408
Šilutė d. mun.;2003;46;687;323;364
Šilutė d. mun.;2003;47;666;325;341
Šilutė d. mun.;2003;48;647;320;327
Šilutė d. mun.;2003;49;569;290;279
Šilutė d. mun.;2003;50;572;290;282
Šilutė d. mun.;2003;51;533;261;272
Šilutė d. mun.;2003;52;582;285;297
Šilutė d. mun.;2003;53;616;286;330
Šilutė d. mun.;2003;54;577;292;285
Šilutė d. mun.;2003;55;457;195;262
Šilutė d. mun.;2003;56;412;191;221
Šilutė d. mun.;2003;57;483;213;270
Šilutė d. mun.;2003;58;390;182;208
Šilutė d. mun.;2003;59;472;214;258
Šilutė d. mun.;2003;60;490;213;277
Šilutė d. mun.;2003;61;559;223;336
Šilutė d. mun.;2003;62;520;221;299
Šilutė d. mun.;2003;63;543;221;322
Šilutė d. mun.;2003;64;523;216;307
Šilutė d. mun.;2003;65;519;216;303
Šilutė d. mun.;2003;66;554;210;344
Šilutė d. mun.;2003;67;538;215;323
Šilutė d. mun.;2003;68;479;191;288
Šilutė d. mun.;2003;69;476;173;303
Šilutė d. mun.;2003;70;504;185;319
Šilutė d. mun.;2003;71;462;165;297
Šilutė d. mun.;2003;72;438;169;269
Šilutė d. mun.;2003;73;393;145;248
Šilutė d. mun.;2003;74;386;125;261
Šilutė d. mun.;2003;75;370;135;235
Šilutė d. mun.;2003;76;334;104;230
Šilutė d. mun.;2003;77;271;83;188
Šilutė d. mun.;2003;78;260;69;191
Šilutė d. mun.;2003;79;229;61;168
Šilutė d. mun.;2003;80;220;69;151
Šilutė d. mun.;2003;81;184;55;129
Šilutė d. mun.;2003;82;122;35;87
Šilutė d. mun.;2003;83;126;36;90
Šilutė d. mun.;2003;84;77;24;53
Šilutė d. mun.;2003;85;409;131;278
Šilutė d. mun.;2004;-1;53143;25284;27859
Šilutė d. mun.;2004;0;547;289;258
Šilutė d. mun.;2004;1;544;280;264
Šilutė d. mun.;2004;2;553;266;287
Šilutė d. mun.;2004;3;585;298;287
Šilutė d. mun.;2004;4;678;360;318
Šilutė d. mun.;2004;5;677;328;349
Šilutė d. mun.;2004;6;696;366;330
Šilutė d. mun.;2004;7;718;344;374
Šilutė d. mun.;2004;8;715;383;332
Šilutė d. mun.;2004;9;725;394;331
Šilutė d. mun.;2004;10;843;428;415
Šilutė d. mun.;2004;11;979;491;488
Šilutė d. mun.;2004;12;1021;504;517
Šilutė d. mun.;2004;13;1023;531;492
Šilutė d. mun.;2004;14;969;517;452
Šilutė d. mun.;2004;15;957;478;479
Šilutė d. mun.;2004;16;1049;529;520
Šilutė d. mun.;2004;17;1056;527;529
Šilutė d. mun.;2004;18;979;480;499
Šilutė d. mun.;2004;19;929;490;439
Šilutė d. mun.;2004;20;930;458;472
Šilutė d. mun.;2004;21;714;396;318
Šilutė d. mun.;2004;22;673;372;301
Šilutė d. mun.;2004;23;610;347;263
Šilutė d. mun.;2004;24;627;309;318
Šilutė d. mun.;2004;25;625;338;287
Šilutė d. mun.;2004;26;589;306;283
Šilutė d. mun.;2004;27;626;333;293
Šilutė d. mun.;2004;28;608;296;312
Šilutė d. mun.;2004;29;629;330;299
Šilutė d. mun.;2004;30;724;357;367
Šilutė d. mun.;2004;31;691;348;343
Šilutė d. mun.;2004;32;762;361;401
Šilutė d. mun.;2004;33;780;378;402
Šilutė d. mun.;2004;34;749;354;395
Šilutė d. mun.;2004;35;781;401;380
Šilutė d. mun.;2004;36;725;375;350
Šilutė d. mun.;2004;37;749;360;389
Šilutė d. mun.;2004;38;792;419;373
Šilutė d. mun.;2004;39;771;394;377
Šilutė d. mun.;2004;40;855;434;421
Šilutė d. mun.;2004;41;794;408;386
Šilutė d. mun.;2004;42;851;417;434
Šilutė d. mun.;2004;43;850;401;449
Šilutė d. mun.;2004;44;808;378;430
Šilutė d. mun.;2004;45;815;392;423
Šilutė d. mun.;2004;46;749;344;405
Šilutė d. mun.;2004;47;670;311;359
Šilutė d. mun.;2004;48;655;317;338
Šilutė d. mun.;2004;49;638;314;324
Šilutė d. mun.;2004;50;559;282;277
Šilutė d. mun.;2004;51;551;271;280
Šilutė d. mun.;2004;52;522;252;270
Šilutė d. mun.;2004;53;567;276;291
Šilutė d. mun.;2004;54;608;283;325
Šilutė d. mun.;2004;55;562;282;280
Šilutė d. mun.;2004;56;442;186;256
Šilutė d. mun.;2004;57;408;188;220
Šilutė d. mun.;2004;58;477;208;269
Šilutė d. mun.;2004;59;384;177;207
Šilutė d. mun.;2004;60;454;201;253
Šilutė d. mun.;2004;61;473;202;271
Šilutė d. mun.;2004;62;549;218;331
Šilutė d. mun.;2004;63;502;209;293
Šilutė d. mun.;2004;64;528;210;318
Šilutė d. mun.;2004;65;510;207;303
Šilutė d. mun.;2004;66;499;202;297
Šilutė d. mun.;2004;67;534;193;341
Šilutė d. mun.;2004;68;528;209;319
Šilutė d. mun.;2004;69;471;185;286
Šilutė d. mun.;2004;70;460;167;293
Šilutė d. mun.;2004;71;482;172;310
Šilutė d. mun.;2004;72;447;155;292
Šilutė d. mun.;2004;73;425;162;263
Šilutė d. mun.;2004;74;378;137;241
Šilutė d. mun.;2004;75;366;116;250
Šilutė d. mun.;2004;76;349;123;226
Šilutė d. mun.;2004;77;313;91;222
Šilutė d. mun.;2004;78;256;74;182
Šilutė d. mun.;2004;79;238;64;174
Šilutė d. mun.;2004;80;219;57;162
Šilutė d. mun.;2004;81;206;62;144
Šilutė d. mun.;2004;82;167;52;115
Šilutė d. mun.;2004;83;112;28;84
Šilutė d. mun.;2004;84;107;28;79
Šilutė d. mun.;2004;85;407;124;283
Šilutė d. mun.;2005;-1;52184;24739;27445
Šilutė d. mun.;2005;0;540;296;244
Šilutė d. mun.;2005;1;537;283;254
Šilutė d. mun.;2005;2;541;277;264
Šilutė d. mun.;2005;3;544;265;279
Šilutė d. mun.;2005;4;581;296;285
Šilutė d. mun.;2005;5;670;356;314
Šilutė d. mun.;2005;6;663;321;342
Šilutė d. mun.;2005;7;684;361;323
Šilutė d. mun.;2005;8;709;339;370
Šilutė d. mun.;2005;9;705;374;331
Šilutė d. mun.;2005;10;714;386;328
Šilutė d. mun.;2005;11;841;424;417
Šilutė d. mun.;2005;12;965;485;480
Šilutė d. mun.;2005;13;1004;495;509
Šilutė d. mun.;2005;14;1008;520;488
Šilutė d. mun.;2005;15;948;503;445
Šilutė d. mun.;2005;16;935;464;471
Šilutė d. mun.;2005;17;1017;511;506
Šilutė d. mun.;2005;18;1024;506;518
Šilutė d. mun.;2005;19;951;464;487
Šilutė d. mun.;2005;20;903;474;429
Šilutė d. mun.;2005;21;896;442;454
Šilutė d. mun.;2005;22;699;387;312
Šilutė d. mun.;2005;23;647;358;289
Šilutė d. mun.;2005;24;593;339;254
Šilutė d. mun.;2005;25;595;301;294
Šilutė d. mun.;2005;26;599;326;273
Šilutė d. mun.;2005;27;550;286;264
Šilutė d. mun.;2005;28;595;322;273
Šilutė d. mun.;2005;29;585;281;304
Šilutė d. mun.;2005;30;604;318;286
Šilutė d. mun.;2005;31;707;350;357
Šilutė d. mun.;2005;32;674;331;343
Šilutė d. mun.;2005;33;745;357;388
Šilutė d. mun.;2005;34;763;367;396
Šilutė d. mun.;2005;35;737;346;391
Šilutė d. mun.;2005;36;769;390;379
Šilutė d. mun.;2005;37;712;369;343
Šilutė d. mun.;2005;38;734;350;384
Šilutė d. mun.;2005;39;763;406;357
Šilutė d. mun.;2005;40;751;383;368
Šilutė d. mun.;2005;41;830;417;413
Šilutė d. mun.;2005;42;773;396;377
Šilutė d. mun.;2005;43;829;400;429
Šilutė d. mun.;2005;44;831;389;442
Šilutė d. mun.;2005;45;795;372;423
Šilutė d. mun.;2005;46;807;388;419
Šilutė d. mun.;2005;47;741;338;403
Šilutė d. mun.;2005;48;651;298;353
Šilutė d. mun.;2005;49;639;311;328
Šilutė d. mun.;2005;50;634;311;323
Šilutė d. mun.;2005;51;547;273;274
Šilutė d. mun.;2005;52;536;257;279
Šilutė d. mun.;2005;53;513;246;267
Šilutė d. mun.;2005;54;554;267;287
Šilutė d. mun.;2005;55;589;268;321
Šilutė d. mun.;2005;56;545;267;278
Šilutė d. mun.;2005;57;429;174;255
Šilutė d. mun.;2005;58;397;181;216
Šilutė d. mun.;2005;59;465;198;267
Šilutė d. mun.;2005;60;368;166;202
Šilutė d. mun.;2005;61;450;200;250
Šilutė d. mun.;2005;62;455;191;264
Šilutė d. mun.;2005;63;536;208;328
Šilutė d. mun.;2005;64;486;197;289
Šilutė d. mun.;2005;65;510;200;310
Šilutė d. mun.;2005;66;494;196;298
Šilutė d. mun.;2005;67;484;191;293
Šilutė d. mun.;2005;68;520;187;333
Šilutė d. mun.;2005;69;506;194;312
Šilutė d. mun.;2005;70;461;178;283
Šilutė d. mun.;2005;71;445;154;291
Šilutė d. mun.;2005;72;469;164;305
Šilutė d. mun.;2005;73;428;144;284
Šilutė d. mun.;2005;74;414;156;258
Šilutė d. mun.;2005;75;357;125;232
Šilutė d. mun.;2005;76;345;109;236
Šilutė d. mun.;2005;77;320;116;204
Šilutė d. mun.;2005;78;292;83;209
Šilutė d. mun.;2005;79;236;67;169
Šilutė d. mun.;2005;80;225;59;166
Šilutė d. mun.;2005;81;205;52;153
Šilutė d. mun.;2005;82;194;53;141
Šilutė d. mun.;2005;83;146;40;106
Šilutė d. mun.;2005;84;97;24;73
Šilutė d. mun.;2005;85;434;125;309
Šilutė d. mun.;2006;-1;50834;24065;26769
Šilutė d. mun.;2006;0;502;258;244
Šilutė d. mun.;2006;1;531;292;239
Šilutė d. mun.;2006;2;528;278;250
Šilutė d. mun.;2006;3;530;272;258
Šilutė d. mun.;2006;4;532;259;273
Šilutė d. mun.;2006;5;574;291;283
Šilutė d. mun.;2006;6;655;349;306
Šilutė d. mun.;2006;7;650;317;333
Šilutė d. mun.;2006;8;673;355;318
Šilutė d. mun.;2006;9;693;332;361
Šilutė d. mun.;2006;10;701;370;331
Šilutė d. mun.;2006;11;712;389;323
Šilutė d. mun.;2006;12;828;419;409
Šilutė d. mun.;2006;13;942;473;469
Šilutė d. mun.;2006;14;981;483;498
Šilutė d. mun.;2006;15;969;493;476
Šilutė d. mun.;2006;16;921;487;434
Šilutė d. mun.;2006;17;906;449;457
Šilutė d. mun.;2006;18;973;491;482
Šilutė d. mun.;2006;19;969;479;490
Šilutė d. mun.;2006;20;895;430;465
Šilutė d. mun.;2006;21;841;439;402
Šilutė d. mun.;2006;22;846;425;421
Šilutė d. mun.;2006;23;673;371;302
Šilutė d. mun.;2006;24;611;341;270
Šilutė d. mun.;2006;25;549;323;226
Šilutė d. mun.;2006;26;555;287;268
Šilutė d. mun.;2006;27;575;310;265
Šilutė d. mun.;2006;28;525;271;254
Šilutė d. mun.;2006;29;567;302;265
Šilutė d. mun.;2006;30;570;275;295
Šilutė d. mun.;2006;31;586;308;278
Šilutė d. mun.;2006;32;682;337;345
Šilutė d. mun.;2006;33;657;324;333
Šilutė d. mun.;2006;34;716;344;372
Šilutė d. mun.;2006;35;733;350;383
Šilutė d. mun.;2006;36;715;332;383
Šilutė d. mun.;2006;37;749;375;374
Šilutė d. mun.;2006;38;689;356;333
Šilutė d. mun.;2006;39;715;340;375
Šilutė d. mun.;2006;40;750;397;353
Šilutė d. mun.;2006;41;731;372;359
Šilutė d. mun.;2006;42;801;401;400
Šilutė d. mun.;2006;43;752;383;369
Šilutė d. mun.;2006;44;804;387;417
Šilutė d. mun.;2006;45;813;373;440
Šilutė d. mun.;2006;46;778;362;416
Šilutė d. mun.;2006;47;797;384;413
Šilutė d. mun.;2006;48;726;329;397
Šilutė d. mun.;2006;49;635;285;350
Šilutė d. mun.;2006;50;627;300;327
Šilutė d. mun.;2006;51;622;300;322
Šilutė d. mun.;2006;52;532;263;269
Šilutė d. mun.;2006;53;524;248;276
Šilutė d. mun.;2006;54;499;240;259
Šilutė d. mun.;2006;55;542;262;280
Šilutė d. mun.;2006;56;577;260;317
Šilutė d. mun.;2006;57;528;258;270
Šilutė d. mun.;2006;58;423;172;251
Šilutė d. mun.;2006;59;391;181;210
Šilutė d. mun.;2006;60;453;191;262
Šilutė d. mun.;2006;61;356;160;196
Šilutė d. mun.;2006;62;435;190;245
Šilutė d. mun.;2006;63;437;181;256
Šilutė d. mun.;2006;64;530;206;324
Šilutė d. mun.;2006;65;468;188;280
Šilutė d. mun.;2006;66;489;189;300
Šilutė d. mun.;2006;67;477;185;292
Šilutė d. mun.;2006;68;462;180;282
Šilutė d. mun.;2006;69;503;181;322
Šilutė d. mun.;2006;70;490;182;308
Šilutė d. mun.;2006;71;454;176;278
Šilutė d. mun.;2006;72;424;147;277
Šilutė d. mun.;2006;73;453;158;295
Šilutė d. mun.;2006;74;403;132;271
Šilutė d. mun.;2006;75;391;147;244
Šilutė d. mun.;2006;76;339;113;226
Šilutė d. mun.;2006;77;324;100;224
Šilutė d. mun.;2006;78;299;104;195
Šilutė d. mun.;2006;79;265;74;191
Šilutė d. mun.;2006;80;222;59;163
Šilutė d. mun.;2006;81;203;48;155
Šilutė d. mun.;2006;82;179;45;134
Šilutė d. mun.;2006;83;163;44;119
Šilutė d. mun.;2006;84;126;34;92
Šilutė d. mun.;2006;85;418;118;300
Šilutė d. mun.;2007;-1;49994;23637;26357
Šilutė d. mun.;2007;0;504;247;257
Šilutė d. mun.;2007;1;501;257;244
Šilutė d. mun.;2007;2;515;283;232
Šilutė d. mun.;2007;3;520;273;247
Šilutė d. mun.;2007;4;522;267;255
Šilutė d. mun.;2007;5;529;258;271
Šilutė d. mun.;2007;6;563;287;276
Šilutė d. mun.;2007;7;643;343;300
Šilutė d. mun.;2007;8;649;315;334
Šilutė d. mun.;2007;9;673;357;316
Šilutė d. mun.;2007;10;686;326;360
Šilutė d. mun.;2007;11;694;365;329
Šilutė d. mun.;2007;12;706;387;319
Šilutė d. mun.;2007;13;819;413;406
Šilutė d. mun.;2007;14;938;471;467
Šilutė d. mun.;2007;15;970;478;492
Šilutė d. mun.;2007;16;951;485;466
Šilutė d. mun.;2007;17;904;478;426
Šilutė d. mun.;2007;18;883;439;444
Šilutė d. mun.;2007;19;947;477;470
Šilutė d. mun.;2007;20;942;466;476
Šilutė d. mun.;2007;21;870;417;453
Šilutė d. mun.;2007;22;806;422;384
Šilutė d. mun.;2007;23;815;413;402
Šilutė d. mun.;2007;24;641;359;282
Šilutė d. mun.;2007;25;587;331;256
Šilutė d. mun.;2007;26;531;316;215
Šilutė d. mun.;2007;27;541;276;265
Šilutė d. mun.;2007;28;559;300;259
Šilutė d. mun.;2007;29;508;263;245
Šilutė d. mun.;2007;30;545;296;249
Šilutė d. mun.;2007;31;556;266;290
Šilutė d. mun.;2007;32;574;293;281
Šilutė d. mun.;2007;33;664;327;337
Šilutė d. mun.;2007;34;647;316;331
Šilutė d. mun.;2007;35;699;336;363
Šilutė d. mun.;2007;36;719;345;374
Šilutė d. mun.;2007;37;702;327;375
Šilutė d. mun.;2007;38;735;370;365
Šilutė d. mun.;2007;39;671;344;327
Šilutė d. mun.;2007;40;701;332;369
Šilutė d. mun.;2007;41;730;383;347
Šilutė d. mun.;2007;42;719;364;355
Šilutė d. mun.;2007;43;786;392;394
Šilutė d. mun.;2007;44;741;379;362
Šilutė d. mun.;2007;45;793;380;413
Šilutė d. mun.;2007;46;804;367;437
Šilutė d. mun.;2007;47;760;351;409
Šilutė d. mun.;2007;48;778;372;406
Šilutė d. mun.;2007;49;704;315;389
Šilutė d. mun.;2007;50;630;285;345
Šilutė d. mun.;2007;51;616;293;323
Šilutė d. mun.;2007;52;611;293;318
Šilutė d. mun.;2007;53;521;255;266
Šilutė d. mun.;2007;54;514;241;273
Šilutė d. mun.;2007;55;489;235;254
Šilutė d. mun.;2007;56;525;249;276
Šilutė d. mun.;2007;57;569;253;316
Šilutė d. mun.;2007;58;515;251;264
Šilutė d. mun.;2007;59;408;166;242
Šilutė d. mun.;2007;60;379;171;208
Šilutė d. mun.;2007;61;435;185;250
Šilutė d. mun.;2007;62;341;154;187
Šilutė d. mun.;2007;63;428;187;241
Šilutė d. mun.;2007;64;424;169;255
Šilutė d. mun.;2007;65;503;190;313
Šilutė d. mun.;2007;66;459;182;277
Šilutė d. mun.;2007;67;469;182;287
Šilutė d. mun.;2007;68;470;183;287
Šilutė d. mun.;2007;69;450;171;279
Šilutė d. mun.;2007;70;487;170;317
Šilutė d. mun.;2007;71;470;168;302
Šilutė d. mun.;2007;72;432;168;264
Šilutė d. mun.;2007;73;405;133;272
Šilutė d. mun.;2007;74;437;145;292
Šilutė d. mun.;2007;75;385;125;260
Šilutė d. mun.;2007;76;364;143;221
Šilutė d. mun.;2007;77;325;113;212
Šilutė d. mun.;2007;78;308;94;214
Šilutė d. mun.;2007;79;284;98;186
Šilutė d. mun.;2007;80;244;63;181
Šilutė d. mun.;2007;81;200;50;150
Šilutė d. mun.;2007;82;185;46;139
Šilutė d. mun.;2007;83;164;42;122
Šilutė d. mun.;2007;84;143;41;102
Šilutė d. mun.;2007;85;460;119;341
Šilutė d. mun.;2008;-1;49207;23279;25928
Šilutė d. mun.;2008;0;530;271;259
Šilutė d. mun.;2008;1;499;245;254
Šilutė d. mun.;2008;2;495;252;243
Šilutė d. mun.;2008;3;511;280;231
Šilutė d. mun.;2008;4;509;273;236
Šilutė d. mun.;2008;5;511;262;249
Šilutė d. mun.;2008;6;520;256;264
Šilutė d. mun.;2008;7;558;283;275
Šilutė d. mun.;2008;8;640;343;297
Šilutė d. mun.;2008;9;651;314;337
Šilutė d. mun.;2008;10;668;355;313
Šilutė d. mun.;2008;11;682;326;356
Šilutė d. mun.;2008;12;695;366;329
Šilutė d. mun.;2008;13;704;388;316
Šilutė d. mun.;2008;14;813;413;400
Šilutė d. mun.;2008;15;930;468;462
Šilutė d. mun.;2008;16;961;473;488
Šilutė d. mun.;2008;17;938;478;460
Šilutė d. mun.;2008;18;888;470;418
Šilutė d. mun.;2008;19;867;432;435
Šilutė d. mun.;2008;20;925;468;457
Šilutė d. mun.;2008;21;915;454;461
Šilutė d. mun.;2008;22;833;401;432
Šilutė d. mun.;2008;23;781;411;370
Šilutė d. mun.;2008;24;797;401;396
Šilutė d. mun.;2008;25;623;348;275
Šilutė d. mun.;2008;26;558;318;240
Šilutė d. mun.;2008;27;502;303;199
Šilutė d. mun.;2008;28;522;266;256
Šilutė d. mun.;2008;29;547;300;247
Šilutė d. mun.;2008;30;496;257;239
Šilutė d. mun.;2008;31;520;286;234
Šilutė d. mun.;2008;32;539;260;279
Šilutė d. mun.;2008;33;571;294;277
Šilutė d. mun.;2008;34;651;315;336
Šilutė d. mun.;2008;35;634;306;328
Šilutė d. mun.;2008;36;686;330;356
Šilutė d. mun.;2008;37;708;338;370
Šilutė d. mun.;2008;38;695;323;372
Šilutė d. mun.;2008;39;722;363;359
Šilutė d. mun.;2008;40;661;339;322
Šilutė d. mun.;2008;41;687;324;363
Šilutė d. mun.;2008;42;710;370;340
Šilutė d. mun.;2008;43;705;356;349
Šilutė d. mun.;2008;44;771;382;389
Šilutė d. mun.;2008;45;727;373;354
Šilutė d. mun.;2008;46;777;376;401
Šilutė d. mun.;2008;47;785;355;430
Šilutė d. mun.;2008;48;750;345;405
Šilutė d. mun.;2008;49;767;366;401
Šilutė d. mun.;2008;50;701;315;386
Šilutė d. mun.;2008;51;623;281;342
Šilutė d. mun.;2008;52;604;286;318
Šilutė d. mun.;2008;53;601;285;316
Šilutė d. mun.;2008;54;500;243;257
Šilutė d. mun.;2008;55;503;235;268
Šilutė d. mun.;2008;56;472;223;249
Šilutė d. mun.;2008;57;518;245;273
Šilutė d. mun.;2008;58;560;248;312
Šilutė d. mun.;2008;59;504;243;261
Šilutė d. mun.;2008;60;400;164;236
Šilutė d. mun.;2008;61;363;158;205
Šilutė d. mun.;2008;62;427;180;247
Šilutė d. mun.;2008;63;336;151;185
Šilutė d. mun.;2008;64;416;179;237
Šilutė d. mun.;2008;65;413;164;249
Šilutė d. mun.;2008;66;494;184;310
Šilutė d. mun.;2008;67;439;169;270
Šilutė d. mun.;2008;68;456;176;280
Šilutė d. mun.;2008;69;444;171;273
Šilutė d. mun.;2008;70;433;162;271
Šilutė d. mun.;2008;71;469;165;304
Šilutė d. mun.;2008;72;446;155;291
Šilutė d. mun.;2008;73;414;154;260
Šilutė d. mun.;2008;74;386;130;256
Šilutė d. mun.;2008;75;408;132;276
Šilutė d. mun.;2008;76;365;112;253
Šilutė d. mun.;2008;77;338;130;208
Šilutė d. mun.;2008;78;304;98;206
Šilutė d. mun.;2008;79;283;84;199
Šilutė d. mun.;2008;80;251;83;168
Šilutė d. mun.;2008;81;221;57;164
Šilutė d. mun.;2008;82;186;45;141
Šilutė d. mun.;2008;83;168;41;127
Šilutė d. mun.;2008;84;143;35;108
Šilutė d. mun.;2008;85;483;120;363
Šilutė d. mun.;2009;-1;48566;23004;25562
Šilutė d. mun.;2009;0;506;237;269
Šilutė d. mun.;2009;1;520;265;255
Šilutė d. mun.;2009;2;486;241;245
Šilutė d. mun.;2009;3;477;242;235
Šilutė d. mun.;2009;4;507;280;227
Šilutė d. mun.;2009;5;507;268;239
Šilutė d. mun.;2009;6;503;257;246
Šilutė d. mun.;2009;7;517;253;264
Šilutė d. mun.;2009;8;551;278;273
Šilutė d. mun.;2009;9;633;343;290
Šilutė d. mun.;2009;10;646;311;335
Šilutė d. mun.;2009;11;662;351;311
Šilutė d. mun.;2009;12;680;326;354
Šilutė d. mun.;2009;13;695;366;329
Šilutė d. mun.;2009;14;704;390;314
Šilutė d. mun.;2009;15;810;415;395
Šilutė d. mun.;2009;16;922;461;461
Šilutė d. mun.;2009;17;945;466;479
Šilutė d. mun.;2009;18;928;473;455
Šilutė d. mun.;2009;19;876;467;409
Šilutė d. mun.;2009;20;851;426;425
Šilutė d. mun.;2009;21;900;456;444
Šilutė d. mun.;2009;22;889;440;449
Šilutė d. mun.;2009;23;805;394;411
Šilutė d. mun.;2009;24;757;403;354
Šilutė d. mun.;2009;25;767;393;374
Šilutė d. mun.;2009;26;597;333;264
Šilutė d. mun.;2009;27;545;312;233
Šilutė d. mun.;2009;28;487;298;189
Šilutė d. mun.;2009;29;498;262;236
Šilutė d. mun.;2009;30;518;289;229
Šilutė d. mun.;2009;31;484;250;234
Šilutė d. mun.;2009;32;507;282;225
Šilutė d. mun.;2009;33;530;258;272
Šilutė d. mun.;2009;34;560;288;272
Šilutė d. mun.;2009;35;638;312;326
Šilutė d. mun.;2009;36;634;309;325
Šilutė d. mun.;2009;37;676;325;351
Šilutė d. mun.;2009;38;693;333;360
Šilutė d. mun.;2009;39;682;314;368
Šilutė d. mun.;2009;40;724;363;361
Šilutė d. mun.;2009;41;656;335;321
Šilutė d. mun.;2009;42;679;320;359
Šilutė d. mun.;2009;43;707;367;340
Šilutė d. mun.;2009;44;696;355;341
Šilutė d. mun.;2009;45;763;381;382
Šilutė d. mun.;2009;46;721;370;351
Šilutė d. mun.;2009;47;765;365;400
Šilutė d. mun.;2009;48;783;355;428
Šilutė d. mun.;2009;49;748;345;403
Šilutė d. mun.;2009;50;757;365;392
Šilutė d. mun.;2009;51;690;308;382
Šilutė d. mun.;2009;52;615;277;338
Šilutė d. mun.;2009;53;599;285;314
Šilutė d. mun.;2009;54;584;277;307
Šilutė d. mun.;2009;55;494;238;256
Šilutė d. mun.;2009;56;486;224;262
Šilutė d. mun.;2009;57;466;217;249
Šilutė d. mun.;2009;58;501;236;265
Šilutė d. mun.;2009;59;545;237;308
Šilutė d. mun.;2009;60;493;233;260
Šilutė d. mun.;2009;61;397;162;235
Šilutė d. mun.;2009;62;358;155;203
Šilutė d. mun.;2009;63;415;175;240
Šilutė d. mun.;2009;64;326;142;184
Šilutė d. mun.;2009;65;412;173;239
Šilutė d. mun.;2009;66;402;157;245
Šilutė d. mun.;2009;67;472;170;302
Šilutė d. mun.;2009;68;427;166;261
Šilutė d. mun.;2009;69;444;172;272
Šilutė d. mun.;2009;70;433;162;271
Šilutė d. mun.;2009;71;425;160;265
Šilutė d. mun.;2009;72;452;158;294
Šilutė d. mun.;2009;73;427;145;282
Šilutė d. mun.;2009;74;397;144;253
Šilutė d. mun.;2009;75;365;117;248
Šilutė d. mun.;2009;76;384;121;263
Šilutė d. mun.;2009;77;343;102;241
Šilutė d. mun.;2009;78;314;119;195
Šilutė d. mun.;2009;79;286;90;196
Šilutė d. mun.;2009;80;252;66;186
Šilutė d. mun.;2009;81;226;69;157
Šilutė d. mun.;2009;82;206;53;153
Šilutė d. mun.;2009;83;164;36;128
Šilutė d. mun.;2009;84;154;36;118
Šilutė d. mun.;2009;85;520;134;386
Šilutė d. mun.;2010;-1;47713;22553;25160
Šilutė d. mun.;2010;0;467;225;242
Šilutė d. mun.;2010;1;491;231;260
Šilutė d. mun.;2010;2;515;264;251
Šilutė d. mun.;2010;3;472;236;236
Šilutė d. mun.;2010;4;467;232;235
Šilutė d. mun.;2010;5;501;273;228
Šilutė d. mun.;2010;6;496;260;236
Šilutė d. mun.;2010;7;497;254;243
Šilutė d. mun.;2010;8;513;251;262
Šilutė d. mun.;2010;9;545;272;273
Šilutė d. mun.;2010;10;626;340;286
Šilutė d. mun.;2010;11;642;312;330
Šilutė d. mun.;2010;12;661;350;311
Šilutė d. mun.;2010;13;679;325;354
Šilutė d. mun.;2010;14;687;360;327
Šilutė d. mun.;2010;15;699;387;312
Šilutė d. mun.;2010;16;801;410;391
Šilutė d. mun.;2010;17;914;455;459
Šilutė d. mun.;2010;18;939;462;477
Šilutė d. mun.;2010;19;918;464;454
Šilutė d. mun.;2010;20;856;459;397
Šilutė d. mun.;2010;21;831;414;417
Šilutė d. mun.;2010;22;869;443;426
Šilutė d. mun.;2010;23;854;425;429
Šilutė d. mun.;2010;24;768;379;389
Šilutė d. mun.;2010;25;725;386;339
Šilutė d. mun.;2010;26;723;371;352
Šilutė d. mun.;2010;27;555;313;242
Šilutė d. mun.;2010;28;516;297;219
Šilutė d. mun.;2010;29;457;282;175
Šilutė d. mun.;2010;30;487;255;232
Šilutė d. mun.;2010;31;503;279;224
Šilutė d. mun.;2010;32;476;248;228
Šilutė d. mun.;2010;33;494;278;216
Šilutė d. mun.;2010;34;520;257;263
Šilutė d. mun.;2010;35;553;285;268
Šilutė d. mun.;2010;36;618;302;316
Šilutė d. mun.;2010;37;621;302;319
Šilutė d. mun.;2010;38;659;314;345
Šilutė d. mun.;2010;39;681;325;356
Šilutė d. mun.;2010;40;672;312;360
Šilutė d. mun.;2010;41;710;355;355
Šilutė d. mun.;2010;42;640;324;316
Šilutė d. mun.;2010;43;664;312;352
Šilutė d. mun.;2010;44;695;358;337
Šilutė d. mun.;2010;45;689;352;337
Šilutė d. mun.;2010;46;756;376;380
Šilutė d. mun.;2010;47;710;362;348
Šilutė d. mun.;2010;48;755;359;396
Šilutė d. mun.;2010;49;772;349;423
Šilutė d. mun.;2010;50;738;339;399
Šilutė d. mun.;2010;51;738;352;386
Šilutė d. mun.;2010;52;676;298;378
Šilutė d. mun.;2010;53;605;271;334
Šilutė d. mun.;2010;54;591;278;313
Šilutė d. mun.;2010;55;572;270;302
Šilutė d. mun.;2010;56;482;232;250
Šilutė d. mun.;2010;57;478;221;257
Šilutė d. mun.;2010;58;452;206;246
Šilutė d. mun.;2010;59;487;227;260
Šilutė d. mun.;2010;60;536;231;305
Šilutė d. mun.;2010;61;477;225;252
Šilutė d. mun.;2010;62;386;158;228
Šilutė d. mun.;2010;63;349;149;200
Šilutė d. mun.;2010;64;400;163;237
Šilutė d. mun.;2010;65;318;139;179
Šilutė d. mun.;2010;66;397;164;233
Šilutė d. mun.;2010;67;388;150;238
Šilutė d. mun.;2010;68;453;156;297
Šilutė d. mun.;2010;69;408;156;252
Šilutė d. mun.;2010;70;428;160;268
Šilutė d. mun.;2010;71;423;156;267
Šilutė d. mun.;2010;72;410;153;257
Šilutė d. mun.;2010;73;432;144;288
Šilutė d. mun.;2010;74;413;144;269
Šilutė d. mun.;2010;75;384;135;249
Šilutė d. mun.;2010;76;347;109;238
Šilutė d. mun.;2010;77;367;112;255
Šilutė d. mun.;2010;78;322;94;228
Šilutė d. mun.;2010;79;296;109;187
Šilutė d. mun.;2010;80;271;83;188
Šilutė d. mun.;2010;81;233;58;175
Šilutė d. mun.;2010;82;209;61;148
Šilutė d. mun.;2010;83;185;48;137
Šilutė d. mun.;2010;84;147;32;115
Šilutė d. mun.;2010;85;556;134;422
Šilutė d. mun.;2011;-1;45380;21375;24005
Šilutė d. mun.;2011;0;381;185;196
Šilutė d. mun.;2011;1;445;218;227
Šilutė d. mun.;2011;2;468;216;252
Šilutė d. mun.;2011;3;456;234;222
Šilutė d. mun.;2011;4;426;212;214
Šilutė d. mun.;2011;5;420;215;205
Šilutė d. mun.;2011;6;452;257;195
Šilutė d. mun.;2011;7;441;221;220
Šilutė d. mun.;2011;8;461;242;219
Šilutė d. mun.;2011;9;515;246;269
Šilutė d. mun.;2011;10;544;267;277
Šilutė d. mun.;2011;11;610;335;275
Šilutė d. mun.;2011;12;625;307;318
Šilutė d. mun.;2011;13;655;345;310
Šilutė d. mun.;2011;14;667;324;343
Šilutė d. mun.;2011;15;664;349;315
Šilutė d. mun.;2011;16;699;388;311
Šilutė d. mun.;2011;17;787;410;377
Šilutė d. mun.;2011;18;856;435;421
Šilutė d. mun.;2011;19;791;400;391
Šilutė d. mun.;2011;20;728;390;338
Šilutė d. mun.;2011;21;643;346;297
Šilutė d. mun.;2011;22;634;327;307
Šilutė d. mun.;2011;23;625;325;300
Šilutė d. mun.;2011;24;612;326;286
Šilutė d. mun.;2011;25;519;278;241
Šilutė d. mun.;2011;26;485;255;230
Šilutė d. mun.;2011;27;499;267;232
Šilutė d. mun.;2011;28;419;216;203
Šilutė d. mun.;2011;29;454;249;205
Šilutė d. mun.;2011;30;441;232;209
Šilutė d. mun.;2011;31;446;224;222
Šilutė d. mun.;2011;32;484;244;240
Šilutė d. mun.;2011;33;480;229;251
Šilutė d. mun.;2011;34;512;279;233
Šilutė d. mun.;2011;35;507;240;267
Šilutė d. mun.;2011;36;556;283;273
Šilutė d. mun.;2011;37;628;303;325
Šilutė d. mun.;2011;38;631;318;313
Šilutė d. mun.;2011;39;681;317;364
Šilutė d. mun.;2011;40;663;315;348
Šilutė d. mun.;2011;41;716;337;379
Šilutė d. mun.;2011;42;722;369;353
Šilutė d. mun.;2011;43;646;323;323
Šilutė d. mun.;2011;44;663;315;348
Šilutė d. mun.;2011;45;690;355;335
Šilutė d. mun.;2011;46;702;363;339
Šilutė d. mun.;2011;47;764;389;375
Šilutė d. mun.;2011;48;709;359;350
Šilutė d. mun.;2011;49;776;386;390
Šilutė d. mun.;2011;50;758;357;401
Šilutė d. mun.;2011;51;741;356;385
Šilutė d. mun.;2011;52;715;345;370
Šilutė d. mun.;2011;53;661;307;354
Šilutė d. mun.;2011;54;596;266;330
Šilutė d. mun.;2011;55;580;270;310
Šilutė d. mun.;2011;56;565;253;312
Šilutė d. mun.;2011;57;506;240;266
Šilutė d. mun.;2011;58;491;235;256
Šilutė d. mun.;2011;59;465;213;252
Šilutė d. mun.;2011;60;502;233;269
Šilutė d. mun.;2011;61;541;235;306
Šilutė d. mun.;2011;62;481;231;250
Šilutė d. mun.;2011;63;413;166;247
Šilutė d. mun.;2011;64;361;149;212
Šilutė d. mun.;2011;65;399;159;240
Šilutė d. mun.;2011;66;341;145;196
Šilutė d. mun.;2011;67;403;165;238
Šilutė d. mun.;2011;68;386;152;234
Šilutė d. mun.;2011;69;448;146;302
Šilutė d. mun.;2011;70;416;154;262
Šilutė d. mun.;2011;71;433;154;279
Šilutė d. mun.;2011;72;415;155;260
Šilutė d. mun.;2011;73;421;155;266
Šilutė d. mun.;2011;74;429;142;287
Šilutė d. mun.;2011;75;409;142;267
Šilutė d. mun.;2011;76;369;129;240
Šilutė d. mun.;2011;77;337;107;230
Šilutė d. mun.;2011;78;358;109;249
Šilutė d. mun.;2011;79;304;79;225
Šilutė d. mun.;2011;80;286;99;187
Šilutė d. mun.;2011;81;255;73;182
Šilutė d. mun.;2011;82;226;58;168
Šilutė d. mun.;2011;83;199;52;147
Šilutė d. mun.;2011;84;163;42;121
Šilutė d. mun.;2011;85;609;137;472
Šilutė d. mun.;2012;-1;44040;20696;23344
Šilutė d. mun.;2012;0;451;227;224
Šilutė d. mun.;2012;1;373;182;191
Šilutė d. mun.;2012;2;434;214;220
Šilutė d. mun.;2012;3;455;208;247
Šilutė d. mun.;2012;4;446;224;222
Šilutė d. mun.;2012;5;405;203;202
Šilutė d. mun.;2012;6;406;212;194
Šilutė d. mun.;2012;7;436;245;191
Šilutė d. mun.;2012;8;440;218;222
Šilutė d. mun.;2012;9;452;237;215
Šilutė d. mun.;2012;10;495;235;260
Šilutė d. mun.;2012;11;534;263;271
Šilutė d. mun.;2012;12;589;329;260
Šilutė d. mun.;2012;13;609;299;310
Šilutė d. mun.;2012;14;641;338;303
Šilutė d. mun.;2012;15;656;319;337
Šilutė d. mun.;2012;16;659;347;312
Šilutė d. mun.;2012;17;693;386;307
Šilutė d. mun.;2012;18;759;399;360
Šilutė d. mun.;2012;19;814;419;395
Šilutė d. mun.;2012;20;741;377;364
Šilutė d. mun.;2012;21;690;368;322
Šilutė d. mun.;2012;22;607;328;279
Šilutė d. mun.;2012;23;588;309;279
Šilutė d. mun.;2012;24;570;305;265
Šilutė d. mun.;2012;25;556;298;258
Šilutė d. mun.;2012;26;466;252;214
Šilutė d. mun.;2012;27;422;218;204
Šilutė d. mun.;2012;28;452;251;201
Šilutė d. mun.;2012;29;388;198;190
Šilutė d. mun.;2012;30;423;231;192
Šilutė d. mun.;2012;31;410;213;197
Šilutė d. mun.;2012;32;419;211;208
Šilutė d. mun.;2012;33;466;232;234
Šilutė d. mun.;2012;34;458;223;235
Šilutė d. mun.;2012;35;482;259;223
Šilutė d. mun.;2012;36;484;225;259
Šilutė d. mun.;2012;37;536;273;263
Šilutė d. mun.;2012;38;607;290;317
Šilutė d. mun.;2012;39;620;309;311
Šilutė d. mun.;2012;40;663;305;358
Šilutė d. mun.;2012;41;648;304;344
Šilutė d. mun.;2012;42;700;326;374
Šilutė d. mun.;2012;43;710;356;354
Šilutė d. mun.;2012;44;639;323;316
Šilutė d. mun.;2012;45;650;308;342
Šilutė d. mun.;2012;46;675;347;328
Šilutė d. mun.;2012;47;685;354;331
Šilutė d. mun.;2012;48;752;383;369
Šilutė d. mun.;2012;49;688;353;335
Šilutė d. mun.;2012;50;758;380;378
Šilutė d. mun.;2012;51;739;350;389
Šilutė d. mun.;2012;52;724;341;383
Šilutė d. mun.;2012;53;699;332;367
Šilutė d. mun.;2012;54;654;305;349
Šilutė d. mun.;2012;55;580;254;326
Šilutė d. mun.;2012;56;576;267;309
Šilutė d. mun.;2012;57;550;241;309
Šilutė d. mun.;2012;58;494;232;262
Šilutė d. mun.;2012;59;481;227;254
Šilutė d. mun.;2012;60;452;204;248
Šilutė d. mun.;2012;61;482;223;259
Šilutė d. mun.;2012;62;527;226;301
Šilutė d. mun.;2012;63;472;226;246
Šilutė d. mun.;2012;64;409;162;247
Šilutė d. mun.;2012;65;351;145;206
Šilutė d. mun.;2012;66;383;149;234
Šilutė d. mun.;2012;67;333;140;193
Šilutė d. mun.;2012;68;392;155;237
Šilutė d. mun.;2012;69;378;148;230
Šilutė d. mun.;2012;70;434;140;294
Šilutė d. mun.;2012;71;397;139;258
Šilutė d. mun.;2012;72;413;142;271
Šilutė d. mun.;2012;73;404;150;254
Šilutė d. mun.;2012;74;405;145;260
Šilutė d. mun.;2012;75;406;131;275
Šilutė d. mun.;2012;76;392;133;259
Šilutė d. mun.;2012;77;351;119;232
Šilutė d. mun.;2012;78;316;97;219
Šilutė d. mun.;2012;79;345;103;242
Šilutė d. mun.;2012;80;283;73;210
Šilutė d. mun.;2012;81;263;89;174
Šilutė d. mun.;2012;82;225;59;166
Šilutė d. mun.;2012;83;207;49;158
Šilutė d. mun.;2012;84;166;41;125
Šilutė d. mun.;2012;85;657;146;511
Šilutė d. mun.;2013;-1;43218;20311;22907
Šilutė d. mun.;2013;0;475;238;237
Šilutė d. mun.;2013;1;441;223;218
Šilutė d. mun.;2013;2;364;180;184
Šilutė d. mun.;2013;3;429;217;212
Šilutė d. mun.;2013;4;455;209;246
Šilutė d. mun.;2013;5;435;220;215
Šilutė d. mun.;2013;6;393;196;197
Šilutė d. mun.;2013;7;411;219;192
Šilutė d. mun.;2013;8;437;247;190
Šilutė d. mun.;2013;9;433;218;215
Šilutė d. mun.;2013;10;446;233;213
Šilutė d. mun.;2013;11;483;227;256
Šilutė d. mun.;2013;12;522;258;264
Šilutė d. mun.;2013;13;575;322;253
Šilutė d. mun.;2013;14;603;294;309
Šilutė d. mun.;2013;15;630;329;301
Šilutė d. mun.;2013;16;648;315;333
Šilutė d. mun.;2013;17;655;346;309
Šilutė d. mun.;2013;18;683;379;304
Šilutė d. mun.;2013;19;714;388;326
Šilutė d. mun.;2013;20;782;404;378
Šilutė d. mun.;2013;21;719;370;349
Šilutė d. mun.;2013;22;665;353;312
Šilutė d. mun.;2013;23;575;318;257
Šilutė d. mun.;2013;24;560;297;263
Šilutė d. mun.;2013;25;540;291;249
Šilutė d. mun.;2013;26;523;279;244
Šilutė d. mun.;2013;27;411;221;190
Šilutė d. mun.;2013;28;396;202;194
Šilutė d. mun.;2013;29;438;245;193
Šilutė d. mun.;2013;30;370;188;182
Šilutė d. mun.;2013;31;398;212;186
Šilutė d. mun.;2013;32;392;205;187
Šilutė d. mun.;2013;33;389;197;192
Šilutė d. mun.;2013;34;449;225;224
Šilutė d. mun.;2013;35;447;219;228
Šilutė d. mun.;2013;36;473;252;221
Šilutė d. mun.;2013;37;467;214;253
Šilutė d. mun.;2013;38;536;275;261
Šilutė d. mun.;2013;39;593;283;310
Šilutė d. mun.;2013;40;610;305;305
Šilutė d. mun.;2013;41;652;297;355
Šilutė d. mun.;2013;42;640;305;335
Šilutė d. mun.;2013;43;692;326;366
Šilutė d. mun.;2013;44;707;353;354
Šilutė d. mun.;2013;45;622;312;310
Šilutė d. mun.;2013;46;635;297;338
Šilutė d. mun.;2013;47;659;336;323
Šilutė d. mun.;2013;48;675;347;328
Šilutė d. mun.;2013;49;743;377;366
Šilutė d. mun.;2013;50;681;346;335
Šilutė d. mun.;2013;51;750;376;374
Šilutė d. mun.;2013;52;728;343;385
Šilutė d. mun.;2013;53;716;336;380
Šilutė d. mun.;2013;54;690;326;364
Šilutė d. mun.;2013;55;646;299;347
Šilutė d. mun.;2013;56;569;248;321
Šilutė d. mun.;2013;57;571;264;307
Šilutė d. mun.;2013;58;543;236;307
Šilutė d. mun.;2013;59;482;224;258
Šilutė d. mun.;2013;60;475;222;253
Šilutė d. mun.;2013;61;439;195;244
Šilutė d. mun.;2013;62;476;219;257
Šilutė d. mun.;2013;63;515;221;294
Šilutė d. mun.;2013;64;463;219;244
Šilutė d. mun.;2013;65;400;157;243
Šilutė d. mun.;2013;66;350;142;208
Šilutė d. mun.;2013;67;373;143;230
Šilutė d. mun.;2013;68;321;133;188
Šilutė d. mun.;2013;69;389;151;238
Šilutė d. mun.;2013;70;370;147;223
Šilutė d. mun.;2013;71;418;132;286
Šilutė d. mun.;2013;72;388;134;254
Šilutė d. mun.;2013;73;400;135;265
Šilutė d. mun.;2013;74;388;142;246
Šilutė d. mun.;2013;75;389;138;251
Šilutė d. mun.;2013;76;386;118;268
Šilutė d. mun.;2013;77;369;120;249
Šilutė d. mun.;2013;78;337;113;224
Šilutė d. mun.;2013;79;294;85;209
Šilutė d. mun.;2013;80;327;94;233
Šilutė d. mun.;2013;81;260;67;193
Šilutė d. mun.;2013;82;236;74;162
Šilutė d. mun.;2013;83;211;55;156
Šilutė d. mun.;2013;84;188;42;146
Šilutė d. mun.;2013;85;690;152;538
Šilutė d. mun.;2014;-1;42447;20002;22445
Šilutė d. mun.;2014;0;479;260;219
Šilutė d. mun.;2014;1;460;230;230
Šilutė d. mun.;2014;2;418;218;200
Šilutė d. mun.;2014;3;344;172;172
Šilutė d. mun.;2014;4;413;211;202
Šilutė d. mun.;2014;5;442;200;242
Šilutė d. mun.;2014;6;425;213;212
Šilutė d. mun.;2014;7;383;189;194
Šilutė d. mun.;2014;8;407;215;192
Šilutė d. mun.;2014;9;430;244;186
Šilutė d. mun.;2014;10;421;212;209
Šilutė d. mun.;2014;11;430;226;204
Šilutė d. mun.;2014;12;477;225;252
Šilutė d. mun.;2014;13;517;256;261
Šilutė d. mun.;2014;14;569;319;250
Šilutė d. mun.;2014;15;589;290;299
Šilutė d. mun.;2014;16;626;327;299
Šilutė d. mun.;2014;17;650;316;334
Šilutė d. mun.;2014;18;643;339;304
Šilutė d. mun.;2014;19;671;376;295
Šilutė d. mun.;2014;20;693;372;321
Šilutė d. mun.;2014;21;749;389;360
Šilutė d. mun.;2014;22;688;355;333
Šilutė d. mun.;2014;23;624;337;287
Šilutė d. mun.;2014;24;550;312;238
Šilutė d. mun.;2014;25;546;290;256
Šilutė d. mun.;2014;26;514;277;237
Šilutė d. mun.;2014;27;496;260;236
Šilutė d. mun.;2014;28;385;219;166
Šilutė d. mun.;2014;29;384;202;182
Šilutė d. mun.;2014;30;416;236;180
Šilutė d. mun.;2014;31;353;181;172
Šilutė d. mun.;2014;32;387;204;183
Šilutė d. mun.;2014;33;369;193;176
Šilutė d. mun.;2014;34;383;192;191
Šilutė d. mun.;2014;35;442;224;218
Šilutė d. mun.;2014;36;435;212;223
Šilutė d. mun.;2014;37;461;248;213
Šilutė d. mun.;2014;38;464;213;251
Šilutė d. mun.;2014;39;531;275;256
Šilutė d. mun.;2014;40;590;281;309
Šilutė d. mun.;2014;41;595;297;298
Šilutė d. mun.;2014;42;639;292;347
Šilutė d. mun.;2014;43;629;301;328
Šilutė d. mun.;2014;44;686;320;366
Šilutė d. mun.;2014;45;695;349;346
Šilutė d. mun.;2014;46;612;308;304
Šilutė d. mun.;2014;47;627;293;334
Šilutė d. mun.;2014;48;648;325;323
Šilutė d. mun.;2014;49;676;349;327
Šilutė d. mun.;2014;50;736;375;361
Šilutė d. mun.;2014;51;676;342;334
Šilutė d. mun.;2014;52;748;373;375
Šilutė d. mun.;2014;53;719;338;381
Šilutė d. mun.;2014;54;703;328;375
Šilutė d. mun.;2014;55;671;312;359
Šilutė d. mun.;2014;56;641;294;347
Šilutė d. mun.;2014;57;560;240;320
Šilutė d. mun.;2014;58;558;256;302
Šilutė d. mun.;2014;59;532;230;302
Šilutė d. mun.;2014;60;480;223;257
Šilutė d. mun.;2014;61;464;213;251
Šilutė d. mun.;2014;62;437;192;245
Šilutė d. mun.;2014;63;462;213;249
Šilutė d. mun.;2014;64;499;211;288
Šilutė d. mun.;2014;65;458;217;241
Šilutė d. mun.;2014;66;394;152;242
Šilutė d. mun.;2014;67;347;140;207
Šilutė d. mun.;2014;68;358;132;226
Šilutė d. mun.;2014;69;310;126;184
Šilutė d. mun.;2014;70;373;143;230
Šilutė d. mun.;2014;71;360;143;217
Šilutė d. mun.;2014;72;408;125;283
Šilutė d. mun.;2014;73;374;131;243
Šilutė d. mun.;2014;74;383;126;257
Šilutė d. mun.;2014;75;370;134;236
Šilutė d. mun.;2014;76;372;129;243
Šilutė d. mun.;2014;77;368;111;257
Šilutė d. mun.;2014;78;352;109;243
Šilutė d. mun.;2014;79;320;106;214
Šilutė d. mun.;2014;80;274;76;198
Šilutė d. mun.;2014;81;298;81;217
Šilutė d. mun.;2014;82;238;58;180
Šilutė d. mun.;2014;83;212;61;151
Šilutė d. mun.;2014;84;185;51;134
Šilutė d. mun.;2014;85;746;167;579
Šilutė d. mun.;2015;-1;41814;19618;22196
Šilutė d. mun.;2015;0;491;244;247
Šilutė d. mun.;2015;1;474;254;220
Šilutė d. mun.;2015;2;452;223;229
Šilutė d. mun.;2015;3;404;209;195
Šilutė d. mun.;2015;4;333;168;165
Šilutė d. mun.;2015;5;398;208;190
Šilutė d. mun.;2015;6;439;198;241
Šilutė d. mun.;2015;7;418;208;210
Šilutė d. mun.;2015;8;384;189;195
Šilutė d. mun.;2015;9;397;207;190
Šilutė d. mun.;2015;10;430;244;186
Šilutė d. mun.;2015;11;414;210;204
Šilutė d. mun.;2015;12;422;219;203
Šilutė d. mun.;2015;13;463;215;248
Šilutė d. mun.;2015;14;509;253;256
Šilutė d. mun.;2015;15;558;313;245
Šilutė d. mun.;2015;16;575;285;290
Šilutė d. mun.;2015;17;616;324;292
Šilutė d. mun.;2015;18;641;310;331
Šilutė d. mun.;2015;19;627;331;296
Šilutė d. mun.;2015;20;645;358;287
Šilutė d. mun.;2015;21;684;365;319
Šilutė d. mun.;2015;22;722;370;352
Šilutė d. mun.;2015;23;675;348;327
Šilutė d. mun.;2015;24;595;334;261
Šilutė d. mun.;2015;25;519;297;222
Šilutė d. mun.;2015;26;525;273;252
Šilutė d. mun.;2015;27;512;266;246
Šilutė d. mun.;2015;28;471;246;225
Šilutė d. mun.;2015;29;365;201;164
Šilutė d. mun.;2015;30;367;185;182
Šilutė d. mun.;2015;31;422;235;187
Šilutė d. mun.;2015;32;319;158;161
Šilutė d. mun.;2015;33;367;198;169
Šilutė d. mun.;2015;34;363;192;171
Šilutė d. mun.;2015;35;369;185;184
Šilutė d. mun.;2015;36;424;213;211
Šilutė d. mun.;2015;37;417;201;216
Šilutė d. mun.;2015;38;450;244;206
Šilutė d. mun.;2015;39;455;211;244
Šilutė d. mun.;2015;40;525;273;252
Šilutė d. mun.;2015;41;578;273;305
Šilutė d. mun.;2015;42;581;294;287
Šilutė d. mun.;2015;43;628;284;344
Šilutė d. mun.;2015;44;619;297;322
Šilutė d. mun.;2015;45;679;321;358
Šilutė d. mun.;2015;46;690;348;342
Šilutė d. mun.;2015;47;615;306;309
Šilutė d. mun.;2015;48;622;288;334
Šilutė d. mun.;2015;49;635;317;318
Šilutė d. mun.;2015;50;674;347;327
Šilutė d. mun.;2015;51;730;371;359
Šilutė d. mun.;2015;52;669;335;334
Šilutė d. mun.;2015;53;742;371;371
Šilutė d. mun.;2015;54;709;327;382
Šilutė d. mun.;2015;55;692;325;367
Šilutė d. mun.;2015;56;667;309;358
Šilutė d. mun.;2015;57;632;289;343
Šilutė d. mun.;2015;58;553;233;320
Šilutė d. mun.;2015;59;548;249;299
Šilutė d. mun.;2015;60;518;222;296
Šilutė d. mun.;2015;61;470;213;257
Šilutė d. mun.;2015;62;451;205;246
Šilutė d. mun.;2015;63;429;189;240
Šilutė d. mun.;2015;64;454;207;247
Šilutė d. mun.;2015;65;493;206;287
Šilutė d. mun.;2015;66;444;207;237
Šilutė d. mun.;2015;67;389;148;241
Šilutė d. mun.;2015;68;337;134;203
Šilutė d. mun.;2015;69;349;126;223
Šilutė d. mun.;2015;70;303;119;184
Šilutė d. mun.;2015;71;361;135;226
Šilutė d. mun.;2015;72;345;134;211
Šilutė d. mun.;2015;73;397;121;276
Šilutė d. mun.;2015;74;365;126;239
Šilutė d. mun.;2015;75;368;118;250
Šilutė d. mun.;2015;76;357;126;231
Šilutė d. mun.;2015;77;357;120;237
Šilutė d. mun.;2015;78;349;103;246
Šilutė d. mun.;2015;79;330;100;230
Šilutė d. mun.;2015;80;299;93;206
Šilutė d. mun.;2015;81;260;71;189
Šilutė d. mun.;2015;82;280;72;208
Šilutė d. mun.;2015;83;211;48;163
Šilutė d. mun.;2015;84;187;48;139
Šilutė d. mun.;2015;85;812;178;634
Šilutė d. mun.;2016;-1;41093;19276;21817
Šilutė d. mun.;2016;0;548;282;266
Šilutė d. mun.;2016;1;484;239;245
Šilutė d. mun.;2016;2;459;252;207
Šilutė d. mun.;2016;3;439;216;223
Šilutė d. mun.;2016;4;392;205;187
Šilutė d. mun.;2016;5;324;160;164
Šilutė d. mun.;2016;6;389;204;185
Šilutė d. mun.;2016;7;433;196;237
Šilutė d. mun.;2016;8;410;201;209
Šilutė d. mun.;2016;9;380;186;194
Šilutė d. mun.;2016;10;395;208;187
Šilutė d. mun.;2016;11;426;243;183
Šilutė d. mun.;2016;12;401;207;194
Šilutė d. mun.;2016;13;414;216;198
Šilutė d. mun.;2016;14;457;208;249
Šilutė d. mun.;2016;15;505;248;257
Šilutė d. mun.;2016;16;551;310;241
Šilutė d. mun.;2016;17;570;282;288
Šilutė d. mun.;2016;18;602;321;281
Šilutė d. mun.;2016;19;622;303;319
Šilutė d. mun.;2016;20;606;321;285
Šilutė d. mun.;2016;21;629;342;287
Šilutė d. mun.;2016;22;659;344;315
Šilutė d. mun.;2016;23;697;354;343
Šilutė d. mun.;2016;24;645;333;312
Šilutė d. mun.;2016;25;553;316;237
Šilutė d. mun.;2016;26;484;277;207
Šilutė d. mun.;2016;27;486;255;231
Šilutė d. mun.;2016;28;494;256;238
Šilutė d. mun.;2016;29;435;236;199
Šilutė d. mun.;2016;30;362;206;156
Šilutė d. mun.;2016;31;341;170;171
Šilutė d. mun.;2016;32;401;218;183
Šilutė d. mun.;2016;33;303;151;152
Šilutė d. mun.;2016;34;339;191;148
Šilutė d. mun.;2016;35;351;184;167
Šilutė d. mun.;2016;36;352;180;172
Šilutė d. mun.;2016;37;420;212;208
Šilutė d. mun.;2016;38;402;196;206
Šilutė d. mun.;2016;39;437;231;206
Šilutė d. mun.;2016;40;445;205;240
Šilutė d. mun.;2016;41;517;265;252
Šilutė d. mun.;2016;42;571;273;298
Šilutė d. mun.;2016;43;570;286;284
Šilutė d. mun.;2016;44;622;279;343
Šilutė d. mun.;2016;45;613;292;321
Šilutė d. mun.;2016;46;674;318;356
Šilutė d. mun.;2016;47;677;337;340
Šilutė d. mun.;2016;48;606;301;305
Šilutė d. mun.;2016;49;611;278;333
Šilutė d. mun.;2016;50;628;313;315
Šilutė d. mun.;2016;51;667;341;326
Šilutė d. mun.;2016;52;723;364;359
Šilutė d. mun.;2016;53;660;330;330
Šilutė d. mun.;2016;54;736;368;368
Šilutė d. mun.;2016;55;697;323;374
Šilutė d. mun.;2016;56;681;318;363
Šilutė d. mun.;2016;57;661;306;355
Šilutė d. mun.;2016;58;618;279;339
Šilutė d. mun.;2016;59;550;229;321
Šilutė d. mun.;2016;60;542;244;298
Šilutė d. mun.;2016;61;507;215;292
Šilutė d. mun.;2016;62;467;211;256
Šilutė d. mun.;2016;63;438;197;241
Šilutė d. mun.;2016;64;420;184;236
Šilutė d. mun.;2016;65;450;203;247
Šilutė d. mun.;2016;66;484;199;285
Šilutė d. mun.;2016;67;434;202;232
Šilutė d. mun.;2016;68;385;148;237
Šilutė d. mun.;2016;69;322;127;195
Šilutė d. mun.;2016;70;335;120;215
Šilutė d. mun.;2016;71;292;112;180
Šilutė d. mun.;2016;72;351;128;223
Šilutė d. mun.;2016;73;337;128;209
Šilutė d. mun.;2016;74;385;118;267
Šilutė d. mun.;2016;75;348;118;230
Šilutė d. mun.;2016;76;351;112;239
Šilutė d. mun.;2016;77;336;113;223
Šilutė d. mun.;2016;78;340;113;227
Šilutė d. mun.;2016;79;333;97;236
Šilutė d. mun.;2016;80;311;89;222
Šilutė d. mun.;2016;81;281;84;197
Šilutė d. mun.;2016;82;247;68;179
Šilutė d. mun.;2016;83;251;63;188
Šilutė d. mun.;2016;84;194;40;154
Šilutė d. mun.;2016;85;828;178;650
Šilutė d. mun.;2017;-1;39902;18669;21233
Šilutė d. mun.;2017;0;414;213;201
Šilutė d. mun.;2017;1;541;276;265
Šilutė d. mun.;2017;2;469;231;238
Šilutė d. mun.;2017;3;453;244;209
Šilutė d. mun.;2017;4;417;202;215
Šilutė d. mun.;2017;5;378;197;181
Šilutė d. mun.;2017;6;310;151;159
Šilutė d. mun.;2017;7;384;200;184
Šilutė d. mun.;2017;8;427;195;232
Šilutė d. mun.;2017;9;401;199;202
Šilutė d. mun.;2017;10;381;184;197
Šilutė d. mun.;2017;11;378;197;181
Šilutė d. mun.;2017;12;413;236;177
Šilutė d. mun.;2017;13;394;203;191
Šilutė d. mun.;2017;14;407;213;194
Šilutė d. mun.;2017;15;445;200;245
Šilutė d. mun.;2017;16;494;242;252
Šilutė d. mun.;2017;17;544;305;239
Šilutė d. mun.;2017;18;552;272;280
Šilutė d. mun.;2017;19;572;303;269
Šilutė d. mun.;2017;20;605;293;312
Šilutė d. mun.;2017;21;576;299;277
Šilutė d. mun.;2017;22;608;334;274
Šilutė d. mun.;2017;23;610;326;284
Šilutė d. mun.;2017;24;656;337;319
Šilutė d. mun.;2017;25;613;326;287
Šilutė d. mun.;2017;26;492;286;206
Šilutė d. mun.;2017;27;447;252;195
Šilutė d. mun.;2017;28;454;232;222
Šilutė d. mun.;2017;29;449;237;212
Šilutė d. mun.;2017;30;401;218;183
Šilutė d. mun.;2017;31;328;179;149
Šilutė d. mun.;2017;32;302;150;152
Šilutė d. mun.;2017;33;378;207;171
Šilutė d. mun.;2017;34;259;131;128
Šilutė d. mun.;2017;35;308;168;140
Šilutė d. mun.;2017;36;336;172;164
Šilutė d. mun.;2017;37;324;163;161
Šilutė d. mun.;2017;38;386;191;195
Šilutė d. mun.;2017;39;385;190;195
Šilutė d. mun.;2017;40;422;223;199
Šilutė d. mun.;2017;41;440;202;238
Šilutė d. mun.;2017;42;505;257;248
Šilutė d. mun.;2017;43;553;260;293
Šilutė d. mun.;2017;44;556;277;279
Šilutė d. mun.;2017;45;603;274;329
Šilutė d. mun.;2017;46;604;288;316
Šilutė d. mun.;2017;47;671;317;354
Šilutė d. mun.;2017;48;667;333;334
Šilutė d. mun.;2017;49;600;297;303
Šilutė d. mun.;2017;50;603;274;329
Šilutė d. mun.;2017;51;620;306;314
Šilutė d. mun.;2017;52;655;337;318
Šilutė d. mun.;2017;53;716;358;358
Šilutė d. mun.;2017;54;659;330;329
Šilutė d. mun.;2017;55;722;360;362
Šilutė d. mun.;2017;56;686;313;373
Šilutė d. mun.;2017;57;666;313;353
Šilutė d. mun.;2017;58;640;291;349
Šilutė d. mun.;2017;59;602;271;331
Šilutė d. mun.;2017;60;538;218;320
Šilutė d. mun.;2017;61;533;235;298
Šilutė d. mun.;2017;62;506;216;290
Šilutė d. mun.;2017;63;460;208;252
Šilutė d. mun.;2017;64;436;193;243
Šilutė d. mun.;2017;65;413;180;233
Šilutė d. mun.;2017;66;438;193;245
Šilutė d. mun.;2017;67;473;190;283
Šilutė d. mun.;2017;68;417;191;226
Šilutė d. mun.;2017;69;379;145;234
Šilutė d. mun.;2017;70;312;123;189
Šilutė d. mun.;2017;71;331;120;211
Šilutė d. mun.;2017;72;285;108;177
Šilutė d. mun.;2017;73;338;120;218
Šilutė d. mun.;2017;74;320;118;202
Šilutė d. mun.;2017;75;369;113;256
Šilutė d. mun.;2017;76;331;111;220
Šilutė d. mun.;2017;77;343;108;235
Šilutė d. mun.;2017;78;313;103;210
Šilutė d. mun.;2017;79;320;103;217
Šilutė d. mun.;2017;80;313;92;221
Šilutė d. mun.;2017;81;293;76;217
Šilutė d. mun.;2017;82;263;79;184
Šilutė d. mun.;2017;83;230;61;169
Šilutė d. mun.;2017;84;229;59;170
Šilutė d. mun.;2017;85;838;171;667
Šilutė d. mun.;2018;-1;38749;18147;20602
Šilutė d. mun.;2018;0;401;205;196
Šilutė d. mun.;2018;1;399;203;196
Šilutė d. mun.;2018;2;531;268;263
Šilutė d. mun.;2018;3;451;219;232
Šilutė d. mun.;2018;4;448;238;210
Šilutė d. mun.;2018;5;404;193;211
Šilutė d. mun.;2018;6;366;191;175
Šilutė d. mun.;2018;7;311;155;156
Šilutė d. mun.;2018;8;378;199;179
Šilutė d. mun.;2018;9;421;194;227
Šilutė d. mun.;2018;10;397;196;201
Šilutė d. mun.;2018;11;376;184;192
Šilutė d. mun.;2018;12;372;195;177
Šilutė d. mun.;2018;13;408;230;178
Šilutė d. mun.;2018;14;387;200;187
Šilutė d. mun.;2018;15;398;208;190
Šilutė d. mun.;2018;16;437;200;237
Šilutė d. mun.;2018;17;485;238;247
Šilutė d. mun.;2018;18;525;292;233
Šilutė d. mun.;2018;19;532;265;267
Šilutė d. mun.;2018;20;542;289;253
Šilutė d. mun.;2018;21;563;280;283
Šilutė d. mun.;2018;22;539;278;261
Šilutė d. mun.;2018;23;554;306;248
Šilutė d. mun.;2018;24;571;315;256
Šilutė d. mun.;2018;25;598;307;291
Šilutė d. mun.;2018;26;558;296;262
Šilutė d. mun.;2018;27;422;257;165
Šilutė d. mun.;2018;28;395;225;170
Šilutė d. mun.;2018;29;416;213;203
Šilutė d. mun.;2018;30;401;210;191
Šilutė d. mun.;2018;31;358;197;161
Šilutė d. mun.;2018;32;297;159;138
Šilutė d. mun.;2018;33;293;141;152
Šilutė d. mun.;2018;34;357;197;160
Šilutė d. mun.;2018;35;245;122;123
Šilutė d. mun.;2018;36;296;164;132
Šilutė d. mun.;2018;37;323;168;155
Šilutė d. mun.;2018;38;318;160;158
Šilutė d. mun.;2018;39;369;182;187
Šilutė d. mun.;2018;40;363;182;181
Šilutė d. mun.;2018;41;420;220;200
Šilutė d. mun.;2018;42;434;201;233
Šilutė d. mun.;2018;43;487;245;242
Šilutė d. mun.;2018;44;550;260;290
Šilutė d. mun.;2018;45;550;273;277
Šilutė d. mun.;2018;46;593;269;324
Šilutė d. mun.;2018;47;599;286;313
Šilutė d. mun.;2018;48;653;314;339
Šilutė d. mun.;2018;49;661;334;327
Šilutė d. mun.;2018;50;581;285;296
Šilutė d. mun.;2018;51;596;271;325
Šilutė d. mun.;2018;52;613;306;307
Šilutė d. mun.;2018;53;652;337;315
Šilutė d. mun.;2018;54;704;352;352
Šilutė d. mun.;2018;55;648;322;326
Šilutė d. mun.;2018;56;707;349;358
Šilutė d. mun.;2018;57;678;307;371
Šilutė d. mun.;2018;58;656;308;348
Šilutė d. mun.;2018;59;630;283;347
Šilutė d. mun.;2018;60;591;263;328
Šilutė d. mun.;2018;61;530;213;317
Šilutė d. mun.;2018;62;523;223;300
Šilutė d. mun.;2018;63;489;205;284
Šilutė d. mun.;2018;64;455;203;252
Šilutė d. mun.;2018;65;422;187;235
Šilutė d. mun.;2018;66;406;177;229
Šilutė d. mun.;2018;67;434;190;244
Šilutė d. mun.;2018;68;465;183;282
Šilutė d. mun.;2018;69;404;180;224
Šilutė d. mun.;2018;70;370;140;230
Šilutė d. mun.;2018;71;306;119;187
Šilutė d. mun.;2018;72;326;115;211
Šilutė d. mun.;2018;73;279;104;175
Šilutė d. mun.;2018;74;330;117;213
Šilutė d. mun.;2018;75;302;112;190
Šilutė d. mun.;2018;76;356;106;250
Šilutė d. mun.;2018;77;317;105;212
Šilutė d. mun.;2018;78;327;100;227
Šilutė d. mun.;2018;79;300;98;202
Šilutė d. mun.;2018;80;305;95;210
Šilutė d. mun.;2018;81;292;87;205
Šilutė d. mun.;2018;82;279;72;207
Šilutė d. mun.;2018;83;246;68;178
Šilutė d. mun.;2018;84;204;52;152
Šilutė d. mun.;2018;85;874;190;684
Širvintos d. mun.;2001;-1;20223;9556;10667
Širvintos d. mun.;2001;0;216;121;95
Širvintos d. mun.;2001;1;185;86;99
Širvintos d. mun.;2001;2;203;107;96
Širvintos d. mun.;2001;3;194;104;90
Širvintos d. mun.;2001;4;224;118;106
Širvintos d. mun.;2001;5;212;118;94
Širvintos d. mun.;2001;6;242;129;113
Širvintos d. mun.;2001;7;227;115;112
Širvintos d. mun.;2001;8;326;173;153
Širvintos d. mun.;2001;9;320;160;160
Širvintos d. mun.;2001;10;343;165;178
Širvintos d. mun.;2001;11;297;143;154
Širvintos d. mun.;2001;12;354;180;174
Širvintos d. mun.;2001;13;362;200;162
Širvintos d. mun.;2001;14;374;194;180
Širvintos d. mun.;2001;15;348;172;176
Širvintos d. mun.;2001;16;302;150;152
Širvintos d. mun.;2001;17;296;153;143
Širvintos d. mun.;2001;18;262;149;113
Širvintos d. mun.;2001;19;197;107;90
Širvintos d. mun.;2001;20;170;94;76
Širvintos d. mun.;2001;21;203;108;95
Širvintos d. mun.;2001;22;216;119;97
Širvintos d. mun.;2001;23;199;95;104
Širvintos d. mun.;2001;24;236;129;107
Širvintos d. mun.;2001;25;213;113;100
Širvintos d. mun.;2001;26;230;130;100
Širvintos d. mun.;2001;27;250;127;123
Širvintos d. mun.;2001;28;226;117;109
Širvintos d. mun.;2001;29;239;118;121
Širvintos d. mun.;2001;30;270;126;144
Širvintos d. mun.;2001;31;291;147;144
Širvintos d. mun.;2001;32;278;149;129
Širvintos d. mun.;2001;33;293;158;135
Širvintos d. mun.;2001;34;285;132;153
Širvintos d. mun.;2001;35;255;134;121
Širvintos d. mun.;2001;36;302;150;152
Širvintos d. mun.;2001;37;320;179;141
Širvintos d. mun.;2001;38;323;166;157
Širvintos d. mun.;2001;39;336;182;154
Širvintos d. mun.;2001;40;294;152;142
Širvintos d. mun.;2001;41;305;154;151
Širvintos d. mun.;2001;42;269;132;137
Širvintos d. mun.;2001;43;246;125;121
Širvintos d. mun.;2001;44;262;139;123
Širvintos d. mun.;2001;45;242;121;121
Širvintos d. mun.;2001;46;237;123;114
Širvintos d. mun.;2001;47;227;102;125
Širvintos d. mun.;2001;48;239;115;124
Širvintos d. mun.;2001;49;223;119;104
Širvintos d. mun.;2001;50;240;109;131
Širvintos d. mun.;2001;51;274;130;144
Širvintos d. mun.;2001;52;216;110;106
Širvintos d. mun.;2001;53;206;102;104
Širvintos d. mun.;2001;54;207;96;111
Širvintos d. mun.;2001;55;208;100;108
Širvintos d. mun.;2001;56;211;101;110
Širvintos d. mun.;2001;57;238;115;123
Širvintos d. mun.;2001;58;256;114;142
Širvintos d. mun.;2001;59;218;93;125
Širvintos d. mun.;2001;60;220;97;123
Širvintos d. mun.;2001;61;223;97;126
Širvintos d. mun.;2001;62;226;96;130
Širvintos d. mun.;2001;63;210;81;129
Širvintos d. mun.;2001;64;293;110;183
Širvintos d. mun.;2001;65;246;95;151
Širvintos d. mun.;2001;66;233;99;134
Širvintos d. mun.;2001;67;227;90;137
Širvintos d. mun.;2001;68;257;81;176
Širvintos d. mun.;2001;69;222;92;130
Širvintos d. mun.;2001;70;207;60;147
Širvintos d. mun.;2001;71;215;78;137
Širvintos d. mun.;2001;72;210;54;156
Širvintos d. mun.;2001;73;188;71;117
Širvintos d. mun.;2001;74;187;71;116
Širvintos d. mun.;2001;75;196;56;140
Širvintos d. mun.;2001;76;168;48;120
Širvintos d. mun.;2001;77;143;47;96
Širvintos d. mun.;2001;78;145;53;92
Širvintos d. mun.;2001;79;130;43;87
Širvintos d. mun.;2001;80;113;33;80
Širvintos d. mun.;2001;81;90;21;69
Širvintos d. mun.;2001;82;51;14;37
Širvintos d. mun.;2001;83;45;14;31
Širvintos d. mun.;2001;84;41;7;34
Širvintos d. mun.;2001;85;300;79;221
Širvintos d. mun.;2002;-1;20081;9494;10587
Širvintos d. mun.;2002;0;174;99;75
Širvintos d. mun.;2002;1;214;120;94
Širvintos d. mun.;2002;2;182;85;97
Širvintos d. mun.;2002;3;204;107;97
Širvintos d. mun.;2002;4;194;104;90
Širvintos d. mun.;2002;5;222;117;105
Širvintos d. mun.;2002;6;211;118;93
Širvintos d. mun.;2002;7;240;128;112
Širvintos d. mun.;2002;8;228;116;112
Širvintos d. mun.;2002;9;323;171;152
Širvintos d. mun.;2002;10;321;161;160
Širvintos d. mun.;2002;11;341;164;177
Širvintos d. mun.;2002;12;297;142;155
Širvintos d. mun.;2002;13;345;177;168
Širvintos d. mun.;2002;14;356;194;162
Širvintos d. mun.;2002;15;372;192;180
Širvintos d. mun.;2002;16;345;169;176
Širvintos d. mun.;2002;17;294;143;151
Širvintos d. mun.;2002;18;294;151;143
Širvintos d. mun.;2002;19;258;148;110
Širvintos d. mun.;2002;20;196;106;90
Širvintos d. mun.;2002;21;165;90;75
Širvintos d. mun.;2002;22;200;106;94
Širvintos d. mun.;2002;23;212;117;95
Širvintos d. mun.;2002;24;194;91;103
Širvintos d. mun.;2002;25;239;133;106
Širvintos d. mun.;2002;26;213;111;102
Širvintos d. mun.;2002;27;223;125;98
Širvintos d. mun.;2002;28;248;127;121
Širvintos d. mun.;2002;29;226;116;110
Širvintos d. mun.;2002;30;236;116;120
Širvintos d. mun.;2002;31;262;124;138
Širvintos d. mun.;2002;32;289;145;144
Širvintos d. mun.;2002;33;277;149;128
Širvintos d. mun.;2002;34;290;157;133
Širvintos d. mun.;2002;35;285;134;151
Širvintos d. mun.;2002;36;253;133;120
Širvintos d. mun.;2002;37;299;148;151
Širvintos d. mun.;2002;38;316;176;140
Širvintos d. mun.;2002;39;318;162;156
Širvintos d. mun.;2002;40;331;177;154
Širvintos d. mun.;2002;41;296;153;143
Širvintos d. mun.;2002;42;302;154;148
Širvintos d. mun.;2002;43;271;134;137
Širvintos d. mun.;2002;44;244;124;120
Širvintos d. mun.;2002;45;258;136;122
Širvintos d. mun.;2002;46;238;120;118
Širvintos d. mun.;2002;47;236;126;110
Širvintos d. mun.;2002;48;227;102;125
Širvintos d. mun.;2002;49;236;113;123
Širvintos d. mun.;2002;50;222;117;105
Širvintos d. mun.;2002;51;236;108;128
Širvintos d. mun.;2002;52;268;125;143
Širvintos d. mun.;2002;53;216;110;106
Širvintos d. mun.;2002;54;203;100;103
Širvintos d. mun.;2002;55;203;93;110
Širvintos d. mun.;2002;56;206;99;107
Širvintos d. mun.;2002;57;209;100;109
Širvintos d. mun.;2002;58;236;114;122
Širvintos d. mun.;2002;59;252;109;143
Širvintos d. mun.;2002;60;217;92;125
Širvintos d. mun.;2002;61;217;95;122
Širvintos d. mun.;2002;62;220;95;125
Širvintos d. mun.;2002;63;226;95;131
Širvintos d. mun.;2002;64;212;80;132
Širvintos d. mun.;2002;65;286;106;180
Širvintos d. mun.;2002;66;241;92;149
Širvintos d. mun.;2002;67;226;97;129
Širvintos d. mun.;2002;68;223;88;135
Širvintos d. mun.;2002;69;251;78;173
Širvintos d. mun.;2002;70;218;90;128
Širvintos d. mun.;2002;71;208;59;149
Širvintos d. mun.;2002;72;210;74;136
Širvintos d. mun.;2002;73;199;52;147
Širvintos d. mun.;2002;74;186;69;117
Širvintos d. mun.;2002;75;177;65;112
Širvintos d. mun.;2002;76;187;53;134
Širvintos d. mun.;2002;77;166;48;118
Širvintos d. mun.;2002;78;134;41;93
Širvintos d. mun.;2002;79;138;52;86
Širvintos d. mun.;2002;80;119;38;81
Širvintos d. mun.;2002;81;105;27;78
Širvintos d. mun.;2002;82;85;21;64
Širvintos d. mun.;2002;83;46;12;34
Širvintos d. mun.;2002;84;46;14;32
Širvintos d. mun.;2002;85;292;75;217
Širvintos d. mun.;2003;-1;19869;9385;10484
Širvintos d. mun.;2003;0;155;94;61
Širvintos d. mun.;2003;1;171;97;74
Širvintos d. mun.;2003;2;213;119;94
Širvintos d. mun.;2003;3;178;83;95
Širvintos d. mun.;2003;4;201;106;95
Širvintos d. mun.;2003;5;190;101;89
Širvintos d. mun.;2003;6;220;117;103
Širvintos d. mun.;2003;7;211;118;93
Širvintos d. mun.;2003;8;239;128;111
Širvintos d. mun.;2003;9;228;116;112
Širvintos d. mun.;2003;10;321;171;150
Širvintos d. mun.;2003;11;317;157;160
Širvintos d. mun.;2003;12;340;164;176
Širvintos d. mun.;2003;13;293;140;153
Širvintos d. mun.;2003;14;343;176;167
Širvintos d. mun.;2003;15;350;190;160
Širvintos d. mun.;2003;16;368;191;177
Širvintos d. mun.;2003;17;338;165;173
Širvintos d. mun.;2003;18;293;143;150
Širvintos d. mun.;2003;19;293;150;143
Širvintos d. mun.;2003;20;257;149;108
Širvintos d. mun.;2003;21;199;107;92
Širvintos d. mun.;2003;22;164;88;76
Širvintos d. mun.;2003;23;199;107;92
Širvintos d. mun.;2003;24;212;117;95
Širvintos d. mun.;2003;25;194;86;108
Širvintos d. mun.;2003;26;234;134;100
Širvintos d. mun.;2003;27;208;110;98
Širvintos d. mun.;2003;28;218;122;96
Širvintos d. mun.;2003;29;244;125;119
Širvintos d. mun.;2003;30;225;115;110
Širvintos d. mun.;2003;31;229;112;117
Širvintos d. mun.;2003;32;256;118;138
Širvintos d. mun.;2003;33;281;143;138
Širvintos d. mun.;2003;34;277;148;129
Širvintos d. mun.;2003;35;287;156;131
Širvintos d. mun.;2003;36;279;129;150
Širvintos d. mun.;2003;37;251;132;119
Širvintos d. mun.;2003;38;296;148;148
Širvintos d. mun.;2003;39;313;174;139
Širvintos d. mun.;2003;40;316;163;153
Širvintos d. mun.;2003;41;331;177;154
Širvintos d. mun.;2003;42;293;152;141
Širvintos d. mun.;2003;43;300;151;149
Širvintos d. mun.;2003;44;269;133;136
Širvintos d. mun.;2003;45;246;125;121
Širvintos d. mun.;2003;46;254;133;121
Širvintos d. mun.;2003;47;236;119;117
Širvintos d. mun.;2003;48;235;125;110
Širvintos d. mun.;2003;49;226;101;125
Širvintos d. mun.;2003;50;235;111;124
Širvintos d. mun.;2003;51;215;111;104
Širvintos d. mun.;2003;52;239;110;129
Širvintos d. mun.;2003;53;265;121;144
Širvintos d. mun.;2003;54;214;109;105
Širvintos d. mun.;2003;55;202;98;104
Širvintos d. mun.;2003;56;202;92;110
Širvintos d. mun.;2003;57;204;97;107
Širvintos d. mun.;2003;58;203;96;107
Širvintos d. mun.;2003;59;231;112;119
Širvintos d. mun.;2003;60;243;104;139
Širvintos d. mun.;2003;61;213;92;121
Širvintos d. mun.;2003;62;219;95;124
Širvintos d. mun.;2003;63;220;95;125
Širvintos d. mun.;2003;64;226;96;130
Širvintos d. mun.;2003;65;209;78;131
Širvintos d. mun.;2003;66;285;104;181
Širvintos d. mun.;2003;67;235;88;147
Širvintos d. mun.;2003;68;217;91;126
Širvintos d. mun.;2003;69;220;85;135
Širvintos d. mun.;2003;70;243;72;171
Širvintos d. mun.;2003;71;213;87;126
Širvintos d. mun.;2003;72;201;54;147
Širvintos d. mun.;2003;73;206;74;132
Širvintos d. mun.;2003;74;193;47;146
Širvintos d. mun.;2003;75;175;62;113
Širvintos d. mun.;2003;76;171;60;111
Širvintos d. mun.;2003;77;179;46;133
Širvintos d. mun.;2003;78;152;39;113
Širvintos d. mun.;2003;79;129;40;89
Širvintos d. mun.;2003;80;132;46;86
Širvintos d. mun.;2003;81;111;35;76
Širvintos d. mun.;2003;82;100;26;74
Širvintos d. mun.;2003;83;79;18;61
Širvintos d. mun.;2003;84;41;11;30
Širvintos d. mun.;2003;85;256;58;198
Širvintos d. mun.;2004;-1;19677;9269;10408
Širvintos d. mun.;2004;0;145;76;69
Širvintos d. mun.;2004;1;153;92;61
Širvintos d. mun.;2004;2;168;96;72
Širvintos d. mun.;2004;3;209;118;91
Širvintos d. mun.;2004;4;175;81;94
Širvintos d. mun.;2004;5;198;105;93
Širvintos d. mun.;2004;6;188;101;87
Širvintos d. mun.;2004;7;219;116;103
Širvintos d. mun.;2004;8;208;116;92
Širvintos d. mun.;2004;9;239;128;111
Širvintos d. mun.;2004;10;226;116;110
Širvintos d. mun.;2004;11;314;171;143
Širvintos d. mun.;2004;12;311;153;158
Širvintos d. mun.;2004;13;334;160;174
Širvintos d. mun.;2004;14;287;137;150
Širvintos d. mun.;2004;15;337;172;165
Širvintos d. mun.;2004;16;344;186;158
Širvintos d. mun.;2004;17;367;190;177
Širvintos d. mun.;2004;18;334;164;170
Širvintos d. mun.;2004;19;287;141;146
Širvintos d. mun.;2004;20;291;150;141
Širvintos d. mun.;2004;21;259;148;111
Širvintos d. mun.;2004;22;196;107;89
Širvintos d. mun.;2004;23;166;86;80
Širvintos d. mun.;2004;24;201;104;97
Širvintos d. mun.;2004;25;208;113;95
Širvintos d. mun.;2004;26;196;88;108
Širvintos d. mun.;2004;27;226;129;97
Širvintos d. mun.;2004;28;208;109;99
Širvintos d. mun.;2004;29;210;118;92
Širvintos d. mun.;2004;30;238;122;116
Širvintos d. mun.;2004;31;216;109;107
Širvintos d. mun.;2004;32;225;109;116
Širvintos d. mun.;2004;33;262;123;139
Širvintos d. mun.;2004;34;276;140;136
Širvintos d. mun.;2004;35;279;149;130
Širvintos d. mun.;2004;36;281;152;129
Širvintos d. mun.;2004;37;277;127;150
Širvintos d. mun.;2004;38;246;129;117
Širvintos d. mun.;2004;39;291;143;148
Širvintos d. mun.;2004;40;308;171;137
Širvintos d. mun.;2004;41;313;162;151
Širvintos d. mun.;2004;42;325;175;150
Širvintos d. mun.;2004;43;292;149;143
Širvintos d. mun.;2004;44;296;146;150
Širvintos d. mun.;2004;45;274;135;139
Širvintos d. mun.;2004;46;246;126;120
Širvintos d. mun.;2004;47;257;135;122
Širvintos d. mun.;2004;48;234;119;115
Širvintos d. mun.;2004;49;236;126;110
Širvintos d. mun.;2004;50;222;98;124
Širvintos d. mun.;2004;51;234;111;123
Širvintos d. mun.;2004;52;213;109;104
Širvintos d. mun.;2004;53;237;109;128
Širvintos d. mun.;2004;54;262;120;142
Širvintos d. mun.;2004;55;209;106;103
Širvintos d. mun.;2004;56;201;97;104
Širvintos d. mun.;2004;57;201;89;112
Širvintos d. mun.;2004;58;199;94;105
Širvintos d. mun.;2004;59;202;94;108
Širvintos d. mun.;2004;60;229;107;122
Širvintos d. mun.;2004;61;240;101;139
Širvintos d. mun.;2004;62;207;87;120
Širvintos d. mun.;2004;63;215;93;122
Širvintos d. mun.;2004;64;211;86;125
Širvintos d. mun.;2004;65;223;93;130
Širvintos d. mun.;2004;66;209;76;133
Širvintos d. mun.;2004;67;283;104;179
Širvintos d. mun.;2004;68;238;88;150
Širvintos d. mun.;2004;69;220;93;127
Širvintos d. mun.;2004;70;216;79;137
Širvintos d. mun.;2004;71;239;69;170
Širvintos d. mun.;2004;72;204;81;123
Širvintos d. mun.;2004;73;194;51;143
Širvintos d. mun.;2004;74;203;71;132
Širvintos d. mun.;2004;75;184;45;139
Širvintos d. mun.;2004;76;174;58;116
Širvintos d. mun.;2004;77;160;55;105
Širvintos d. mun.;2004;78;163;41;122
Širvintos d. mun.;2004;79;142;37;105
Širvintos d. mun.;2004;80;121;37;84
Širvintos d. mun.;2004;81;121;43;78
Širvintos d. mun.;2004;82;105;32;73
Širvintos d. mun.;2004;83;96;24;72
Širvintos d. mun.;2004;84;77;16;61
Širvintos d. mun.;2004;85;247;57;190
Širvintos d. mun.;2005;-1;19529;9200;10329
Širvintos d. mun.;2005;0;161;84;77
Širvintos d. mun.;2005;1;144;74;70
Širvintos d. mun.;2005;2;151;90;61
Širvintos d. mun.;2005;3;168;96;72
Širvintos d. mun.;2005;4;207;117;90
Širvintos d. mun.;2005;5;173;80;93
Širvintos d. mun.;2005;6;199;106;93
Širvintos d. mun.;2005;7;188;102;86
Širvintos d. mun.;2005;8;219;115;104
Širvintos d. mun.;2005;9;207;116;91
Širvintos d. mun.;2005;10;241;130;111
Širvintos d. mun.;2005;11;224;114;110
Širvintos d. mun.;2005;12;314;170;144
Širvintos d. mun.;2005;13;310;154;156
Širvintos d. mun.;2005;14;333;160;173
Širvintos d. mun.;2005;15;286;137;149
Širvintos d. mun.;2005;16;335;171;164
Širvintos d. mun.;2005;17;342;184;158
Širvintos d. mun.;2005;18;359;188;171
Širvintos d. mun.;2005;19;327;161;166
Širvintos d. mun.;2005;20;281;137;144
Širvintos d. mun.;2005;21;288;144;144
Širvintos d. mun.;2005;22;257;147;110
Širvintos d. mun.;2005;23;196;102;94
Širvintos d. mun.;2005;24;164;83;81
Širvintos d. mun.;2005;25;206;104;102
Širvintos d. mun.;2005;26;200;105;95
Širvintos d. mun.;2005;27;184;86;98
Širvintos d. mun.;2005;28;213;128;85
Širvintos d. mun.;2005;29;205;109;96
Širvintos d. mun.;2005;30;211;120;91
Širvintos d. mun.;2005;31;234;119;115
Širvintos d. mun.;2005;32;206;102;104
Širvintos d. mun.;2005;33;221;104;117
Širvintos d. mun.;2005;34;258;122;136
Širvintos d. mun.;2005;35;275;138;137
Širvintos d. mun.;2005;36;274;146;128
Širvintos d. mun.;2005;37;276;150;126
Širvintos d. mun.;2005;38;272;126;146
Širvintos d. mun.;2005;39;244;129;115
Širvintos d. mun.;2005;40;294;145;149
Širvintos d. mun.;2005;41;306;171;135
Širvintos d. mun.;2005;42;316;164;152
Širvintos d. mun.;2005;43;328;176;152
Širvintos d. mun.;2005;44;293;146;147
Širvintos d. mun.;2005;45;294;145;149
Širvintos d. mun.;2005;46;273;135;138
Širvintos d. mun.;2005;47;242;124;118
Širvintos d. mun.;2005;48;255;133;122
Širvintos d. mun.;2005;49;229;116;113
Širvintos d. mun.;2005;50;232;123;109
Širvintos d. mun.;2005;51;219;96;123
Širvintos d. mun.;2005;52;233;111;122
Širvintos d. mun.;2005;53;213;107;106
Širvintos d. mun.;2005;54;238;109;129
Širvintos d. mun.;2005;55;260;118;142
Širvintos d. mun.;2005;56;210;107;103
Širvintos d. mun.;2005;57;198;96;102
Širvintos d. mun.;2005;58;200;88;112
Širvintos d. mun.;2005;59;200;93;107
Širvintos d. mun.;2005;60;202;95;107
Širvintos d. mun.;2005;61;223;104;119
Širvintos d. mun.;2005;62;237;101;136
Širvintos d. mun.;2005;63;209;88;121
Širvintos d. mun.;2005;64;212;92;120
Širvintos d. mun.;2005;65;204;83;121
Širvintos d. mun.;2005;66;224;94;130
Širvintos d. mun.;2005;67;206;73;133
Širvintos d. mun.;2005;68;280;103;177
Širvintos d. mun.;2005;69;230;83;147
Širvintos d. mun.;2005;70;219;94;125
Širvintos d. mun.;2005;71;212;76;136
Širvintos d. mun.;2005;72;232;62;170
Širvintos d. mun.;2005;73;201;80;121
Širvintos d. mun.;2005;74;193;50;143
Širvintos d. mun.;2005;75;205;70;135
Širvintos d. mun.;2005;76;171;41;130
Širvintos d. mun.;2005;77;166;55;111
Širvintos d. mun.;2005;78;153;50;103
Širvintos d. mun.;2005;79;154;39;115
Širvintos d. mun.;2005;80;131;31;100
Širvintos d. mun.;2005;81;118;37;81
Širvintos d. mun.;2005;82;110;40;70
Širvintos d. mun.;2005;83;93;25;68
Širvintos d. mun.;2005;84;87;22;65
Širvintos d. mun.;2005;85;271;59;212
Širvintos d. mun.;2006;-1;19239;9068;10171
Širvintos d. mun.;2006;0;142;72;70
Širvintos d. mun.;2006;1;160;84;76
Širvintos d. mun.;2006;2;143;74;69
Širvintos d. mun.;2006;3;151;91;60
Širvintos d. mun.;2006;4;166;95;71
Širvintos d. mun.;2006;5;205;115;90
Širvintos d. mun.;2006;6;172;79;93
Širvintos d. mun.;2006;7;198;106;92
Širvintos d. mun.;2006;8;188;102;86
Širvintos d. mun.;2006;9;222;117;105
Širvintos d. mun.;2006;10;207;116;91
Širvintos d. mun.;2006;11;243;131;112
Širvintos d. mun.;2006;12;227;116;111
Širvintos d. mun.;2006;13;309;168;141
Širvintos d. mun.;2006;14;308;153;155
Širvintos d. mun.;2006;15;329;157;172
Širvintos d. mun.;2006;16;283;137;146
Širvintos d. mun.;2006;17;328;167;161
Širvintos d. mun.;2006;18;332;177;155
Širvintos d. mun.;2006;19;345;182;163
Širvintos d. mun.;2006;20;315;156;159
Širvintos d. mun.;2006;21;267;130;137
Širvintos d. mun.;2006;22;276;139;137
Širvintos d. mun.;2006;23;249;139;110
Širvintos d. mun.;2006;24;191;98;93
Širvintos d. mun.;2006;25;159;77;82
Širvintos d. mun.;2006;26;207;106;101
Širvintos d. mun.;2006;27;188;97;91
Širvintos d. mun.;2006;28;179;84;95
Širvintos d. mun.;2006;29;208;125;83
Širvintos d. mun.;2006;30;200;109;91
Širvintos d. mun.;2006;31;209;118;91
Širvintos d. mun.;2006;32;231;117;114
Širvintos d. mun.;2006;33;195;96;99
Širvintos d. mun.;2006;34;217;103;114
Širvintos d. mun.;2006;35;262;125;137
Širvintos d. mun.;2006;36;269;134;135
Širvintos d. mun.;2006;37;276;150;126
Širvintos d. mun.;2006;38;273;148;125
Širvintos d. mun.;2006;39;267;122;145
Širvintos d. mun.;2006;40;243;126;117
Širvintos d. mun.;2006;41;292;143;149
Širvintos d. mun.;2006;42;304;169;135
Širvintos d. mun.;2006;43;313;163;150
Širvintos d. mun.;2006;44;327;178;149
Širvintos d. mun.;2006;45;287;143;144
Širvintos d. mun.;2006;46;293;143;150
Širvintos d. mun.;2006;47;272;134;138
Širvintos d. mun.;2006;48;241;125;116
Širvintos d. mun.;2006;49;250;131;119
Širvintos d. mun.;2006;50;227;115;112
Širvintos d. mun.;2006;51;231;122;109
Širvintos d. mun.;2006;52;215;95;120
Širvintos d. mun.;2006;53;230;108;122
Širvintos d. mun.;2006;54;211;105;106
Širvintos d. mun.;2006;55;241;109;132
Širvintos d. mun.;2006;56;257;118;139
Širvintos d. mun.;2006;57;209;105;104
Širvintos d. mun.;2006;58;194;95;99
Širvintos d. mun.;2006;59;198;89;109
Širvintos d. mun.;2006;60;196;91;105
Širvintos d. mun.;2006;61;198;91;107
Širvintos d. mun.;2006;62;215;99;116
Širvintos d. mun.;2006;63;230;97;133
Širvintos d. mun.;2006;64;207;86;121
Širvintos d. mun.;2006;65;207;90;117
Širvintos d. mun.;2006;66;196;80;116
Širvintos d. mun.;2006;67;218;89;129
Širvintos d. mun.;2006;68;205;72;133
Širvintos d. mun.;2006;69;276;103;173
Širvintos d. mun.;2006;70;225;79;146
Širvintos d. mun.;2006;71;205;86;119
Širvintos d. mun.;2006;72;206;73;133
Širvintos d. mun.;2006;73;223;57;166
Širvintos d. mun.;2006;74;191;78;113
Širvintos d. mun.;2006;75;183;47;136
Širvintos d. mun.;2006;76;199;67;132
Širvintos d. mun.;2006;77;166;40;126
Širvintos d. mun.;2006;78;157;49;108
Širvintos d. mun.;2006;79;143;48;95
Širvintos d. mun.;2006;80;148;38;110
Širvintos d. mun.;2006;81;128;29;99
Širvintos d. mun.;2006;82;115;33;82
Širvintos d. mun.;2006;83;99;37;62
Širvintos d. mun.;2006;84;83;21;62
Širvintos d. mun.;2006;85;289;60;229
Širvintos d. mun.;2007;-1;18999;8928;10071
Širvintos d. mun.;2007;0;161;75;86
Širvintos d. mun.;2007;1;141;70;71
Širvintos d. mun.;2007;2;160;84;76
Širvintos d. mun.;2007;3;138;72;66
Širvintos d. mun.;2007;4;150;90;60
Širvintos d. mun.;2007;5;164;93;71
Širvintos d. mun.;2007;6;204;115;89
Širvintos d. mun.;2007;7;171;79;92
Širvintos d. mun.;2007;8;199;106;93
Širvintos d. mun.;2007;9;188;102;86
Širvintos d. mun.;2007;10;219;116;103
Širvintos d. mun.;2007;11;211;118;93
Širvintos d. mun.;2007;12;244;131;113
Širvintos d. mun.;2007;13;225;114;111
Širvintos d. mun.;2007;14;307;166;141
Širvintos d. mun.;2007;15;304;153;151
Širvintos d. mun.;2007;16;329;157;172
Širvintos d. mun.;2007;17;281;136;145
Širvintos d. mun.;2007;18;324;166;158
Širvintos d. mun.;2007;19;326;175;151
Širvintos d. mun.;2007;20;336;177;159
Širvintos d. mun.;2007;21;307;150;157
Širvintos d. mun.;2007;22;260;126;134
Širvintos d. mun.;2007;23;270;136;134
Širvintos d. mun.;2007;24;245;135;110
Širvintos d. mun.;2007;25;177;93;84
Širvintos d. mun.;2007;26;157;74;83
Širvintos d. mun.;2007;27;205;107;98
Širvintos d. mun.;2007;28;176;90;86
Širvintos d. mun.;2007;29;178;84;94
Širvintos d. mun.;2007;30;212;127;85
Širvintos d. mun.;2007;31;197;107;90
Širvintos d. mun.;2007;32;209;117;92
Širvintos d. mun.;2007;33;231;116;115
Širvintos d. mun.;2007;34;201;102;99
Širvintos d. mun.;2007;35;216;102;114
Širvintos d. mun.;2007;36;260;122;138
Širvintos d. mun.;2007;37;265;130;135
Širvintos d. mun.;2007;38;272;146;126
Širvintos d. mun.;2007;39;270;146;124
Širvintos d. mun.;2007;40;262;120;142
Širvintos d. mun.;2007;41;238;121;117
Širvintos d. mun.;2007;42;289;142;147
Širvintos d. mun.;2007;43;300;164;136
Širvintos d. mun.;2007;44;310;161;149
Širvintos d. mun.;2007;45;321;175;146
Širvintos d. mun.;2007;46;286;141;145
Širvintos d. mun.;2007;47;287;140;147
Širvintos d. mun.;2007;48;267;130;137
Širvintos d. mun.;2007;49;242;123;119
Širvintos d. mun.;2007;50;252;132;120
Širvintos d. mun.;2007;51;231;118;113
Širvintos d. mun.;2007;52;230;123;107
Širvintos d. mun.;2007;53;216;95;121
Širvintos d. mun.;2007;54;230;106;124
Širvintos d. mun.;2007;55;208;102;106
Širvintos d. mun.;2007;56;239;107;132
Širvintos d. mun.;2007;57;251;112;139
Širvintos d. mun.;2007;58;208;102;106
Širvintos d. mun.;2007;59;194;94;100
Širvintos d. mun.;2007;60;196;88;108
Širvintos d. mun.;2007;61;191;86;105
Širvintos d. mun.;2007;62;193;87;106
Širvintos d. mun.;2007;63;210;96;114
Širvintos d. mun.;2007;64;229;97;132
Širvintos d. mun.;2007;65;201;82;119
Širvintos d. mun.;2007;66;202;87;115
Širvintos d. mun.;2007;67;186;74;112
Širvintos d. mun.;2007;68;215;87;128
Širvintos d. mun.;2007;69;197;65;132
Širvintos d. mun.;2007;70;267;98;169
Širvintos d. mun.;2007;71;220;74;146
Širvintos d. mun.;2007;72;195;76;119
Širvintos d. mun.;2007;73;192;64;128
Širvintos d. mun.;2007;74;213;53;160
Širvintos d. mun.;2007;75;184;75;109
Širvintos d. mun.;2007;76;179;48;131
Širvintos d. mun.;2007;77;182;60;122
Širvintos d. mun.;2007;78;160;37;123
Širvintos d. mun.;2007;79;146;41;105
Širvintos d. mun.;2007;80;129;42;87
Širvintos d. mun.;2007;81;139;37;102
Širvintos d. mun.;2007;82;114;23;91
Širvintos d. mun.;2007;83;103;32;71
Širvintos d. mun.;2007;84;89;30;59
Širvintos d. mun.;2007;85;316;76;240
Širvintos d. mun.;2008;-1;18752;8787;9965
Širvintos d. mun.;2008;0;157;77;80
Širvintos d. mun.;2008;1;160;74;86
Širvintos d. mun.;2008;2;141;69;72
Širvintos d. mun.;2008;3;163;86;77
Širvintos d. mun.;2008;4;138;72;66
Širvintos d. mun.;2008;5;150;90;60
Širvintos d. mun.;2008;6;167;95;72
Širvintos d. mun.;2008;7;203;114;89
Širvintos d. mun.;2008;8;169;79;90
Širvintos d. mun.;2008;9;201;107;94
Širvintos d. mun.;2008;10;187;100;87
Širvintos d. mun.;2008;11;219;115;104
Širvintos d. mun.;2008;12;212;119;93
Širvintos d. mun.;2008;13;244;131;113
Širvintos d. mun.;2008;14;224;113;111
Širvintos d. mun.;2008;15;308;167;141
Širvintos d. mun.;2008;16;303;152;151
Širvintos d. mun.;2008;17;328;157;171
Širvintos d. mun.;2008;18;280;135;145
Širvintos d. mun.;2008;19;320;163;157
Širvintos d. mun.;2008;20;322;175;147
Širvintos d. mun.;2008;21;333;176;157
Širvintos d. mun.;2008;22;298;148;150
Širvintos d. mun.;2008;23;255;124;131
Širvintos d. mun.;2008;24;270;138;132
Širvintos d. mun.;2008;25;241;130;111
Širvintos d. mun.;2008;26;174;90;84
Širvintos d. mun.;2008;27;152;72;80
Širvintos d. mun.;2008;28;194;100;94
Širvintos d. mun.;2008;29;173;92;81
Širvintos d. mun.;2008;30;180;84;96
Širvintos d. mun.;2008;31;212;128;84
Širvintos d. mun.;2008;32;197;108;89
Širvintos d. mun.;2008;33;206;116;90
Širvintos d. mun.;2008;34;229;114;115
Širvintos d. mun.;2008;35;202;104;98
Širvintos d. mun.;2008;36;213;103;110
Širvintos d. mun.;2008;37;257;117;140
Širvintos d. mun.;2008;38;264;128;136
Širvintos d. mun.;2008;39;277;151;126
Širvintos d. mun.;2008;40;271;146;125
Širvintos d. mun.;2008;41;261;119;142
Širvintos d. mun.;2008;42;234;120;114
Širvintos d. mun.;2008;43;292;146;146
Širvintos d. mun.;2008;44;296;161;135
Širvintos d. mun.;2008;45;307;160;147
Širvintos d. mun.;2008;46;317;171;146
Širvintos d. mun.;2008;47;283;138;145
Širvintos d. mun.;2008;48;286;137;149
Širvintos d. mun.;2008;49;263;128;135
Širvintos d. mun.;2008;50;240;121;119
Širvintos d. mun.;2008;51;249;129;120
Širvintos d. mun.;2008;52;233;118;115
Širvintos d. mun.;2008;53;226;120;106
Širvintos d. mun.;2008;54;213;93;120
Širvintos d. mun.;2008;55;226;104;122
Širvintos d. mun.;2008;56;201;98;103
Širvintos d. mun.;2008;57;230;101;129
Širvintos d. mun.;2008;58;247;110;137
Širvintos d. mun.;2008;59;201;97;104
Širvintos d. mun.;2008;60;192;93;99
Širvintos d. mun.;2008;61;193;86;107
Širvintos d. mun.;2008;62;183;79;104
Širvintos d. mun.;2008;63;184;82;102
Širvintos d. mun.;2008;64;200;88;112
Širvintos d. mun.;2008;65;221;91;130
Širvintos d. mun.;2008;66;190;73;117
Širvintos d. mun.;2008;67;198;83;115
Širvintos d. mun.;2008;68;178;70;108
Širvintos d. mun.;2008;69;206;82;124
Širvintos d. mun.;2008;70;189;59;130
Širvintos d. mun.;2008;71;253;86;167
Širvintos d. mun.;2008;72;210;65;145
Širvintos d. mun.;2008;73;189;72;117
Širvintos d. mun.;2008;74;182;60;122
Širvintos d. mun.;2008;75;199;46;153
Širvintos d. mun.;2008;76;177;72;105
Širvintos d. mun.;2008;77;172;44;128
Širvintos d. mun.;2008;78;173;53;120
Širvintos d. mun.;2008;79;152;35;117
Širvintos d. mun.;2008;80;135;41;94
Širvintos d. mun.;2008;81;121;39;82
Širvintos d. mun.;2008;82;119;26;93
Širvintos d. mun.;2008;83;106;21;85
Širvintos d. mun.;2008;84;89;29;60
Širvintos d. mun.;2008;85;342;82;260
Širvintos d. mun.;2009;-1;18461;8670;9791
Širvintos d. mun.;2009;0;152;80;72
Širvintos d. mun.;2009;1;155;77;78
Širvintos d. mun.;2009;2;152;71;81
Širvintos d. mun.;2009;3;138;66;72
Širvintos d. mun.;2009;4;165;88;77
Širvintos d. mun.;2009;5;137;74;63
Širvintos d. mun.;2009;6;146;89;57
Širvintos d. mun.;2009;7;164;93;71
Širvintos d. mun.;2009;8;204;115;89
Širvintos d. mun.;2009;9;167;79;88
Širvintos d. mun.;2009;10;198;107;91
Širvintos d. mun.;2009;11;185;99;86
Širvintos d. mun.;2009;12;218;114;104
Širvintos d. mun.;2009;13;209;117;92
Širvintos d. mun.;2009;14;243;130;113
Širvintos d. mun.;2009;15;221;111;110
Širvintos d. mun.;2009;16;308;168;140
Širvintos d. mun.;2009;17;304;152;152
Širvintos d. mun.;2009;18;330;158;172
Širvintos d. mun.;2009;19;278;133;145
Širvintos d. mun.;2009;20;316;161;155
Širvintos d. mun.;2009;21;321;173;148
Širvintos d. mun.;2009;22;330;175;155
Širvintos d. mun.;2009;23;292;148;144
Širvintos d. mun.;2009;24;245;120;125
Širvintos d. mun.;2009;25;262;136;126
Širvintos d. mun.;2009;26;233;125;108
Širvintos d. mun.;2009;27;171;89;82
Širvintos d. mun.;2009;28;142;66;76
Širvintos d. mun.;2009;29;192;100;92
Širvintos d. mun.;2009;30;168;90;78
Širvintos d. mun.;2009;31;174;80;94
Širvintos d. mun.;2009;32;207;127;80
Širvintos d. mun.;2009;33;189;104;85
Širvintos d. mun.;2009;34;203;115;88
Širvintos d. mun.;2009;35;220;108;112
Širvintos d. mun.;2009;36;199;103;96
Širvintos d. mun.;2009;37;211;101;110
Širvintos d. mun.;2009;38;253;114;139
Širvintos d. mun.;2009;39;263;128;135
Širvintos d. mun.;2009;40;280;154;126
Širvintos d. mun.;2009;41;267;141;126
Širvintos d. mun.;2009;42;259;117;142
Širvintos d. mun.;2009;43;236;121;115
Širvintos d. mun.;2009;44;293;146;147
Širvintos d. mun.;2009;45;297;163;134
Širvintos d. mun.;2009;46;305;160;145
Širvintos d. mun.;2009;47;323;177;146
Širvintos d. mun.;2009;48;279;138;141
Širvintos d. mun.;2009;49;291;140;151
Širvintos d. mun.;2009;50;265;129;136
Širvintos d. mun.;2009;51;232;115;117
Širvintos d. mun.;2009;52;245;127;118
Širvintos d. mun.;2009;53;229;114;115
Širvintos d. mun.;2009;54;217;114;103
Širvintos d. mun.;2009;55;206;87;119
Širvintos d. mun.;2009;56;219;100;119
Širvintos d. mun.;2009;57;198;97;101
Širvintos d. mun.;2009;58;227;99;128
Širvintos d. mun.;2009;59;244;109;135
Širvintos d. mun.;2009;60;195;93;102
Širvintos d. mun.;2009;61;187;88;99
Širvintos d. mun.;2009;62;189;83;106
Širvintos d. mun.;2009;63;182;79;103
Širvintos d. mun.;2009;64;181;79;102
Širvintos d. mun.;2009;65;191;83;108
Širvintos d. mun.;2009;66;218;91;127
Širvintos d. mun.;2009;67;185;69;116
Širvintos d. mun.;2009;68;192;79;113
Širvintos d. mun.;2009;69;170;65;105
Širvintos d. mun.;2009;70;196;76;120
Širvintos d. mun.;2009;71;179;51;128
Širvintos d. mun.;2009;72;242;80;162
Širvintos d. mun.;2009;73;205;63;142
Širvintos d. mun.;2009;74;181;67;114
Širvintos d. mun.;2009;75;173;57;116
Širvintos d. mun.;2009;76;193;44;149
Širvintos d. mun.;2009;77;170;69;101
Širvintos d. mun.;2009;78;159;36;123
Širvintos d. mun.;2009;79;163;50;113
Širvintos d. mun.;2009;80;136;29;107
Širvintos d. mun.;2009;81;122;35;87
Širvintos d. mun.;2009;82;113;38;75
Širvintos d. mun.;2009;83;107;23;84
Širvintos d. mun.;2009;84;97;19;78
Širvintos d. mun.;2009;85;358;92;266
Širvintos d. mun.;2010;-1;18166;8513;9653
Širvintos d. mun.;2010;0;166;79;87
Širvintos d. mun.;2010;1;148;78;70
Širvintos d. mun.;2010;2;157;76;81
Širvintos d. mun.;2010;3;150;70;80
Širvintos d. mun.;2010;4;139;67;72
Širvintos d. mun.;2010;5;166;91;75
Širvintos d. mun.;2010;6;134;74;60
Širvintos d. mun.;2010;7;145;88;57
Širvintos d. mun.;2010;8;162;91;71
Širvintos d. mun.;2010;9;200;111;89
Širvintos d. mun.;2010;10;166;79;87
Širvintos d. mun.;2010;11;194;104;90
Širvintos d. mun.;2010;12;184;99;85
Širvintos d. mun.;2010;13;215;115;100
Širvintos d. mun.;2010;14;213;122;91
Širvintos d. mun.;2010;15;245;132;113
Širvintos d. mun.;2010;16;221;111;110
Širvintos d. mun.;2010;17;307;167;140
Širvintos d. mun.;2010;18;301;152;149
Širvintos d. mun.;2010;19;325;157;168
Širvintos d. mun.;2010;20;279;133;146
Širvintos d. mun.;2010;21;310;158;152
Širvintos d. mun.;2010;22;314;169;145
Širvintos d. mun.;2010;23;321;172;149
Širvintos d. mun.;2010;24;289;144;145
Širvintos d. mun.;2010;25;243;118;125
Širvintos d. mun.;2010;26;254;131;123
Širvintos d. mun.;2010;27;225;120;105
Širvintos d. mun.;2010;28;167;87;80
Širvintos d. mun.;2010;29;141;63;78
Širvintos d. mun.;2010;30;179;94;85
Širvintos d. mun.;2010;31;169;92;77
Širvintos d. mun.;2010;32;171;78;93
Širvintos d. mun.;2010;33;199;121;78
Širvintos d. mun.;2010;34;183;103;80
Širvintos d. mun.;2010;35;194;108;86
Širvintos d. mun.;2010;36;220;109;111
Širvintos d. mun.;2010;37;193;98;95
Širvintos d. mun.;2010;38;208;97;111
Širvintos d. mun.;2010;39;248;113;135
Širvintos d. mun.;2010;40;260;126;134
Širvintos d. mun.;2010;41;279;153;126
Širvintos d. mun.;2010;42;266;141;125
Širvintos d. mun.;2010;43;263;117;146
Širvintos d. mun.;2010;44;229;116;113
Širvintos d. mun.;2010;45;287;140;147
Širvintos d. mun.;2010;46;292;157;135
Širvintos d. mun.;2010;47;301;157;144
Širvintos d. mun.;2010;48;320;175;145
Širvintos d. mun.;2010;49;278;138;140
Širvintos d. mun.;2010;50;284;134;150
Širvintos d. mun.;2010;51;261;126;135
Širvintos d. mun.;2010;52;231;115;116
Širvintos d. mun.;2010;53;240;123;117
Širvintos d. mun.;2010;54;224;112;112
Širvintos d. mun.;2010;55;208;108;100
Širvintos d. mun.;2010;56;204;85;119
Širvintos d. mun.;2010;57;217;100;117
Širvintos d. mun.;2010;58;192;93;99
Širvintos d. mun.;2010;59;220;94;126
Širvintos d. mun.;2010;60;239;104;135
Širvintos d. mun.;2010;61;191;90;101
Širvintos d. mun.;2010;62;187;86;101
Širvintos d. mun.;2010;63;186;80;106
Širvintos d. mun.;2010;64;175;72;103
Širvintos d. mun.;2010;65;170;73;97
Širvintos d. mun.;2010;66;188;81;107
Širvintos d. mun.;2010;67;212;85;127
Širvintos d. mun.;2010;68;179;65;114
Širvintos d. mun.;2010;69;188;76;112
Širvintos d. mun.;2010;70;165;62;103
Širvintos d. mun.;2010;71;190;73;117
Širvintos d. mun.;2010;72;173;50;123
Širvintos d. mun.;2010;73;232;78;154
Širvintos d. mun.;2010;74;197;60;137
Širvintos d. mun.;2010;75;179;64;115
Širvintos d. mun.;2010;76;159;49;110
Širvintos d. mun.;2010;77;188;43;145
Širvintos d. mun.;2010;78;166;69;97
Širvintos d. mun.;2010;79;149;34;115
Širvintos d. mun.;2010;80;149;45;104
Širvintos d. mun.;2010;81;122;29;93
Širvintos d. mun.;2010;82;111;30;81
Širvintos d. mun.;2010;83;100;31;69
Širvintos d. mun.;2010;84;100;23;77
Širvintos d. mun.;2010;85;370;80;290
Širvintos d. mun.;2011;-1;17659;8282;9377
Širvintos d. mun.;2011;0;131;64;67
Širvintos d. mun.;2011;1;147;66;81
Širvintos d. mun.;2011;2;143;73;70
Širvintos d. mun.;2011;3;165;75;90
Širvintos d. mun.;2011;4;141;69;72
Širvintos d. mun.;2011;5;146;71;75
Širvintos d. mun.;2011;6;151;80;71
Širvintos d. mun.;2011;7;137;77;60
Širvintos d. mun.;2011;8;141;80;61
Širvintos d. mun.;2011;9;152;79;73
Širvintos d. mun.;2011;10;203;112;91
Širvintos d. mun.;2011;11;170;83;87
Širvintos d. mun.;2011;12;201;110;91
Širvintos d. mun.;2011;13;201;102;99
Širvintos d. mun.;2011;14;209;115;94
Širvintos d. mun.;2011;15;209;121;88
Širvintos d. mun.;2011;16;253;135;118
Širvintos d. mun.;2011;17;223;112;111
Širvintos d. mun.;2011;18;300;159;141
Širvintos d. mun.;2011;19;287;146;141
Širvintos d. mun.;2011;20;284;142;142
Širvintos d. mun.;2011;21;237;126;111
Širvintos d. mun.;2011;22;254;129;125
Širvintos d. mun.;2011;23;248;133;115
Širvintos d. mun.;2011;24;235;112;123
Širvintos d. mun.;2011;25;233;127;106
Širvintos d. mun.;2011;26;196;99;97
Širvintos d. mun.;2011;27;206;108;98
Širvintos d. mun.;2011;28;205;106;99
Širvintos d. mun.;2011;29;169;85;84
Širvintos d. mun.;2011;30;175;99;76
Širvintos d. mun.;2011;31;202;110;92
Širvintos d. mun.;2011;32;193;99;94
Širvintos d. mun.;2011;33;181;81;100
Širvintos d. mun.;2011;34;210;111;99
Širvintos d. mun.;2011;35;199;109;90
Širvintos d. mun.;2011;36;206;111;95
Širvintos d. mun.;2011;37;254;126;128
Širvintos d. mun.;2011;38;212;110;102
Širvintos d. mun.;2011;39;240;118;122
Širvintos d. mun.;2011;40;255;120;135
Širvintos d. mun.;2011;41;289;143;146
Širvintos d. mun.;2011;42;278;156;122
Širvintos d. mun.;2011;43;277;146;131
Širvintos d. mun.;2011;44;271;124;147
Širvintos d. mun.;2011;45;224;105;119
Širvintos d. mun.;2011;46;276;139;137
Širvintos d. mun.;2011;47;291;157;134
Širvintos d. mun.;2011;48;313;160;153
Širvintos d. mun.;2011;49;314;166;148
Širvintos d. mun.;2011;50;274;139;135
Širvintos d. mun.;2011;51;281;139;142
Širvintos d. mun.;2011;52;256;118;138
Širvintos d. mun.;2011;53;227;114;113
Širvintos d. mun.;2011;54;250;123;127
Širvintos d. mun.;2011;55;226;112;114
Širvintos d. mun.;2011;56;214;112;102
Širvintos d. mun.;2011;57;209;86;123
Širvintos d. mun.;2011;58;217;103;114
Širvintos d. mun.;2011;59;196;94;102
Širvintos d. mun.;2011;60;209;88;121
Širvintos d. mun.;2011;61;242;99;143
Širvintos d. mun.;2011;62;195;89;106
Širvintos d. mun.;2011;63;178;81;97
Širvintos d. mun.;2011;64;178;71;107
Širvintos d. mun.;2011;65;167;71;96
Širvintos d. mun.;2011;66;179;71;108
Širvintos d. mun.;2011;67;174;75;99
Širvintos d. mun.;2011;68;204;82;122
Širvintos d. mun.;2011;69;172;56;116
Širvintos d. mun.;2011;70;185;73;112
Širvintos d. mun.;2011;71;155;59;96
Širvintos d. mun.;2011;72;172;61;111
Širvintos d. mun.;2011;73;172;51;121
Širvintos d. mun.;2011;74;207;67;140
Širvintos d. mun.;2011;75;180;54;126
Širvintos d. mun.;2011;76;161;58;103
Širvintos d. mun.;2011;77;143;42;101
Širvintos d. mun.;2011;78;156;36;120
Širvintos d. mun.;2011;79;140;56;84
Širvintos d. mun.;2011;80;119;27;92
Širvintos d. mun.;2011;81;128;36;92
Širvintos d. mun.;2011;82;102;24;78
Širvintos d. mun.;2011;83;96;25;71
Širvintos d. mun.;2011;84;80;22;58
Širvintos d. mun.;2011;85;378;82;296
Širvintos d. mun.;2012;-1;17225;8096;9129
Širvintos d. mun.;2012;0;135;70;65
Širvintos d. mun.;2012;1;123;61;62
Širvintos d. mun.;2012;2;134;62;72
Širvintos d. mun.;2012;3;144;75;69
Širvintos d. mun.;2012;4;163;74;89
Širvintos d. mun.;2012;5;140;68;72
Širvintos d. mun.;2012;6;147;72;75
Širvintos d. mun.;2012;7;146;74;72
Širvintos d. mun.;2012;8;135;75;60
Širvintos d. mun.;2012;9;141;80;61
Širvintos d. mun.;2012;10;149;77;72
Širvintos d. mun.;2012;11;200;110;90
Širvintos d. mun.;2012;12;167;82;85
Širvintos d. mun.;2012;13;200;110;90
Širvintos d. mun.;2012;14;203;102;101
Širvintos d. mun.;2012;15;207;115;92
Širvintos d. mun.;2012;16;207;119;88
Širvintos d. mun.;2012;17;252;135;117
Širvintos d. mun.;2012;18;221;112;109
Širvintos d. mun.;2012;19;288;158;130
Širvintos d. mun.;2012;20;281;142;139
Širvintos d. mun.;2012;21;279;142;137
Širvintos d. mun.;2012;22;233;124;109
Širvintos d. mun.;2012;23;241;123;118
Širvintos d. mun.;2012;24;233;128;105
Širvintos d. mun.;2012;25;205;91;114
Širvintos d. mun.;2012;26;211;117;94
Širvintos d. mun.;2012;27;169;90;79
Širvintos d. mun.;2012;28;190;95;95
Širvintos d. mun.;2012;29;189;104;85
Širvintos d. mun.;2012;30;164;88;76
Širvintos d. mun.;2012;31;171;98;73
Širvintos d. mun.;2012;32;196;106;90
Širvintos d. mun.;2012;33;194;100;94
Širvintos d. mun.;2012;34;176;83;93
Širvintos d. mun.;2012;35;211;113;98
Širvintos d. mun.;2012;36;196;110;86
Širvintos d. mun.;2012;37;204;110;94
Širvintos d. mun.;2012;38;250;122;128
Širvintos d. mun.;2012;39;207;106;101
Širvintos d. mun.;2012;40;238;115;123
Širvintos d. mun.;2012;41;250;115;135
Širvintos d. mun.;2012;42;285;141;144
Širvintos d. mun.;2012;43;276;153;123
Širvintos d. mun.;2012;44;271;143;128
Širvintos d. mun.;2012;45;269;123;146
Širvintos d. mun.;2012;46;219;101;118
Širvintos d. mun.;2012;47;269;135;134
Širvintos d. mun.;2012;48;286;153;133
Širvintos d. mun.;2012;49;308;157;151
Širvintos d. mun.;2012;50;313;167;146
Širvintos d. mun.;2012;51;273;138;135
Širvintos d. mun.;2012;52;278;138;140
Širvintos d. mun.;2012;53;252;116;136
Širvintos d. mun.;2012;54;225;114;111
Širvintos d. mun.;2012;55;245;118;127
Širvintos d. mun.;2012;56;225;112;113
Širvintos d. mun.;2012;57;209;109;100
Širvintos d. mun.;2012;58;209;86;123
Širvintos d. mun.;2012;59;211;99;112
Širvintos d. mun.;2012;60;194;93;101
Širvintos d. mun.;2012;61;206;85;121
Širvintos d. mun.;2012;62;233;93;140
Širvintos d. mun.;2012;63;193;88;105
Širvintos d. mun.;2012;64;174;78;96
Širvintos d. mun.;2012;65;174;68;106
Širvintos d. mun.;2012;66;161;68;93
Širvintos d. mun.;2012;67;175;68;107
Širvintos d. mun.;2012;68;165;69;96
Širvintos d. mun.;2012;69;194;75;119
Širvintos d. mun.;2012;70;167;52;115
Širvintos d. mun.;2012;71;180;68;112
Širvintos d. mun.;2012;72;152;57;95
Širvintos d. mun.;2012;73;161;57;104
Širvintos d. mun.;2012;74;172;50;122
Širvintos d. mun.;2012;75;202;65;137
Širvintos d. mun.;2012;76;170;48;122
Širvintos d. mun.;2012;77;151;54;97
Širvintos d. mun.;2012;78;139;39;100
Širvintos d. mun.;2012;79;149;35;114
Širvintos d. mun.;2012;80;124;50;74
Širvintos d. mun.;2012;81;108;24;84
Širvintos d. mun.;2012;82;117;31;86
Širvintos d. mun.;2012;83;92;20;72
Širvintos d. mun.;2012;84;87;24;63
Širvintos d. mun.;2012;85;372;81;291
Širvintos d. mun.;2013;-1;16908;7958;8950
Širvintos d. mun.;2013;0;168;82;86
Širvintos d. mun.;2013;1;135;71;64
Širvintos d. mun.;2013;2;115;56;59
Širvintos d. mun.;2013;3;124;54;70
Širvintos d. mun.;2013;4;137;72;65
Širvintos d. mun.;2013;5;157;73;84
Širvintos d. mun.;2013;6;133;65;68
Širvintos d. mun.;2013;7;147;71;76
Širvintos d. mun.;2013;8;142;73;69
Širvintos d. mun.;2013;9;133;74;59
Širvintos d. mun.;2013;10;140;79;61
Širvintos d. mun.;2013;11;151;79;72
Širvintos d. mun.;2013;12;198;111;87
Širvintos d. mun.;2013;13;165;80;85
Širvintos d. mun.;2013;14;197;110;87
Širvintos d. mun.;2013;15;201;101;100
Širvintos d. mun.;2013;16;202;112;90
Širvintos d. mun.;2013;17;204;118;86
Širvintos d. mun.;2013;18;253;135;118
Širvintos d. mun.;2013;19;211;111;100
Širvintos d. mun.;2013;20;276;151;125
Širvintos d. mun.;2013;21;274;135;139
Širvintos d. mun.;2013;22;270;140;130
Širvintos d. mun.;2013;23;225;119;106
Širvintos d. mun.;2013;24;235;121;114
Širvintos d. mun.;2013;25;225;123;102
Širvintos d. mun.;2013;26;186;84;102
Širvintos d. mun.;2013;27;194;112;82
Širvintos d. mun.;2013;28;168;91;77
Širvintos d. mun.;2013;29;178;86;92
Širvintos d. mun.;2013;30;185;103;82
Širvintos d. mun.;2013;31;159;85;74
Širvintos d. mun.;2013;32;161;93;68
Širvintos d. mun.;2013;33;190;105;85
Širvintos d. mun.;2013;34;184;93;91
Širvintos d. mun.;2013;35;168;80;88
Širvintos d. mun.;2013;36;214;117;97
Širvintos d. mun.;2013;37;190;105;85
Širvintos d. mun.;2013;38;204;110;94
Širvintos d. mun.;2013;39;241;118;123
Širvintos d. mun.;2013;40;206;106;100
Širvintos d. mun.;2013;41;234;112;122
Širvintos d. mun.;2013;42;248;113;135
Širvintos d. mun.;2013;43;285;142;143
Širvintos d. mun.;2013;44;272;152;120
Širvintos d. mun.;2013;45;271;142;129
Širvintos d. mun.;2013;46;270;122;148
Širvintos d. mun.;2013;47;218;97;121
Širvintos d. mun.;2013;48;260;130;130
Širvintos d. mun.;2013;49;286;154;132
Širvintos d. mun.;2013;50;309;159;150
Širvintos d. mun.;2013;51;304;162;142
Širvintos d. mun.;2013;52;269;136;133
Širvintos d. mun.;2013;53;279;136;143
Širvintos d. mun.;2013;54;253;118;135
Širvintos d. mun.;2013;55;225;111;114
Širvintos d. mun.;2013;56;236;109;127
Širvintos d. mun.;2013;57;225;114;111
Širvintos d. mun.;2013;58;205;106;99
Širvintos d. mun.;2013;59;206;82;124
Širvintos d. mun.;2013;60;205;94;111
Širvintos d. mun.;2013;61;189;91;98
Širvintos d. mun.;2013;62;206;84;122
Širvintos d. mun.;2013;63;233;92;141
Širvintos d. mun.;2013;64;192;87;105
Širvintos d. mun.;2013;65;169;76;93
Širvintos d. mun.;2013;66;170;67;103
Širvintos d. mun.;2013;67;157;64;93
Širvintos d. mun.;2013;68;170;64;106
Širvintos d. mun.;2013;69;158;66;92
Širvintos d. mun.;2013;70;190;71;119
Širvintos d. mun.;2013;71;162;50;112
Širvintos d. mun.;2013;72;174;63;111
Širvintos d. mun.;2013;73;149;56;93
Širvintos d. mun.;2013;74;153;53;100
Širvintos d. mun.;2013;75;166;48;118
Širvintos d. mun.;2013;76;191;62;129
Širvintos d. mun.;2013;77;164;47;117
Širvintos d. mun.;2013;78;145;50;95
Širvintos d. mun.;2013;79;127;34;93
Širvintos d. mun.;2013;80;136;32;104
Širvintos d. mun.;2013;81;118;47;71
Širvintos d. mun.;2013;82;101;24;77
Širvintos d. mun.;2013;83;110;28;82
Širvintos d. mun.;2013;84;79;17;62
Širvintos d. mun.;2013;85;393;90;303
Širvintos d. mun.;2014;-1;16599;7817;8782
Širvintos d. mun.;2014;0;146;71;75
Širvintos d. mun.;2014;1;162;78;84
Širvintos d. mun.;2014;2;128;69;59
Širvintos d. mun.;2014;3;110;55;55
Širvintos d. mun.;2014;4;117;50;67
Širvintos d. mun.;2014;5;133;71;62
Širvintos d. mun.;2014;6;151;71;80
Širvintos d. mun.;2014;7;131;65;66
Širvintos d. mun.;2014;8;147;70;77
Širvintos d. mun.;2014;9;141;71;70
Širvintos d. mun.;2014;10;131;73;58
Širvintos d. mun.;2014;11;141;80;61
Širvintos d. mun.;2014;12;148;77;71
Širvintos d. mun.;2014;13;196;108;88
Širvintos d. mun.;2014;14;162;79;83
Širvintos d. mun.;2014;15;198;109;89
Širvintos d. mun.;2014;16;201;102;99
Širvintos d. mun.;2014;17;203;112;91
Širvintos d. mun.;2014;18;202;117;85
Širvintos d. mun.;2014;19;244;130;114
Širvintos d. mun.;2014;20;208;107;101
Širvintos d. mun.;2014;21;270;147;123
Širvintos d. mun.;2014;22;265;135;130
Širvintos d. mun.;2014;23;257;134;123
Širvintos d. mun.;2014;24;222;120;102
Širvintos d. mun.;2014;25;235;123;112
Širvintos d. mun.;2014;26;214;122;92
Širvintos d. mun.;2014;27;172;76;96
Širvintos d. mun.;2014;28;186;109;77
Širvintos d. mun.;2014;29;167;88;79
Širvintos d. mun.;2014;30;172;89;83
Širvintos d. mun.;2014;31;176;100;76
Širvintos d. mun.;2014;32;159;84;75
Širvintos d. mun.;2014;33;156;91;65
Širvintos d. mun.;2014;34;188;104;84
Širvintos d. mun.;2014;35;182;92;90
Širvintos d. mun.;2014;36;169;79;90
Širvintos d. mun.;2014;37;209;114;95
Širvintos d. mun.;2014;38;189;105;84
Širvintos d. mun.;2014;39;199;105;94
Širvintos d. mun.;2014;40;237;117;120
Širvintos d. mun.;2014;41;199;100;99
Širvintos d. mun.;2014;42;234;113;121
Širvintos d. mun.;2014;43;248;113;135
Širvintos d. mun.;2014;44;284;143;141
Širvintos d. mun.;2014;45;272;152;120
Širvintos d. mun.;2014;46;269;143;126
Širvintos d. mun.;2014;47;268;120;148
Širvintos d. mun.;2014;48;216;95;121
Širvintos d. mun.;2014;49;261;131;130
Širvintos d. mun.;2014;50;280;150;130
Širvintos d. mun.;2014;51;309;160;149
Širvintos d. mun.;2014;52;300;157;143
Širvintos d. mun.;2014;53;265;135;130
Širvintos d. mun.;2014;54;279;136;143
Širvintos d. mun.;2014;55;251;116;135
Širvintos d. mun.;2014;56;220;108;112
Širvintos d. mun.;2014;57;232;108;124
Širvintos d. mun.;2014;58;223;115;108
Širvintos d. mun.;2014;59;205;106;99
Širvintos d. mun.;2014;60;197;76;121
Širvintos d. mun.;2014;61;204;92;112
Širvintos d. mun.;2014;62;189;91;98
Širvintos d. mun.;2014;63;199;81;118
Širvintos d. mun.;2014;64;230;89;141
Širvintos d. mun.;2014;65;183;83;100
Širvintos d. mun.;2014;66;168;75;93
Širvintos d. mun.;2014;67;170;65;105
Širvintos d. mun.;2014;68;151;61;90
Širvintos d. mun.;2014;69;168;63;105
Širvintos d. mun.;2014;70;152;61;91
Širvintos d. mun.;2014;71;187;68;119
Širvintos d. mun.;2014;72;159;49;110
Širvintos d. mun.;2014;73;167;58;109
Širvintos d. mun.;2014;74;139;51;88
Širvintos d. mun.;2014;75;145;49;96
Širvintos d. mun.;2014;76;163;45;118
Širvintos d. mun.;2014;77;181;59;122
Širvintos d. mun.;2014;78;155;41;114
Širvintos d. mun.;2014;79;133;45;88
Širvintos d. mun.;2014;80;115;30;85
Širvintos d. mun.;2014;81;122;24;98
Širvintos d. mun.;2014;82;105;40;65
Širvintos d. mun.;2014;83;93;23;70
Širvintos d. mun.;2014;84;100;20;80
Širvintos d. mun.;2014;85;385;78;307
Širvintos d. mun.;2015;-1;16333;7729;8604
Širvintos d. mun.;2015;0;161;78;83
Širvintos d. mun.;2015;1;142;70;72
Širvintos d. mun.;2015;2;153;77;76
Širvintos d. mun.;2015;3;132;71;61
Širvintos d. mun.;2015;4;110;55;55
Širvintos d. mun.;2015;5;117;52;65
Širvintos d. mun.;2015;6;129;70;59
Širvintos d. mun.;2015;7;153;72;81
Širvintos d. mun.;2015;8;128;63;65
Širvintos d. mun.;2015;9;143;70;73
Širvintos d. mun.;2015;10;142;72;70
Širvintos d. mun.;2015;11;131;72;59
Širvintos d. mun.;2015;12;138;79;59
Širvintos d. mun.;2015;13;148;76;72
Širvintos d. mun.;2015;14;192;106;86
Širvintos d. mun.;2015;15;162;79;83
Širvintos d. mun.;2015;16;198;109;89
Širvintos d. mun.;2015;17;196;100;96
Širvintos d. mun.;2015;18;205;116;89
Širvintos d. mun.;2015;19;196;113;83
Širvintos d. mun.;2015;20;239;128;111
Širvintos d. mun.;2015;21;204;106;98
Širvintos d. mun.;2015;22;267;145;122
Širvintos d. mun.;2015;23;255;128;127
Širvintos d. mun.;2015;24;251;132;119
Širvintos d. mun.;2015;25;203;116;87
Širvintos d. mun.;2015;26;224;121;103
Širvintos d. mun.;2015;27;198;115;83
Širvintos d. mun.;2015;28;164;71;93
Širvintos d. mun.;2015;29;181;102;79
Širvintos d. mun.;2015;30;169;88;81
Širvintos d. mun.;2015;31;166;87;79
Širvintos d. mun.;2015;32;169;96;73
Širvintos d. mun.;2015;33;160;87;73
Širvintos d. mun.;2015;34;154;88;66
Širvintos d. mun.;2015;35;180;99;81
Širvintos d. mun.;2015;36;181;96;85
Širvintos d. mun.;2015;37;172;84;88
Širvintos d. mun.;2015;38;206;113;93
Širvintos d. mun.;2015;39;187;103;84
Širvintos d. mun.;2015;40;198;105;93
Širvintos d. mun.;2015;41;231;115;116
Širvintos d. mun.;2015;42;196;99;97
Širvintos d. mun.;2015;43;237;118;119
Širvintos d. mun.;2015;44;244;111;133
Širvintos d. mun.;2015;45;281;141;140
Širvintos d. mun.;2015;46;261;144;117
Širvintos d. mun.;2015;47;274;145;129
Širvintos d. mun.;2015;48;268;120;148
Širvintos d. mun.;2015;49;215;97;118
Širvintos d. mun.;2015;50;259;128;131
Širvintos d. mun.;2015;51;277;148;129
Širvintos d. mun.;2015;52;304;158;146
Širvintos d. mun.;2015;53;304;161;143
Širvintos d. mun.;2015;54;265;134;131
Širvintos d. mun.;2015;55;274;133;141
Širvintos d. mun.;2015;56;249;116;133
Širvintos d. mun.;2015;57;224;112;112
Širvintos d. mun.;2015;58;234;108;126
Širvintos d. mun.;2015;59;215;107;108
Širvintos d. mun.;2015;60;201;104;97
Širvintos d. mun.;2015;61;196;76;120
Širvintos d. mun.;2015;62;200;89;111
Širvintos d. mun.;2015;63;186;87;99
Širvintos d. mun.;2015;64;201;83;118
Širvintos d. mun.;2015;65;223;85;138
Širvintos d. mun.;2015;66;179;81;98
Širvintos d. mun.;2015;67;164;70;94
Širvintos d. mun.;2015;68;164;60;104
Širvintos d. mun.;2015;69;149;59;90
Širvintos d. mun.;2015;70;163;58;105
Širvintos d. mun.;2015;71;146;58;88
Širvintos d. mun.;2015;72;179;62;117
Širvintos d. mun.;2015;73;151;43;108
Širvintos d. mun.;2015;74;163;56;107
Širvintos d. mun.;2015;75;135;48;87
Širvintos d. mun.;2015;76;138;44;94
Širvintos d. mun.;2015;77;149;40;109
Širvintos d. mun.;2015;78;175;58;117
Širvintos d. mun.;2015;79;146;37;109
Širvintos d. mun.;2015;80;124;40;84
Širvintos d. mun.;2015;81;106;27;79
Širvintos d. mun.;2015;82;107;20;87
Širvintos d. mun.;2015;83;91;34;57
Širvintos d. mun.;2015;84;87;23;64
Širvintos d. mun.;2015;85;394;82;312
Širvintos d. mun.;2016;-1;16074;7606;8468
Širvintos d. mun.;2016;0;149;64;85
Širvintos d. mun.;2016;1;159;79;80
Širvintos d. mun.;2016;2;145;70;75
Širvintos d. mun.;2016;3;152;75;77
Širvintos d. mun.;2016;4;130;70;60
Širvintos d. mun.;2016;5;115;58;57
Širvintos d. mun.;2016;6;119;56;63
Širvintos d. mun.;2016;7;124;69;55
Širvintos d. mun.;2016;8;154;73;81
Širvintos d. mun.;2016;9;127;61;66
Širvintos d. mun.;2016;10;146;72;74
Širvintos d. mun.;2016;11;142;72;70
Širvintos d. mun.;2016;12;129;71;58
Širvintos d. mun.;2016;13;137;78;59
Širvintos d. mun.;2016;14;143;75;68
Širvintos d. mun.;2016;15;188;103;85
Širvintos d. mun.;2016;16;161;76;85
Širvintos d. mun.;2016;17;198;111;87
Širvintos d. mun.;2016;18;194;99;95
Širvintos d. mun.;2016;19;197;113;84
Širvintos d. mun.;2016;20;189;109;80
Širvintos d. mun.;2016;21;238;129;109
Širvintos d. mun.;2016;22;202;104;98
Širvintos d. mun.;2016;23;260;139;121
Širvintos d. mun.;2016;24;246;124;122
Širvintos d. mun.;2016;25;244;126;118
Širvintos d. mun.;2016;26;199;114;85
Širvintos d. mun.;2016;27;202;113;89
Širvintos d. mun.;2016;28;185;110;75
Širvintos d. mun.;2016;29;161;70;91
Širvintos d. mun.;2016;30;177;106;71
Širvintos d. mun.;2016;31;169;86;83
Širvintos d. mun.;2016;32;166;87;79
Širvintos d. mun.;2016;33;161;91;70
Širvintos d. mun.;2016;34;149;80;69
Širvintos d. mun.;2016;35;151;89;62
Širvintos d. mun.;2016;36;177;100;77
Širvintos d. mun.;2016;37;174;93;81
Širvintos d. mun.;2016;38;167;82;85
Širvintos d. mun.;2016;39;203;111;92
Širvintos d. mun.;2016;40;188;107;81
Širvintos d. mun.;2016;41;194;101;93
Širvintos d. mun.;2016;42;231;114;117
Širvintos d. mun.;2016;43;196;98;98
Širvintos d. mun.;2016;44;240;120;120
Širvintos d. mun.;2016;45;242;113;129
Širvintos d. mun.;2016;46;283;143;140
Širvintos d. mun.;2016;47;257;144;113
Širvintos d. mun.;2016;48;269;142;127
Širvintos d. mun.;2016;49;266;119;147
Širvintos d. mun.;2016;50;211;95;116
Širvintos d. mun.;2016;51;256;128;128
Širvintos d. mun.;2016;52;274;147;127
Širvintos d. mun.;2016;53;300;154;146
Širvintos d. mun.;2016;54;297;155;142
Širvintos d. mun.;2016;55;262;130;132
Širvintos d. mun.;2016;56;273;132;141
Širvintos d. mun.;2016;57;242;110;132
Širvintos d. mun.;2016;58;221;109;112
Širvintos d. mun.;2016;59;229;105;124
Širvintos d. mun.;2016;60;208;102;106
Širvintos d. mun.;2016;61;197;103;94
Širvintos d. mun.;2016;62;194;77;117
Širvintos d. mun.;2016;63;199;88;111
Širvintos d. mun.;2016;64;178;81;97
Širvintos d. mun.;2016;65;196;80;116
Širvintos d. mun.;2016;66;222;85;137
Širvintos d. mun.;2016;67;174;78;96
Širvintos d. mun.;2016;68;160;67;93
Širvintos d. mun.;2016;69;158;55;103
Širvintos d. mun.;2016;70;144;54;90
Širvintos d. mun.;2016;71;156;51;105
Širvintos d. mun.;2016;72;141;53;88
Širvintos d. mun.;2016;73;170;56;114
Širvintos d. mun.;2016;74;144;41;103
Širvintos d. mun.;2016;75;158;53;105
Širvintos d. mun.;2016;76;133;46;87
Širvintos d. mun.;2016;77;135;43;92
Širvintos d. mun.;2016;78;144;40;104
Širvintos d. mun.;2016;79;168;55;113
Širvintos d. mun.;2016;80;133;31;102
Širvintos d. mun.;2016;81;117;36;81
Širvintos d. mun.;2016;82;99;23;76
Širvintos d. mun.;2016;83;96;17;79
Širvintos d. mun.;2016;84;87;31;56
Širvintos d. mun.;2016;85;403;86;317
Širvintos d. mun.;2017;-1;15863;7494;8369
Širvintos d. mun.;2017;0;148;80;68
Širvintos d. mun.;2017;1;150;67;83
Širvintos d. mun.;2017;2;155;73;82
Širvintos d. mun.;2017;3;149;70;79
Širvintos d. mun.;2017;4;154;77;77
Širvintos d. mun.;2017;5;127;67;60
Širvintos d. mun.;2017;6;117;58;59
Širvintos d. mun.;2017;7;118;56;62
Širvintos d. mun.;2017;8;127;67;60
Širvintos d. mun.;2017;9;155;70;85
Širvintos d. mun.;2017;10;126;60;66
Širvintos d. mun.;2017;11;146;72;74
Širvintos d. mun.;2017;12;145;72;73
Širvintos d. mun.;2017;13;128;70;58
Širvintos d. mun.;2017;14;136;77;59
Širvintos d. mun.;2017;15;137;67;70
Širvintos d. mun.;2017;16;185;101;84
Širvintos d. mun.;2017;17;159;75;84
Širvintos d. mun.;2017;18;194;109;85
Širvintos d. mun.;2017;19;193;97;96
Širvintos d. mun.;2017;20;193;111;82
Širvintos d. mun.;2017;21;191;111;80
Širvintos d. mun.;2017;22;238;129;109
Širvintos d. mun.;2017;23;201;103;98
Širvintos d. mun.;2017;24;258;139;119
Širvintos d. mun.;2017;25;236;118;118
Širvintos d. mun.;2017;26;226;123;103
Širvintos d. mun.;2017;27;195;113;82
Širvintos d. mun.;2017;28;190;104;86
Širvintos d. mun.;2017;29;182;106;76
Širvintos d. mun.;2017;30;160;70;90
Širvintos d. mun.;2017;31;167;103;64
Širvintos d. mun.;2017;32;164;85;79
Širvintos d. mun.;2017;33;162;81;81
Širvintos d. mun.;2017;34;153;88;65
Širvintos d. mun.;2017;35;149;82;67
Širvintos d. mun.;2017;36;148;88;60
Širvintos d. mun.;2017;37;173;92;81
Širvintos d. mun.;2017;38;169;90;79
Širvintos d. mun.;2017;39;168;84;84
Širvintos d. mun.;2017;40;195;105;90
Širvintos d. mun.;2017;41;186;105;81
Širvintos d. mun.;2017;42;189;99;90
Širvintos d. mun.;2017;43;223;111;112
Širvintos d. mun.;2017;44;191;94;97
Širvintos d. mun.;2017;45;236;117;119
Širvintos d. mun.;2017;46;237;112;125
Širvintos d. mun.;2017;47;281;143;138
Širvintos d. mun.;2017;48;254;140;114
Širvintos d. mun.;2017;49;264;140;124
Širvintos d. mun.;2017;50;268;120;148
Širvintos d. mun.;2017;51;213;96;117
Širvintos d. mun.;2017;52;255;127;128
Širvintos d. mun.;2017;53;270;144;126
Širvintos d. mun.;2017;54;293;151;142
Širvintos d. mun.;2017;55;294;154;140
Širvintos d. mun.;2017;56;260;130;130
Širvintos d. mun.;2017;57;274;132;142
Širvintos d. mun.;2017;58;238;108;130
Širvintos d. mun.;2017;59;219;110;109
Širvintos d. mun.;2017;60;230;106;124
Širvintos d. mun.;2017;61;205;100;105
Širvintos d. mun.;2017;62;195;101;94
Širvintos d. mun.;2017;63;192;76;116
Širvintos d. mun.;2017;64;199;87;112
Širvintos d. mun.;2017;65;170;76;94
Širvintos d. mun.;2017;66;190;77;113
Širvintos d. mun.;2017;67;219;83;136
Širvintos d. mun.;2017;68;172;78;94
Širvintos d. mun.;2017;69;156;65;91
Širvintos d. mun.;2017;70;152;50;102
Širvintos d. mun.;2017;71;139;50;89
Širvintos d. mun.;2017;72;152;49;103
Širvintos d. mun.;2017;73;142;53;89
Širvintos d. mun.;2017;74;165;54;111
Širvintos d. mun.;2017;75;137;36;101
Širvintos d. mun.;2017;76;150;49;101
Širvintos d. mun.;2017;77;131;45;86
Širvintos d. mun.;2017;78;126;39;87
Širvintos d. mun.;2017;79;136;38;98
Širvintos d. mun.;2017;80;162;51;111
Širvintos d. mun.;2017;81;128;28;100
Širvintos d. mun.;2017;82;108;31;77
Širvintos d. mun.;2017;83;90;20;70
Širvintos d. mun.;2017;84;87;12;75
Širvintos d. mun.;2017;85;418;97;321
Širvintos d. mun.;2018;-1;15570;7375;8195
Širvintos d. mun.;2018;0;144;73;71
Širvintos d. mun.;2018;1;148;79;69
Širvintos d. mun.;2018;2;147;65;82
Širvintos d. mun.;2018;3;155;73;82
Širvintos d. mun.;2018;4;149;69;80
Širvintos d. mun.;2018;5;152;73;79
Širvintos d. mun.;2018;6;126;66;60
Širvintos d. mun.;2018;7;117;58;59
Širvintos d. mun.;2018;8;118;57;61
Širvintos d. mun.;2018;9;122;64;58
Širvintos d. mun.;2018;10;153;67;86
Širvintos d. mun.;2018;11;125;60;65
Širvintos d. mun.;2018;12;142;70;72
Širvintos d. mun.;2018;13;144;70;74
Širvintos d. mun.;2018;14;129;70;59
Širvintos d. mun.;2018;15;133;75;58
Širvintos d. mun.;2018;16;136;66;70
Širvintos d. mun.;2018;17;184;102;82
Širvintos d. mun.;2018;18;158;76;82
Širvintos d. mun.;2018;19;185;107;78
Širvintos d. mun.;2018;20;193;100;93
Širvintos d. mun.;2018;21;183;107;76
Širvintos d. mun.;2018;22;186;108;78
Širvintos d. mun.;2018;23;230;125;105
Širvintos d. mun.;2018;24;194;102;92
Širvintos d. mun.;2018;25;243;140;103
Širvintos d. mun.;2018;26;220;112;108
Širvintos d. mun.;2018;27;204;109;95
Širvintos d. mun.;2018;28;188;109;79
Širvintos d. mun.;2018;29;173;98;75
Širvintos d. mun.;2018;30;176;105;71
Širvintos d. mun.;2018;31;145;63;82
Širvintos d. mun.;2018;32;162;100;62
Širvintos d. mun.;2018;33;163;84;79
Širvintos d. mun.;2018;34;154;78;76
Širvintos d. mun.;2018;35;151;84;67
Širvintos d. mun.;2018;36;146;78;68
Širvintos d. mun.;2018;37;145;86;59
Širvintos d. mun.;2018;38;169;89;80
Širvintos d. mun.;2018;39;169;90;79
Širvintos d. mun.;2018;40;161;78;83
Širvintos d. mun.;2018;41;194;105;89
Širvintos d. mun.;2018;42;181;102;79
Širvintos d. mun.;2018;43;191;104;87
Širvintos d. mun.;2018;44;221;108;113
Širvintos d. mun.;2018;45;187;91;96
Širvintos d. mun.;2018;46;238;118;120
Širvintos d. mun.;2018;47;234;110;124
Širvintos d. mun.;2018;48;279;141;138
Širvintos d. mun.;2018;49;250;137;113
Širvintos d. mun.;2018;50;266;142;124
Širvintos d. mun.;2018;51;264;117;147
Širvintos d. mun.;2018;52;210;92;118
Širvintos d. mun.;2018;53;254;127;127
Širvintos d. mun.;2018;54;270;141;129
Širvintos d. mun.;2018;55;287;147;140
Širvintos d. mun.;2018;56;292;154;138
Širvintos d. mun.;2018;57;263;133;130
Širvintos d. mun.;2018;58;270;130;140
Širvintos d. mun.;2018;59;241;110;131
Širvintos d. mun.;2018;60;212;105;107
Širvintos d. mun.;2018;61;227;101;126
Širvintos d. mun.;2018;62;200;100;100
Širvintos d. mun.;2018;63;193;101;92
Širvintos d. mun.;2018;64;191;75;116
Širvintos d. mun.;2018;65;197;85;112
Širvintos d. mun.;2018;66;164;73;91
Širvintos d. mun.;2018;67;189;76;113
Širvintos d. mun.;2018;68;217;81;136
Širvintos d. mun.;2018;69;167;74;93
Širvintos d. mun.;2018;70;155;65;90
Širvintos d. mun.;2018;71;152;49;103
Širvintos d. mun.;2018;72;132;46;86
Širvintos d. mun.;2018;73;151;48;103
Širvintos d. mun.;2018;74;141;53;88
Širvintos d. mun.;2018;75;156;51;105
Širvintos d. mun.;2018;76;130;33;97
Širvintos d. mun.;2018;77;142;46;96
Širvintos d. mun.;2018;78;125;41;84
Širvintos d. mun.;2018;79;118;36;82
Širvintos d. mun.;2018;80;125;34;91
Širvintos d. mun.;2018;81;153;48;105
Širvintos d. mun.;2018;82;114;23;91
Širvintos d. mun.;2018;83;97;28;69
Širvintos d. mun.;2018;84;80;17;63
Širvintos d. mun.;2018;85;428;92;336
Skuodas d. mun.;2001;-1;25637;12312;13325
Skuodas d. mun.;2001;0;273;137;136
Skuodas d. mun.;2001;1;303;150;153
Skuodas d. mun.;2001;2;304;153;151
Skuodas d. mun.;2001;3;335;168;167
Skuodas d. mun.;2001;4;331;159;172
Skuodas d. mun.;2001;5;357;195;162
Skuodas d. mun.;2001;6;348;201;147
Skuodas d. mun.;2001;7;396;207;189
Skuodas d. mun.;2001;8;460;246;214
Skuodas d. mun.;2001;9;474;235;239
Skuodas d. mun.;2001;10;493;235;258
Skuodas d. mun.;2001;11;490;243;247
Skuodas d. mun.;2001;12;470;231;239
Skuodas d. mun.;2001;13;470;239;231
Skuodas d. mun.;2001;14;486;251;235
Skuodas d. mun.;2001;15;478;251;227
Skuodas d. mun.;2001;16;441;225;216
Skuodas d. mun.;2001;17;412;201;211
Skuodas d. mun.;2001;18;306;165;141
Skuodas d. mun.;2001;19;241;147;94
Skuodas d. mun.;2001;20;228;129;99
Skuodas d. mun.;2001;21;241;136;105
Skuodas d. mun.;2001;22;240;135;105
Skuodas d. mun.;2001;23;273;155;118
Skuodas d. mun.;2001;24;283;144;139
Skuodas d. mun.;2001;25;272;149;123
Skuodas d. mun.;2001;26;267;132;135
Skuodas d. mun.;2001;27;276;140;136
Skuodas d. mun.;2001;28;273;124;149
Skuodas d. mun.;2001;29;326;170;156
Skuodas d. mun.;2001;30;328;165;163
Skuodas d. mun.;2001;31;311;149;162
Skuodas d. mun.;2001;32;329;166;163
Skuodas d. mun.;2001;33;352;173;179
Skuodas d. mun.;2001;34;349;181;168
Skuodas d. mun.;2001;35;376;191;185
Skuodas d. mun.;2001;36;365;183;182
Skuodas d. mun.;2001;37;351;171;180
Skuodas d. mun.;2001;38;365;197;168
Skuodas d. mun.;2001;39;372;193;179
Skuodas d. mun.;2001;40;353;193;160
Skuodas d. mun.;2001;41;383;192;191
Skuodas d. mun.;2001;42;344;175;169
Skuodas d. mun.;2001;43;358;160;198
Skuodas d. mun.;2001;44;335;158;177
Skuodas d. mun.;2001;45;326;167;159
Skuodas d. mun.;2001;46;309;160;149
Skuodas d. mun.;2001;47;287;137;150
Skuodas d. mun.;2001;48;307;158;149
Skuodas d. mun.;2001;49;294;145;149
Skuodas d. mun.;2001;50;289;137;152
Skuodas d. mun.;2001;51;309;154;155
Skuodas d. mun.;2001;52;319;152;167
Skuodas d. mun.;2001;53;261;120;141
Skuodas d. mun.;2001;54;257;109;148
Skuodas d. mun.;2001;55;251;120;131
Skuodas d. mun.;2001;56;258;121;137
Skuodas d. mun.;2001;57;269;128;141
Skuodas d. mun.;2001;58;296;126;170
Skuodas d. mun.;2001;59;299;153;146
Skuodas d. mun.;2001;60;245;113;132
Skuodas d. mun.;2001;61;242;107;135
Skuodas d. mun.;2001;62;247;121;126
Skuodas d. mun.;2001;63;229;96;133
Skuodas d. mun.;2001;64;274;120;154
Skuodas d. mun.;2001;65;293;131;162
Skuodas d. mun.;2001;66;282;122;160
Skuodas d. mun.;2001;67;254;102;152
Skuodas d. mun.;2001;68;237;95;142
Skuodas d. mun.;2001;69;267;107;160
Skuodas d. mun.;2001;70;252;88;164
Skuodas d. mun.;2001;71;219;78;141
Skuodas d. mun.;2001;72;274;94;180
Skuodas d. mun.;2001;73;221;83;138
Skuodas d. mun.;2001;74;230;78;152
Skuodas d. mun.;2001;75;222;77;145
Skuodas d. mun.;2001;76;187;74;113
Skuodas d. mun.;2001;77;205;78;127
Skuodas d. mun.;2001;78;183;69;114
Skuodas d. mun.;2001;79;153;52;101
Skuodas d. mun.;2001;80;123;41;82
Skuodas d. mun.;2001;81;98;32;66
Skuodas d. mun.;2001;82;66;21;45
Skuodas d. mun.;2001;83;61;21;40
Skuodas d. mun.;2001;84;60;16;44
Skuodas d. mun.;2001;85;364;109;255
Skuodas d. mun.;2002;-1;25291;12103;13188
Skuodas d. mun.;2002;0;241;118;123
Skuodas d. mun.;2002;1;272;135;137
Skuodas d. mun.;2002;2;300;151;149
Skuodas d. mun.;2002;3;303;153;150
Skuodas d. mun.;2002;4;332;166;166
Skuodas d. mun.;2002;5;328;157;171
Skuodas d. mun.;2002;6;356;193;163
Skuodas d. mun.;2002;7;345;199;146
Skuodas d. mun.;2002;8;394;206;188
Skuodas d. mun.;2002;9;460;244;216
Skuodas d. mun.;2002;10;468;234;234
Skuodas d. mun.;2002;11;490;234;256
Skuodas d. mun.;2002;12;481;239;242
Skuodas d. mun.;2002;13;464;227;237
Skuodas d. mun.;2002;14;465;236;229
Skuodas d. mun.;2002;15;481;248;233
Skuodas d. mun.;2002;16;469;246;223
Skuodas d. mun.;2002;17;433;221;212
Skuodas d. mun.;2002;18;400;196;204
Skuodas d. mun.;2002;19;301;164;137
Skuodas d. mun.;2002;20;236;143;93
Skuodas d. mun.;2002;21;228;130;98
Skuodas d. mun.;2002;22;246;134;112
Skuodas d. mun.;2002;23;241;136;105
Skuodas d. mun.;2002;24;268;149;119
Skuodas d. mun.;2002;25;276;139;137
Skuodas d. mun.;2002;26;260;143;117
Skuodas d. mun.;2002;27;255;122;133
Skuodas d. mun.;2002;28;270;133;137
Skuodas d. mun.;2002;29;259;115;144
Skuodas d. mun.;2002;30;321;168;153
Skuodas d. mun.;2002;31;317;160;157
Skuodas d. mun.;2002;32;304;147;157
Skuodas d. mun.;2002;33;325;162;163
Skuodas d. mun.;2002;34;344;165;179
Skuodas d. mun.;2002;35;343;176;167
Skuodas d. mun.;2002;36;370;187;183
Skuodas d. mun.;2002;37;361;181;180
Skuodas d. mun.;2002;38;344;164;180
Skuodas d. mun.;2002;39;353;189;164
Skuodas d. mun.;2002;40;367;187;180
Skuodas d. mun.;2002;41;348;189;159
Skuodas d. mun.;2002;42;378;188;190
Skuodas d. mun.;2002;43;342;174;168
Skuodas d. mun.;2002;44;352;157;195
Skuodas d. mun.;2002;45;326;153;173
Skuodas d. mun.;2002;46;322;164;158
Skuodas d. mun.;2002;47;304;158;146
Skuodas d. mun.;2002;48;280;132;148
Skuodas d. mun.;2002;49;301;154;147
Skuodas d. mun.;2002;50;290;142;148
Skuodas d. mun.;2002;51;283;133;150
Skuodas d. mun.;2002;52;309;153;156
Skuodas d. mun.;2002;53;316;150;166
Skuodas d. mun.;2002;54;256;117;139
Skuodas d. mun.;2002;55;250;104;146
Skuodas d. mun.;2002;56;240;114;126
Skuodas d. mun.;2002;57;252;117;135
Skuodas d. mun.;2002;58;260;123;137
Skuodas d. mun.;2002;59;284;122;162
Skuodas d. mun.;2002;60;291;148;143
Skuodas d. mun.;2002;61;240;111;129
Skuodas d. mun.;2002;62;239;104;135
Skuodas d. mun.;2002;63;241;117;124
Skuodas d. mun.;2002;64;224;95;129
Skuodas d. mun.;2002;65;272;119;153
Skuodas d. mun.;2002;66;288;127;161
Skuodas d. mun.;2002;67;274;117;157
Skuodas d. mun.;2002;68;249;100;149
Skuodas d. mun.;2002;69;233;92;141
Skuodas d. mun.;2002;70;256;103;153
Skuodas d. mun.;2002;71;246;83;163
Skuodas d. mun.;2002;72;211;72;139
Skuodas d. mun.;2002;73;274;96;178
Skuodas d. mun.;2002;74;212;79;133
Skuodas d. mun.;2002;75;227;74;153
Skuodas d. mun.;2002;76;209;73;136
Skuodas d. mun.;2002;77;180;66;114
Skuodas d. mun.;2002;78;195;74;121
Skuodas d. mun.;2002;79;169;62;107
Skuodas d. mun.;2002;80;143;48;95
Skuodas d. mun.;2002;81;112;38;74
Skuodas d. mun.;2002;82;93;29;64
Skuodas d. mun.;2002;83;58;19;39
Skuodas d. mun.;2002;84;53;17;36
Skuodas d. mun.;2002;85;338;99;239
Skuodas d. mun.;2003;-1;24973;11945;13028
Skuodas d. mun.;2003;0;213;110;103
Skuodas d. mun.;2003;1;242;119;123
Skuodas d. mun.;2003;2;270;136;134
Skuodas d. mun.;2003;3;302;153;149
Skuodas d. mun.;2003;4;304;152;152
Skuodas d. mun.;2003;5;330;167;163
Skuodas d. mun.;2003;6;330;159;171
Skuodas d. mun.;2003;7;356;194;162
Skuodas d. mun.;2003;8;343;198;145
Skuodas d. mun.;2003;9;394;205;189
Skuodas d. mun.;2003;10;455;242;213
Skuodas d. mun.;2003;11;466;232;234
Skuodas d. mun.;2003;12;482;231;251
Skuodas d. mun.;2003;13;472;235;237
Skuodas d. mun.;2003;14;457;224;233
Skuodas d. mun.;2003;15;457;231;226
Skuodas d. mun.;2003;16;471;244;227
Skuodas d. mun.;2003;17;461;241;220
Skuodas d. mun.;2003;18;427;217;210
Skuodas d. mun.;2003;19;393;191;202
Skuodas d. mun.;2003;20;297;161;136
Skuodas d. mun.;2003;21;235;145;90
Skuodas d. mun.;2003;22;226;129;97
Skuodas d. mun.;2003;23;251;138;113
Skuodas d. mun.;2003;24;234;135;99
Skuodas d. mun.;2003;25;254;141;113
Skuodas d. mun.;2003;26;274;141;133
Skuodas d. mun.;2003;27;249;136;113
Skuodas d. mun.;2003;28;246;115;131
Skuodas d. mun.;2003;29;261;129;132
Skuodas d. mun.;2003;30;257;114;143
Skuodas d. mun.;2003;31;314;164;150
Skuodas d. mun.;2003;32;313;159;154
Skuodas d. mun.;2003;33;299;144;155
Skuodas d. mun.;2003;34;320;160;160
Skuodas d. mun.;2003;35;334;161;173
Skuodas d. mun.;2003;36;333;171;162
Skuodas d. mun.;2003;37;364;184;180
Skuodas d. mun.;2003;38;360;180;180
Skuodas d. mun.;2003;39;337;161;176
Skuodas d. mun.;2003;40;349;187;162
Skuodas d. mun.;2003;41;360;184;176
Skuodas d. mun.;2003;42;344;186;158
Skuodas d. mun.;2003;43;374;187;187
Skuodas d. mun.;2003;44;341;175;166
Skuodas d. mun.;2003;45;345;153;192
Skuodas d. mun.;2003;46;321;149;172
Skuodas d. mun.;2003;47;318;162;156
Skuodas d. mun.;2003;48;302;156;146
Skuodas d. mun.;2003;49;272;129;143
Skuodas d. mun.;2003;50;293;147;146
Skuodas d. mun.;2003;51;285;138;147
Skuodas d. mun.;2003;52;277;128;149
Skuodas d. mun.;2003;53;310;156;154
Skuodas d. mun.;2003;54;315;150;165
Skuodas d. mun.;2003;55;248;110;138
Skuodas d. mun.;2003;56;245;100;145
Skuodas d. mun.;2003;57;240;113;127
Skuodas d. mun.;2003;58;245;112;133
Skuodas d. mun.;2003;59;256;118;138
Skuodas d. mun.;2003;60;282;120;162
Skuodas d. mun.;2003;61;284;145;139
Skuodas d. mun.;2003;62;237;110;127
Skuodas d. mun.;2003;63;235;102;133
Skuodas d. mun.;2003;64;242;117;125
Skuodas d. mun.;2003;65;225;93;132
Skuodas d. mun.;2003;66;272;118;154
Skuodas d. mun.;2003;67;281;124;157
Skuodas d. mun.;2003;68;270;116;154
Skuodas d. mun.;2003;69;243;95;148
Skuodas d. mun.;2003;70;232;91;141
Skuodas d. mun.;2003;71;246;95;151
Skuodas d. mun.;2003;72;235;80;155
Skuodas d. mun.;2003;73;206;68;138
Skuodas d. mun.;2003;74;272;95;177
Skuodas d. mun.;2003;75;203;70;133
Skuodas d. mun.;2003;76;213;67;146
Skuodas d. mun.;2003;77;191;67;124
Skuodas d. mun.;2003;78;167;61;106
Skuodas d. mun.;2003;79;179;64;115
Skuodas d. mun.;2003;80;158;55;103
Skuodas d. mun.;2003;81;128;41;87
Skuodas d. mun.;2003;82;98;32;66
Skuodas d. mun.;2003;83;85;26;59
Skuodas d. mun.;2003;84;52;17;35
Skuodas d. mun.;2003;85;314;87;227
Skuodas d. mun.;2004;-1;24613;11746;12867
Skuodas d. mun.;2004;0;234;126;108
Skuodas d. mun.;2004;1;216;111;105
Skuodas d. mun.;2004;2;240;118;122
Skuodas d. mun.;2004;3;271;135;136
Skuodas d. mun.;2004;4;300;151;149
Skuodas d. mun.;2004;5;307;153;154
Skuodas d. mun.;2004;6;333;167;166
Skuodas d. mun.;2004;7;328;157;171
Skuodas d. mun.;2004;8;354;193;161
Skuodas d. mun.;2004;9;345;202;143
Skuodas d. mun.;2004;10;393;204;189
Skuodas d. mun.;2004;11;456;243;213
Skuodas d. mun.;2004;12;458;227;231
Skuodas d. mun.;2004;13;477;228;249
Skuodas d. mun.;2004;14;466;232;234
Skuodas d. mun.;2004;15;451;220;231
Skuodas d. mun.;2004;16;448;228;220
Skuodas d. mun.;2004;17;462;241;221
Skuodas d. mun.;2004;18;452;237;215
Skuodas d. mun.;2004;19;420;214;206
Skuodas d. mun.;2004;20;380;185;195
Skuodas d. mun.;2004;21;293;162;131
Skuodas d. mun.;2004;22;230;143;87
Skuodas d. mun.;2004;23;218;129;89
Skuodas d. mun.;2004;24;249;137;112
Skuodas d. mun.;2004;25;229;133;96
Skuodas d. mun.;2004;26;244;138;106
Skuodas d. mun.;2004;27;263;135;128
Skuodas d. mun.;2004;28;231;126;105
Skuodas d. mun.;2004;29;234;109;125
Skuodas d. mun.;2004;30;249;121;128
Skuodas d. mun.;2004;31;244;108;136
Skuodas d. mun.;2004;32;307;156;151
Skuodas d. mun.;2004;33;305;154;151
Skuodas d. mun.;2004;34;298;143;155
Skuodas d. mun.;2004;35;319;159;160
Skuodas d. mun.;2004;36;327;158;169
Skuodas d. mun.;2004;37;330;167;163
Skuodas d. mun.;2004;38;359;181;178
Skuodas d. mun.;2004;39;359;178;181
Skuodas d. mun.;2004;40;329;157;172
Skuodas d. mun.;2004;41;343;183;160
Skuodas d. mun.;2004;42;354;180;174
Skuodas d. mun.;2004;43;336;183;153
Skuodas d. mun.;2004;44;368;182;186
Skuodas d. mun.;2004;45;339;174;165
Skuodas d. mun.;2004;46;343;152;191
Skuodas d. mun.;2004;47;318;147;171
Skuodas d. mun.;2004;48;313;158;155
Skuodas d. mun.;2004;49;295;151;144
Skuodas d. mun.;2004;50;270;128;142
Skuodas d. mun.;2004;51;284;141;143
Skuodas d. mun.;2004;52;279;133;146
Skuodas d. mun.;2004;53;273;126;147
Skuodas d. mun.;2004;54;311;158;153
Skuodas d. mun.;2004;55;308;146;162
Skuodas d. mun.;2004;56;246;109;137
Skuodas d. mun.;2004;57;236;96;140
Skuodas d. mun.;2004;58;238;112;126
Skuodas d. mun.;2004;59;236;108;128
Skuodas d. mun.;2004;60;248;112;136
Skuodas d. mun.;2004;61;276;116;160
Skuodas d. mun.;2004;62;283;145;138
Skuodas d. mun.;2004;63;232;106;126
Skuodas d. mun.;2004;64;232;100;132
Skuodas d. mun.;2004;65;233;110;123
Skuodas d. mun.;2004;66;219;90;129
Skuodas d. mun.;2004;67;262;110;152
Skuodas d. mun.;2004;68;276;120;156
Skuodas d. mun.;2004;69;265;110;155
Skuodas d. mun.;2004;70;233;89;144
Skuodas d. mun.;2004;71;224;84;140
Skuodas d. mun.;2004;72;240;88;152
Skuodas d. mun.;2004;73;224;75;149
Skuodas d. mun.;2004;74;195;62;133
Skuodas d. mun.;2004;75;257;89;168
Skuodas d. mun.;2004;76;192;67;125
Skuodas d. mun.;2004;77;196;55;141
Skuodas d. mun.;2004;78;181;59;122
Skuodas d. mun.;2004;79;158;56;102
Skuodas d. mun.;2004;80;165;56;109
Skuodas d. mun.;2004;81;143;49;94
Skuodas d. mun.;2004;82;119;35;84
Skuodas d. mun.;2004;83;90;29;61
Skuodas d. mun.;2004;84;83;23;60
Skuodas d. mun.;2004;85;289;78;211
Skuodas d. mun.;2005;-1;24143;11544;12599
Skuodas d. mun.;2005;0;228;107;121
Skuodas d. mun.;2005;1;232;127;105
Skuodas d. mun.;2005;2;216;111;105
Skuodas d. mun.;2005;3;236;116;120
Skuodas d. mun.;2005;4;265;133;132
Skuodas d. mun.;2005;5;294;148;146
Skuodas d. mun.;2005;6;307;154;153
Skuodas d. mun.;2005;7;329;167;162
Skuodas d. mun.;2005;8;322;154;168
Skuodas d. mun.;2005;9;350;189;161
Skuodas d. mun.;2005;10;341;199;142
Skuodas d. mun.;2005;11;390;202;188
Skuodas d. mun.;2005;12;452;240;212
Skuodas d. mun.;2005;13;456;226;230
Skuodas d. mun.;2005;14;473;227;246
Skuodas d. mun.;2005;15;457;228;229
Skuodas d. mun.;2005;16;443;215;228
Skuodas d. mun.;2005;17;436;222;214
Skuodas d. mun.;2005;18;449;234;215
Skuodas d. mun.;2005;19;435;228;207
Skuodas d. mun.;2005;20;416;212;204
Skuodas d. mun.;2005;21;366;180;186
Skuodas d. mun.;2005;22;287;157;130
Skuodas d. mun.;2005;23;222;141;81
Skuodas d. mun.;2005;24;208;124;84
Skuodas d. mun.;2005;25;227;124;103
Skuodas d. mun.;2005;26;206;127;79
Skuodas d. mun.;2005;27;222;124;98
Skuodas d. mun.;2005;28;244;126;118
Skuodas d. mun.;2005;29;223;124;99
Skuodas d. mun.;2005;30;222;102;120
Skuodas d. mun.;2005;31;245;121;124
Skuodas d. mun.;2005;32;232;108;124
Skuodas d. mun.;2005;33;300;154;146
Skuodas d. mun.;2005;34;296;150;146
Skuodas d. mun.;2005;35;284;136;148
Skuodas d. mun.;2005;36;312;155;157
Skuodas d. mun.;2005;37;321;156;165
Skuodas d. mun.;2005;38;321;163;158
Skuodas d. mun.;2005;39;350;176;174
Skuodas d. mun.;2005;40;359;177;182
Skuodas d. mun.;2005;41;321;156;165
Skuodas d. mun.;2005;42;341;182;159
Skuodas d. mun.;2005;43;350;178;172
Skuodas d. mun.;2005;44;336;185;151
Skuodas d. mun.;2005;45;366;181;185
Skuodas d. mun.;2005;46;334;172;162
Skuodas d. mun.;2005;47;343;153;190
Skuodas d. mun.;2005;48;311;145;166
Skuodas d. mun.;2005;49;312;156;156
Skuodas d. mun.;2005;50;292;150;142
Skuodas d. mun.;2005;51;262;123;139
Skuodas d. mun.;2005;52;280;138;142
Skuodas d. mun.;2005;53;273;128;145
Skuodas d. mun.;2005;54;268;124;144
Skuodas d. mun.;2005;55;301;152;149
Skuodas d. mun.;2005;56;307;145;162
Skuodas d. mun.;2005;57;244;107;137
Skuodas d. mun.;2005;58;230;94;136
Skuodas d. mun.;2005;59;232;110;122
Skuodas d. mun.;2005;60;232;103;129
Skuodas d. mun.;2005;61;240;106;134
Skuodas d. mun.;2005;62;269;113;156
Skuodas d. mun.;2005;63;274;139;135
Skuodas d. mun.;2005;64;229;106;123
Skuodas d. mun.;2005;65;227;96;131
Skuodas d. mun.;2005;66;220;102;118
Skuodas d. mun.;2005;67;216;87;129
Skuodas d. mun.;2005;68;256;107;149
Skuodas d. mun.;2005;69;274;118;156
Skuodas d. mun.;2005;70;256;102;154
Skuodas d. mun.;2005;71;230;87;143
Skuodas d. mun.;2005;72;216;79;137
Skuodas d. mun.;2005;73;230;85;145
Skuodas d. mun.;2005;74;216;72;144
Skuodas d. mun.;2005;75;181;55;126
Skuodas d. mun.;2005;76;239;81;158
Skuodas d. mun.;2005;77;186;65;121
Skuodas d. mun.;2005;78;182;50;132
Skuodas d. mun.;2005;79;169;56;113
Skuodas d. mun.;2005;80;144;50;94
Skuodas d. mun.;2005;81;152;51;101
Skuodas d. mun.;2005;82;133;48;85
Skuodas d. mun.;2005;83;108;33;75
Skuodas d. mun.;2005;84;85;27;58
Skuodas d. mun.;2005;85;302;83;219
Skuodas d. mun.;2006;-1;23427;11197;12230
Skuodas d. mun.;2006;0;194;99;95
Skuodas d. mun.;2006;1;222;104;118
Skuodas d. mun.;2006;2;228;123;105
Skuodas d. mun.;2006;3;212;111;101
Skuodas d. mun.;2006;4;233;115;118
Skuodas d. mun.;2006;5;260;130;130
Skuodas d. mun.;2006;6;288;145;143
Skuodas d. mun.;2006;7;303;153;150
Skuodas d. mun.;2006;8;324;165;159
Skuodas d. mun.;2006;9;318;154;164
Skuodas d. mun.;2006;10;342;187;155
Skuodas d. mun.;2006;11;333;197;136
Skuodas d. mun.;2006;12;384;202;182
Skuodas d. mun.;2006;13;442;234;208
Skuodas d. mun.;2006;14;451;224;227
Skuodas d. mun.;2006;15;455;217;238
Skuodas d. mun.;2006;16;443;221;222
Skuodas d. mun.;2006;17;429;207;222
Skuodas d. mun.;2006;18;417;214;203
Skuodas d. mun.;2006;19;424;222;202
Skuodas d. mun.;2006;20;409;212;197
Skuodas d. mun.;2006;21;388;196;192
Skuodas d. mun.;2006;22;341;171;170
Skuodas d. mun.;2006;23;271;152;119
Skuodas d. mun.;2006;24;213;142;71
Skuodas d. mun.;2006;25;197;117;80
Skuodas d. mun.;2006;26;212;116;96
Skuodas d. mun.;2006;27;191;118;73
Skuodas d. mun.;2006;28;212;116;96
Skuodas d. mun.;2006;29;230;117;113
Skuodas d. mun.;2006;30;205;113;92
Skuodas d. mun.;2006;31;209;96;113
Skuodas d. mun.;2006;32;236;116;120
Skuodas d. mun.;2006;33;226;105;121
Skuodas d. mun.;2006;34;292;148;144
Skuodas d. mun.;2006;35;287;146;141
Skuodas d. mun.;2006;36;276;132;144
Skuodas d. mun.;2006;37;306;153;153
Skuodas d. mun.;2006;38;311;150;161
Skuodas d. mun.;2006;39;312;157;155
Skuodas d. mun.;2006;40;341;168;173
Skuodas d. mun.;2006;41;347;170;177
Skuodas d. mun.;2006;42;310;151;159
Skuodas d. mun.;2006;43;329;174;155
Skuodas d. mun.;2006;44;344;172;172
Skuodas d. mun.;2006;45;327;180;147
Skuodas d. mun.;2006;46;357;178;179
Skuodas d. mun.;2006;47;322;163;159
Skuodas d. mun.;2006;48;340;153;187
Skuodas d. mun.;2006;49;304;141;163
Skuodas d. mun.;2006;50;301;150;151
Skuodas d. mun.;2006;51;283;146;137
Skuodas d. mun.;2006;52;259;121;138
Skuodas d. mun.;2006;53;269;135;134
Skuodas d. mun.;2006;54;269;126;143
Skuodas d. mun.;2006;55;259;118;141
Skuodas d. mun.;2006;56;294;147;147
Skuodas d. mun.;2006;57;304;145;159
Skuodas d. mun.;2006;58;241;104;137
Skuodas d. mun.;2006;59;223;90;133
Skuodas d. mun.;2006;60;227;104;123
Skuodas d. mun.;2006;61;227;102;125
Skuodas d. mun.;2006;62;231;99;132
Skuodas d. mun.;2006;63;267;111;156
Skuodas d. mun.;2006;64;259;131;128
Skuodas d. mun.;2006;65;227;107;120
Skuodas d. mun.;2006;66;221;93;128
Skuodas d. mun.;2006;67;215;98;117
Skuodas d. mun.;2006;68;210;85;125
Skuodas d. mun.;2006;69;246;102;144
Skuodas d. mun.;2006;70;265;111;154
Skuodas d. mun.;2006;71;253;101;152
Skuodas d. mun.;2006;72;219;80;139
Skuodas d. mun.;2006;73;204;73;131
Skuodas d. mun.;2006;74;216;78;138
Skuodas d. mun.;2006;75;203;68;135
Skuodas d. mun.;2006;76;175;50;125
Skuodas d. mun.;2006;77;223;74;149
Skuodas d. mun.;2006;78;179;61;118
Skuodas d. mun.;2006;79;168;48;120
Skuodas d. mun.;2006;80;149;45;104
Skuodas d. mun.;2006;81;134;49;85
Skuodas d. mun.;2006;82;140;44;96
Skuodas d. mun.;2006;83;118;42;76
Skuodas d. mun.;2006;84;95;26;69
Skuodas d. mun.;2006;85;307;86;221
Skuodas d. mun.;2007;-1;22849;10904;11945
Skuodas d. mun.;2007;0;163;76;87
Skuodas d. mun.;2007;1;191;98;93
Skuodas d. mun.;2007;2;219;105;114
Skuodas d. mun.;2007;3;215;118;97
Skuodas d. mun.;2007;4;208;111;97
Skuodas d. mun.;2007;5;230;113;117
Skuodas d. mun.;2007;6;258;129;129
Skuodas d. mun.;2007;7;283;142;141
Skuodas d. mun.;2007;8;298;152;146
Skuodas d. mun.;2007;9;324;165;159
Skuodas d. mun.;2007;10;314;152;162
Skuodas d. mun.;2007;11;337;186;151
Skuodas d. mun.;2007;12;331;198;133
Skuodas d. mun.;2007;13;377;197;180
Skuodas d. mun.;2007;14;437;235;202
Skuodas d. mun.;2007;15;447;222;225
Skuodas d. mun.;2007;16;444;215;229
Skuodas d. mun.;2007;17;434;214;220
Skuodas d. mun.;2007;18;417;202;215
Skuodas d. mun.;2007;19;406;209;197
Skuodas d. mun.;2007;20;408;211;197
Skuodas d. mun.;2007;21;389;204;185
Skuodas d. mun.;2007;22;369;184;185
Skuodas d. mun.;2007;23;326;164;162
Skuodas d. mun.;2007;24;256;148;108
Skuodas d. mun.;2007;25;197;136;61
Skuodas d. mun.;2007;26;184;109;75
Skuodas d. mun.;2007;27;197;109;88
Skuodas d. mun.;2007;28;181;114;67
Skuodas d. mun.;2007;29;194;104;90
Skuodas d. mun.;2007;30;219;109;110
Skuodas d. mun.;2007;31;197;109;88
Skuodas d. mun.;2007;32;203;91;112
Skuodas d. mun.;2007;33;223;108;115
Skuodas d. mun.;2007;34;222;103;119
Skuodas d. mun.;2007;35;283;144;139
Skuodas d. mun.;2007;36;280;143;137
Skuodas d. mun.;2007;37;267;128;139
Skuodas d. mun.;2007;38;299;149;150
Skuodas d. mun.;2007;39;313;153;160
Skuodas d. mun.;2007;40;309;155;154
Skuodas d. mun.;2007;41;326;157;169
Skuodas d. mun.;2007;42;342;166;176
Skuodas d. mun.;2007;43;307;149;158
Skuodas d. mun.;2007;44;323;170;153
Skuodas d. mun.;2007;45;334;166;168
Skuodas d. mun.;2007;46;319;175;144
Skuodas d. mun.;2007;47;354;175;179
Skuodas d. mun.;2007;48;319;161;158
Skuodas d. mun.;2007;49;330;145;185
Skuodas d. mun.;2007;50;293;133;160
Skuodas d. mun.;2007;51;289;142;147
Skuodas d. mun.;2007;52;279;141;138
Skuodas d. mun.;2007;53;252;116;136
Skuodas d. mun.;2007;54;267;134;133
Skuodas d. mun.;2007;55;265;123;142
Skuodas d. mun.;2007;56;256;115;141
Skuodas d. mun.;2007;57;292;145;147
Skuodas d. mun.;2007;58;301;144;157
Skuodas d. mun.;2007;59;238;102;136
Skuodas d. mun.;2007;60;217;86;131
Skuodas d. mun.;2007;61;219;101;118
Skuodas d. mun.;2007;62;224;100;124
Skuodas d. mun.;2007;63;226;98;128
Skuodas d. mun.;2007;64;261;107;154
Skuodas d. mun.;2007;65;252;126;126
Skuodas d. mun.;2007;66;224;105;119
Skuodas d. mun.;2007;67;211;88;123
Skuodas d. mun.;2007;68;212;96;116
Skuodas d. mun.;2007;69;206;83;123
Skuodas d. mun.;2007;70;233;94;139
Skuodas d. mun.;2007;71;255;105;150
Skuodas d. mun.;2007;72;242;94;148
Skuodas d. mun.;2007;73;209;74;135
Skuodas d. mun.;2007;74;201;71;130
Skuodas d. mun.;2007;75;212;76;136
Skuodas d. mun.;2007;76;201;65;136
Skuodas d. mun.;2007;77;169;50;119
Skuodas d. mun.;2007;78;210;65;145
Skuodas d. mun.;2007;79;167;54;113
Skuodas d. mun.;2007;80;153;43;110
Skuodas d. mun.;2007;81;135;42;93
Skuodas d. mun.;2007;82;119;44;75
Skuodas d. mun.;2007;83;126;38;88
Skuodas d. mun.;2007;84;103;35;68
Skuodas d. mun.;2007;85;327;91;236
Skuodas d. mun.;2008;-1;22348;10671;11677
Skuodas d. mun.;2008;0;163;89;74
Skuodas d. mun.;2008;1;163;75;88
Skuodas d. mun.;2008;2;188;98;90
Skuodas d. mun.;2008;3;213;103;110
Skuodas d. mun.;2008;4;209;113;96
Skuodas d. mun.;2008;5;208;111;97
Skuodas d. mun.;2008;6;223;109;114
Skuodas d. mun.;2008;7;255;128;127
Skuodas d. mun.;2008;8;279;139;140
Skuodas d. mun.;2008;9;299;152;147
Skuodas d. mun.;2008;10;317;159;158
Skuodas d. mun.;2008;11;312;149;163
Skuodas d. mun.;2008;12;334;185;149
Skuodas d. mun.;2008;13;330;197;133
Skuodas d. mun.;2008;14;372;197;175
Skuodas d. mun.;2008;15;432;230;202
Skuodas d. mun.;2008;16;449;223;226
Skuodas d. mun.;2008;17;439;212;227
Skuodas d. mun.;2008;18;429;209;220
Skuodas d. mun.;2008;19;410;199;211
Skuodas d. mun.;2008;20;394;204;190
Skuodas d. mun.;2008;21;390;203;187
Skuodas d. mun.;2008;22;377;201;176
Skuodas d. mun.;2008;23;351;177;174
Skuodas d. mun.;2008;24;312;162;150
Skuodas d. mun.;2008;25;248;141;107
Skuodas d. mun.;2008;26;177;127;50
Skuodas d. mun.;2008;27;172;103;69
Skuodas d. mun.;2008;28;185;107;78
Skuodas d. mun.;2008;29;162;100;62
Skuodas d. mun.;2008;30;182;95;87
Skuodas d. mun.;2008;31;207;105;102
Skuodas d. mun.;2008;32;192;105;87
Skuodas d. mun.;2008;33;191;84;107
Skuodas d. mun.;2008;34;218;106;112
Skuodas d. mun.;2008;35;223;103;120
Skuodas d. mun.;2008;36;284;148;136
Skuodas d. mun.;2008;37;278;142;136
Skuodas d. mun.;2008;38;265;125;140
Skuodas d. mun.;2008;39;289;145;144
Skuodas d. mun.;2008;40;309;151;158
Skuodas d. mun.;2008;41;305;152;153
Skuodas d. mun.;2008;42;322;153;169
Skuodas d. mun.;2008;43;337;163;174
Skuodas d. mun.;2008;44;301;148;153
Skuodas d. mun.;2008;45;320;170;150
Skuodas d. mun.;2008;46;325;161;164
Skuodas d. mun.;2008;47;312;169;143
Skuodas d. mun.;2008;48;343;167;176
Skuodas d. mun.;2008;49;315;158;157
Skuodas d. mun.;2008;50;325;143;182
Skuodas d. mun.;2008;51;285;127;158
Skuodas d. mun.;2008;52;284;141;143
Skuodas d. mun.;2008;53;277;142;135
Skuodas d. mun.;2008;54;249;114;135
Skuodas d. mun.;2008;55;261;130;131
Skuodas d. mun.;2008;56;262;123;139
Skuodas d. mun.;2008;57;247;110;137
Skuodas d. mun.;2008;58;293;147;146
Skuodas d. mun.;2008;59;296;141;155
Skuodas d. mun.;2008;60;232;102;130
Skuodas d. mun.;2008;61;212;82;130
Skuodas d. mun.;2008;62;213;93;120
Skuodas d. mun.;2008;63;221;99;122
Skuodas d. mun.;2008;64;218;92;126
Skuodas d. mun.;2008;65;253;104;149
Skuodas d. mun.;2008;66;246;121;125
Skuodas d. mun.;2008;67;217;101;116
Skuodas d. mun.;2008;68;200;80;120
Skuodas d. mun.;2008;69;204;89;115
Skuodas d. mun.;2008;70;203;80;123
Skuodas d. mun.;2008;71;225;87;138
Skuodas d. mun.;2008;72;248;102;146
Skuodas d. mun.;2008;73;230;88;142
Skuodas d. mun.;2008;74;195;69;126
Skuodas d. mun.;2008;75;193;68;125
Skuodas d. mun.;2008;76;200;71;129
Skuodas d. mun.;2008;77;192;63;129
Skuodas d. mun.;2008;78;160;48;112
Skuodas d. mun.;2008;79;200;59;141
Skuodas d. mun.;2008;80;154;49;105
Skuodas d. mun.;2008;81;146;41;105
Skuodas d. mun.;2008;82;118;32;86
Skuodas d. mun.;2008;83;106;40;66
Skuodas d. mun.;2008;84;111;34;77
Skuodas d. mun.;2008;85;362;107;255
Skuodas d. mun.;2009;-1;21807;10427;11380
Skuodas d. mun.;2009;0;194;93;101
Skuodas d. mun.;2009;1;160;86;74
Skuodas d. mun.;2009;2;159;72;87
Skuodas d. mun.;2009;3;182;94;88
Skuodas d. mun.;2009;4;204;102;102
Skuodas d. mun.;2009;5;200;107;93
Skuodas d. mun.;2009;6;205;111;94
Skuodas d. mun.;2009;7;220;109;111
Skuodas d. mun.;2009;8;249;124;125
Skuodas d. mun.;2009;9;278;137;141
Skuodas d. mun.;2009;10;293;148;145
Skuodas d. mun.;2009;11;313;160;153
Skuodas d. mun.;2009;12;306;148;158
Skuodas d. mun.;2009;13;333;185;148
Skuodas d. mun.;2009;14;330;196;134
Skuodas d. mun.;2009;15;366;195;171
Skuodas d. mun.;2009;16;427;227;200
Skuodas d. mun.;2009;17;446;223;223
Skuodas d. mun.;2009;18;439;215;224
Skuodas d. mun.;2009;19;422;205;217
Skuodas d. mun.;2009;20;401;197;204
Skuodas d. mun.;2009;21;373;198;175
Skuodas d. mun.;2009;22;378;199;179
Skuodas d. mun.;2009;23;364;195;169
Skuodas d. mun.;2009;24;334;174;160
Skuodas d. mun.;2009;25;292;157;135
Skuodas d. mun.;2009;26;229;132;97
Skuodas d. mun.;2009;27;166;123;43
Skuodas d. mun.;2009;28;156;92;64
Skuodas d. mun.;2009;29;170;100;70
Skuodas d. mun.;2009;30;160;99;61
Skuodas d. mun.;2009;31;177;94;83
Skuodas d. mun.;2009;32;200;101;99
Skuodas d. mun.;2009;33;172;95;77
Skuodas d. mun.;2009;34;188;83;105
Skuodas d. mun.;2009;35;212;105;107
Skuodas d. mun.;2009;36;215;97;118
Skuodas d. mun.;2009;37;278;143;135
Skuodas d. mun.;2009;38;272;139;133
Skuodas d. mun.;2009;39;254;121;133
Skuodas d. mun.;2009;40;285;143;142
Skuodas d. mun.;2009;41;304;147;157
Skuodas d. mun.;2009;42;299;146;153
Skuodas d. mun.;2009;43;318;152;166
Skuodas d. mun.;2009;44;329;157;172
Skuodas d. mun.;2009;45;294;145;149
Skuodas d. mun.;2009;46;315;168;147
Skuodas d. mun.;2009;47;322;157;165
Skuodas d. mun.;2009;48;310;167;143
Skuodas d. mun.;2009;49;339;165;174
Skuodas d. mun.;2009;50;313;157;156
Skuodas d. mun.;2009;51;320;138;182
Skuodas d. mun.;2009;52;279;123;156
Skuodas d. mun.;2009;53;281;140;141
Skuodas d. mun.;2009;54;270;138;132
Skuodas d. mun.;2009;55;244;110;134
Skuodas d. mun.;2009;56;253;125;128
Skuodas d. mun.;2009;57;256;120;136
Skuodas d. mun.;2009;58;241;104;137
Skuodas d. mun.;2009;59;287;142;145
Skuodas d. mun.;2009;60;285;133;152
Skuodas d. mun.;2009;61;227;99;128
Skuodas d. mun.;2009;62;209;81;128
Skuodas d. mun.;2009;63;205;89;116
Skuodas d. mun.;2009;64;212;92;120
Skuodas d. mun.;2009;65;214;89;125
Skuodas d. mun.;2009;66;246;100;146
Skuodas d. mun.;2009;67;235;111;124
Skuodas d. mun.;2009;68;213;100;113
Skuodas d. mun.;2009;69;194;76;118
Skuodas d. mun.;2009;70;204;88;116
Skuodas d. mun.;2009;71;194;74;120
Skuodas d. mun.;2009;72;217;82;135
Skuodas d. mun.;2009;73;230;92;138
Skuodas d. mun.;2009;74;219;84;135
Skuodas d. mun.;2009;75;185;65;120
Skuodas d. mun.;2009;76;182;62;120
Skuodas d. mun.;2009;77;193;70;123
Skuodas d. mun.;2009;78;173;57;116
Skuodas d. mun.;2009;79;150;47;103
Skuodas d. mun.;2009;80;188;55;133
Skuodas d. mun.;2009;81;139;44;95
Skuodas d. mun.;2009;82;131;33;98
Skuodas d. mun.;2009;83;111;33;78
Skuodas d. mun.;2009;84;93;31;62
Skuodas d. mun.;2009;85;382;115;267
Skuodas d. mun.;2010;-1;21394;10185;11209
Skuodas d. mun.;2010;0;208;119;89
Skuodas d. mun.;2010;1;189;90;99
Skuodas d. mun.;2010;2;156;85;71
Skuodas d. mun.;2010;3;161;73;88
Skuodas d. mun.;2010;4;180;93;87
Skuodas d. mun.;2010;5;201;100;101
Skuodas d. mun.;2010;6;196;103;93
Skuodas d. mun.;2010;7;205;110;95
Skuodas d. mun.;2010;8;216;106;110
Skuodas d. mun.;2010;9;247;121;126
Skuodas d. mun.;2010;10;272;134;138
Skuodas d. mun.;2010;11;296;151;145
Skuodas d. mun.;2010;12;312;158;154
Skuodas d. mun.;2010;13;306;149;157
Skuodas d. mun.;2010;14;334;184;150
Skuodas d. mun.;2010;15;332;195;137
Skuodas d. mun.;2010;16;363;191;172
Skuodas d. mun.;2010;17;426;225;201
Skuodas d. mun.;2010;18;441;220;221
Skuodas d. mun.;2010;19;431;210;221
Skuodas d. mun.;2010;20;419;203;216
Skuodas d. mun.;2010;21;390;193;197
Skuodas d. mun.;2010;22;369;190;179
Skuodas d. mun.;2010;23;360;192;168
Skuodas d. mun.;2010;24;343;185;158
Skuodas d. mun.;2010;25;315;165;150
Skuodas d. mun.;2010;26;267;146;121
Skuodas d. mun.;2010;27;208;122;86
Skuodas d. mun.;2010;28;150;115;35
Skuodas d. mun.;2010;29;141;86;55
Skuodas d. mun.;2010;30;159;93;66
Skuodas d. mun.;2010;31;154;92;62
Skuodas d. mun.;2010;32;168;91;77
Skuodas d. mun.;2010;33;200;102;98
Skuodas d. mun.;2010;34;162;86;76
Skuodas d. mun.;2010;35;181;77;104
Skuodas d. mun.;2010;36;207;104;103
Skuodas d. mun.;2010;37;211;96;115
Skuodas d. mun.;2010;38;274;137;137
Skuodas d. mun.;2010;39;266;132;134
Skuodas d. mun.;2010;40;252;119;133
Skuodas d. mun.;2010;41;281;140;141
Skuodas d. mun.;2010;42;297;142;155
Skuodas d. mun.;2010;43;294;145;149
Skuodas d. mun.;2010;44;308;144;164
Skuodas d. mun.;2010;45;323;153;170
Skuodas d. mun.;2010;46;291;142;149
Skuodas d. mun.;2010;47;310;162;148
Skuodas d. mun.;2010;48;318;154;164
Skuodas d. mun.;2010;49;303;161;142
Skuodas d. mun.;2010;50;329;158;171
Skuodas d. mun.;2010;51;312;152;160
Skuodas d. mun.;2010;52;315;134;181
Skuodas d. mun.;2010;53;276;119;157
Skuodas d. mun.;2010;54;275;138;137
Skuodas d. mun.;2010;55;263;132;131
Skuodas d. mun.;2010;56;243;109;134
Skuodas d. mun.;2010;57;245;118;127
Skuodas d. mun.;2010;58;252;117;135
Skuodas d. mun.;2010;59;238;103;135
Skuodas d. mun.;2010;60;283;139;144
Skuodas d. mun.;2010;61;279;128;151
Skuodas d. mun.;2010;62;227;99;128
Skuodas d. mun.;2010;63;205;78;127
Skuodas d. mun.;2010;64;204;87;117
Skuodas d. mun.;2010;65;210;91;119
Skuodas d. mun.;2010;66;209;85;124
Skuodas d. mun.;2010;67;241;97;144
Skuodas d. mun.;2010;68;229;105;124
Skuodas d. mun.;2010;69;206;94;112
Skuodas d. mun.;2010;70;187;72;115
Skuodas d. mun.;2010;71;198;85;113
Skuodas d. mun.;2010;72;191;72;119
Skuodas d. mun.;2010;73;213;79;134
Skuodas d. mun.;2010;74;217;85;132
Skuodas d. mun.;2010;75;211;81;130
Skuodas d. mun.;2010;76;178;61;117
Skuodas d. mun.;2010;77;168;58;110
Skuodas d. mun.;2010;78;186;67;119
Skuodas d. mun.;2010;79;161;49;112
Skuodas d. mun.;2010;80;138;43;95
Skuodas d. mun.;2010;81;176;50;126
Skuodas d. mun.;2010;82;126;39;87
Skuodas d. mun.;2010;83;116;29;87
Skuodas d. mun.;2010;84;92;24;68
Skuodas d. mun.;2010;85;402;122;280
Skuodas d. mun.;2011;-1;20694;9838;10856
Skuodas d. mun.;2011;0;137;55;82
Skuodas d. mun.;2011;1;166;89;77
Skuodas d. mun.;2011;2;161;75;86
Skuodas d. mun.;2011;3;154;88;66
Skuodas d. mun.;2011;4;134;62;72
Skuodas d. mun.;2011;5;162;85;77
Skuodas d. mun.;2011;6;184;92;92
Skuodas d. mun.;2011;7;198;106;92
Skuodas d. mun.;2011;8;192;100;92
Skuodas d. mun.;2011;9;200;89;111
Skuodas d. mun.;2011;10;256;128;128
Skuodas d. mun.;2011;11;261;129;132
Skuodas d. mun.;2011;12;277;138;139
Skuodas d. mun.;2011;13;316;162;154
Skuodas d. mun.;2011;14;308;147;161
Skuodas d. mun.;2011;15;319;176;143
Skuodas d. mun.;2011;16;324;191;133
Skuodas d. mun.;2011;17;368;198;170
Skuodas d. mun.;2011;18;409;213;196
Skuodas d. mun.;2011;19;348;184;164
Skuodas d. mun.;2011;20;305;166;139
Skuodas d. mun.;2011;21;317;170;147
Skuodas d. mun.;2011;22;295;158;137
Skuodas d. mun.;2011;23;275;156;119
Skuodas d. mun.;2011;24;230;140;90
Skuodas d. mun.;2011;25;222;132;90
Skuodas d. mun.;2011;26;199;120;79
Skuodas d. mun.;2011;27;161;82;79
Skuodas d. mun.;2011;28;151;80;71
Skuodas d. mun.;2011;29;152;85;67
Skuodas d. mun.;2011;30;160;79;81
Skuodas d. mun.;2011;31;172;93;79
Skuodas d. mun.;2011;32;180;92;88
Skuodas d. mun.;2011;33;206;96;110
Skuodas d. mun.;2011;34;219;107;112
Skuodas d. mun.;2011;35;214;109;105
Skuodas d. mun.;2011;36;223;107;116
Skuodas d. mun.;2011;37;227;103;124
Skuodas d. mun.;2011;38;249;115;134
Skuodas d. mun.;2011;39;290;152;138
Skuodas d. mun.;2011;40;300;145;155
Skuodas d. mun.;2011;41;274;118;156
Skuodas d. mun.;2011;42;301;152;149
Skuodas d. mun.;2011;43;316;155;161
Skuodas d. mun.;2011;44;310;158;152
Skuodas d. mun.;2011;45;325;160;165
Skuodas d. mun.;2011;46;325;156;169
Skuodas d. mun.;2011;47;316;154;162
Skuodas d. mun.;2011;48;340;180;160
Skuodas d. mun.;2011;49;333;175;158
Skuodas d. mun.;2011;50;303;165;138
Skuodas d. mun.;2011;51;336;169;167
Skuodas d. mun.;2011;52;306;146;160
Skuodas d. mun.;2011;53;327;140;187
Skuodas d. mun.;2011;54;292;131;161
Skuodas d. mun.;2011;55;274;138;136
Skuodas d. mun.;2011;56;265;132;133
Skuodas d. mun.;2011;57;247;112;135
Skuodas d. mun.;2011;58;258;124;134
Skuodas d. mun.;2011;59;267;125;142
Skuodas d. mun.;2011;60;258;114;144
Skuodas d. mun.;2011;61;277;136;141
Skuodas d. mun.;2011;62;283;129;154
Skuodas d. mun.;2011;63;225;98;127
Skuodas d. mun.;2011;64;219;81;138
Skuodas d. mun.;2011;65;224;100;124
Skuodas d. mun.;2011;66;213;85;128
Skuodas d. mun.;2011;67;218;94;124
Skuodas d. mun.;2011;68;254;103;151
Skuodas d. mun.;2011;69;232;102;130
Skuodas d. mun.;2011;70;199;84;115
Skuodas d. mun.;2011;71;189;72;117
Skuodas d. mun.;2011;72;190;77;113
Skuodas d. mun.;2011;73;185;68;117
Skuodas d. mun.;2011;74;205;76;129
Skuodas d. mun.;2011;75;202;79;123
Skuodas d. mun.;2011;76;198;78;120
Skuodas d. mun.;2011;77;175;56;119
Skuodas d. mun.;2011;78;152;49;103
Skuodas d. mun.;2011;79;170;60;110
Skuodas d. mun.;2011;80;162;49;113
Skuodas d. mun.;2011;81;125;40;85
Skuodas d. mun.;2011;82;164;48;116
Skuodas d. mun.;2011;83;109;34;75
Skuodas d. mun.;2011;84;101;24;77
Skuodas d. mun.;2011;85;429;118;311
Skuodas d. mun.;2012;-1;20124;9570;10554
Skuodas d. mun.;2012;0;160;75;85
Skuodas d. mun.;2012;1;129;51;78
Skuodas d. mun.;2012;2;165;90;75
Skuodas d. mun.;2012;3;154;75;79
Skuodas d. mun.;2012;4;150;85;65
Skuodas d. mun.;2012;5;133;60;73
Skuodas d. mun.;2012;6;158;85;73
Skuodas d. mun.;2012;7;180;90;90
Skuodas d. mun.;2012;8;197;103;94
Skuodas d. mun.;2012;9;191;101;90
Skuodas d. mun.;2012;10;194;85;109
Skuodas d. mun.;2012;11;253;126;127
Skuodas d. mun.;2012;12;259;126;133
Skuodas d. mun.;2012;13;274;135;139
Skuodas d. mun.;2012;14;314;160;154
Skuodas d. mun.;2012;15;304;143;161
Skuodas d. mun.;2012;16;318;176;142
Skuodas d. mun.;2012;17;324;190;134
Skuodas d. mun.;2012;18;363;196;167
Skuodas d. mun.;2012;19;392;203;189
Skuodas d. mun.;2012;20;333;177;156
Skuodas d. mun.;2012;21;294;163;131
Skuodas d. mun.;2012;22;298;163;135
Skuodas d. mun.;2012;23;276;151;125
Skuodas d. mun.;2012;24;237;145;92
Skuodas d. mun.;2012;25;208;127;81
Skuodas d. mun.;2012;26;197;116;81
Skuodas d. mun.;2012;27;167;103;64
Skuodas d. mun.;2012;28;147;75;72
Skuodas d. mun.;2012;29;125;68;57
Skuodas d. mun.;2012;30;144;79;65
Skuodas d. mun.;2012;31;152;78;74
Skuodas d. mun.;2012;32;166;87;79
Skuodas d. mun.;2012;33;166;86;80
Skuodas d. mun.;2012;34;196;96;100
Skuodas d. mun.;2012;35;210;105;105
Skuodas d. mun.;2012;36;203;100;103
Skuodas d. mun.;2012;37;218;105;113
Skuodas d. mun.;2012;38;223;102;121
Skuodas d. mun.;2012;39;242;112;130
Skuodas d. mun.;2012;40;279;147;132
Skuodas d. mun.;2012;41;297;142;155
Skuodas d. mun.;2012;42;270;115;155
Skuodas d. mun.;2012;43;300;151;149
Skuodas d. mun.;2012;44;311;153;158
Skuodas d. mun.;2012;45;304;154;150
Skuodas d. mun.;2012;46;319;156;163
Skuodas d. mun.;2012;47;322;153;169
Skuodas d. mun.;2012;48;311;151;160
Skuodas d. mun.;2012;49;337;178;159
Skuodas d. mun.;2012;50;332;175;157
Skuodas d. mun.;2012;51;297;162;135
Skuodas d. mun.;2012;52;332;168;164
Skuodas d. mun.;2012;53;303;145;158
Skuodas d. mun.;2012;54;325;139;186
Skuodas d. mun.;2012;55;289;129;160
Skuodas d. mun.;2012;56;272;137;135
Skuodas d. mun.;2012;57;263;132;131
Skuodas d. mun.;2012;58;245;111;134
Skuodas d. mun.;2012;59;259;123;136
Skuodas d. mun.;2012;60;269;126;143
Skuodas d. mun.;2012;61;257;115;142
Skuodas d. mun.;2012;62;269;129;140
Skuodas d. mun.;2012;63;278;125;153
Skuodas d. mun.;2012;64;220;97;123
Skuodas d. mun.;2012;65;211;77;134
Skuodas d. mun.;2012;66;217;96;121
Skuodas d. mun.;2012;67;206;80;126
Skuodas d. mun.;2012;68;218;94;124
Skuodas d. mun.;2012;69;247;99;148
Skuodas d. mun.;2012;70;227;99;128
Skuodas d. mun.;2012;71;190;78;112
Skuodas d. mun.;2012;72;183;69;114
Skuodas d. mun.;2012;73;183;74;109
Skuodas d. mun.;2012;74;182;66;116
Skuodas d. mun.;2012;75;198;72;126
Skuodas d. mun.;2012;76;196;75;121
Skuodas d. mun.;2012;77;184;71;113
Skuodas d. mun.;2012;78;164;51;113
Skuodas d. mun.;2012;79;143;47;96
Skuodas d. mun.;2012;80;156;55;101
Skuodas d. mun.;2012;81;154;47;107
Skuodas d. mun.;2012;82;120;37;83
Skuodas d. mun.;2012;83;154;44;110
Skuodas d. mun.;2012;84;98;29;69
Skuodas d. mun.;2012;85;419;104;315
Skuodas d. mun.;2013;-1;19513;9292;10221
Skuodas d. mun.;2013;0;186;91;95
Skuodas d. mun.;2013;1;154;71;83
Skuodas d. mun.;2013;2;124;46;78
Skuodas d. mun.;2013;3;153;80;73
Skuodas d. mun.;2013;4;145;73;72
Skuodas d. mun.;2013;5;145;84;61
Skuodas d. mun.;2013;6;129;59;70
Skuodas d. mun.;2013;7;151;81;70
Skuodas d. mun.;2013;8;176;87;89
Skuodas d. mun.;2013;9;196;104;92
Skuodas d. mun.;2013;10;186;97;89
Skuodas d. mun.;2013;11;192;84;108
Skuodas d. mun.;2013;12;250;124;126
Skuodas d. mun.;2013;13;254;124;130
Skuodas d. mun.;2013;14;265;132;133
Skuodas d. mun.;2013;15;308;157;151
Skuodas d. mun.;2013;16;294;137;157
Skuodas d. mun.;2013;17;313;174;139
Skuodas d. mun.;2013;18;320;190;130
Skuodas d. mun.;2013;19;350;192;158
Skuodas d. mun.;2013;20;387;202;185
Skuodas d. mun.;2013;21;308;168;140
Skuodas d. mun.;2013;22;277;154;123
Skuodas d. mun.;2013;23;284;154;130
Skuodas d. mun.;2013;24;251;144;107
Skuodas d. mun.;2013;25;214;131;83
Skuodas d. mun.;2013;26;172;114;58
Skuodas d. mun.;2013;27;158;101;57
Skuodas d. mun.;2013;28;135;90;45
Skuodas d. mun.;2013;29;140;74;66
Skuodas d. mun.;2013;30;117;64;53
Skuodas d. mun.;2013;31;128;72;56
Skuodas d. mun.;2013;32;146;76;70
Skuodas d. mun.;2013;33;152;77;75
Skuodas d. mun.;2013;34;163;79;84
Skuodas d. mun.;2013;35;191;94;97
Skuodas d. mun.;2013;36;193;97;96
Skuodas d. mun.;2013;37;197;95;102
Skuodas d. mun.;2013;38;214;103;111
Skuodas d. mun.;2013;39;218;100;118
Skuodas d. mun.;2013;40;241;113;128
Skuodas d. mun.;2013;41;267;142;125
Skuodas d. mun.;2013;42;284;136;148
Skuodas d. mun.;2013;43;268;112;156
Skuodas d. mun.;2013;44;295;149;146
Skuodas d. mun.;2013;45;303;147;156
Skuodas d. mun.;2013;46;304;153;151
Skuodas d. mun.;2013;47;314;151;163
Skuodas d. mun.;2013;48;322;155;167
Skuodas d. mun.;2013;49;305;150;155
Skuodas d. mun.;2013;50;338;180;158
Skuodas d. mun.;2013;51;331;174;157
Skuodas d. mun.;2013;52;290;158;132
Skuodas d. mun.;2013;53;321;163;158
Skuodas d. mun.;2013;54;302;145;157
Skuodas d. mun.;2013;55;318;135;183
Skuodas d. mun.;2013;56;284;126;158
Skuodas d. mun.;2013;57;267;134;133
Skuodas d. mun.;2013;58;255;126;129
Skuodas d. mun.;2013;59;240;108;132
Skuodas d. mun.;2013;60;261;123;138
Skuodas d. mun.;2013;61;260;117;143
Skuodas d. mun.;2013;62;248;107;141
Skuodas d. mun.;2013;63;265;127;138
Skuodas d. mun.;2013;64;272;123;149
Skuodas d. mun.;2013;65;212;94;118
Skuodas d. mun.;2013;66;207;73;134
Skuodas d. mun.;2013;67;216;93;123
Skuodas d. mun.;2013;68;199;78;121
Skuodas d. mun.;2013;69;216;91;125
Skuodas d. mun.;2013;70;244;98;146
Skuodas d. mun.;2013;71;219;94;125
Skuodas d. mun.;2013;72;180;74;106
Skuodas d. mun.;2013;73;181;69;112
Skuodas d. mun.;2013;74;174;70;104
Skuodas d. mun.;2013;75;169;59;110
Skuodas d. mun.;2013;76;189;69;120
Skuodas d. mun.;2013;77;191;71;120
Skuodas d. mun.;2013;78;166;58;108
Skuodas d. mun.;2013;79;143;41;102
Skuodas d. mun.;2013;80;136;45;91
Skuodas d. mun.;2013;81;146;50;96
Skuodas d. mun.;2013;82;145;44;101
Skuodas d. mun.;2013;83;114;36;78
Skuodas d. mun.;2013;84;141;39;102
Skuodas d. mun.;2013;85;434;116;318
Skuodas d. mun.;2014;-1;18908;9010;9898
Skuodas d. mun.;2014;0;157;68;89
Skuodas d. mun.;2014;1;170;86;84
Skuodas d. mun.;2014;2;153;73;80
Skuodas d. mun.;2014;3;122;45;77
Skuodas d. mun.;2014;4;154;82;72
Skuodas d. mun.;2014;5;141;71;70
Skuodas d. mun.;2014;6;142;81;61
Skuodas d. mun.;2014;7;127;58;69
Skuodas d. mun.;2014;8;148;80;68
Skuodas d. mun.;2014;9;175;85;90
Skuodas d. mun.;2014;10;192;102;90
Skuodas d. mun.;2014;11;184;96;88
Skuodas d. mun.;2014;12;193;85;108
Skuodas d. mun.;2014;13;243;121;122
Skuodas d. mun.;2014;14;251;123;128
Skuodas d. mun.;2014;15;259;128;131
Skuodas d. mun.;2014;16;299;152;147
Skuodas d. mun.;2014;17;292;137;155
Skuodas d. mun.;2014;18;304;172;132
Skuodas d. mun.;2014;19;308;184;124
Skuodas d. mun.;2014;20;338;184;154
Skuodas d. mun.;2014;21;375;197;178
Skuodas d. mun.;2014;22;297;165;132
Skuodas d. mun.;2014;23;251;149;102
Skuodas d. mun.;2014;24;271;147;124
Skuodas d. mun.;2014;25;227;133;94
Skuodas d. mun.;2014;26;197;122;75
Skuodas d. mun.;2014;27;151;106;45
Skuodas d. mun.;2014;28;137;87;50
Skuodas d. mun.;2014;29;121;81;40
Skuodas d. mun.;2014;30;123;64;59
Skuodas d. mun.;2014;31;106;59;47
Skuodas d. mun.;2014;32;116;63;53
Skuodas d. mun.;2014;33;140;78;62
Skuodas d. mun.;2014;34;144;73;71
Skuodas d. mun.;2014;35;158;76;82
Skuodas d. mun.;2014;36;185;90;95
Skuodas d. mun.;2014;37;185;92;93
Skuodas d. mun.;2014;38;189;90;99
Skuodas d. mun.;2014;39;211;103;108
Skuodas d. mun.;2014;40;210;96;114
Skuodas d. mun.;2014;41;236;111;125
Skuodas d. mun.;2014;42;262;141;121
Skuodas d. mun.;2014;43;280;133;147
Skuodas d. mun.;2014;44;270;115;155
Skuodas d. mun.;2014;45;286;141;145
Skuodas d. mun.;2014;46;290;137;153
Skuodas d. mun.;2014;47;305;156;149
Skuodas d. mun.;2014;48;307;146;161
Skuodas d. mun.;2014;49;315;152;163
Skuodas d. mun.;2014;50;301;149;152
Skuodas d. mun.;2014;51;336;181;155
Skuodas d. mun.;2014;52;322;170;152
Skuodas d. mun.;2014;53;289;159;130
Skuodas d. mun.;2014;54;316;162;154
Skuodas d. mun.;2014;55;296;141;155
Skuodas d. mun.;2014;56;313;133;180
Skuodas d. mun.;2014;57;284;126;158
Skuodas d. mun.;2014;58;263;132;131
Skuodas d. mun.;2014;59;249;121;128
Skuodas d. mun.;2014;60;231;102;129
Skuodas d. mun.;2014;61;256;120;136
Skuodas d. mun.;2014;62;250;110;140
Skuodas d. mun.;2014;63;246;105;141
Skuodas d. mun.;2014;64;262;125;137
Skuodas d. mun.;2014;65;264;116;148
Skuodas d. mun.;2014;66;204;89;115
Skuodas d. mun.;2014;67;203;73;130
Skuodas d. mun.;2014;68;205;86;119
Skuodas d. mun.;2014;69;191;74;117
Skuodas d. mun.;2014;70;209;85;124
Skuodas d. mun.;2014;71;239;96;143
Skuodas d. mun.;2014;72;208;88;120
Skuodas d. mun.;2014;73;171;70;101
Skuodas d. mun.;2014;74;173;63;110
Skuodas d. mun.;2014;75;166;67;99
Skuodas d. mun.;2014;76;157;50;107
Skuodas d. mun.;2014;77;173;60;113
Skuodas d. mun.;2014;78;185;67;118
Skuodas d. mun.;2014;79;155;54;101
Skuodas d. mun.;2014;80;135;38;97
Skuodas d. mun.;2014;81;129;44;85
Skuodas d. mun.;2014;82;129;43;86
Skuodas d. mun.;2014;83;134;39;95
Skuodas d. mun.;2014;84;105;35;70
Skuodas d. mun.;2014;85;462;121;341
Skuodas d. mun.;2015;-1;18498;8792;9706
Skuodas d. mun.;2015;0;166;78;88
Skuodas d. mun.;2015;1;155;67;88
Skuodas d. mun.;2015;2;164;80;84
Skuodas d. mun.;2015;3;147;70;77
Skuodas d. mun.;2015;4;122;45;77
Skuodas d. mun.;2015;5;153;81;72
Skuodas d. mun.;2015;6;145;69;76
Skuodas d. mun.;2015;7;142;80;62
Skuodas d. mun.;2015;8;128;57;71
Skuodas d. mun.;2015;9;147;80;67
Skuodas d. mun.;2015;10;176;86;90
Skuodas d. mun.;2015;11;192;102;90
Skuodas d. mun.;2015;12;181;95;86
Skuodas d. mun.;2015;13;192;84;108
Skuodas d. mun.;2015;14;243;121;122
Skuodas d. mun.;2015;15;249;124;125
Skuodas d. mun.;2015;16;255;126;129
Skuodas d. mun.;2015;17;294;149;145
Skuodas d. mun.;2015;18;291;138;153
Skuodas d. mun.;2015;19;298;172;126
Skuodas d. mun.;2015;20;299;179;120
Skuodas d. mun.;2015;21;324;177;147
Skuodas d. mun.;2015;22;368;192;176
Skuodas d. mun.;2015;23;282;160;122
Skuodas d. mun.;2015;24;223;140;83
Skuodas d. mun.;2015;25;254;143;111
Skuodas d. mun.;2015;26;193;115;78
Skuodas d. mun.;2015;27;179;117;62
Skuodas d. mun.;2015;28;137;102;35
Skuodas d. mun.;2015;29;118;70;48
Skuodas d. mun.;2015;30;109;71;38
Skuodas d. mun.;2015;31;114;58;56
Skuodas d. mun.;2015;32;96;48;48
Skuodas d. mun.;2015;33;109;55;54
Skuodas d. mun.;2015;34;140;75;65
Skuodas d. mun.;2015;35;139;69;70
Skuodas d. mun.;2015;36;152;70;82
Skuodas d. mun.;2015;37;181;89;92
Skuodas d. mun.;2015;38;183;92;91
Skuodas d. mun.;2015;39;188;91;97
Skuodas d. mun.;2015;40;208;104;104
Skuodas d. mun.;2015;41;204;94;110
Skuodas d. mun.;2015;42;227;111;116
Skuodas d. mun.;2015;43;259;137;122
Skuodas d. mun.;2015;44;275;131;144
Skuodas d. mun.;2015;45;268;113;155
Skuodas d. mun.;2015;46;285;140;145
Skuodas d. mun.;2015;47;285;134;151
Skuodas d. mun.;2015;48;304;156;148
Skuodas d. mun.;2015;49;302;143;159
Skuodas d. mun.;2015;50;315;152;163
Skuodas d. mun.;2015;51;298;150;148
Skuodas d. mun.;2015;52;330;175;155
Skuodas d. mun.;2015;53;323;170;153
Skuodas d. mun.;2015;54;283;157;126
Skuodas d. mun.;2015;55;316;161;155
Skuodas d. mun.;2015;56;291;136;155
Skuodas d. mun.;2015;57;306;131;175
Skuodas d. mun.;2015;58;281;125;156
Skuodas d. mun.;2015;59;262;131;131
Skuodas d. mun.;2015;60;247;120;127
Skuodas d. mun.;2015;61;229;101;128
Skuodas d. mun.;2015;62;254;118;136
Skuodas d. mun.;2015;63;246;108;138
Skuodas d. mun.;2015;64;245;103;142
Skuodas d. mun.;2015;65;256;122;134
Skuodas d. mun.;2015;66;253;110;143
Skuodas d. mun.;2015;67;195;83;112
Skuodas d. mun.;2015;68;202;71;131
Skuodas d. mun.;2015;69;198;82;116
Skuodas d. mun.;2015;70;183;71;112
Skuodas d. mun.;2015;71;202;80;122
Skuodas d. mun.;2015;72;234;95;139
Skuodas d. mun.;2015;73;205;84;121
Skuodas d. mun.;2015;74;169;70;99
Skuodas d. mun.;2015;75;170;60;110
Skuodas d. mun.;2015;76;159;62;97
Skuodas d. mun.;2015;77;145;45;100
Skuodas d. mun.;2015;78;163;53;110
Skuodas d. mun.;2015;79;171;62;109
Skuodas d. mun.;2015;80;149;49;100
Skuodas d. mun.;2015;81;128;33;95
Skuodas d. mun.;2015;82;120;39;81
Skuodas d. mun.;2015;83;121;38;83
Skuodas d. mun.;2015;84;123;32;91
Skuodas d. mun.;2015;85;481;133;348
Skuodas d. mun.;2016;-1;18057;8564;9493
Skuodas d. mun.;2016;0;214;99;115
Skuodas d. mun.;2016;1;158;74;84
Skuodas d. mun.;2016;2;154;67;87
Skuodas d. mun.;2016;3;158;77;81
Skuodas d. mun.;2016;4;148;71;77
Skuodas d. mun.;2016;5;120;45;75
Skuodas d. mun.;2016;6;147;78;69
Skuodas d. mun.;2016;7;148;68;80
Skuodas d. mun.;2016;8;139;81;58
Skuodas d. mun.;2016;9;130;59;71
Skuodas d. mun.;2016;10;145;77;68
Skuodas d. mun.;2016;11;175;87;88
Skuodas d. mun.;2016;12;185;98;87
Skuodas d. mun.;2016;13;179;95;84
Skuodas d. mun.;2016;14;191;83;108
Skuodas d. mun.;2016;15;240;119;121
Skuodas d. mun.;2016;16;246;122;124
Skuodas d. mun.;2016;17;253;125;128
Skuodas d. mun.;2016;18;294;150;144
Skuodas d. mun.;2016;19;282;134;148
Skuodas d. mun.;2016;20;297;171;126
Skuodas d. mun.;2016;21;284;168;116
Skuodas d. mun.;2016;22;309;170;139
Skuodas d. mun.;2016;23;348;180;168
Skuodas d. mun.;2016;24;270;158;112
Skuodas d. mun.;2016;25;207;126;81
Skuodas d. mun.;2016;26;227;133;94
Skuodas d. mun.;2016;27;185;108;77
Skuodas d. mun.;2016;28;166;114;52
Skuodas d. mun.;2016;29;120;94;26
Skuodas d. mun.;2016;30;107;63;44
Skuodas d. mun.;2016;31;97;62;35
Skuodas d. mun.;2016;32;102;57;45
Skuodas d. mun.;2016;33;85;43;42
Skuodas d. mun.;2016;34;99;48;51
Skuodas d. mun.;2016;35;132;69;63
Skuodas d. mun.;2016;36;134;67;67
Skuodas d. mun.;2016;37;142;62;80
Skuodas d. mun.;2016;38;172;83;89
Skuodas d. mun.;2016;39;179;91;88
Skuodas d. mun.;2016;40;179;87;92
Skuodas d. mun.;2016;41;203;102;101
Skuodas d. mun.;2016;42;200;92;108
Skuodas d. mun.;2016;43;225;111;114
Skuodas d. mun.;2016;44;260;135;125
Skuodas d. mun.;2016;45;275;129;146
Skuodas d. mun.;2016;46;269;113;156
Skuodas d. mun.;2016;47;283;139;144
Skuodas d. mun.;2016;48;287;135;152
Skuodas d. mun.;2016;49;306;159;147
Skuodas d. mun.;2016;50;296;136;160
Skuodas d. mun.;2016;51;308;148;160
Skuodas d. mun.;2016;52;295;148;147
Skuodas d. mun.;2016;53;324;173;151
Skuodas d. mun.;2016;54;318;166;152
Skuodas d. mun.;2016;55;281;155;126
Skuodas d. mun.;2016;56;311;158;153
Skuodas d. mun.;2016;57;286;131;155
Skuodas d. mun.;2016;58;303;129;174
Skuodas d. mun.;2016;59;275;123;152
Skuodas d. mun.;2016;60;261;130;131
Skuodas d. mun.;2016;61;244;117;127
Skuodas d. mun.;2016;62;225;98;127
Skuodas d. mun.;2016;63;250;114;136
Skuodas d. mun.;2016;64;240;104;136
Skuodas d. mun.;2016;65;239;97;142
Skuodas d. mun.;2016;66;252;118;134
Skuodas d. mun.;2016;67;250;107;143
Skuodas d. mun.;2016;68;190;81;109
Skuodas d. mun.;2016;69;199;69;130
Skuodas d. mun.;2016;70;188;74;114
Skuodas d. mun.;2016;71;176;67;109
Skuodas d. mun.;2016;72;194;74;120
Skuodas d. mun.;2016;73;229;90;139
Skuodas d. mun.;2016;74;196;81;115
Skuodas d. mun.;2016;75;161;66;95
Skuodas d. mun.;2016;76;163;54;109
Skuodas d. mun.;2016;77;149;55;94
Skuodas d. mun.;2016;78;137;43;94
Skuodas d. mun.;2016;79;151;49;102
Skuodas d. mun.;2016;80;149;57;92
Skuodas d. mun.;2016;81;143;49;94
Skuodas d. mun.;2016;82;117;30;87
Skuodas d. mun.;2016;83;107;30;77
Skuodas d. mun.;2016;84;111;32;79
Skuodas d. mun.;2016;85;484;133;351
Skuodas d. mun.;2017;-1;17557;8330;9227
Skuodas d. mun.;2017;0;192;96;96
Skuodas d. mun.;2017;1;204;92;112
Skuodas d. mun.;2017;2;162;75;87
Skuodas d. mun.;2017;3;148;66;82
Skuodas d. mun.;2017;4;160;79;81
Skuodas d. mun.;2017;5;143;68;75
Skuodas d. mun.;2017;6;117;41;76
Skuodas d. mun.;2017;7;145;76;69
Skuodas d. mun.;2017;8;150;70;80
Skuodas d. mun.;2017;9;136;80;56
Skuodas d. mun.;2017;10;130;59;71
Skuodas d. mun.;2017;11;144;77;67
Skuodas d. mun.;2017;12;175;88;87
Skuodas d. mun.;2017;13;185;99;86
Skuodas d. mun.;2017;14;179;95;84
Skuodas d. mun.;2017;15;189;83;106
Skuodas d. mun.;2017;16;240;119;121
Skuodas d. mun.;2017;17;246;122;124
Skuodas d. mun.;2017;18;250;122;128
Skuodas d. mun.;2017;19;286;148;138
Skuodas d. mun.;2017;20;273;132;141
Skuodas d. mun.;2017;21;292;168;124
Skuodas d. mun.;2017;22;279;165;114
Skuodas d. mun.;2017;23;290;163;127
Skuodas d. mun.;2017;24;317;167;150
Skuodas d. mun.;2017;25;227;135;92
Skuodas d. mun.;2017;26;169;108;61
Skuodas d. mun.;2017;27;197;117;80
Skuodas d. mun.;2017;28;163;99;64
Skuodas d. mun.;2017;29;137;100;37
Skuodas d. mun.;2017;30;104;88;16
Skuodas d. mun.;2017;31;84;55;29
Skuodas d. mun.;2017;32;75;47;28
Skuodas d. mun.;2017;33;91;51;40
Skuodas d. mun.;2017;34;78;39;39
Skuodas d. mun.;2017;35;93;48;45
Skuodas d. mun.;2017;36;125;62;63
Skuodas d. mun.;2017;37;127;67;60
Skuodas d. mun.;2017;38;141;62;79
Skuodas d. mun.;2017;39;173;83;90
Skuodas d. mun.;2017;40;180;90;90
Skuodas d. mun.;2017;41;179;86;93
Skuodas d. mun.;2017;42;198;97;101
Skuodas d. mun.;2017;43;193;86;107
Skuodas d. mun.;2017;44;220;108;112
Skuodas d. mun.;2017;45;256;132;124
Skuodas d. mun.;2017;46;275;127;148
Skuodas d. mun.;2017;47;265;110;155
Skuodas d. mun.;2017;48;280;139;141
Skuodas d. mun.;2017;49;284;134;150
Skuodas d. mun.;2017;50;300;156;144
Skuodas d. mun.;2017;51;287;133;154
Skuodas d. mun.;2017;52;302;144;158
Skuodas d. mun.;2017;53;290;146;144
Skuodas d. mun.;2017;54;323;174;149
Skuodas d. mun.;2017;55;314;163;151
Skuodas d. mun.;2017;56;277;152;125
Skuodas d. mun.;2017;57;308;153;155
Skuodas d. mun.;2017;58;287;131;156
Skuodas d. mun.;2017;59;298;127;171
Skuodas d. mun.;2017;60;271;123;148
Skuodas d. mun.;2017;61;257;128;129
Skuodas d. mun.;2017;62;246;117;129
Skuodas d. mun.;2017;63;223;97;126
Skuodas d. mun.;2017;64;246;112;134
Skuodas d. mun.;2017;65;237;101;136
Skuodas d. mun.;2017;66;235;93;142
Skuodas d. mun.;2017;67;246;115;131
Skuodas d. mun.;2017;68;245;105;140
Skuodas d. mun.;2017;69;186;78;108
Skuodas d. mun.;2017;70;199;69;130
Skuodas d. mun.;2017;71;188;74;114
Skuodas d. mun.;2017;72;173;65;108
Skuodas d. mun.;2017;73;192;73;119
Skuodas d. mun.;2017;74;222;87;135
Skuodas d. mun.;2017;75;186;76;110
Skuodas d. mun.;2017;76;155;64;91
Skuodas d. mun.;2017;77;155;47;108
Skuodas d. mun.;2017;78;139;49;90
Skuodas d. mun.;2017;79;131;41;90
Skuodas d. mun.;2017;80;148;48;100
Skuodas d. mun.;2017;81;139;52;87
Skuodas d. mun.;2017;82;129;43;86
Skuodas d. mun.;2017;83;108;26;82
Skuodas d. mun.;2017;84;95;25;70
Skuodas d. mun.;2017;85;474;123;351
Skuodas d. mun.;2018;-1;16914;8027;8887
Skuodas d. mun.;2018;0;155;81;74
Skuodas d. mun.;2018;1;187;90;97
Skuodas d. mun.;2018;2;190;86;104
Skuodas d. mun.;2018;3;161;71;90
Skuodas d. mun.;2018;4;150;66;84
Skuodas d. mun.;2018;5;159;76;83
Skuodas d. mun.;2018;6;143;68;75
Skuodas d. mun.;2018;7;113;40;73
Skuodas d. mun.;2018;8;146;77;69
Skuodas d. mun.;2018;9;150;72;78
Skuodas d. mun.;2018;10;136;80;56
Skuodas d. mun.;2018;11;128;56;72
Skuodas d. mun.;2018;12;144;77;67
Skuodas d. mun.;2018;13;171;88;83
Skuodas d. mun.;2018;14;183;97;86
Skuodas d. mun.;2018;15;178;94;84
Skuodas d. mun.;2018;16;185;82;103
Skuodas d. mun.;2018;17;239;119;120
Skuodas d. mun.;2018;18;238;119;119
Skuodas d. mun.;2018;19;245;119;126
Skuodas d. mun.;2018;20;278;142;136
Skuodas d. mun.;2018;21;261;131;130
Skuodas d. mun.;2018;22;269;158;111
Skuodas d. mun.;2018;23;248;151;97
Skuodas d. mun.;2018;24;267;155;112
Skuodas d. mun.;2018;25;279;151;128
Skuodas d. mun.;2018;26;199;121;78
Skuodas d. mun.;2018;27;137;92;45
Skuodas d. mun.;2018;28;167;103;64
Skuodas d. mun.;2018;29;140;87;53
Skuodas d. mun.;2018;30;112;90;22
Skuodas d. mun.;2018;31;87;75;12
Skuodas d. mun.;2018;32;66;43;23
Skuodas d. mun.;2018;33;69;44;25
Skuodas d. mun.;2018;34;81;44;37
Skuodas d. mun.;2018;35;68;35;33
Skuodas d. mun.;2018;36;86;40;46
Skuodas d. mun.;2018;37;119;57;62
Skuodas d. mun.;2018;38;117;61;56
Skuodas d. mun.;2018;39;131;57;74
Skuodas d. mun.;2018;40;164;78;86
Skuodas d. mun.;2018;41;176;85;91
Skuodas d. mun.;2018;42;175;84;91
Skuodas d. mun.;2018;43;192;95;97
Skuodas d. mun.;2018;44;187;84;103
Skuodas d. mun.;2018;45;213;106;107
Skuodas d. mun.;2018;46;252;129;123
Skuodas d. mun.;2018;47;269;126;143
Skuodas d. mun.;2018;48;263;110;153
Skuodas d. mun.;2018;49;279;139;140
Skuodas d. mun.;2018;50;281;134;147
Skuodas d. mun.;2018;51;292;151;141
Skuodas d. mun.;2018;52;283;131;152
Skuodas d. mun.;2018;53;298;140;158
Skuodas d. mun.;2018;54;284;140;144
Skuodas d. mun.;2018;55;320;172;148
Skuodas d. mun.;2018;56;310;159;151
Skuodas d. mun.;2018;57;272;150;122
Skuodas d. mun.;2018;58;301;150;151
Skuodas d. mun.;2018;59;284;129;155
Skuodas d. mun.;2018;60;294;123;171
Skuodas d. mun.;2018;61;271;122;149
Skuodas d. mun.;2018;62;253;126;127
Skuodas d. mun.;2018;63;242;115;127
Skuodas d. mun.;2018;64;219;95;124
Skuodas d. mun.;2018;65;242;111;131
Skuodas d. mun.;2018;66;231;98;133
Skuodas d. mun.;2018;67;228;91;137
Skuodas d. mun.;2018;68;238;110;128
Skuodas d. mun.;2018;69;235;98;137
Skuodas d. mun.;2018;70;182;78;104
Skuodas d. mun.;2018;71;191;63;128
Skuodas d. mun.;2018;72;183;73;110
Skuodas d. mun.;2018;73;170;63;107
Skuodas d. mun.;2018;74;185;71;114
Skuodas d. mun.;2018;75;213;80;133
Skuodas d. mun.;2018;76;181;72;109
Skuodas d. mun.;2018;77;144;55;89
Skuodas d. mun.;2018;78;145;43;102
Skuodas d. mun.;2018;79;131;45;86
Skuodas d. mun.;2018;80;125;39;86
Skuodas d. mun.;2018;81;137;42;95
Skuodas d. mun.;2018;82;128;46;82
Skuodas d. mun.;2018;83;116;39;77
Skuodas d. mun.;2018;84;97;24;73
Skuodas d. mun.;2018;85;456;118;338
Švenčionys d. mun.;2001;-1;33221;15503;17718
Švenčionys d. mun.;2001;0;264;138;126
Švenčionys d. mun.;2001;1;327;173;154
Švenčionys d. mun.;2001;2;292;152;140
Švenčionys d. mun.;2001;3;321;169;152
Švenčionys d. mun.;2001;4;324;153;171
Švenčionys d. mun.;2001;5;347;162;185
Švenčionys d. mun.;2001;6;358;171;187
Švenčionys d. mun.;2001;7;393;176;217
Švenčionys d. mun.;2001;8;449;217;232
Švenčionys d. mun.;2001;9;449;222;227
Švenčionys d. mun.;2001;10;462;238;224
Švenčionys d. mun.;2001;11;447;236;211
Švenčionys d. mun.;2001;12;540;292;248
Švenčionys d. mun.;2001;13;530;275;255
Švenčionys d. mun.;2001;14;578;295;283
Švenčionys d. mun.;2001;15;493;272;221
Švenčionys d. mun.;2001;16;519;267;252
Švenčionys d. mun.;2001;17;509;264;245
Švenčionys d. mun.;2001;18;431;220;211
Švenčionys d. mun.;2001;19;402;236;166
Švenčionys d. mun.;2001;20;328;165;163
Švenčionys d. mun.;2001;21;353;175;178
Švenčionys d. mun.;2001;22;391;217;174
Švenčionys d. mun.;2001;23;373;205;168
Švenčionys d. mun.;2001;24;392;198;194
Švenčionys d. mun.;2001;25;388;207;181
Švenčionys d. mun.;2001;26;367;184;183
Švenčionys d. mun.;2001;27;409;206;203
Švenčionys d. mun.;2001;28;402;210;192
Švenčionys d. mun.;2001;29;434;215;219
Švenčionys d. mun.;2001;30;446;222;224
Švenčionys d. mun.;2001;31;407;221;186
Švenčionys d. mun.;2001;32;398;199;199
Švenčionys d. mun.;2001;33;388;197;191
Švenčionys d. mun.;2001;34;432;216;216
Švenčionys d. mun.;2001;35;455;225;230
Švenčionys d. mun.;2001;36;450;255;195
Švenčionys d. mun.;2001;37;468;226;242
Švenčionys d. mun.;2001;38;467;236;231
Švenčionys d. mun.;2001;39;493;246;247
Švenčionys d. mun.;2001;40;505;253;252
Švenčionys d. mun.;2001;41;486;248;238
Švenčionys d. mun.;2001;42;482;245;237
Švenčionys d. mun.;2001;43;445;217;228
Švenčionys d. mun.;2001;44;413;226;187
Švenčionys d. mun.;2001;45;402;208;194
Švenčionys d. mun.;2001;46;420;209;211
Švenčionys d. mun.;2001;47;345;177;168
Švenčionys d. mun.;2001;48;397;206;191
Švenčionys d. mun.;2001;49;416;217;199
Švenčionys d. mun.;2001;50;408;186;222
Švenčionys d. mun.;2001;51;460;229;231
Švenčionys d. mun.;2001;52;418;181;237
Švenčionys d. mun.;2001;53;323;152;171
Švenčionys d. mun.;2001;54;311;149;162
Švenčionys d. mun.;2001;55;342;170;172
Švenčionys d. mun.;2001;56;348;169;179
Švenčionys d. mun.;2001;57;371;163;208
Švenčionys d. mun.;2001;58;404;188;216
Švenčionys d. mun.;2001;59;396;169;227
Švenčionys d. mun.;2001;60;389;171;218
Švenčionys d. mun.;2001;61;367;127;240
Švenčionys d. mun.;2001;62;408;168;240
Švenčionys d. mun.;2001;63;359;157;202
Švenčionys d. mun.;2001;64;377;152;225
Švenčionys d. mun.;2001;65;435;195;240
Švenčionys d. mun.;2001;66;375;152;223
Švenčionys d. mun.;2001;67;408;167;241
Švenčionys d. mun.;2001;68;435;140;295
Švenčionys d. mun.;2001;69;430;147;283
Švenčionys d. mun.;2001;70;440;178;262
Švenčionys d. mun.;2001;71;401;150;251
Švenčionys d. mun.;2001;72;395;138;257
Švenčionys d. mun.;2001;73;373;128;245
Švenčionys d. mun.;2001;74;374;122;252
Švenčionys d. mun.;2001;75;368;116;252
Švenčionys d. mun.;2001;76;300;80;220
Švenčionys d. mun.;2001;77;291;79;212
Švenčionys d. mun.;2001;78;237;62;175
Švenčionys d. mun.;2001;79;224;60;164
Švenčionys d. mun.;2001;80;183;47;136
Švenčionys d. mun.;2001;81;130;44;86
Švenčionys d. mun.;2001;82;86;27;59
Švenčionys d. mun.;2001;83;74;18;56
Švenčionys d. mun.;2001;84;68;17;51
Švenčionys d. mun.;2001;85;526;146;380
Švenčionys d. mun.;2002;-1;32812;15308;17504
Švenčionys d. mun.;2002;0;280;150;130
Švenčionys d. mun.;2002;1;266;141;125
Švenčionys d. mun.;2002;2;326;171;155
Švenčionys d. mun.;2002;3;290;149;141
Švenčionys d. mun.;2002;4;319;169;150
Švenčionys d. mun.;2002;5;323;154;169
Švenčionys d. mun.;2002;6;346;162;184
Švenčionys d. mun.;2002;7;356;171;185
Švenčionys d. mun.;2002;8;390;173;217
Švenčionys d. mun.;2002;9;447;215;232
Švenčionys d. mun.;2002;10;448;222;226
Švenčionys d. mun.;2002;11;455;236;219
Švenčionys d. mun.;2002;12;442;233;209
Švenčionys d. mun.;2002;13;530;286;244
Švenčionys d. mun.;2002;14;525;272;253
Švenčionys d. mun.;2002;15;570;288;282
Švenčionys d. mun.;2002;16;483;268;215
Švenčionys d. mun.;2002;17;509;259;250
Švenčionys d. mun.;2002;18;501;262;239
Švenčionys d. mun.;2002;19;416;211;205
Švenčionys d. mun.;2002;20;397;234;163
Švenčionys d. mun.;2002;21;316;158;158
Švenčionys d. mun.;2002;22;345;170;175
Švenčionys d. mun.;2002;23;382;214;168
Švenčionys d. mun.;2002;24;364;197;167
Švenčionys d. mun.;2002;25;387;196;191
Švenčionys d. mun.;2002;26;381;204;177
Švenčionys d. mun.;2002;27;363;181;182
Švenčionys d. mun.;2002;28;402;201;201
Švenčionys d. mun.;2002;29;397;205;192
Švenčionys d. mun.;2002;30;421;208;213
Švenčionys d. mun.;2002;31;435;215;220
Švenčionys d. mun.;2002;32;392;210;182
Švenčionys d. mun.;2002;33;388;192;196
Švenčionys d. mun.;2002;34;387;198;189
Švenčionys d. mun.;2002;35;424;211;213
Švenčionys d. mun.;2002;36;449;224;225
Švenčionys d. mun.;2002;37;445;253;192
Švenčionys d. mun.;2002;38;464;224;240
Švenčionys d. mun.;2002;39;457;230;227
Švenčionys d. mun.;2002;40;482;239;243
Švenčionys d. mun.;2002;41;508;254;254
Švenčionys d. mun.;2002;42;475;243;232
Švenčionys d. mun.;2002;43;479;244;235
Švenčionys d. mun.;2002;44;439;214;225
Švenčionys d. mun.;2002;45;406;222;184
Švenčionys d. mun.;2002;46;398;206;192
Švenčionys d. mun.;2002;47;422;209;213
Švenčionys d. mun.;2002;48;342;176;166
Švenčionys d. mun.;2002;49;390;202;188
Švenčionys d. mun.;2002;50;413;213;200
Švenčionys d. mun.;2002;51;396;181;215
Švenčionys d. mun.;2002;52;458;226;232
Švenčionys d. mun.;2002;53;411;178;233
Švenčionys d. mun.;2002;54;317;148;169
Švenčionys d. mun.;2002;55;300;139;161
Švenčionys d. mun.;2002;56;331;162;169
Švenčionys d. mun.;2002;57;345;167;178
Švenčionys d. mun.;2002;58;354;155;199
Švenčionys d. mun.;2002;59;390;179;211
Švenčionys d. mun.;2002;60;390;166;224
Švenčionys d. mun.;2002;61;385;170;215
Švenčionys d. mun.;2002;62;367;125;242
Švenčionys d. mun.;2002;63;404;165;239
Švenčionys d. mun.;2002;64;358;156;202
Švenčionys d. mun.;2002;65;367;147;220
Švenčionys d. mun.;2002;66;433;195;238
Švenčionys d. mun.;2002;67;368;149;219
Švenčionys d. mun.;2002;68;404;165;239
Švenčionys d. mun.;2002;69;431;135;296
Švenčionys d. mun.;2002;70;426;147;279
Švenčionys d. mun.;2002;71;423;166;257
Švenčionys d. mun.;2002;72;391;145;246
Švenčionys d. mun.;2002;73;380;133;247
Švenčionys d. mun.;2002;74;368;122;246
Švenčionys d. mun.;2002;75;362;117;245
Švenčionys d. mun.;2002;76;353;112;241
Švenčionys d. mun.;2002;77;277;73;204
Švenčionys d. mun.;2002;78;281;76;205
Švenčionys d. mun.;2002;79;229;59;170
Švenčionys d. mun.;2002;80;215;56;159
Švenčionys d. mun.;2002;81;174;43;131
Švenčionys d. mun.;2002;82;120;43;77
Švenčionys d. mun.;2002;83;75;23;52
Švenčionys d. mun.;2002;84;67;15;52
Švenčionys d. mun.;2002;85;490;131;359
Švenčionys d. mun.;2003;-1;32428;15105;17323
Švenčionys d. mun.;2003;0;253;125;128
Švenčionys d. mun.;2003;1;278;148;130
Švenčionys d. mun.;2003;2;262;139;123
Švenčionys d. mun.;2003;3;325;170;155
Švenčionys d. mun.;2003;4;288;148;140
Švenčionys d. mun.;2003;5;316;167;149
Švenčionys d. mun.;2003;6;319;152;167
Švenčionys d. mun.;2003;7;346;162;184
Švenčionys d. mun.;2003;8;353;171;182
Švenčionys d. mun.;2003;9;391;175;216
Švenčionys d. mun.;2003;10;443;214;229
Švenčionys d. mun.;2003;11;442;219;223
Švenčionys d. mun.;2003;12;448;230;218
Švenčionys d. mun.;2003;13;436;228;208
Švenčionys d. mun.;2003;14;520;280;240
Švenčionys d. mun.;2003;15;517;266;251
Švenčionys d. mun.;2003;16;567;285;282
Švenčionys d. mun.;2003;17;473;262;211
Švenčionys d. mun.;2003;18;498;255;243
Švenčionys d. mun.;2003;19;495;257;238
Švenčionys d. mun.;2003;20;409;207;202
Švenčionys d. mun.;2003;21;390;229;161
Švenčionys d. mun.;2003;22;318;158;160
Švenčionys d. mun.;2003;23;337;168;169
Švenčionys d. mun.;2003;24;372;212;160
Švenčionys d. mun.;2003;25;360;196;164
Švenčionys d. mun.;2003;26;387;198;189
Švenčionys d. mun.;2003;27;373;196;177
Švenčionys d. mun.;2003;28;350;173;177
Švenčionys d. mun.;2003;29;399;200;199
Švenčionys d. mun.;2003;30;386;200;186
Švenčionys d. mun.;2003;31;414;204;210
Švenčionys d. mun.;2003;32;426;211;215
Švenčionys d. mun.;2003;33;387;206;181
Švenčionys d. mun.;2003;34;386;193;193
Švenčionys d. mun.;2003;35;384;195;189
Švenčionys d. mun.;2003;36;419;209;210
Švenčionys d. mun.;2003;37;448;224;224
Švenčionys d. mun.;2003;38;439;249;190
Švenčionys d. mun.;2003;39;455;218;237
Švenčionys d. mun.;2003;40;453;229;224
Švenčionys d. mun.;2003;41;478;235;243
Švenčionys d. mun.;2003;42;498;247;251
Švenčionys d. mun.;2003;43;475;241;234
Švenčionys d. mun.;2003;44;475;242;233
Švenčionys d. mun.;2003;45;437;213;224
Švenčionys d. mun.;2003;46;400;218;182
Švenčionys d. mun.;2003;47;397;208;189
Švenčionys d. mun.;2003;48;414;203;211
Švenčionys d. mun.;2003;49;341;175;166
Švenčionys d. mun.;2003;50;387;200;187
Švenčionys d. mun.;2003;51;410;213;197
Švenčionys d. mun.;2003;52;391;179;212
Švenčionys d. mun.;2003;53;456;225;231
Švenčionys d. mun.;2003;54;408;175;233
Švenčionys d. mun.;2003;55;312;145;167
Švenčionys d. mun.;2003;56;305;144;161
Švenčionys d. mun.;2003;57;324;156;168
Švenčionys d. mun.;2003;58;341;164;177
Švenčionys d. mun.;2003;59;355;154;201
Švenčionys d. mun.;2003;60;384;176;208
Švenčionys d. mun.;2003;61;382;161;221
Švenčionys d. mun.;2003;62;369;159;210
Švenčionys d. mun.;2003;63;357;122;235
Švenčionys d. mun.;2003;64;401;161;240
Švenčionys d. mun.;2003;65;361;157;204
Švenčionys d. mun.;2003;66;360;142;218
Švenčionys d. mun.;2003;67;423;187;236
Švenčionys d. mun.;2003;68;364;145;219
Švenčionys d. mun.;2003;69;396;159;237
Švenčionys d. mun.;2003;70;417;126;291
Švenčionys d. mun.;2003;71;416;141;275
Švenčionys d. mun.;2003;72;409;157;252
Švenčionys d. mun.;2003;73;371;129;242
Švenčionys d. mun.;2003;74;361;124;237
Švenčionys d. mun.;2003;75;353;120;233
Švenčionys d. mun.;2003;76;354;113;241
Švenčionys d. mun.;2003;77;339;104;235
Švenčionys d. mun.;2003;78;264;68;196
Švenčionys d. mun.;2003;79;264;74;190
Švenčionys d. mun.;2003;80;214;55;159
Švenčionys d. mun.;2003;81;206;52;154
Švenčionys d. mun.;2003;82;159;37;122
Švenčionys d. mun.;2003;83;113;39;74
Švenčionys d. mun.;2003;84;72;25;47
Švenčionys d. mun.;2003;85;453;107;346
Švenčionys d. mun.;2004;-1;32002;14894;17108
Švenčionys d. mun.;2004;0;239;134;105
Švenčionys d. mun.;2004;1;253;124;129
Švenčionys d. mun.;2004;2;279;149;130
Švenčionys d. mun.;2004;3;260;139;121
Švenčionys d. mun.;2004;4;323;171;152
Švenčionys d. mun.;2004;5;283;144;139
Švenčionys d. mun.;2004;6;315;166;149
Švenčionys d. mun.;2004;7;315;151;164
Švenčionys d. mun.;2004;8;342;161;181
Švenčionys d. mun.;2004;9;349;171;178
Švenčionys d. mun.;2004;10;387;171;216
Švenčionys d. mun.;2004;11;443;214;229
Švenčionys d. mun.;2004;12;439;219;220
Švenčionys d. mun.;2004;13;440;226;214
Švenčionys d. mun.;2004;14;426;223;203
Švenčionys d. mun.;2004;15;516;277;239
Švenčionys d. mun.;2004;16;510;263;247
Švenčionys d. mun.;2004;17;558;280;278
Švenčionys d. mun.;2004;18;464;256;208
Švenčionys d. mun.;2004;19;485;249;236
Švenčionys d. mun.;2004;20;484;251;233
Švenčionys d. mun.;2004;21;406;207;199
Švenčionys d. mun.;2004;22;380;224;156
Švenčionys d. mun.;2004;23;318;153;165
Švenčionys d. mun.;2004;24;334;164;170
Švenčionys d. mun.;2004;25;358;203;155
Švenčionys d. mun.;2004;26;358;196;162
Švenčionys d. mun.;2004;27;373;193;180
Švenčionys d. mun.;2004;28;376;199;177
Švenčionys d. mun.;2004;29;342;169;173
Švenčionys d. mun.;2004;30;398;199;199
Švenčionys d. mun.;2004;31;384;195;189
Švenčionys d. mun.;2004;32;403;197;206
Švenčionys d. mun.;2004;33;424;214;210
Švenčionys d. mun.;2004;34;380;201;179
Švenčionys d. mun.;2004;35;383;192;191
Švenčionys d. mun.;2004;36;378;194;184
Švenčionys d. mun.;2004;37;414;205;209
Švenčionys d. mun.;2004;38;438;218;220
Švenčionys d. mun.;2004;39;432;246;186
Švenčionys d. mun.;2004;40;453;219;234
Švenčionys d. mun.;2004;41;449;226;223
Švenčionys d. mun.;2004;42;477;234;243
Švenčionys d. mun.;2004;43;497;245;252
Švenčionys d. mun.;2004;44;472;242;230
Švenčionys d. mun.;2004;45;476;245;231
Švenčionys d. mun.;2004;46;429;209;220
Švenčionys d. mun.;2004;47;399;215;184
Švenčionys d. mun.;2004;48;396;205;191
Švenčionys d. mun.;2004;49;412;203;209
Švenčionys d. mun.;2004;50;336;173;163
Švenčionys d. mun.;2004;51;383;200;183
Švenčionys d. mun.;2004;52;406;212;194
Švenčionys d. mun.;2004;53;385;174;211
Švenčionys d. mun.;2004;54;452;225;227
Švenčionys d. mun.;2004;55;405;170;235
Švenčionys d. mun.;2004;56;312;143;169
Švenčionys d. mun.;2004;57;294;136;158
Švenčionys d. mun.;2004;58;320;152;168
Švenčionys d. mun.;2004;59;337;163;174
Švenčionys d. mun.;2004;60;352;152;200
Švenčionys d. mun.;2004;61;377;169;208
Švenčionys d. mun.;2004;62;372;154;218
Švenčionys d. mun.;2004;63;356;148;208
Švenčionys d. mun.;2004;64;347;118;229
Švenčionys d. mun.;2004;65;396;153;243
Švenčionys d. mun.;2004;66;354;151;203
Švenčionys d. mun.;2004;67;351;135;216
Švenčionys d. mun.;2004;68;410;179;231
Švenčionys d. mun.;2004;69;358;140;218
Švenčionys d. mun.;2004;70;383;151;232
Švenčionys d. mun.;2004;71;403;117;286
Švenčionys d. mun.;2004;72;400;136;264
Švenčionys d. mun.;2004;73;396;144;252
Švenčionys d. mun.;2004;74;361;124;237
Švenčionys d. mun.;2004;75;357;118;239
Švenčionys d. mun.;2004;76;330;110;220
Švenčionys d. mun.;2004;77;334;104;230
Švenčionys d. mun.;2004;78;327;98;229
Švenčionys d. mun.;2004;79;241;62;179
Švenčionys d. mun.;2004;80;243;66;177
Švenčionys d. mun.;2004;81;199;50;149
Švenčionys d. mun.;2004;82;178;40;138
Švenčionys d. mun.;2004;83;138;31;107
Švenčionys d. mun.;2004;84;97;33;64
Švenčionys d. mun.;2004;85;463;112;351
Švenčionys d. mun.;2005;-1;31436;14635;16801
Švenčionys d. mun.;2005;0;250;130;120
Švenčionys d. mun.;2005;1;229;129;100
Švenčionys d. mun.;2005;2;251;123;128
Švenčionys d. mun.;2005;3;277;148;129
Švenčionys d. mun.;2005;4;257;139;118
Švenčionys d. mun.;2005;5;319;168;151
Švenčionys d. mun.;2005;6;279;141;138
Švenčionys d. mun.;2005;7;315;168;147
Švenčionys d. mun.;2005;8;313;150;163
Švenčionys d. mun.;2005;9;343;161;182
Švenčionys d. mun.;2005;10;346;170;176
Švenčionys d. mun.;2005;11;385;167;218
Švenčionys d. mun.;2005;12;438;212;226
Švenčionys d. mun.;2005;13;435;215;220
Švenčionys d. mun.;2005;14;436;225;211
Švenčionys d. mun.;2005;15;421;219;202
Švenčionys d. mun.;2005;16;514;275;239
Švenčionys d. mun.;2005;17;502;261;241
Švenčionys d. mun.;2005;18;545;274;271
Švenčionys d. mun.;2005;19;460;255;205
Švenčionys d. mun.;2005;20;474;243;231
Švenčionys d. mun.;2005;21;470;247;223
Švenčionys d. mun.;2005;22;391;199;192
Švenčionys d. mun.;2005;23;365;216;149
Švenčionys d. mun.;2005;24;316;149;167
Švenčionys d. mun.;2005;25;327;161;166
Švenčionys d. mun.;2005;26;344;196;148
Švenčionys d. mun.;2005;27;346;187;159
Švenčionys d. mun.;2005;28;363;189;174
Švenčionys d. mun.;2005;29;369;196;173
Švenčionys d. mun.;2005;30;333;165;168
Švenčionys d. mun.;2005;31;387;194;193
Švenčionys d. mun.;2005;32;371;188;183
Švenčionys d. mun.;2005;33;397;192;205
Švenčionys d. mun.;2005;34;415;207;208
Švenčionys d. mun.;2005;35;370;197;173
Švenčionys d. mun.;2005;36;371;185;186
Švenčionys d. mun.;2005;37;373;189;184
Švenčionys d. mun.;2005;38;409;203;206
Švenčionys d. mun.;2005;39;433;217;216
Švenčionys d. mun.;2005;40;425;240;185
Švenčionys d. mun.;2005;41;450;217;233
Švenčionys d. mun.;2005;42;447;223;224
Švenčionys d. mun.;2005;43;468;231;237
Švenčionys d. mun.;2005;44;493;244;249
Švenčionys d. mun.;2005;45;465;237;228
Švenčionys d. mun.;2005;46;471;242;229
Švenčionys d. mun.;2005;47;425;207;218
Švenčionys d. mun.;2005;48;393;212;181
Švenčionys d. mun.;2005;49;394;205;189
Švenčionys d. mun.;2005;50;406;197;209
Švenčionys d. mun.;2005;51;322;163;159
Švenčionys d. mun.;2005;52;381;198;183
Švenčionys d. mun.;2005;53;395;206;189
Švenčionys d. mun.;2005;54;380;173;207
Švenčionys d. mun.;2005;55;449;225;224
Švenčionys d. mun.;2005;56;400;166;234
Švenčionys d. mun.;2005;57;312;145;167
Švenčionys d. mun.;2005;58;297;136;161
Švenčionys d. mun.;2005;59;316;151;165
Švenčionys d. mun.;2005;60;333;160;173
Švenčionys d. mun.;2005;61;345;146;199
Švenčionys d. mun.;2005;62;363;160;203
Švenčionys d. mun.;2005;63;363;147;216
Švenčionys d. mun.;2005;64;351;143;208
Švenčionys d. mun.;2005;65;341;113;228
Švenčionys d. mun.;2005;66;381;143;238
Švenčionys d. mun.;2005;67;342;140;202
Švenčionys d. mun.;2005;68;339;127;212
Švenčionys d. mun.;2005;69;395;167;228
Švenčionys d. mun.;2005;70;349;133;216
Švenčionys d. mun.;2005;71;368;144;224
Švenčionys d. mun.;2005;72;389;114;275
Švenčionys d. mun.;2005;73;377;120;257
Švenčionys d. mun.;2005;74;380;135;245
Švenčionys d. mun.;2005;75;344;118;226
Švenčionys d. mun.;2005;76;341;115;226
Švenčionys d. mun.;2005;77;310;103;207
Švenčionys d. mun.;2005;78;316;94;222
Švenčionys d. mun.;2005;79;302;89;213
Švenčionys d. mun.;2005;80;221;54;167
Švenčionys d. mun.;2005;81;220;59;161
Švenčionys d. mun.;2005;82;179;46;133
Švenčionys d. mun.;2005;83;163;37;126
Švenčionys d. mun.;2005;84;124;24;100
Švenčionys d. mun.;2005;85;472;136;336
Švenčionys d. mun.;2006;-1;30690;14281;16409
Švenčionys d. mun.;2006;0;222;118;104
Švenčionys d. mun.;2006;1;247;127;120
Švenčionys d. mun.;2006;2;231;129;102
Švenčionys d. mun.;2006;3;248;121;127
Švenčionys d. mun.;2006;4;274;147;127
Švenčionys d. mun.;2006;5;257;137;120
Švenčionys d. mun.;2006;6;315;169;146
Švenčionys d. mun.;2006;7;277;139;138
Švenčionys d. mun.;2006;8;316;170;146
Švenčionys d. mun.;2006;9;315;150;165
Švenčionys d. mun.;2006;10;340;160;180
Švenčionys d. mun.;2006;11;350;173;177
Švenčionys d. mun.;2006;12;386;169;217
Švenčionys d. mun.;2006;13;434;207;227
Švenčionys d. mun.;2006;14;433;216;217
Švenčionys d. mun.;2006;15;427;222;205
Švenčionys d. mun.;2006;16;418;214;204
Švenčionys d. mun.;2006;17;502;268;234
Švenčionys d. mun.;2006;18;491;255;236
Švenčionys d. mun.;2006;19;519;259;260
Švenčionys d. mun.;2006;20;444;244;200
Švenčionys d. mun.;2006;21;447;229;218
Švenčionys d. mun.;2006;22;452;240;212
Švenčionys d. mun.;2006;23;369;186;183
Švenčionys d. mun.;2006;24;344;204;140
Švenčionys d. mun.;2006;25;298;141;157
Švenčionys d. mun.;2006;26;310;152;158
Švenčionys d. mun.;2006;27;329;189;140
Švenčionys d. mun.;2006;28;339;183;156
Švenčionys d. mun.;2006;29;343;177;166
Švenčionys d. mun.;2006;30;366;194;172
Švenčionys d. mun.;2006;31;322;162;160
Švenčionys d. mun.;2006;32;374;191;183
Švenčionys d. mun.;2006;33;361;183;178
Švenčionys d. mun.;2006;34;387;184;203
Švenčionys d. mun.;2006;35;407;204;203
Švenčionys d. mun.;2006;36;351;187;164
Švenčionys d. mun.;2006;37;357;177;180
Švenčionys d. mun.;2006;38;366;190;176
Švenčionys d. mun.;2006;39;404;200;204
Švenčionys d. mun.;2006;40;426;211;215
Švenčionys d. mun.;2006;41;410;227;183
Švenčionys d. mun.;2006;42;443;211;232
Švenčionys d. mun.;2006;43;441;218;223
Švenčionys d. mun.;2006;44;458;226;232
Švenčionys d. mun.;2006;45;490;245;245
Švenčionys d. mun.;2006;46;456;232;224
Švenčionys d. mun.;2006;47;466;240;226
Švenčionys d. mun.;2006;48;418;204;214
Švenčionys d. mun.;2006;49;383;204;179
Švenčionys d. mun.;2006;50;387;200;187
Švenčionys d. mun.;2006;51;406;195;211
Švenčionys d. mun.;2006;52;318;160;158
Švenčionys d. mun.;2006;53;366;190;176
Švenčionys d. mun.;2006;54;386;202;184
Švenčionys d. mun.;2006;55;374;171;203
Švenčionys d. mun.;2006;56;445;217;228
Švenčionys d. mun.;2006;57;397;164;233
Švenčionys d. mun.;2006;58;312;147;165
Švenčionys d. mun.;2006;59;292;132;160
Švenčionys d. mun.;2006;60;311;148;163
Švenčionys d. mun.;2006;61;325;154;171
Švenčionys d. mun.;2006;62;335;141;194
Švenčionys d. mun.;2006;63;354;155;199
Švenčionys d. mun.;2006;64;353;139;214
Švenčionys d. mun.;2006;65;337;134;203
Švenčionys d. mun.;2006;66;341;113;228
Švenčionys d. mun.;2006;67;374;141;233
Švenčionys d. mun.;2006;68;327;133;194
Švenčionys d. mun.;2006;69;335;126;209
Švenčionys d. mun.;2006;70;384;160;224
Švenčionys d. mun.;2006;71;337;126;211
Švenčionys d. mun.;2006;72;352;137;215
Švenčionys d. mun.;2006;73;369;106;263
Švenčionys d. mun.;2006;74;366;112;254
Švenčionys d. mun.;2006;75;360;122;238
Švenčionys d. mun.;2006;76;329;109;220
Švenčionys d. mun.;2006;77;321;105;216
Švenčionys d. mun.;2006;78;297;100;197
Švenčionys d. mun.;2006;79;300;90;210
Švenčionys d. mun.;2006;80;281;80;201
Švenčionys d. mun.;2006;81;204;46;158
Švenčionys d. mun.;2006;82;198;51;147
Švenčionys d. mun.;2006;83;149;37;112
Švenčionys d. mun.;2006;84;142;29;113
Švenčionys d. mun.;2006;85;463;124;339
Švenčionys d. mun.;2007;-1;30148;14006;16142
Švenčionys d. mun.;2007;0;242;121;121
Švenčionys d. mun.;2007;1;223;118;105
Švenčionys d. mun.;2007;2;246;126;120
Švenčionys d. mun.;2007;3;233;131;102
Švenčionys d. mun.;2007;4;247;122;125
Švenčionys d. mun.;2007;5;270;147;123
Švenčionys d. mun.;2007;6;261;142;119
Švenčionys d. mun.;2007;7;314;169;145
Švenčionys d. mun.;2007;8;274;137;137
Švenčionys d. mun.;2007;9;311;167;144
Švenčionys d. mun.;2007;10;315;151;164
Švenčionys d. mun.;2007;11;337;158;179
Švenčionys d. mun.;2007;12;350;172;178
Švenčionys d. mun.;2007;13;387;171;216
Švenčionys d. mun.;2007;14;432;208;224
Švenčionys d. mun.;2007;15;431;213;218
Švenčionys d. mun.;2007;16;422;222;200
Švenčionys d. mun.;2007;17;413;212;201
Švenčionys d. mun.;2007;18;495;265;230
Švenčionys d. mun.;2007;19;469;244;225
Švenčionys d. mun.;2007;20;500;246;254
Švenčionys d. mun.;2007;21;433;237;196
Švenčionys d. mun.;2007;22;435;221;214
Švenčionys d. mun.;2007;23;437;231;206
Švenčionys d. mun.;2007;24;358;181;177
Švenčionys d. mun.;2007;25;329;197;132
Švenčionys d. mun.;2007;26;291;138;153
Švenčionys d. mun.;2007;27;294;143;151
Švenčionys d. mun.;2007;28;316;183;133
Švenčionys d. mun.;2007;29;323;172;151
Švenčionys d. mun.;2007;30;335;172;163
Švenčionys d. mun.;2007;31;356;190;166
Švenčionys d. mun.;2007;32;319;161;158
Švenčionys d. mun.;2007;33;366;185;181
Švenčionys d. mun.;2007;34;362;185;177
Švenčionys d. mun.;2007;35;380;180;200
Švenčionys d. mun.;2007;36;404;201;203
Švenčionys d. mun.;2007;37;350;185;165
Švenčionys d. mun.;2007;38;355;175;180
Švenčionys d. mun.;2007;39;356;181;175
Švenčionys d. mun.;2007;40;395;196;199
Švenčionys d. mun.;2007;41;420;209;211
Švenčionys d. mun.;2007;42;407;224;183
Švenčionys d. mun.;2007;43;437;207;230
Švenčionys d. mun.;2007;44;432;213;219
Švenčionys d. mun.;2007;45;450;221;229
Švenčionys d. mun.;2007;46;489;245;244
Švenčionys d. mun.;2007;47;455;230;225
Švenčionys d. mun.;2007;48;461;236;225
Švenčionys d. mun.;2007;49;415;200;215
Švenčionys d. mun.;2007;50;380;203;177
Švenčionys d. mun.;2007;51;380;196;184
Švenčionys d. mun.;2007;52;404;196;208
Švenčionys d. mun.;2007;53;310;154;156
Švenčionys d. mun.;2007;54;360;183;177
Švenčionys d. mun.;2007;55;383;200;183
Švenčionys d. mun.;2007;56;372;170;202
Švenčionys d. mun.;2007;57;442;211;231
Švenčionys d. mun.;2007;58;400;165;235
Švenčionys d. mun.;2007;59;311;144;167
Švenčionys d. mun.;2007;60;287;126;161
Švenčionys d. mun.;2007;61;311;146;165
Švenčionys d. mun.;2007;62;320;152;168
Švenčionys d. mun.;2007;63;327;136;191
Švenčionys d. mun.;2007;64;346;149;197
Švenčionys d. mun.;2007;65;343;134;209
Švenčionys d. mun.;2007;66;325;128;197
Švenčionys d. mun.;2007;67;333;106;227
Švenčionys d. mun.;2007;68;367;135;232
Švenčionys d. mun.;2007;69;317;127;190
Švenčionys d. mun.;2007;70;322;115;207
Švenčionys d. mun.;2007;71;374;155;219
Švenčionys d. mun.;2007;72;327;119;208
Švenčionys d. mun.;2007;73;340;128;212
Švenčionys d. mun.;2007;74;351;96;255
Švenčionys d. mun.;2007;75;348;103;245
Švenčionys d. mun.;2007;76;341;115;226
Švenčionys d. mun.;2007;77;304;98;206
Švenčionys d. mun.;2007;78;301;97;204
Švenčionys d. mun.;2007;79;270;88;182
Švenčionys d. mun.;2007;80;285;81;204
Švenčionys d. mun.;2007;81;253;73;180
Švenčionys d. mun.;2007;82;183;38;145
Švenčionys d. mun.;2007;83;180;45;135
Švenčionys d. mun.;2007;84;134;32;102
Švenčionys d. mun.;2007;85;485;121;364
Švenčionys d. mun.;2008;-1;29613;13767;15846
Švenčionys d. mun.;2008;0;238;137;101
Švenčionys d. mun.;2008;1;237;117;120
Švenčionys d. mun.;2008;2;225;120;105
Švenčionys d. mun.;2008;3;247;127;120
Švenčionys d. mun.;2008;4;233;131;102
Švenčionys d. mun.;2008;5;244;122;122
Švenčionys d. mun.;2008;6;272;148;124
Švenčionys d. mun.;2008;7;266;141;125
Švenčionys d. mun.;2008;8;317;172;145
Švenčionys d. mun.;2008;9;269;133;136
Švenčionys d. mun.;2008;10;307;164;143
Švenčionys d. mun.;2008;11;314;152;162
Švenčionys d. mun.;2008;12;331;157;174
Švenčionys d. mun.;2008;13;353;174;179
Švenčionys d. mun.;2008;14;387;170;217
Švenčionys d. mun.;2008;15;429;207;222
Švenčionys d. mun.;2008;16;429;211;218
Švenčionys d. mun.;2008;17;431;229;202
Švenčionys d. mun.;2008;18;411;210;201
Švenčionys d. mun.;2008;19;486;260;226
Švenčionys d. mun.;2008;20;464;242;222
Švenčionys d. mun.;2008;21;494;244;250
Švenčionys d. mun.;2008;22;423;232;191
Švenčionys d. mun.;2008;23;424;214;210
Švenčionys d. mun.;2008;24;425;225;200
Švenčionys d. mun.;2008;25;345;174;171
Švenčionys d. mun.;2008;26;315;189;126
Švenčionys d. mun.;2008;27;271;129;142
Švenčionys d. mun.;2008;28;283;138;145
Švenčionys d. mun.;2008;29;304;177;127
Švenčionys d. mun.;2008;30;316;172;144
Švenčionys d. mun.;2008;31;325;169;156
Švenčionys d. mun.;2008;32;345;183;162
Švenčionys d. mun.;2008;33;316;159;157
Švenčionys d. mun.;2008;34;363;180;183
Švenčionys d. mun.;2008;35;357;179;178
Švenčionys d. mun.;2008;36;374;176;198
Švenčionys d. mun.;2008;37;399;198;201
Švenčionys d. mun.;2008;38;353;187;166
Švenčionys d. mun.;2008;39;352;175;177
Švenčionys d. mun.;2008;40;354;178;176
Švenčionys d. mun.;2008;41;390;194;196
Švenčionys d. mun.;2008;42;412;204;208
Švenčionys d. mun.;2008;43;394;216;178
Švenčionys d. mun.;2008;44;433;203;230
Švenčionys d. mun.;2008;45;421;206;215
Švenčionys d. mun.;2008;46;446;221;225
Švenčionys d. mun.;2008;47;480;239;241
Švenčionys d. mun.;2008;48;447;224;223
Švenčionys d. mun.;2008;49;457;234;223
Švenčionys d. mun.;2008;50;416;200;216
Švenčionys d. mun.;2008;51;374;197;177
Švenčionys d. mun.;2008;52;380;192;188
Švenčionys d. mun.;2008;53;399;195;204
Švenčionys d. mun.;2008;54;307;153;154
Švenčionys d. mun.;2008;55;352;177;175
Švenčionys d. mun.;2008;56;379;199;180
Švenčionys d. mun.;2008;57;370;168;202
Švenčionys d. mun.;2008;58;430;200;230
Švenčionys d. mun.;2008;59;392;160;232
Švenčionys d. mun.;2008;60;306;138;168
Švenčionys d. mun.;2008;61;280;122;158
Švenčionys d. mun.;2008;62;305;141;164
Švenčionys d. mun.;2008;63;314;148;166
Švenčionys d. mun.;2008;64;320;131;189
Švenčionys d. mun.;2008;65;336;141;195
Švenčionys d. mun.;2008;66;331;127;204
Švenčionys d. mun.;2008;67;316;121;195
Švenčionys d. mun.;2008;68;325;102;223
Švenčionys d. mun.;2008;69;357;127;230
Švenčionys d. mun.;2008;70;307;120;187
Švenčionys d. mun.;2008;71;309;108;201
Švenčionys d. mun.;2008;72;356;142;214
Švenčionys d. mun.;2008;73;320;118;202
Švenčionys d. mun.;2008;74;328;124;204
Švenčionys d. mun.;2008;75;336;91;245
Švenčionys d. mun.;2008;76;337;100;237
Švenčionys d. mun.;2008;77;316;105;211
Švenčionys d. mun.;2008;78;284;86;198
Švenčionys d. mun.;2008;79;273;84;189
Švenčionys d. mun.;2008;80;244;75;169
Švenčionys d. mun.;2008;81;262;70;192
Švenčionys d. mun.;2008;82;235;62;173
Švenčionys d. mun.;2008;83;163;36;127
Švenčionys d. mun.;2008;84;155;43;112
Švenčionys d. mun.;2008;85;491;121;370
Švenčionys d. mun.;2009;-1;29218;13634;15584
Švenčionys d. mun.;2009;0;231;126;105
Švenčionys d. mun.;2009;1;231;133;98
Švenčionys d. mun.;2009;2;236;116;120
Švenčionys d. mun.;2009;3;223;119;104
Švenčionys d. mun.;2009;4;251;127;124
Švenčionys d. mun.;2009;5;234;131;103
Švenčionys d. mun.;2009;6;248;125;123
Švenčionys d. mun.;2009;7;273;149;124
Švenčionys d. mun.;2009;8;272;149;123
Švenčionys d. mun.;2009;9;317;172;145
Švenčionys d. mun.;2009;10;270;132;138
Švenčionys d. mun.;2009;11;311;164;147
Švenčionys d. mun.;2009;12;314;151;163
Švenčionys d. mun.;2009;13;331;157;174
Švenčionys d. mun.;2009;14;350;171;179
Švenčionys d. mun.;2009;15;390;173;217
Švenčionys d. mun.;2009;16;428;206;222
Švenčionys d. mun.;2009;17;423;211;212
Švenčionys d. mun.;2009;18;432;232;200
Švenčionys d. mun.;2009;19;398;206;192
Švenčionys d. mun.;2009;20;476;255;221
Švenčionys d. mun.;2009;21;461;242;219
Švenčionys d. mun.;2009;22;484;243;241
Švenčionys d. mun.;2009;23;417;229;188
Švenčionys d. mun.;2009;24;419;213;206
Švenčionys d. mun.;2009;25;409;220;189
Švenčionys d. mun.;2009;26;324;167;157
Švenčionys d. mun.;2009;27;307;184;123
Švenčionys d. mun.;2009;28;264;129;135
Švenčionys d. mun.;2009;29;273;134;139
Švenčionys d. mun.;2009;30;290;170;120
Švenčionys d. mun.;2009;31;312;171;141
Švenčionys d. mun.;2009;32;318;168;150
Švenčionys d. mun.;2009;33;348;180;168
Švenčionys d. mun.;2009;34;316;163;153
Švenčionys d. mun.;2009;35;360;179;181
Švenčionys d. mun.;2009;36;356;180;176
Švenčionys d. mun.;2009;37;367;174;193
Švenčionys d. mun.;2009;38;402;202;200
Švenčionys d. mun.;2009;39;350;186;164
Švenčionys d. mun.;2009;40;356;176;180
Švenčionys d. mun.;2009;41;355;181;174
Švenčionys d. mun.;2009;42;383;189;194
Švenčionys d. mun.;2009;43;415;206;209
Švenčionys d. mun.;2009;44;386;213;173
Švenčionys d. mun.;2009;45;433;203;230
Švenčionys d. mun.;2009;46;418;205;213
Švenčionys d. mun.;2009;47;442;219;223
Švenčionys d. mun.;2009;48;481;242;239
Švenčionys d. mun.;2009;49;442;220;222
Švenčionys d. mun.;2009;50;458;233;225
Švenčionys d. mun.;2009;51;416;199;217
Švenčionys d. mun.;2009;52;363;194;169
Švenčionys d. mun.;2009;53;375;189;186
Švenčionys d. mun.;2009;54;401;195;206
Švenčionys d. mun.;2009;55;302;148;154
Švenčionys d. mun.;2009;56;345;171;174
Švenčionys d. mun.;2009;57;369;193;176
Švenčionys d. mun.;2009;58;358;160;198
Švenčionys d. mun.;2009;59;414;188;226
Švenčionys d. mun.;2009;60;380;154;226
Švenčionys d. mun.;2009;61;300;134;166
Švenčionys d. mun.;2009;62;275;117;158
Švenčionys d. mun.;2009;63;299;134;165
Švenčionys d. mun.;2009;64;306;142;164
Švenčionys d. mun.;2009;65;316;129;187
Švenčionys d. mun.;2009;66;325;132;193
Švenčionys d. mun.;2009;67;321;125;196
Švenčionys d. mun.;2009;68;307;118;189
Švenčionys d. mun.;2009;69;314;99;215
Švenčionys d. mun.;2009;70;347;121;226
Švenčionys d. mun.;2009;71;301;116;185
Švenčionys d. mun.;2009;72;300;106;194
Švenčionys d. mun.;2009;73;338;133;205
Švenčionys d. mun.;2009;74;306;111;195
Švenčionys d. mun.;2009;75;317;117;200
Švenčionys d. mun.;2009;76;310;82;228
Švenčionys d. mun.;2009;77;322;94;228
Švenčionys d. mun.;2009;78;296;93;203
Švenčionys d. mun.;2009;79;272;80;192
Švenčionys d. mun.;2009;80;247;74;173
Švenčionys d. mun.;2009;81;226;68;158
Švenčionys d. mun.;2009;82;243;59;184
Švenčionys d. mun.;2009;83;219;56;163
Švenčionys d. mun.;2009;84;150;32;118
Švenčionys d. mun.;2009;85;553;145;408
Švenčionys d. mun.;2010;-1;28690;13414;15276
Švenčionys d. mun.;2010;0;240;113;127
Švenčionys d. mun.;2010;1;229;124;105
Švenčionys d. mun.;2010;2;228;132;96
Švenčionys d. mun.;2010;3;230;115;115
Švenčionys d. mun.;2010;4;222;118;104
Švenčionys d. mun.;2010;5;251;127;124
Švenčionys d. mun.;2010;6;235;132;103
Švenčionys d. mun.;2010;7;244;124;120
Švenčionys d. mun.;2010;8;272;150;122
Švenčionys d. mun.;2010;9;273;149;124
Švenčionys d. mun.;2010;10;316;172;144
Švenčionys d. mun.;2010;11;272;134;138
Švenčionys d. mun.;2010;12;310;161;149
Švenčionys d. mun.;2010;13;317;153;164
Švenčionys d. mun.;2010;14;333;161;172
Švenčionys d. mun.;2010;15;358;177;181
Švenčionys d. mun.;2010;16;390;172;218
Švenčionys d. mun.;2010;17;432;209;223
Švenčionys d. mun.;2010;18;416;209;207
Švenčionys d. mun.;2010;19;423;227;196
Švenčionys d. mun.;2010;20;388;202;186
Švenčionys d. mun.;2010;21;463;250;213
Švenčionys d. mun.;2010;22;441;235;206
Švenčionys d. mun.;2010;23;470;240;230
Švenčionys d. mun.;2010;24;403;220;183
Švenčionys d. mun.;2010;25;401;205;196
Švenčionys d. mun.;2010;26;388;213;175
Švenčionys d. mun.;2010;27;315;161;154
Švenčionys d. mun.;2010;28;293;177;116
Švenčionys d. mun.;2010;29;253;128;125
Švenčionys d. mun.;2010;30;272;133;139
Švenčionys d. mun.;2010;31;284;169;115
Švenčionys d. mun.;2010;32;305;169;136
Švenčionys d. mun.;2010;33;308;165;143
Švenčionys d. mun.;2010;34;344;177;167
Švenčionys d. mun.;2010;35;311;164;147
Švenčionys d. mun.;2010;36;349;173;176
Švenčionys d. mun.;2010;37;345;175;170
Švenčionys d. mun.;2010;38;359;171;188
Švenčionys d. mun.;2010;39;398;196;202
Švenčionys d. mun.;2010;40;346;182;164
Švenčionys d. mun.;2010;41;352;174;178
Švenčionys d. mun.;2010;42;350;178;172
Švenčionys d. mun.;2010;43;378;184;194
Švenčionys d. mun.;2010;44;411;205;206
Švenčionys d. mun.;2010;45;377;208;169
Švenčionys d. mun.;2010;46;432;199;233
Švenčionys d. mun.;2010;47;414;204;210
Švenčionys d. mun.;2010;48;440;220;220
Švenčionys d. mun.;2010;49;472;238;234
Švenčionys d. mun.;2010;50;440;219;221
Švenčionys d. mun.;2010;51;460;235;225
Švenčionys d. mun.;2010;52;418;200;218
Švenčionys d. mun.;2010;53;357;191;166
Švenčionys d. mun.;2010;54;362;178;184
Švenčionys d. mun.;2010;55;394;187;207
Švenčionys d. mun.;2010;56;299;144;155
Švenčionys d. mun.;2010;57;344;169;175
Švenčionys d. mun.;2010;58;356;183;173
Švenčionys d. mun.;2010;59;349;154;195
Švenčionys d. mun.;2010;60;411;185;226
Švenčionys d. mun.;2010;61;373;153;220
Švenčionys d. mun.;2010;62;292;127;165
Švenčionys d. mun.;2010;63;266;112;154
Švenčionys d. mun.;2010;64;290;128;162
Švenčionys d. mun.;2010;65;298;139;159
Švenčionys d. mun.;2010;66;308;122;186
Švenčionys d. mun.;2010;67;316;125;191
Švenčionys d. mun.;2010;68;315;121;194
Švenčionys d. mun.;2010;69;298;112;186
Švenčionys d. mun.;2010;70;301;93;208
Švenčionys d. mun.;2010;71;338;117;221
Švenčionys d. mun.;2010;72;290;108;182
Švenčionys d. mun.;2010;73;294;103;191
Švenčionys d. mun.;2010;74;319;126;193
Švenčionys d. mun.;2010;75;296;106;190
Švenčionys d. mun.;2010;76;301;113;188
Švenčionys d. mun.;2010;77;295;73;222
Švenčionys d. mun.;2010;78;303;87;216
Švenčionys d. mun.;2010;79;279;87;192
Švenčionys d. mun.;2010;80;256;72;184
Švenčionys d. mun.;2010;81;230;67;163
Švenčionys d. mun.;2010;82;199;54;145
Švenčionys d. mun.;2010;83;223;57;166
Švenčionys d. mun.;2010;84;193;50;143
Švenčionys d. mun.;2010;85;574;143;431
Švenčionys d. mun.;2011;-1;27961;13080;14881
Švenčionys d. mun.;2011;0;178;82;96
Švenčionys d. mun.;2011;1;222;114;108
Švenčionys d. mun.;2011;2;204;112;92
Švenčionys d. mun.;2011;3;207;121;86
Švenčionys d. mun.;2011;4;207;104;103
Švenčionys d. mun.;2011;5;212;108;104
Švenčionys d. mun.;2011;6;245;120;125
Švenčionys d. mun.;2011;7;223;125;98
Švenčionys d. mun.;2011;8;234;124;110
Švenčionys d. mun.;2011;9;271;141;130
Švenčionys d. mun.;2011;10;259;141;118
Švenčionys d. mun.;2011;11;315;171;144
Švenčionys d. mun.;2011;12;278;144;134
Švenčionys d. mun.;2011;13;320;171;149
Švenčionys d. mun.;2011;14;316;156;160
Švenčionys d. mun.;2011;15;341;164;177
Švenčionys d. mun.;2011;16;363;172;191
Švenčionys d. mun.;2011;17;387;182;205
Švenčionys d. mun.;2011;18;419;208;211
Švenčionys d. mun.;2011;19;355;193;162
Švenčionys d. mun.;2011;20;359;204;155
Švenčionys d. mun.;2011;21;315;183;132
Švenčionys d. mun.;2011;22;388;212;176
Švenčionys d. mun.;2011;23;364;212;152
Švenčionys d. mun.;2011;24;362;189;173
Švenčionys d. mun.;2011;25;345;192;153
Švenčionys d. mun.;2011;26;314;169;145
Švenčionys d. mun.;2011;27;331;186;145
Švenčionys d. mun.;2011;28;305;146;159
Švenčionys d. mun.;2011;29;316;178;138
Švenčionys d. mun.;2011;30;290;150;140
Švenčionys d. mun.;2011;31;284;143;141
Švenčionys d. mun.;2011;32;322;171;151
Švenčionys d. mun.;2011;33;315;166;149
Švenčionys d. mun.;2011;34;355;190;165
Švenčionys d. mun.;2011;35;367;188;179
Švenčionys d. mun.;2011;36;325;169;156
Švenčionys d. mun.;2011;37;372;188;184
Švenčionys d. mun.;2011;38;371;193;178
Švenčionys d. mun.;2011;39;385;184;201
Švenčionys d. mun.;2011;40;423;205;218
Švenčionys d. mun.;2011;41;370;206;164
Švenčionys d. mun.;2011;42;387;192;195
Švenčionys d. mun.;2011;43;366;189;177
Švenčionys d. mun.;2011;44;402;193;209
Švenčionys d. mun.;2011;45;426;205;221
Švenčionys d. mun.;2011;46;400;223;177
Švenčionys d. mun.;2011;47;427;202;225
Švenčionys d. mun.;2011;48;415;207;208
Švenčionys d. mun.;2011;49;446;216;230
Švenčionys d. mun.;2011;50;468;232;236
Švenčionys d. mun.;2011;51;452;222;230
Švenčionys d. mun.;2011;52;444;216;228
Švenčionys d. mun.;2011;53;414;197;217
Švenčionys d. mun.;2011;54;371;196;175
Švenčionys d. mun.;2011;55;373;184;189
Švenčionys d. mun.;2011;56;375;174;201
Švenčionys d. mun.;2011;57;315;154;161
Švenčionys d. mun.;2011;58;352;178;174
Švenčionys d. mun.;2011;59;354;176;178
Švenčionys d. mun.;2011;60;355;151;204
Švenčionys d. mun.;2011;61;397;174;223
Švenčionys d. mun.;2011;62;360;142;218
Švenčionys d. mun.;2011;63;281;120;161
Švenčionys d. mun.;2011;64;256;108;148
Švenčionys d. mun.;2011;65;298;122;176
Švenčionys d. mun.;2011;66;297;136;161
Švenčionys d. mun.;2011;67;297;114;183
Švenčionys d. mun.;2011;68;295;114;181
Švenčionys d. mun.;2011;69;309;116;193
Švenčionys d. mun.;2011;70;289;106;183
Švenčionys d. mun.;2011;71;288;85;203
Švenčionys d. mun.;2011;72;316;108;208
Švenčionys d. mun.;2011;73;264;100;164
Švenčionys d. mun.;2011;74;273;93;180
Švenčionys d. mun.;2011;75;301;117;184
Švenčionys d. mun.;2011;76;271;91;180
Švenčionys d. mun.;2011;77;283;101;182
Švenčionys d. mun.;2011;78;271;66;205
Švenčionys d. mun.;2011;79;269;68;201
Švenčionys d. mun.;2011;80;249;78;171
Švenčionys d. mun.;2011;81;221;54;167
Švenčionys d. mun.;2011;82;206;56;150
Švenčionys d. mun.;2011;83;168;40;128
Švenčionys d. mun.;2011;84;188;44;144
Švenčionys d. mun.;2011;85;638;143;495
Švenčionys d. mun.;2012;-1;27434;12852;14582
Švenčionys d. mun.;2012;0;234;126;108
Švenčionys d. mun.;2012;1;177;82;95
Švenčionys d. mun.;2012;2;215;112;103
Švenčionys d. mun.;2012;3;200;110;90
Švenčionys d. mun.;2012;4;202;119;83
Švenčionys d. mun.;2012;5;203;103;100
Švenčionys d. mun.;2012;6;208;106;102
Švenčionys d. mun.;2012;7;246;119;127
Švenčionys d. mun.;2012;8;219;123;96
Švenčionys d. mun.;2012;9;233;122;111
Švenčionys d. mun.;2012;10;267;138;129
Švenčionys d. mun.;2012;11;262;144;118
Švenčionys d. mun.;2012;12;312;170;142
Švenčionys d. mun.;2012;13;282;146;136
Švenčionys d. mun.;2012;14;323;173;150
Švenčionys d. mun.;2012;15;313;154;159
Švenčionys d. mun.;2012;16;339;163;176
Švenčionys d. mun.;2012;17;358;170;188
Švenčionys d. mun.;2012;18;384;181;203
Švenčionys d. mun.;2012;19;406;203;203
Švenčionys d. mun.;2012;20;345;184;161
Švenčionys d. mun.;2012;21;346;196;150
Švenčionys d. mun.;2012;22;309;178;131
Švenčionys d. mun.;2012;23;372;202;170
Švenčionys d. mun.;2012;24;350;212;138
Švenčionys d. mun.;2012;25;344;181;163
Švenčionys d. mun.;2012;26;325;184;141
Švenčionys d. mun.;2012;27;293;157;136
Švenčionys d. mun.;2012;28;309;175;134
Švenčionys d. mun.;2012;29;285;140;145
Švenčionys d. mun.;2012;30;300;171;129
Švenčionys d. mun.;2012;31;288;150;138
Švenčionys d. mun.;2012;32;275;134;141
Švenčionys d. mun.;2012;33;321;168;153
Švenčionys d. mun.;2012;34;313;165;148
Švenčionys d. mun.;2012;35;357;192;165
Švenčionys d. mun.;2012;36;361;186;175
Švenčionys d. mun.;2012;37;325;170;155
Švenčionys d. mun.;2012;38;369;186;183
Švenčionys d. mun.;2012;39;369;192;177
Švenčionys d. mun.;2012;40;381;182;199
Švenčionys d. mun.;2012;41;423;205;218
Švenčionys d. mun.;2012;42;370;209;161
Švenčionys d. mun.;2012;43;383;189;194
Švenčionys d. mun.;2012;44;359;185;174
Švenčionys d. mun.;2012;45;397;192;205
Švenčionys d. mun.;2012;46;416;197;219
Švenčionys d. mun.;2012;47;403;228;175
Švenčionys d. mun.;2012;48;425;203;222
Švenčionys d. mun.;2012;49;413;206;207
Švenčionys d. mun.;2012;50;444;216;228
Švenčionys d. mun.;2012;51;459;226;233
Švenčionys d. mun.;2012;52;446;221;225
Švenčionys d. mun.;2012;53;437;211;226
Švenčionys d. mun.;2012;54;413;195;218
Švenčionys d. mun.;2012;55;364;190;174
Švenčionys d. mun.;2012;56;370;178;192
Švenčionys d. mun.;2012;57;371;169;202
Švenčionys d. mun.;2012;58;314;150;164
Švenčionys d. mun.;2012;59;347;174;173
Švenčionys d. mun.;2012;60;340;165;175
Švenčionys d. mun.;2012;61;349;149;200
Švenčionys d. mun.;2012;62;387;167;220
Švenčionys d. mun.;2012;63;357;139;218
Švenčionys d. mun.;2012;64;278;118;160
Švenčionys d. mun.;2012;65;254;106;148
Švenčionys d. mun.;2012;66;295;120;175
Švenčionys d. mun.;2012;67;288;130;158
Švenčionys d. mun.;2012;68;292;112;180
Švenčionys d. mun.;2012;69;280;106;174
Švenčionys d. mun.;2012;70;296;108;188
Švenčionys d. mun.;2012;71;277;98;179
Švenčionys d. mun.;2012;72;285;83;202
Švenčionys d. mun.;2012;73;301;100;201
Švenčionys d. mun.;2012;74;247;90;157
Švenčionys d. mun.;2012;75;260;86;174
Švenčionys d. mun.;2012;76;293;110;183
Švenčionys d. mun.;2012;77;256;87;169
Švenčionys d. mun.;2012;78;269;94;175
Švenčionys d. mun.;2012;79;260;61;199
Švenčionys d. mun.;2012;80;242;53;189
Švenčionys d. mun.;2012;81;232;73;159
Švenčionys d. mun.;2012;82;206;50;156
Švenčionys d. mun.;2012;83;186;49;137
Švenčionys d. mun.;2012;84;147;34;113
Švenčionys d. mun.;2012;85;683;151;532
Švenčionys d. mun.;2013;-1;26853;12621;14232
Švenčionys d. mun.;2013;0;223;131;92
Švenčionys d. mun.;2013;1;232;126;106
Švenčionys d. mun.;2013;2;167;74;93
Švenčionys d. mun.;2013;3;215;114;101
Švenčionys d. mun.;2013;4;191;106;85
Švenčionys d. mun.;2013;5;196;118;78
Švenčionys d. mun.;2013;6;196;96;100
Švenčionys d. mun.;2013;7;207;103;104
Švenčionys d. mun.;2013;8;248;119;129
Švenčionys d. mun.;2013;9;214;118;96
Švenčionys d. mun.;2013;10;233;120;113
Švenčionys d. mun.;2013;11;263;137;126
Švenčionys d. mun.;2013;12;260;143;117
Švenčionys d. mun.;2013;13;312;169;143
Švenčionys d. mun.;2013;14;283;148;135
Švenčionys d. mun.;2013;15;318;167;151
Švenčionys d. mun.;2013;16;314;154;160
Švenčionys d. mun.;2013;17;338;162;176
Švenčionys d. mun.;2013;18;352;169;183
Švenčionys d. mun.;2013;19;366;174;192
Švenčionys d. mun.;2013;20;398;199;199
Švenčionys d. mun.;2013;21;338;180;158
Švenčionys d. mun.;2013;22;334;193;141
Švenčionys d. mun.;2013;23;296;173;123
Švenčionys d. mun.;2013;24;360;201;159
Švenčionys d. mun.;2013;25;334;205;129
Švenčionys d. mun.;2013;26;319;172;147
Švenčionys d. mun.;2013;27;311;178;133
Švenčionys d. mun.;2013;28;278;155;123
Švenčionys d. mun.;2013;29;291;172;119
Švenčionys d. mun.;2013;30;278;138;140
Švenčionys d. mun.;2013;31;282;158;124
Švenčionys d. mun.;2013;32;276;146;130
Švenčionys d. mun.;2013;33;268;132;136
Švenčionys d. mun.;2013;34;307;158;149
Švenčionys d. mun.;2013;35;309;165;144
Švenčionys d. mun.;2013;36;356;189;167
Švenčionys d. mun.;2013;37;351;177;174
Švenčionys d. mun.;2013;38;319;165;154
Švenčionys d. mun.;2013;39;360;185;175
Švenčionys d. mun.;2013;40;356;187;169
Švenčionys d. mun.;2013;41;379;182;197
Švenčionys d. mun.;2013;42;419;204;215
Švenčionys d. mun.;2013;43;368;207;161
Švenčionys d. mun.;2013;44;384;190;194
Švenčionys d. mun.;2013;45;354;180;174
Švenčionys d. mun.;2013;46;396;190;206
Švenčionys d. mun.;2013;47;409;194;215
Švenčionys d. mun.;2013;48;401;226;175
Švenčionys d. mun.;2013;49;423;202;221
Švenčionys d. mun.;2013;50;406;206;200
Švenčionys d. mun.;2013;51;442;215;227
Švenčionys d. mun.;2013;52;452;221;231
Švenčionys d. mun.;2013;53;447;223;224
Švenčionys d. mun.;2013;54;435;208;227
Švenčionys d. mun.;2013;55;408;192;216
Švenčionys d. mun.;2013;56;359;182;177
Švenčionys d. mun.;2013;57;370;177;193
Švenčionys d. mun.;2013;58;365;166;199
Švenčionys d. mun.;2013;59;309;145;164
Švenčionys d. mun.;2013;60;344;170;174
Švenčionys d. mun.;2013;61;336;162;174
Švenčionys d. mun.;2013;62;350;148;202
Švenčionys d. mun.;2013;63;376;161;215
Švenčionys d. mun.;2013;64;345;133;212
Švenčionys d. mun.;2013;65;269;111;158
Švenčionys d. mun.;2013;66;249;102;147
Švenčionys d. mun.;2013;67;291;117;174
Švenčionys d. mun.;2013;68;278;124;154
Švenčionys d. mun.;2013;69;284;107;177
Švenčionys d. mun.;2013;70;272;100;172
Švenčionys d. mun.;2013;71;279;94;185
Švenčionys d. mun.;2013;72;268;96;172
Švenčionys d. mun.;2013;73;278;80;198
Švenčionys d. mun.;2013;74;289;95;194
Švenčionys d. mun.;2013;75;230;81;149
Švenčionys d. mun.;2013;76;251;80;171
Švenčionys d. mun.;2013;77;277;101;176
Švenčionys d. mun.;2013;78;233;76;157
Švenčionys d. mun.;2013;79;254;89;165
Švenčionys d. mun.;2013;80;243;54;189
Švenčionys d. mun.;2013;81;220;51;169
Švenčionys d. mun.;2013;82;213;65;148
Švenčionys d. mun.;2013;83;183;44;139
Švenčionys d. mun.;2013;84;170;43;127
Švenčionys d. mun.;2013;85;696;151;545
Švenčionys d. mun.;2014;-1;26259;12357;13902
Švenčionys d. mun.;2014;0;208;107;101
Švenčionys d. mun.;2014;1;215;127;88
Švenčionys d. mun.;2014;2;224;125;99
Švenčionys d. mun.;2014;3;167;74;93
Švenčionys d. mun.;2014;4;215;112;103
Švenčionys d. mun.;2014;5;196;108;88
Švenčionys d. mun.;2014;6;194;117;77
Švenčionys d. mun.;2014;7;193;92;101
Švenčionys d. mun.;2014;8;207;102;105
Švenčionys d. mun.;2014;9;247;120;127
Švenčionys d. mun.;2014;10;210;116;94
Švenčionys d. mun.;2014;11;234;121;113
Švenčionys d. mun.;2014;12;262;137;125
Švenčionys d. mun.;2014;13;264;145;119
Švenčionys d. mun.;2014;14;311;168;143
Švenčionys d. mun.;2014;15;278;147;131
Švenčionys d. mun.;2014;16;315;165;150
Švenčionys d. mun.;2014;17;310;152;158
Švenčionys d. mun.;2014;18;329;158;171
Švenčionys d. mun.;2014;19;347;168;179
Švenčionys d. mun.;2014;20;364;172;192
Švenčionys d. mun.;2014;21;388;195;193
Švenčionys d. mun.;2014;22;325;177;148
Švenčionys d. mun.;2014;23;329;191;138
Švenčionys d. mun.;2014;24;286;168;118
Švenčionys d. mun.;2014;25;346;196;150
Švenčionys d. mun.;2014;26;316;196;120
Švenčionys d. mun.;2014;27;302;161;141
Švenčionys d. mun.;2014;28;291;167;124
Švenčionys d. mun.;2014;29;263;147;116
Švenčionys d. mun.;2014;30;270;161;109
Švenčionys d. mun.;2014;31;269;134;135
Švenčionys d. mun.;2014;32;267;150;117
Švenčionys d. mun.;2014;33;269;144;125
Švenčionys d. mun.;2014;34;269;130;139
Švenčionys d. mun.;2014;35;301;157;144
Švenčionys d. mun.;2014;36;307;164;143
Švenčionys d. mun.;2014;37;349;186;163
Švenčionys d. mun.;2014;38;341;168;173
Švenčionys d. mun.;2014;39;312;159;153
Švenčionys d. mun.;2014;40;356;182;174
Švenčionys d. mun.;2014;41;356;189;167
Švenčionys d. mun.;2014;42;376;182;194
Švenčionys d. mun.;2014;43;417;199;218
Švenčionys d. mun.;2014;44;370;210;160
Švenčionys d. mun.;2014;45;378;187;191
Švenčionys d. mun.;2014;46;348;175;173
Švenčionys d. mun.;2014;47;391;186;205
Švenčionys d. mun.;2014;48;402;189;213
Švenčionys d. mun.;2014;49;402;223;179
Švenčionys d. mun.;2014;50;421;202;219
Švenčionys d. mun.;2014;51;403;203;200
Švenčionys d. mun.;2014;52;438;210;228
Švenčionys d. mun.;2014;53;448;221;227
Švenčionys d. mun.;2014;54;439;219;220
Švenčionys d. mun.;2014;55;426;201;225
Švenčionys d. mun.;2014;56;407;191;216
Švenčionys d. mun.;2014;57;347;175;172
Švenčionys d. mun.;2014;58;364;171;193
Švenčionys d. mun.;2014;59;355;160;195
Švenčionys d. mun.;2014;60;303;140;163
Švenčionys d. mun.;2014;61;334;164;170
Švenčionys d. mun.;2014;62;325;154;171
Švenčionys d. mun.;2014;63;334;137;197
Švenčionys d. mun.;2014;64;371;156;215
Švenčionys d. mun.;2014;65;338;129;209
Švenčionys d. mun.;2014;66;261;105;156
Švenčionys d. mun.;2014;67;241;99;142
Švenčionys d. mun.;2014;68;286;115;171
Švenčionys d. mun.;2014;69;263;115;148
Švenčionys d. mun.;2014;70;274;103;171
Švenčionys d. mun.;2014;71;266;97;169
Švenčionys d. mun.;2014;72;275;93;182
Švenčionys d. mun.;2014;73;258;89;169
Švenčionys d. mun.;2014;74;263;73;190
Švenčionys d. mun.;2014;75;273;89;184
Švenčionys d. mun.;2014;76;216;75;141
Švenčionys d. mun.;2014;77;242;76;166
Švenčionys d. mun.;2014;78;264;93;171
Švenčionys d. mun.;2014;79;223;72;151
Švenčionys d. mun.;2014;80;243;86;157
Švenčionys d. mun.;2014;81;228;49;179
Švenčionys d. mun.;2014;82;195;44;151
Švenčionys d. mun.;2014;83;193;58;135
Švenčionys d. mun.;2014;84;157;33;124
Švenčionys d. mun.;2014;85;699;154;545
Švenčionys d. mun.;2015;-1;25719;12110;13609
Švenčionys d. mun.;2015;0;210;118;92
Švenčionys d. mun.;2015;1;203;102;101
Švenčionys d. mun.;2015;2;209;121;88
Švenčionys d. mun.;2015;3;222;123;99
Švenčionys d. mun.;2015;4;165;73;92
Švenčionys d. mun.;2015;5;211;114;97
Švenčionys d. mun.;2015;6;200;111;89
Švenčionys d. mun.;2015;7;193;117;76
Švenčionys d. mun.;2015;8;195;94;101
Švenčionys d. mun.;2015;9;208;103;105
Švenčionys d. mun.;2015;10;244;118;126
Švenčionys d. mun.;2015;11;209;116;93
Švenčionys d. mun.;2015;12;235;120;115
Švenčionys d. mun.;2015;13;262;137;125
Švenčionys d. mun.;2015;14;263;145;118
Švenčionys d. mun.;2015;15;316;169;147
Švenčionys d. mun.;2015;16;277;145;132
Švenčionys d. mun.;2015;17;307;161;146
Švenčionys d. mun.;2015;18;303;148;155
Švenčionys d. mun.;2015;19;319;153;166
Švenčionys d. mun.;2015;20;342;163;179
Švenčionys d. mun.;2015;21;354;165;189
Švenčionys d. mun.;2015;22;375;185;190
Švenčionys d. mun.;2015;23;315;179;136
Švenčionys d. mun.;2015;24;322;187;135
Švenčionys d. mun.;2015;25;275;165;110
Švenčionys d. mun.;2015;26;332;189;143
Švenčionys d. mun.;2015;27;302;193;109
Švenčionys d. mun.;2015;28;287;151;136
Švenčionys d. mun.;2015;29;276;157;119
Švenčionys d. mun.;2015;30;248;141;107
Švenčionys d. mun.;2015;31;262;157;105
Švenčionys d. mun.;2015;32;268;134;134
Švenčionys d. mun.;2015;33;255;141;114
Švenčionys d. mun.;2015;34;259;137;122
Švenčionys d. mun.;2015;35;267;129;138
Švenčionys d. mun.;2015;36;284;147;137
Švenčionys d. mun.;2015;37;298;158;140
Švenčionys d. mun.;2015;38;341;181;160
Švenčionys d. mun.;2015;39;336;164;172
Švenčionys d. mun.;2015;40;310;155;155
Švenčionys d. mun.;2015;41;356;182;174
Švenčionys d. mun.;2015;42;349;186;163
Švenčionys d. mun.;2015;43;374;181;193
Švenčionys d. mun.;2015;44;416;200;216
Švenčionys d. mun.;2015;45;368;207;161
Švenčionys d. mun.;2015;46;376;187;189
Švenčionys d. mun.;2015;47;343;171;172
Švenčionys d. mun.;2015;48;387;184;203
Švenčionys d. mun.;2015;49;401;187;214
Švenčionys d. mun.;2015;50;390;216;174
Švenčionys d. mun.;2015;51;412;196;216
Švenčionys d. mun.;2015;52;400;198;202
Švenčionys d. mun.;2015;53;433;208;225
Švenčionys d. mun.;2015;54;444;217;227
Švenčionys d. mun.;2015;55;436;215;221
Švenčionys d. mun.;2015;56;430;202;228
Švenčionys d. mun.;2015;57;406;191;215
Švenčionys d. mun.;2015;58;337;166;171
Švenčionys d. mun.;2015;59;357;167;190
Švenčionys d. mun.;2015;60;355;158;197
Švenčionys d. mun.;2015;61;299;136;163
Švenčionys d. mun.;2015;62;330;161;169
Švenčionys d. mun.;2015;63;316;151;165
Švenčionys d. mun.;2015;64;329;133;196
Švenčionys d. mun.;2015;65;358;147;211
Švenčionys d. mun.;2015;66;325;124;201
Švenčionys d. mun.;2015;67;257;103;154
Švenčionys d. mun.;2015;68;232;92;140
Švenčionys d. mun.;2015;69;273;108;165
Švenčionys d. mun.;2015;70;256;110;146
Švenčionys d. mun.;2015;71;264;95;169
Švenčionys d. mun.;2015;72;253;92;161
Švenčionys d. mun.;2015;73;262;87;175
Švenčionys d. mun.;2015;74;251;83;168
Švenčionys d. mun.;2015;75;249;64;185
Švenčionys d. mun.;2015;76;259;84;175
Švenčionys d. mun.;2015;77;199;66;133
Švenčionys d. mun.;2015;78;236;74;162
Švenčionys d. mun.;2015;79;243;83;160
Švenčionys d. mun.;2015;80;208;68;140
Švenčionys d. mun.;2015;81;223;74;149
Švenčionys d. mun.;2015;82;212;44;168
Švenčionys d. mun.;2015;83;176;40;136
Švenčionys d. mun.;2015;84;171;53;118
Švenčionys d. mun.;2015;85;709;153;556
Švenčionys d. mun.;2016;-1;25180;11885;13295
Švenčionys d. mun.;2016;0;222;110;112
Švenčionys d. mun.;2016;1;205;119;86
Švenčionys d. mun.;2016;2;197;97;100
Švenčionys d. mun.;2016;3;205;123;82
Švenčionys d. mun.;2016;4;218;122;96
Švenčionys d. mun.;2016;5;164;73;91
Švenčionys d. mun.;2016;6;210;113;97
Švenčionys d. mun.;2016;7;196;109;87
Švenčionys d. mun.;2016;8;200;123;77
Švenčionys d. mun.;2016;9;195;94;101
Švenčionys d. mun.;2016;10;207;104;103
Švenčionys d. mun.;2016;11;245;119;126
Švenčionys d. mun.;2016;12;207;115;92
Švenčionys d. mun.;2016;13;235;119;116
Švenčionys d. mun.;2016;14;265;138;127
Švenčionys d. mun.;2016;15;259;143;116
Švenčionys d. mun.;2016;16;315;165;150
Švenčionys d. mun.;2016;17;277;145;132
Švenčionys d. mun.;2016;18;297;158;139
Švenčionys d. mun.;2016;19;288;139;149
Švenčionys d. mun.;2016;20;313;150;163
Švenčionys d. mun.;2016;21;329;153;176
Švenčionys d. mun.;2016;22;342;158;184
Švenčionys d. mun.;2016;23;363;175;188
Švenčionys d. mun.;2016;24;307;174;133
Švenčionys d. mun.;2016;25;311;184;127
Švenčionys d. mun.;2016;26;258;155;103
Švenčionys d. mun.;2016;27;323;189;134
Švenčionys d. mun.;2016;28;284;183;101
Švenčionys d. mun.;2016;29;267;141;126
Švenčionys d. mun.;2016;30;264;150;114
Švenčionys d. mun.;2016;31;226;133;93
Švenčionys d. mun.;2016;32;257;152;105
Švenčionys d. mun.;2016;33;257;127;130
Švenčionys d. mun.;2016;34;250;139;111
Švenčionys d. mun.;2016;35;254;136;118
Švenčionys d. mun.;2016;36;260;123;137
Švenčionys d. mun.;2016;37;282;149;133
Švenčionys d. mun.;2016;38;294;155;139
Švenčionys d. mun.;2016;39;342;185;157
Švenčionys d. mun.;2016;40;331;163;168
Švenčionys d. mun.;2016;41;307;154;153
Švenčionys d. mun.;2016;42;347;176;171
Švenčionys d. mun.;2016;43;342;182;160
Švenčionys d. mun.;2016;44;374;178;196
Švenčionys d. mun.;2016;45;406;191;215
Švenčionys d. mun.;2016;46;366;208;158
Švenčionys d. mun.;2016;47;376;184;192
Švenčionys d. mun.;2016;48;342;169;173
Švenčionys d. mun.;2016;49;385;183;202
Švenčionys d. mun.;2016;50;401;188;213
Švenčionys d. mun.;2016;51;385;215;170
Švenčionys d. mun.;2016;52;412;196;216
Švenčionys d. mun.;2016;53;398;196;202
Švenčionys d. mun.;2016;54;428;204;224
Švenčionys d. mun.;2016;55;439;215;224
Švenčionys d. mun.;2016;56;433;214;219
Švenčionys d. mun.;2016;57;425;197;228
Švenčionys d. mun.;2016;58;402;188;214
Švenčionys d. mun.;2016;59;330;160;170
Švenčionys d. mun.;2016;60;352;162;190
Švenčionys d. mun.;2016;61;351;156;195
Švenčionys d. mun.;2016;62;295;133;162
Švenčionys d. mun.;2016;63;318;153;165
Švenčionys d. mun.;2016;64;310;148;162
Švenčionys d. mun.;2016;65;322;129;193
Švenčionys d. mun.;2016;66;347;137;210
Švenčionys d. mun.;2016;67;318;121;197
Švenčionys d. mun.;2016;68;246;97;149
Švenčionys d. mun.;2016;69;224;88;136
Švenčionys d. mun.;2016;70;267;105;162
Švenčionys d. mun.;2016;71;248;104;144
Švenčionys d. mun.;2016;72;257;90;167
Švenčionys d. mun.;2016;73;243;86;157
Švenčionys d. mun.;2016;74;254;86;168
Švenčionys d. mun.;2016;75;244;79;165
Švenčionys d. mun.;2016;76;233;56;177
Švenčionys d. mun.;2016;77;251;79;172
Švenčionys d. mun.;2016;78;189;65;124
Švenčionys d. mun.;2016;79;217;66;151
Švenčionys d. mun.;2016;80;225;76;149
Švenčionys d. mun.;2016;81;195;61;134
Švenčionys d. mun.;2016;82;209;66;143
Švenčionys d. mun.;2016;83;184;39;145
Švenčionys d. mun.;2016;84;159;33;126
Švenčionys d. mun.;2016;85;703;170;533
Švenčionys d. mun.;2017;-1;24565;11584;12981
Švenčionys d. mun.;2017;0;211;108;103
Švenčionys d. mun.;2017;1;217;107;110
Švenčionys d. mun.;2017;2;203;118;85
Švenčionys d. mun.;2017;3;194;93;101
Švenčionys d. mun.;2017;4;200;120;80
Švenčionys d. mun.;2017;5;216;122;94
Švenčionys d. mun.;2017;6;155;67;88
Švenčionys d. mun.;2017;7;207;111;96
Švenčionys d. mun.;2017;8;194;104;90
Švenčionys d. mun.;2017;9;200;122;78
Švenčionys d. mun.;2017;10;189;93;96
Švenčionys d. mun.;2017;11;207;104;103
Švenčionys d. mun.;2017;12;245;121;124
Švenčionys d. mun.;2017;13;207;112;95
Švenčionys d. mun.;2017;14;232;120;112
Švenčionys d. mun.;2017;15;262;137;125
Švenčionys d. mun.;2017;16;257;143;114
Švenčionys d. mun.;2017;17;309;162;147
Švenčionys d. mun.;2017;18;269;143;126
Švenčionys d. mun.;2017;19;286;152;134
Švenčionys d. mun.;2017;20;278;136;142
Švenčionys d. mun.;2017;21;315;149;166
Švenčionys d. mun.;2017;22;316;150;166
Švenčionys d. mun.;2017;23;327;156;171
Švenčionys d. mun.;2017;24;362;174;188
Švenčionys d. mun.;2017;25;294;166;128
Švenčionys d. mun.;2017;26;301;182;119
Švenčionys d. mun.;2017;27;240;146;94
Švenčionys d. mun.;2017;28;303;180;123
Švenčionys d. mun.;2017;29;269;174;95
Švenčionys d. mun.;2017;30;247;135;112
Švenčionys d. mun.;2017;31;250;140;110
Švenčionys d. mun.;2017;32;204;120;84
Švenčionys d. mun.;2017;33;243;143;100
Švenčionys d. mun.;2017;34;235;119;116
Švenčionys d. mun.;2017;35;236;128;108
Švenčionys d. mun.;2017;36;246;138;108
Švenčionys d. mun.;2017;37;247;116;131
Švenčionys d. mun.;2017;38;265;142;123
Švenčionys d. mun.;2017;39;290;149;141
Švenčionys d. mun.;2017;40;331;176;155
Švenčionys d. mun.;2017;41;327;161;166
Švenčionys d. mun.;2017;42;298;148;150
Švenčionys d. mun.;2017;43;340;168;172
Švenčionys d. mun.;2017;44;335;177;158
Švenčionys d. mun.;2017;45;375;177;198
Švenčionys d. mun.;2017;46;405;192;213
Švenčionys d. mun.;2017;47;362;204;158
Švenčionys d. mun.;2017;48;375;184;191
Švenčionys d. mun.;2017;49;340;168;172
Švenčionys d. mun.;2017;50;379;179;200
Švenčionys d. mun.;2017;51;396;185;211
Švenčionys d. mun.;2017;52;382;214;168
Švenčionys d. mun.;2017;53;411;194;217
Švenčionys d. mun.;2017;54;396;193;203
Švenčionys d. mun.;2017;55;426;201;225
Švenčionys d. mun.;2017;56;430;211;219
Švenčionys d. mun.;2017;57;432;211;221
Švenčionys d. mun.;2017;58;421;195;226
Švenčionys d. mun.;2017;59;398;185;213
Švenčionys d. mun.;2017;60;318;150;168
Švenčionys d. mun.;2017;61;353;161;192
Švenčionys d. mun.;2017;62;344;148;196
Švenčionys d. mun.;2017;63;286;129;157
Švenčionys d. mun.;2017;64;312;147;165
Švenčionys d. mun.;2017;65;305;145;160
Švenčionys d. mun.;2017;66;317;126;191
Švenčionys d. mun.;2017;67;339;135;204
Švenčionys d. mun.;2017;68;308;115;193
Švenčionys d. mun.;2017;69;238;92;146
Švenčionys d. mun.;2017;70;212;78;134
Švenčionys d. mun.;2017;71;260;98;162
Švenčionys d. mun.;2017;72;240;101;139
Švenčionys d. mun.;2017;73;251;85;166
Švenčionys d. mun.;2017;74;234;82;152
Švenčionys d. mun.;2017;75;244;80;164
Švenčionys d. mun.;2017;76;236;73;163
Švenčionys d. mun.;2017;77;223;51;172
Švenčionys d. mun.;2017;78;241;73;168
Švenčionys d. mun.;2017;79;169;52;117
Švenčionys d. mun.;2017;80;201;61;140
Švenčionys d. mun.;2017;81;201;64;137
Švenčionys d. mun.;2017;82;181;52;129
Švenčionys d. mun.;2017;83;187;57;130
Švenčionys d. mun.;2017;84;162;34;128
Švenčionys d. mun.;2017;85;716;170;546
Švenčionys d. mun.;2018;-1;23881;11280;12601
Švenčionys d. mun.;2018;0;191;104;87
Švenčionys d. mun.;2018;1;206;104;102
Švenčionys d. mun.;2018;2;210;107;103
Švenčionys d. mun.;2018;3;199;116;83
Švenčionys d. mun.;2018;4;185;90;95
Švenčionys d. mun.;2018;5;198;119;79
Švenčionys d. mun.;2018;6;213;121;92
Švenčionys d. mun.;2018;7;154;67;87
Švenčionys d. mun.;2018;8;206;110;96
Švenčionys d. mun.;2018;9;195;106;89
Švenčionys d. mun.;2018;10;198;122;76
Švenčionys d. mun.;2018;11;186;91;95
Švenčionys d. mun.;2018;12;203;101;102
Švenčionys d. mun.;2018;13;243;120;123
Švenčionys d. mun.;2018;14;203;111;92
Švenčionys d. mun.;2018;15;225;118;107
Švenčionys d. mun.;2018;16;256;135;121
Švenčionys d. mun.;2018;17;254;142;112
Švenčionys d. mun.;2018;18;306;163;143
Švenčionys d. mun.;2018;19;262;143;119
Švenčionys d. mun.;2018;20;279;148;131
Švenčionys d. mun.;2018;21;272;134;138
Švenčionys d. mun.;2018;22;300;145;155
Švenčionys d. mun.;2018;23;308;147;161
Švenčionys d. mun.;2018;24;314;149;165
Švenčionys d. mun.;2018;25;340;163;177
Švenčionys d. mun.;2018;26;275;160;115
Švenčionys d. mun.;2018;27;277;170;107
Švenčionys d. mun.;2018;28;222;142;80
Švenčionys d. mun.;2018;29;279;169;110
Švenčionys d. mun.;2018;30;248;166;82
Švenčionys d. mun.;2018;31;229;126;103
Švenčionys d. mun.;2018;32;229;129;100
Švenčionys d. mun.;2018;33;191;109;82
Švenčionys d. mun.;2018;34;229;136;93
Švenčionys d. mun.;2018;35;228;117;111
Švenčionys d. mun.;2018;36;223;121;102
Švenčionys d. mun.;2018;37;235;131;104
Švenčionys d. mun.;2018;38;239;111;128
Švenčionys d. mun.;2018;39;265;142;123
Švenčionys d. mun.;2018;40;277;137;140
Švenčionys d. mun.;2018;41;329;173;156
Švenčionys d. mun.;2018;42;322;157;165
Švenčionys d. mun.;2018;43;290;147;143
Švenčionys d. mun.;2018;44;335;166;169
Švenčionys d. mun.;2018;45;330;174;156
Švenčionys d. mun.;2018;46;370;173;197
Švenčionys d. mun.;2018;47;402;192;210
Švenčionys d. mun.;2018;48;358;198;160
Švenčionys d. mun.;2018;49;373;182;191
Švenčionys d. mun.;2018;50;338;166;172
Švenčionys d. mun.;2018;51;378;180;198
Švenčionys d. mun.;2018;52;390;180;210
Švenčionys d. mun.;2018;53;374;208;166
Švenčionys d. mun.;2018;54;407;192;215
Švenčionys d. mun.;2018;55;388;189;199
Švenčionys d. mun.;2018;56;414;195;219
Švenčionys d. mun.;2018;57;419;202;217
Švenčionys d. mun.;2018;58;427;208;219
Švenčionys d. mun.;2018;59;413;189;224
Švenčionys d. mun.;2018;60;393;182;211
Švenčionys d. mun.;2018;61;305;140;165
Švenčionys d. mun.;2018;62;351;163;188
Švenčionys d. mun.;2018;63;338;143;195
Švenčionys d. mun.;2018;64;277;119;158
Švenčionys d. mun.;2018;65;309;146;163
Švenčionys d. mun.;2018;66;293;136;157
Švenčionys d. mun.;2018;67;309;123;186
Švenčionys d. mun.;2018;68;327;125;202
Švenčionys d. mun.;2018;69;302;111;191
Švenčionys d. mun.;2018;70;233;88;145
Švenčionys d. mun.;2018;71;205;75;130
Švenčionys d. mun.;2018;72;249;94;155
Švenčionys d. mun.;2018;73;237;99;138
Švenčionys d. mun.;2018;74;242;79;163
Švenčionys d. mun.;2018;75;221;74;147
Švenčionys d. mun.;2018;76;235;75;160
Švenčionys d. mun.;2018;77;223;72;151
Švenčionys d. mun.;2018;78;208;44;164
Švenčionys d. mun.;2018;79;230;70;160
Švenčionys d. mun.;2018;80;153;45;108
Švenčionys d. mun.;2018;81;187;56;131
Švenčionys d. mun.;2018;82;186;56;130
Švenčionys d. mun.;2018;83;168;49;119
Švenčionys d. mun.;2018;84;166;53;113
Švenčionys d. mun.;2018;85;725;150;575
Tauragė county;2001;-1;134277;63890;70387
Tauragė county;2001;0;1428;733;695
Tauragė county;2001;1;1548;830;718
Tauragė county;2001;2;1561;839;722
Tauragė county;2001;3;1550;812;738
Tauragė county;2001;4;1672;831;841
Tauragė county;2001;5;1800;945;855
Tauragė county;2001;6;1938;991;947
Tauragė county;2001;7;2080;1061;1019
Tauragė county;2001;8;2390;1192;1198
Tauragė county;2001;9;2312;1191;1121
Tauragė county;2001;10;2454;1203;1251
Tauragė county;2001;11;2280;1204;1076
Tauragė county;2001;12;2295;1116;1179
Tauragė county;2001;13;2462;1259;1203
Tauragė county;2001;14;2419;1251;1168
Tauragė county;2001;15;2460;1252;1208
Tauragė county;2001;16;2267;1179;1088
Tauragė county;2001;17;2185;1125;1060
Tauragė county;2001;18;1765;903;862
Tauragė county;2001;19;1501;872;629
Tauragė county;2001;20;1440;796;644
Tauragė county;2001;21;1537;803;734
Tauragė county;2001;22;1569;823;746
Tauragė county;2001;23;1527;837;690
Tauragė county;2001;24;1604;824;780
Tauragė county;2001;25;1657;826;831
Tauragė county;2001;26;1643;860;783
Tauragė county;2001;27;1622;772;850
Tauragė county;2001;28;1817;926;891
Tauragė county;2001;29;1874;946;928
Tauragė county;2001;30;1877;965;912
Tauragė county;2001;31;1907;1014;893
Tauragė county;2001;32;1855;925;930
Tauragė county;2001;33;1855;923;932
Tauragė county;2001;34;1857;913;944
Tauragė county;2001;35;1869;980;889
Tauragė county;2001;36;1925;974;951
Tauragė county;2001;37;1910;983;927
Tauragė county;2001;38;2025;1055;970
Tauragė county;2001;39;2120;1099;1021
Tauragė county;2001;40;2169;1111;1058
Tauragė county;2001;41;1979;1013;966
Tauragė county;2001;42;2013;1023;990
Tauragė county;2001;43;1766;871;895
Tauragė county;2001;44;1687;841;846
Tauragė county;2001;45;1685;840;845
Tauragė county;2001;46;1566;775;791
Tauragė county;2001;47;1469;742;727
Tauragė county;2001;48;1423;703;720
Tauragė county;2001;49;1514;687;827
Tauragė county;2001;50;1503;734;769
Tauragė county;2001;51;1506;709;797
Tauragė county;2001;52;1443;650;793
Tauragė county;2001;53;1278;647;631
Tauragė county;2001;54;1226;555;671
Tauragė county;2001;55;1351;611;740
Tauragė county;2001;56;1111;497;614
Tauragė county;2001;57;1438;640;798
Tauragė county;2001;58;1577;705;872
Tauragė county;2001;59;1501;642;859
Tauragė county;2001;60;1331;581;750
Tauragė county;2001;61;1362;576;786
Tauragė county;2001;62;1310;540;770
Tauragė county;2001;63;1358;552;806
Tauragė county;2001;64;1444;583;861
Tauragė county;2001;65;1432;553;879
Tauragė county;2001;66;1352;558;794
Tauragė county;2001;67;1402;533;869
Tauragė county;2001;68;1425;529;896
Tauragė county;2001;69;1368;527;841
Tauragė county;2001;70;1324;484;840
Tauragė county;2001;71;1205;402;803
Tauragė county;2001;72;1268;440;828
Tauragė county;2001;73;1191;393;798
Tauragė county;2001;74;1042;345;697
Tauragė county;2001;75;971;312;659
Tauragė county;2001;76;822;286;536
Tauragė county;2001;77;896;300;596
Tauragė county;2001;78;730;212;518
Tauragė county;2001;79;623;180;443
Tauragė county;2001;80;545;142;403
Tauragė county;2001;81;438;132;306
Tauragė county;2001;82;313;88;225
Tauragė county;2001;83;258;77;181
Tauragė county;2001;84;270;84;186
Tauragė county;2001;85;1535;452;1083
Tauragė county;2002;-1;132982;63030;69952
Tauragė county;2002;0;1258;622;636
Tauragė county;2002;1;1416;724;692
Tauragė county;2002;2;1529;818;711
Tauragė county;2002;3;1557;833;724
Tauragė county;2002;4;1539;807;732
Tauragė county;2002;5;1669;830;839
Tauragė county;2002;6;1792;938;854
Tauragė county;2002;7;1927;985;942
Tauragė county;2002;8;2068;1049;1019
Tauragė county;2002;9;2382;1184;1198
Tauragė county;2002;10;2299;1183;1116
Tauragė county;2002;11;2422;1182;1240
Tauragė county;2002;12;2254;1192;1062
Tauragė county;2002;13;2264;1096;1168
Tauragė county;2002;14;2433;1236;1197
Tauragė county;2002;15;2388;1234;1154
Tauragė county;2002;16;2428;1234;1194
Tauragė county;2002;17;2235;1157;1078
Tauragė county;2002;18;2149;1102;1047
Tauragė county;2002;19;1712;873;839
Tauragė county;2002;20;1478;847;631
Tauragė county;2002;21;1428;788;640
Tauragė county;2002;22;1532;787;745
Tauragė county;2002;23;1554;812;742
Tauragė county;2002;24;1524;823;701
Tauragė county;2002;25;1579;806;773
Tauragė county;2002;26;1626;801;825
Tauragė county;2002;27;1619;834;785
Tauragė county;2002;28;1579;741;838
Tauragė county;2002;29;1770;893;877
Tauragė county;2002;30;1839;921;918
Tauragė county;2002;31;1841;949;892
Tauragė county;2002;32;1878;991;887
Tauragė county;2002;33;1829;909;920
Tauragė county;2002;34;1831;909;922
Tauragė county;2002;35;1823;885;938
Tauragė county;2002;36;1847;965;882
Tauragė county;2002;37;1889;943;946
Tauragė county;2002;38;1877;956;921
Tauragė county;2002;39;1979;1024;955
Tauragė county;2002;40;2077;1071;1006
Tauragė county;2002;41;2138;1092;1046
Tauragė county;2002;42;1950;993;957
Tauragė county;2002;43;1996;1013;983
Tauragė county;2002;44;1737;851;886
Tauragė county;2002;45;1654;824;830
Tauragė county;2002;46;1653;822;831
Tauragė county;2002;47;1561;778;783
Tauragė county;2002;48;1433;722;711
Tauragė county;2002;49;1395;685;710
Tauragė county;2002;50;1488;666;822
Tauragė county;2002;51;1475;717;758
Tauragė county;2002;52;1488;697;791
Tauragė county;2002;53;1432;650;782
Tauragė county;2002;54;1252;633;619
Tauragė county;2002;55;1196;539;657
Tauragė county;2002;56;1311;586;725
Tauragė county;2002;57;1074;481;593
Tauragė county;2002;58;1393;613;780
Tauragė county;2002;59;1539;687;852
Tauragė county;2002;60;1479;631;848
Tauragė county;2002;61;1319;571;748
Tauragė county;2002;62;1342;558;784
Tauragė county;2002;63;1295;526;769
Tauragė county;2002;64;1345;540;805
Tauragė county;2002;65;1422;569;853
Tauragė county;2002;66;1410;537;873
Tauragė county;2002;67;1328;548;780
Tauragė county;2002;68;1371;519;852
Tauragė county;2002;69;1404;515;889
Tauragė county;2002;70;1342;511;831
Tauragė county;2002;71;1298;463;835
Tauragė county;2002;72;1170;384;786
Tauragė county;2002;73;1233;420;813
Tauragė county;2002;74;1152;379;773
Tauragė county;2002;75;1018;335;683
Tauragė county;2002;76;928;293;635
Tauragė county;2002;77;793;269;524
Tauragė county;2002;78;851;283;568
Tauragė county;2002;79;699;206;493
Tauragė county;2002;80;585;164;421
Tauragė county;2002;81;496;125;371
Tauragė county;2002;82;402;116;286
Tauragė county;2002;83;283;79;204
Tauragė county;2002;84;224;67;157
Tauragė county;2002;85;1508;439;1069
Tauragė county;2003;-1;131808;62359;69449
Tauragė county;2003;0;1202;614;588
Tauragė county;2003;1;1261;626;635
Tauragė county;2003;2;1405;716;689
Tauragė county;2003;3;1535;822;713
Tauragė county;2003;4;1554;830;724
Tauragė county;2003;5;1535;803;732
Tauragė county;2003;6;1663;826;837
Tauragė county;2003;7;1787;932;855
Tauragė county;2003;8;1929;986;943
Tauragė county;2003;9;2063;1044;1019
Tauragė county;2003;10;2365;1176;1189
Tauragė county;2003;11;2286;1177;1109
Tauragė county;2003;12;2391;1169;1222
Tauragė county;2003;13;2222;1173;1049
Tauragė county;2003;14;2233;1075;1158
Tauragė county;2003;15;2394;1213;1181
Tauragė county;2003;16;2349;1211;1138
Tauragė county;2003;17;2379;1207;1172
Tauragė county;2003;18;2207;1139;1068
Tauragė county;2003;19;2119;1089;1030
Tauragė county;2003;20;1693;867;826
Tauragė county;2003;21;1460;834;626
Tauragė county;2003;22;1428;776;652
Tauragė county;2003;23;1525;772;753
Tauragė county;2003;24;1550;801;749
Tauragė county;2003;25;1509;815;694
Tauragė county;2003;26;1567;798;769
Tauragė county;2003;27;1573;765;808
Tauragė county;2003;28;1594;823;771
Tauragė county;2003;29;1559;732;827
Tauragė county;2003;30;1755;888;867
Tauragė county;2003;31;1808;904;904
Tauragė county;2003;32;1818;934;884
Tauragė county;2003;33;1863;985;878
Tauragė county;2003;34;1803;893;910
Tauragė county;2003;35;1804;890;914
Tauragė county;2003;36;1796;870;926
Tauragė county;2003;37;1826;950;876
Tauragė county;2003;38;1864;927;937
Tauragė county;2003;39;1857;946;911
Tauragė county;2003;40;1958;1010;948
Tauragė county;2003;41;2068;1070;998
Tauragė county;2003;42;2130;1088;1042
Tauragė county;2003;43;1938;989;949
Tauragė county;2003;44;1989;1007;982
Tauragė county;2003;45;1713;838;875
Tauragė county;2003;46;1629;807;822
Tauragė county;2003;47;1637;814;823
Tauragė county;2003;48;1550;766;784
Tauragė county;2003;49;1410;709;701
Tauragė county;2003;50;1379;673;706
Tauragė county;2003;51;1471;656;815
Tauragė county;2003;52;1448;701;747
Tauragė county;2003;53;1478;693;785
Tauragė county;2003;54;1418;641;777
Tauragė county;2003;55;1237;624;613
Tauragė county;2003;56;1173;520;653
Tauragė county;2003;57;1292;573;719
Tauragė county;2003;58;1047;458;589
Tauragė county;2003;59;1363;591;772
Tauragė county;2003;60;1508;668;840
Tauragė county;2003;61;1450;612;838
Tauragė county;2003;62;1286;553;733
Tauragė county;2003;63;1324;546;778
Tauragė county;2003;64;1276;517;759
Tauragė county;2003;65;1324;530;794
Tauragė county;2003;66;1390;550;840
Tauragė county;2003;67;1385;524;861
Tauragė county;2003;68;1289;517;772
Tauragė county;2003;69;1325;484;841
Tauragė county;2003;70;1373;493;880
Tauragė county;2003;71;1295;485;810
Tauragė county;2003;72;1264;442;822
Tauragė county;2003;73;1133;367;766
Tauragė county;2003;74;1189;401;788
Tauragė county;2003;75;1098;347;751
Tauragė county;2003;76;966;314;652
Tauragė county;2003;77;870;263;607
Tauragė county;2003;78;738;252;486
Tauragė county;2003;79;797;254;543
Tauragė county;2003;80;638;186;452
Tauragė county;2003;81;541;148;393
Tauragė county;2003;82;465;113;352
Tauragė county;2003;83;349;96;253
Tauragė county;2003;84;255;69;186
Tauragė county;2003;85;1421;402;1019
Tauragė county;2004;-1;130179;61532;68647
Tauragė county;2004;0;1258;643;615
Tauragė county;2004;1;1201;617;584
Tauragė county;2004;2;1249;618;631
Tauragė county;2004;3;1401;714;687
Tauragė county;2004;4;1529;821;708
Tauragė county;2004;5;1544;826;718
Tauragė county;2004;6;1524;801;723
Tauragė county;2004;7;1655;820;835
Tauragė county;2004;8;1777;925;852
Tauragė county;2004;9;1914;980;934
Tauragė county;2004;10;2053;1040;1013
Tauragė county;2004;11;2355;1175;1180
Tauragė county;2004;12;2254;1157;1097
Tauragė county;2004;13;2361;1160;1201
Tauragė county;2004;14;2178;1151;1027
Tauragė county;2004;15;2200;1067;1133
Tauragė county;2004;16;2353;1197;1156
Tauragė county;2004;17;2307;1191;1116
Tauragė county;2004;18;2326;1182;1144
Tauragė county;2004;19;2156;1115;1041
Tauragė county;2004;20;2065;1061;1004
Tauragė county;2004;21;1640;846;794
Tauragė county;2004;22;1435;822;613
Tauragė county;2004;23;1412;769;643
Tauragė county;2004;24;1517;761;756
Tauragė county;2004;25;1489;778;711
Tauragė county;2004;26;1456;788;668
Tauragė county;2004;27;1515;769;746
Tauragė county;2004;28;1527;746;781
Tauragė county;2004;29;1546;793;753
Tauragė county;2004;30;1524;719;805
Tauragė county;2004;31;1727;873;854
Tauragė county;2004;32;1770;884;886
Tauragė county;2004;33;1781;912;869
Tauragė county;2004;34;1826;963;863
Tauragė county;2004;35;1781;885;896
Tauragė county;2004;36;1784;880;904
Tauragė county;2004;37;1770;855;915
Tauragė county;2004;38;1799;933;866
Tauragė county;2004;39;1842;920;922
Tauragė county;2004;40;1828;929;899
Tauragė county;2004;41;1926;994;932
Tauragė county;2004;42;2039;1055;984
Tauragė county;2004;43;2106;1073;1033
Tauragė county;2004;44;1893;956;937
Tauragė county;2004;45;1967;1000;967
Tauragė county;2004;46;1700;830;870
Tauragė county;2004;47;1589;789;800
Tauragė county;2004;48;1611;797;814
Tauragė county;2004;49;1532;758;774
Tauragė county;2004;50;1379;686;693
Tauragė county;2004;51;1348;657;691
Tauragė county;2004;52;1441;642;799
Tauragė county;2004;53;1420;687;733
Tauragė county;2004;54;1476;696;780
Tauragė county;2004;55;1397;623;774
Tauragė county;2004;56;1223;611;612
Tauragė county;2004;57;1154;508;646
Tauragė county;2004;58;1269;554;715
Tauragė county;2004;59;1029;450;579
Tauragė county;2004;60;1327;571;756
Tauragė county;2004;61;1467;643;824
Tauragė county;2004;62;1419;600;819
Tauragė county;2004;63;1257;535;722
Tauragė county;2004;64;1299;525;774
Tauragė county;2004;65;1259;505;754
Tauragė county;2004;66;1292;503;789
Tauragė county;2004;67;1352;515;837
Tauragė county;2004;68;1356;506;850
Tauragė county;2004;69;1257;496;761
Tauragė county;2004;70;1289;464;825
Tauragė county;2004;71;1325;461;864
Tauragė county;2004;72;1244;451;793
Tauragė county;2004;73;1227;419;808
Tauragė county;2004;74;1088;342;746
Tauragė county;2004;75;1126;360;766
Tauragė county;2004;76;1051;325;726
Tauragė county;2004;77;914;281;633
Tauragė county;2004;78;836;242;594
Tauragė county;2004;79;684;231;453
Tauragė county;2004;80;734;229;505
Tauragė county;2004;81;588;170;418
Tauragė county;2004;82;498;135;363
Tauragė county;2004;83;425;96;329
Tauragė county;2004;84;321;83;238
Tauragė county;2004;85;1416;392;1024
Tauragė county;2005;-1;127690;60396;67294
Tauragė county;2005;0;1104;573;531
Tauragė county;2005;1;1237;630;607
Tauragė county;2005;2;1194;614;580
Tauragė county;2005;3;1235;611;624
Tauragė county;2005;4;1388;709;679
Tauragė county;2005;5;1507;811;696
Tauragė county;2005;6;1531;822;709
Tauragė county;2005;7;1511;793;718
Tauragė county;2005;8;1642;816;826
Tauragė county;2005;9;1765;923;842
Tauragė county;2005;10;1902;975;927
Tauragė county;2005;11;2029;1028;1001
Tauragė county;2005;12;2328;1158;1170
Tauragė county;2005;13;2226;1145;1081
Tauragė county;2005;14;2325;1141;1184
Tauragė county;2005;15;2156;1139;1017
Tauragė county;2005;16;2158;1048;1110
Tauragė county;2005;17;2309;1174;1135
Tauragė county;2005;18;2247;1161;1086
Tauragė county;2005;19;2260;1154;1106
Tauragė county;2005;20;2080;1079;1001
Tauragė county;2005;21;2015;1036;979
Tauragė county;2005;22;1577;817;760
Tauragė county;2005;23;1379;798;581
Tauragė county;2005;24;1359;757;602
Tauragė county;2005;25;1460;736;724
Tauragė county;2005;26;1441;752;689
Tauragė county;2005;27;1396;753;643
Tauragė county;2005;28;1458;744;714
Tauragė county;2005;29;1460;717;743
Tauragė county;2005;30;1483;767;716
Tauragė county;2005;31;1469;686;783
Tauragė county;2005;32;1667;840;827
Tauragė county;2005;33;1723;860;863
Tauragė county;2005;34;1734;886;848
Tauragė county;2005;35;1781;937;844
Tauragė county;2005;36;1738;863;875
Tauragė county;2005;37;1756;868;888
Tauragė county;2005;38;1748;849;899
Tauragė county;2005;39;1771;919;852
Tauragė county;2005;40;1817;907;910
Tauragė county;2005;41;1803;907;896
Tauragė county;2005;42;1884;971;913
Tauragė county;2005;43;2009;1033;976
Tauragė county;2005;44;2069;1052;1017
Tauragė county;2005;45;1858;940;918
Tauragė county;2005;46;1939;981;958
Tauragė county;2005;47;1678;824;854
Tauragė county;2005;48;1556;766;790
Tauragė county;2005;49;1579;783;796
Tauragė county;2005;50;1506;739;767
Tauragė county;2005;51;1354;669;685
Tauragė county;2005;52;1327;645;682
Tauragė county;2005;53;1408;624;784
Tauragė county;2005;54;1392;670;722
Tauragė county;2005;55;1448;680;768
Tauragė county;2005;56;1375;611;764
Tauragė county;2005;57;1200;596;604
Tauragė county;2005;58;1128;493;635
Tauragė county;2005;59;1253;544;709
Tauragė county;2005;60;1006;434;572
Tauragė county;2005;61;1290;552;738
Tauragė county;2005;62;1432;621;811
Tauragė county;2005;63;1371;568;803
Tauragė county;2005;64;1212;511;701
Tauragė county;2005;65;1262;505;757
Tauragė county;2005;66;1219;489;730
Tauragė county;2005;67;1267;486;781
Tauragė county;2005;68;1309;491;818
Tauragė county;2005;69;1310;477;833
Tauragė county;2005;70;1225;481;744
Tauragė county;2005;71;1228;429;799
Tauragė county;2005;72;1287;445;842
Tauragė county;2005;73;1193;424;769
Tauragė county;2005;74;1168;390;778
Tauragė county;2005;75;1028;315;713
Tauragė county;2005;76;1069;332;737
Tauragė county;2005;77;992;296;696
Tauragė county;2005;78;863;261;602
Tauragė county;2005;79;779;228;551
Tauragė county;2005;80;636;217;419
Tauragė county;2005;81;669;203;466
Tauragė county;2005;82;528;149;379
Tauragė county;2005;83;447;115;332
Tauragė county;2005;84;374;80;294
Tauragė county;2005;85;1394;373;1021
Tauragė county;2006;-1;124020;58388;65632
Tauragė county;2006;0;1094;575;519
Tauragė county;2006;1;1082;561;521
Tauragė county;2006;2;1208;613;595
Tauragė county;2006;3;1158;591;567
Tauragė county;2006;4;1208;599;609
Tauragė county;2006;5;1365;689;676
Tauragė county;2006;6;1481;798;683
Tauragė county;2006;7;1504;803;701
Tauragė county;2006;8;1497;782;715
Tauragė county;2006;9;1623;805;818
Tauragė county;2006;10;1747;909;838
Tauragė county;2006;11;1878;961;917
Tauragė county;2006;12;2006;1013;993
Tauragė county;2006;13;2271;1125;1146
Tauragė county;2006;14;2174;1111;1063
Tauragė county;2006;15;2253;1105;1148
Tauragė county;2006;16;2077;1093;984
Tauragė county;2006;17;2078;1007;1071
Tauragė county;2006;18;2212;1121;1091
Tauragė county;2006;19;2117;1084;1033
Tauragė county;2006;20;2131;1075;1056
Tauragė county;2006;21;1947;1014;933
Tauragė county;2006;22;1904;980;924
Tauragė county;2006;23;1491;775;716
Tauragė county;2006;24;1282;751;531
Tauragė county;2006;25;1245;695;550
Tauragė county;2006;26;1383;693;690
Tauragė county;2006;27;1362;713;649
Tauragė county;2006;28;1322;709;613
Tauragė county;2006;29;1389;715;674
Tauragė county;2006;30;1401;686;715
Tauragė county;2006;31;1418;733;685
Tauragė county;2006;32;1412;656;756
Tauragė county;2006;33;1607;807;800
Tauragė county;2006;34;1656;816;840
Tauragė county;2006;35;1675;850;825
Tauragė county;2006;36;1728;899;829
Tauragė county;2006;37;1679;823;856
Tauragė county;2006;38;1705;836;869
Tauragė county;2006;39;1705;824;881
Tauragė county;2006;40;1721;886;835
Tauragė county;2006;41;1768;876;892
Tauragė county;2006;42;1763;883;880
Tauragė county;2006;43;1838;939;899
Tauragė county;2006;44;1970;1012;958
Tauragė county;2006;45;2031;1032;999
Tauragė county;2006;46;1812;912;900
Tauragė county;2006;47;1910;964;946
Tauragė county;2006;48;1648;802;846
Tauragė county;2006;49;1505;734;771
Tauragė county;2006;50;1547;761;786
Tauragė county;2006;51;1468;721;747
Tauragė county;2006;52;1317;640;677
Tauragė county;2006;53;1301;630;671
Tauragė county;2006;54;1368;600;768
Tauragė county;2006;55;1355;647;708
Tauragė county;2006;56;1424;662;762
Tauragė county;2006;57;1346;593;753
Tauragė county;2006;58;1163;572;591
Tauragė county;2006;59;1098;470;628
Tauragė county;2006;60;1218;519;699
Tauragė county;2006;61;974;415;559
Tauragė county;2006;62;1251;526;725
Tauragė county;2006;63;1380;584;796
Tauragė county;2006;64;1334;542;792
Tauragė county;2006;65;1177;485;692
Tauragė county;2006;66;1234;487;747
Tauragė county;2006;67;1170;458;712
Tauragė county;2006;68;1219;456;763
Tauragė county;2006;69;1263;472;791
Tauragė county;2006;70;1270;447;823
Tauragė county;2006;71;1178;448;730
Tauragė county;2006;72;1179;397;782
Tauragė county;2006;73;1223;406;817
Tauragė county;2006;74;1141;397;744
Tauragė county;2006;75;1123;370;753
Tauragė county;2006;76;957;289;668
Tauragė county;2006;77;995;300;695
Tauragė county;2006;78;914;267;647
Tauragė county;2006;79;795;233;562
Tauragė county;2006;80;731;201;530
Tauragė county;2006;81;562;185;377
Tauragė county;2006;82;620;185;435
Tauragė county;2006;83;469;131;338
Tauragė county;2006;84;390;93;297
Tauragė county;2006;85;1425;364;1061
Tauragė county;2007;-1;121549;57081;64468
Tauragė county;2007;0;1050;544;506
Tauragė county;2007;1;1073;563;510
Tauragė county;2007;2;1074;556;518
Tauragė county;2007;3;1191;609;582
Tauragė county;2007;4;1148;584;564
Tauragė county;2007;5;1201;591;610
Tauragė county;2007;6;1347;680;667
Tauragė county;2007;7;1462;783;679
Tauragė county;2007;8;1498;802;696
Tauragė county;2007;9;1478;773;705
Tauragė county;2007;10;1610;793;817
Tauragė county;2007;11;1734;906;828
Tauragė county;2007;12;1864;948;916
Tauragė county;2007;13;1995;1010;985
Tauragė county;2007;14;2248;1113;1135
Tauragė county;2007;15;2141;1094;1047
Tauragė county;2007;16;2219;1088;1131
Tauragė county;2007;17;2041;1067;974
Tauragė county;2007;18;2029;981;1048
Tauragė county;2007;19;2155;1085;1070
Tauragė county;2007;20;2039;1043;996
Tauragė county;2007;21;2055;1033;1022
Tauragė county;2007;22;1891;986;905
Tauragė county;2007;23;1828;937;891
Tauragė county;2007;24;1442;747;695
Tauragė county;2007;25;1209;708;501
Tauragė county;2007;26;1192;662;530
Tauragė county;2007;27;1331;667;664
Tauragė county;2007;28;1309;679;630
Tauragė county;2007;29;1278;683;595
Tauragė county;2007;30;1348;694;654
Tauragė county;2007;31;1373;675;698
Tauragė county;2007;32;1379;715;664
Tauragė county;2007;33;1405;648;757
Tauragė county;2007;34;1564;784;780
Tauragė county;2007;35;1622;797;825
Tauragė county;2007;36;1634;820;814
Tauragė county;2007;37;1693;874;819
Tauragė county;2007;38;1640;796;844
Tauragė county;2007;39;1675;819;856
Tauragė county;2007;40;1666;803;863
Tauragė county;2007;41;1688;866;822
Tauragė county;2007;42;1735;852;883
Tauragė county;2007;43;1730;861;869
Tauragė county;2007;44;1789;911;878
Tauragė county;2007;45;1929;984;945
Tauragė county;2007;46;2011;1019;992
Tauragė county;2007;47;1785;900;885
Tauragė county;2007;48;1879;943;936
Tauragė county;2007;49;1626;789;837
Tauragė county;2007;50;1469;718;751
Tauragė county;2007;51;1508;735;773
Tauragė county;2007;52;1432;705;727
Tauragė county;2007;53;1285;617;668
Tauragė county;2007;54;1272;612;660
Tauragė county;2007;55;1336;578;758
Tauragė county;2007;56;1329;629;700
Tauragė county;2007;57;1395;641;754
Tauragė county;2007;58;1315;579;736
Tauragė county;2007;59;1140;552;588
Tauragė county;2007;60;1067;454;613
Tauragė county;2007;61;1185;498;687
Tauragė county;2007;62;950;405;545
Tauragė county;2007;63;1208;500;708
Tauragė county;2007;64;1328;559;769
Tauragė county;2007;65;1293;518;775
Tauragė county;2007;66;1145;466;679
Tauragė county;2007;67;1195;465;730
Tauragė county;2007;68;1134;438;696
Tauragė county;2007;69;1184;438;746
Tauragė county;2007;70;1222;445;777
Tauragė county;2007;71;1220;421;799
Tauragė county;2007;72;1122;414;708
Tauragė county;2007;73;1130;367;763
Tauragė county;2007;74;1165;379;786
Tauragė county;2007;75;1068;356;712
Tauragė county;2007;76;1061;352;709
Tauragė county;2007;77;907;269;638
Tauragė county;2007;78;924;271;653
Tauragė county;2007;79;860;242;618
Tauragė county;2007;80;724;211;513
Tauragė county;2007;81;665;176;489
Tauragė county;2007;82;507;161;346
Tauragė county;2007;83;568;165;403
Tauragė county;2007;84;410;110;300
Tauragė county;2007;85;1523;370;1153
Tauragė county;2008;-1;119179;55910;63269
Tauragė county;2008;0;1090;557;533
Tauragė county;2008;1;1029;535;494
Tauragė county;2008;2;1062;554;508
Tauragė county;2008;3;1059;554;505
Tauragė county;2008;4;1176;600;576
Tauragė county;2008;5;1128;576;552
Tauragė county;2008;6;1185;584;601
Tauragė county;2008;7;1324;661;663
Tauragė county;2008;8;1444;776;668
Tauragė county;2008;9;1482;793;689
Tauragė county;2008;10;1462;759;703
Tauragė county;2008;11;1590;784;806
Tauragė county;2008;12;1716;895;821
Tauragė county;2008;13;1845;939;906
Tauragė county;2008;14;1977;1003;974
Tauragė county;2008;15;2219;1096;1123
Tauragė county;2008;16;2119;1083;1036
Tauragė county;2008;17;2188;1079;1109
Tauragė county;2008;18;2001;1047;954
Tauragė county;2008;19;1992;965;1027
Tauragė county;2008;20;2101;1065;1036
Tauragė county;2008;21;1973;1017;956
Tauragė county;2008;22;1980;998;982
Tauragė county;2008;23;1837;967;870
Tauragė county;2008;24;1761;904;857
Tauragė county;2008;25;1357;712;645
Tauragė county;2008;26;1134;670;464
Tauragė county;2008;27;1143;636;507
Tauragė county;2008;28;1272;643;629
Tauragė county;2008;29;1252;655;597
Tauragė county;2008;30;1231;661;570
Tauragė county;2008;31;1301;667;634
Tauragė county;2008;32;1335;657;678
Tauragė county;2008;33;1347;697;650
Tauragė county;2008;34;1378;632;746
Tauragė county;2008;35;1543;768;775
Tauragė county;2008;36;1581;768;813
Tauragė county;2008;37;1609;810;799
Tauragė county;2008;38;1663;849;814
Tauragė county;2008;39;1603;775;828
Tauragė county;2008;40;1653;810;843
Tauragė county;2008;41;1626;776;850
Tauragė county;2008;42;1658;849;809
Tauragė county;2008;43;1697;830;867
Tauragė county;2008;44;1701;845;856
Tauragė county;2008;45;1753;891;862
Tauragė county;2008;46;1892;961;931
Tauragė county;2008;47;1963;988;975
Tauragė county;2008;48;1741;872;869
Tauragė county;2008;49;1854;929;925
Tauragė county;2008;50;1593;763;830
Tauragė county;2008;51;1451;706;745
Tauragė county;2008;52;1482;719;763
Tauragė county;2008;53;1413;684;729
Tauragė county;2008;54;1267;607;660
Tauragė county;2008;55;1248;597;651
Tauragė county;2008;56;1312;562;750
Tauragė county;2008;57;1294;607;687
Tauragė county;2008;58;1369;622;747
Tauragė county;2008;59;1291;561;730
Tauragė county;2008;60;1111;532;579
Tauragė county;2008;61;1034;436;598
Tauragė county;2008;62;1166;487;679
Tauragė county;2008;63;919;387;532
Tauragė county;2008;64;1178;480;698
Tauragė county;2008;65;1296;534;762
Tauragė county;2008;66;1260;494;766
Tauragė county;2008;67;1106;441;665
Tauragė county;2008;68;1157;440;717
Tauragė county;2008;69;1095;408;687
Tauragė county;2008;70;1134;410;724
Tauragė county;2008;71;1182;420;762
Tauragė county;2008;72;1170;396;774
Tauragė county;2008;73;1085;392;693
Tauragė county;2008;74;1073;338;735
Tauragė county;2008;75;1103;350;753
Tauragė county;2008;76;1026;337;689
Tauragė county;2008;77;1001;325;676
Tauragė county;2008;78;848;243;605
Tauragė county;2008;79;862;248;614
Tauragė county;2008;80;803;221;582
Tauragė county;2008;81;667;195;472
Tauragė county;2008;82;615;165;450
Tauragė county;2008;83;449;137;312
Tauragė county;2008;84;497;138;359
Tauragė county;2008;85;1595;386;1209
Tauragė county;2009;-1;117100;54920;62180
Tauragė county;2009;0;1108;547;561
Tauragė county;2009;1;1080;556;524
Tauragė county;2009;2;1012;525;487
Tauragė county;2009;3;1057;553;504
Tauragė county;2009;4;1044;545;499
Tauragė county;2009;5;1143;590;553
Tauragė county;2009;6;1105;563;542
Tauragė county;2009;7;1165;577;588
Tauragė county;2009;8;1308;655;653
Tauragė county;2009;9;1429;766;663
Tauragė county;2009;10;1465;787;678
Tauragė county;2009;11;1445;752;693
Tauragė county;2009;12;1566;770;796
Tauragė county;2009;13;1700;887;813
Tauragė county;2009;14;1832;932;900
Tauragė county;2009;15;1963;993;970
Tauragė county;2009;16;2203;1092;1111
Tauragė county;2009;17;2102;1071;1031
Tauragė county;2009;18;2167;1071;1096
Tauragė county;2009;19;1982;1036;946
Tauragė county;2009;20;1968;953;1015
Tauragė county;2009;21;2059;1046;1013
Tauragė county;2009;22;1921;994;927
Tauragė county;2009;23;1942;985;957
Tauragė county;2009;24;1770;936;834
Tauragė county;2009;25;1709;878;831
Tauragė county;2009;26;1270;677;593
Tauragė county;2009;27;1079;646;433
Tauragė county;2009;28;1103;609;494
Tauragė county;2009;29;1211;614;597
Tauragė county;2009;30;1202;628;574
Tauragė county;2009;31;1186;639;547
Tauragė county;2009;32;1259;643;616
Tauragė county;2009;33;1298;650;648
Tauragė county;2009;34;1310;675;635
Tauragė county;2009;35;1347;617;730
Tauragė county;2009;36;1500;742;758
Tauragė county;2009;37;1561;751;810
Tauragė county;2009;38;1573;782;791
Tauragė county;2009;39;1639;832;807
Tauragė county;2009;40;1573;761;812
Tauragė county;2009;41;1614;784;830
Tauragė county;2009;42;1601;763;838
Tauragė county;2009;43;1637;837;800
Tauragė county;2009;44;1681;819;862
Tauragė county;2009;45;1678;832;846
Tauragė county;2009;46;1733;873;860
Tauragė county;2009;47;1872;950;922
Tauragė county;2009;48;1926;967;959
Tauragė county;2009;49;1718;861;857
Tauragė county;2009;50;1823;903;920
Tauragė county;2009;51;1570;748;822
Tauragė county;2009;52;1425;697;728
Tauragė county;2009;53;1450;698;752
Tauragė county;2009;54;1388;670;718
Tauragė county;2009;55;1239;595;644
Tauragė county;2009;56;1221;580;641
Tauragė county;2009;57;1278;551;727
Tauragė county;2009;58;1262;590;672
Tauragė county;2009;59;1338;601;737
Tauragė county;2009;60;1262;543;719
Tauragė county;2009;61;1084;517;567
Tauragė county;2009;62;1012;422;590
Tauragė county;2009;63;1131;467;664
Tauragė county;2009;64;905;379;526
Tauragė county;2009;65;1133;454;679
Tauragė county;2009;66;1254;508;746
Tauragė county;2009;67;1225;476;749
Tauragė county;2009;68;1066;417;649
Tauragė county;2009;69;1122;418;704
Tauragė county;2009;70;1063;391;672
Tauragė county;2009;71;1088;383;705
Tauragė county;2009;72;1146;405;741
Tauragė county;2009;73;1127;374;753
Tauragė county;2009;74;1040;369;671
Tauragė county;2009;75;1022;325;697
Tauragė county;2009;76;1060;334;726
Tauragė county;2009;77;973;316;657
Tauragė county;2009;78;952;294;658
Tauragė county;2009;79;779;217;562
Tauragė county;2009;80;787;212;575
Tauragė county;2009;81;743;198;545
Tauragė county;2009;82;598;166;432
Tauragė county;2009;83;558;143;415
Tauragė county;2009;84;406;113;293
Tauragė county;2009;85;1754;434;1320
Tauragė county;2010;-1;114763;53736;61027
Tauragė county;2010;0;1041;517;524
Tauragė county;2010;1;1073;527;546
Tauragė county;2010;2;1051;536;515
Tauragė county;2010;3;999;520;479
Tauragė county;2010;4;1039;547;492
Tauragė county;2010;5;1024;534;490
Tauragė county;2010;6;1131;581;550
Tauragė county;2010;7;1086;554;532
Tauragė county;2010;8;1158;578;580
Tauragė county;2010;9;1301;652;649
Tauragė county;2010;10;1414;759;655
Tauragė county;2010;11;1458;779;679
Tauragė county;2010;12;1433;747;686
Tauragė county;2010;13;1559;768;791
Tauragė county;2010;14;1688;880;808
Tauragė county;2010;15;1820;926;894
Tauragė county;2010;16;1946;985;961
Tauragė county;2010;17;2182;1080;1102
Tauragė county;2010;18;2066;1058;1008
Tauragė county;2010;19;2128;1051;1077
Tauragė county;2010;20;1937;1012;925
Tauragė county;2010;21;1908;927;981
Tauragė county;2010;22;1980;1001;979
Tauragė county;2010;23;1841;952;889
Tauragė county;2010;24;1855;944;911
Tauragė county;2010;25;1685;890;795
Tauragė county;2010;26;1582;823;759
Tauragė county;2010;27;1194;640;554
Tauragė county;2010;28;1019;612;407
Tauragė county;2010;29;1054;584;470
Tauragė county;2010;30;1165;595;570
Tauragė county;2010;31;1156;599;557
Tauragė county;2010;32;1146;624;522
Tauragė county;2010;33;1238;632;606
Tauragė county;2010;34;1257;624;633
Tauragė county;2010;35;1271;655;616
Tauragė county;2010;36;1322;603;719
Tauragė county;2010;37;1476;730;746
Tauragė county;2010;38;1531;729;802
Tauragė county;2010;39;1543;764;779
Tauragė county;2010;40;1620;821;799
Tauragė county;2010;41;1544;740;804
Tauragė county;2010;42;1581;762;819
Tauragė county;2010;43;1582;752;830
Tauragė county;2010;44;1604;820;784
Tauragė county;2010;45;1647;798;849
Tauragė county;2010;46;1647;809;838
Tauragė county;2010;47;1707;854;853
Tauragė county;2010;48;1842;928;914
Tauragė county;2010;49;1885;937;948
Tauragė county;2010;50;1686;838;848
Tauragė county;2010;51;1787;881;906
Tauragė county;2010;52;1542;732;810
Tauragė county;2010;53;1407;680;727
Tauragė county;2010;54;1422;678;744
Tauragė county;2010;55;1354;650;704
Tauragė county;2010;56;1214;580;634
Tauragė county;2010;57;1196;563;633
Tauragė county;2010;58;1260;540;720
Tauragė county;2010;59;1236;571;665
Tauragė county;2010;60;1298;578;720
Tauragė county;2010;61;1232;525;707
Tauragė county;2010;62;1065;503;562
Tauragė county;2010;63;983;402;581
Tauragė county;2010;64;1108;450;658
Tauragė county;2010;65;875;362;513
Tauragė county;2010;66;1094;429;665
Tauragė county;2010;67;1229;493;736
Tauragė county;2010;68;1197;459;738
Tauragė county;2010;69;1025;397;628
Tauragė county;2010;70;1086;396;690
Tauragė county;2010;71;1027;373;654
Tauragė county;2010;72;1050;364;686
Tauragė county;2010;73;1106;387;719
Tauragė county;2010;74;1077;349;728
Tauragė county;2010;75;1007;352;655
Tauragė county;2010;76;962;300;662
Tauragė county;2010;77;992;304;688
Tauragė county;2010;78;919;298;621
Tauragė county;2010;79;895;276;619
Tauragė county;2010;80;743;203;540
Tauragė county;2010;81;723;183;540
Tauragė county;2010;82;686;175;511
Tauragė county;2010;83;546;151;395
Tauragė county;2010;84;494;125;369
Tauragė county;2010;85;1824;449;1375
Tauragė county;2011;-1;110511;51746;58765
Tauragė county;2011;0;907;467;440
Tauragė county;2011;1;954;464;490
Tauragė county;2011;2;942;470;472
Tauragė county;2011;3;994;522;472
Tauragė county;2011;4;936;495;441
Tauragė county;2011;5;938;505;433
Tauragė county;2011;6;986;514;472
Tauragė county;2011;7;1107;563;544
Tauragė county;2011;8;1056;535;521
Tauragė county;2011;9;1133;572;561
Tauragė county;2011;10;1291;663;628
Tauragė county;2011;11;1390;754;636
Tauragė county;2011;12;1411;758;653
Tauragė county;2011;13;1432;739;693
Tauragė county;2011;14;1521;754;767
Tauragė county;2011;15;1675;880;795
Tauragė county;2011;16;1800;903;897
Tauragė county;2011;17;1922;989;933
Tauragė county;2011;18;2101;1054;1047
Tauragė county;2011;19;1731;939;792
Tauragė county;2011;20;1687;875;812
Tauragė county;2011;21;1498;810;688
Tauragė county;2011;22;1432;731;701
Tauragė county;2011;23;1523;802;721
Tauragė county;2011;24;1328;705;623
Tauragė county;2011;25;1338;726;612
Tauragė county;2011;26;1188;644;544
Tauragė county;2011;27;1100;588;512
Tauragė county;2011;28;977;485;492
Tauragė county;2011;29;1037;541;496
Tauragė county;2011;30;1057;533;524
Tauragė county;2011;31;1142;549;593
Tauragė county;2011;32;1177;593;584
Tauragė county;2011;33;1158;621;537
Tauragė county;2011;34;1245;602;643
Tauragė county;2011;35;1319;652;667
Tauragė county;2011;36;1348;678;670
Tauragė county;2011;37;1366;625;741
Tauragė county;2011;38;1513;751;762
Tauragė county;2011;39;1621;781;840
Tauragė county;2011;40;1588;788;800
Tauragė county;2011;41;1674;864;810
Tauragė county;2011;42;1614;775;839
Tauragė county;2011;43;1625;790;835
Tauragė county;2011;44;1615;765;850
Tauragė county;2011;45;1627;835;792
Tauragė county;2011;46;1684;821;863
Tauragė county;2011;47;1663;835;828
Tauragė county;2011;48;1782;895;887
Tauragė county;2011;49;1832;923;909
Tauragė county;2011;50;1881;948;933
Tauragė county;2011;51;1695;836;859
Tauragė county;2011;52;1755;872;883
Tauragė county;2011;53;1525;719;806
Tauragė county;2011;54;1479;722;757
Tauragė county;2011;55;1455;691;764
Tauragė county;2011;56;1374;652;722
Tauragė county;2011;57;1247;603;644
Tauragė county;2011;58;1229;578;651
Tauragė county;2011;59;1314;559;755
Tauragė county;2011;60;1261;580;681
Tauragė county;2011;61;1324;581;743
Tauragė county;2011;62;1245;521;724
Tauragė county;2011;63;1053;485;568
Tauragė county;2011;64;970;387;583
Tauragė county;2011;65;1099;440;659
Tauragė county;2011;66;903;361;542
Tauragė county;2011;67;1117;436;681
Tauragė county;2011;68;1232;467;765
Tauragė county;2011;69;1198;445;753
Tauragė county;2011;70;1040;407;633
Tauragė county;2011;71;1079;393;686
Tauragė county;2011;72;1011;361;650
Tauragė county;2011;73;1038;357;681
Tauragė county;2011;74;1063;369;694
Tauragė county;2011;75;1048;334;714
Tauragė county;2011;76;961;332;629
Tauragė county;2011;77;929;279;650
Tauragė county;2011;78;935;289;646
Tauragė county;2011;79;851;259;592
Tauragė county;2011;80;837;260;577
Tauragė county;2011;81;697;187;510
Tauragė county;2011;82;660;170;490
Tauragė county;2011;83;605;151;454
Tauragė county;2011;84;492;129;363
Tauragė county;2011;85;1924;463;1461
Tauragė county;2012;-1;108125;50658;57467
Tauragė county;2012;0;1027;544;483
Tauragė county;2012;1;900;467;433
Tauragė county;2012;2;946;461;485
Tauragė county;2012;3;929;463;466
Tauragė county;2012;4;974;514;460
Tauragė county;2012;5;915;490;425
Tauragė county;2012;6;921;498;423
Tauragė county;2012;7;978;507;471
Tauragė county;2012;8;1104;563;541
Tauragė county;2012;9;1049;532;517
Tauragė county;2012;10;1129;572;557
Tauragė county;2012;11;1289;660;629
Tauragė county;2012;12;1368;744;624
Tauragė county;2012;13;1395;750;645
Tauragė county;2012;14;1423;735;688
Tauragė county;2012;15;1517;754;763
Tauragė county;2012;16;1669;880;789
Tauragė county;2012;17;1792;901;891
Tauragė county;2012;18;1906;980;926
Tauragė county;2012;19;2024;1025;999
Tauragė county;2012;20;1689;915;774
Tauragė county;2012;21;1627;847;780
Tauragė county;2012;22;1429;776;653
Tauragė county;2012;23;1303;674;629
Tauragė county;2012;24;1432;760;672
Tauragė county;2012;25;1219;657;562
Tauragė county;2012;26;1209;678;531
Tauragė county;2012;27;1096;591;505
Tauragė county;2012;28;1021;550;471
Tauragė county;2012;29;907;445;462
Tauragė county;2012;30;976;502;474
Tauragė county;2012;31;1020;518;502
Tauragė county;2012;32;1104;526;578
Tauragė county;2012;33;1140;571;569
Tauragė county;2012;34;1122;593;529
Tauragė county;2012;35;1210;588;622
Tauragė county;2012;36;1293;641;652
Tauragė county;2012;37;1322;665;657
Tauragė county;2012;38;1335;604;731
Tauragė county;2012;39;1473;724;749
Tauragė county;2012;40;1599;771;828
Tauragė county;2012;41;1545;760;785
Tauragė county;2012;42;1647;848;799
Tauragė county;2012;43;1590;764;826
Tauragė county;2012;44;1605;781;824
Tauragė county;2012;45;1582;745;837
Tauragė county;2012;46;1602;820;782
Tauragė county;2012;47;1661;808;853
Tauragė county;2012;48;1648;828;820
Tauragė county;2012;49;1767;893;874
Tauragė county;2012;50;1790;904;886
Tauragė county;2012;51;1863;933;930
Tauragė county;2012;52;1675;824;851
Tauragė county;2012;53;1734;861;873
Tauragė county;2012;54;1505;710;795
Tauragė county;2012;55;1459;708;751
Tauragė county;2012;56;1430;676;754
Tauragė county;2012;57;1357;641;716
Tauragė county;2012;58;1228;589;639
Tauragė county;2012;59;1200;559;641
Tauragė county;2012;60;1291;542;749
Tauragė county;2012;61;1245;570;675
Tauragė county;2012;62;1301;566;735
Tauragė county;2012;63;1211;496;715
Tauragė county;2012;64;1033;473;560
Tauragė county;2012;65;928;356;572
Tauragė county;2012;66;1063;417;646
Tauragė county;2012;67;879;343;536
Tauragė county;2012;68;1081;418;663
Tauragė county;2012;69;1199;445;754
Tauragė county;2012;70;1159;425;734
Tauragė county;2012;71;992;380;612
Tauragė county;2012;72;1055;378;677
Tauragė county;2012;73;975;337;638
Tauragė county;2012;74;997;341;656
Tauragė county;2012;75;1010;342;668
Tauragė county;2012;76;998;313;685
Tauragė county;2012;77;915;310;605
Tauragė county;2012;78;874;249;625
Tauragė county;2012;79;883;262;621
Tauragė county;2012;80;785;236;549
Tauragė county;2012;81;758;234;524
Tauragė county;2012;82;630;162;468
Tauragė county;2012;83;601;150;451
Tauragė county;2012;84;528;125;403
Tauragė county;2012;85;2065;500;1565
Tauragė county;2013;-1;106335;49863;56472
Tauragė county;2013;0;1090;579;511
Tauragė county;2013;1;1011;536;475
Tauragė county;2013;2;869;447;422
Tauragė county;2013;3;942;454;488
Tauragė county;2013;4;920;460;460
Tauragė county;2013;5;958;507;451
Tauragė county;2013;6;901;483;418
Tauragė county;2013;7;911;492;419
Tauragė county;2013;8;969;501;468
Tauragė county;2013;9;1096;559;537
Tauragė county;2013;10;1036;526;510
Tauragė county;2013;11;1122;571;551
Tauragė county;2013;12;1282;653;629
Tauragė county;2013;13;1358;744;614
Tauragė county;2013;14;1393;747;646
Tauragė county;2013;15;1408;725;683
Tauragė county;2013;16;1508;750;758
Tauragė county;2013;17;1659;877;782
Tauragė county;2013;18;1764;889;875
Tauragė county;2013;19;1859;951;908
Tauragė county;2013;20;1978;1006;972
Tauragė county;2013;21;1647;901;746
Tauragė county;2013;22;1558;824;734
Tauragė county;2013;23;1345;742;603
Tauragė county;2013;24;1246;667;579
Tauragė county;2013;25;1374;740;634
Tauragė county;2013;26;1160;628;532
Tauragė county;2013;27;1112;625;487
Tauragė county;2013;28;1011;547;464
Tauragė county;2013;29;961;521;440
Tauragė county;2013;30;859;419;440
Tauragė county;2013;31;930;477;453
Tauragė county;2013;32;987;501;486
Tauragė county;2013;33;1068;498;570
Tauragė county;2013;34;1117;570;547
Tauragė county;2013;35;1094;579;515
Tauragė county;2013;36;1185;572;613
Tauragė county;2013;37;1273;620;653
Tauragė county;2013;38;1300;658;642
Tauragė county;2013;39;1333;603;730
Tauragė county;2013;40;1457;718;739
Tauragė county;2013;41;1592;766;826
Tauragė county;2013;42;1516;745;771
Tauragė county;2013;43;1632;842;790
Tauragė county;2013;44;1581;760;821
Tauragė county;2013;45;1592;776;816
Tauragė county;2013;46;1553;731;822
Tauragė county;2013;47;1586;811;775
Tauragė county;2013;48;1649;803;846
Tauragė county;2013;49;1632;819;813
Tauragė county;2013;50;1750;880;870
Tauragė county;2013;51;1777;897;880
Tauragė county;2013;52;1841;916;925
Tauragė county;2013;53;1654;811;843
Tauragė county;2013;54;1713;847;866
Tauragė county;2013;55;1487;699;788
Tauragė county;2013;56;1439;694;745
Tauragė county;2013;57;1409;662;747
Tauragė county;2013;58;1345;629;716
Tauragė county;2013;59;1212;575;637
Tauragė county;2013;60;1183;545;638
Tauragė county;2013;61;1268;524;744
Tauragė county;2013;62;1215;550;665
Tauragė county;2013;63;1280;551;729
Tauragė county;2013;64;1182;478;704
Tauragė county;2013;65;1017;464;553
Tauragė county;2013;66;912;345;567
Tauragė county;2013;67;1038;394;644
Tauragė county;2013;68;856;329;527
Tauragė county;2013;69;1049;403;646
Tauragė county;2013;70;1161;416;745
Tauragė county;2013;71;1118;407;711
Tauragė county;2013;72;962;363;599
Tauragė county;2013;73;1024;357;667
Tauragė county;2013;74;935;319;616
Tauragė county;2013;75;963;321;642
Tauragė county;2013;76;966;323;643
Tauragė county;2013;77;951;289;662
Tauragė county;2013;78;866;280;586
Tauragė county;2013;79;827;225;602
Tauragė county;2013;80;831;241;590
Tauragė county;2013;81;728;211;517
Tauragė county;2013;82;698;207;491
Tauragė county;2013;83;567;144;423
Tauragė county;2013;84;541;130;411
Tauragė county;2013;85;2186;517;1669
Tauragė county;2014;-1;104623;49124;55499
Tauragė county;2014;0;1086;570;516
Tauragė county;2014;1;1080;575;505
Tauragė county;2014;2;986;519;467
Tauragė county;2014;3;848;436;412
Tauragė county;2014;4;920;445;475
Tauragė county;2014;5;900;454;446
Tauragė county;2014;6;939;493;446
Tauragė county;2014;7;892;479;413
Tauragė county;2014;8;913;496;417
Tauragė county;2014;9;973;502;471
Tauragė county;2014;10;1085;551;534
Tauragė county;2014;11;1029;521;508
Tauragė county;2014;12;1113;565;548
Tauragė county;2014;13;1280;656;624
Tauragė county;2014;14;1353;745;608
Tauragė county;2014;15;1376;735;641
Tauragė county;2014;16;1394;717;677
Tauragė county;2014;17;1502;746;756
Tauragė county;2014;18;1647;873;774
Tauragė county;2014;19;1720;875;845
Tauragė county;2014;20;1834;935;899
Tauragė county;2014;21;1948;986;962
Tauragė county;2014;22;1603;887;716
Tauragė county;2014;23;1498;804;694
Tauragė county;2014;24;1312;751;561
Tauragė county;2014;25;1199;644;555
Tauragė county;2014;26;1324;733;591
Tauragė county;2014;27;1113;603;510
Tauragė county;2014;28;1054;608;446
Tauragė county;2014;29;956;515;441
Tauragė county;2014;30;931;508;423
Tauragė county;2014;31;837;411;426
Tauragė county;2014;32;902;457;445
Tauragė county;2014;33;969;501;468
Tauragė county;2014;34;1030;467;563
Tauragė county;2014;35;1082;544;538
Tauragė county;2014;36;1084;569;515
Tauragė county;2014;37;1165;557;608
Tauragė county;2014;38;1261;612;649
Tauragė county;2014;39;1280;649;631
Tauragė county;2014;40;1319;599;720
Tauragė county;2014;41;1440;709;731
Tauragė county;2014;42;1577;761;816
Tauragė county;2014;43;1515;744;771
Tauragė county;2014;44;1620;834;786
Tauragė county;2014;45;1562;752;810
Tauragė county;2014;46;1576;764;812
Tauragė county;2014;47;1538;725;813
Tauragė county;2014;48;1564;797;767
Tauragė county;2014;49;1630;792;838
Tauragė county;2014;50;1609;806;803
Tauragė county;2014;51;1727;865;862
Tauragė county;2014;52;1761;883;878
Tauragė county;2014;53;1826;906;920
Tauragė county;2014;54;1634;800;834
Tauragė county;2014;55;1674;820;854
Tauragė county;2014;56;1476;694;782
Tauragė county;2014;57;1414;680;734
Tauragė county;2014;58;1383;641;742
Tauragė county;2014;59;1327;611;716
Tauragė county;2014;60;1193;563;630
Tauragė county;2014;61;1162;526;636
Tauragė county;2014;62;1243;507;736
Tauragė county;2014;63;1192;531;661
Tauragė county;2014;64;1245;529;716
Tauragė county;2014;65;1155;463;692
Tauragė county;2014;66;991;440;551
Tauragė county;2014;67;886;327;559
Tauragė county;2014;68;996;366;630
Tauragė county;2014;69;833;314;519
Tauragė county;2014;70;1017;383;634
Tauragė county;2014;71;1125;394;731
Tauragė county;2014;72;1078;388;690
Tauragė county;2014;73;932;342;590
Tauragė county;2014;74;986;340;646
Tauragė county;2014;75;901;305;596
Tauragė county;2014;76;927;302;625
Tauragė county;2014;77;909;294;615
Tauragė county;2014;78;904;271;633
Tauragė county;2014;79;811;251;560
Tauragė county;2014;80;761;197;564
Tauragė county;2014;81;763;217;546
Tauragė county;2014;82;660;185;475
Tauragė county;2014;83;626;177;449
Tauragė county;2014;84;494;126;368
Tauragė county;2014;85;2243;509;1734
Tauragė county;2015;-1;103083;48469;54614
Tauragė county;2015;0;1075;564;511
Tauragė county;2015;1;1088;573;515
Tauragė county;2015;2;1038;550;488
Tauragė county;2015;3;975;511;464
Tauragė county;2015;4;828;422;406
Tauragė county;2015;5;912;436;476
Tauragė county;2015;6;871;439;432
Tauragė county;2015;7;928;493;435
Tauragė county;2015;8;874;470;404
Tauragė county;2015;9;905;492;413
Tauragė county;2015;10;961;493;468
Tauragė county;2015;11;1074;550;524
Tauragė county;2015;12;1029;521;508
Tauragė county;2015;13;1105;560;545
Tauragė county;2015;14;1271;650;621
Tauragė county;2015;15;1349;745;604
Tauragė county;2015;16;1371;737;634
Tauragė county;2015;17;1388;713;675
Tauragė county;2015;18;1481;737;744
Tauragė county;2015;19;1617;854;763
Tauragė county;2015;20;1677;855;822
Tauragė county;2015;21;1804;930;874
Tauragė county;2015;22;1900;967;933
Tauragė county;2015;23;1545;870;675
Tauragė county;2015;24;1430;784;646
Tauragė county;2015;25;1245;726;519
Tauragė county;2015;26;1165;629;536
Tauragė county;2015;27;1252;692;560
Tauragė county;2015;28;1065;580;485
Tauragė county;2015;29;1012;578;434
Tauragė county;2015;30;925;502;423
Tauragė county;2015;31;906;500;406
Tauragė county;2015;32;798;393;405
Tauragė county;2015;33;891;450;441
Tauragė county;2015;34;942;480;462
Tauragė county;2015;35;1001;462;539
Tauragė county;2015;36;1041;522;519
Tauragė county;2015;37;1069;554;515
Tauragė county;2015;38;1137;543;594
Tauragė county;2015;39;1257;609;648
Tauragė county;2015;40;1267;635;632
Tauragė county;2015;41;1303;589;714
Tauragė county;2015;42;1425;697;728
Tauragė county;2015;43;1565;757;808
Tauragė county;2015;44;1495;725;770
Tauragė county;2015;45;1607;824;783
Tauragė county;2015;46;1545;738;807
Tauragė county;2015;47;1562;756;806
Tauragė county;2015;48;1537;721;816
Tauragė county;2015;49;1569;805;764
Tauragė county;2015;50;1617;780;837
Tauragė county;2015;51;1595;800;795
Tauragė county;2015;52;1727;866;861
Tauragė county;2015;53;1747;878;869
Tauragė county;2015;54;1809;897;912
Tauragė county;2015;55;1616;781;835
Tauragė county;2015;56;1656;810;846
Tauragė county;2015;57;1463;680;783
Tauragė county;2015;58;1398;670;728
Tauragė county;2015;59;1361;625;736
Tauragė county;2015;60;1307;598;709
Tauragė county;2015;61;1171;544;627
Tauragė county;2015;62;1143;514;629
Tauragė county;2015;63;1224;493;731
Tauragė county;2015;64;1170;515;655
Tauragė county;2015;65;1212;513;699
Tauragė county;2015;66;1123;441;682
Tauragė county;2015;67;979;432;547
Tauragė county;2015;68;869;315;554
Tauragė county;2015;69;975;354;621
Tauragė county;2015;70;809;300;509
Tauragė county;2015;71;986;362;624
Tauragė county;2015;72;1087;375;712
Tauragė county;2015;73;1048;375;673
Tauragė county;2015;74;901;327;574
Tauragė county;2015;75;952;323;629
Tauragė county;2015;76;854;280;574
Tauragė county;2015;77;876;270;606
Tauragė county;2015;78;855;263;592
Tauragė county;2015;79;850;249;601
Tauragė county;2015;80;768;230;538
Tauragė county;2015;81;703;183;520
Tauragė county;2015;82;702;194;508
Tauragė county;2015;83;600;162;438
Tauragė county;2015;84;564;157;407
Tauragė county;2015;85;2289;530;1759
Tauragė county;2016;-1;101200;47538;53662
Tauragė county;2016;0;1146;575;571
Tauragė county;2016;1;1067;560;507
Tauragė county;2016;2;1072;567;505
Tauragė county;2016;3;1026;540;486
Tauragė county;2016;4;963;502;461
Tauragė county;2016;5;813;413;400
Tauragė county;2016;6;891;425;466
Tauragė county;2016;7;862;441;421
Tauragė county;2016;8;917;487;430
Tauragė county;2016;9;880;471;409
Tauragė county;2016;10;889;482;407
Tauragė county;2016;11;943;478;465
Tauragė county;2016;12;1067;548;519
Tauragė county;2016;13;1024;516;508
Tauragė county;2016;14;1097;558;539
Tauragė county;2016;15;1256;647;609
Tauragė county;2016;16;1340;742;598
Tauragė county;2016;17;1361;732;629
Tauragė county;2016;18;1376;704;672
Tauragė county;2016;19;1436;715;721
Tauragė county;2016;20;1573;828;745
Tauragė county;2016;21;1638;828;810
Tauragė county;2016;22;1729;894;835
Tauragė county;2016;23;1802;915;887
Tauragė county;2016;24;1456;821;635
Tauragė county;2016;25;1340;746;594
Tauragė county;2016;26;1191;687;504
Tauragė county;2016;27;1102;606;496
Tauragė county;2016;28;1195;669;526
Tauragė county;2016;29;990;548;442
Tauragė county;2016;30;952;553;399
Tauragė county;2016;31;896;486;410
Tauragė county;2016;32;874;477;397
Tauragė county;2016;33;778;382;396
Tauragė county;2016;34;869;444;425
Tauragė county;2016;35;913;463;450
Tauragė county;2016;36;981;445;536
Tauragė county;2016;37;1020;513;507
Tauragė county;2016;38;1044;543;501
Tauragė county;2016;39;1113;525;588
Tauragė county;2016;40;1243;604;639
Tauragė county;2016;41;1245;621;624
Tauragė county;2016;42;1282;578;704
Tauragė county;2016;43;1405;682;723
Tauragė county;2016;44;1558;759;799
Tauragė county;2016;45;1470;713;757
Tauragė county;2016;46;1594;811;783
Tauragė county;2016;47;1530;728;802
Tauragė county;2016;48;1542;744;798
Tauragė county;2016;49;1519;714;805
Tauragė county;2016;50;1551;789;762
Tauragė county;2016;51;1612;775;837
Tauragė county;2016;52;1582;790;792
Tauragė county;2016;53;1698;847;851
Tauragė county;2016;54;1724;863;861
Tauragė county;2016;55;1779;874;905
Tauragė county;2016;56;1586;764;822
Tauragė county;2016;57;1630;795;835
Tauragė county;2016;58;1442;665;777
Tauragė county;2016;59;1386;663;723
Tauragė county;2016;60;1330;601;729
Tauragė county;2016;61;1276;571;705
Tauragė county;2016;62;1153;531;622
Tauragė county;2016;63;1125;501;624
Tauragė county;2016;64;1201;480;721
Tauragė county;2016;65;1146;496;650
Tauragė county;2016;66;1190;495;695
Tauragė county;2016;67;1087;417;670
Tauragė county;2016;68;945;405;540
Tauragė county;2016;69;838;301;537
Tauragė county;2016;70;943;332;611
Tauragė county;2016;71;787;287;500
Tauragė county;2016;72;960;347;613
Tauragė county;2016;73;1049;350;699
Tauragė county;2016;74;1008;355;653
Tauragė county;2016;75;858;301;557
Tauragė county;2016;76;910;304;606
Tauragė county;2016;77;811;262;549
Tauragė county;2016;78;841;249;592
Tauragė county;2016;79;796;243;553
Tauragė county;2016;80;791;228;563
Tauragė county;2016;81;699;201;498
Tauragė county;2016;82;644;158;486
Tauragė county;2016;83;635;168;467
Tauragė county;2016;84;544;147;397
Tauragė county;2016;85;2373;553;1820
Tauragė county;2017;-1;98608;46363;52245
Tauragė county;2017;0;1051;540;511
Tauragė county;2017;1;1128;563;565
Tauragė county;2017;2;1037;542;495
Tauragė county;2017;3;1054;557;497
Tauragė county;2017;4;995;521;474
Tauragė county;2017;5;945;490;455
Tauragė county;2017;6;797;408;389
Tauragė county;2017;7;883;424;459
Tauragė county;2017;8;844;434;410
Tauragė county;2017;9;909;486;423
Tauragė county;2017;10;872;464;408
Tauragė county;2017;11;877;476;401
Tauragė county;2017;12;935;473;462
Tauragė county;2017;13;1050;537;513
Tauragė county;2017;14;1007;514;493
Tauragė county;2017;15;1086;554;532
Tauragė county;2017;16;1239;636;603
Tauragė county;2017;17;1325;733;592
Tauragė county;2017;18;1343;726;617
Tauragė county;2017;19;1325;682;643
Tauragė county;2017;20;1406;696;710
Tauragė county;2017;21;1521;797;724
Tauragė county;2017;22;1580;811;769
Tauragė county;2017;23;1630;860;770
Tauragė county;2017;24;1710;880;830
Tauragė county;2017;25;1368;780;588
Tauragė county;2017;26;1224;709;515
Tauragė county;2017;27;1077;632;445
Tauragė county;2017;28;1005;569;436
Tauragė county;2017;29;1105;639;466
Tauragė county;2017;30;898;485;413
Tauragė county;2017;31;872;508;364
Tauragė county;2017;32;829;453;376
Tauragė county;2017;33;825;447;378
Tauragė county;2017;34;716;341;375
Tauragė county;2017;35;811;411;400
Tauragė county;2017;36;893;456;437
Tauragė county;2017;37;932;413;519
Tauragė county;2017;38;984;491;493
Tauragė county;2017;39;1026;534;492
Tauragė county;2017;40;1087;511;576
Tauragė county;2017;41;1212;594;618
Tauragė county;2017;42;1215;605;610
Tauragė county;2017;43;1260;561;699
Tauragė county;2017;44;1373;666;707
Tauragė county;2017;45;1537;755;782
Tauragė county;2017;46;1447;695;752
Tauragė county;2017;47;1575;798;777
Tauragė county;2017;48;1519;724;795
Tauragė county;2017;49;1524;734;790
Tauragė county;2017;50;1498;703;795
Tauragė county;2017;51;1522;772;750
Tauragė county;2017;52;1581;755;826
Tauragė county;2017;53;1551;769;782
Tauragė county;2017;54;1678;831;847
Tauragė county;2017;55;1696;850;846
Tauragė county;2017;56;1739;848;891
Tauragė county;2017;57;1565;747;818
Tauragė county;2017;58;1604;773;831
Tauragė county;2017;59;1414;650;764
Tauragė county;2017;60;1361;647;714
Tauragė county;2017;61;1303;584;719
Tauragė county;2017;62;1257;553;704
Tauragė county;2017;63;1128;515;613
Tauragė county;2017;64;1093;480;613
Tauragė county;2017;65;1176;461;715
Tauragė county;2017;66;1120;484;636
Tauragė county;2017;67;1151;472;679
Tauragė county;2017;68;1064;404;660
Tauragė county;2017;69;921;388;533
Tauragė county;2017;70;826;291;535
Tauragė county;2017;71;903;306;597
Tauragė county;2017;72;757;275;482
Tauragė county;2017;73;929;336;593
Tauragė county;2017;74;998;330;668
Tauragė county;2017;75;964;328;636
Tauragė county;2017;76;815;279;536
Tauragė county;2017;77;874;284;590
Tauragė county;2017;78;776;245;531
Tauragė county;2017;79;794;230;564
Tauragė county;2017;80;743;223;520
Tauragė county;2017;81;733;204;529
Tauragė county;2017;82;632;177;455
Tauragė county;2017;83;579;136;443
Tauragė county;2017;84;582;145;437
Tauragė county;2017;85;2418;573;1845
Tauragė county;2018;-1;95817;44998;50819
Tauragė county;2018;0;954;492;462
Tauragė county;2018;1;1040;531;509
Tauragė county;2018;2;1091;547;544
Tauragė county;2018;3;1029;537;492
Tauragė county;2018;4;1025;543;482
Tauragė county;2018;5;993;527;466
Tauragė county;2018;6;932;487;445
Tauragė county;2018;7;787;397;390
Tauragė county;2018;8;878;421;457
Tauragė county;2018;9;829;431;398
Tauragė county;2018;10;892;475;417
Tauragė county;2018;11;858;459;399
Tauragė county;2018;12;863;469;394
Tauragė county;2018;13;924;464;460
Tauragė county;2018;14;1031;524;507
Tauragė county;2018;15;997;511;486
Tauragė county;2018;16;1071;547;524
Tauragė county;2018;17;1235;635;600
Tauragė county;2018;18;1298;720;578
Tauragė county;2018;19;1266;685;581
Tauragė county;2018;20;1268;656;612
Tauragė county;2018;21;1322;656;666
Tauragė county;2018;22;1442;757;685
Tauragė county;2018;23;1482;766;716
Tauragė county;2018;24;1497;797;700
Tauragė county;2018;25;1561;800;761
Tauragė county;2018;26;1232;720;512
Tauragė county;2018;27;1118;657;461
Tauragė county;2018;28;969;578;391
Tauragė county;2018;29;903;522;381
Tauragė county;2018;30;1014;583;431
Tauragė county;2018;31;818;454;364
Tauragė county;2018;32;791;461;330
Tauragė county;2018;33;770;423;347
Tauragė county;2018;34;763;406;357
Tauragė county;2018;35;673;313;360
Tauragė county;2018;36;773;386;387
Tauragė county;2018;37;854;433;421
Tauragė county;2018;38;907;395;512
Tauragė county;2018;39;953;471;482
Tauragė county;2018;40;999;513;486
Tauragė county;2018;41;1067;503;564
Tauragė county;2018;42;1189;582;607
Tauragė county;2018;43;1185;587;598
Tauragė county;2018;44;1240;551;689
Tauragė county;2018;45;1354;652;702
Tauragė county;2018;46;1518;747;771
Tauragė county;2018;47;1427;686;741
Tauragė county;2018;48;1556;786;770
Tauragė county;2018;49;1498;715;783
Tauragė county;2018;50;1502;717;785
Tauragė county;2018;51;1488;703;785
Tauragė county;2018;52;1504;762;742
Tauragė county;2018;53;1560;741;819
Tauragė county;2018;54;1534;754;780
Tauragė county;2018;55;1648;811;837
Tauragė county;2018;56;1669;823;846
Tauragė county;2018;57;1709;832;877
Tauragė county;2018;58;1538;725;813
Tauragė county;2018;59;1589;756;833
Tauragė county;2018;60;1391;633;758
Tauragė county;2018;61;1338;629;709
Tauragė county;2018;62;1276;565;711
Tauragė county;2018;63;1232;537;695
Tauragė county;2018;64;1095;494;601
Tauragė county;2018;65;1074;470;604
Tauragė county;2018;66;1152;446;706
Tauragė county;2018;67;1086;462;624
Tauragė county;2018;68;1121;452;669
Tauragė county;2018;69;1041;389;652
Tauragė county;2018;70;898;371;527
Tauragė county;2018;71;803;277;526
Tauragė county;2018;72;875;289;586
Tauragė county;2018;73;723;253;470
Tauragė county;2018;74;898;314;584
Tauragė county;2018;75;951;308;643
Tauragė county;2018;76;924;306;618
Tauragė county;2018;77;784;263;521
Tauragė county;2018;78;831;262;569
Tauragė county;2018;79;733;230;503
Tauragė county;2018;80;744;212;532
Tauragė county;2018;81;697;207;490
Tauragė county;2018;82;678;183;495
Tauragė county;2018;83;572;151;421
Tauragė county;2018;84;533;129;404
Tauragė county;2018;85;2490;584;1906
Tauragė d. mun.;2001;-1;52732;24815;27917
Tauragė d. mun.;2001;0;524;279;245
Tauragė d. mun.;2001;1;559;291;268
Tauragė d. mun.;2001;2;566;300;266
Tauragė d. mun.;2001;3;590;311;279
Tauragė d. mun.;2001;4;658;315;343
Tauragė d. mun.;2001;5;721;380;341
Tauragė d. mun.;2001;6;717;362;355
Tauragė d. mun.;2001;7;775;392;383
Tauragė d. mun.;2001;8;905;448;457
Tauragė d. mun.;2001;9;880;456;424
Tauragė d. mun.;2001;10;983;481;502
Tauragė d. mun.;2001;11;889;464;425
Tauragė d. mun.;2001;12;956;452;504
Tauragė d. mun.;2001;13;951;474;477
Tauragė d. mun.;2001;14;940;479;461
Tauragė d. mun.;2001;15;942;461;481
Tauragė d. mun.;2001;16;874;452;422
Tauragė d. mun.;2001;17;851;442;409
Tauragė d. mun.;2001;18;639;329;310
Tauragė d. mun.;2001;19;565;330;235
Tauragė d. mun.;2001;20;528;285;243
Tauragė d. mun.;2001;21;613;310;303
Tauragė d. mun.;2001;22;610;314;296
Tauragė d. mun.;2001;23;597;333;264
Tauragė d. mun.;2001;24;673;346;327
Tauragė d. mun.;2001;25;702;347;355
Tauragė d. mun.;2001;26;709;370;339
Tauragė d. mun.;2001;27;694;307;387
Tauragė d. mun.;2001;28;792;405;387
Tauragė d. mun.;2001;29;761;382;379
Tauragė d. mun.;2001;30;777;408;369
Tauragė d. mun.;2001;31;725;383;342
Tauragė d. mun.;2001;32;796;369;427
Tauragė d. mun.;2001;33;768;381;387
Tauragė d. mun.;2001;34;783;374;409
Tauragė d. mun.;2001;35;769;383;386
Tauragė d. mun.;2001;36;778;397;381
Tauragė d. mun.;2001;37;763;385;378
Tauragė d. mun.;2001;38;799;423;376
Tauragė d. mun.;2001;39;824;421;403
Tauragė d. mun.;2001;40;915;463;452
Tauragė d. mun.;2001;41;795;384;411
Tauragė d. mun.;2001;42;791;404;387
Tauragė d. mun.;2001;43;722;353;369
Tauragė d. mun.;2001;44;666;331;335
Tauragė d. mun.;2001;45;677;317;360
Tauragė d. mun.;2001;46;634;306;328
Tauragė d. mun.;2001;47;610;301;309
Tauragė d. mun.;2001;48;575;276;299
Tauragė d. mun.;2001;49;590;260;330
Tauragė d. mun.;2001;50;598;288;310
Tauragė d. mun.;2001;51;627;295;332
Tauragė d. mun.;2001;52;593;270;323
Tauragė d. mun.;2001;53;529;267;262
Tauragė d. mun.;2001;54;501;222;279
Tauragė d. mun.;2001;55;550;235;315
Tauragė d. mun.;2001;56;436;183;253
Tauragė d. mun.;2001;57;568;236;332
Tauragė d. mun.;2001;58;640;308;332
Tauragė d. mun.;2001;59;565;238;327
Tauragė d. mun.;2001;60;537;226;311
Tauragė d. mun.;2001;61;519;217;302
Tauragė d. mun.;2001;62;547;222;325
Tauragė d. mun.;2001;63;538;223;315
Tauragė d. mun.;2001;64;544;204;340
Tauragė d. mun.;2001;65;586;229;357
Tauragė d. mun.;2001;66;554;221;333
Tauragė d. mun.;2001;67;537;213;324
Tauragė d. mun.;2001;68;553;193;360
Tauragė d. mun.;2001;69;500;192;308
Tauragė d. mun.;2001;70;485;178;307
Tauragė d. mun.;2001;71;425;144;281
Tauragė d. mun.;2001;72;463;147;316
Tauragė d. mun.;2001;73;428;133;295
Tauragė d. mun.;2001;74;381;133;248
Tauragė d. mun.;2001;75;342;102;240
Tauragė d. mun.;2001;76;307;101;206
Tauragė d. mun.;2001;77;310;107;203
Tauragė d. mun.;2001;78;241;70;171
Tauragė d. mun.;2001;79;234;65;169
Tauragė d. mun.;2001;80;196;46;150
Tauragė d. mun.;2001;81;180;56;124
Tauragė d. mun.;2001;82;97;28;69
Tauragė d. mun.;2001;83;91;28;63
Tauragė d. mun.;2001;84;96;31;65
Tauragė d. mun.;2001;85;513;148;365
Tauragė d. mun.;2002;-1;52196;24454;27742
Tauragė d. mun.;2002;0;458;224;234
Tauragė d. mun.;2002;1;513;271;242
Tauragė d. mun.;2002;2;555;288;267
Tauragė d. mun.;2002;3;561;295;266
Tauragė d. mun.;2002;4;581;308;273
Tauragė d. mun.;2002;5;659;318;341
Tauragė d. mun.;2002;6;715;376;339
Tauragė d. mun.;2002;7;713;361;352
Tauragė d. mun.;2002;8;773;392;381
Tauragė d. mun.;2002;9;898;444;454
Tauragė d. mun.;2002;10;874;451;423
Tauragė d. mun.;2002;11;972;475;497
Tauragė d. mun.;2002;12;872;454;418
Tauragė d. mun.;2002;13;940;441;499
Tauragė d. mun.;2002;14;935;463;472
Tauragė d. mun.;2002;15;924;470;454
Tauragė d. mun.;2002;16;932;455;477
Tauragė d. mun.;2002;17;856;440;416
Tauragė d. mun.;2002;18;828;431;397
Tauragė d. mun.;2002;19;617;320;297
Tauragė d. mun.;2002;20;550;317;233
Tauragė d. mun.;2002;21;519;280;239
Tauragė d. mun.;2002;22;615;303;312
Tauragė d. mun.;2002;23;605;306;299
Tauragė d. mun.;2002;24;597;326;271
Tauragė d. mun.;2002;25;661;338;323
Tauragė d. mun.;2002;26;695;342;353
Tauragė d. mun.;2002;27;697;357;340
Tauragė d. mun.;2002;28;676;293;383
Tauragė d. mun.;2002;29;779;398;381
Tauragė d. mun.;2002;30;752;375;377
Tauragė d. mun.;2002;31;763;402;361
Tauragė d. mun.;2002;32;711;372;339
Tauragė d. mun.;2002;33;782;361;421
Tauragė d. mun.;2002;34;755;372;383
Tauragė d. mun.;2002;35;769;363;406
Tauragė d. mun.;2002;36;758;376;382
Tauragė d. mun.;2002;37;767;385;382
Tauragė d. mun.;2002;38;748;375;373
Tauragė d. mun.;2002;39;777;409;368
Tauragė d. mun.;2002;40;801;405;396
Tauragė d. mun.;2002;41;904;455;449
Tauragė d. mun.;2002;42;784;377;407
Tauragė d. mun.;2002;43;785;400;385
Tauragė d. mun.;2002;44;709;345;364
Tauragė d. mun.;2002;45;657;324;333
Tauragė d. mun.;2002;46;663;311;352
Tauragė d. mun.;2002;47;630;305;325
Tauragė d. mun.;2002;48;597;293;304
Tauragė d. mun.;2002;49;562;267;295
Tauragė d. mun.;2002;50;579;250;329
Tauragė d. mun.;2002;51;584;278;306
Tauragė d. mun.;2002;52;615;287;328
Tauragė d. mun.;2002;53;591;269;322
Tauragė d. mun.;2002;54;520;262;258
Tauragė d. mun.;2002;55;490;218;272
Tauragė d. mun.;2002;56;535;227;308
Tauragė d. mun.;2002;57;422;178;244
Tauragė d. mun.;2002;58;548;223;325
Tauragė d. mun.;2002;59;623;301;322
Tauragė d. mun.;2002;60;555;232;323
Tauragė d. mun.;2002;61;531;220;311
Tauragė d. mun.;2002;62;517;212;305
Tauragė d. mun.;2002;63;542;217;325
Tauragė d. mun.;2002;64;530;218;312
Tauragė d. mun.;2002;65;537;202;335
Tauragė d. mun.;2002;66;579;225;354
Tauragė d. mun.;2002;67;541;217;324
Tauragė d. mun.;2002;68;521;202;319
Tauragė d. mun.;2002;69;543;188;355
Tauragė d. mun.;2002;70;486;181;305
Tauragė d. mun.;2002;71;478;171;307
Tauragė d. mun.;2002;72;415;140;275
Tauragė d. mun.;2002;73;452;144;308
Tauragė d. mun.;2002;74;418;132;286
Tauragė d. mun.;2002;75;370;129;241
Tauragė d. mun.;2002;76;329;96;233
Tauragė d. mun.;2002;77;299;97;202
Tauragė d. mun.;2002;78;294;101;193
Tauragė d. mun.;2002;79;234;68;166
Tauragė d. mun.;2002;80;229;65;164
Tauragė d. mun.;2002;81;182;43;139
Tauragė d. mun.;2002;82;161;49;112
Tauragė d. mun.;2002;83;91;26;65
Tauragė d. mun.;2002;84;79;25;54
Tauragė d. mun.;2002;85;532;152;380
Tauragė d. mun.;2003;-1;51861;24225;27636
Tauragė d. mun.;2003;0;431;212;219
Tauragė d. mun.;2003;1;465;230;235
Tauragė d. mun.;2003;2;512;270;242
Tauragė d. mun.;2003;3;553;286;267
Tauragė d. mun.;2003;4;560;293;267
Tauragė d. mun.;2003;5;579;307;272
Tauragė d. mun.;2003;6;654;314;340
Tauragė d. mun.;2003;7;712;373;339
Tauragė d. mun.;2003;8;716;361;355
Tauragė d. mun.;2003;9;771;390;381
Tauragė d. mun.;2003;10;895;441;454
Tauragė d. mun.;2003;11;871;449;422
Tauragė d. mun.;2003;12;959;469;490
Tauragė d. mun.;2003;13;863;447;416
Tauragė d. mun.;2003;14;927;433;494
Tauragė d. mun.;2003;15;922;454;468
Tauragė d. mun.;2003;16;912;461;451
Tauragė d. mun.;2003;17;919;447;472
Tauragė d. mun.;2003;18;849;435;414
Tauragė d. mun.;2003;19;824;429;395
Tauragė d. mun.;2003;20;616;321;295
Tauragė d. mun.;2003;21;547;315;232
Tauragė d. mun.;2003;22;523;281;242
Tauragė d. mun.;2003;23;619;302;317
Tauragė d. mun.;2003;24;610;306;304
Tauragė d. mun.;2003;25;600;329;271
Tauragė d. mun.;2003;26;661;334;327
Tauragė d. mun.;2003;27;683;335;348
Tauragė d. mun.;2003;28;690;350;340
Tauragė d. mun.;2003;29;675;294;381
Tauragė d. mun.;2003;30;777;399;378
Tauragė d. mun.;2003;31;739;370;369
Tauragė d. mun.;2003;32;755;397;358
Tauragė d. mun.;2003;33;702;367;335
Tauragė d. mun.;2003;34;773;354;419
Tauragė d. mun.;2003;35;745;364;381
Tauragė d. mun.;2003;36;752;353;399
Tauragė d. mun.;2003;37;755;374;381
Tauragė d. mun.;2003;38;759;379;380
Tauragė d. mun.;2003;39;738;368;370
Tauragė d. mun.;2003;40;769;404;365
Tauragė d. mun.;2003;41;795;399;396
Tauragė d. mun.;2003;42;902;456;446
Tauragė d. mun.;2003;43;784;379;405
Tauragė d. mun.;2003;44;782;397;385
Tauragė d. mun.;2003;45;700;341;359
Tauragė d. mun.;2003;46;644;315;329
Tauragė d. mun.;2003;47;663;311;352
Tauragė d. mun.;2003;48;620;297;323
Tauragė d. mun.;2003;49;592;289;303
Tauragė d. mun.;2003;50;555;261;294
Tauragė d. mun.;2003;51;576;247;329
Tauragė d. mun.;2003;52;578;276;302
Tauragė d. mun.;2003;53;613;285;328
Tauragė d. mun.;2003;54;584;268;316
Tauragė d. mun.;2003;55;517;260;257
Tauragė d. mun.;2003;56;478;208;270
Tauragė d. mun.;2003;57;525;222;303
Tauragė d. mun.;2003;58;414;172;242
Tauragė d. mun.;2003;59;537;216;321
Tauragė d. mun.;2003;60;612;293;319
Tauragė d. mun.;2003;61;542;225;317
Tauragė d. mun.;2003;62;521;215;306
Tauragė d. mun.;2003;63;510;206;304
Tauragė d. mun.;2003;64;529;209;320
Tauragė d. mun.;2003;65;516;210;306
Tauragė d. mun.;2003;66;528;195;333
Tauragė d. mun.;2003;67;567;221;346
Tauragė d. mun.;2003;68;528;204;324
Tauragė d. mun.;2003;69;506;190;316
Tauragė d. mun.;2003;70;535;183;352
Tauragė d. mun.;2003;71;472;171;301
Tauragė d. mun.;2003;72;463;161;302
Tauragė d. mun.;2003;73;400;131;269
Tauragė d. mun.;2003;74;437;139;298
Tauragė d. mun.;2003;75;400;118;282
Tauragė d. mun.;2003;76;350;123;227
Tauragė d. mun.;2003;77;307;84;223
Tauragė d. mun.;2003;78;278;91;187
Tauragė d. mun.;2003;79;272;88;184
Tauragė d. mun.;2003;80;216;60;156
Tauragė d. mun.;2003;81;213;57;156
Tauragė d. mun.;2003;82;170;42;128
Tauragė d. mun.;2003;83;146;41;105
Tauragė d. mun.;2003;84;82;22;60
Tauragė d. mun.;2003;85;520;150;370
Tauragė d. mun.;2004;-1;51352;23958;27394
Tauragė d. mun.;2004;0;458;240;218
Tauragė d. mun.;2004;1;425;209;216
Tauragė d. mun.;2004;2;454;222;232
Tauragė d. mun.;2004;3;506;267;239
Tauragė d. mun.;2004;4;548;285;263
Tauragė d. mun.;2004;5;555;292;263
Tauragė d. mun.;2004;6;571;305;266
Tauragė d. mun.;2004;7;654;314;340
Tauragė d. mun.;2004;8;709;371;338
Tauragė d. mun.;2004;9;706;358;348
Tauragė d. mun.;2004;10;759;384;375
Tauragė d. mun.;2004;11;888;438;450
Tauragė d. mun.;2004;12;855;442;413
Tauragė d. mun.;2004;13;947;464;483
Tauragė d. mun.;2004;14;848;439;409
Tauragė d. mun.;2004;15;914;431;483
Tauragė d. mun.;2004;16;910;450;460
Tauragė d. mun.;2004;17;897;454;443
Tauragė d. mun.;2004;18;895;436;459
Tauragė d. mun.;2004;19;824;423;401
Tauragė d. mun.;2004;20;805;418;387
Tauragė d. mun.;2004;21;602;315;287
Tauragė d. mun.;2004;22;535;308;227
Tauragė d. mun.;2004;23;526;278;248
Tauragė d. mun.;2004;24;619;299;320
Tauragė d. mun.;2004;25;590;299;291
Tauragė d. mun.;2004;26;595;324;271
Tauragė d. mun.;2004;27;653;330;323
Tauragė d. mun.;2004;28;669;324;345
Tauragė d. mun.;2004;29;683;347;336
Tauragė d. mun.;2004;30;662;290;372
Tauragė d. mun.;2004;31;761;389;372
Tauragė d. mun.;2004;32;727;366;361
Tauragė d. mun.;2004;33;740;387;353
Tauragė d. mun.;2004;34;694;357;337
Tauragė d. mun.;2004;35;771;358;413
Tauragė d. mun.;2004;36;735;359;376
Tauragė d. mun.;2004;37;745;348;397
Tauragė d. mun.;2004;38;746;369;377
Tauragė d. mun.;2004;39;752;379;373
Tauragė d. mun.;2004;40;732;365;367
Tauragė d. mun.;2004;41;762;398;364
Tauragė d. mun.;2004;42;785;394;391
Tauragė d. mun.;2004;43;897;453;444
Tauragė d. mun.;2004;44;772;370;402
Tauragė d. mun.;2004;45;775;397;378
Tauragė d. mun.;2004;46;692;334;358
Tauragė d. mun.;2004;47;632;310;322
Tauragė d. mun.;2004;48;645;299;346
Tauragė d. mun.;2004;49;611;292;319
Tauragė d. mun.;2004;50;579;279;300
Tauragė d. mun.;2004;51;544;255;289
Tauragė d. mun.;2004;52;566;245;321
Tauragė d. mun.;2004;53;575;276;299
Tauragė d. mun.;2004;54;611;285;326
Tauragė d. mun.;2004;55;577;260;317
Tauragė d. mun.;2004;56;515;257;258
Tauragė d. mun.;2004;57;471;203;268
Tauragė d. mun.;2004;58;517;214;303
Tauragė d. mun.;2004;59;406;165;241
Tauragė d. mun.;2004;60;523;210;313
Tauragė d. mun.;2004;61;589;280;309
Tauragė d. mun.;2004;62;523;218;305
Tauragė d. mun.;2004;63;513;211;302
Tauragė d. mun.;2004;64;496;195;301
Tauragė d. mun.;2004;65;521;202;319
Tauragė d. mun.;2004;66;505;201;304
Tauragė d. mun.;2004;67;519;185;334
Tauragė d. mun.;2004;68;560;219;341
Tauragė d. mun.;2004;69;515;192;323
Tauragė d. mun.;2004;70;500;188;312
Tauragė d. mun.;2004;71;516;168;348
Tauragė d. mun.;2004;72;461;164;297
Tauragė d. mun.;2004;73;451;156;295
Tauragė d. mun.;2004;74;388;126;262
Tauragė d. mun.;2004;75;421;128;293
Tauragė d. mun.;2004;76;382;114;268
Tauragė d. mun.;2004;77;333;110;223
Tauragė d. mun.;2004;78;303;80;223
Tauragė d. mun.;2004;79;263;82;181
Tauragė d. mun.;2004;80;246;81;165
Tauragė d. mun.;2004;81;211;57;154
Tauragė d. mun.;2004;82;201;55;146
Tauragė d. mun.;2004;83;155;36;119
Tauragė d. mun.;2004;84;135;34;101
Tauragė d. mun.;2004;85;525;147;378
Tauragė d. mun.;2005;-1;50371;23569;26802
Tauragė d. mun.;2005;0;412;216;196
Tauragė d. mun.;2005;1;445;234;211
Tauragė d. mun.;2005;2;421;207;214
Tauragė d. mun.;2005;3;449;219;230
Tauragė d. mun.;2005;4;498;263;235
Tauragė d. mun.;2005;5;537;281;256
Tauragė d. mun.;2005;6;549;291;258
Tauragė d. mun.;2005;7;568;304;264
Tauragė d. mun.;2005;8;646;312;334
Tauragė d. mun.;2005;9;708;372;336
Tauragė d. mun.;2005;10;699;356;343
Tauragė d. mun.;2005;11;749;380;369
Tauragė d. mun.;2005;12;877;433;444
Tauragė d. mun.;2005;13;842;434;408
Tauragė d. mun.;2005;14;933;457;476
Tauragė d. mun.;2005;15;834;433;401
Tauragė d. mun.;2005;16;890;423;467
Tauragė d. mun.;2005;17;892;446;446
Tauragė d. mun.;2005;18;871;440;431
Tauragė d. mun.;2005;19;872;428;444
Tauragė d. mun.;2005;20;792;409;383
Tauragė d. mun.;2005;21;783;406;377
Tauragė d. mun.;2005;22;571;299;272
Tauragė d. mun.;2005;23;514;298;216
Tauragė d. mun.;2005;24;505;276;229
Tauragė d. mun.;2005;25;611;297;314
Tauragė d. mun.;2005;26;574;290;284
Tauragė d. mun.;2005;27;571;312;259
Tauragė d. mun.;2005;28;625;315;310
Tauragė d. mun.;2005;29;643;312;331
Tauragė d. mun.;2005;30;666;338;328
Tauragė d. mun.;2005;31;647;280;367
Tauragė d. mun.;2005;32;734;374;360
Tauragė d. mun.;2005;33;713;357;356
Tauragė d. mun.;2005;34;720;377;343
Tauragė d. mun.;2005;35;673;342;331
Tauragė d. mun.;2005;36;754;353;401
Tauragė d. mun.;2005;37;721;351;370
Tauragė d. mun.;2005;38;742;351;391
Tauragė d. mun.;2005;39;734;363;371
Tauragė d. mun.;2005;40;742;371;371
Tauragė d. mun.;2005;41;723;358;365
Tauragė d. mun.;2005;42;741;390;351
Tauragė d. mun.;2005;43;769;385;384
Tauragė d. mun.;2005;44;884;448;436
Tauragė d. mun.;2005;45;761;370;391
Tauragė d. mun.;2005;46;765;393;372
Tauragė d. mun.;2005;47;683;336;347
Tauragė d. mun.;2005;48;623;305;318
Tauragė d. mun.;2005;49;629;294;335
Tauragė d. mun.;2005;50;599;284;315
Tauragė d. mun.;2005;51;566;273;293
Tauragė d. mun.;2005;52;535;248;287
Tauragė d. mun.;2005;53;554;238;316
Tauragė d. mun.;2005;54;559;269;290
Tauragė d. mun.;2005;55;601;280;321
Tauragė d. mun.;2005;56;568;256;312
Tauragė d. mun.;2005;57;507;253;254
Tauragė d. mun.;2005;58;451;191;260
Tauragė d. mun.;2005;59;510;213;297
Tauragė d. mun.;2005;60;396;159;237
Tauragė d. mun.;2005;61;514;206;308
Tauragė d. mun.;2005;62;574;271;303
Tauragė d. mun.;2005;63;503;206;297
Tauragė d. mun.;2005;64;499;205;294
Tauragė d. mun.;2005;65;485;194;291
Tauragė d. mun.;2005;66;506;197;309
Tauragė d. mun.;2005;67;491;191;300
Tauragė d. mun.;2005;68;498;175;323
Tauragė d. mun.;2005;69;539;207;332
Tauragė d. mun.;2005;70;502;187;315
Tauragė d. mun.;2005;71;478;177;301
Tauragė d. mun.;2005;72;504;164;340
Tauragė d. mun.;2005;73;436;149;287
Tauragė d. mun.;2005;74;426;144;282
Tauragė d. mun.;2005;75;367;119;248
Tauragė d. mun.;2005;76;397;119;278
Tauragė d. mun.;2005;77;355;105;250
Tauragė d. mun.;2005;78;316;100;216
Tauragė d. mun.;2005;79;288;78;210
Tauragė d. mun.;2005;80;242;77;165
Tauragė d. mun.;2005;81;230;77;153
Tauragė d. mun.;2005;82;192;49;143
Tauragė d. mun.;2005;83;179;47;132
Tauragė d. mun.;2005;84;138;33;105
Tauragė d. mun.;2005;85;561;149;412
Tauragė d. mun.;2006;-1;48911;22749;26162
Tauragė d. mun.;2006;0;378;216;162
Tauragė d. mun.;2006;1;405;214;191
Tauragė d. mun.;2006;2;432;226;206
Tauragė d. mun.;2006;3;414;203;211
Tauragė d. mun.;2006;4;439;215;224
Tauragė d. mun.;2006;5;488;254;234
Tauragė d. mun.;2006;6;529;277;252
Tauragė d. mun.;2006;7;542;286;256
Tauragė d. mun.;2006;8;560;297;263
Tauragė d. mun.;2006;9;639;308;331
Tauragė d. mun.;2006;10;705;367;338
Tauragė d. mun.;2006;11;688;348;340
Tauragė d. mun.;2006;12;739;377;362
Tauragė d. mun.;2006;13;855;422;433
Tauragė d. mun.;2006;14;824;421;403
Tauragė d. mun.;2006;15;902;441;461
Tauragė d. mun.;2006;16;802;416;386
Tauragė d. mun.;2006;17;852;403;449
Tauragė d. mun.;2006;18;852;422;430
Tauragė d. mun.;2006;19;824;412;412
Tauragė d. mun.;2006;20;819;398;421
Tauragė d. mun.;2006;21;738;380;358
Tauragė d. mun.;2006;22;734;378;356
Tauragė d. mun.;2006;23;548;283;265
Tauragė d. mun.;2006;24;479;282;197
Tauragė d. mun.;2006;25;469;255;214
Tauragė d. mun.;2006;26;586;281;305
Tauragė d. mun.;2006;27;533;269;264
Tauragė d. mun.;2006;28;552;303;249
Tauragė d. mun.;2006;29;610;309;301
Tauragė d. mun.;2006;30;623;302;321
Tauragė d. mun.;2006;31;639;324;315
Tauragė d. mun.;2006;32;631;271;360
Tauragė d. mun.;2006;33;710;359;351
Tauragė d. mun.;2006;34;685;342;343
Tauragė d. mun.;2006;35;696;360;336
Tauragė d. mun.;2006;36;653;327;326
Tauragė d. mun.;2006;37;721;332;389
Tauragė d. mun.;2006;38;702;338;364
Tauragė d. mun.;2006;39;716;335;381
Tauragė d. mun.;2006;40;715;346;369
Tauragė d. mun.;2006;41;719;358;361
Tauragė d. mun.;2006;42;704;345;359
Tauragė d. mun.;2006;43;726;378;348
Tauragė d. mun.;2006;44;749;372;377
Tauragė d. mun.;2006;45;867;441;426
Tauragė d. mun.;2006;46;743;358;385
Tauragė d. mun.;2006;47;757;387;370
Tauragė d. mun.;2006;48;666;324;342
Tauragė d. mun.;2006;49;602;291;311
Tauragė d. mun.;2006;50;618;284;334
Tauragė d. mun.;2006;51;589;280;309
Tauragė d. mun.;2006;52;546;258;288
Tauragė d. mun.;2006;53;518;238;280
Tauragė d. mun.;2006;54;536;226;310
Tauragė d. mun.;2006;55;542;260;282
Tauragė d. mun.;2006;56;590;270;320
Tauragė d. mun.;2006;57;554;248;306
Tauragė d. mun.;2006;58;488;242;246
Tauragė d. mun.;2006;59;437;181;256
Tauragė d. mun.;2006;60;491;200;291
Tauragė d. mun.;2006;61;386;155;231
Tauragė d. mun.;2006;62;496;195;301
Tauragė d. mun.;2006;63;549;253;296
Tauragė d. mun.;2006;64;490;196;294
Tauragė d. mun.;2006;65;492;200;292
Tauragė d. mun.;2006;66;475;191;284
Tauragė d. mun.;2006;67;486;185;301
Tauragė d. mun.;2006;68;475;181;294
Tauragė d. mun.;2006;69;485;172;313
Tauragė d. mun.;2006;70;520;190;330
Tauragė d. mun.;2006;71;488;176;312
Tauragė d. mun.;2006;72;469;169;300
Tauragė d. mun.;2006;73;480;151;329
Tauragė d. mun.;2006;74;421;140;281
Tauragė d. mun.;2006;75;405;136;269
Tauragė d. mun.;2006;76;345;108;237
Tauragė d. mun.;2006;77;373;106;267
Tauragė d. mun.;2006;78;320;94;226
Tauragė d. mun.;2006;79;287;86;201
Tauragė d. mun.;2006;80;265;66;199
Tauragė d. mun.;2006;81;213;64;149
Tauragė d. mun.;2006;82;211;70;141
Tauragė d. mun.;2006;83;171;45;126
Tauragė d. mun.;2006;84;156;35;121
Tauragė d. mun.;2006;85;583;145;438
Tauragė d. mun.;2007;-1;48119;22270;25849
Tauragė d. mun.;2007;0;406;214;192
Tauragė d. mun.;2007;1;373;211;162
Tauragė d. mun.;2007;2;405;213;192
Tauragė d. mun.;2007;3;432;227;205
Tauragė d. mun.;2007;4;413;202;211
Tauragė d. mun.;2007;5;438;215;223
Tauragė d. mun.;2007;6;485;249;236
Tauragė d. mun.;2007;7;524;273;251
Tauragė d. mun.;2007;8;541;287;254
Tauragė d. mun.;2007;9;552;293;259
Tauragė d. mun.;2007;10;630;301;329
Tauragė d. mun.;2007;11;703;369;334
Tauragė d. mun.;2007;12;684;344;340
Tauragė d. mun.;2007;13;736;376;360
Tauragė d. mun.;2007;14;849;419;430
Tauragė d. mun.;2007;15;814;412;402
Tauragė d. mun.;2007;16;890;434;456
Tauragė d. mun.;2007;17;797;411;386
Tauragė d. mun.;2007;18;832;389;443
Tauragė d. mun.;2007;19;833;411;422
Tauragė d. mun.;2007;20;796;394;402
Tauragė d. mun.;2007;21;794;386;408
Tauragė d. mun.;2007;22;719;365;354
Tauragė d. mun.;2007;23;717;364;353
Tauragė d. mun.;2007;24;537;274;263
Tauragė d. mun.;2007;25;453;269;184
Tauragė d. mun.;2007;26;444;238;206
Tauragė d. mun.;2007;27;564;268;296
Tauragė d. mun.;2007;28;519;259;260
Tauragė d. mun.;2007;29;541;293;248
Tauragė d. mun.;2007;30;596;302;294
Tauragė d. mun.;2007;31;614;297;317
Tauragė d. mun.;2007;32;623;316;307
Tauragė d. mun.;2007;33;630;266;364
Tauragė d. mun.;2007;34;690;348;342
Tauragė d. mun.;2007;35;684;341;343
Tauragė d. mun.;2007;36;680;346;334
Tauragė d. mun.;2007;37;639;320;319
Tauragė d. mun.;2007;38;705;321;384
Tauragė d. mun.;2007;39;688;328;360
Tauragė d. mun.;2007;40;697;323;374
Tauragė d. mun.;2007;41;693;334;359
Tauragė d. mun.;2007;42;706;349;357
Tauragė d. mun.;2007;43;693;340;353
Tauragė d. mun.;2007;44;711;371;340
Tauragė d. mun.;2007;45;735;363;372
Tauragė d. mun.;2007;46;862;436;426
Tauragė d. mun.;2007;47;730;352;378
Tauragė d. mun.;2007;48;748;378;370
Tauragė d. mun.;2007;49;657;317;340
Tauragė d. mun.;2007;50;588;286;302
Tauragė d. mun.;2007;51;602;272;330
Tauragė d. mun.;2007;52;574;274;300
Tauragė d. mun.;2007;53;533;252;281
Tauragė d. mun.;2007;54;505;229;276
Tauragė d. mun.;2007;55;523;216;307
Tauragė d. mun.;2007;56;534;253;281
Tauragė d. mun.;2007;57;579;263;316
Tauragė d. mun.;2007;58;543;241;302
Tauragė d. mun.;2007;59;480;234;246
Tauragė d. mun.;2007;60;426;173;253
Tauragė d. mun.;2007;61;483;193;290
Tauragė d. mun.;2007;62;375;152;223
Tauragė d. mun.;2007;63;482;186;296
Tauragė d. mun.;2007;64;536;248;288
Tauragė d. mun.;2007;65;473;186;287
Tauragė d. mun.;2007;66;490;198;292
Tauragė d. mun.;2007;67;461;179;282
Tauragė d. mun.;2007;68;468;175;293
Tauragė d. mun.;2007;69;460;172;288
Tauragė d. mun.;2007;70;472;162;310
Tauragė d. mun.;2007;71;505;178;327
Tauragė d. mun.;2007;72;467;166;301
Tauragė d. mun.;2007;73;452;157;295
Tauragė d. mun.;2007;74;451;136;315
Tauragė d. mun.;2007;75;395;124;271
Tauragė d. mun.;2007;76;387;131;256
Tauragė d. mun.;2007;77;335;100;235
Tauragė d. mun.;2007;78;355;99;256
Tauragė d. mun.;2007;79;308;89;219
Tauragė d. mun.;2007;80;271;81;190
Tauragė d. mun.;2007;81;241;60;181
Tauragė d. mun.;2007;82;196;57;139
Tauragė d. mun.;2007;83;192;60;132
Tauragė d. mun.;2007;84;148;31;117
Tauragė d. mun.;2007;85;627;149;478
Tauragė d. mun.;2008;-1;47318;21894;25424
Tauragė d. mun.;2008;0;459;229;230
Tauragė d. mun.;2008;1;395;210;185
Tauragė d. mun.;2008;2;369;209;160
Tauragė d. mun.;2008;3;401;211;190
Tauragė d. mun.;2008;4;426;224;202
Tauragė d. mun.;2008;5;410;201;209
Tauragė d. mun.;2008;6;438;217;221
Tauragė d. mun.;2008;7;476;243;233
Tauragė d. mun.;2008;8;520;274;246
Tauragė d. mun.;2008;9;536;283;253
Tauragė d. mun.;2008;10;544;289;255
Tauragė d. mun.;2008;11;620;297;323
Tauragė d. mun.;2008;12;698;364;334
Tauragė d. mun.;2008;13;673;338;335
Tauragė d. mun.;2008;14;735;376;359
Tauragė d. mun.;2008;15;841;415;426
Tauragė d. mun.;2008;16;803;409;394
Tauragė d. mun.;2008;17;877;431;446
Tauragė d. mun.;2008;18;781;404;377
Tauragė d. mun.;2008;19;821;386;435
Tauragė d. mun.;2008;20;811;404;407
Tauragė d. mun.;2008;21;777;385;392
Tauragė d. mun.;2008;22;768;376;392
Tauragė d. mun.;2008;23;705;361;344
Tauragė d. mun.;2008;24;691;349;342
Tauragė d. mun.;2008;25;513;265;248
Tauragė d. mun.;2008;26;432;255;177
Tauragė d. mun.;2008;27;429;234;195
Tauragė d. mun.;2008;28;549;264;285
Tauragė d. mun.;2008;29;499;251;248
Tauragė d. mun.;2008;30;523;280;243
Tauragė d. mun.;2008;31;581;292;289
Tauragė d. mun.;2008;32;604;295;309
Tauragė d. mun.;2008;33;617;313;304
Tauragė d. mun.;2008;34;620;263;357
Tauragė d. mun.;2008;35;686;346;340
Tauragė d. mun.;2008;36;666;329;337
Tauragė d. mun.;2008;37;675;346;329
Tauragė d. mun.;2008;38;634;314;320
Tauragė d. mun.;2008;39;694;316;378
Tauragė d. mun.;2008;40;680;326;354
Tauragė d. mun.;2008;41;681;317;364
Tauragė d. mun.;2008;42;677;326;351
Tauragė d. mun.;2008;43;691;340;351
Tauragė d. mun.;2008;44;679;333;346
Tauragė d. mun.;2008;45;693;362;331
Tauragė d. mun.;2008;46;715;350;365
Tauragė d. mun.;2008;47;839;424;415
Tauragė d. mun.;2008;48;711;340;371
Tauragė d. mun.;2008;49;739;371;368
Tauragė d. mun.;2008;50;646;309;337
Tauragė d. mun.;2008;51;577;281;296
Tauragė d. mun.;2008;52;593;268;325
Tauragė d. mun.;2008;53;568;266;302
Tauragė d. mun.;2008;54;525;247;278
Tauragė d. mun.;2008;55;491;221;270
Tauragė d. mun.;2008;56;508;207;301
Tauragė d. mun.;2008;57;516;242;274
Tauragė d. mun.;2008;58;572;258;314
Tauragė d. mun.;2008;59;531;232;299
Tauragė d. mun.;2008;60;469;226;243
Tauragė d. mun.;2008;61;407;165;242
Tauragė d. mun.;2008;62;470;185;285
Tauragė d. mun.;2008;63;359;143;216
Tauragė d. mun.;2008;64;472;183;289
Tauragė d. mun.;2008;65;522;234;288
Tauragė d. mun.;2008;66;466;180;286
Tauragė d. mun.;2008;67;482;193;289
Tauragė d. mun.;2008;68;447;172;275
Tauragė d. mun.;2008;69;451;162;289
Tauragė d. mun.;2008;70;443;164;279
Tauragė d. mun.;2008;71;457;151;306
Tauragė d. mun.;2008;72;487;168;319
Tauragė d. mun.;2008;73;451;157;294
Tauragė d. mun.;2008;74;431;146;285
Tauragė d. mun.;2008;75;420;123;297
Tauragė d. mun.;2008;76;378;114;264
Tauragė d. mun.;2008;77;358;117;241
Tauragė d. mun.;2008;78;309;87;222
Tauragė d. mun.;2008;79;335;91;244
Tauragė d. mun.;2008;80;292;86;206
Tauragė d. mun.;2008;81;252;74;178
Tauragė d. mun.;2008;82;227;58;169
Tauragė d. mun.;2008;83;172;48;124
Tauragė d. mun.;2008;84;175;54;121
Tauragė d. mun.;2008;85;657;145;512
Tauragė d. mun.;2009;-1;46683;21577;25106
Tauragė d. mun.;2009;0;438;207;231
Tauragė d. mun.;2009;1;454;228;226
Tauragė d. mun.;2009;2;389;208;181
Tauragė d. mun.;2009;3;371;208;163
Tauragė d. mun.;2009;4;392;208;184
Tauragė d. mun.;2009;5;417;222;195
Tauragė d. mun.;2009;6;403;199;204
Tauragė d. mun.;2009;7;433;214;219
Tauragė d. mun.;2009;8;476;244;232
Tauragė d. mun.;2009;9;518;273;245
Tauragė d. mun.;2009;10;539;284;255
Tauragė d. mun.;2009;11;535;285;250
Tauragė d. mun.;2009;12;618;294;324
Tauragė d. mun.;2009;13;691;361;330
Tauragė d. mun.;2009;14;674;342;332
Tauragė d. mun.;2009;15;730;373;357
Tauragė d. mun.;2009;16;838;414;424
Tauragė d. mun.;2009;17;794;403;391
Tauragė d. mun.;2009;18;874;428;446
Tauragė d. mun.;2009;19;776;401;375
Tauragė d. mun.;2009;20;810;381;429
Tauragė d. mun.;2009;21;792;396;396
Tauragė d. mun.;2009;22;753;371;382
Tauragė d. mun.;2009;23;754;371;383
Tauragė d. mun.;2009;24;687;356;331
Tauragė d. mun.;2009;25;680;342;338
Tauragė d. mun.;2009;26;488;256;232
Tauragė d. mun.;2009;27;421;250;171
Tauragė d. mun.;2009;28;424;227;197
Tauragė d. mun.;2009;29;535;255;280
Tauragė d. mun.;2009;30;483;238;245
Tauragė d. mun.;2009;31;509;276;233
Tauragė d. mun.;2009;32;574;287;287
Tauragė d. mun.;2009;33;592;291;301
Tauragė d. mun.;2009;34;606;305;301
Tauragė d. mun.;2009;35;609;259;350
Tauragė d. mun.;2009;36;668;334;334
Tauragė d. mun.;2009;37;657;322;335
Tauragė d. mun.;2009;38;663;339;324
Tauragė d. mun.;2009;39;631;313;318
Tauragė d. mun.;2009;40;684;312;372
Tauragė d. mun.;2009;41;666;317;349
Tauragė d. mun.;2009;42;671;314;357
Tauragė d. mun.;2009;43;665;319;346
Tauragė d. mun.;2009;44;688;337;351
Tauragė d. mun.;2009;45;671;328;343
Tauragė d. mun.;2009;46;690;359;331
Tauragė d. mun.;2009;47;708;349;359
Tauragė d. mun.;2009;48;830;416;414
Tauragė d. mun.;2009;49;706;338;368
Tauragė d. mun.;2009;50;733;365;368
Tauragė d. mun.;2009;51;642;305;337
Tauragė d. mun.;2009;52;562;277;285
Tauragė d. mun.;2009;53;578;257;321
Tauragė d. mun.;2009;54;557;260;297
Tauragė d. mun.;2009;55;516;243;273
Tauragė d. mun.;2009;56;481;215;266
Tauragė d. mun.;2009;57;496;204;292
Tauragė d. mun.;2009;58;502;234;268
Tauragė d. mun.;2009;59;562;250;312
Tauragė d. mun.;2009;60;526;226;300
Tauragė d. mun.;2009;61;460;219;241
Tauragė d. mun.;2009;62;402;161;241
Tauragė d. mun.;2009;63;457;178;279
Tauragė d. mun.;2009;64;357;143;214
Tauragė d. mun.;2009;65;458;174;284
Tauragė d. mun.;2009;66;503;223;280
Tauragė d. mun.;2009;67;454;173;281
Tauragė d. mun.;2009;68;460;180;280
Tauragė d. mun.;2009;69;431;161;270
Tauragė d. mun.;2009;70;439;156;283
Tauragė d. mun.;2009;71;420;152;268
Tauragė d. mun.;2009;72;445;148;297
Tauragė d. mun.;2009;73;468;158;310
Tauragė d. mun.;2009;74;432;148;284
Tauragė d. mun.;2009;75;412;142;270
Tauragė d. mun.;2009;76;398;117;281
Tauragė d. mun.;2009;77;354;106;248
Tauragė d. mun.;2009;78;341;104;237
Tauragė d. mun.;2009;79;288;78;210
Tauragė d. mun.;2009;80;309;80;229
Tauragė d. mun.;2009;81;271;75;196
Tauragė d. mun.;2009;82;231;62;169
Tauragė d. mun.;2009;83;209;49;160
Tauragė d. mun.;2009;84;155;40;115
Tauragė d. mun.;2009;85;699;160;539
Tauragė d. mun.;2010;-1;45894;21146;24748
Tauragė d. mun.;2010;0;389;188;201
Tauragė d. mun.;2010;1;431;202;229
Tauragė d. mun.;2010;2;444;220;224
Tauragė d. mun.;2010;3;382;207;175
Tauragė d. mun.;2010;4;370;210;160
Tauragė d. mun.;2010;5;383;203;180
Tauragė d. mun.;2010;6;413;218;195
Tauragė d. mun.;2010;7;397;193;204
Tauragė d. mun.;2010;8;429;215;214
Tauragė d. mun.;2010;9;474;242;232
Tauragė d. mun.;2010;10;510;270;240
Tauragė d. mun.;2010;11;539;281;258
Tauragė d. mun.;2010;12;527;281;246
Tauragė d. mun.;2010;13;615;293;322
Tauragė d. mun.;2010;14;682;355;327
Tauragė d. mun.;2010;15;669;339;330
Tauragė d. mun.;2010;16;724;369;355
Tauragė d. mun.;2010;17;837;413;424
Tauragė d. mun.;2010;18;785;400;385
Tauragė d. mun.;2010;19;860;421;439
Tauragė d. mun.;2010;20;755;389;366
Tauragė d. mun.;2010;21;794;374;420
Tauragė d. mun.;2010;22;770;380;390
Tauragė d. mun.;2010;23;719;355;364
Tauragė d. mun.;2010;24;736;362;374
Tauragė d. mun.;2010;25;664;340;324
Tauragė d. mun.;2010;26;635;322;313
Tauragė d. mun.;2010;27;462;242;220
Tauragė d. mun.;2010;28;400;237;163
Tauragė d. mun.;2010;29;409;223;186
Tauragė d. mun.;2010;30;518;248;270
Tauragė d. mun.;2010;31;475;232;243
Tauragė d. mun.;2010;32;496;271;225
Tauragė d. mun.;2010;33;561;280;281
Tauragė d. mun.;2010;34;578;284;294
Tauragė d. mun.;2010;35;587;297;290
Tauragė d. mun.;2010;36;598;253;345
Tauragė d. mun.;2010;37;663;333;330
Tauragė d. mun.;2010;38;646;315;331
Tauragė d. mun.;2010;39;654;334;320
Tauragė d. mun.;2010;40;623;307;316
Tauragė d. mun.;2010;41;671;299;372
Tauragė d. mun.;2010;42;658;309;349
Tauragė d. mun.;2010;43;661;307;354
Tauragė d. mun.;2010;44;654;314;340
Tauragė d. mun.;2010;45;676;332;344
Tauragė d. mun.;2010;46;664;323;341
Tauragė d. mun.;2010;47;679;350;329
Tauragė d. mun.;2010;48;703;345;358
Tauragė d. mun.;2010;49;814;405;409
Tauragė d. mun.;2010;50;697;331;366
Tauragė d. mun.;2010;51;718;357;361
Tauragė d. mun.;2010;52;628;295;333
Tauragė d. mun.;2010;53;556;270;286
Tauragė d. mun.;2010;54;566;249;317
Tauragė d. mun.;2010;55;542;250;292
Tauragė d. mun.;2010;56;509;237;272
Tauragė d. mun.;2010;57;476;209;267
Tauragė d. mun.;2010;58;495;204;291
Tauragė d. mun.;2010;59;493;228;265
Tauragė d. mun.;2010;60;538;233;305
Tauragė d. mun.;2010;61;512;215;297
Tauragė d. mun.;2010;62;452;212;240
Tauragė d. mun.;2010;63;391;153;238
Tauragė d. mun.;2010;64;450;176;274
Tauragė d. mun.;2010;65;346;137;209
Tauragė d. mun.;2010;66;442;161;281
Tauragė d. mun.;2010;67;489;215;274
Tauragė d. mun.;2010;68;447;169;278
Tauragė d. mun.;2010;69;446;173;273
Tauragė d. mun.;2010;70;419;155;264
Tauragė d. mun.;2010;71;426;152;274
Tauragė d. mun.;2010;72;403;142;261
Tauragė d. mun.;2010;73;430;143;287
Tauragė d. mun.;2010;74;447;147;300
Tauragė d. mun.;2010;75;423;146;277
Tauragė d. mun.;2010;76;384;130;254
Tauragė d. mun.;2010;77;370;106;264
Tauragė d. mun.;2010;78;334;99;235
Tauragė d. mun.;2010;79;327;101;226
Tauragė d. mun.;2010;80;275;74;201
Tauragė d. mun.;2010;81;291;70;221
Tauragė d. mun.;2010;82;250;65;185
Tauragė d. mun.;2010;83;210;55;155
Tauragė d. mun.;2010;84;188;43;145
Tauragė d. mun.;2010;85;741;162;579
Tauragė d. mun.;2011;-1;44059;20275;23784
Tauragė d. mun.;2011;0;362;196;166
Tauragė d. mun.;2011;1;354;164;190
Tauragė d. mun.;2011;2;400;188;212
Tauragė d. mun.;2011;3;420;223;197
Tauragė d. mun.;2011;4;365;199;166
Tauragė d. mun.;2011;5;349;199;150
Tauragė d. mun.;2011;6;391;213;178
Tauragė d. mun.;2011;7;426;217;209
Tauragė d. mun.;2011;8;402;189;213
Tauragė d. mun.;2011;9;442;217;225
Tauragė d. mun.;2011;10;485;256;229
Tauragė d. mun.;2011;11;513;278;235
Tauragė d. mun.;2011;12;518;267;251
Tauragė d. mun.;2011;13;543;281;262
Tauragė d. mun.;2011;14;600;292;308
Tauragė d. mun.;2011;15;678;345;333
Tauragė d. mun.;2011;16;663;323;340
Tauragė d. mun.;2011;17;716;363;353
Tauragė d. mun.;2011;18;800;395;405
Tauragė d. mun.;2011;19;636;350;286
Tauragė d. mun.;2011;20;658;342;316
Tauragė d. mun.;2011;21;560;288;272
Tauragė d. mun.;2011;22;587;279;308
Tauragė d. mun.;2011;23;604;300;304
Tauragė d. mun.;2011;24;519;269;250
Tauragė d. mun.;2011;25;500;262;238
Tauragė d. mun.;2011;26;482;251;231
Tauragė d. mun.;2011;27;475;253;222
Tauragė d. mun.;2011;28;399;196;203
Tauragė d. mun.;2011;29;426;217;209
Tauragė d. mun.;2011;30;415;206;209
Tauragė d. mun.;2011;31;484;227;257
Tauragė d. mun.;2011;32;469;229;240
Tauragė d. mun.;2011;33;463;244;219
Tauragė d. mun.;2011;34;528;247;281
Tauragė d. mun.;2011;35;577;280;297
Tauragė d. mun.;2011;36;592;301;291
Tauragė d. mun.;2011;37;580;248;332
Tauragė d. mun.;2011;38;647;319;328
Tauragė d. mun.;2011;39;656;313;343
Tauragė d. mun.;2011;40;648;313;335
Tauragė d. mun.;2011;41;638;323;315
Tauragė d. mun.;2011;42;681;309;372
Tauragė d. mun.;2011;43;667;323;344
Tauragė d. mun.;2011;44;674;319;355
Tauragė d. mun.;2011;45;665;330;335
Tauragė d. mun.;2011;46;667;331;336
Tauragė d. mun.;2011;47;663;324;339
Tauragė d. mun.;2011;48;693;354;339
Tauragė d. mun.;2011;49;704;338;366
Tauragė d. mun.;2011;50;800;399;401
Tauragė d. mun.;2011;51;698;335;363
Tauragė d. mun.;2011;52;692;349;343
Tauragė d. mun.;2011;53;618;288;330
Tauragė d. mun.;2011;54;576;280;296
Tauragė d. mun.;2011;55;581;251;330
Tauragė d. mun.;2011;56;553;258;295
Tauragė d. mun.;2011;57;525;247;278
Tauragė d. mun.;2011;58;487;213;274
Tauragė d. mun.;2011;59;515;206;309
Tauragė d. mun.;2011;60;492;222;270
Tauragė d. mun.;2011;61;562;243;319
Tauragė d. mun.;2011;62;529;224;305
Tauragė d. mun.;2011;63;447;203;244
Tauragė d. mun.;2011;64;396;157;239
Tauragė d. mun.;2011;65;461;182;279
Tauragė d. mun.;2011;66;352;137;215
Tauragė d. mun.;2011;67;458;166;292
Tauragė d. mun.;2011;68;485;196;289
Tauragė d. mun.;2011;69;455;167;288
Tauragė d. mun.;2011;70;444;171;273
Tauragė d. mun.;2011;71;421;156;265
Tauragė d. mun.;2011;72;424;150;274
Tauragė d. mun.;2011;73;407;146;261
Tauragė d. mun.;2011;74;412;135;277
Tauragė d. mun.;2011;75;441;139;302
Tauragė d. mun.;2011;76;396;138;258
Tauragė d. mun.;2011;77;369;123;246
Tauragė d. mun.;2011;78;363;113;250
Tauragė d. mun.;2011;79;318;89;229
Tauragė d. mun.;2011;80;316;102;214
Tauragė d. mun.;2011;81;267;73;194
Tauragė d. mun.;2011;82;265;59;206
Tauragė d. mun.;2011;83;215;51;164
Tauragė d. mun.;2011;84;199;53;146
Tauragė d. mun.;2011;85;736;164;572
Tauragė d. mun.;2012;-1;43124;19839;23285
Tauragė d. mun.;2012;0;403;202;201
Tauragė d. mun.;2012;1;357;194;163
Tauragė d. mun.;2012;2;342;156;186
Tauragė d. mun.;2012;3;391;185;206
Tauragė d. mun.;2012;4;411;215;196
Tauragė d. mun.;2012;5;356;196;160
Tauragė d. mun.;2012;6;348;199;149
Tauragė d. mun.;2012;7;390;209;181
Tauragė d. mun.;2012;8;427;219;208
Tauragė d. mun.;2012;9;402;188;214
Tauragė d. mun.;2012;10;439;217;222
Tauragė d. mun.;2012;11;487;256;231
Tauragė d. mun.;2012;12;505;276;229
Tauragė d. mun.;2012;13;512;264;248
Tauragė d. mun.;2012;14;537;278;259
Tauragė d. mun.;2012;15;603;291;312
Tauragė d. mun.;2012;16;673;344;329
Tauragė d. mun.;2012;17;662;324;338
Tauragė d. mun.;2012;18;705;355;350
Tauragė d. mun.;2012;19;757;382;375
Tauragė d. mun.;2012;20;614;335;279
Tauragė d. mun.;2012;21;636;330;306
Tauragė d. mun.;2012;22;533;276;257
Tauragė d. mun.;2012;23;524;250;274
Tauragė d. mun.;2012;24;563;285;278
Tauragė d. mun.;2012;25;484;256;228
Tauragė d. mun.;2012;26;450;245;205
Tauragė d. mun.;2012;27;442;220;222
Tauragė d. mun.;2012;28;450;245;205
Tauragė d. mun.;2012;29;368;178;190
Tauragė d. mun.;2012;30;406;204;202
Tauragė d. mun.;2012;31;402;200;202
Tauragė d. mun.;2012;32;464;211;253
Tauragė d. mun.;2012;33;458;222;236
Tauragė d. mun.;2012;34;455;234;221
Tauragė d. mun.;2012;35;519;245;274
Tauragė d. mun.;2012;36;568;271;297
Tauragė d. mun.;2012;37;584;298;286
Tauragė d. mun.;2012;38;568;240;328
Tauragė d. mun.;2012;39;624;310;314
Tauragė d. mun.;2012;40;648;308;340
Tauragė d. mun.;2012;41;634;301;333
Tauragė d. mun.;2012;42;628;318;310
Tauragė d. mun.;2012;43;666;304;362
Tauragė d. mun.;2012;44;657;320;337
Tauragė d. mun.;2012;45;660;312;348
Tauragė d. mun.;2012;46;653;321;332
Tauragė d. mun.;2012;47;659;329;330
Tauragė d. mun.;2012;48;651;319;332
Tauragė d. mun.;2012;49;685;352;333
Tauragė d. mun.;2012;50;690;334;356
Tauragė d. mun.;2012;51;796;398;398
Tauragė d. mun.;2012;52;695;335;360
Tauragė d. mun.;2012;53;683;342;341
Tauragė d. mun.;2012;54;609;285;324
Tauragė d. mun.;2012;55;571;277;294
Tauragė d. mun.;2012;56;572;246;326
Tauragė d. mun.;2012;57;546;254;292
Tauragė d. mun.;2012;58;519;243;276
Tauragė d. mun.;2012;59;476;207;269
Tauragė d. mun.;2012;60;506;199;307
Tauragė d. mun.;2012;61;489;220;269
Tauragė d. mun.;2012;62;552;239;313
Tauragė d. mun.;2012;63;518;216;302
Tauragė d. mun.;2012;64;438;199;239
Tauragė d. mun.;2012;65;375;141;234
Tauragė d. mun.;2012;66;447;175;272
Tauragė d. mun.;2012;67;341;130;211
Tauragė d. mun.;2012;68;443;158;285
Tauragė d. mun.;2012;69;475;189;286
Tauragė d. mun.;2012;70;441;160;281
Tauragė d. mun.;2012;71;427;162;265
Tauragė d. mun.;2012;72;412;149;263
Tauragė d. mun.;2012;73;410;139;271
Tauragė d. mun.;2012;74;389;134;255
Tauragė d. mun.;2012;75;392;125;267
Tauragė d. mun.;2012;76;423;131;292
Tauragė d. mun.;2012;77;379;130;249
Tauragė d. mun.;2012;78;346;111;235
Tauragė d. mun.;2012;79;348;104;244
Tauragė d. mun.;2012;80;293;81;212
Tauragė d. mun.;2012;81;287;91;196
Tauragė d. mun.;2012;82;236;64;172
Tauragė d. mun.;2012;83;247;52;195
Tauragė d. mun.;2012;84;189;41;148
Tauragė d. mun.;2012;85;804;189;615
Tauragė d. mun.;2013;-1;42494;19578;22916
Tauragė d. mun.;2013;0;393;213;180
Tauragė d. mun.;2013;1;397;195;202
Tauragė d. mun.;2013;2;347;187;160
Tauragė d. mun.;2013;3;341;154;187
Tauragė d. mun.;2013;4;388;180;208
Tauragė d. mun.;2013;5;403;212;191
Tauragė d. mun.;2013;6;348;193;155
Tauragė d. mun.;2013;7;340;195;145
Tauragė d. mun.;2013;8;387;208;179
Tauragė d. mun.;2013;9;423;214;209
Tauragė d. mun.;2013;10;395;185;210
Tauragė d. mun.;2013;11;436;217;219
Tauragė d. mun.;2013;12;487;253;234
Tauragė d. mun.;2013;13;499;274;225
Tauragė d. mun.;2013;14;514;265;249
Tauragė d. mun.;2013;15;537;277;260
Tauragė d. mun.;2013;16;598;289;309
Tauragė d. mun.;2013;17;673;345;328
Tauragė d. mun.;2013;18;645;318;327
Tauragė d. mun.;2013;19;680;342;338
Tauragė d. mun.;2013;20;748;375;373
Tauragė d. mun.;2013;21;604;335;269
Tauragė d. mun.;2013;22;610;322;288
Tauragė d. mun.;2013;23;522;281;241
Tauragė d. mun.;2013;24;503;246;257
Tauragė d. mun.;2013;25;549;280;269
Tauragė d. mun.;2013;26;472;250;222
Tauragė d. mun.;2013;27;426;230;196
Tauragė d. mun.;2013;28;412;206;206
Tauragė d. mun.;2013;29;443;244;199
Tauragė d. mun.;2013;30;351;169;182
Tauragė d. mun.;2013;31;387;194;193
Tauragė d. mun.;2013;32;393;194;199
Tauragė d. mun.;2013;33;457;207;250
Tauragė d. mun.;2013;34;450;223;227
Tauragė d. mun.;2013;35;449;231;218
Tauragė d. mun.;2013;36;511;240;271
Tauragė d. mun.;2013;37;556;262;294
Tauragė d. mun.;2013;38;572;297;275
Tauragė d. mun.;2013;39;573;242;331
Tauragė d. mun.;2013;40;605;299;306
Tauragė d. mun.;2013;41;637;302;335
Tauragė d. mun.;2013;42;625;297;328
Tauragė d. mun.;2013;43;623;315;308
Tauragė d. mun.;2013;44;659;298;361
Tauragė d. mun.;2013;45;649;317;332
Tauragė d. mun.;2013;46;648;307;341
Tauragė d. mun.;2013;47;650;320;330
Tauragė d. mun.;2013;48;658;330;328
Tauragė d. mun.;2013;49;648;316;332
Tauragė d. mun.;2013;50;676;346;330
Tauragė d. mun.;2013;51;686;331;355
Tauragė d. mun.;2013;52;788;391;397
Tauragė d. mun.;2013;53;686;330;356
Tauragė d. mun.;2013;54;673;338;335
Tauragė d. mun.;2013;55;599;277;322
Tauragė d. mun.;2013;56;563;273;290
Tauragė d. mun.;2013;57;565;240;325
Tauragė d. mun.;2013;58;535;248;287
Tauragė d. mun.;2013;59;513;237;276
Tauragė d. mun.;2013;60;470;201;269
Tauragė d. mun.;2013;61;497;193;304
Tauragė d. mun.;2013;62;482;214;268
Tauragė d. mun.;2013;63;539;231;308
Tauragė d. mun.;2013;64;503;206;297
Tauragė d. mun.;2013;65;435;197;238
Tauragė d. mun.;2013;66;369;138;231
Tauragė d. mun.;2013;67;442;169;273
Tauragė d. mun.;2013;68;330;124;206
Tauragė d. mun.;2013;69;427;151;276
Tauragė d. mun.;2013;70;451;171;280
Tauragė d. mun.;2013;71;426;157;269
Tauragė d. mun.;2013;72;411;152;259
Tauragė d. mun.;2013;73;405;144;261
Tauragė d. mun.;2013;74;394;132;262
Tauragė d. mun.;2013;75;384;131;253
Tauragė d. mun.;2013;76;368;116;252
Tauragė d. mun.;2013;77;407;123;284
Tauragė d. mun.;2013;78;361;120;241
Tauragė d. mun.;2013;79;330;101;229
Tauragė d. mun.;2013;80;336;100;236
Tauragė d. mun.;2013;81;273;73;200
Tauragė d. mun.;2013;82;263;80;183
Tauragė d. mun.;2013;83;210;56;154
Tauragė d. mun.;2013;84;227;50;177
Tauragė d. mun.;2013;85;849;192;657
Tauragė d. mun.;2014;-1;41839;19288;22551
Tauragė d. mun.;2014;0;438;226;212
Tauragė d. mun.;2014;1;400;215;185
Tauragė d. mun.;2014;2;383;189;194
Tauragė d. mun.;2014;3;334;184;150
Tauragė d. mun.;2014;4;330;149;181
Tauragė d. mun.;2014;5;377;174;203
Tauragė d. mun.;2014;6;394;206;188
Tauragė d. mun.;2014;7;349;197;152
Tauragė d. mun.;2014;8;341;197;144
Tauragė d. mun.;2014;9;384;206;178
Tauragė d. mun.;2014;10;421;211;210
Tauragė d. mun.;2014;11;396;185;211
Tauragė d. mun.;2014;12;436;217;219
Tauragė d. mun.;2014;13;490;256;234
Tauragė d. mun.;2014;14;496;275;221
Tauragė d. mun.;2014;15;509;261;248
Tauragė d. mun.;2014;16;535;276;259
Tauragė d. mun.;2014;17;594;286;308
Tauragė d. mun.;2014;18;665;342;323
Tauragė d. mun.;2014;19;629;313;316
Tauragė d. mun.;2014;20;674;334;340
Tauragė d. mun.;2014;21;744;363;381
Tauragė d. mun.;2014;22;594;332;262
Tauragė d. mun.;2014;23;579;317;262
Tauragė d. mun.;2014;24;524;293;231
Tauragė d. mun.;2014;25;484;240;244
Tauragė d. mun.;2014;26;534;281;253
Tauragė d. mun.;2014;27;453;238;215
Tauragė d. mun.;2014;28;413;231;182
Tauragė d. mun.;2014;29;387;192;195
Tauragė d. mun.;2014;30;424;235;189
Tauragė d. mun.;2014;31;343;169;174
Tauragė d. mun.;2014;32;377;185;192
Tauragė d. mun.;2014;33;388;194;194
Tauragė d. mun.;2014;34;437;188;249
Tauragė d. mun.;2014;35;432;210;222
Tauragė d. mun.;2014;36;449;230;219
Tauragė d. mun.;2014;37;503;235;268
Tauragė d. mun.;2014;38;549;255;294
Tauragė d. mun.;2014;39;564;289;275
Tauragė d. mun.;2014;40;567;241;326
Tauragė d. mun.;2014;41;595;290;305
Tauragė d. mun.;2014;42;628;297;331
Tauragė d. mun.;2014;43;624;296;328
Tauragė d. mun.;2014;44;615;312;303
Tauragė d. mun.;2014;45;650;294;356
Tauragė d. mun.;2014;46;643;313;330
Tauragė d. mun.;2014;47;636;300;336
Tauragė d. mun.;2014;48;637;313;324
Tauragė d. mun.;2014;49;654;329;325
Tauragė d. mun.;2014;50;634;308;326
Tauragė d. mun.;2014;51;673;344;329
Tauragė d. mun.;2014;52;681;326;355
Tauragė d. mun.;2014;53;776;383;393
Tauragė d. mun.;2014;54;681;326;355
Tauragė d. mun.;2014;55;656;329;327
Tauragė d. mun.;2014;56;599;278;321
Tauragė d. mun.;2014;57;558;270;288
Tauragė d. mun.;2014;58;555;231;324
Tauragė d. mun.;2014;59;532;245;287
Tauragė d. mun.;2014;60;504;233;271
Tauragė d. mun.;2014;61;464;194;270
Tauragė d. mun.;2014;62;481;183;298
Tauragė d. mun.;2014;63;469;206;263
Tauragė d. mun.;2014;64;521;217;304
Tauragė d. mun.;2014;65;491;199;292
Tauragė d. mun.;2014;66;426;188;238
Tauragė d. mun.;2014;67;358;129;229
Tauragė d. mun.;2014;68;426;160;266
Tauragė d. mun.;2014;69;321;119;202
Tauragė d. mun.;2014;70;416;144;272
Tauragė d. mun.;2014;71;436;163;273
Tauragė d. mun.;2014;72;413;150;263
Tauragė d. mun.;2014;73;396;141;255
Tauragė d. mun.;2014;74;388;133;255
Tauragė d. mun.;2014;75;377;125;252
Tauragė d. mun.;2014;76;370;124;246
Tauragė d. mun.;2014;77;341;103;238
Tauragė d. mun.;2014;78;387;116;271
Tauragė d. mun.;2014;79;336;102;234
Tauragė d. mun.;2014;80;304;90;214
Tauragė d. mun.;2014;81;316;94;222
Tauragė d. mun.;2014;82;245;60;185
Tauragė d. mun.;2014;83;236;69;167
Tauragė d. mun.;2014;84;186;50;136
Tauragė d. mun.;2014;85;884;195;689
Tauragė d. mun.;2015;-1;41341;19053;22288
Tauragė d. mun.;2015;0;447;221;226
Tauragė d. mun.;2015;1;443;229;214
Tauragė d. mun.;2015;2;388;207;181
Tauragė d. mun.;2015;3;382;189;193
Tauragė d. mun.;2015;4;328;177;151
Tauragė d. mun.;2015;5;327;145;182
Tauragė d. mun.;2015;6;365;170;195
Tauragė d. mun.;2015;7;388;203;185
Tauragė d. mun.;2015;8;344;193;151
Tauragė d. mun.;2015;9;335;193;142
Tauragė d. mun.;2015;10;381;203;178
Tauragė d. mun.;2015;11;421;213;208
Tauragė d. mun.;2015;12;394;182;212
Tauragė d. mun.;2015;13;432;213;219
Tauragė d. mun.;2015;14;484;252;232
Tauragė d. mun.;2015;15;495;273;222
Tauragė d. mun.;2015;16;507;262;245
Tauragė d. mun.;2015;17;534;276;258
Tauragė d. mun.;2015;18;581;280;301
Tauragė d. mun.;2015;19;654;335;319
Tauragė d. mun.;2015;20;609;300;309
Tauragė d. mun.;2015;21;657;327;330
Tauragė d. mun.;2015;22;714;349;365
Tauragė d. mun.;2015;23;580;329;251
Tauragė d. mun.;2015;24;552;307;245
Tauragė d. mun.;2015;25;501;276;225
Tauragė d. mun.;2015;26;479;236;243
Tauragė d. mun.;2015;27;504;260;244
Tauragė d. mun.;2015;28;452;239;213
Tauragė d. mun.;2015;29;398;218;180
Tauragė d. mun.;2015;30;389;195;194
Tauragė d. mun.;2015;31;427;242;185
Tauragė d. mun.;2015;32;328;161;167
Tauragė d. mun.;2015;33;369;181;188
Tauragė d. mun.;2015;34;377;185;192
Tauragė d. mun.;2015;35;426;184;242
Tauragė d. mun.;2015;36;414;198;216
Tauragė d. mun.;2015;37;444;220;224
Tauragė d. mun.;2015;38;497;229;268
Tauragė d. mun.;2015;39;543;252;291
Tauragė d. mun.;2015;40;559;284;275
Tauragė d. mun.;2015;41;560;237;323
Tauragė d. mun.;2015;42;601;289;312
Tauragė d. mun.;2015;43;627;299;328
Tauragė d. mun.;2015;44;612;288;324
Tauragė d. mun.;2015;45;616;311;305
Tauragė d. mun.;2015;46;650;294;356
Tauragė d. mun.;2015;47;640;313;327
Tauragė d. mun.;2015;48;632;296;336
Tauragė d. mun.;2015;49;635;310;325
Tauragė d. mun.;2015;50;647;324;323
Tauragė d. mun.;2015;51;625;306;319
Tauragė d. mun.;2015;52;674;344;330
Tauragė d. mun.;2015;53;683;327;356
Tauragė d. mun.;2015;54;769;378;391
Tauragė d. mun.;2015;55;672;315;357
Tauragė d. mun.;2015;56;653;328;325
Tauragė d. mun.;2015;57;593;271;322
Tauragė d. mun.;2015;58;551;269;282
Tauragė d. mun.;2015;59;549;228;321
Tauragė d. mun.;2015;60;526;240;286
Tauragė d. mun.;2015;61;490;221;269
Tauragė d. mun.;2015;62;460;195;265
Tauragė d. mun.;2015;63;475;180;295
Tauragė d. mun.;2015;64;465;206;259
Tauragė d. mun.;2015;65;513;211;302
Tauragė d. mun.;2015;66;481;192;289
Tauragė d. mun.;2015;67;420;187;233
Tauragė d. mun.;2015;68;350;124;226
Tauragė d. mun.;2015;69;419;156;263
Tauragė d. mun.;2015;70;310;114;196
Tauragė d. mun.;2015;71;406;136;270
Tauragė d. mun.;2015;72;423;156;267
Tauragė d. mun.;2015;73;396;142;254
Tauragė d. mun.;2015;74;385;135;250
Tauragė d. mun.;2015;75;373;126;247
Tauragė d. mun.;2015;76;351;111;240
Tauragė d. mun.;2015;77;352;111;241
Tauragė d. mun.;2015;78;328;97;231
Tauragė d. mun.;2015;79;364;106;258
Tauragė d. mun.;2015;80;321;95;226
Tauragė d. mun.;2015;81;283;86;197
Tauragė d. mun.;2015;82;295;85;210
Tauragė d. mun.;2015;83;221;56;165
Tauragė d. mun.;2015;84;218;64;154
Tauragė d. mun.;2015;85;878;206;672
Tauragė d. mun.;2016;-1;40788;18753;22035
Tauragė d. mun.;2016;0;479;232;247
Tauragė d. mun.;2016;1;448;224;224
Tauragė d. mun.;2016;2;442;229;213
Tauragė d. mun.;2016;3;388;210;178
Tauragė d. mun.;2016;4;384;186;198
Tauragė d. mun.;2016;5;326;174;152
Tauragė d. mun.;2016;6;321;141;180
Tauragė d. mun.;2016;7;372;173;199
Tauragė d. mun.;2016;8;382;201;181
Tauragė d. mun.;2016;9;347;194;153
Tauragė d. mun.;2016;10;331;190;141
Tauragė d. mun.;2016;11;374;201;173
Tauragė d. mun.;2016;12;414;211;203
Tauragė d. mun.;2016;13;394;181;213
Tauragė d. mun.;2016;14;430;212;218
Tauragė d. mun.;2016;15;478;249;229
Tauragė d. mun.;2016;16;492;273;219
Tauragė d. mun.;2016;17;504;260;244
Tauragė d. mun.;2016;18;527;268;259
Tauragė d. mun.;2016;19;561;270;291
Tauragė d. mun.;2016;20;631;322;309
Tauragė d. mun.;2016;21;593;286;307
Tauragė d. mun.;2016;22;630;315;315
Tauragė d. mun.;2016;23;690;340;350
Tauragė d. mun.;2016;24;554;314;240
Tauragė d. mun.;2016;25;511;287;224
Tauragė d. mun.;2016;26;479;260;219
Tauragė d. mun.;2016;27;458;232;226
Tauragė d. mun.;2016;28;488;248;240
Tauragė d. mun.;2016;29;432;228;204
Tauragė d. mun.;2016;30;383;214;169
Tauragė d. mun.;2016;31;389;192;197
Tauragė d. mun.;2016;32;412;230;182
Tauragė d. mun.;2016;33;329;159;170
Tauragė d. mun.;2016;34;363;180;183
Tauragė d. mun.;2016;35;373;184;189
Tauragė d. mun.;2016;36;415;177;238
Tauragė d. mun.;2016;37;405;193;212
Tauragė d. mun.;2016;38;437;216;221
Tauragė d. mun.;2016;39;494;227;267
Tauragė d. mun.;2016;40;536;248;288
Tauragė d. mun.;2016;41;554;280;274
Tauragė d. mun.;2016;42;551;232;319
Tauragė d. mun.;2016;43;595;284;311
Tauragė d. mun.;2016;44;631;301;330
Tauragė d. mun.;2016;45;602;284;318
Tauragė d. mun.;2016;46;613;306;307
Tauragė d. mun.;2016;47;640;290;350
Tauragė d. mun.;2016;48;629;308;321
Tauragė d. mun.;2016;49;627;296;331
Tauragė d. mun.;2016;50;636;307;329
Tauragė d. mun.;2016;51;649;326;323
Tauragė d. mun.;2016;52;622;303;319
Tauragė d. mun.;2016;53;663;337;326
Tauragė d. mun.;2016;54;681;324;357
Tauragė d. mun.;2016;55;756;366;390
Tauragė d. mun.;2016;56;665;312;353
Tauragė d. mun.;2016;57;643;320;323
Tauragė d. mun.;2016;58;587;266;321
Tauragė d. mun.;2016;59;546;262;284
Tauragė d. mun.;2016;60;534;215;319
Tauragė d. mun.;2016;61;523;235;288
Tauragė d. mun.;2016;62;483;215;268
Tauragė d. mun.;2016;63;456;192;264
Tauragė d. mun.;2016;64;468;176;292
Tauragė d. mun.;2016;65;455;197;258
Tauragė d. mun.;2016;66;506;206;300
Tauragė d. mun.;2016;67;465;182;283
Tauragė d. mun.;2016;68;408;178;230
Tauragė d. mun.;2016;69;333;116;217
Tauragė d. mun.;2016;70;407;148;259
Tauragė d. mun.;2016;71;307;113;194
Tauragė d. mun.;2016;72;397;130;267
Tauragė d. mun.;2016;73;404;142;262
Tauragė d. mun.;2016;74;383;137;246
Tauragė d. mun.;2016;75;364;122;242
Tauragė d. mun.;2016;76;361;125;236
Tauragė d. mun.;2016;77;337;105;232
Tauragė d. mun.;2016;78;344;104;240
Tauragė d. mun.;2016;79;303;89;214
Tauragė d. mun.;2016;80;344;99;245
Tauragė d. mun.;2016;81;292;83;209
Tauragė d. mun.;2016;82;260;74;186
Tauragė d. mun.;2016;83;259;67;192
Tauragė d. mun.;2016;84;196;49;147
Tauragė d. mun.;2016;85;913;219;694
Tauragė d. mun.;2017;-1;39923;18353;21570
Tauragė d. mun.;2017;0;430;217;213
Tauragė d. mun.;2017;1;479;232;247
Tauragė d. mun.;2017;2;434;213;221
Tauragė d. mun.;2017;3;438;226;212
Tauragė d. mun.;2017;4;375;208;167
Tauragė d. mun.;2017;5;375;180;195
Tauragė d. mun.;2017;6;325;172;153
Tauragė d. mun.;2017;7;325;148;177
Tauragė d. mun.;2017;8;360;167;193
Tauragė d. mun.;2017;9;379;201;178
Tauragė d. mun.;2017;10;337;187;150
Tauragė d. mun.;2017;11;326;189;137
Tauragė d. mun.;2017;12;368;196;172
Tauragė d. mun.;2017;13;403;205;198
Tauragė d. mun.;2017;14;387;183;204
Tauragė d. mun.;2017;15;424;209;215
Tauragė d. mun.;2017;16;472;243;229
Tauragė d. mun.;2017;17;492;272;220
Tauragė d. mun.;2017;18;502;256;246
Tauragė d. mun.;2017;19;500;252;248
Tauragė d. mun.;2017;20;559;268;291
Tauragė d. mun.;2017;21;614;305;309
Tauragė d. mun.;2017;22;572;283;289
Tauragė d. mun.;2017;23;596;301;295
Tauragė d. mun.;2017;24;662;323;339
Tauragė d. mun.;2017;25;517;300;217
Tauragė d. mun.;2017;26;469;272;197
Tauragė d. mun.;2017;27;436;243;193
Tauragė d. mun.;2017;28;437;222;215
Tauragė d. mun.;2017;29;458;239;219
Tauragė d. mun.;2017;30;393;206;187
Tauragė d. mun.;2017;31;362;198;164
Tauragė d. mun.;2017;32;370;187;183
Tauragė d. mun.;2017;33;390;215;175
Tauragė d. mun.;2017;34;312;149;163
Tauragė d. mun.;2017;35;338;170;168
Tauragė d. mun.;2017;36;373;189;184
Tauragė d. mun.;2017;37;405;169;236
Tauragė d. mun.;2017;38;396;185;211
Tauragė d. mun.;2017;39;431;211;220
Tauragė d. mun.;2017;40;477;216;261
Tauragė d. mun.;2017;41;530;251;279
Tauragė d. mun.;2017;42;535;266;269
Tauragė d. mun.;2017;43;535;225;310
Tauragė d. mun.;2017;44;579;277;302
Tauragė d. mun.;2017;45;627;300;327
Tauragė d. mun.;2017;46;597;279;318
Tauragė d. mun.;2017;47;605;303;302
Tauragė d. mun.;2017;48;631;285;346
Tauragė d. mun.;2017;49;624;306;318
Tauragė d. mun.;2017;50;617;296;321
Tauragė d. mun.;2017;51;627;301;326
Tauragė d. mun.;2017;52;639;316;323
Tauragė d. mun.;2017;53;611;293;318
Tauragė d. mun.;2017;54;655;331;324
Tauragė d. mun.;2017;55;671;319;352
Tauragė d. mun.;2017;56;741;357;384
Tauragė d. mun.;2017;57;654;302;352
Tauragė d. mun.;2017;58;635;313;322
Tauragė d. mun.;2017;59;576;262;314
Tauragė d. mun.;2017;60;537;256;281
Tauragė d. mun.;2017;61;527;211;316
Tauragė d. mun.;2017;62;519;229;290
Tauragė d. mun.;2017;63;472;208;264
Tauragė d. mun.;2017;64;445;184;261
Tauragė d. mun.;2017;65;456;166;290
Tauragė d. mun.;2017;66;448;191;257
Tauragė d. mun.;2017;67;493;198;295
Tauragė d. mun.;2017;68;455;175;280
Tauragė d. mun.;2017;69;396;171;225
Tauragė d. mun.;2017;70;332;114;218
Tauragė d. mun.;2017;71;389;138;251
Tauragė d. mun.;2017;72;297;109;188
Tauragė d. mun.;2017;73;389;128;261
Tauragė d. mun.;2017;74;384;136;248
Tauragė d. mun.;2017;75;370;129;241
Tauragė d. mun.;2017;76;347;116;231
Tauragė d. mun.;2017;77;349;120;229
Tauragė d. mun.;2017;78;321;97;224
Tauragė d. mun.;2017;79;333;99;234
Tauragė d. mun.;2017;80;291;86;205
Tauragė d. mun.;2017;81;323;88;235
Tauragė d. mun.;2017;82;264;70;194
Tauragė d. mun.;2017;83;232;64;168
Tauragė d. mun.;2017;84;234;57;177
Tauragė d. mun.;2017;85;933;224;709
Tauragė d. mun.;2018;-1;38921;17856;21065
Tauragė d. mun.;2018;0;408;218;190
Tauragė d. mun.;2018;1;428;213;215
Tauragė d. mun.;2018;2;461;225;236
Tauragė d. mun.;2018;3;431;208;223
Tauragė d. mun.;2018;4;425;217;208
Tauragė d. mun.;2018;5;376;209;167
Tauragė d. mun.;2018;6;375;183;192
Tauragė d. mun.;2018;7;324;170;154
Tauragė d. mun.;2018;8;324;148;176
Tauragė d. mun.;2018;9;352;167;185
Tauragė d. mun.;2018;10;374;198;176
Tauragė d. mun.;2018;11;335;183;152
Tauragė d. mun.;2018;12;322;183;139
Tauragė d. mun.;2018;13;362;193;169
Tauragė d. mun.;2018;14;399;201;198
Tauragė d. mun.;2018;15;382;180;202
Tauragė d. mun.;2018;16;421;207;214
Tauragė d. mun.;2018;17;472;243;229
Tauragė d. mun.;2018;18;486;270;216
Tauragė d. mun.;2018;19;469;242;227
Tauragė d. mun.;2018;20;482;243;239
Tauragė d. mun.;2018;21;532;250;282
Tauragė d. mun.;2018;22;578;290;288
Tauragė d. mun.;2018;23;528;264;264
Tauragė d. mun.;2018;24;549;276;273
Tauragė d. mun.;2018;25;619;297;322
Tauragė d. mun.;2018;26;471;279;192
Tauragė d. mun.;2018;27;431;255;176
Tauragė d. mun.;2018;28;393;217;176
Tauragė d. mun.;2018;29;405;210;195
Tauragė d. mun.;2018;30;421;215;206
Tauragė d. mun.;2018;31;359;195;164
Tauragė d. mun.;2018;32;339;186;153
Tauragė d. mun.;2018;33;341;173;168
Tauragė d. mun.;2018;34;376;205;171
Tauragė d. mun.;2018;35;295;138;157
Tauragė d. mun.;2018;36;317;154;163
Tauragė d. mun.;2018;37;362;180;182
Tauragė d. mun.;2018;38;393;161;232
Tauragė d. mun.;2018;39;383;179;204
Tauragė d. mun.;2018;40;422;204;218
Tauragė d. mun.;2018;41;469;215;254
Tauragė d. mun.;2018;42;520;248;272
Tauragė d. mun.;2018;43;522;257;265
Tauragė d. mun.;2018;44;532;225;307
Tauragė d. mun.;2018;45;569;267;302
Tauragė d. mun.;2018;46;613;295;318
Tauragė d. mun.;2018;47;584;271;313
Tauragė d. mun.;2018;48;596;295;301
Tauragė d. mun.;2018;49;627;282;345
Tauragė d. mun.;2018;50;615;298;317
Tauragė d. mun.;2018;51;610;297;313
Tauragė d. mun.;2018;52;617;297;320
Tauragė d. mun.;2018;53;630;307;323
Tauragė d. mun.;2018;54;605;289;316
Tauragė d. mun.;2018;55;648;326;322
Tauragė d. mun.;2018;56;663;312;351
Tauragė d. mun.;2018;57;725;350;375
Tauragė d. mun.;2018;58;639;293;346
Tauragė d. mun.;2018;59;628;304;324
Tauragė d. mun.;2018;60;568;254;314
Tauragė d. mun.;2018;61;528;249;279
Tauragė d. mun.;2018;62;517;204;313
Tauragė d. mun.;2018;63;507;221;286
Tauragė d. mun.;2018;64;462;200;262
Tauragė d. mun.;2018;65;438;180;258
Tauragė d. mun.;2018;66;447;162;285
Tauragė d. mun.;2018;67;430;179;251
Tauragė d. mun.;2018;68;480;189;291
Tauragė d. mun.;2018;69;445;169;276
Tauragė d. mun.;2018;70;385;165;220
Tauragė d. mun.;2018;71;325;110;215
Tauragė d. mun.;2018;72;377;132;245
Tauragė d. mun.;2018;73;287;103;184
Tauragė d. mun.;2018;74;378;122;256
Tauragė d. mun.;2018;75;373;128;245
Tauragė d. mun.;2018;76;358;122;236
Tauragė d. mun.;2018;77;333;111;222
Tauragė d. mun.;2018;78;339;115;224
Tauragė d. mun.;2018;79;304;90;214
Tauragė d. mun.;2018;80;308;89;219
Tauragė d. mun.;2018;81;270;78;192
Tauragė d. mun.;2018;82;299;78;221
Tauragė d. mun.;2018;83;239;58;181
Tauragė d. mun.;2018;84;215;61;154
Tauragė d. mun.;2018;85;975;230;745
Telšiai county;2001;-1;179952;85319;94633
Telšiai county;2001;0;1960;1021;939
Telšiai county;2001;1;2112;1124;988
Telšiai county;2001;2;2198;1109;1089
Telšiai county;2001;3;2190;1154;1036
Telšiai county;2001;4;2268;1197;1071
Telšiai county;2001;5;2425;1214;1211
Telšiai county;2001;6;2608;1275;1333
Telšiai county;2001;7;2851;1464;1387
Telšiai county;2001;8;3360;1674;1686
Telšiai county;2001;9;3195;1577;1618
Telšiai county;2001;10;3157;1673;1484
Telšiai county;2001;11;3297;1700;1597
Telšiai county;2001;12;3086;1573;1513
Telšiai county;2001;13;3227;1640;1587
Telšiai county;2001;14;3302;1699;1603
Telšiai county;2001;15;3200;1680;1520
Telšiai county;2001;16;3125;1579;1546
Telšiai county;2001;17;3074;1561;1513
Telšiai county;2001;18;2570;1377;1193
Telšiai county;2001;19;2163;1160;1003
Telšiai county;2001;20;2155;1134;1021
Telšiai county;2001;21;2184;1156;1028
Telšiai county;2001;22;2234;1158;1076
Telšiai county;2001;23;2298;1180;1118
Telšiai county;2001;24;2286;1153;1133
Telšiai county;2001;25;2300;1125;1175
Telšiai county;2001;26;2352;1156;1196
Telšiai county;2001;27;2370;1141;1229
Telšiai county;2001;28;2587;1277;1310
Telšiai county;2001;29;2732;1353;1379
Telšiai county;2001;30;2669;1307;1362
Telšiai county;2001;31;2573;1325;1248
Telšiai county;2001;32;2485;1215;1270
Telšiai county;2001;33;2624;1291;1333
Telšiai county;2001;34;2608;1308;1300
Telšiai county;2001;35;2603;1313;1290
Telšiai county;2001;36;2779;1380;1399
Telšiai county;2001;37;2687;1292;1395
Telšiai county;2001;38;2860;1466;1394
Telšiai county;2001;39;2958;1426;1532
Telšiai county;2001;40;2849;1432;1417
Telšiai county;2001;41;2838;1384;1454
Telšiai county;2001;42;2735;1309;1426
Telšiai county;2001;43;2516;1224;1292
Telšiai county;2001;44;2353;1131;1222
Telšiai county;2001;45;2394;1142;1252
Telšiai county;2001;46;2049;980;1069
Telšiai county;2001;47;2013;980;1033
Telšiai county;2001;48;2085;983;1102
Telšiai county;2001;49;1988;953;1035
Telšiai county;2001;50;2117;1030;1087
Telšiai county;2001;51;2077;965;1112
Telšiai county;2001;52;1846;872;974
Telšiai county;2001;53;1658;764;894
Telšiai county;2001;54;1639;755;884
Telšiai county;2001;55;1746;764;982
Telšiai county;2001;56;1549;675;874
Telšiai county;2001;57;1742;760;982
Telšiai county;2001;58;1825;800;1025
Telšiai county;2001;59;1886;867;1019
Telšiai county;2001;60;1693;714;979
Telšiai county;2001;61;1633;680;953
Telšiai county;2001;62;1653;692;961
Telšiai county;2001;63;1644;648;996
Telšiai county;2001;64;1850;788;1062
Telšiai county;2001;65;1731;697;1034
Telšiai county;2001;66;1537;607;930
Telšiai county;2001;67;1625;628;997
Telšiai county;2001;68;1561;614;947
Telšiai county;2001;69;1534;605;929
Telšiai county;2001;70;1404;532;872
Telšiai county;2001;71;1347;518;829
Telšiai county;2001;72;1512;530;982
Telšiai county;2001;73;1337;444;893
Telšiai county;2001;74;1184;382;802
Telšiai county;2001;75;1207;381;826
Telšiai county;2001;76;1091;346;745
Telšiai county;2001;77;1004;345;659
Telšiai county;2001;78;904;306;598
Telšiai county;2001;79;808;244;564
Telšiai county;2001;80;625;213;412
Telšiai county;2001;81;519;167;352
Telšiai county;2001;82;368;106;262
Telšiai county;2001;83;317;96;221
Telšiai county;2001;84;354;115;239
Telšiai county;2001;85;1893;544;1349
Telšiai county;2002;-1;178315;84329;93986
Telšiai county;2002;0;1749;904;845
Telšiai county;2002;1;1930;1002;928
Telšiai county;2002;2;2106;1121;985
Telšiai county;2002;3;2177;1103;1074
Telšiai county;2002;4;2170;1145;1025
Telšiai county;2002;5;2266;1195;1071
Telšiai county;2002;6;2403;1207;1196
Telšiai county;2002;7;2599;1272;1327
Telšiai county;2002;8;2827;1452;1375
Telšiai county;2002;9;3342;1657;1685
Telšiai county;2002;10;3193;1570;1623
Telšiai county;2002;11;3121;1652;1469
Telšiai county;2002;12;3260;1680;1580
Telšiai county;2002;13;3031;1544;1487
Telšiai county;2002;14;3193;1615;1578
Telšiai county;2002;15;3254;1668;1586
Telšiai county;2002;16;3160;1658;1502
Telšiai county;2002;17;3073;1549;1524
Telšiai county;2002;18;2978;1508;1470
Telšiai county;2002;19;2487;1327;1160
Telšiai county;2002;20;2137;1141;996
Telšiai county;2002;21;2125;1116;1009
Telšiai county;2002;22;2176;1135;1041
Telšiai county;2002;23;2202;1135;1067
Telšiai county;2002;24;2262;1158;1104
Telšiai county;2002;25;2262;1138;1124
Telšiai county;2002;26;2269;1109;1160
Telšiai county;2002;27;2306;1129;1177
Telšiai county;2002;28;2319;1111;1208
Telšiai county;2002;29;2532;1238;1294
Telšiai county;2002;30;2659;1315;1344
Telšiai county;2002;31;2622;1283;1339
Telšiai county;2002;32;2528;1296;1232
Telšiai county;2002;33;2447;1186;1261
Telšiai county;2002;34;2584;1265;1319
Telšiai county;2002;35;2568;1281;1287
Telšiai county;2002;36;2575;1296;1279
Telšiai county;2002;37;2727;1341;1386
Telšiai county;2002;38;2639;1258;1381
Telšiai county;2002;39;2803;1430;1373
Telšiai county;2002;40;2901;1387;1514
Telšiai county;2002;41;2808;1403;1405
Telšiai county;2002;42;2797;1361;1436
Telšiai county;2002;43;2714;1306;1408
Telšiai county;2002;44;2480;1205;1275
Telšiai county;2002;45;2305;1102;1203
Telšiai county;2002;46;2347;1113;1234
Telšiai county;2002;47;2026;971;1055
Telšiai county;2002;48;1973;958;1015
Telšiai county;2002;49;2032;951;1081
Telšiai county;2002;50;1952;924;1028
Telšiai county;2002;51;2075;1001;1074
Telšiai county;2002;52;2043;941;1102
Telšiai county;2002;53;1822;860;962
Telšiai county;2002;54;1610;743;867
Telšiai county;2002;55;1597;730;867
Telšiai county;2002;56;1702;748;954
Telšiai county;2002;57;1516;659;857
Telšiai county;2002;58;1690;734;956
Telšiai county;2002;59;1780;775;1005
Telšiai county;2002;60;1860;851;1009
Telšiai county;2002;61;1687;714;973
Telšiai county;2002;62;1620;673;947
Telšiai county;2002;63;1636;680;956
Telšiai county;2002;64;1626;633;993
Telšiai county;2002;65;1825;766;1059
Telšiai county;2002;66;1699;669;1030
Telšiai county;2002;67;1515;591;924
Telšiai county;2002;68;1600;607;993
Telšiai county;2002;69;1531;590;941
Telšiai county;2002;70;1515;596;919
Telšiai county;2002;71;1365;507;858
Telšiai county;2002;72;1330;507;823
Telšiai county;2002;73;1479;514;965
Telšiai county;2002;74;1294;419;875
Telšiai county;2002;75;1148;363;785
Telšiai county;2002;76;1154;356;798
Telšiai county;2002;77;1047;331;716
Telšiai county;2002;78;960;317;643
Telšiai county;2002;79;848;278;570
Telšiai county;2002;80;773;221;552
Telšiai county;2002;81;579;192;387
Telšiai county;2002;82;478;159;319
Telšiai county;2002;83;338;96;242
Telšiai county;2002;84;281;83;198
Telšiai county;2002;85;1896;554;1342
Telšiai county;2003;-1;177139;83734;93405
Telšiai county;2003;0;1641;857;784
Telšiai county;2003;1;1736;897;839
Telšiai county;2003;2;1922;993;929
Telšiai county;2003;3;2097;1116;981
Telšiai county;2003;4;2171;1098;1073
Telšiai county;2003;5;2164;1142;1022
Telšiai county;2003;6;2247;1184;1063
Telšiai county;2003;7;2390;1201;1189
Telšiai county;2003;8;2590;1265;1325
Telšiai county;2003;9;2821;1450;1371
Telšiai county;2003;10;3312;1646;1666
Telšiai county;2003;11;3172;1566;1606
Telšiai county;2003;12;3076;1629;1447
Telšiai county;2003;13;3207;1651;1556
Telšiai county;2003;14;2991;1521;1470
Telšiai county;2003;15;3149;1589;1560
Telšiai county;2003;16;3205;1642;1563
Telšiai county;2003;17;3100;1619;1481
Telšiai county;2003;18;3042;1536;1506
Telšiai county;2003;19;2936;1489;1447
Telšiai county;2003;20;2453;1313;1140
Telšiai county;2003;21;2131;1134;997
Telšiai county;2003;22;2117;1102;1015
Telšiai county;2003;23;2167;1126;1041
Telšiai county;2003;24;2199;1130;1069
Telšiai county;2003;25;2251;1154;1097
Telšiai county;2003;26;2262;1139;1123
Telšiai county;2003;27;2245;1089;1156
Telšiai county;2003;28;2278;1111;1167
Telšiai county;2003;29;2309;1103;1206
Telšiai county;2003;30;2497;1217;1280
Telšiai county;2003;31;2638;1304;1334
Telšiai county;2003;32;2595;1272;1323
Telšiai county;2003;33;2496;1286;1210
Telšiai county;2003;34;2418;1180;1238
Telšiai county;2003;35;2546;1241;1305
Telšiai county;2003;36;2537;1264;1273
Telšiai county;2003;37;2551;1286;1265
Telšiai county;2003;38;2701;1332;1369
Telšiai county;2003;39;2616;1249;1367
Telšiai county;2003;40;2779;1418;1361
Telšiai county;2003;41;2870;1373;1497
Telšiai county;2003;42;2783;1388;1395
Telšiai county;2003;43;2763;1345;1418
Telšiai county;2003;44;2698;1295;1403
Telšiai county;2003;45;2448;1183;1265
Telšiai county;2003;46;2288;1094;1194
Telšiai county;2003;47;2311;1096;1215
Telšiai county;2003;48;2006;959;1047
Telšiai county;2003;49;1956;947;1009
Telšiai county;2003;50;2015;948;1067
Telšiai county;2003;51;1917;907;1010
Telšiai county;2003;52;2042;982;1060
Telšiai county;2003;53;2039;943;1096
Telšiai county;2003;54;1790;836;954
Telšiai county;2003;55;1589;729;860
Telšiai county;2003;56;1567;712;855
Telšiai county;2003;57;1668;719;949
Telšiai county;2003;58;1495;643;852
Telšiai county;2003;59;1671;723;948
Telšiai county;2003;60;1736;751;985
Telšiai county;2003;61;1832;834;998
Telšiai county;2003;62;1663;698;965
Telšiai county;2003;63;1595;649;946
Telšiai county;2003;64;1618;667;951
Telšiai county;2003;65;1606;623;983
Telšiai county;2003;66;1803;751;1052
Telšiai county;2003;67;1687;665;1022
Telšiai county;2003;68;1479;567;912
Telšiai county;2003;69;1558;578;980
Telšiai county;2003;70;1495;563;932
Telšiai county;2003;71;1472;573;899
Telšiai county;2003;72;1340;494;846
Telšiai county;2003;73;1278;480;798
Telšiai county;2003;74;1436;487;949
Telšiai county;2003;75;1230;387;843
Telšiai county;2003;76;1103;340;763
Telšiai county;2003;77;1103;331;772
Telšiai county;2003;78;979;305;674
Telšiai county;2003;79;900;287;613
Telšiai county;2003;80;798;258;540
Telšiai county;2003;81;717;194;523
Telšiai county;2003;82;520;162;358
Telšiai county;2003;83;425;140;285
Telšiai county;2003;84;306;74;232
Telšiai county;2003;85;1789;513;1276
Telšiai county;2004;-1;175090;82733;92357
Telšiai county;2004;0;1697;888;809
Telšiai county;2004;1;1631;850;781
Telšiai county;2004;2;1728;893;835
Telšiai county;2004;3;1908;990;918
Telšiai county;2004;4;2079;1104;975
Telšiai county;2004;5;2148;1093;1055
Telšiai county;2004;6;2159;1142;1017
Telšiai county;2004;7;2232;1174;1058
Telšiai county;2004;8;2383;1200;1183
Telšiai county;2004;9;2578;1264;1314
Telšiai county;2004;10;2807;1448;1359
Telšiai county;2004;11;3286;1633;1653
Telšiai county;2004;12;3140;1552;1588
Telšiai county;2004;13;3026;1612;1414
Telšiai county;2004;14;3145;1625;1520
Telšiai county;2004;15;2947;1506;1441
Telšiai county;2004;16;3099;1572;1527
Telšiai county;2004;17;3152;1626;1526
Telšiai county;2004;18;3032;1589;1443
Telšiai county;2004;19;2962;1504;1458
Telšiai county;2004;20;2868;1458;1410
Telšiai county;2004;21;2382;1275;1107
Telšiai county;2004;22;2100;1117;983
Telšiai county;2004;23;2086;1092;994
Telšiai county;2004;24;2142;1105;1037
Telšiai county;2004;25;2123;1090;1033
Telšiai county;2004;26;2183;1111;1072
Telšiai county;2004;27;2209;1107;1102
Telšiai county;2004;28;2196;1064;1132
Telšiai county;2004;29;2237;1085;1152
Telšiai county;2004;30;2238;1067;1171
Telšiai county;2004;31;2438;1183;1255
Telšiai county;2004;32;2577;1273;1304
Telšiai county;2004;33;2565;1254;1311
Telšiai county;2004;34;2460;1260;1200
Telšiai county;2004;35;2386;1164;1222
Telšiai county;2004;36;2513;1223;1290
Telšiai county;2004;37;2512;1253;1259
Telšiai county;2004;38;2514;1266;1248
Telšiai county;2004;39;2655;1312;1343
Telšiai county;2004;40;2564;1225;1339
Telšiai county;2004;41;2735;1400;1335
Telšiai county;2004;42;2833;1357;1476
Telšiai county;2004;43;2756;1372;1384
Telšiai county;2004;44;2707;1308;1399
Telšiai county;2004;45;2670;1287;1383
Telšiai county;2004;46;2398;1153;1245
Telšiai county;2004;47;2253;1078;1175
Telšiai county;2004;48;2275;1073;1202
Telšiai county;2004;49;1970;936;1034
Telšiai county;2004;50;1917;928;989
Telšiai county;2004;51;1978;924;1054
Telšiai county;2004;52;1882;889;993
Telšiai county;2004;53;2003;963;1040
Telšiai county;2004;54;2004;918;1086
Telšiai county;2004;55;1762;818;944
Telšiai county;2004;56;1557;707;850
Telšiai county;2004;57;1515;679;836
Telšiai county;2004;58;1633;701;932
Telšiai county;2004;59;1472;627;845
Telšiai county;2004;60;1620;695;925
Telšiai county;2004;61;1697;725;972
Telšiai county;2004;62;1803;818;985
Telšiai county;2004;63;1630;680;950
Telšiai county;2004;64;1571;629;942
Telšiai county;2004;65;1602;648;954
Telšiai county;2004;66;1584;598;986
Telšiai county;2004;67;1773;729;1044
Telšiai county;2004;68;1647;636;1011
Telšiai county;2004;69;1451;542;909
Telšiai county;2004;70;1525;558;967
Telšiai county;2004;71;1440;537;903
Telšiai county;2004;72;1424;544;880
Telšiai county;2004;73;1278;455;823
Telšiai county;2004;74;1236;458;778
Telšiai county;2004;75;1383;454;929
Telšiai county;2004;76;1172;355;817
Telšiai county;2004;77;1047;317;730
Telšiai county;2004;78;1046;312;734
Telšiai county;2004;79;912;263;649
Telšiai county;2004;80;834;257;577
Telšiai county;2004;81;728;229;499
Telšiai county;2004;82;655;169;486
Telšiai county;2004;83;477;145;332
Telšiai county;2004;84;380;119;261
Telšiai county;2004;85;1768;494;1274
Telšiai county;2005;-1;172426;81423;91003
Telšiai county;2005;0;1695;852;843
Telšiai county;2005;1;1684;889;795
Telšiai county;2005;2;1616;844;772
Telšiai county;2005;3;1715;888;827
Telšiai county;2005;4;1881;974;907
Telšiai county;2005;5;2053;1091;962
Telšiai county;2005;6;2119;1077;1042
Telšiai county;2005;7;2137;1128;1009
Telšiai county;2005;8;2218;1167;1051
Telšiai county;2005;9;2370;1196;1174
Telšiai county;2005;10;2562;1258;1304
Telšiai county;2005;11;2782;1440;1342
Telšiai county;2005;12;3250;1616;1634
Telšiai county;2005;13;3106;1538;1568
Telšiai county;2005;14;2986;1591;1395
Telšiai county;2005;15;3102;1602;1500
Telšiai county;2005;16;2895;1480;1415
Telšiai county;2005;17;3034;1534;1500
Telšiai county;2005;18;3068;1581;1487
Telšiai county;2005;19;2930;1534;1396
Telšiai county;2005;20;2863;1459;1404
Telšiai county;2005;21;2775;1416;1359
Telšiai county;2005;22;2313;1242;1071
Telšiai county;2005;23;1999;1075;924
Telšiai county;2005;24;2014;1065;949
Telšiai county;2005;25;2048;1061;987
Telšiai county;2005;26;2058;1068;990
Telšiai county;2005;27;2091;1073;1018
Telšiai county;2005;28;2145;1078;1067
Telšiai county;2005;29;2160;1043;1117
Telšiai county;2005;30;2174;1052;1122
Telšiai county;2005;31;2181;1032;1149
Telšiai county;2005;32;2371;1139;1232
Telšiai county;2005;33;2541;1253;1288
Telšiai county;2005;34;2497;1215;1282
Telšiai county;2005;35;2405;1223;1182
Telšiai county;2005;36;2337;1135;1202
Telšiai county;2005;37;2460;1195;1265
Telšiai county;2005;38;2473;1229;1244
Telšiai county;2005;39;2461;1226;1235
Telšiai county;2005;40;2601;1283;1318
Telšiai county;2005;41;2511;1198;1313
Telšiai county;2005;42;2680;1369;1311
Telšiai county;2005;43;2786;1329;1457
Telšiai county;2005;44;2733;1358;1375
Telšiai county;2005;45;2664;1286;1378
Telšiai county;2005;46;2643;1274;1369
Telšiai county;2005;47;2368;1137;1231
Telšiai county;2005;48;2208;1052;1156
Telšiai county;2005;49;2232;1051;1181
Telšiai county;2005;50;1941;916;1025
Telšiai county;2005;51;1883;908;975
Telšiai county;2005;52;1927;887;1040
Telšiai county;2005;53;1846;867;979
Telšiai county;2005;54;1975;941;1034
Telšiai county;2005;55;1968;893;1075
Telšiai county;2005;56;1739;804;935
Telšiai county;2005;57;1523;686;837
Telšiai county;2005;58;1485;661;824
Telšiai county;2005;59;1601;684;917
Telšiai county;2005;60;1448;611;837
Telšiai county;2005;61;1583;676;907
Telšiai county;2005;62;1660;703;957
Telšiai county;2005;63;1754;791;963
Telšiai county;2005;64;1572;644;928
Telšiai county;2005;65;1542;613;929
Telšiai county;2005;66;1560;630;930
Telšiai county;2005;67;1548;576;972
Telšiai county;2005;68;1715;692;1023
Telšiai county;2005;69;1599;612;987
Telšiai county;2005;70;1403;513;890
Telšiai county;2005;71;1485;528;957
Telšiai county;2005;72;1379;499;880
Telšiai county;2005;73;1383;526;857
Telšiai county;2005;74;1236;436;800
Telšiai county;2005;75;1182;427;755
Telšiai county;2005;76;1329;432;897
Telšiai county;2005;77;1116;334;782
Telšiai county;2005;78;986;293;693
Telšiai county;2005;79;972;285;687
Telšiai county;2005;80;848;238;610
Telšiai county;2005;81;790;240;550
Telšiai county;2005;82;679;216;463
Telšiai county;2005;83;593;157;436
Telšiai county;2005;84;433;130;303
Telšiai county;2005;85;1748;478;1270
Telšiai county;2006;-1;167888;78876;89012
Telšiai county;2006;0;1564;807;757
Telšiai county;2006;1;1657;830;827
Telšiai county;2006;2;1641;861;780
Telšiai county;2006;3;1579;828;751
Telšiai county;2006;4;1673;864;809
Telšiai county;2006;5;1848;958;890
Telšiai county;2006;6;2012;1073;939
Telšiai county;2006;7;2081;1055;1026
Telšiai county;2006;8;2108;1109;999
Telšiai county;2006;9;2184;1154;1030
Telšiai county;2006;10;2337;1177;1160
Telšiai county;2006;11;2529;1237;1292
Telšiai county;2006;12;2755;1421;1334
Telšiai county;2006;13;3173;1568;1605
Telšiai county;2006;14;3045;1506;1539
Telšiai county;2006;15;2890;1535;1355
Telšiai county;2006;16;2989;1538;1451
Telšiai county;2006;17;2798;1421;1377
Telšiai county;2006;18;2910;1463;1447
Telšiai county;2006;19;2894;1477;1417
Telšiai county;2006;20;2769;1447;1322
Telšiai county;2006;21;2676;1363;1313
Telšiai county;2006;22;2613;1346;1267
Telšiai county;2006;23;2179;1175;1004
Telšiai county;2006;24;1862;1002;860
Telšiai county;2006;25;1857;983;874
Telšiai county;2006;26;1924;994;930
Telšiai county;2006;27;1963;1015;948
Telšiai county;2006;28;2016;1023;993
Telšiai county;2006;29;2087;1050;1037
Telšiai county;2006;30;2113;1009;1104
Telšiai county;2006;31;2104;1019;1085
Telšiai county;2006;32;2116;997;1119
Telšiai county;2006;33;2298;1092;1206
Telšiai county;2006;34;2455;1198;1257
Telšiai county;2006;35;2417;1168;1249
Telšiai county;2006;36;2322;1175;1147
Telšiai county;2006;37;2264;1089;1175
Telšiai county;2006;38;2390;1153;1237
Telšiai county;2006;39;2404;1188;1216
Telšiai county;2006;40;2390;1181;1209
Telšiai county;2006;41;2527;1240;1287
Telšiai county;2006;42;2427;1143;1284
Telšiai county;2006;43;2619;1331;1288
Telšiai county;2006;44;2720;1289;1431
Telšiai county;2006;45;2674;1325;1349
Telšiai county;2006;46;2608;1249;1359
Telšiai county;2006;47;2596;1243;1353
Telšiai county;2006;48;2316;1101;1215
Telšiai county;2006;49;2146;1012;1134
Telšiai county;2006;50;2182;1020;1162
Telšiai county;2006;51;1903;889;1014
Telšiai county;2006;52;1839;879;960
Telšiai county;2006;53;1888;862;1026
Telšiai county;2006;54;1802;847;955
Telšiai county;2006;55;1929;912;1017
Telšiai county;2006;56;1912;854;1058
Telšiai county;2006;57;1712;778;934
Telšiai county;2006;58;1493;670;823
Telšiai county;2006;59;1444;639;805
Telšiai county;2006;60;1573;662;911
Telšiai county;2006;61;1399;578;821
Telšiai county;2006;62;1528;636;892
Telšiai county;2006;63;1602;656;946
Telšiai county;2006;64;1698;752;946
Telšiai county;2006;65;1519;609;910
Telšiai county;2006;66;1505;591;914
Telšiai county;2006;67;1510;596;914
Telšiai county;2006;68;1498;550;948
Telšiai county;2006;69;1653;654;999
Telšiai county;2006;70;1538;563;975
Telšiai county;2006;71;1342;483;859
Telšiai county;2006;72;1431;497;934
Telšiai county;2006;73;1327;479;848
Telšiai county;2006;74;1322;490;832
Telšiai county;2006;75;1189;408;781
Telšiai county;2006;76;1122;400;722
Telšiai county;2006;77;1251;396;855
Telšiai county;2006;78;1038;303;735
Telšiai county;2006;79;923;261;662
Telšiai county;2006;80;916;264;652
Telšiai county;2006;81;759;200;559
Telšiai county;2006;82;711;205;506
Telšiai county;2006;83;605;183;422
Telšiai county;2006;84;519;130;389
Telšiai county;2006;85;1787;498;1289
Telšiai county;2007;-1;164963;77170;87793
Telšiai county;2007;0;1614;781;833
Telšiai county;2007;1;1545;793;752
Telšiai county;2007;2;1629;818;811
Telšiai county;2007;3;1626;851;775
Telšiai county;2007;4;1557;811;746
Telšiai county;2007;5;1645;848;797
Telšiai county;2007;6;1823;951;872
Telšiai county;2007;7;1995;1058;937
Telšiai county;2007;8;2053;1035;1018
Telšiai county;2007;9;2080;1094;986
Telšiai county;2007;10;2162;1138;1024
Telšiai county;2007;11;2324;1166;1158
Telšiai county;2007;12;2507;1222;1285
Telšiai county;2007;13;2715;1394;1321
Telšiai county;2007;14;3136;1551;1585
Telšiai county;2007;15;3010;1487;1523
Telšiai county;2007;16;2846;1509;1337
Telšiai county;2007;17;2939;1513;1426
Telšiai county;2007;18;2744;1390;1354
Telšiai county;2007;19;2830;1419;1411
Telšiai county;2007;20;2798;1433;1365
Telšiai county;2007;21;2668;1389;1279
Telšiai county;2007;22;2575;1305;1270
Telšiai county;2007;23;2509;1288;1221
Telšiai county;2007;24;2097;1132;965
Telšiai county;2007;25;1775;951;824
Telšiai county;2007;26;1778;937;841
Telšiai county;2007;27;1873;965;908
Telšiai county;2007;28;1906;984;922
Telšiai county;2007;29;1953;986;967
Telšiai county;2007;30;2031;1012;1019
Telšiai county;2007;31;2070;986;1084
Telšiai county;2007;32;2049;983;1066
Telšiai county;2007;33;2077;974;1103
Telšiai county;2007;34;2261;1064;1197
Telšiai county;2007;35;2410;1176;1234
Telšiai county;2007;36;2363;1134;1229
Telšiai county;2007;37;2284;1150;1134
Telšiai county;2007;38;2216;1060;1156
Telšiai county;2007;39;2337;1119;1218
Telšiai county;2007;40;2358;1163;1195
Telšiai county;2007;41;2350;1156;1194
Telšiai county;2007;42;2477;1208;1269
Telšiai county;2007;43;2359;1106;1253
Telšiai county;2007;44;2557;1289;1268
Telšiai county;2007;45;2669;1266;1403
Telšiai county;2007;46;2645;1307;1338
Telšiai county;2007;47;2567;1231;1336
Telšiai county;2007;48;2557;1208;1349
Telšiai county;2007;49;2283;1074;1209
Telšiai county;2007;50;2090;979;1111
Telšiai county;2007;51;2144;999;1145
Telšiai county;2007;52;1870;868;1002
Telšiai county;2007;53;1786;844;942
Telšiai county;2007;54;1850;842;1008
Telšiai county;2007;55;1754;810;944
Telšiai county;2007;56;1886;884;1002
Telšiai county;2007;57;1864;822;1042
Telšiai county;2007;58;1671;747;924
Telšiai county;2007;59;1454;644;810
Telšiai county;2007;60;1398;608;790
Telšiai county;2007;61;1526;630;896
Telšiai county;2007;62;1366;555;811
Telšiai county;2007;63;1471;602;869
Telšiai county;2007;64;1548;624;924
Telšiai county;2007;65;1637;709;928
Telšiai county;2007;66;1464;581;883
Telšiai county;2007;67;1467;563;904
Telšiai county;2007;68;1466;570;896
Telšiai county;2007;69;1448;520;928
Telšiai county;2007;70;1615;625;990
Telšiai county;2007;71;1491;539;952
Telšiai county;2007;72;1304;460;844
Telšiai county;2007;73;1368;467;901
Telšiai county;2007;74;1265;451;814
Telšiai county;2007;75;1254;454;800
Telšiai county;2007;76;1136;385;751
Telšiai county;2007;77;1049;360;689
Telšiai county;2007;78;1164;352;812
Telšiai county;2007;79;978;273;705
Telšiai county;2007;80;864;237;627
Telšiai county;2007;81;826;237;589
Telšiai county;2007;82;706;186;520
Telšiai county;2007;83;647;181;466
Telšiai county;2007;84;546;160;386
Telšiai county;2007;85;1958;537;1421
Telšiai county;2008;-1;162431;75996;86435
Telšiai county;2008;0;1544;790;754
Telšiai county;2008;1;1601;780;821
Telšiai county;2008;2;1521;776;745
Telšiai county;2008;3;1617;811;806
Telšiai county;2008;4;1606;842;764
Telšiai county;2008;5;1533;798;735
Telšiai county;2008;6;1628;844;784
Telšiai county;2008;7;1798;936;862
Telšiai county;2008;8;1984;1050;934
Telšiai county;2008;9;2039;1031;1008
Telšiai county;2008;10;2061;1088;973
Telšiai county;2008;11;2147;1126;1021
Telšiai county;2008;12;2298;1150;1148
Telšiai county;2008;13;2482;1207;1275
Telšiai county;2008;14;2697;1388;1309
Telšiai county;2008;15;3106;1540;1566
Telšiai county;2008;16;2975;1470;1505
Telšiai county;2008;17;2799;1491;1308
Telšiai county;2008;18;2883;1488;1395
Telšiai county;2008;19;2679;1356;1323
Telšiai county;2008;20;2760;1391;1369
Telšiai county;2008;21;2713;1396;1317
Telšiai county;2008;22;2588;1345;1243
Telšiai county;2008;23;2498;1279;1219
Telšiai county;2008;24;2430;1243;1187
Telšiai county;2008;25;2013;1087;926
Telšiai county;2008;26;1712;925;787
Telšiai county;2008;27;1716;905;811
Telšiai county;2008;28;1823;940;883
Telšiai county;2008;29;1877;974;903
Telšiai county;2008;30;1917;974;943
Telšiai county;2008;31;1986;987;999
Telšiai county;2008;32;2033;971;1062
Telšiai county;2008;33;2028;972;1056
Telšiai county;2008;34;2040;957;1083
Telšiai county;2008;35;2223;1047;1176
Telšiai county;2008;36;2350;1137;1213
Telšiai county;2008;37;2327;1117;1210
Telšiai county;2008;38;2247;1128;1119
Telšiai county;2008;39;2179;1040;1139
Telšiai county;2008;40;2297;1097;1200
Telšiai county;2008;41;2336;1157;1179
Telšiai county;2008;42;2305;1140;1165
Telšiai county;2008;43;2419;1171;1248
Telšiai county;2008;44;2303;1075;1228
Telšiai county;2008;45;2511;1260;1251
Telšiai county;2008;46;2619;1236;1383
Telšiai county;2008;47;2601;1284;1317
Telšiai county;2008;48;2532;1205;1327
Telšiai county;2008;49;2532;1200;1332
Telšiai county;2008;50;2252;1055;1197
Telšiai county;2008;51;2055;955;1100
Telšiai county;2008;52;2112;984;1128
Telšiai county;2008;53;1839;851;988
Telšiai county;2008;54;1769;836;933
Telšiai county;2008;55;1812;819;993
Telšiai county;2008;56;1716;786;930
Telšiai county;2008;57;1843;856;987
Telšiai county;2008;58;1827;796;1031
Telšiai county;2008;59;1645;729;916
Telšiai county;2008;60;1422;623;799
Telšiai county;2008;61;1367;588;779
Telšiai county;2008;62;1480;609;871
Telšiai county;2008;63;1324;531;793
Telšiai county;2008;64;1429;577;852
Telšiai county;2008;65;1509;599;910
Telšiai county;2008;66;1578;671;907
Telšiai county;2008;67;1423;554;869
Telšiai county;2008;68;1425;537;888
Telšiai county;2008;69;1430;545;885
Telšiai county;2008;70;1404;493;911
Telšiai county;2008;71;1548;591;957
Telšiai county;2008;72;1433;508;925
Telšiai county;2008;73;1260;439;821
Telšiai county;2008;74;1309;435;874
Telšiai county;2008;75;1213;432;781
Telšiai county;2008;76;1185;412;773
Telšiai county;2008;77;1094;362;732
Telšiai county;2008;78;983;331;652
Telšiai county;2008;79;1091;334;757
Telšiai county;2008;80;909;248;661
Telšiai county;2008;81;806;218;588
Telšiai county;2008;82;754;211;543
Telšiai county;2008;83;639;167;472
Telšiai county;2008;84;584;150;434
Telšiai county;2008;85;2049;562;1487
Telšiai county;2009;-1;160532;75219;85313
Telšiai county;2009;0;1705;916;789
Telšiai county;2009;1;1511;769;742
Telšiai county;2009;2;1583;777;806
Telšiai county;2009;3;1506;768;738
Telšiai county;2009;4;1597;803;794
Telšiai county;2009;5;1596;837;759
Telšiai county;2009;6;1523;796;727
Telšiai county;2009;7;1610;834;776
Telšiai county;2009;8;1782;933;849
Telšiai county;2009;9;1964;1040;924
Telšiai county;2009;10;2028;1021;1007
Telšiai county;2009;11;2050;1081;969
Telšiai county;2009;12;2133;1124;1009
Telšiai county;2009;13;2286;1147;1139
Telšiai county;2009;14;2465;1199;1266
Telšiai county;2009;15;2673;1375;1298
Telšiai county;2009;16;3076;1526;1550
Telšiai county;2009;17;2951;1461;1490
Telšiai county;2009;18;2763;1472;1291
Telšiai county;2009;19;2842;1466;1376
Telšiai county;2009;20;2641;1335;1306
Telšiai county;2009;21;2710;1364;1346
Telšiai county;2009;22;2660;1371;1289
Telšiai county;2009;23;2530;1319;1211
Telšiai county;2009;24;2436;1257;1179
Telšiai county;2009;25;2357;1208;1149
Telšiai county;2009;26;1947;1054;893
Telšiai county;2009;27;1632;884;748
Telšiai county;2009;28;1673;890;783
Telšiai county;2009;29;1783;917;866
Telšiai county;2009;30;1825;946;879
Telšiai county;2009;31;1860;941;919
Telšiai county;2009;32;1956;977;979
Telšiai county;2009;33;1997;941;1056
Telšiai county;2009;34;1995;955;1040
Telšiai county;2009;35;2004;934;1070
Telšiai county;2009;36;2201;1038;1163
Telšiai county;2009;37;2314;1114;1200
Telšiai county;2009;38;2287;1092;1195
Telšiai county;2009;39;2232;1125;1107
Telšiai county;2009;40;2156;1030;1126
Telšiai county;2009;41;2269;1082;1187
Telšiai county;2009;42;2306;1140;1166
Telšiai county;2009;43;2276;1123;1153
Telšiai county;2009;44;2395;1162;1233
Telšiai county;2009;45;2272;1056;1216
Telšiai county;2009;46;2481;1246;1235
Telšiai county;2009;47;2580;1220;1360
Telšiai county;2009;48;2564;1266;1298
Telšiai county;2009;49;2500;1185;1315
Telšiai county;2009;50;2498;1183;1315
Telšiai county;2009;51;2220;1037;1183
Telšiai county;2009;52;2029;939;1090
Telšiai county;2009;53;2082;965;1117
Telšiai county;2009;54;1803;830;973
Telšiai county;2009;55;1742;822;920
Telšiai county;2009;56;1771;795;976
Telšiai county;2009;57;1680;765;915
Telšiai county;2009;58;1805;837;968
Telšiai county;2009;59;1794;779;1015
Telšiai county;2009;60;1605;704;901
Telšiai county;2009;61;1397;610;787
Telšiai county;2009;62;1326;558;768
Telšiai county;2009;63;1447;589;858
Telšiai county;2009;64;1297;519;778
Telšiai county;2009;65;1395;558;837
Telšiai county;2009;66;1472;580;892
Telšiai county;2009;67;1533;647;886
Telšiai county;2009;68;1395;534;861
Telšiai county;2009;69;1389;514;875
Telšiai county;2009;70;1382;513;869
Telšiai county;2009;71;1363;473;890
Telšiai county;2009;72;1500;564;936
Telšiai county;2009;73;1388;489;899
Telšiai county;2009;74;1204;412;792
Telšiai county;2009;75;1240;408;832
Telšiai county;2009;76;1158;406;752
Telšiai county;2009;77;1124;390;734
Telšiai county;2009;78;1037;339;698
Telšiai county;2009;79;924;306;618
Telšiai county;2009;80;1008;304;704
Telšiai county;2009;81;845;230;615
Telšiai county;2009;82;733;199;534
Telšiai county;2009;83;668;186;482
Telšiai county;2009;84;579;141;438
Telšiai county;2009;85;2216;577;1639
Telšiai county;2010;-1;157718;73830;83888
Telšiai county;2010;0;1543;783;760
Telšiai county;2010;1;1673;898;775
Telšiai county;2010;2;1466;742;724
Telšiai county;2010;3;1555;767;788
Telšiai county;2010;4;1481;756;725
Telšiai county;2010;5;1571;791;780
Telšiai county;2010;6;1571;826;745
Telšiai county;2010;7;1507;788;719
Telšiai county;2010;8;1587;822;765
Telšiai county;2010;9;1767;922;845
Telšiai county;2010;10;1941;1025;916
Telšiai county;2010;11;2010;1010;1000
Telšiai county;2010;12;2035;1071;964
Telšiai county;2010;13;2123;1116;1007
Telšiai county;2010;14;2271;1143;1128
Telšiai county;2010;15;2453;1194;1259
Telšiai county;2010;16;2658;1366;1292
Telšiai county;2010;17;3060;1518;1542
Telšiai county;2010;18;2913;1443;1470
Telšiai county;2010;19;2713;1443;1270
Telšiai county;2010;20;2778;1440;1338
Telšiai county;2010;21;2576;1306;1270
Telšiai county;2010;22;2607;1324;1283
Telšiai county;2010;23;2547;1309;1238
Telšiai county;2010;24;2424;1278;1146
Telšiai county;2010;25;2321;1202;1119
Telšiai county;2010;26;2240;1153;1087
Telšiai county;2010;27;1846;994;852
Telšiai county;2010;28;1534;827;707
Telšiai county;2010;29;1597;854;743
Telšiai county;2010;30;1729;891;838
Telšiai county;2010;31;1761;911;850
Telšiai county;2010;32;1816;922;894
Telšiai county;2010;33;1894;940;954
Telšiai county;2010;34;1946;915;1031
Telšiai county;2010;35;1948;930;1018
Telšiai county;2010;36;1956;910;1046
Telšiai county;2010;37;2159;1011;1148
Telšiai county;2010;38;2281;1091;1190
Telšiai county;2010;39;2255;1074;1181
Telšiai county;2010;40;2180;1092;1088
Telšiai county;2010;41;2119;1004;1115
Telšiai county;2010;42;2241;1060;1181
Telšiai county;2010;43;2265;1113;1152
Telšiai county;2010;44;2244;1105;1139
Telšiai county;2010;45;2326;1115;1211
Telšiai county;2010;46;2225;1028;1197
Telšiai county;2010;47;2440;1223;1217
Telšiai county;2010;48;2543;1197;1346
Telšiai county;2010;49;2520;1239;1281
Telšiai county;2010;50;2468;1164;1304
Telšiai county;2010;51;2466;1167;1299
Telšiai county;2010;52;2186;1017;1169
Telšiai county;2010;53;1984;910;1074
Telšiai county;2010;54;2044;939;1105
Telšiai county;2010;55;1765;808;957
Telšiai county;2010;56;1697;797;900
Telšiai county;2010;57;1745;776;969
Telšiai county;2010;58;1642;739;903
Telšiai county;2010;59;1766;813;953
Telšiai county;2010;60;1755;757;998
Telšiai county;2010;61;1574;687;887
Telšiai county;2010;62;1360;578;782
Telšiai county;2010;63;1297;545;752
Telšiai county;2010;64;1412;571;841
Telšiai county;2010;65;1263;495;768
Telšiai county;2010;66;1369;544;825
Telšiai county;2010;67;1422;549;873
Telšiai county;2010;68;1490;627;863
Telšiai county;2010;69;1349;504;845
Telšiai county;2010;70;1343;492;851
Telšiai county;2010;71;1346;494;852
Telšiai county;2010;72;1309;447;862
Telšiai county;2010;73;1451;542;909
Telšiai county;2010;74;1337;470;867
Telšiai county;2010;75;1163;390;773
Telšiai county;2010;76;1185;384;801
Telšiai county;2010;77;1090;371;719
Telšiai county;2010;78;1064;357;707
Telšiai county;2010;79;973;317;656
Telšiai county;2010;80;862;279;583
Telšiai county;2010;81;920;264;656
Telšiai county;2010;82;776;207;569
Telšiai county;2010;83;668;179;489
Telšiai county;2010;84;613;169;444
Telšiai county;2010;85;2348;599;1749
Telšiai county;2011;-1;152594;71376;81218
Telšiai county;2011;0;1406;742;664
Telšiai county;2011;1;1451;734;717
Telšiai county;2011;2;1561;838;723
Telšiai county;2011;3;1385;713;672
Telšiai county;2011;4;1480;717;763
Telšiai county;2011;5;1407;736;671
Telšiai county;2011;6;1509;750;759
Telšiai county;2011;7;1546;812;734
Telšiai county;2011;8;1509;774;735
Telšiai county;2011;9;1580;834;746
Telšiai county;2011;10;1772;913;859
Telšiai county;2011;11;1964;1035;929
Telšiai county;2011;12;1990;1014;976
Telšiai county;2011;13;2016;1051;965
Telšiai county;2011;14;2126;1112;1014
Telšiai county;2011;15;2266;1144;1122
Telšiai county;2011;16;2430;1198;1232
Telšiai county;2011;17;2669;1377;1292
Telšiai county;2011;18;2994;1495;1499
Telšiai county;2011;19;2457;1264;1193
Telšiai county;2011;20;2264;1258;1006
Telšiai county;2011;21;2209;1185;1024
Telšiai county;2011;22;2037;1062;975
Telšiai county;2011;23;2058;1113;945
Telšiai county;2011;24;1965;1041;924
Telšiai county;2011;25;1780;951;829
Telšiai county;2011;26;1652;872;780
Telšiai county;2011;27;1587;842;745
Telšiai county;2011;28;1550;801;749
Telšiai county;2011;29;1493;752;741
Telšiai county;2011;30;1579;767;812
Telšiai county;2011;31;1634;805;829
Telšiai county;2011;32;1686;831;855
Telšiai county;2011;33;1706;843;863
Telšiai county;2011;34;1894;923;971
Telšiai county;2011;35;1846;881;965
Telšiai county;2011;36;2001;965;1036
Telšiai county;2011;37;2037;962;1075
Telšiai county;2011;38;2209;1060;1149
Telšiai county;2011;39;2341;1137;1204
Telšiai county;2011;40;2303;1105;1198
Telšiai county;2011;41;2202;1091;1111
Telšiai county;2011;42;2210;1068;1142
Telšiai county;2011;43;2254;1054;1200
Telšiai county;2011;44;2272;1105;1167
Telšiai county;2011;45;2236;1116;1120
Telšiai county;2011;46;2366;1121;1245
Telšiai county;2011;47;2271;1058;1213
Telšiai county;2011;48;2423;1207;1216
Telšiai county;2011;49;2548;1199;1349
Telšiai county;2011;50;2497;1213;1284
Telšiai county;2011;51;2480;1165;1315
Telšiai county;2011;52;2465;1162;1303
Telšiai county;2011;53;2235;1061;1174
Telšiai county;2011;54;2006;921;1085
Telšiai county;2011;55;2109;982;1127
Telšiai county;2011;56;1768;815;953
Telšiai county;2011;57;1711;798;913
Telšiai county;2011;58;1798;806;992
Telšiai county;2011;59;1686;772;914
Telšiai county;2011;60;1771;794;977
Telšiai county;2011;61;1788;766;1022
Telšiai county;2011;62;1624;703;921
Telšiai county;2011;63;1385;591;794
Telšiai county;2011;64;1323;563;760
Telšiai county;2011;65;1445;579;866
Telšiai county;2011;66;1286;501;785
Telšiai county;2011;67;1396;552;844
Telšiai county;2011;68;1461;558;903
Telšiai county;2011;69;1512;640;872
Telšiai county;2011;70;1376;501;875
Telšiai county;2011;71;1339;488;851
Telšiai county;2011;72;1312;474;838
Telšiai county;2011;73;1271;438;833
Telšiai county;2011;74;1422;517;905
Telšiai county;2011;75;1302;447;855
Telšiai county;2011;76;1127;377;750
Telšiai county;2011;77;1146;372;774
Telšiai county;2011;78;1046;353;693
Telšiai county;2011;79;1011;328;683
Telšiai county;2011;80;928;287;641
Telšiai county;2011;81;801;248;553
Telšiai county;2011;82;841;231;610
Telšiai county;2011;83;750;199;551
Telšiai county;2011;84;592;145;447
Telšiai county;2011;85;2453;601;1852
Telšiai county;2012;-1;149843;70041;79802
Telšiai county;2012;0;1572;802;770
Telšiai county;2012;1;1410;745;665
Telšiai county;2012;2;1430;727;703
Telšiai county;2012;3;1517;822;695
Telšiai county;2012;4;1357;699;658
Telšiai county;2012;5;1459;703;756
Telšiai county;2012;6;1384;720;664
Telšiai county;2012;7;1495;741;754
Telšiai county;2012;8;1532;806;726
Telšiai county;2012;9;1503;771;732
Telšiai county;2012;10;1569;825;744
Telšiai county;2012;11;1750;901;849
Telšiai county;2012;12;1944;1025;919
Telšiai county;2012;13;1961;1000;961
Telšiai county;2012;14;2000;1035;965
Telšiai county;2012;15;2108;1105;1003
Telšiai county;2012;16;2249;1139;1110
Telšiai county;2012;17;2414;1190;1224
Telšiai county;2012;18;2651;1363;1288
Telšiai county;2012;19;2889;1449;1440
Telšiai county;2012;20;2380;1232;1148
Telšiai county;2012;21;2194;1225;969
Telšiai county;2012;22;2110;1133;977
Telšiai county;2012;23;1917;1010;907
Telšiai county;2012;24;1943;1077;866
Telšiai county;2012;25;1817;975;842
Telšiai county;2012;26;1641;881;760
Telšiai county;2012;27;1526;808;718
Telšiai county;2012;28;1476;787;689
Telšiai county;2012;29;1481;754;727
Telšiai county;2012;30;1417;708;709
Telšiai county;2012;31;1525;737;788
Telšiai county;2012;32;1556;777;779
Telšiai county;2012;33;1616;798;818
Telšiai county;2012;34;1666;818;848
Telšiai county;2012;35;1849;903;946
Telšiai county;2012;36;1806;871;935
Telšiai county;2012;37;1968;950;1018
Telšiai county;2012;38;2004;943;1061
Telšiai county;2012;39;2174;1040;1134
Telšiai county;2012;40;2302;1128;1174
Telšiai county;2012;41;2266;1084;1182
Telšiai county;2012;42;2160;1065;1095
Telšiai county;2012;43;2165;1043;1122
Telšiai county;2012;44;2219;1033;1186
Telšiai county;2012;45;2233;1085;1148
Telšiai county;2012;46;2192;1093;1099
Telšiai county;2012;47;2351;1111;1240
Telšiai county;2012;48;2243;1043;1200
Telšiai county;2012;49;2392;1191;1201
Telšiai county;2012;50;2506;1174;1332
Telšiai county;2012;51;2463;1194;1269
Telšiai county;2012;52;2431;1137;1294
Telšiai county;2012;53;2427;1134;1293
Telšiai county;2012;54;2218;1044;1174
Telšiai county;2012;55;1972;896;1076
Telšiai county;2012;56;2074;963;1111
Telšiai county;2012;57;1749;803;946
Telšiai county;2012;58;1681;774;907
Telšiai county;2012;59;1763;785;978
Telšiai county;2012;60;1658;746;912
Telšiai county;2012;61;1747;771;976
Telšiai county;2012;62;1756;743;1013
Telšiai county;2012;63;1589;676;913
Telšiai county;2012;64;1354;570;784
Telšiai county;2012;65;1305;552;753
Telšiai county;2012;66;1416;557;859
Telšiai county;2012;67;1263;487;776
Telšiai county;2012;68;1369;537;832
Telšiai county;2012;69;1417;528;889
Telšiai county;2012;70;1463;607;856
Telšiai county;2012;71;1339;478;861
Telšiai county;2012;72;1294;462;832
Telšiai county;2012;73;1259;440;819
Telšiai county;2012;74;1223;420;803
Telšiai county;2012;75;1356;475;881
Telšiai county;2012;76;1256;420;836
Telšiai county;2012;77;1071;352;719
Telšiai county;2012;78;1084;344;740
Telšiai county;2012;79;989;326;663
Telšiai county;2012;80;948;300;648
Telšiai county;2012;81;869;265;604
Telšiai county;2012;82;727;220;507
Telšiai county;2012;83;767;203;564
Telšiai county;2012;84;683;176;507
Telšiai county;2012;85;2574;611;1963
Telšiai county;2013;-1;147728;69056;78672
Telšiai county;2013;0;1597;803;794
Telšiai county;2013;1;1564;790;774
Telšiai county;2013;2;1390;730;660
Telšiai county;2013;3;1400;708;692
Telšiai county;2013;4;1505;818;687
Telšiai county;2013;5;1338;685;653
Telšiai county;2013;6;1429;687;742
Telšiai county;2013;7;1369;712;657
Telšiai county;2013;8;1479;728;751
Telšiai county;2013;9;1530;802;728
Telšiai county;2013;10;1503;773;730
Telšiai county;2013;11;1544;815;729
Telšiai county;2013;12;1732;889;843
Telšiai county;2013;13;1932;1021;911
Telšiai county;2013;14;1948;991;957
Telšiai county;2013;15;1984;1027;957
Telšiai county;2013;16;2090;1098;992
Telšiai county;2013;17;2229;1135;1094
Telšiai county;2013;18;2385;1175;1210
Telšiai county;2013;19;2571;1331;1240
Telšiai county;2013;20;2819;1424;1395
Telšiai county;2013;21;2334;1195;1139
Telšiai county;2013;22;2112;1187;925
Telšiai county;2013;23;2011;1092;919
Telšiai county;2013;24;1823;969;854
Telšiai county;2013;25;1855;1042;813
Telšiai county;2013;26;1712;934;778
Telšiai county;2013;27;1567;861;706
Telšiai county;2013;28;1434;774;660
Telšiai county;2013;29;1390;740;650
Telšiai county;2013;30;1412;721;691
Telšiai county;2013;31;1371;681;690
Telšiai county;2013;32;1490;717;773
Telšiai county;2013;33;1514;748;766
Telšiai county;2013;34;1586;785;801
Telšiai county;2013;35;1633;802;831
Telšiai county;2013;36;1808;878;930
Telšiai county;2013;37;1773;858;915
Telšiai county;2013;38;1943;933;1010
Telšiai county;2013;39;1984;936;1048
Telšiai county;2013;40;2143;1027;1116
Telšiai county;2013;41;2281;1110;1171
Telšiai county;2013;42;2247;1080;1167
Telšiai county;2013;43;2138;1056;1082
Telšiai county;2013;44;2157;1039;1118
Telšiai county;2013;45;2187;1019;1168
Telšiai county;2013;46;2200;1066;1134
Telšiai county;2013;47;2165;1077;1088
Telšiai county;2013;48;2319;1092;1227
Telšiai county;2013;49;2218;1020;1198
Telšiai county;2013;50;2375;1181;1194
Telšiai county;2013;51;2497;1171;1326
Telšiai county;2013;52;2432;1175;1257
Telšiai county;2013;53;2409;1123;1286
Telšiai county;2013;54;2390;1102;1288
Telšiai county;2013;55;2189;1027;1162
Telšiai county;2013;56;1941;873;1068
Telšiai county;2013;57;2044;944;1100
Telšiai county;2013;58;1713;778;935
Telšiai county;2013;59;1657;757;900
Telšiai county;2013;60;1744;771;973
Telšiai county;2013;61;1624;723;901
Telšiai county;2013;62;1718;750;968
Telšiai county;2013;63;1717;716;1001
Telšiai county;2013;64;1554;654;900
Telšiai county;2013;65;1325;548;777
Telšiai county;2013;66;1276;539;737
Telšiai county;2013;67;1379;537;842
Telšiai county;2013;68;1217;459;758
Telšiai county;2013;69;1337;514;823
Telšiai county;2013;70;1380;510;870
Telšiai county;2013;71;1411;582;829
Telšiai county;2013;72;1312;461;851
Telšiai county;2013;73;1263;447;816
Telšiai county;2013;74;1223;424;799
Telšiai county;2013;75;1183;399;784
Telšiai county;2013;76;1295;440;855
Telšiai county;2013;77;1198;393;805
Telšiai county;2013;78;1024;330;694
Telšiai county;2013;79;1029;313;716
Telšiai county;2013;80;928;299;629
Telšiai county;2013;81;877;262;615
Telšiai county;2013;82;809;244;565
Telšiai county;2013;83;664;195;469
Telšiai county;2013;84;700;174;526
Telšiai county;2013;85;2749;660;2089
Telšiai county;2014;-1;145482;68034;77448
Telšiai county;2014;0;1528;776;752
Telšiai county;2014;1;1604;811;793
Telšiai county;2014;2;1530;767;763
Telšiai county;2014;3;1369;717;652
Telšiai county;2014;4;1395;707;688
Telšiai county;2014;5;1479;806;673
Telšiai county;2014;6;1326;682;644
Telšiai county;2014;7;1411;679;732
Telšiai county;2014;8;1342;701;641
Telšiai county;2014;9;1468;723;745
Telšiai county;2014;10;1510;787;723
Telšiai county;2014;11;1478;761;717
Telšiai county;2014;12;1525;804;721
Telšiai county;2014;13;1715;881;834
Telšiai county;2014;14;1919;1013;906
Telšiai county;2014;15;1935;982;953
Telšiai county;2014;16;1966;1016;950
Telšiai county;2014;17;2082;1092;990
Telšiai county;2014;18;2211;1125;1086
Telšiai county;2014;19;2328;1151;1177
Telšiai county;2014;20;2502;1296;1206
Telšiai county;2014;21;2742;1383;1359
Telšiai county;2014;22;2241;1162;1079
Telšiai county;2014;23;2002;1144;858
Telšiai county;2014;24;1909;1062;847
Telšiai county;2014;25;1749;933;816
Telšiai county;2014;26;1770;1001;769
Telšiai county;2014;27;1608;874;734
Telšiai county;2014;28;1518;835;683
Telšiai county;2014;29;1375;736;639
Telšiai county;2014;30;1327;713;614
Telšiai county;2014;31;1396;709;687
Telšiai county;2014;32;1340;659;681
Telšiai county;2014;33;1447;698;749
Telšiai county;2014;34;1470;733;737
Telšiai county;2014;35;1539;767;772
Telšiai county;2014;36;1609;789;820
Telšiai county;2014;37;1777;858;919
Telšiai county;2014;38;1755;851;904
Telšiai county;2014;39;1914;920;994
Telšiai county;2014;40;1962;922;1040
Telšiai county;2014;41;2112;1010;1102
Telšiai county;2014;42;2266;1104;1162
Telšiai county;2014;43;2216;1063;1153
Telšiai county;2014;44;2102;1036;1066
Telšiai county;2014;45;2127;1022;1105
Telšiai county;2014;46;2173;1008;1165
Telšiai county;2014;47;2184;1057;1127
Telšiai county;2014;48;2143;1062;1081
Telšiai county;2014;49;2300;1085;1215
Telšiai county;2014;50;2205;1016;1189
Telšiai county;2014;51;2351;1166;1185
Telšiai county;2014;52;2478;1164;1314
Telšiai county;2014;53;2386;1153;1233
Telšiai county;2014;54;2374;1102;1272
Telšiai county;2014;55;2354;1082;1272
Telšiai county;2014;56;2154;1006;1148
Telšiai county;2014;57;1920;858;1062
Telšiai county;2014;58;2020;925;1095
Telšiai county;2014;59;1684;756;928
Telšiai county;2014;60;1638;745;893
Telšiai county;2014;61;1716;754;962
Telšiai county;2014;62;1593;704;889
Telšiai county;2014;63;1687;731;956
Telšiai county;2014;64;1686;694;992
Telšiai county;2014;65;1521;630;891
Telšiai county;2014;66;1296;527;769
Telšiai county;2014;67;1249;518;731
Telšiai county;2014;68;1335;504;831
Telšiai county;2014;69;1198;445;753
Telšiai county;2014;70;1299;493;806
Telšiai county;2014;71;1333;485;848
Telšiai county;2014;72;1376;562;814
Telšiai county;2014;73;1256;436;820
Telšiai county;2014;74;1220;417;803
Telšiai county;2014;75;1171;396;775
Telšiai county;2014;76;1138;375;763
Telšiai county;2014;77;1228;407;821
Telšiai county;2014;78;1132;374;758
Telšiai county;2014;79;967;303;664
Telšiai county;2014;80;971;287;684
Telšiai county;2014;81;851;271;580
Telšiai county;2014;82;800;231;569
Telšiai county;2014;83;729;211;518
Telšiai county;2014;84;580;168;412
Telšiai county;2014;85;2890;665;2225
Telšiai county;2015;-1;143511;67228;76283
Telšiai county;2015;0;1442;728;714
Telšiai county;2015;1;1534;780;754
Telšiai county;2015;2;1578;792;786
Telšiai county;2015;3;1519;764;755
Telšiai county;2015;4;1361;711;650
Telšiai county;2015;5;1379;695;684
Telšiai county;2015;6;1455;805;650
Telšiai county;2015;7;1310;673;637
Telšiai county;2015;8;1398;673;725
Telšiai county;2015;9;1330;700;630
Telšiai county;2015;10;1453;719;734
Telšiai county;2015;11;1490;776;714
Telšiai county;2015;12;1458;749;709
Telšiai county;2015;13;1511;796;715
Telšiai county;2015;14;1697;873;824
Telšiai county;2015;15;1906;1008;898
Telšiai county;2015;16;1916;974;942
Telšiai county;2015;17;1951;1006;945
Telšiai county;2015;18;2051;1078;973
Telšiai county;2015;19;2148;1090;1058
Telšiai county;2015;20;2278;1132;1146
Telšiai county;2015;21;2468;1271;1197
Telšiai county;2015;22;2683;1354;1329
Telšiai county;2015;23;2135;1137;998
Telšiai county;2015;24;1902;1101;801
Telšiai county;2015;25;1811;1026;785
Telšiai county;2015;26;1672;906;766
Telšiai county;2015;27;1697;972;725
Telšiai county;2015;28;1556;859;697
Telšiai county;2015;29;1475;812;663
Telšiai county;2015;30;1328;706;622
Telšiai county;2015;31;1287;699;588
Telšiai county;2015;32;1343;693;650
Telšiai county;2015;33;1333;659;674
Telšiai county;2015;34;1440;688;752
Telšiai county;2015;35;1437;709;728
Telšiai county;2015;36;1501;747;754
Telšiai county;2015;37;1595;776;819
Telšiai county;2015;38;1760;850;910
Telšiai county;2015;39;1729;843;886
Telšiai county;2015;40;1894;913;981
Telšiai county;2015;41;1943;915;1028
Telšiai county;2015;42;2097;1000;1097
Telšiai county;2015;43;2241;1094;1147
Telšiai county;2015;44;2194;1063;1131
Telšiai county;2015;45;2082;1026;1056
Telšiai county;2015;46;2106;1018;1088
Telšiai county;2015;47;2149;994;1155
Telšiai county;2015;48;2174;1050;1124
Telšiai county;2015;49;2135;1057;1078
Telšiai county;2015;50;2285;1078;1207
Telšiai county;2015;51;2194;1006;1188
Telšiai county;2015;52;2327;1155;1172
Telšiai county;2015;53;2448;1139;1309
Telšiai county;2015;54;2356;1129;1227
Telšiai county;2015;55;2343;1083;1260
Telšiai county;2015;56;2351;1078;1273
Telšiai county;2015;57;2122;987;1135
Telšiai county;2015;58;1903;846;1057
Telšiai county;2015;59;1995;911;1084
Telšiai county;2015;60;1659;735;924
Telšiai county;2015;61;1619;734;885
Telšiai county;2015;62;1684;732;952
Telšiai county;2015;63;1569;692;877
Telšiai county;2015;64;1657;703;954
Telšiai county;2015;65;1650;670;980
Telšiai county;2015;66;1498;612;886
Telšiai county;2015;67;1271;513;758
Telšiai county;2015;68;1215;500;715
Telšiai county;2015;69;1304;483;821
Telšiai county;2015;70;1158;420;738
Telšiai county;2015;71;1267;475;792
Telšiai county;2015;72;1302;471;831
Telšiai county;2015;73;1320;530;790
Telšiai county;2015;74;1208;413;795
Telšiai county;2015;75;1173;393;780
Telšiai county;2015;76;1112;367;745
Telšiai county;2015;77;1090;356;734
Telšiai county;2015;78;1155;362;793
Telšiai county;2015;79;1069;352;717
Telšiai county;2015;80;906;273;633
Telšiai county;2015;81;907;267;640
Telšiai county;2015;82;784;241;543
Telšiai county;2015;83;721;202;519
Telšiai county;2015;84;662;184;478
Telšiai county;2015;85;2895;676;2219
Telšiai county;2016;-1;141293;66201;75092
Telšiai county;2016;0;1555;789;766
Telšiai county;2016;1;1427;719;708
Telšiai county;2016;2;1524;769;755
Telšiai county;2016;3;1558;775;783
Telšiai county;2016;4;1499;756;743
Telšiai county;2016;5;1335;700;635
Telšiai county;2016;6;1370;694;676
Telšiai county;2016;7;1437;795;642
Telšiai county;2016;8;1308;676;632
Telšiai county;2016;9;1379;667;712
Telšiai county;2016;10;1310;693;617
Telšiai county;2016;11;1424;700;724
Telšiai county;2016;12;1464;766;698
Telšiai county;2016;13;1442;741;701
Telšiai county;2016;14;1496;792;704
Telšiai county;2016;15;1677;861;816
Telšiai county;2016;16;1887;1000;887
Telšiai county;2016;17;1911;972;939
Telšiai county;2016;18;1936;995;941
Telšiai county;2016;19;2008;1058;950
Telšiai county;2016;20;2099;1063;1036
Telšiai county;2016;21;2205;1097;1108
Telšiai county;2016;22;2369;1230;1139
Telšiai county;2016;23;2570;1300;1270
Telšiai county;2016;24;2018;1075;943
Telšiai county;2016;25;1794;1032;762
Telšiai county;2016;26;1676;964;712
Telšiai county;2016;27;1588;870;718
Telšiai county;2016;28;1614;925;689
Telšiai county;2016;29;1494;833;661
Telšiai county;2016;30;1414;786;628
Telšiai county;2016;31;1274;680;594
Telšiai county;2016;32;1237;671;566
Telšiai county;2016;33;1289;663;626
Telšiai county;2016;34;1307;644;663
Telšiai county;2016;35;1373;643;730
Telšiai county;2016;36;1428;703;725
Telšiai county;2016;37;1479;739;740
Telšiai county;2016;38;1560;762;798
Telšiai county;2016;39;1738;841;897
Telšiai county;2016;40;1714;833;881
Telšiai county;2016;41;1872;905;967
Telšiai county;2016;42;1917;907;1010
Telšiai county;2016;43;2078;981;1097
Telšiai county;2016;44;2213;1078;1135
Telšiai county;2016;45;2157;1045;1112
Telšiai county;2016;46;2062;1017;1045
Telšiai county;2016;47;2084;1003;1081
Telšiai county;2016;48;2132;983;1149
Telšiai county;2016;49;2167;1048;1119
Telšiai county;2016;50;2129;1050;1079
Telšiai county;2016;51;2241;1051;1190
Telšiai county;2016;52;2176;996;1180
Telšiai county;2016;53;2302;1139;1163
Telšiai county;2016;54;2420;1125;1295
Telšiai county;2016;55;2320;1101;1219
Telšiai county;2016;56;2304;1061;1243
Telšiai county;2016;57;2323;1061;1262
Telšiai county;2016;58;2108;975;1133
Telšiai county;2016;59;1872;827;1045
Telšiai county;2016;60;1973;897;1076
Telšiai county;2016;61;1642;723;919
Telšiai county;2016;62;1599;718;881
Telšiai county;2016;63;1658;713;945
Telšiai county;2016;64;1540;669;871
Telšiai county;2016;65;1617;678;939
Telšiai county;2016;66;1615;649;966
Telšiai county;2016;67;1459;584;875
Telšiai county;2016;68;1236;493;743
Telšiai county;2016;69;1185;483;702
Telšiai county;2016;70;1269;462;807
Telšiai county;2016;71;1128;400;728
Telšiai county;2016;72;1240;459;781
Telšiai county;2016;73;1250;436;814
Telšiai county;2016;74;1282;510;772
Telšiai county;2016;75;1159;387;772
Telšiai county;2016;76;1122;365;757
Telšiai county;2016;77;1059;344;715
Telšiai county;2016;78;1037;328;709
Telšiai county;2016;79;1099;341;758
Telšiai county;2016;80;1009;332;677
Telšiai county;2016;81;858;257;601
Telšiai county;2016;82;848;238;610
Telšiai county;2016;83;718;211;507
Telšiai county;2016;84;641;179;462
Telšiai county;2016;85;2986;720;2266
Telšiai county;2017;-1;137769;64518;73251
Telšiai county;2017;0;1436;697;739
Telšiai county;2017;1;1527;770;757
Telšiai county;2017;2;1394;705;689
Telšiai county;2017;3;1491;748;743
Telšiai county;2017;4;1529;757;772
Telšiai county;2017;5;1474;740;734
Telšiai county;2017;6;1310;684;626
Telšiai county;2017;7;1342;682;660
Telšiai county;2017;8;1405;779;626
Telšiai county;2017;9;1294;668;626
Telšiai county;2017;10;1344;650;694
Telšiai county;2017;11;1276;681;595
Telšiai county;2017;12;1402;697;705
Telšiai county;2017;13;1442;747;695
Telšiai county;2017;14;1419;725;694
Telšiai county;2017;15;1481;786;695
Telšiai county;2017;16;1654;845;809
Telšiai county;2017;17;1870;995;875
Telšiai county;2017;18;1879;955;924
Telšiai county;2017;19;1862;964;898
Telšiai county;2017;20;1956;1039;917
Telšiai county;2017;21;2025;1027;998
Telšiai county;2017;22;2125;1057;1068
Telšiai county;2017;23;2241;1170;1071
Telšiai county;2017;24;2416;1232;1184
Telšiai county;2017;25;1871;1018;853
Telšiai county;2017;26;1621;953;668
Telšiai county;2017;27;1528;897;631
Telšiai county;2017;28;1431;800;631
Telšiai county;2017;29;1454;852;602
Telšiai county;2017;30;1377;769;608
Telšiai county;2017;31;1291;717;574
Telšiai county;2017;32;1173;629;544
Telšiai county;2017;33;1132;613;519
Telšiai county;2017;34;1206;627;579
Telšiai county;2017;35;1242;606;636
Telšiai county;2017;36;1320;620;700
Telšiai county;2017;37;1361;673;688
Telšiai county;2017;38;1432;712;720
Telšiai county;2017;39;1524;743;781
Telšiai county;2017;40;1689;821;868
Telšiai county;2017;41;1680;811;869
Telšiai county;2017;42;1846;891;955
Telšiai county;2017;43;1884;888;996
Telšiai county;2017;44;2047;964;1083
Telšiai county;2017;45;2175;1063;1112
Telšiai county;2017;46;2119;1029;1090
Telšiai county;2017;47;2022;994;1028
Telšiai county;2017;48;2061;993;1068
Telšiai county;2017;49;2108;974;1134
Telšiai county;2017;50;2144;1033;1111
Telšiai county;2017;51;2083;1020;1063
Telšiai county;2017;52;2210;1038;1172
Telšiai county;2017;53;2145;986;1159
Telšiai county;2017;54;2267;1117;1150
Telšiai county;2017;55;2370;1093;1277
Telšiai county;2017;56;2283;1074;1209
Telšiai county;2017;57;2270;1041;1229
Telšiai county;2017;58;2296;1045;1251
Telšiai county;2017;59;2077;955;1122
Telšiai county;2017;60;1844;808;1036
Telšiai county;2017;61;1939;878;1061
Telšiai county;2017;62;1611;699;912
Telšiai county;2017;63;1562;688;874
Telšiai county;2017;64;1624;685;939
Telšiai county;2017;65;1506;651;855
Telšiai county;2017;66;1581;652;929
Telšiai county;2017;67;1579;629;950
Telšiai county;2017;68;1429;561;868
Telšiai county;2017;69;1198;475;723
Telšiai county;2017;70;1160;468;692
Telšiai county;2017;71;1234;440;794
Telšiai county;2017;72;1095;382;713
Telšiai county;2017;73;1200;436;764
Telšiai county;2017;74;1212;416;796
Telšiai county;2017;75;1230;475;755
Telšiai county;2017;76;1125;370;755
Telšiai county;2017;77;1080;341;739
Telšiai county;2017;78;993;319;674
Telšiai county;2017;79;986;303;683
Telšiai county;2017;80;1026;313;713
Telšiai county;2017;81;949;301;648
Telšiai county;2017;82;805;234;571
Telšiai county;2017;83;771;209;562
Telšiai county;2017;84;646;184;462
Telšiai county;2017;85;3051;742;2309
Telšiai county;2018;-1;134139;62736;71403
Telšiai county;2018;0;1332;680;652
Telšiai county;2018;1;1414;685;729
Telšiai county;2018;2;1497;759;738
Telšiai county;2018;3;1379;707;672
Telšiai county;2018;4;1475;738;737
Telšiai county;2018;5;1500;751;749
Telšiai county;2018;6;1436;718;718
Telšiai county;2018;7;1282;671;611
Telšiai county;2018;8;1336;676;660
Telšiai county;2018;9;1389;772;617
Telšiai county;2018;10;1270;660;610
Telšiai county;2018;11;1321;637;684
Telšiai county;2018;12;1259;680;579
Telšiai county;2018;13;1391;694;697
Telšiai county;2018;14;1431;740;691
Telšiai county;2018;15;1400;713;687
Telšiai county;2018;16;1465;775;690
Telšiai county;2018;17;1637;832;805
Telšiai county;2018;18;1828;970;858
Telšiai county;2018;19;1752;907;845
Telšiai county;2018;20;1762;898;864
Telšiai county;2018;21;1853;991;862
Telšiai county;2018;22;1901;963;938
Telšiai county;2018;23;1938;970;968
Telšiai county;2018;24;2056;1088;968
Telšiai county;2018;25;2218;1156;1062
Telšiai county;2018;26;1683;936;747
Telšiai county;2018;27;1462;869;593
Telšiai county;2018;28;1396;841;555
Telšiai county;2018;29;1297;711;586
Telšiai county;2018;30;1347;798;549
Telšiai county;2018;31;1297;721;576
Telšiai county;2018;32;1225;669;556
Telšiai county;2018;33;1122;595;527
Telšiai county;2018;34;1068;563;505
Telšiai county;2018;35;1126;584;542
Telšiai county;2018;36;1196;585;611
Telšiai county;2018;37;1286;601;685
Telšiai county;2018;38;1312;651;661
Telšiai county;2018;39;1391;693;698
Telšiai county;2018;40;1482;715;767
Telšiai county;2018;41;1645;802;843
Telšiai county;2018;42;1634;786;848
Telšiai county;2018;43;1803;870;933
Telšiai county;2018;44;1854;870;984
Telšiai county;2018;45;2001;936;1065
Telšiai county;2018;46;2139;1045;1094
Telšiai county;2018;47;2090;1013;1077
Telšiai county;2018;48;1987;973;1014
Telšiai county;2018;49;2027;966;1061
Telšiai county;2018;50;2084;954;1130
Telšiai county;2018;51;2127;1022;1105
Telšiai county;2018;52;2063;1010;1053
Telšiai county;2018;53;2182;1018;1164
Telšiai county;2018;54;2113;966;1147
Telšiai county;2018;55;2238;1100;1138
Telšiai county;2018;56;2339;1076;1263
Telšiai county;2018;57;2258;1053;1205
Telšiai county;2018;58;2232;1016;1216
Telšiai county;2018;59;2263;1025;1238
Telšiai county;2018;60;2045;936;1109
Telšiai county;2018;61;1818;794;1024
Telšiai county;2018;62;1927;869;1058
Telšiai county;2018;63;1583;684;899
Telšiai county;2018;64;1536;671;865
Telšiai county;2018;65;1599;667;932
Telšiai county;2018;66;1478;633;845
Telšiai county;2018;67;1557;637;920
Telšiai county;2018;68;1539;597;942
Telšiai county;2018;69;1397;538;859
Telšiai county;2018;70;1164;452;712
Telšiai county;2018;71;1128;451;677
Telšiai county;2018;72;1205;422;783
Telšiai county;2018;73;1056;361;695
Telšiai county;2018;74;1159;410;749
Telšiai county;2018;75;1162;383;779
Telšiai county;2018;76;1173;446;727
Telšiai county;2018;77;1062;335;727
Telšiai county;2018;78;1041;319;722
Telšiai county;2018;79;940;294;646
Telšiai county;2018;80;927;281;646
Telšiai county;2018;81;959;275;684
Telšiai county;2018;82;879;272;607
Telšiai county;2018;83;724;202;522
Telšiai county;2018;84;700;181;519
Telšiai county;2018;85;3090;762;2328
Telšiai d. mun.;2001;-1;57743;27269;30474
Telšiai d. mun.;2001;0;625;332;293
Telšiai d. mun.;2001;1;625;335;290
Telšiai d. mun.;2001;2;670;339;331
Telšiai d. mun.;2001;3;649;349;300
Telšiai d. mun.;2001;4;686;362;324
Telšiai d. mun.;2001;5;755;382;373
Telšiai d. mun.;2001;6;848;404;444
Telšiai d. mun.;2001;7;879;439;440
Telšiai d. mun.;2001;8;1048;528;520
Telšiai d. mun.;2001;9;1004;482;522
Telšiai d. mun.;2001;10;959;516;443
Telšiai d. mun.;2001;11;962;516;446
Telšiai d. mun.;2001;12;960;485;475
Telšiai d. mun.;2001;13;1029;508;521
Telšiai d. mun.;2001;14;1079;562;517
Telšiai d. mun.;2001;15;992;514;478
Telšiai d. mun.;2001;16;953;476;477
Telšiai d. mun.;2001;17;977;498;479
Telšiai d. mun.;2001;18;819;432;387
Telšiai d. mun.;2001;19;698;334;364
Telšiai d. mun.;2001;20;722;373;349
Telšiai d. mun.;2001;21;726;381;345
Telšiai d. mun.;2001;22;699;364;335
Telšiai d. mun.;2001;23;689;352;337
Telšiai d. mun.;2001;24;730;353;377
Telšiai d. mun.;2001;25;712;363;349
Telšiai d. mun.;2001;26;711;362;349
Telšiai d. mun.;2001;27;700;340;360
Telšiai d. mun.;2001;28;816;385;431
Telšiai d. mun.;2001;29;871;449;422
Telšiai d. mun.;2001;30;805;400;405
Telšiai d. mun.;2001;31;765;418;347
Telšiai d. mun.;2001;32;767;386;381
Telšiai d. mun.;2001;33;804;389;415
Telšiai d. mun.;2001;34;817;422;395
Telšiai d. mun.;2001;35;813;410;403
Telšiai d. mun.;2001;36;888;447;441
Telšiai d. mun.;2001;37;830;405;425
Telšiai d. mun.;2001;38;864;433;431
Telšiai d. mun.;2001;39;880;409;471
Telšiai d. mun.;2001;40;930;473;457
Telšiai d. mun.;2001;41;909;465;444
Telšiai d. mun.;2001;42;855;437;418
Telšiai d. mun.;2001;43;793;394;399
Telšiai d. mun.;2001;44;738;363;375
Telšiai d. mun.;2001;45;772;371;401
Telšiai d. mun.;2001;46;627;306;321
Telšiai d. mun.;2001;47;633;273;360
Telšiai d. mun.;2001;48;659;299;360
Telšiai d. mun.;2001;49;627;321;306
Telšiai d. mun.;2001;50;708;341;367
Telšiai d. mun.;2001;51;685;310;375
Telšiai d. mun.;2001;52;588;292;296
Telšiai d. mun.;2001;53;544;254;290
Telšiai d. mun.;2001;54;546;249;297
Telšiai d. mun.;2001;55;589;266;323
Telšiai d. mun.;2001;56;508;231;277
Telšiai d. mun.;2001;57;610;249;361
Telšiai d. mun.;2001;58;623;276;347
Telšiai d. mun.;2001;59;623;292;331
Telšiai d. mun.;2001;60;605;252;353
Telšiai d. mun.;2001;61;595;261;334
Telšiai d. mun.;2001;62;571;231;340
Telšiai d. mun.;2001;63;584;227;357
Telšiai d. mun.;2001;64;639;269;370
Telšiai d. mun.;2001;65;600;242;358
Telšiai d. mun.;2001;66;520;203;317
Telšiai d. mun.;2001;67;572;211;361
Telšiai d. mun.;2001;68;544;217;327
Telšiai d. mun.;2001;69;573;219;354
Telšiai d. mun.;2001;70;510;187;323
Telšiai d. mun.;2001;71;482;196;286
Telšiai d. mun.;2001;72;536;193;343
Telšiai d. mun.;2001;73;471;157;314
Telšiai d. mun.;2001;74;412;127;285
Telšiai d. mun.;2001;75;429;127;302
Telšiai d. mun.;2001;76;381;121;260
Telšiai d. mun.;2001;77;328;114;214
Telšiai d. mun.;2001;78;320;115;205
Telšiai d. mun.;2001;79;296;89;207
Telšiai d. mun.;2001;80;226;76;150
Telšiai d. mun.;2001;81;193;63;130
Telšiai d. mun.;2001;82;119;33;86
Telšiai d. mun.;2001;83;97;34;63
Telšiai d. mun.;2001;84;130;41;89
Telšiai d. mun.;2001;85;617;168;449
Telšiai d. mun.;2002;-1;57119;26851;30268
Telšiai d. mun.;2002;0;562;287;275
Telšiai d. mun.;2002;1;618;327;291
Telšiai d. mun.;2002;2;619;330;289
Telšiai d. mun.;2002;3;667;338;329
Telšiai d. mun.;2002;4;644;346;298
Telšiai d. mun.;2002;5;682;359;323
Telšiai d. mun.;2002;6;742;375;367
Telšiai d. mun.;2002;7;848;404;444
Telšiai d. mun.;2002;8;871;434;437
Telšiai d. mun.;2002;9;1043;524;519
Telšiai d. mun.;2002;10;1003;480;523
Telšiai d. mun.;2002;11;946;507;439
Telšiai d. mun.;2002;12;950;507;443
Telšiai d. mun.;2002;13;938;472;466
Telšiai d. mun.;2002;14;1018;501;517
Telšiai d. mun.;2002;15;1062;549;513
Telšiai d. mun.;2002;16;973;502;471
Telšiai d. mun.;2002;17;929;463;466
Telšiai d. mun.;2002;18;949;477;472
Telšiai d. mun.;2002;19;794;418;376
Telšiai d. mun.;2002;20;688;327;361
Telšiai d. mun.;2002;21;703;364;339
Telšiai d. mun.;2002;22;728;380;348
Telšiai d. mun.;2002;23;692;357;335
Telšiai d. mun.;2002;24;667;335;332
Telšiai d. mun.;2002;25;717;342;375
Telšiai d. mun.;2002;26;700;354;346
Telšiai d. mun.;2002;27;692;351;341
Telšiai d. mun.;2002;28;679;328;351
Telšiai d. mun.;2002;29;799;370;429
Telšiai d. mun.;2002;30;841;437;404
Telšiai d. mun.;2002;31;789;391;398
Telšiai d. mun.;2002;32;753;408;345
Telšiai d. mun.;2002;33;755;375;380
Telšiai d. mun.;2002;34;791;382;409
Telšiai d. mun.;2002;35;806;413;393
Telšiai d. mun.;2002;36;807;405;402
Telšiai d. mun.;2002;37;871;433;438
Telšiai d. mun.;2002;38;812;392;420
Telšiai d. mun.;2002;39;839;417;422
Telšiai d. mun.;2002;40;865;400;465
Telšiai d. mun.;2002;41;910;460;450
Telšiai d. mun.;2002;42;895;455;440
Telšiai d. mun.;2002;43;852;440;412
Telšiai d. mun.;2002;44;779;386;393
Telšiai d. mun.;2002;45;720;349;371
Telšiai d. mun.;2002;46;755;362;393
Telšiai d. mun.;2002;47;617;300;317
Telšiai d. mun.;2002;48;624;270;354
Telšiai d. mun.;2002;49;645;288;357
Telšiai d. mun.;2002;50;612;308;304
Telšiai d. mun.;2002;51;687;325;362
Telšiai d. mun.;2002;52;674;304;370
Telšiai d. mun.;2002;53;575;285;290
Telšiai d. mun.;2002;54;532;250;282
Telšiai d. mun.;2002;55;531;237;294
Telšiai d. mun.;2002;56;575;260;315
Telšiai d. mun.;2002;57;498;225;273
Telšiai d. mun.;2002;58;590;240;350
Telšiai d. mun.;2002;59;612;271;341
Telšiai d. mun.;2002;60;613;286;327
Telšiai d. mun.;2002;61;603;252;351
Telšiai d. mun.;2002;62;593;260;333
Telšiai d. mun.;2002;63;563;224;339
Telšiai d. mun.;2002;64;580;225;355
Telšiai d. mun.;2002;65;625;257;368
Telšiai d. mun.;2002;66;587;230;357
Telšiai d. mun.;2002;67;516;200;316
Telšiai d. mun.;2002;68;570;206;364
Telšiai d. mun.;2002;69;538;211;327
Telšiai d. mun.;2002;70;570;219;351
Telšiai d. mun.;2002;71;498;178;320
Telšiai d. mun.;2002;72;473;190;283
Telšiai d. mun.;2002;73;523;185;338
Telšiai d. mun.;2002;74;456;152;304
Telšiai d. mun.;2002;75;401;122;279
Telšiai d. mun.;2002;76;405;116;289
Telšiai d. mun.;2002;77;371;116;255
Telšiai d. mun.;2002;78;313;108;205
Telšiai d. mun.;2002;79;303;106;197
Telšiai d. mun.;2002;80;284;81;203
Telšiai d. mun.;2002;81;206;69;137
Telšiai d. mun.;2002;82;177;59;118
Telšiai d. mun.;2002;83;108;28;80
Telšiai d. mun.;2002;84;84;28;56
Telšiai d. mun.;2002;85;624;167;457
Telšiai d. mun.;2003;-1;56541;26571;29970
Telšiai d. mun.;2003;0;512;268;244
Telšiai d. mun.;2003;1;561;289;272
Telšiai d. mun.;2003;2;620;330;290
Telšiai d. mun.;2003;3;611;328;283
Telšiai d. mun.;2003;4;667;337;330
Telšiai d. mun.;2003;5;641;343;298
Telšiai d. mun.;2003;6;674;355;319
Telšiai d. mun.;2003;7;737;372;365
Telšiai d. mun.;2003;8;841;399;442
Telšiai d. mun.;2003;9;868;433;435
Telšiai d. mun.;2003;10;1034;520;514
Telšiai d. mun.;2003;11;995;480;515
Telšiai d. mun.;2003;12;931;498;433
Telšiai d. mun.;2003;13;933;497;436
Telšiai d. mun.;2003;14;925;464;461
Telšiai d. mun.;2003;15;1004;491;513
Telšiai d. mun.;2003;16;1045;539;506
Telšiai d. mun.;2003;17;954;489;465
Telšiai d. mun.;2003;18;913;454;459
Telšiai d. mun.;2003;19;935;466;469
Telšiai d. mun.;2003;20;781;411;370
Telšiai d. mun.;2003;21;689;326;363
Telšiai d. mun.;2003;22;694;359;335
Telšiai d. mun.;2003;23;722;373;349
Telšiai d. mun.;2003;24;687;355;332
Telšiai d. mun.;2003;25;656;331;325
Telšiai d. mun.;2003;26;712;336;376
Telšiai d. mun.;2003;27;694;347;347
Telšiai d. mun.;2003;28;674;340;334
Telšiai d. mun.;2003;29;671;322;349
Telšiai d. mun.;2003;30;786;360;426
Telšiai d. mun.;2003;31;840;437;403
Telšiai d. mun.;2003;32;772;385;387
Telšiai d. mun.;2003;33;738;404;334
Telšiai d. mun.;2003;34;744;371;373
Telšiai d. mun.;2003;35;774;375;399
Telšiai d. mun.;2003;36;797;412;385
Telšiai d. mun.;2003;37;793;397;396
Telšiai d. mun.;2003;38;860;430;430
Telšiai d. mun.;2003;39;797;387;410
Telšiai d. mun.;2003;40;824;413;411
Telšiai d. mun.;2003;41;850;390;460
Telšiai d. mun.;2003;42;904;456;448
Telšiai d. mun.;2003;43;881;448;433
Telšiai d. mun.;2003;44;843;433;410
Telšiai d. mun.;2003;45;772;380;392
Telšiai d. mun.;2003;46;705;341;364
Telšiai d. mun.;2003;47;746;355;391
Telšiai d. mun.;2003;48;611;294;317
Telšiai d. mun.;2003;49;619;268;351
Telšiai d. mun.;2003;50;636;285;351
Telšiai d. mun.;2003;51;602;302;300
Telšiai d. mun.;2003;52;677;319;358
Telšiai d. mun.;2003;53;668;303;365
Telšiai d. mun.;2003;54;561;277;284
Telšiai d. mun.;2003;55;523;244;279
Telšiai d. mun.;2003;56;525;233;292
Telšiai d. mun.;2003;57;560;250;310
Telšiai d. mun.;2003;58;492;218;274
Telšiai d. mun.;2003;59;588;241;347
Telšiai d. mun.;2003;60;601;266;335
Telšiai d. mun.;2003;61;603;281;322
Telšiai d. mun.;2003;62;595;248;347
Telšiai d. mun.;2003;63;578;247;331
Telšiai d. mun.;2003;64;556;220;336
Telšiai d. mun.;2003;65;570;222;348
Telšiai d. mun.;2003;66;614;248;366
Telšiai d. mun.;2003;67;577;223;354
Telšiai d. mun.;2003;68;499;187;312
Telšiai d. mun.;2003;69;552;196;356
Telšiai d. mun.;2003;70;525;203;322
Telšiai d. mun.;2003;71;545;211;334
Telšiai d. mun.;2003;72;483;174;309
Telšiai d. mun.;2003;73;458;179;279
Telšiai d. mun.;2003;74;504;176;328
Telšiai d. mun.;2003;75;429;135;294
Telšiai d. mun.;2003;76;388;117;271
Telšiai d. mun.;2003;77;387;107;280
Telšiai d. mun.;2003;78;350;108;242
Telšiai d. mun.;2003;79;288;99;189
Telšiai d. mun.;2003;80;289;102;187
Telšiai d. mun.;2003;81;266;73;193
Telšiai d. mun.;2003;82;189;59;130
Telšiai d. mun.;2003;83;149;49;100
Telšiai d. mun.;2003;84;100;23;77
Telšiai d. mun.;2003;85;577;158;419
Telšiai d. mun.;2004;-1;55587;26113;29474
Telšiai d. mun.;2004;0;527;272;255
Telšiai d. mun.;2004;1;510;264;246
Telšiai d. mun.;2004;2;557;286;271
Telšiai d. mun.;2004;3;614;327;287
Telšiai d. mun.;2004;4;601;322;279
Telšiai d. mun.;2004;5;655;333;322
Telšiai d. mun.;2004;6;635;339;296
Telšiai d. mun.;2004;7;659;344;315
Telšiai d. mun.;2004;8;731;370;361
Telšiai d. mun.;2004;9;831;397;434
Telšiai d. mun.;2004;10;865;433;432
Telšiai d. mun.;2004;11;1023;515;508
Telšiai d. mun.;2004;12;983;474;509
Telšiai d. mun.;2004;13;914;490;424
Telšiai d. mun.;2004;14;910;488;422
Telšiai d. mun.;2004;15;909;458;451
Telšiai d. mun.;2004;16;982;484;498
Telšiai d. mun.;2004;17;1023;531;492
Telšiai d. mun.;2004;18;929;480;449
Telšiai d. mun.;2004;19;887;442;445
Telšiai d. mun.;2004;20;908;453;455
Telšiai d. mun.;2004;21;755;400;355
Telšiai d. mun.;2004;22;668;318;350
Telšiai d. mun.;2004;23;682;353;329
Telšiai d. mun.;2004;24;716;372;344
Telšiai d. mun.;2004;25;644;340;304
Telšiai d. mun.;2004;26;631;311;320
Telšiai d. mun.;2004;27;687;322;365
Telšiai d. mun.;2004;28;670;334;336
Telšiai d. mun.;2004;29;650;326;324
Telšiai d. mun.;2004;30;644;314;330
Telšiai d. mun.;2004;31;759;347;412
Telšiai d. mun.;2004;32;820;427;393
Telšiai d. mun.;2004;33;755;378;377
Telšiai d. mun.;2004;34;724;392;332
Telšiai d. mun.;2004;35;726;363;363
Telšiai d. mun.;2004;36;753;366;387
Telšiai d. mun.;2004;37;787;408;379
Telšiai d. mun.;2004;38;781;392;389
Telšiai d. mun.;2004;39;839;419;420
Telšiai d. mun.;2004;40;780;378;402
Telšiai d. mun.;2004;41;808;407;401
Telšiai d. mun.;2004;42;831;384;447
Telšiai d. mun.;2004;43;892;450;442
Telšiai d. mun.;2004;44;863;437;426
Telšiai d. mun.;2004;45;827;425;402
Telšiai d. mun.;2004;46;752;370;382
Telšiai d. mun.;2004;47;692;333;359
Telšiai d. mun.;2004;48;733;347;386
Telšiai d. mun.;2004;49;599;285;314
Telšiai d. mun.;2004;50;605;263;342
Telšiai d. mun.;2004;51;623;276;347
Telšiai d. mun.;2004;52;594;301;293
Telšiai d. mun.;2004;53;670;316;354
Telšiai d. mun.;2004;54;652;292;360
Telšiai d. mun.;2004;55;554;270;284
Telšiai d. mun.;2004;56;509;235;274
Telšiai d. mun.;2004;57;510;226;284
Telšiai d. mun.;2004;58;547;246;301
Telšiai d. mun.;2004;59;489;217;272
Telšiai d. mun.;2004;60;573;233;340
Telšiai d. mun.;2004;61;585;256;329
Telšiai d. mun.;2004;62;585;272;313
Telšiai d. mun.;2004;63;576;239;337
Telšiai d. mun.;2004;64;565;236;329
Telšiai d. mun.;2004;65;547;213;334
Telšiai d. mun.;2004;66;558;212;346
Telšiai d. mun.;2004;67;600;237;363
Telšiai d. mun.;2004;68;567;213;354
Telšiai d. mun.;2004;69;489;179;310
Telšiai d. mun.;2004;70;539;187;352
Telšiai d. mun.;2004;71;499;192;307
Telšiai d. mun.;2004;72;526;201;325
Telšiai d. mun.;2004;73;459;158;301
Telšiai d. mun.;2004;74;445;168;277
Telšiai d. mun.;2004;75;492;169;323
Telšiai d. mun.;2004;76;412;123;289
Telšiai d. mun.;2004;77;367;106;261
Telšiai d. mun.;2004;78;368;102;266
Telšiai d. mun.;2004;79;331;95;236
Telšiai d. mun.;2004;80;263;90;173
Telšiai d. mun.;2004;81;256;91;165
Telšiai d. mun.;2004;82;242;59;183
Telšiai d. mun.;2004;83;175;54;121
Telšiai d. mun.;2004;84;132;42;90
Telšiai d. mun.;2004;85;562;144;418
Telšiai d. mun.;2005;-1;54561;25629;28932
Telšiai d. mun.;2005;0;524;250;274
Telšiai d. mun.;2005;1;518;270;248
Telšiai d. mun.;2005;2;505;264;241
Telšiai d. mun.;2005;3;553;284;269
Telšiai d. mun.;2005;4;605;321;284
Telšiai d. mun.;2005;5;589;316;273
Telšiai d. mun.;2005;6;643;325;318
Telšiai d. mun.;2005;7;626;334;292
Telšiai d. mun.;2005;8;656;344;312
Telšiai d. mun.;2005;9;726;370;356
Telšiai d. mun.;2005;10;825;395;430
Telšiai d. mun.;2005;11;855;431;424
Telšiai d. mun.;2005;12;1003;506;497
Telšiai d. mun.;2005;13;975;472;503
Telšiai d. mun.;2005;14;899;481;418
Telšiai d. mun.;2005;15;895;480;415
Telšiai d. mun.;2005;16;888;447;441
Telšiai d. mun.;2005;17;962;472;490
Telšiai d. mun.;2005;18;997;515;482
Telšiai d. mun.;2005;19;900;465;435
Telšiai d. mun.;2005;20;857;430;427
Telšiai d. mun.;2005;21;881;438;443
Telšiai d. mun.;2005;22;735;392;343
Telšiai d. mun.;2005;23;632;309;323
Telšiai d. mun.;2005;24;640;334;306
Telšiai d. mun.;2005;25;676;353;323
Telšiai d. mun.;2005;26;623;332;291
Telšiai d. mun.;2005;27;591;294;297
Telšiai d. mun.;2005;28;657;308;349
Telšiai d. mun.;2005;29;656;327;329
Telšiai d. mun.;2005;30;622;311;311
Telšiai d. mun.;2005;31;617;295;322
Telšiai d. mun.;2005;32;730;330;400
Telšiai d. mun.;2005;33;806;419;387
Telšiai d. mun.;2005;34;726;362;364
Telšiai d. mun.;2005;35;708;381;327
Telšiai d. mun.;2005;36;710;354;356
Telšiai d. mun.;2005;37;731;355;376
Telšiai d. mun.;2005;38;771;398;373
Telšiai d. mun.;2005;39;764;383;381
Telšiai d. mun.;2005;40;824;415;409
Telšiai d. mun.;2005;41;768;372;396
Telšiai d. mun.;2005;42;794;397;397
Telšiai d. mun.;2005;43;822;380;442
Telšiai d. mun.;2005;44;888;446;442
Telšiai d. mun.;2005;45;849;427;422
Telšiai d. mun.;2005;46;817;421;396
Telšiai d. mun.;2005;47;746;365;381
Telšiai d. mun.;2005;48;674;324;350
Telšiai d. mun.;2005;49;711;334;377
Telšiai d. mun.;2005;50;588;279;309
Telšiai d. mun.;2005;51;595;259;336
Telšiai d. mun.;2005;52;610;268;342
Telšiai d. mun.;2005;53;583;294;289
Telšiai d. mun.;2005;54;660;308;352
Telšiai d. mun.;2005;55;641;285;356
Telšiai d. mun.;2005;56;538;263;275
Telšiai d. mun.;2005;57;497;228;269
Telšiai d. mun.;2005;58;499;220;279
Telšiai d. mun.;2005;59;538;241;297
Telšiai d. mun.;2005;60;483;212;271
Telšiai d. mun.;2005;61;563;226;337
Telšiai d. mun.;2005;62;574;248;326
Telšiai d. mun.;2005;63;568;263;305
Telšiai d. mun.;2005;64;556;228;328
Telšiai d. mun.;2005;65;547;226;321
Telšiai d. mun.;2005;66;536;209;327
Telšiai d. mun.;2005;67;542;202;340
Telšiai d. mun.;2005;68;584;227;357
Telšiai d. mun.;2005;69;553;206;347
Telšiai d. mun.;2005;70;477;172;305
Telšiai d. mun.;2005;71;524;177;347
Telšiai d. mun.;2005;72;474;179;295
Telšiai d. mun.;2005;73;510;194;316
Telšiai d. mun.;2005;74;446;152;294
Telšiai d. mun.;2005;75;425;153;272
Telšiai d. mun.;2005;76;471;161;310
Telšiai d. mun.;2005;77;396;121;275
Telšiai d. mun.;2005;78;347;101;246
Telšiai d. mun.;2005;79;345;94;251
Telšiai d. mun.;2005;80;300;85;215
Telšiai d. mun.;2005;81;246;81;165
Telšiai d. mun.;2005;82;239;86;153
Telšiai d. mun.;2005;83;224;61;163
Telšiai d. mun.;2005;84;162;50;112
Telšiai d. mun.;2005;85;550;142;408
Telšiai d. mun.;2006;-1;52882;24591;28291
Telšiai d. mun.;2006;0;516;252;264
Telšiai d. mun.;2006;1;510;241;269
Telšiai d. mun.;2006;2;505;260;245
Telšiai d. mun.;2006;3;492;257;235
Telšiai d. mun.;2006;4;536;274;262
Telšiai d. mun.;2006;5;594;314;280
Telšiai d. mun.;2006;6;574;307;267
Telšiai d. mun.;2006;7;633;318;315
Telšiai d. mun.;2006;8;616;327;289
Telšiai d. mun.;2006;9;638;335;303
Telšiai d. mun.;2006;10;716;362;354
Telšiai d. mun.;2006;11;810;385;425
Telšiai d. mun.;2006;12;840;419;421
Telšiai d. mun.;2006;13;974;488;486
Telšiai d. mun.;2006;14;954;462;492
Telšiai d. mun.;2006;15;868;461;407
Telšiai d. mun.;2006;16;860;458;402
Telšiai d. mun.;2006;17;855;424;431
Telšiai d. mun.;2006;18;917;447;470
Telšiai d. mun.;2006;19;940;478;462
Telšiai d. mun.;2006;20;849;439;410
Telšiai d. mun.;2006;21;798;398;400
Telšiai d. mun.;2006;22;834;416;418
Telšiai d. mun.;2006;23;688;368;320
Telšiai d. mun.;2006;24;581;279;302
Telšiai d. mun.;2006;25;591;311;280
Telšiai d. mun.;2006;26;636;335;301
Telšiai d. mun.;2006;27;590;314;276
Telšiai d. mun.;2006;28;567;280;287
Telšiai d. mun.;2006;29;639;301;338
Telšiai d. mun.;2006;30;631;309;322
Telšiai d. mun.;2006;31;594;295;299
Telšiai d. mun.;2006;32;599;283;316
Telšiai d. mun.;2006;33;690;303;387
Telšiai d. mun.;2006;34;772;396;376
Telšiai d. mun.;2006;35;700;346;354
Telšiai d. mun.;2006;36;672;360;312
Telšiai d. mun.;2006;37;687;339;348
Telšiai d. mun.;2006;38;703;336;367
Telšiai d. mun.;2006;39;743;378;365
Telšiai d. mun.;2006;40;737;364;373
Telšiai d. mun.;2006;41;794;398;396
Telšiai d. mun.;2006;42;733;351;382
Telšiai d. mun.;2006;43;771;381;390
Telšiai d. mun.;2006;44;798;368;430
Telšiai d. mun.;2006;45;860;426;434
Telšiai d. mun.;2006;46;831;416;415
Telšiai d. mun.;2006;47;796;402;394
Telšiai d. mun.;2006;48;725;351;374
Telšiai d. mun.;2006;49;654;312;342
Telšiai d. mun.;2006;50;691;321;370
Telšiai d. mun.;2006;51;578;269;309
Telšiai d. mun.;2006;52;580;249;331
Telšiai d. mun.;2006;53;593;257;336
Telšiai d. mun.;2006;54;564;280;284
Telšiai d. mun.;2006;55;642;298;344
Telšiai d. mun.;2006;56;626;273;353
Telšiai d. mun.;2006;57;523;251;272
Telšiai d. mun.;2006;58;485;218;267
Telšiai d. mun.;2006;59;483;210;273
Telšiai d. mun.;2006;60;528;232;296
Telšiai d. mun.;2006;61;460;196;264
Telšiai d. mun.;2006;62;542;211;331
Telšiai d. mun.;2006;63;560;237;323
Telšiai d. mun.;2006;64;551;252;299
Telšiai d. mun.;2006;65;539;213;326
Telšiai d. mun.;2006;66;534;217;317
Telšiai d. mun.;2006;67;524;198;326
Telšiai d. mun.;2006;68;519;188;331
Telšiai d. mun.;2006;69;558;208;350
Telšiai d. mun.;2006;70;536;190;346
Telšiai d. mun.;2006;71;451;160;291
Telšiai d. mun.;2006;72;505;165;340
Telšiai d. mun.;2006;73;450;171;279
Telšiai d. mun.;2006;74;485;178;307
Telšiai d. mun.;2006;75;425;140;285
Telšiai d. mun.;2006;76;401;140;261
Telšiai d. mun.;2006;77;434;141;293
Telšiai d. mun.;2006;78;370;112;258
Telšiai d. mun.;2006;79;324;90;234
Telšiai d. mun.;2006;80;327;85;242
Telšiai d. mun.;2006;81;263;66;197
Telšiai d. mun.;2006;82;219;67;152
Telšiai d. mun.;2006;83;213;73;140
Telšiai d. mun.;2006;84;198;50;148
Telšiai d. mun.;2006;85;590;161;429
Telšiai d. mun.;2007;-1;51592;23883;27709
Telšiai d. mun.;2007;0;499;251;248
Telšiai d. mun.;2007;1;510;248;262
Telšiai d. mun.;2007;2;503;239;264
Telšiai d. mun.;2007;3;498;257;241
Telšiai d. mun.;2007;4;485;251;234
Telšiai d. mun.;2007;5;526;269;257
Telšiai d. mun.;2007;6;581;309;272
Telšiai d. mun.;2007;7;567;299;268
Telšiai d. mun.;2007;8;621;311;310
Telšiai d. mun.;2007;9;605;322;283
Telšiai d. mun.;2007;10;627;327;300
Telšiai d. mun.;2007;11;702;353;349
Telšiai d. mun.;2007;12;804;379;425
Telšiai d. mun.;2007;13;819;409;410
Telšiai d. mun.;2007;14;959;479;480
Telšiai d. mun.;2007;15;939;452;487
Telšiai d. mun.;2007;16;850;448;402
Telšiai d. mun.;2007;17;842;449;393
Telšiai d. mun.;2007;18;834;413;421
Telšiai d. mun.;2007;19;884;429;455
Telšiai d. mun.;2007;20;905;463;442
Telšiai d. mun.;2007;21;805;416;389
Telšiai d. mun.;2007;22;765;378;387
Telšiai d. mun.;2007;23;794;392;402
Telšiai d. mun.;2007;24;658;352;306
Telšiai d. mun.;2007;25;549;255;294
Telšiai d. mun.;2007;26;558;292;266
Telšiai d. mun.;2007;27;607;323;284
Telšiai d. mun.;2007;28;563;303;260
Telšiai d. mun.;2007;29;539;261;278
Telšiai d. mun.;2007;30;608;283;325
Telšiai d. mun.;2007;31;611;296;315
Telšiai d. mun.;2007;32;572;280;292
Telšiai d. mun.;2007;33;574;271;303
Telšiai d. mun.;2007;34;678;293;385
Telšiai d. mun.;2007;35;750;382;368
Telšiai d. mun.;2007;36;677;327;350
Telšiai d. mun.;2007;37;650;346;304
Telšiai d. mun.;2007;38;666;328;338
Telšiai d. mun.;2007;39;685;324;361
Telšiai d. mun.;2007;40;726;369;357
Telšiai d. mun.;2007;41;721;352;369
Telšiai d. mun.;2007;42;777;386;391
Telšiai d. mun.;2007;43;706;336;370
Telšiai d. mun.;2007;44;748;368;380
Telšiai d. mun.;2007;45;781;360;421
Telšiai d. mun.;2007;46;843;416;427
Telšiai d. mun.;2007;47;810;404;406
Telšiai d. mun.;2007;48;785;395;390
Telšiai d. mun.;2007;49;717;343;374
Telšiai d. mun.;2007;50;633;296;337
Telšiai d. mun.;2007;51;675;313;362
Telšiai d. mun.;2007;52;564;262;302
Telšiai d. mun.;2007;53;561;235;326
Telšiai d. mun.;2007;54;574;247;327
Telšiai d. mun.;2007;55;548;267;281
Telšiai d. mun.;2007;56;626;288;338
Telšiai d. mun.;2007;57;607;259;348
Telšiai d. mun.;2007;58;507;239;268
Telšiai d. mun.;2007;59;469;211;258
Telšiai d. mun.;2007;60;463;197;266
Telšiai d. mun.;2007;61;507;221;286
Telšiai d. mun.;2007;62;447;189;258
Telšiai d. mun.;2007;63;520;200;320
Telšiai d. mun.;2007;64;539;228;311
Telšiai d. mun.;2007;65;530;239;291
Telšiai d. mun.;2007;66;520;201;319
Telšiai d. mun.;2007;67;518;206;312
Telšiai d. mun.;2007;68;505;187;318
Telšiai d. mun.;2007;69;501;178;323
Telšiai d. mun.;2007;70;554;203;351
Telšiai d. mun.;2007;71;513;180;333
Telšiai d. mun.;2007;72;439;154;285
Telšiai d. mun.;2007;73;483;156;327
Telšiai d. mun.;2007;74;426;159;267
Telšiai d. mun.;2007;75;456;162;294
Telšiai d. mun.;2007;76;406;132;274
Telšiai d. mun.;2007;77;370;125;245
Telšiai d. mun.;2007;78;396;123;273
Telšiai d. mun.;2007;79;348;102;246
Telšiai d. mun.;2007;80;306;85;221
Telšiai d. mun.;2007;81;284;72;212
Telšiai d. mun.;2007;82;246;65;181
Telšiai d. mun.;2007;83;191;54;137
Telšiai d. mun.;2007;84;190;64;126
Telšiai d. mun.;2007;85;687;196;491
Telšiai d. mun.;2008;-1;50589;23472;27117
Telšiai d. mun.;2008;0;429;239;190
Telšiai d. mun.;2008;1;494;249;245
Telšiai d. mun.;2008;2;499;242;257
Telšiai d. mun.;2008;3;496;235;261
Telšiai d. mun.;2008;4;490;254;236
Telšiai d. mun.;2008;5;473;240;233
Telšiai d. mun.;2008;6;516;264;252
Telšiai d. mun.;2008;7;575;304;271
Telšiai d. mun.;2008;8;566;300;266
Telšiai d. mun.;2008;9;610;307;303
Telšiai d. mun.;2008;10;598;317;281
Telšiai d. mun.;2008;11;615;317;298
Telšiai d. mun.;2008;12;692;349;343
Telšiai d. mun.;2008;13;786;370;416
Telšiai d. mun.;2008;14;809;404;405
Telšiai d. mun.;2008;15;948;475;473
Telšiai d. mun.;2008;16;924;447;477
Telšiai d. mun.;2008;17;833;440;393
Telšiai d. mun.;2008;18;821;441;380
Telšiai d. mun.;2008;19;813;402;411
Telšiai d. mun.;2008;20;860;422;438
Telšiai d. mun.;2008;21;870;449;421
Telšiai d. mun.;2008;22;776;403;373
Telšiai d. mun.;2008;23;734;367;367
Telšiai d. mun.;2008;24;766;379;387
Telšiai d. mun.;2008;25;623;332;291
Telšiai d. mun.;2008;26;537;251;286
Telšiai d. mun.;2008;27;538;281;257
Telšiai d. mun.;2008;28;595;317;278
Telšiai d. mun.;2008;29;551;295;256
Telšiai d. mun.;2008;30;527;257;270
Telšiai d. mun.;2008;31;593;275;318
Telšiai d. mun.;2008;32;601;291;310
Telšiai d. mun.;2008;33;563;279;284
Telšiai d. mun.;2008;34;566;273;293
Telšiai d. mun.;2008;35;661;282;379
Telšiai d. mun.;2008;36;729;370;359
Telšiai d. mun.;2008;37;669;324;345
Telšiai d. mun.;2008;38;634;338;296
Telšiai d. mun.;2008;39;651;319;332
Telšiai d. mun.;2008;40;666;315;351
Telšiai d. mun.;2008;41;715;366;349
Telšiai d. mun.;2008;42;701;348;353
Telšiai d. mun.;2008;43;761;379;382
Telšiai d. mun.;2008;44;685;326;359
Telšiai d. mun.;2008;45;739;366;373
Telšiai d. mun.;2008;46;770;354;416
Telšiai d. mun.;2008;47;829;409;420
Telšiai d. mun.;2008;48;798;396;402
Telšiai d. mun.;2008;49;782;394;388
Telšiai d. mun.;2008;50;704;338;366
Telšiai d. mun.;2008;51;625;292;333
Telšiai d. mun.;2008;52;659;305;354
Telšiai d. mun.;2008;53;556;255;301
Telšiai d. mun.;2008;54;558;237;321
Telšiai d. mun.;2008;55;567;244;323
Telšiai d. mun.;2008;56;540;263;277
Telšiai d. mun.;2008;57;608;275;333
Telšiai d. mun.;2008;58;591;247;344
Telšiai d. mun.;2008;59;498;234;264
Telšiai d. mun.;2008;60;457;202;255
Telšiai d. mun.;2008;61;455;192;263
Telšiai d. mun.;2008;62;490;213;277
Telšiai d. mun.;2008;63;434;183;251
Telšiai d. mun.;2008;64;499;188;311
Telšiai d. mun.;2008;65;528;222;306
Telšiai d. mun.;2008;66;509;225;284
Telšiai d. mun.;2008;67;507;195;312
Telšiai d. mun.;2008;68;504;200;304
Telšiai d. mun.;2008;69;496;181;315
Telšiai d. mun.;2008;70;485;168;317
Telšiai d. mun.;2008;71;532;196;336
Telšiai d. mun.;2008;72;489;167;322
Telšiai d. mun.;2008;73;424;144;280
Telšiai d. mun.;2008;74;461;147;314
Telšiai d. mun.;2008;75;412;155;257
Telšiai d. mun.;2008;76;428;144;284
Telšiai d. mun.;2008;77;388;123;265
Telšiai d. mun.;2008;78;345;114;231
Telšiai d. mun.;2008;79;369;117;252
Telšiai d. mun.;2008;80;322;90;232
Telšiai d. mun.;2008;81;286;81;205
Telšiai d. mun.;2008;82;262;66;196
Telšiai d. mun.;2008;83;223;58;165
Telšiai d. mun.;2008;84;174;48;126
Telšiai d. mun.;2008;85;727;210;517
Telšiai d. mun.;2009;-1;49789;23120;26669
Telšiai d. mun.;2009;0;508;255;253
Telšiai d. mun.;2009;1;422;233;189
Telšiai d. mun.;2009;2;482;245;237
Telšiai d. mun.;2009;3;487;235;252
Telšiai d. mun.;2009;4;489;233;256
Telšiai d. mun.;2009;5;488;251;237
Telšiai d. mun.;2009;6;473;241;232
Telšiai d. mun.;2009;7;504;259;245
Telšiai d. mun.;2009;8;565;297;268
Telšiai d. mun.;2009;9;561;297;264
Telšiai d. mun.;2009;10;603;302;301
Telšiai d. mun.;2009;11;595;316;279
Telšiai d. mun.;2009;12;608;316;292
Telšiai d. mun.;2009;13;690;348;342
Telšiai d. mun.;2009;14;776;364;412
Telšiai d. mun.;2009;15;805;402;403
Telšiai d. mun.;2009;16;935;470;465
Telšiai d. mun.;2009;17;924;447;477
Telšiai d. mun.;2009;18;825;433;392
Telšiai d. mun.;2009;19;804;431;373
Telšiai d. mun.;2009;20;799;395;404
Telšiai d. mun.;2009;21;840;413;427
Telšiai d. mun.;2009;22;854;440;414
Telšiai d. mun.;2009;23;759;395;364
Telšiai d. mun.;2009;24;712;360;352
Telšiai d. mun.;2009;25;732;366;366
Telšiai d. mun.;2009;26;588;315;273
Telšiai d. mun.;2009;27;515;240;275
Telšiai d. mun.;2009;28;523;273;250
Telšiai d. mun.;2009;29;571;303;268
Telšiai d. mun.;2009;30;537;288;249
Telšiai d. mun.;2009;31;504;247;257
Telšiai d. mun.;2009;32;582;271;311
Telšiai d. mun.;2009;33;587;282;305
Telšiai d. mun.;2009;34;556;277;279
Telšiai d. mun.;2009;35;555;266;289
Telšiai d. mun.;2009;36;648;277;371
Telšiai d. mun.;2009;37;714;361;353
Telšiai d. mun.;2009;38;659;318;341
Telšiai d. mun.;2009;39;624;334;290
Telšiai d. mun.;2009;40;643;315;328
Telšiai d. mun.;2009;41;655;310;345
Telšiai d. mun.;2009;42;709;362;347
Telšiai d. mun.;2009;43;692;342;350
Telšiai d. mun.;2009;44;753;376;377
Telšiai d. mun.;2009;45;680;319;361
Telšiai d. mun.;2009;46;733;365;368
Telšiai d. mun.;2009;47;759;351;408
Telšiai d. mun.;2009;48;818;405;413
Telšiai d. mun.;2009;49;788;391;397
Telšiai d. mun.;2009;50;766;385;381
Telšiai d. mun.;2009;51;695;333;362
Telšiai d. mun.;2009;52;615;287;328
Telšiai d. mun.;2009;53;651;300;351
Telšiai d. mun.;2009;54;550;252;298
Telšiai d. mun.;2009;55;549;231;318
Telšiai d. mun.;2009;56;553;234;319
Telšiai d. mun.;2009;57;527;255;272
Telšiai d. mun.;2009;58;587;263;324
Telšiai d. mun.;2009;59;579;241;338
Telšiai d. mun.;2009;60;492;231;261
Telšiai d. mun.;2009;61;446;196;250
Telšiai d. mun.;2009;62;440;181;259
Telšiai d. mun.;2009;63;482;210;272
Telšiai d. mun.;2009;64;416;175;241
Telšiai d. mun.;2009;65;485;182;303
Telšiai d. mun.;2009;66;517;218;299
Telšiai d. mun.;2009;67;489;213;276
Telšiai d. mun.;2009;68;499;189;310
Telšiai d. mun.;2009;69;482;188;294
Telšiai d. mun.;2009;70;486;176;310
Telšiai d. mun.;2009;71;468;157;311
Telšiai d. mun.;2009;72;521;191;330
Telšiai d. mun.;2009;73;475;163;312
Telšiai d. mun.;2009;74;402;132;270
Telšiai d. mun.;2009;75;426;134;292
Telšiai d. mun.;2009;76;395;146;249
Telšiai d. mun.;2009;77;400;135;265
Telšiai d. mun.;2009;78;362;114;248
Telšiai d. mun.;2009;79;322;100;222
Telšiai d. mun.;2009;80;341;104;237
Telšiai d. mun.;2009;81;301;85;216
Telšiai d. mun.;2009;82;262;72;190
Telšiai d. mun.;2009;83;230;61;169
Telšiai d. mun.;2009;84;199;48;151
Telšiai d. mun.;2009;85;746;206;540
Telšiai d. mun.;2010;-1;48655;22549;26106
Telšiai d. mun.;2010;0;459;214;245
Telšiai d. mun.;2010;1;496;246;250
Telšiai d. mun.;2010;2;406;224;182
Telšiai d. mun.;2010;3;473;239;234
Telšiai d. mun.;2010;4;469;227;242
Telšiai d. mun.;2010;5;480;226;254
Telšiai d. mun.;2010;6;470;244;226
Telšiai d. mun.;2010;7;463;233;230
Telšiai d. mun.;2010;8;496;254;242
Telšiai d. mun.;2010;9;556;290;266
Telšiai d. mun.;2010;10;552;291;261
Telšiai d. mun.;2010;11;596;298;298
Telšiai d. mun.;2010;12;585;312;273
Telšiai d. mun.;2010;13;604;313;291
Telšiai d. mun.;2010;14;678;342;336
Telšiai d. mun.;2010;15;769;363;406
Telšiai d. mun.;2010;16;798;399;399
Telšiai d. mun.;2010;17;922;463;459
Telšiai d. mun.;2010;18;909;441;468
Telšiai d. mun.;2010;19;801;420;381
Telšiai d. mun.;2010;20;786;422;364
Telšiai d. mun.;2010;21;784;390;394
Telšiai d. mun.;2010;22;811;401;410
Telšiai d. mun.;2010;23;813;416;397
Telšiai d. mun.;2010;24;730;386;344
Telšiai d. mun.;2010;25;678;346;332
Telšiai d. mun.;2010;26;691;350;341
Telšiai d. mun.;2010;27;558;293;265
Telšiai d. mun.;2010;28;480;220;260
Telšiai d. mun.;2010;29;500;262;238
Telšiai d. mun.;2010;30;554;292;262
Telšiai d. mun.;2010;31;510;271;239
Telšiai d. mun.;2010;32;489;242;247
Telšiai d. mun.;2010;33;557;259;298
Telšiai d. mun.;2010;34;572;276;296
Telšiai d. mun.;2010;35;540;270;270
Telšiai d. mun.;2010;36;538;256;282
Telšiai d. mun.;2010;37;635;273;362
Telšiai d. mun.;2010;38;706;356;350
Telšiai d. mun.;2010;39;644;308;336
Telšiai d. mun.;2010;40;609;324;285
Telšiai d. mun.;2010;41;631;309;322
Telšiai d. mun.;2010;42;648;305;343
Telšiai d. mun.;2010;43;697;356;341
Telšiai d. mun.;2010;44;682;338;344
Telšiai d. mun.;2010;45;735;365;370
Telšiai d. mun.;2010;46;658;307;351
Telšiai d. mun.;2010;47;716;355;361
Telšiai d. mun.;2010;48;744;340;404
Telšiai d. mun.;2010;49;806;399;407
Telšiai d. mun.;2010;50;775;383;392
Telšiai d. mun.;2010;51;754;376;378
Telšiai d. mun.;2010;52;679;325;354
Telšiai d. mun.;2010;53;597;276;321
Telšiai d. mun.;2010;54;640;294;346
Telšiai d. mun.;2010;55;537;246;291
Telšiai d. mun.;2010;56;536;225;311
Telšiai d. mun.;2010;57;541;230;311
Telšiai d. mun.;2010;58;510;241;269
Telšiai d. mun.;2010;59;567;252;315
Telšiai d. mun.;2010;60;563;232;331
Telšiai d. mun.;2010;61;483;226;257
Telšiai d. mun.;2010;62;429;182;247
Telšiai d. mun.;2010;63;429;175;254
Telšiai d. mun.;2010;64;470;207;263
Telšiai d. mun.;2010;65;407;168;239
Telšiai d. mun.;2010;66;478;179;299
Telšiai d. mun.;2010;67;493;203;290
Telšiai d. mun.;2010;68;475;208;267
Telšiai d. mun.;2010;69;481;180;301
Telšiai d. mun.;2010;70;464;179;285
Telšiai d. mun.;2010;71;468;166;302
Telšiai d. mun.;2010;72;448;147;301
Telšiai d. mun.;2010;73;505;185;320
Telšiai d. mun.;2010;74;453;154;299
Telšiai d. mun.;2010;75;389;126;263
Telšiai d. mun.;2010;76;408;126;282
Telšiai d. mun.;2010;77;367;130;237
Telšiai d. mun.;2010;78;376;121;255
Telšiai d. mun.;2010;79;332;103;229
Telšiai d. mun.;2010;80;291;89;202
Telšiai d. mun.;2010;81;304;86;218
Telšiai d. mun.;2010;82;278;76;202
Telšiai d. mun.;2010;83;234;61;173
Telšiai d. mun.;2010;84;211;57;154
Telšiai d. mun.;2010;85;799;209;590
Telšiai d. mun.;2011;-1;47171;21859;25312
Telšiai d. mun.;2011;0;404;225;179
Telšiai d. mun.;2011;1;447;204;243
Telšiai d. mun.;2011;2;456;230;226
Telšiai d. mun.;2011;3;376;214;162
Telšiai d. mun.;2011;4;464;228;236
Telšiai d. mun.;2011;5;437;223;214
Telšiai d. mun.;2011;6;444;208;236
Telšiai d. mun.;2011;7;459;242;217
Telšiai d. mun.;2011;8;460;228;232
Telšiai d. mun.;2011;9;490;259;231
Telšiai d. mun.;2011;10;548;276;272
Telšiai d. mun.;2011;11;571;305;266
Telšiai d. mun.;2011;12;587;297;290
Telšiai d. mun.;2011;13;586;308;278
Telšiai d. mun.;2011;14;619;320;299
Telšiai d. mun.;2011;15;688;358;330
Telšiai d. mun.;2011;16;753;367;386
Telšiai d. mun.;2011;17;795;404;391
Telšiai d. mun.;2011;18;912;465;447
Telšiai d. mun.;2011;19;769;372;397
Telšiai d. mun.;2011;20;698;391;307
Telšiai d. mun.;2011;21;647;350;297
Telšiai d. mun.;2011;22;643;326;317
Telšiai d. mun.;2011;23;647;347;300
Telšiai d. mun.;2011;24;621;335;286
Telšiai d. mun.;2011;25;537;297;240
Telšiai d. mun.;2011;26;478;239;239
Telšiai d. mun.;2011;27;476;246;230
Telšiai d. mun.;2011;28;475;255;220
Telšiai d. mun.;2011;29;456;213;243
Telšiai d. mun.;2011;30;485;227;258
Telšiai d. mun.;2011;31;501;248;253
Telšiai d. mun.;2011;32;503;256;247
Telšiai d. mun.;2011;33;497;241;256
Telšiai d. mun.;2011;34;563;253;310
Telšiai d. mun.;2011;35;537;264;273
Telšiai d. mun.;2011;36;567;290;277
Telšiai d. mun.;2011;37;554;263;291
Telšiai d. mun.;2011;38;658;298;360
Telšiai d. mun.;2011;39;710;354;356
Telšiai d. mun.;2011;40;661;311;350
Telšiai d. mun.;2011;41;610;322;288
Telšiai d. mun.;2011;42;654;323;331
Telšiai d. mun.;2011;43;653;302;351
Telšiai d. mun.;2011;44;688;344;344
Telšiai d. mun.;2011;45;670;333;337
Telšiai d. mun.;2011;46;730;356;374
Telšiai d. mun.;2011;47;666;314;352
Telšiai d. mun.;2011;48;718;349;369
Telšiai d. mun.;2011;49;750;339;411
Telšiai d. mun.;2011;50;790;391;399
Telšiai d. mun.;2011;51;782;383;399
Telšiai d. mun.;2011;52;746;367;379
Telšiai d. mun.;2011;53;686;337;349
Telšiai d. mun.;2011;54;627;293;334
Telšiai d. mun.;2011;55;661;305;356
Telšiai d. mun.;2011;56;535;241;294
Telšiai d. mun.;2011;57;545;225;320
Telšiai d. mun.;2011;58;560;231;329
Telšiai d. mun.;2011;59;523;251;272
Telšiai d. mun.;2011;60;573;250;323
Telšiai d. mun.;2011;61;574;240;334
Telšiai d. mun.;2011;62;517;227;290
Telšiai d. mun.;2011;63;447;195;252
Telšiai d. mun.;2011;64;441;180;261
Telšiai d. mun.;2011;65;479;201;278
Telšiai d. mun.;2011;66;407;162;245
Telšiai d. mun.;2011;67;492;186;306
Telšiai d. mun.;2011;68;500;200;300
Telšiai d. mun.;2011;69;485;207;278
Telšiai d. mun.;2011;70;485;176;309
Telšiai d. mun.;2011;71;467;179;288
Telšiai d. mun.;2011;72;453;161;292
Telšiai d. mun.;2011;73;438;151;287
Telšiai d. mun.;2011;74;501;182;319
Telšiai d. mun.;2011;75;447;148;299
Telšiai d. mun.;2011;76;377;125;252
Telšiai d. mun.;2011;77;404;122;282
Telšiai d. mun.;2011;78;355;124;231
Telšiai d. mun.;2011;79;345;108;237
Telšiai d. mun.;2011;80;332;110;222
Telšiai d. mun.;2011;81;273;82;191
Telšiai d. mun.;2011;82;288;77;211
Telšiai d. mun.;2011;83;261;70;191
Telšiai d. mun.;2011;84;207;41;166
Telšiai d. mun.;2011;85;850;212;638
Telšiai d. mun.;2012;-1;46273;21393;24880
Telšiai d. mun.;2012;0;458;229;229
Telšiai d. mun.;2012;1;405;225;180
Telšiai d. mun.;2012;2;441;203;238
Telšiai d. mun.;2012;3;443;228;215
Telšiai d. mun.;2012;4;370;213;157
Telšiai d. mun.;2012;5;456;221;235
Telšiai d. mun.;2012;6;433;220;213
Telšiai d. mun.;2012;7;439;203;236
Telšiai d. mun.;2012;8;457;241;216
Telšiai d. mun.;2012;9;457;226;231
Telšiai d. mun.;2012;10;483;255;228
Telšiai d. mun.;2012;11;538;269;269
Telšiai d. mun.;2012;12;566;302;264
Telšiai d. mun.;2012;13;577;295;282
Telšiai d. mun.;2012;14;586;309;277
Telšiai d. mun.;2012;15;616;318;298
Telšiai d. mun.;2012;16;685;357;328
Telšiai d. mun.;2012;17;749;366;383
Telšiai d. mun.;2012;18;790;400;390
Telšiai d. mun.;2012;19;884;452;432
Telšiai d. mun.;2012;20;749;366;383
Telšiai d. mun.;2012;21;674;376;298
Telšiai d. mun.;2012;22;614;332;282
Telšiai d. mun.;2012;23;621;312;309
Telšiai d. mun.;2012;24;612;342;270
Telšiai d. mun.;2012;25;584;316;268
Telšiai d. mun.;2012;26;484;274;210
Telšiai d. mun.;2012;27;439;221;218
Telšiai d. mun.;2012;28;450;236;214
Telšiai d. mun.;2012;29;461;239;222
Telšiai d. mun.;2012;30;420;188;232
Telšiai d. mun.;2012;31;471;225;246
Telšiai d. mun.;2012;32;482;239;243
Telšiai d. mun.;2012;33;477;242;235
Telšiai d. mun.;2012;34;492;236;256
Telšiai d. mun.;2012;35;557;251;306
Telšiai d. mun.;2012;36;522;257;265
Telšiai d. mun.;2012;37;558;284;274
Telšiai d. mun.;2012;38;546;257;289
Telšiai d. mun.;2012;39;646;292;354
Telšiai d. mun.;2012;40;693;345;348
Telšiai d. mun.;2012;41;653;306;347
Telšiai d. mun.;2012;42;603;317;286
Telšiai d. mun.;2012;43;641;314;327
Telšiai d. mun.;2012;44;640;294;346
Telšiai d. mun.;2012;45;680;338;342
Telšiai d. mun.;2012;46;656;328;328
Telšiai d. mun.;2012;47;717;348;369
Telšiai d. mun.;2012;48;656;305;351
Telšiai d. mun.;2012;49;706;343;363
Telšiai d. mun.;2012;50;741;335;406
Telšiai d. mun.;2012;51;781;387;394
Telšiai d. mun.;2012;52;762;374;388
Telšiai d. mun.;2012;53;733;354;379
Telšiai d. mun.;2012;54;680;330;350
Telšiai d. mun.;2012;55;618;287;331
Telšiai d. mun.;2012;56;652;300;352
Telšiai d. mun.;2012;57;523;234;289
Telšiai d. mun.;2012;58;529;213;316
Telšiai d. mun.;2012;59;549;225;324
Telšiai d. mun.;2012;60;510;241;269
Telšiai d. mun.;2012;61;569;247;322
Telšiai d. mun.;2012;62;563;232;331
Telšiai d. mun.;2012;63;504;216;288
Telšiai d. mun.;2012;64;439;191;248
Telšiai d. mun.;2012;65;437;179;258
Telšiai d. mun.;2012;66;471;194;277
Telšiai d. mun.;2012;67;400;159;241
Telšiai d. mun.;2012;68;482;180;302
Telšiai d. mun.;2012;69;482;186;296
Telšiai d. mun.;2012;70;469;193;276
Telšiai d. mun.;2012;71;471;164;307
Telšiai d. mun.;2012;72;452;169;283
Telšiai d. mun.;2012;73;444;156;288
Telšiai d. mun.;2012;74;422;147;275
Telšiai d. mun.;2012;75;474;162;312
Telšiai d. mun.;2012;76;429;137;292
Telšiai d. mun.;2012;77;354;116;238
Telšiai d. mun.;2012;78;389;116;273
Telšiai d. mun.;2012;79;338;114;224
Telšiai d. mun.;2012;80;321;100;221
Telšiai d. mun.;2012;81;313;104;209
Telšiai d. mun.;2012;82;247;69;178
Telšiai d. mun.;2012;83;261;67;194
Telšiai d. mun.;2012;84;227;58;169
Telšiai d. mun.;2012;85;900;202;698
Telšiai d. mun.;2013;-1;45474;21031;24443
Telšiai d. mun.;2013;0;458;216;242
Telšiai d. mun.;2013;1;461;230;231
Telšiai d. mun.;2013;2;390;219;171
Telšiai d. mun.;2013;3;432;197;235
Telšiai d. mun.;2013;4;439;223;216
Telšiai d. mun.;2013;5;361;206;155
Telšiai d. mun.;2013;6;444;215;229
Telšiai d. mun.;2013;7;424;214;210
Telšiai d. mun.;2013;8;435;197;238
Telšiai d. mun.;2013;9;454;238;216
Telšiai d. mun.;2013;10;462;232;230
Telšiai d. mun.;2013;11;480;255;225
Telšiai d. mun.;2013;12;535;270;265
Telšiai d. mun.;2013;13;561;300;261
Telšiai d. mun.;2013;14;569;290;279
Telšiai d. mun.;2013;15;582;307;275
Telšiai d. mun.;2013;16;611;318;293
Telšiai d. mun.;2013;17;679;358;321
Telšiai d. mun.;2013;18;745;367;378
Telšiai d. mun.;2013;19;768;392;376
Telšiai d. mun.;2013;20;850;437;413
Telšiai d. mun.;2013;21;735;356;379
Telšiai d. mun.;2013;22;645;359;286
Telšiai d. mun.;2013;23;583;317;266
Telšiai d. mun.;2013;24;596;302;294
Telšiai d. mun.;2013;25;576;332;244
Telšiai d. mun.;2013;26;544;299;245
Telšiai d. mun.;2013;27;450;262;188
Telšiai d. mun.;2013;28;412;211;201
Telšiai d. mun.;2013;29;410;220;190
Telšiai d. mun.;2013;30;445;233;212
Telšiai d. mun.;2013;31;395;186;209
Telšiai d. mun.;2013;32;453;209;244
Telšiai d. mun.;2013;33;462;224;238
Telšiai d. mun.;2013;34;464;233;231
Telšiai d. mun.;2013;35;486;230;256
Telšiai d. mun.;2013;36;547;248;299
Telšiai d. mun.;2013;37;514;254;260
Telšiai d. mun.;2013;38;547;277;270
Telšiai d. mun.;2013;39;534;252;282
Telšiai d. mun.;2013;40;644;295;349
Telšiai d. mun.;2013;41;680;334;346
Telšiai d. mun.;2013;42;649;305;344
Telšiai d. mun.;2013;43;601;317;284
Telšiai d. mun.;2013;44;638;313;325
Telšiai d. mun.;2013;45;625;288;337
Telšiai d. mun.;2013;46;671;332;339
Telšiai d. mun.;2013;47;652;325;327
Telšiai d. mun.;2013;48;703;340;363
Telšiai d. mun.;2013;49;647;298;349
Telšiai d. mun.;2013;50;699;334;365
Telšiai d. mun.;2013;51;734;330;404
Telšiai d. mun.;2013;52;769;382;387
Telšiai d. mun.;2013;53;760;371;389
Telšiai d. mun.;2013;54;721;342;379
Telšiai d. mun.;2013;55;668;322;346
Telšiai d. mun.;2013;56;614;284;330
Telšiai d. mun.;2013;57;641;295;346
Telšiai d. mun.;2013;58;514;227;287
Telšiai d. mun.;2013;59;522;208;314
Telšiai d. mun.;2013;60;546;223;323
Telšiai d. mun.;2013;61;499;232;267
Telšiai d. mun.;2013;62;561;242;319
Telšiai d. mun.;2013;63;552;225;327
Telšiai d. mun.;2013;64;490;208;282
Telšiai d. mun.;2013;65;426;180;246
Telšiai d. mun.;2013;66;429;177;252
Telšiai d. mun.;2013;67;463;189;274
Telšiai d. mun.;2013;68;386;152;234
Telšiai d. mun.;2013;69;469;170;299
Telšiai d. mun.;2013;70;468;177;291
Telšiai d. mun.;2013;71;459;189;270
Telšiai d. mun.;2013;72;459;156;303
Telšiai d. mun.;2013;73;447;168;279
Telšiai d. mun.;2013;74;429;148;281
Telšiai d. mun.;2013;75;407;139;268
Telšiai d. mun.;2013;76;451;150;301
Telšiai d. mun.;2013;77;411;131;280
Telšiai d. mun.;2013;78;338;106;232
Telšiai d. mun.;2013;79;369;107;262
Telšiai d. mun.;2013;80;319;104;215
Telšiai d. mun.;2013;81;290;85;205
Telšiai d. mun.;2013;82;296;96;200
Telšiai d. mun.;2013;83;223;60;163
Telšiai d. mun.;2013;84;239;59;180
Telšiai d. mun.;2013;85;958;231;727
Telšiai d. mun.;2014;-1;44610;20677;23933
Telšiai d. mun.;2014;0;467;238;229
Telšiai d. mun.;2014;1;458;217;241
Telšiai d. mun.;2014;2;455;224;231
Telšiai d. mun.;2014;3;382;214;168
Telšiai d. mun.;2014;4;428;195;233
Telšiai d. mun.;2014;5;423;216;207
Telšiai d. mun.;2014;6;355;204;151
Telšiai d. mun.;2014;7;440;214;226
Telšiai d. mun.;2014;8;415;212;203
Telšiai d. mun.;2014;9;432;197;235
Telšiai d. mun.;2014;10;450;236;214
Telšiai d. mun.;2014;11;450;226;224
Telšiai d. mun.;2014;12;473;252;221
Telšiai d. mun.;2014;13;523;264;259
Telšiai d. mun.;2014;14;559;299;260
Telšiai d. mun.;2014;15;565;288;277
Telšiai d. mun.;2014;16;575;303;272
Telšiai d. mun.;2014;17;604;313;291
Telšiai d. mun.;2014;18;673;356;317
Telšiai d. mun.;2014;19;718;354;364
Telšiai d. mun.;2014;20;738;376;362
Telšiai d. mun.;2014;21;826;426;400
Telšiai d. mun.;2014;22;703;342;361
Telšiai d. mun.;2014;23;605;348;257
Telšiai d. mun.;2014;24;549;307;242
Telšiai d. mun.;2014;25;565;290;275
Telšiai d. mun.;2014;26;542;304;238
Telšiai d. mun.;2014;27;513;284;229
Telšiai d. mun.;2014;28;433;251;182
Telšiai d. mun.;2014;29;392;199;193
Telšiai d. mun.;2014;30;392;215;177
Telšiai d. mun.;2014;31;438;229;209
Telšiai d. mun.;2014;32;378;175;203
Telšiai d. mun.;2014;33;439;203;236
Telšiai d. mun.;2014;34;442;217;225
Telšiai d. mun.;2014;35;446;223;223
Telšiai d. mun.;2014;36;479;227;252
Telšiai d. mun.;2014;37;537;241;296
Telšiai d. mun.;2014;38;506;252;254
Telšiai d. mun.;2014;39;547;275;272
Telšiai d. mun.;2014;40;520;248;272
Telšiai d. mun.;2014;41;637;295;342
Telšiai d. mun.;2014;42;673;332;341
Telšiai d. mun.;2014;43;639;300;339
Telšiai d. mun.;2014;44;590;313;277
Telšiai d. mun.;2014;45;629;311;318
Telšiai d. mun.;2014;46;621;284;337
Telšiai d. mun.;2014;47;664;330;334
Telšiai d. mun.;2014;48;641;316;325
Telšiai d. mun.;2014;49;686;336;350
Telšiai d. mun.;2014;50;641;296;345
Telšiai d. mun.;2014;51;701;334;367
Telšiai d. mun.;2014;52;728;331;397
Telšiai d. mun.;2014;53;754;373;381
Telšiai d. mun.;2014;54;754;366;388
Telšiai d. mun.;2014;55;717;340;377
Telšiai d. mun.;2014;56;658;313;345
Telšiai d. mun.;2014;57;607;280;327
Telšiai d. mun.;2014;58;634;290;344
Telšiai d. mun.;2014;59;503;219;284
Telšiai d. mun.;2014;60;509;201;308
Telšiai d. mun.;2014;61;536;220;316
Telšiai d. mun.;2014;62;494;231;263
Telšiai d. mun.;2014;63;550;236;314
Telšiai d. mun.;2014;64;539;216;323
Telšiai d. mun.;2014;65;482;202;280
Telšiai d. mun.;2014;66;414;171;243
Telšiai d. mun.;2014;67;427;175;252
Telšiai d. mun.;2014;68;447;175;272
Telšiai d. mun.;2014;69;379;147;232
Telšiai d. mun.;2014;70;459;165;294
Telšiai d. mun.;2014;71;449;171;278
Telšiai d. mun.;2014;72;453;187;266
Telšiai d. mun.;2014;73;431;147;284
Telšiai d. mun.;2014;74;433;154;279
Telšiai d. mun.;2014;75;405;134;271
Telšiai d. mun.;2014;76;393;132;261
Telšiai d. mun.;2014;77;428;137;291
Telšiai d. mun.;2014;78;389;129;260
Telšiai d. mun.;2014;79;320;97;223
Telšiai d. mun.;2014;80;348;97;251
Telšiai d. mun.;2014;81;296;97;199
Telšiai d. mun.;2014;82;264;75;189
Telšiai d. mun.;2014;83;267;86;181
Telšiai d. mun.;2014;84;194;55;139
Telšiai d. mun.;2014;85;992;227;765
Telšiai d. mun.;2015;-1;43922;20362;23560
Telšiai d. mun.;2015;0;457;236;221
Telšiai d. mun.;2015;1;471;238;233
Telšiai d. mun.;2015;2;442;203;239
Telšiai d. mun.;2015;3;449;219;230
Telšiai d. mun.;2015;4;379;211;168
Telšiai d. mun.;2015;5;430;194;236
Telšiai d. mun.;2015;6;410;213;197
Telšiai d. mun.;2015;7;351;203;148
Telšiai d. mun.;2015;8;428;208;220
Telšiai d. mun.;2015;9;403;207;196
Telšiai d. mun.;2015;10;429;196;233
Telšiai d. mun.;2015;11;443;234;209
Telšiai d. mun.;2015;12;440;220;220
Telšiai d. mun.;2015;13;464;245;219
Telšiai d. mun.;2015;14;515;258;257
Telšiai d. mun.;2015;15;556;299;257
Telšiai d. mun.;2015;16;561;286;275
Telšiai d. mun.;2015;17;574;303;271
Telšiai d. mun.;2015;18;597;305;292
Telšiai d. mun.;2015;19;651;343;308
Telšiai d. mun.;2015;20;708;353;355
Telšiai d. mun.;2015;21;735;368;367
Telšiai d. mun.;2015;22;818;428;390
Telšiai d. mun.;2015;23;663;328;335
Telšiai d. mun.;2015;24;581;340;241
Telšiai d. mun.;2015;25;528;296;232
Telšiai d. mun.;2015;26;527;284;243
Telšiai d. mun.;2015;27;530;302;228
Telšiai d. mun.;2015;28;483;270;213
Telšiai d. mun.;2015;29;414;242;172
Telšiai d. mun.;2015;30;374;190;184
Telšiai d. mun.;2015;31;364;198;166
Telšiai d. mun.;2015;32;415;216;199
Telšiai d. mun.;2015;33;369;169;200
Telšiai d. mun.;2015;34;433;195;238
Telšiai d. mun.;2015;35;426;207;219
Telšiai d. mun.;2015;36;432;211;221
Telšiai d. mun.;2015;37;472;224;248
Telšiai d. mun.;2015;38;527;235;292
Telšiai d. mun.;2015;39;500;253;247
Telšiai d. mun.;2015;40;540;275;265
Telšiai d. mun.;2015;41;509;241;268
Telšiai d. mun.;2015;42;630;290;340
Telšiai d. mun.;2015;43;657;324;333
Telšiai d. mun.;2015;44;627;298;329
Telšiai d. mun.;2015;45;583;307;276
Telšiai d. mun.;2015;46;617;304;313
Telšiai d. mun.;2015;47;607;275;332
Telšiai d. mun.;2015;48;661;325;336
Telšiai d. mun.;2015;49;641;316;325
Telšiai d. mun.;2015;50;682;337;345
Telšiai d. mun.;2015;51;636;289;347
Telšiai d. mun.;2015;52;693;329;364
Telšiai d. mun.;2015;53;726;328;398
Telšiai d. mun.;2015;54;740;363;377
Telšiai d. mun.;2015;55;743;360;383
Telšiai d. mun.;2015;56;720;340;380
Telšiai d. mun.;2015;57;641;303;338
Telšiai d. mun.;2015;58;602;278;324
Telšiai d. mun.;2015;59;624;284;340
Telšiai d. mun.;2015;60;497;213;284
Telšiai d. mun.;2015;61;503;198;305
Telšiai d. mun.;2015;62;521;210;311
Telšiai d. mun.;2015;63;488;227;261
Telšiai d. mun.;2015;64;544;229;315
Telšiai d. mun.;2015;65;533;213;320
Telšiai d. mun.;2015;66;477;197;280
Telšiai d. mun.;2015;67;406;167;239
Telšiai d. mun.;2015;68;419;170;249
Telšiai d. mun.;2015;69;435;167;268
Telšiai d. mun.;2015;70;366;138;228
Telšiai d. mun.;2015;71;447;161;286
Telšiai d. mun.;2015;72;442;164;278
Telšiai d. mun.;2015;73;433;175;258
Telšiai d. mun.;2015;74;416;137;279
Telšiai d. mun.;2015;75;422;150;272
Telšiai d. mun.;2015;76;387;126;261
Telšiai d. mun.;2015;77;381;127;254
Telšiai d. mun.;2015;78;406;126;280
Telšiai d. mun.;2015;79;370;124;246
Telšiai d. mun.;2015;80;299;88;211
Telšiai d. mun.;2015;81;328;90;238
Telšiai d. mun.;2015;82;274;86;188
Telšiai d. mun.;2015;83;236;67;169
Telšiai d. mun.;2015;84;245;76;169
Telšiai d. mun.;2015;85;1019;240;779
Telšiai d. mun.;2016;-1;43059;19978;23081
Telšiai d. mun.;2016;0;445;234;211
Telšiai d. mun.;2016;1;445;229;216
Telšiai d. mun.;2016;2;455;228;227
Telšiai d. mun.;2016;3;440;199;241
Telšiai d. mun.;2016;4;439;215;224
Telšiai d. mun.;2016;5;364;203;161
Telšiai d. mun.;2016;6;434;194;240
Telšiai d. mun.;2016;7;401;208;193
Telšiai d. mun.;2016;8;351;205;146
Telšiai d. mun.;2016;9;422;207;215
Telšiai d. mun.;2016;10;394;206;188
Telšiai d. mun.;2016;11;416;190;226
Telšiai d. mun.;2016;12;434;230;204
Telšiai d. mun.;2016;13;435;218;217
Telšiai d. mun.;2016;14;463;246;217
Telšiai d. mun.;2016;15;509;254;255
Telšiai d. mun.;2016;16;550;295;255
Telšiai d. mun.;2016;17;552;282;270
Telšiai d. mun.;2016;18;564;298;266
Telšiai d. mun.;2016;19;580;298;282
Telšiai d. mun.;2016;20;638;332;306
Telšiai d. mun.;2016;21;685;342;343
Telšiai d. mun.;2016;22;699;353;346
Telšiai d. mun.;2016;23;779;400;379
Telšiai d. mun.;2016;24;610;301;309
Telšiai d. mun.;2016;25;543;319;224
Telšiai d. mun.;2016;26;488;274;214
Telšiai d. mun.;2016;27;494;275;219
Telšiai d. mun.;2016;28;501;287;214
Telšiai d. mun.;2016;29;472;264;208
Telšiai d. mun.;2016;30;405;242;163
Telšiai d. mun.;2016;31;353;184;169
Telšiai d. mun.;2016;32;346;191;155
Telšiai d. mun.;2016;33;389;206;183
Telšiai d. mun.;2016;34;357;164;193
Telšiai d. mun.;2016;35;403;172;231
Telšiai d. mun.;2016;36;425;205;220
Telšiai d. mun.;2016;37;421;203;218
Telšiai d. mun.;2016;38;467;225;242
Telšiai d. mun.;2016;39;518;230;288
Telšiai d. mun.;2016;40;488;245;243
Telšiai d. mun.;2016;41;528;274;254
Telšiai d. mun.;2016;42;509;244;265
Telšiai d. mun.;2016;43;622;282;340
Telšiai d. mun.;2016;44;651;319;332
Telšiai d. mun.;2016;45;612;290;322
Telšiai d. mun.;2016;46;579;303;276
Telšiai d. mun.;2016;47;607;298;309
Telšiai d. mun.;2016;48;603;274;329
Telšiai d. mun.;2016;49;656;325;331
Telšiai d. mun.;2016;50;638;314;324
Telšiai d. mun.;2016;51;669;329;340
Telšiai d. mun.;2016;52;629;284;345
Telšiai d. mun.;2016;53;688;329;359
Telšiai d. mun.;2016;54;717;324;393
Telšiai d. mun.;2016;55;729;355;374
Telšiai d. mun.;2016;56;725;347;378
Telšiai d. mun.;2016;57;709;336;373
Telšiai d. mun.;2016;58;640;300;340
Telšiai d. mun.;2016;59;594;271;323
Telšiai d. mun.;2016;60;621;279;342
Telšiai d. mun.;2016;61;491;212;279
Telšiai d. mun.;2016;62;502;198;304
Telšiai d. mun.;2016;63;512;203;309
Telšiai d. mun.;2016;64;480;220;260
Telšiai d. mun.;2016;65;530;223;307
Telšiai d. mun.;2016;66;520;206;314
Telšiai d. mun.;2016;67;464;186;278
Telšiai d. mun.;2016;68;396;161;235
Telšiai d. mun.;2016;69;410;164;246
Telšiai d. mun.;2016;70;421;160;261
Telšiai d. mun.;2016;71;354;132;222
Telšiai d. mun.;2016;72;437;158;279
Telšiai d. mun.;2016;73;425;152;273
Telšiai d. mun.;2016;74;416;162;254
Telšiai d. mun.;2016;75;400;131;269
Telšiai d. mun.;2016;76;404;142;262
Telšiai d. mun.;2016;77;369;119;250
Telšiai d. mun.;2016;78;362;115;247
Telšiai d. mun.;2016;79;394;122;272
Telšiai d. mun.;2016;80;351;117;234
Telšiai d. mun.;2016;81;283;82;201
Telšiai d. mun.;2016;82;312;81;231
Telšiai d. mun.;2016;83;255;77;178
Telšiai d. mun.;2016;84;210;59;151
Telšiai d. mun.;2016;85;1061;266;795
Telšiai d. mun.;2017;-1;41925;19451;22474
Telšiai d. mun.;2017;0;408;189;219
Telšiai d. mun.;2017;1;430;223;207
Telšiai d. mun.;2017;2;444;230;214
Telšiai d. mun.;2017;3;447;222;225
Telšiai d. mun.;2017;4;433;195;238
Telšiai d. mun.;2017;5;433;212;221
Telšiai d. mun.;2017;6;358;196;162
Telšiai d. mun.;2017;7;435;196;239
Telšiai d. mun.;2017;8;389;201;188
Telšiai d. mun.;2017;9;349;207;142
Telšiai d. mun.;2017;10;418;204;214
Telšiai d. mun.;2017;11;384;206;178
Telšiai d. mun.;2017;12;410;191;219
Telšiai d. mun.;2017;13;425;226;199
Telšiai d. mun.;2017;14;432;215;217
Telšiai d. mun.;2017;15;461;244;217
Telšiai d. mun.;2017;16;502;249;253
Telšiai d. mun.;2017;17;546;294;252
Telšiai d. mun.;2017;18;539;278;261
Telšiai d. mun.;2017;19;547;293;254
Telšiai d. mun.;2017;20;568;292;276
Telšiai d. mun.;2017;21;612;318;294
Telšiai d. mun.;2017;22;668;331;337
Telšiai d. mun.;2017;23;667;343;324
Telšiai d. mun.;2017;24;731;371;360
Telšiai d. mun.;2017;25;569;283;286
Telšiai d. mun.;2017;26;496;297;199
Telšiai d. mun.;2017;27;452;262;190
Telšiai d. mun.;2017;28;435;254;181
Telšiai d. mun.;2017;29;462;266;196
Telšiai d. mun.;2017;30;443;250;193
Telšiai d. mun.;2017;31;372;224;148
Telšiai d. mun.;2017;32;318;164;154
Telšiai d. mun.;2017;33;326;177;149
Telšiai d. mun.;2017;34;364;198;166
Telšiai d. mun.;2017;35;335;152;183
Telšiai d. mun.;2017;36;381;169;212
Telšiai d. mun.;2017;37;402;194;208
Telšiai d. mun.;2017;38;416;198;218
Telšiai d. mun.;2017;39;458;217;241
Telšiai d. mun.;2017;40;505;223;282
Telšiai d. mun.;2017;41;479;243;236
Telšiai d. mun.;2017;42;516;264;252
Telšiai d. mun.;2017;43;502;238;264
Telšiai d. mun.;2017;44;614;276;338
Telšiai d. mun.;2017;45;642;314;328
Telšiai d. mun.;2017;46;600;282;318
Telšiai d. mun.;2017;47;569;296;273
Telšiai d. mun.;2017;48;600;293;307
Telšiai d. mun.;2017;49;593;271;322
Telšiai d. mun.;2017;50;649;319;330
Telšiai d. mun.;2017;51;619;300;319
Telšiai d. mun.;2017;52;655;318;337
Telšiai d. mun.;2017;53;617;281;336
Telšiai d. mun.;2017;54;678;323;355
Telšiai d. mun.;2017;55;698;310;388
Telšiai d. mun.;2017;56;714;346;368
Telšiai d. mun.;2017;57;712;338;374
Telšiai d. mun.;2017;58;701;330;371
Telšiai d. mun.;2017;59;627;292;335
Telšiai d. mun.;2017;60;586;266;320
Telšiai d. mun.;2017;61;608;276;332
Telšiai d. mun.;2017;62;483;209;274
Telšiai d. mun.;2017;63;492;191;301
Telšiai d. mun.;2017;64;501;195;306
Telšiai d. mun.;2017;65;470;214;256
Telšiai d. mun.;2017;66;519;215;304
Telšiai d. mun.;2017;67;501;196;305
Telšiai d. mun.;2017;68;452;179;273
Telšiai d. mun.;2017;69;384;156;228
Telšiai d. mun.;2017;70;399;158;241
Telšiai d. mun.;2017;71;409;151;258
Telšiai d. mun.;2017;72;346;128;218
Telšiai d. mun.;2017;73;419;151;268
Telšiai d. mun.;2017;74;413;146;267
Telšiai d. mun.;2017;75;402;154;248
Telšiai d. mun.;2017;76;384;122;262
Telšiai d. mun.;2017;77;383;130;253
Telšiai d. mun.;2017;78;350;111;239
Telšiai d. mun.;2017;79;348;107;241
Telšiai d. mun.;2017;80;362;110;252
Telšiai d. mun.;2017;81;326;105;221
Telšiai d. mun.;2017;82;268;78;190
Telšiai d. mun.;2017;83;279;68;211
Telšiai d. mun.;2017;84;230;69;161
Telšiai d. mun.;2017;85;1056;278;778
Telšiai d. mun.;2018;-1;40682;18873;21809
Telšiai d. mun.;2018;0;384;203;181
Telšiai d. mun.;2018;1;404;186;218
Telšiai d. mun.;2018;2;428;226;202
Telšiai d. mun.;2018;3;430;221;209
Telšiai d. mun.;2018;4;436;218;218
Telšiai d. mun.;2018;5;416;191;225
Telšiai d. mun.;2018;6;424;206;218
Telšiai d. mun.;2018;7;352;193;159
Telšiai d. mun.;2018;8;427;189;238
Telšiai d. mun.;2018;9;384;198;186
Telšiai d. mun.;2018;10;342;205;137
Telšiai d. mun.;2018;11;412;203;209
Telšiai d. mun.;2018;12;381;210;171
Telšiai d. mun.;2018;13;408;189;219
Telšiai d. mun.;2018;14;422;223;199
Telšiai d. mun.;2018;15;426;212;214
Telšiai d. mun.;2018;16;459;243;216
Telšiai d. mun.;2018;17;489;243;246
Telšiai d. mun.;2018;18;539;290;249
Telšiai d. mun.;2018;19;501;271;230
Telšiai d. mun.;2018;20;516;273;243
Telšiai d. mun.;2018;21;533;274;259
Telšiai d. mun.;2018;22;582;300;282
Telšiai d. mun.;2018;23;614;307;307
Telšiai d. mun.;2018;24;609;316;293
Telšiai d. mun.;2018;25;667;346;321
Telšiai d. mun.;2018;26;504;263;241
Telšiai d. mun.;2018;27;460;276;184
Telšiai d. mun.;2018;28;408;236;172
Telšiai d. mun.;2018;29;388;226;162
Telšiai d. mun.;2018;30;429;255;174
Telšiai d. mun.;2018;31;406;223;183
Telšiai d. mun.;2018;32;350;213;137
Telšiai d. mun.;2018;33;305;154;151
Telšiai d. mun.;2018;34;306;163;143
Telšiai d. mun.;2018;35;336;182;154
Telšiai d. mun.;2018;36;314;139;175
Telšiai d. mun.;2018;37;374;165;209
Telšiai d. mun.;2018;38;387;191;196
Telšiai d. mun.;2018;39;402;189;213
Telšiai d. mun.;2018;40;443;208;235
Telšiai d. mun.;2018;41;500;218;282
Telšiai d. mun.;2018;42;462;233;229
Telšiai d. mun.;2018;43;509;263;246
Telšiai d. mun.;2018;44;492;231;261
Telšiai d. mun.;2018;45;595;264;331
Telšiai d. mun.;2018;46;632;311;321
Telšiai d. mun.;2018;47;589;277;312
Telšiai d. mun.;2018;48;558;292;266
Telšiai d. mun.;2018;49;587;283;304
Telšiai d. mun.;2018;50;586;266;320
Telšiai d. mun.;2018;51;639;313;326
Telšiai d. mun.;2018;52;620;301;319
Telšiai d. mun.;2018;53;643;309;334
Telšiai d. mun.;2018;54;612;279;333
Telšiai d. mun.;2018;55;673;320;353
Telšiai d. mun.;2018;56;689;305;384
Telšiai d. mun.;2018;57;705;339;366
Telšiai d. mun.;2018;58;701;335;366
Telšiai d. mun.;2018;59;697;328;369
Telšiai d. mun.;2018;60;617;283;334
Telšiai d. mun.;2018;61;572;258;314
Telšiai d. mun.;2018;62;596;266;330
Telšiai d. mun.;2018;63;468;201;267
Telšiai d. mun.;2018;64;489;188;301
Telšiai d. mun.;2018;65;495;193;302
Telšiai d. mun.;2018;66;461;206;255
Telšiai d. mun.;2018;67;513;210;303
Telšiai d. mun.;2018;68;489;187;302
Telšiai d. mun.;2018;69;440;172;268
Telšiai d. mun.;2018;70;368;142;226
Telšiai d. mun.;2018;71;390;155;235
Telšiai d. mun.;2018;72;399;146;253
Telšiai d. mun.;2018;73;330;120;210
Telšiai d. mun.;2018;74;404;142;262
Telšiai d. mun.;2018;75;392;130;262
Telšiai d. mun.;2018;76;385;148;237
Telšiai d. mun.;2018;77;365;110;255
Telšiai d. mun.;2018;78;369;120;249
Telšiai d. mun.;2018;79;333;105;228
Telšiai d. mun.;2018;80;328;99;229
Telšiai d. mun.;2018;81;331;92;239
Telšiai d. mun.;2018;82;295;95;200
Telšiai d. mun.;2018;83;237;65;172
Telšiai d. mun.;2018;84;246;57;189
Telšiai d. mun.;2018;85;1084;297;787
Trakai d. mun.;2001;-1;37388;17526;19862
Trakai d. mun.;2001;0;398;203;195
Trakai d. mun.;2001;1;385;189;196
Trakai d. mun.;2001;2;397;206;191
Trakai d. mun.;2001;3;374;172;202
Trakai d. mun.;2001;4;419;213;206
Trakai d. mun.;2001;5;425;207;218
Trakai d. mun.;2001;6;429;225;204
Trakai d. mun.;2001;7;537;259;278
Trakai d. mun.;2001;8;542;283;259
Trakai d. mun.;2001;9;567;310;257
Trakai d. mun.;2001;10;594;322;272
Trakai d. mun.;2001;11;585;298;287
Trakai d. mun.;2001;12;560;297;263
Trakai d. mun.;2001;13;674;355;319
Trakai d. mun.;2001;14;618;295;323
Trakai d. mun.;2001;15;586;286;300
Trakai d. mun.;2001;16;564;309;255
Trakai d. mun.;2001;17;572;322;250
Trakai d. mun.;2001;18;512;269;243
Trakai d. mun.;2001;19;463;244;219
Trakai d. mun.;2001;20;466;239;227
Trakai d. mun.;2001;21;434;215;219
Trakai d. mun.;2001;22;428;201;227
Trakai d. mun.;2001;23;435;215;220
Trakai d. mun.;2001;24;495;258;237
Trakai d. mun.;2001;25;449;232;217
Trakai d. mun.;2001;26;467;236;231
Trakai d. mun.;2001;27;462;242;220
Trakai d. mun.;2001;28;519;264;255
Trakai d. mun.;2001;29;506;241;265
Trakai d. mun.;2001;30;516;262;254
Trakai d. mun.;2001;31;515;259;256
Trakai d. mun.;2001;32;558;268;290
Trakai d. mun.;2001;33;536;270;266
Trakai d. mun.;2001;34;500;261;239
Trakai d. mun.;2001;35;558;290;268
Trakai d. mun.;2001;36;582;292;290
Trakai d. mun.;2001;37;605;315;290
Trakai d. mun.;2001;38;578;293;285
Trakai d. mun.;2001;39;594;297;297
Trakai d. mun.;2001;40;594;316;278
Trakai d. mun.;2001;41;592;283;309
Trakai d. mun.;2001;42;560;267;293
Trakai d. mun.;2001;43;520;254;266
Trakai d. mun.;2001;44;484;242;242
Trakai d. mun.;2001;45;471;232;239
Trakai d. mun.;2001;46;489;231;258
Trakai d. mun.;2001;47;448;212;236
Trakai d. mun.;2001;48;454;229;225
Trakai d. mun.;2001;49;437;213;224
Trakai d. mun.;2001;50;449;222;227
Trakai d. mun.;2001;51;465;226;239
Trakai d. mun.;2001;52;423;205;218
Trakai d. mun.;2001;53;418;185;233
Trakai d. mun.;2001;54;372;156;216
Trakai d. mun.;2001;55;400;177;223
Trakai d. mun.;2001;56;314;148;166
Trakai d. mun.;2001;57;353;154;199
Trakai d. mun.;2001;58;431;199;232
Trakai d. mun.;2001;59;427;171;256
Trakai d. mun.;2001;60;384;144;240
Trakai d. mun.;2001;61;387;168;219
Trakai d. mun.;2001;62;457;176;281
Trakai d. mun.;2001;63;445;179;266
Trakai d. mun.;2001;64;486;202;284
Trakai d. mun.;2001;65;442;184;258
Trakai d. mun.;2001;66;396;170;226
Trakai d. mun.;2001;67;374;161;213
Trakai d. mun.;2001;68;420;158;262
Trakai d. mun.;2001;69;406;156;250
Trakai d. mun.;2001;70;390;146;244
Trakai d. mun.;2001;71;355;123;232
Trakai d. mun.;2001;72;371;121;250
Trakai d. mun.;2001;73;325;102;223
Trakai d. mun.;2001;74;283;90;193
Trakai d. mun.;2001;75;283;69;214
Trakai d. mun.;2001;76;217;48;169
Trakai d. mun.;2001;77;222;73;149
Trakai d. mun.;2001;78;231;52;179
Trakai d. mun.;2001;79;159;43;116
Trakai d. mun.;2001;80;151;41;110
Trakai d. mun.;2001;81;111;35;76
Trakai d. mun.;2001;82;71;20;51
Trakai d. mun.;2001;83;52;14;38
Trakai d. mun.;2001;84;67;21;46
Trakai d. mun.;2001;85;398;94;304
Trakai d. mun.;2002;-1;37118;17389;19729
Trakai d. mun.;2002;0;338;159;179
Trakai d. mun.;2002;1;393;202;191
Trakai d. mun.;2002;2;387;192;195
Trakai d. mun.;2002;3;400;209;191
Trakai d. mun.;2002;4;372;171;201
Trakai d. mun.;2002;5;421;218;203
Trakai d. mun.;2002;6;427;209;218
Trakai d. mun.;2002;7;425;220;205
Trakai d. mun.;2002;8;542;266;276
Trakai d. mun.;2002;9;540;282;258
Trakai d. mun.;2002;10;568;312;256
Trakai d. mun.;2002;11;589;322;267
Trakai d. mun.;2002;12;580;296;284
Trakai d. mun.;2002;13;552;294;258
Trakai d. mun.;2002;14;667;352;315
Trakai d. mun.;2002;15;614;290;324
Trakai d. mun.;2002;16;584;285;299
Trakai d. mun.;2002;17;554;304;250
Trakai d. mun.;2002;18;562;314;248
Trakai d. mun.;2002;19;502;263;239
Trakai d. mun.;2002;20;452;239;213
Trakai d. mun.;2002;21;454;235;219
Trakai d. mun.;2002;22;434;212;222
Trakai d. mun.;2002;23;425;198;227
Trakai d. mun.;2002;24;434;214;220
Trakai d. mun.;2002;25;484;256;228
Trakai d. mun.;2002;26;448;229;219
Trakai d. mun.;2002;27;459;232;227
Trakai d. mun.;2002;28;458;237;221
Trakai d. mun.;2002;29;517;263;254
Trakai d. mun.;2002;30;502;239;263
Trakai d. mun.;2002;31;503;256;247
Trakai d. mun.;2002;32;510;255;255
Trakai d. mun.;2002;33;553;264;289
Trakai d. mun.;2002;34;532;268;264
Trakai d. mun.;2002;35;487;254;233
Trakai d. mun.;2002;36;553;287;266
Trakai d. mun.;2002;37;579;288;291
Trakai d. mun.;2002;38;599;310;289
Trakai d. mun.;2002;39;574;290;284
Trakai d. mun.;2002;40;586;292;294
Trakai d. mun.;2002;41;590;313;277
Trakai d. mun.;2002;42;584;280;304
Trakai d. mun.;2002;43;559;264;295
Trakai d. mun.;2002;44;521;254;267
Trakai d. mun.;2002;45;475;237;238
Trakai d. mun.;2002;46;462;230;232
Trakai d. mun.;2002;47;487;229;258
Trakai d. mun.;2002;48;442;209;233
Trakai d. mun.;2002;49;446;224;222
Trakai d. mun.;2002;50;442;217;225
Trakai d. mun.;2002;51;437;212;225
Trakai d. mun.;2002;52;459;222;237
Trakai d. mun.;2002;53;420;205;215
Trakai d. mun.;2002;54;408;180;228
Trakai d. mun.;2002;55;365;155;210
Trakai d. mun.;2002;56;388;170;218
Trakai d. mun.;2002;57;299;140;159
Trakai d. mun.;2002;58;346;150;196
Trakai d. mun.;2002;59;423;193;230
Trakai d. mun.;2002;60;425;171;254
Trakai d. mun.;2002;61;384;144;240
Trakai d. mun.;2002;62;382;164;218
Trakai d. mun.;2002;63;455;175;280
Trakai d. mun.;2002;64;440;175;265
Trakai d. mun.;2002;65;478;199;279
Trakai d. mun.;2002;66;427;174;253
Trakai d. mun.;2002;67;382;163;219
Trakai d. mun.;2002;68;364;154;210
Trakai d. mun.;2002;69;414;153;261
Trakai d. mun.;2002;70;396;149;247
Trakai d. mun.;2002;71;385;143;242
Trakai d. mun.;2002;72;344;113;231
Trakai d. mun.;2002;73;362;119;243
Trakai d. mun.;2002;74;319;100;219
Trakai d. mun.;2002;75;264;84;180
Trakai d. mun.;2002;76;260;60;200
Trakai d. mun.;2002;77;209;48;161
Trakai d. mun.;2002;78;201;65;136
Trakai d. mun.;2002;79;224;48;176
Trakai d. mun.;2002;80;150;41;109
Trakai d. mun.;2002;81;144;38;106
Trakai d. mun.;2002;82;102;30;72
Trakai d. mun.;2002;83;67;18;49
Trakai d. mun.;2002;84;45;10;35
Trakai d. mun.;2002;85;382;89;293
Trakai d. mun.;2003;-1;36953;17306;19647
Trakai d. mun.;2003;0;322;172;150
Trakai d. mun.;2003;1;343;162;181
Trakai d. mun.;2003;2;399;204;195
Trakai d. mun.;2003;3;385;191;194
Trakai d. mun.;2003;4;402;211;191
Trakai d. mun.;2003;5;374;173;201
Trakai d. mun.;2003;6;423;219;204
Trakai d. mun.;2003;7;430;211;219
Trakai d. mun.;2003;8;427;223;204
Trakai d. mun.;2003;9;547;271;276
Trakai d. mun.;2003;10;543;287;256
Trakai d. mun.;2003;11;572;315;257
Trakai d. mun.;2003;12;585;318;267
Trakai d. mun.;2003;13;573;291;282
Trakai d. mun.;2003;14;552;291;261
Trakai d. mun.;2003;15;662;347;315
Trakai d. mun.;2003;16;610;289;321
Trakai d. mun.;2003;17;574;280;294
Trakai d. mun.;2003;18;544;297;247
Trakai d. mun.;2003;19;561;311;250
Trakai d. mun.;2003;20;486;256;230
Trakai d. mun.;2003;21;447;239;208
Trakai d. mun.;2003;22;453;237;216
Trakai d. mun.;2003;23;432;213;219
Trakai d. mun.;2003;24;423;197;226
Trakai d. mun.;2003;25;436;213;223
Trakai d. mun.;2003;26;488;253;235
Trakai d. mun.;2003;27;447;226;221
Trakai d. mun.;2003;28;458;237;221
Trakai d. mun.;2003;29;455;237;218
Trakai d. mun.;2003;30;514;262;252
Trakai d. mun.;2003;31;499;239;260
Trakai d. mun.;2003;32;496;252;244
Trakai d. mun.;2003;33;508;258;250
Trakai d. mun.;2003;34;556;265;291
Trakai d. mun.;2003;35;524;263;261
Trakai d. mun.;2003;36;488;253;235
Trakai d. mun.;2003;37;548;285;263
Trakai d. mun.;2003;38;578;289;289
Trakai d. mun.;2003;39;598;310;288
Trakai d. mun.;2003;40;564;286;278
Trakai d. mun.;2003;41;581;290;291
Trakai d. mun.;2003;42;592;312;280
Trakai d. mun.;2003;43;575;278;297
Trakai d. mun.;2003;44;556;266;290
Trakai d. mun.;2003;45;515;250;265
Trakai d. mun.;2003;46;473;233;240
Trakai d. mun.;2003;47;461;225;236
Trakai d. mun.;2003;48;486;228;258
Trakai d. mun.;2003;49;442;208;234
Trakai d. mun.;2003;50;445;224;221
Trakai d. mun.;2003;51;438;215;223
Trakai d. mun.;2003;52;433;207;226
Trakai d. mun.;2003;53;458;221;237
Trakai d. mun.;2003;54;413;201;212
Trakai d. mun.;2003;55;399;174;225
Trakai d. mun.;2003;56;362;151;211
Trakai d. mun.;2003;57;381;166;215
Trakai d. mun.;2003;58;295;136;159
Trakai d. mun.;2003;59;337;145;192
Trakai d. mun.;2003;60;408;181;227
Trakai d. mun.;2003;61;419;165;254
Trakai d. mun.;2003;62;371;136;235
Trakai d. mun.;2003;63;375;163;212
Trakai d. mun.;2003;64;446;172;274
Trakai d. mun.;2003;65;441;170;271
Trakai d. mun.;2003;66;472;193;279
Trakai d. mun.;2003;67;423;169;254
Trakai d. mun.;2003;68;373;156;217
Trakai d. mun.;2003;69;354;146;208
Trakai d. mun.;2003;70;405;146;259
Trakai d. mun.;2003;71;383;134;249
Trakai d. mun.;2003;72;374;136;238
Trakai d. mun.;2003;73;333;107;226
Trakai d. mun.;2003;74;342;112;230
Trakai d. mun.;2003;75;299;88;211
Trakai d. mun.;2003;76;245;74;171
Trakai d. mun.;2003;77;250;55;195
Trakai d. mun.;2003;78;195;44;151
Trakai d. mun.;2003;79;184;57;127
Trakai d. mun.;2003;80;207;40;167
Trakai d. mun.;2003;81;146;40;106
Trakai d. mun.;2003;82;131;36;95
Trakai d. mun.;2003;83;95;25;70
Trakai d. mun.;2003;84;61;17;44
Trakai d. mun.;2003;85;353;81;272
Trakai d. mun.;2004;-1;36916;17285;19631
Trakai d. mun.;2004;0;316;156;160
Trakai d. mun.;2004;1;322;173;149
Trakai d. mun.;2004;2;346;165;181
Trakai d. mun.;2004;3;399;205;194
Trakai d. mun.;2004;4;388;193;195
Trakai d. mun.;2004;5;406;211;195
Trakai d. mun.;2004;6;376;174;202
Trakai d. mun.;2004;7;424;220;204
Trakai d. mun.;2004;8;431;210;221
Trakai d. mun.;2004;9;426;223;203
Trakai d. mun.;2004;10;545;272;273
Trakai d. mun.;2004;11;545;288;257
Trakai d. mun.;2004;12;572;316;256
Trakai d. mun.;2004;13;585;317;268
Trakai d. mun.;2004;14;568;288;280
Trakai d. mun.;2004;15;550;291;259
Trakai d. mun.;2004;16;656;347;309
Trakai d. mun.;2004;17;603;287;316
Trakai d. mun.;2004;18;576;280;296
Trakai d. mun.;2004;19;542;297;245
Trakai d. mun.;2004;20;560;312;248
Trakai d. mun.;2004;21;480;251;229
Trakai d. mun.;2004;22;452;238;214
Trakai d. mun.;2004;23;453;234;219
Trakai d. mun.;2004;24;433;211;222
Trakai d. mun.;2004;25;428;198;230
Trakai d. mun.;2004;26;436;212;224
Trakai d. mun.;2004;27;491;257;234
Trakai d. mun.;2004;28;446;227;219
Trakai d. mun.;2004;29;456;239;217
Trakai d. mun.;2004;30;452;233;219
Trakai d. mun.;2004;31;506;259;247
Trakai d. mun.;2004;32;498;235;263
Trakai d. mun.;2004;33;498;256;242
Trakai d. mun.;2004;34;504;257;247
Trakai d. mun.;2004;35;559;267;292
Trakai d. mun.;2004;36;520;258;262
Trakai d. mun.;2004;37;486;246;240
Trakai d. mun.;2004;38;547;285;262
Trakai d. mun.;2004;39;570;286;284
Trakai d. mun.;2004;40;600;311;289
Trakai d. mun.;2004;41;564;285;279
Trakai d. mun.;2004;42;583;294;289
Trakai d. mun.;2004;43;589;310;279
Trakai d. mun.;2004;44;575;275;300
Trakai d. mun.;2004;45;564;271;293
Trakai d. mun.;2004;46;517;249;268
Trakai d. mun.;2004;47;474;232;242
Trakai d. mun.;2004;48;464;230;234
Trakai d. mun.;2004;49;483;226;257
Trakai d. mun.;2004;50;446;211;235
Trakai d. mun.;2004;51;442;221;221
Trakai d. mun.;2004;52;440;214;226
Trakai d. mun.;2004;53;433;204;229
Trakai d. mun.;2004;54;469;226;243
Trakai d. mun.;2004;55;408;198;210
Trakai d. mun.;2004;56;396;171;225
Trakai d. mun.;2004;57;360;151;209
Trakai d. mun.;2004;58;376;164;212
Trakai d. mun.;2004;59;293;135;158
Trakai d. mun.;2004;60;327;142;185
Trakai d. mun.;2004;61;399;177;222
Trakai d. mun.;2004;62;408;162;246
Trakai d. mun.;2004;63;367;132;235
Trakai d. mun.;2004;64;369;159;210
Trakai d. mun.;2004;65;440;165;275
Trakai d. mun.;2004;66;425;161;264
Trakai d. mun.;2004;67;460;184;276
Trakai d. mun.;2004;68;413;158;255
Trakai d. mun.;2004;69;361;145;216
Trakai d. mun.;2004;70;349;145;204
Trakai d. mun.;2004;71;395;143;252
Trakai d. mun.;2004;72;372;123;249
Trakai d. mun.;2004;73;359;125;234
Trakai d. mun.;2004;74;327;104;223
Trakai d. mun.;2004;75;321;101;220
Trakai d. mun.;2004;76;291;84;207
Trakai d. mun.;2004;77;242;72;170
Trakai d. mun.;2004;78;235;50;185
Trakai d. mun.;2004;79;185;42;143
Trakai d. mun.;2004;80;167;51;116
Trakai d. mun.;2004;81;193;39;154
Trakai d. mun.;2004;82;134;32;102
Trakai d. mun.;2004;83;118;31;87
Trakai d. mun.;2004;84;89;23;66
Trakai d. mun.;2004;85;343;83;260
Trakai d. mun.;2005;-1;36712;17149;19563
Trakai d. mun.;2005;0;321;172;149
Trakai d. mun.;2005;1;310;149;161
Trakai d. mun.;2005;2;324;173;151
Trakai d. mun.;2005;3;347;167;180
Trakai d. mun.;2005;4;397;204;193
Trakai d. mun.;2005;5;389;195;194
Trakai d. mun.;2005;6;403;209;194
Trakai d. mun.;2005;7;375;173;202
Trakai d. mun.;2005;8;423;221;202
Trakai d. mun.;2005;9;431;208;223
Trakai d. mun.;2005;10;426;224;202
Trakai d. mun.;2005;11;550;269;281
Trakai d. mun.;2005;12;546;290;256
Trakai d. mun.;2005;13;576;319;257
Trakai d. mun.;2005;14;583;316;267
Trakai d. mun.;2005;15;566;287;279
Trakai d. mun.;2005;16;541;284;257
Trakai d. mun.;2005;17;643;340;303
Trakai d. mun.;2005;18;593;280;313
Trakai d. mun.;2005;19;567;276;291
Trakai d. mun.;2005;20;536;292;244
Trakai d. mun.;2005;21;553;305;248
Trakai d. mun.;2005;22;476;248;228
Trakai d. mun.;2005;23;438;230;208
Trakai d. mun.;2005;24;458;235;223
Trakai d. mun.;2005;25;429;206;223
Trakai d. mun.;2005;26;427;199;228
Trakai d. mun.;2005;27;423;198;225
Trakai d. mun.;2005;28;486;252;234
Trakai d. mun.;2005;29;442;225;217
Trakai d. mun.;2005;30;456;238;218
Trakai d. mun.;2005;31;455;238;217
Trakai d. mun.;2005;32;504;262;242
Trakai d. mun.;2005;33;503;233;270
Trakai d. mun.;2005;34;495;256;239
Trakai d. mun.;2005;35;507;256;251
Trakai d. mun.;2005;36;559;264;295
Trakai d. mun.;2005;37;517;256;261
Trakai d. mun.;2005;38;493;247;246
Trakai d. mun.;2005;39;544;287;257
Trakai d. mun.;2005;40;556;275;281
Trakai d. mun.;2005;41;598;308;290
Trakai d. mun.;2005;42;563;284;279
Trakai d. mun.;2005;43;585;287;298
Trakai d. mun.;2005;44;591;312;279
Trakai d. mun.;2005;45;576;276;300
Trakai d. mun.;2005;46;565;269;296
Trakai d. mun.;2005;47;507;242;265
Trakai d. mun.;2005;48;471;231;240
Trakai d. mun.;2005;49;472;232;240
Trakai d. mun.;2005;50;474;219;255
Trakai d. mun.;2005;51;441;207;234
Trakai d. mun.;2005;52;435;220;215
Trakai d. mun.;2005;53;438;211;227
Trakai d. mun.;2005;54;431;203;228
Trakai d. mun.;2005;55;467;221;246
Trakai d. mun.;2005;56;395;189;206
Trakai d. mun.;2005;57;389;169;220
Trakai d. mun.;2005;58;347;140;207
Trakai d. mun.;2005;59;373;162;211
Trakai d. mun.;2005;60;284;130;154
Trakai d. mun.;2005;61;315;136;179
Trakai d. mun.;2005;62;391;175;216
Trakai d. mun.;2005;63;407;160;247
Trakai d. mun.;2005;64;360;128;232
Trakai d. mun.;2005;65;363;155;208
Trakai d. mun.;2005;66;437;163;274
Trakai d. mun.;2005;67;407;153;254
Trakai d. mun.;2005;68;443;176;267
Trakai d. mun.;2005;69;398;147;251
Trakai d. mun.;2005;70;354;140;214
Trakai d. mun.;2005;71;340;137;203
Trakai d. mun.;2005;72;379;133;246
Trakai d. mun.;2005;73;357;115;242
Trakai d. mun.;2005;74;343;115;228
Trakai d. mun.;2005;75;308;93;215
Trakai d. mun.;2005;76;307;100;207
Trakai d. mun.;2005;77;279;78;201
Trakai d. mun.;2005;78;239;69;170
Trakai d. mun.;2005;79;224;46;178
Trakai d. mun.;2005;80;171;37;134
Trakai d. mun.;2005;81;149;40;109
Trakai d. mun.;2005;82;182;36;146
Trakai d. mun.;2005;83;122;28;94
Trakai d. mun.;2005;84;108;27;81
Trakai d. mun.;2005;85;359;92;267
Trakai d. mun.;2006;-1;36328;16951;19377
Trakai d. mun.;2006;0;322;159;163
Trakai d. mun.;2006;1;325;177;148
Trakai d. mun.;2006;2;310;149;161
Trakai d. mun.;2006;3;321;174;147
Trakai d. mun.;2006;4;342;167;175
Trakai d. mun.;2006;5;395;202;193
Trakai d. mun.;2006;6;393;196;197
Trakai d. mun.;2006;7;401;208;193
Trakai d. mun.;2006;8;377;175;202
Trakai d. mun.;2006;9;424;223;201
Trakai d. mun.;2006;10;433;210;223
Trakai d. mun.;2006;11;431;227;204
Trakai d. mun.;2006;12;554;271;283
Trakai d. mun.;2006;13;543;288;255
Trakai d. mun.;2006;14;581;322;259
Trakai d. mun.;2006;15;573;311;262
Trakai d. mun.;2006;16;554;280;274
Trakai d. mun.;2006;17;530;281;249
Trakai d. mun.;2006;18;628;333;295
Trakai d. mun.;2006;19;572;268;304
Trakai d. mun.;2006;20;540;262;278
Trakai d. mun.;2006;21;518;280;238
Trakai d. mun.;2006;22;531;298;233
Trakai d. mun.;2006;23;461;241;220
Trakai d. mun.;2006;24;423;221;202
Trakai d. mun.;2006;25;451;229;222
Trakai d. mun.;2006;26;418;202;216
Trakai d. mun.;2006;27;423;197;226
Trakai d. mun.;2006;28;418;197;221
Trakai d. mun.;2006;29;481;249;232
Trakai d. mun.;2006;30;436;225;211
Trakai d. mun.;2006;31;460;238;222
Trakai d. mun.;2006;32;451;231;220
Trakai d. mun.;2006;33;492;254;238
Trakai d. mun.;2006;34;493;230;263
Trakai d. mun.;2006;35;493;256;237
Trakai d. mun.;2006;36;493;247;246
Trakai d. mun.;2006;37;553;257;296
Trakai d. mun.;2006;38;513;255;258
Trakai d. mun.;2006;39;484;237;247
Trakai d. mun.;2006;40;528;276;252
Trakai d. mun.;2006;41;552;273;279
Trakai d. mun.;2006;42;593;305;288
Trakai d. mun.;2006;43;545;271;274
Trakai d. mun.;2006;44;586;286;300
Trakai d. mun.;2006;45;591;313;278
Trakai d. mun.;2006;46;573;270;303
Trakai d. mun.;2006;47;570;276;294
Trakai d. mun.;2006;48;502;235;267
Trakai d. mun.;2006;49;459;230;229
Trakai d. mun.;2006;50;464;229;235
Trakai d. mun.;2006;51;472;216;256
Trakai d. mun.;2006;52;428;199;229
Trakai d. mun.;2006;53;431;216;215
Trakai d. mun.;2006;54;426;202;224
Trakai d. mun.;2006;55;430;203;227
Trakai d. mun.;2006;56;456;214;242
Trakai d. mun.;2006;57;395;186;209
Trakai d. mun.;2006;58;385;164;221
Trakai d. mun.;2006;59;342;136;206
Trakai d. mun.;2006;60;368;159;209
Trakai d. mun.;2006;61;278;125;153
Trakai d. mun.;2006;62;304;128;176
Trakai d. mun.;2006;63;381;166;215
Trakai d. mun.;2006;64;405;157;248
Trakai d. mun.;2006;65;349;124;225
Trakai d. mun.;2006;66;351;147;204
Trakai d. mun.;2006;67;432;160;272
Trakai d. mun.;2006;68;396;147;249
Trakai d. mun.;2006;69;433;170;263
Trakai d. mun.;2006;70;388;142;246
Trakai d. mun.;2006;71;343;133;210
Trakai d. mun.;2006;72;330;132;198
Trakai d. mun.;2006;73;372;133;239
Trakai d. mun.;2006;74;340;109;231
Trakai d. mun.;2006;75;329;109;220
Trakai d. mun.;2006;76;306;91;215
Trakai d. mun.;2006;77;290;90;200
Trakai d. mun.;2006;78;258;69;189
Trakai d. mun.;2006;79;229;67;162
Trakai d. mun.;2006;80;212;43;169
Trakai d. mun.;2006;81;165;36;129
Trakai d. mun.;2006;82;134;37;97
Trakai d. mun.;2006;83;160;29;131
Trakai d. mun.;2006;84;117;24;93
Trakai d. mun.;2006;85;389;97;292
Trakai d. mun.;2007;-1;35907;16743;19164
Trakai d. mun.;2007;0;305;172;133
Trakai d. mun.;2007;1;321;157;164
Trakai d. mun.;2007;2;322;177;145
Trakai d. mun.;2007;3;313;148;165
Trakai d. mun.;2007;4;319;174;145
Trakai d. mun.;2007;5;336;163;173
Trakai d. mun.;2007;6;396;201;195
Trakai d. mun.;2007;7;388;193;195
Trakai d. mun.;2007;8;398;207;191
Trakai d. mun.;2007;9;376;174;202
Trakai d. mun.;2007;10;424;223;201
Trakai d. mun.;2007;11;438;212;226
Trakai d. mun.;2007;12;426;224;202
Trakai d. mun.;2007;13;555;275;280
Trakai d. mun.;2007;14;543;289;254
Trakai d. mun.;2007;15;579;321;258
Trakai d. mun.;2007;16;567;306;261
Trakai d. mun.;2007;17;548;278;270
Trakai d. mun.;2007;18;525;278;247
Trakai d. mun.;2007;19;617;325;292
Trakai d. mun.;2007;20;563;265;298
Trakai d. mun.;2007;21;533;259;274
Trakai d. mun.;2007;22;502;271;231
Trakai d. mun.;2007;23;517;289;228
Trakai d. mun.;2007;24;452;235;217
Trakai d. mun.;2007;25;412;217;195
Trakai d. mun.;2007;26;442;222;220
Trakai d. mun.;2007;27;415;198;217
Trakai d. mun.;2007;28;426;197;229
Trakai d. mun.;2007;29;405;189;216
Trakai d. mun.;2007;30;476;249;227
Trakai d. mun.;2007;31;436;224;212
Trakai d. mun.;2007;32;446;229;217
Trakai d. mun.;2007;33;451;232;219
Trakai d. mun.;2007;34;491;251;240
Trakai d. mun.;2007;35;491;229;262
Trakai d. mun.;2007;36;492;255;237
Trakai d. mun.;2007;37;485;241;244
Trakai d. mun.;2007;38;545;253;292
Trakai d. mun.;2007;39;507;252;255
Trakai d. mun.;2007;40;480;234;246
Trakai d. mun.;2007;41;522;270;252
Trakai d. mun.;2007;42;556;275;281
Trakai d. mun.;2007;43;592;304;288
Trakai d. mun.;2007;44;539;270;269
Trakai d. mun.;2007;45;576;281;295
Trakai d. mun.;2007;46;581;305;276
Trakai d. mun.;2007;47;572;265;307
Trakai d. mun.;2007;48;565;274;291
Trakai d. mun.;2007;49;497;229;268
Trakai d. mun.;2007;50;450;224;226
Trakai d. mun.;2007;51;463;229;234
Trakai d. mun.;2007;52;463;208;255
Trakai d. mun.;2007;53;421;193;228
Trakai d. mun.;2007;54;431;212;219
Trakai d. mun.;2007;55;417;200;217
Trakai d. mun.;2007;56;419;195;224
Trakai d. mun.;2007;57;449;208;241
Trakai d. mun.;2007;58;378;176;202
Trakai d. mun.;2007;59;377;162;215
Trakai d. mun.;2007;60;337;130;207
Trakai d. mun.;2007;61;364;158;206
Trakai d. mun.;2007;62;270;119;151
Trakai d. mun.;2007;63;292;119;173
Trakai d. mun.;2007;64;367;158;209
Trakai d. mun.;2007;65;383;142;241
Trakai d. mun.;2007;66;341;118;223
Trakai d. mun.;2007;67;340;143;197
Trakai d. mun.;2007;68;418;150;268
Trakai d. mun.;2007;69;384;141;243
Trakai d. mun.;2007;70;426;163;263
Trakai d. mun.;2007;71;376;135;241
Trakai d. mun.;2007;72;322;116;206
Trakai d. mun.;2007;73;314;125;189
Trakai d. mun.;2007;74;355;123;232
Trakai d. mun.;2007;75;331;105;226
Trakai d. mun.;2007;76;307;100;207
Trakai d. mun.;2007;77;289;83;206
Trakai d. mun.;2007;78;277;82;195
Trakai d. mun.;2007;79;244;65;179
Trakai d. mun.;2007;80;215;62;153
Trakai d. mun.;2007;81;198;42;156
Trakai d. mun.;2007;82;145;26;119
Trakai d. mun.;2007;83;121;32;89
Trakai d. mun.;2007;84;142;24;118
Trakai d. mun.;2007;85;418;114;304
Trakai d. mun.;2008;-1;35550;16583;18967
Trakai d. mun.;2008;0;328;182;146
Trakai d. mun.;2008;1;307;173;134
Trakai d. mun.;2008;2;322;157;165
Trakai d. mun.;2008;3;324;180;144
Trakai d. mun.;2008;4;310;146;164
Trakai d. mun.;2008;5;317;174;143
Trakai d. mun.;2008;6;334;162;172
Trakai d. mun.;2008;7;390;196;194
Trakai d. mun.;2008;8;386;193;193
Trakai d. mun.;2008;9;400;208;192
Trakai d. mun.;2008;10;384;178;206
Trakai d. mun.;2008;11;428;226;202
Trakai d. mun.;2008;12;440;216;224
Trakai d. mun.;2008;13;431;226;205
Trakai d. mun.;2008;14;556;275;281
Trakai d. mun.;2008;15;547;294;253
Trakai d. mun.;2008;16;581;322;259
Trakai d. mun.;2008;17;567;305;262
Trakai d. mun.;2008;18;544;276;268
Trakai d. mun.;2008;19;513;275;238
Trakai d. mun.;2008;20;601;320;281
Trakai d. mun.;2008;21;545;255;290
Trakai d. mun.;2008;22;521;255;266
Trakai d. mun.;2008;23;494;265;229
Trakai d. mun.;2008;24;510;288;222
Trakai d. mun.;2008;25;448;235;213
Trakai d. mun.;2008;26;404;209;195
Trakai d. mun.;2008;27;433;216;217
Trakai d. mun.;2008;28;413;200;213
Trakai d. mun.;2008;29;411;189;222
Trakai d. mun.;2008;30;396;184;212
Trakai d. mun.;2008;31;477;246;231
Trakai d. mun.;2008;32;427;221;206
Trakai d. mun.;2008;33;442;228;214
Trakai d. mun.;2008;34;447;229;218
Trakai d. mun.;2008;35;496;252;244
Trakai d. mun.;2008;36;495;232;263
Trakai d. mun.;2008;37;496;255;241
Trakai d. mun.;2008;38;485;240;245
Trakai d. mun.;2008;39;546;256;290
Trakai d. mun.;2008;40;502;248;254
Trakai d. mun.;2008;41;467;228;239
Trakai d. mun.;2008;42;522;273;249
Trakai d. mun.;2008;43;548;271;277
Trakai d. mun.;2008;44;586;297;289
Trakai d. mun.;2008;45;530;262;268
Trakai d. mun.;2008;46;570;279;291
Trakai d. mun.;2008;47;575;305;270
Trakai d. mun.;2008;48;569;261;308
Trakai d. mun.;2008;49;554;260;294
Trakai d. mun.;2008;50;498;226;272
Trakai d. mun.;2008;51;447;221;226
Trakai d. mun.;2008;52;455;223;232
Trakai d. mun.;2008;53;455;203;252
Trakai d. mun.;2008;54;409;189;220
Trakai d. mun.;2008;55;433;212;221
Trakai d. mun.;2008;56;411;198;213
Trakai d. mun.;2008;57;419;193;226
Trakai d. mun.;2008;58;435;200;235
Trakai d. mun.;2008;59;370;172;198
Trakai d. mun.;2008;60;359;145;214
Trakai d. mun.;2008;61;331;126;205
Trakai d. mun.;2008;62;355;152;203
Trakai d. mun.;2008;63;260;115;145
Trakai d. mun.;2008;64;286;114;172
Trakai d. mun.;2008;65;356;152;204
Trakai d. mun.;2008;66;371;136;235
Trakai d. mun.;2008;67;328;111;217
Trakai d. mun.;2008;68;333;140;193
Trakai d. mun.;2008;69;398;139;259
Trakai d. mun.;2008;70;367;137;230
Trakai d. mun.;2008;71;412;153;259
Trakai d. mun.;2008;72;360;126;234
Trakai d. mun.;2008;73;307;105;202
Trakai d. mun.;2008;74;304;118;186
Trakai d. mun.;2008;75;338;110;228
Trakai d. mun.;2008;76;316;98;218
Trakai d. mun.;2008;77;281;90;191
Trakai d. mun.;2008;78;274;76;198
Trakai d. mun.;2008;79;257;73;184
Trakai d. mun.;2008;80;229;59;170
Trakai d. mun.;2008;81;199;53;146
Trakai d. mun.;2008;82;180;37;143
Trakai d. mun.;2008;83;135;23;112
Trakai d. mun.;2008;84;107;29;78
Trakai d. mun.;2008;85;456;106;350
Trakai d. mun.;2009;-1;35361;16576;18785
Trakai d. mun.;2009;0;321;183;138
Trakai d. mun.;2009;1;327;179;148
Trakai d. mun.;2009;2;313;177;136
Trakai d. mun.;2009;3;321;155;166
Trakai d. mun.;2009;4;329;186;143
Trakai d. mun.;2009;5;309;145;164
Trakai d. mun.;2009;6;320;176;144
Trakai d. mun.;2009;7;335;164;171
Trakai d. mun.;2009;8;396;201;195
Trakai d. mun.;2009;9;389;195;194
Trakai d. mun.;2009;10;404;212;192
Trakai d. mun.;2009;11;386;180;206
Trakai d. mun.;2009;12;436;232;204
Trakai d. mun.;2009;13;434;211;223
Trakai d. mun.;2009;14;433;230;203
Trakai d. mun.;2009;15;560;277;283
Trakai d. mun.;2009;16;545;294;251
Trakai d. mun.;2009;17;583;325;258
Trakai d. mun.;2009;18;567;306;261
Trakai d. mun.;2009;19;539;276;263
Trakai d. mun.;2009;20;515;274;241
Trakai d. mun.;2009;21;593;312;281
Trakai d. mun.;2009;22;546;259;287
Trakai d. mun.;2009;23;515;252;263
Trakai d. mun.;2009;24;485;262;223
Trakai d. mun.;2009;25;505;288;217
Trakai d. mun.;2009;26;444;233;211
Trakai d. mun.;2009;27;406;213;193
Trakai d. mun.;2009;28;427;209;218
Trakai d. mun.;2009;29;405;195;210
Trakai d. mun.;2009;30;406;193;213
Trakai d. mun.;2009;31;397;189;208
Trakai d. mun.;2009;32;471;246;225
Trakai d. mun.;2009;33;421;219;202
Trakai d. mun.;2009;34;445;232;213
Trakai d. mun.;2009;35;450;229;221
Trakai d. mun.;2009;36;488;247;241
Trakai d. mun.;2009;37;486;225;261
Trakai d. mun.;2009;38;496;256;240
Trakai d. mun.;2009;39;483;237;246
Trakai d. mun.;2009;40;546;256;290
Trakai d. mun.;2009;41;500;250;250
Trakai d. mun.;2009;42;470;230;240
Trakai d. mun.;2009;43;529;277;252
Trakai d. mun.;2009;44;549;271;278
Trakai d. mun.;2009;45;587;294;293
Trakai d. mun.;2009;46;525;256;269
Trakai d. mun.;2009;47;569;278;291
Trakai d. mun.;2009;48;575;306;269
Trakai d. mun.;2009;49;565;257;308
Trakai d. mun.;2009;50;553;261;292
Trakai d. mun.;2009;51;494;222;272
Trakai d. mun.;2009;52;444;219;225
Trakai d. mun.;2009;53;442;218;224
Trakai d. mun.;2009;54;445;197;248
Trakai d. mun.;2009;55;399;178;221
Trakai d. mun.;2009;56;429;207;222
Trakai d. mun.;2009;57;401;192;209
Trakai d. mun.;2009;58;414;192;222
Trakai d. mun.;2009;59;421;189;232
Trakai d. mun.;2009;60;361;164;197
Trakai d. mun.;2009;61;352;139;213
Trakai d. mun.;2009;62;327;124;203
Trakai d. mun.;2009;63;346;143;203
Trakai d. mun.;2009;64;252;110;142
Trakai d. mun.;2009;65;280;107;173
Trakai d. mun.;2009;66;349;150;199
Trakai d. mun.;2009;67;359;128;231
Trakai d. mun.;2009;68;317;103;214
Trakai d. mun.;2009;69;327;136;191
Trakai d. mun.;2009;70;388;136;252
Trakai d. mun.;2009;71;351;133;218
Trakai d. mun.;2009;72;394;142;252
Trakai d. mun.;2009;73;349;124;225
Trakai d. mun.;2009;74;290;99;191
Trakai d. mun.;2009;75;297;117;180
Trakai d. mun.;2009;76;320;105;215
Trakai d. mun.;2009;77;299;85;214
Trakai d. mun.;2009;78;267;88;179
Trakai d. mun.;2009;79;260;72;188
Trakai d. mun.;2009;80;241;67;174
Trakai d. mun.;2009;81;216;59;157
Trakai d. mun.;2009;82;185;47;138
Trakai d. mun.;2009;83;163;35;128
Trakai d. mun.;2009;84;115;19;96
Trakai d. mun.;2009;85;468;120;348
Trakai d. mun.;2010;-1;35006;16407;18599
Trakai d. mun.;2010;0;352;189;163
Trakai d. mun.;2010;1;315;181;134
Trakai d. mun.;2010;2;316;175;141
Trakai d. mun.;2010;3;308;178;130
Trakai d. mun.;2010;4;314;151;163
Trakai d. mun.;2010;5;331;189;142
Trakai d. mun.;2010;6;316;147;169
Trakai d. mun.;2010;7;320;175;145
Trakai d. mun.;2010;8;333;166;167
Trakai d. mun.;2010;9;398;203;195
Trakai d. mun.;2010;10;387;193;194
Trakai d. mun.;2010;11;401;210;191
Trakai d. mun.;2010;12;392;184;208
Trakai d. mun.;2010;13;438;232;206
Trakai d. mun.;2010;14;438;215;223
Trakai d. mun.;2010;15;434;230;204
Trakai d. mun.;2010;16;564;280;284
Trakai d. mun.;2010;17;541;292;249
Trakai d. mun.;2010;18;584;324;260
Trakai d. mun.;2010;19;561;302;259
Trakai d. mun.;2010;20;534;275;259
Trakai d. mun.;2010;21;505;269;236
Trakai d. mun.;2010;22;569;298;271
Trakai d. mun.;2010;23;534;253;281
Trakai d. mun.;2010;24;495;243;252
Trakai d. mun.;2010;25;467;252;215
Trakai d. mun.;2010;26;486;280;206
Trakai d. mun.;2010;27;431;227;204
Trakai d. mun.;2010;28;393;203;190
Trakai d. mun.;2010;29;419;206;213
Trakai d. mun.;2010;30;404;197;207
Trakai d. mun.;2010;31;401;189;212
Trakai d. mun.;2010;32;395;187;208
Trakai d. mun.;2010;33;473;247;226
Trakai d. mun.;2010;34;413;215;198
Trakai d. mun.;2010;35;441;227;214
Trakai d. mun.;2010;36;440;223;217
Trakai d. mun.;2010;37;472;236;236
Trakai d. mun.;2010;38;480;222;258
Trakai d. mun.;2010;39;488;249;239
Trakai d. mun.;2010;40;480;239;241
Trakai d. mun.;2010;41;547;256;291
Trakai d. mun.;2010;42;501;251;250
Trakai d. mun.;2010;43;464;226;238
Trakai d. mun.;2010;44;524;276;248
Trakai d. mun.;2010;45;545;272;273
Trakai d. mun.;2010;46;579;287;292
Trakai d. mun.;2010;47;520;253;267
Trakai d. mun.;2010;48;561;272;289
Trakai d. mun.;2010;49;570;299;271
Trakai d. mun.;2010;50;560;252;308
Trakai d. mun.;2010;51;547;257;290
Trakai d. mun.;2010;52;490;217;273
Trakai d. mun.;2010;53;439;214;225
Trakai d. mun.;2010;54;445;219;226
Trakai d. mun.;2010;55;437;192;245
Trakai d. mun.;2010;56;392;172;220
Trakai d. mun.;2010;57;416;200;216
Trakai d. mun.;2010;58;395;188;207
Trakai d. mun.;2010;59;407;187;220
Trakai d. mun.;2010;60;409;181;228
Trakai d. mun.;2010;61;355;163;192
Trakai d. mun.;2010;62;344;134;210
Trakai d. mun.;2010;63;319;120;199
Trakai d. mun.;2010;64;336;135;201
Trakai d. mun.;2010;65;248;104;144
Trakai d. mun.;2010;66;273;103;170
Trakai d. mun.;2010;67;337;144;193
Trakai d. mun.;2010;68;347;122;225
Trakai d. mun.;2010;69;312;100;212
Trakai d. mun.;2010;70;314;128;186
Trakai d. mun.;2010;71;380;127;253
Trakai d. mun.;2010;72;337;123;214
Trakai d. mun.;2010;73;380;137;243
Trakai d. mun.;2010;74;337;118;219
Trakai d. mun.;2010;75;285;95;190
Trakai d. mun.;2010;76;289;111;178
Trakai d. mun.;2010;77;307;99;208
Trakai d. mun.;2010;78;282;78;204
Trakai d. mun.;2010;79;249;79;170
Trakai d. mun.;2010;80;230;57;173
Trakai d. mun.;2010;81;231;65;166
Trakai d. mun.;2010;82;201;54;147
Trakai d. mun.;2010;83;171;43;128
Trakai d. mun.;2010;84;149;30;119
Trakai d. mun.;2010;85;482;114;368
Trakai d. mun.;2011;-1;34453;16125;18328
Trakai d. mun.;2011;0;369;190;179
Trakai d. mun.;2011;1;379;200;179
Trakai d. mun.;2011;2;353;202;151
Trakai d. mun.;2011;3;324;171;153
Trakai d. mun.;2011;4;305;178;127
Trakai d. mun.;2011;5;323;163;160
Trakai d. mun.;2011;6;335;183;152
Trakai d. mun.;2011;7;307;150;157
Trakai d. mun.;2011;8;309;162;147
Trakai d. mun.;2011;9;331;162;169
Trakai d. mun.;2011;10;378;199;179
Trakai d. mun.;2011;11;391;208;183
Trakai d. mun.;2011;12;380;198;182
Trakai d. mun.;2011;13;384;179;205
Trakai d. mun.;2011;14;422;214;208
Trakai d. mun.;2011;15;416;208;208
Trakai d. mun.;2011;16;413;220;193
Trakai d. mun.;2011;17;548;263;285
Trakai d. mun.;2011;18;511;276;235
Trakai d. mun.;2011;19;533;291;242
Trakai d. mun.;2011;20;495;275;220
Trakai d. mun.;2011;21;479;249;230
Trakai d. mun.;2011;22;471;241;230
Trakai d. mun.;2011;23;517;271;246
Trakai d. mun.;2011;24;493;244;249
Trakai d. mun.;2011;25;460;219;241
Trakai d. mun.;2011;26;443;245;198
Trakai d. mun.;2011;27;462;252;210
Trakai d. mun.;2011;28;400;213;187
Trakai d. mun.;2011;29;439;238;201
Trakai d. mun.;2011;30;425;204;221
Trakai d. mun.;2011;31;423;192;231
Trakai d. mun.;2011;32;421;187;234
Trakai d. mun.;2011;33;437;217;220
Trakai d. mun.;2011;34;501;249;252
Trakai d. mun.;2011;35;417;223;194
Trakai d. mun.;2011;36;441;216;225
Trakai d. mun.;2011;37;441;219;222
Trakai d. mun.;2011;38;483;238;245
Trakai d. mun.;2011;39;505;239;266
Trakai d. mun.;2011;40;486;235;251
Trakai d. mun.;2011;41;517;261;256
Trakai d. mun.;2011;42;531;251;280
Trakai d. mun.;2011;43;508;253;255
Trakai d. mun.;2011;44;498;260;238
Trakai d. mun.;2011;45;539;278;261
Trakai d. mun.;2011;46;547;271;276
Trakai d. mun.;2011;47;566;290;276
Trakai d. mun.;2011;48;527;255;272
Trakai d. mun.;2011;49;561;278;283
Trakai d. mun.;2011;50;546;268;278
Trakai d. mun.;2011;51;554;253;301
Trakai d. mun.;2011;52;520;232;288
Trakai d. mun.;2011;53;487;222;265
Trakai d. mun.;2011;54;468;229;239
Trakai d. mun.;2011;55;456;217;239
Trakai d. mun.;2011;56;429;189;240
Trakai d. mun.;2011;57;391;179;212
Trakai d. mun.;2011;58;407;201;206
Trakai d. mun.;2011;59;398;188;210
Trakai d. mun.;2011;60;387;179;208
Trakai d. mun.;2011;61;393;162;231
Trakai d. mun.;2011;62;342;160;182
Trakai d. mun.;2011;63;338;124;214
Trakai d. mun.;2011;64;301;117;184
Trakai d. mun.;2011;65;318;129;189
Trakai d. mun.;2011;66;249;104;145
Trakai d. mun.;2011;67;265;96;169
Trakai d. mun.;2011;68;310;128;182
Trakai d. mun.;2011;69;327;118;209
Trakai d. mun.;2011;70;292;95;197
Trakai d. mun.;2011;71;304;116;188
Trakai d. mun.;2011;72;347;118;229
Trakai d. mun.;2011;73;314;108;206
Trakai d. mun.;2011;74;351;122;229
Trakai d. mun.;2011;75;300;105;195
Trakai d. mun.;2011;76;262;87;175
Trakai d. mun.;2011;77;257;96;161
Trakai d. mun.;2011;78;289;86;203
Trakai d. mun.;2011;79;242;68;174
Trakai d. mun.;2011;80;226;64;162
Trakai d. mun.;2011;81;191;48;143
Trakai d. mun.;2011;82;198;53;145
Trakai d. mun.;2011;83;181;44;137
Trakai d. mun.;2011;84;147;36;111
Trakai d. mun.;2011;85;522;104;418
Trakai d. mun.;2012;-1;34230;15997;18233
Trakai d. mun.;2012;0;347;184;163
Trakai d. mun.;2012;1;368;187;181
Trakai d. mun.;2012;2;377;195;182
Trakai d. mun.;2012;3;352;203;149
Trakai d. mun.;2012;4;322;166;156
Trakai d. mun.;2012;5;303;174;129
Trakai d. mun.;2012;6;320;165;155
Trakai d. mun.;2012;7;337;184;153
Trakai d. mun.;2012;8;311;150;161
Trakai d. mun.;2012;9;309;161;148
Trakai d. mun.;2012;10;333;164;169
Trakai d. mun.;2012;11;376;196;180
Trakai d. mun.;2012;12;390;207;183
Trakai d. mun.;2012;13;375;197;178
Trakai d. mun.;2012;14;378;174;204
Trakai d. mun.;2012;15;424;215;209
Trakai d. mun.;2012;16;418;209;209
Trakai d. mun.;2012;17;413;220;193
Trakai d. mun.;2012;18;544;261;283
Trakai d. mun.;2012;19;508;275;233
Trakai d. mun.;2012;20;530;289;241
Trakai d. mun.;2012;21;492;270;222
Trakai d. mun.;2012;22;471;244;227
Trakai d. mun.;2012;23;459;239;220
Trakai d. mun.;2012;24;508;267;241
Trakai d. mun.;2012;25;487;239;248
Trakai d. mun.;2012;26;447;211;236
Trakai d. mun.;2012;27;444;254;190
Trakai d. mun.;2012;28;452;248;204
Trakai d. mun.;2012;29;404;212;192
Trakai d. mun.;2012;30;439;240;199
Trakai d. mun.;2012;31;428;207;221
Trakai d. mun.;2012;32;424;186;238
Trakai d. mun.;2012;33;420;187;233
Trakai d. mun.;2012;34;443;223;220
Trakai d. mun.;2012;35;502;252;250
Trakai d. mun.;2012;36;405;220;185
Trakai d. mun.;2012;37;435;210;225
Trakai d. mun.;2012;38;437;215;222
Trakai d. mun.;2012;39;482;236;246
Trakai d. mun.;2012;40;501;238;263
Trakai d. mun.;2012;41;483;231;252
Trakai d. mun.;2012;42;510;252;258
Trakai d. mun.;2012;43;527;246;281
Trakai d. mun.;2012;44;499;245;254
Trakai d. mun.;2012;45;494;258;236
Trakai d. mun.;2012;46;525;266;259
Trakai d. mun.;2012;47;542;268;274
Trakai d. mun.;2012;48;564;288;276
Trakai d. mun.;2012;49;532;257;275
Trakai d. mun.;2012;50;560;277;283
Trakai d. mun.;2012;51;524;249;275
Trakai d. mun.;2012;52;546;247;299
Trakai d. mun.;2012;53;516;230;286
Trakai d. mun.;2012;54;479;218;261
Trakai d. mun.;2012;55;463;225;238
Trakai d. mun.;2012;56;454;214;240
Trakai d. mun.;2012;57;424;185;239
Trakai d. mun.;2012;58;390;177;213
Trakai d. mun.;2012;59;398;194;204
Trakai d. mun.;2012;60;392;186;206
Trakai d. mun.;2012;61;382;176;206
Trakai d. mun.;2012;62;384;155;229
Trakai d. mun.;2012;63;332;151;181
Trakai d. mun.;2012;64;336;121;215
Trakai d. mun.;2012;65;295;113;182
Trakai d. mun.;2012;66;316;129;187
Trakai d. mun.;2012;67;244;101;143
Trakai d. mun.;2012;68;252;88;164
Trakai d. mun.;2012;69;298;123;175
Trakai d. mun.;2012;70;320;115;205
Trakai d. mun.;2012;71;282;89;193
Trakai d. mun.;2012;72;298;111;187
Trakai d. mun.;2012;73;333;112;221
Trakai d. mun.;2012;74;298;98;200
Trakai d. mun.;2012;75;343;117;226
Trakai d. mun.;2012;76;290;98;192
Trakai d. mun.;2012;77;252;82;170
Trakai d. mun.;2012;78;243;87;156
Trakai d. mun.;2012;79;273;80;193
Trakai d. mun.;2012;80;230;61;169
Trakai d. mun.;2012;81;211;57;154
Trakai d. mun.;2012;82;176;44;132
Trakai d. mun.;2012;83;180;49;131
Trakai d. mun.;2012;84;160;37;123
Trakai d. mun.;2012;85;565;116;449
Trakai d. mun.;2013;-1;33899;15901;17998
Trakai d. mun.;2013;0;348;189;159
Trakai d. mun.;2013;1;346;186;160
Trakai d. mun.;2013;2;350;178;172
Trakai d. mun.;2013;3;368;188;180
Trakai d. mun.;2013;4;334;193;141
Trakai d. mun.;2013;5;309;165;144
Trakai d. mun.;2013;6;297;174;123
Trakai d. mun.;2013;7;316;163;153
Trakai d. mun.;2013;8;340;185;155
Trakai d. mun.;2013;9;314;155;159
Trakai d. mun.;2013;10;305;158;147
Trakai d. mun.;2013;11;334;167;167
Trakai d. mun.;2013;12;377;200;177
Trakai d. mun.;2013;13;387;206;181
Trakai d. mun.;2013;14;369;189;180
Trakai d. mun.;2013;15;369;171;198
Trakai d. mun.;2013;16;420;215;205
Trakai d. mun.;2013;17;417;209;208
Trakai d. mun.;2013;18;409;216;193
Trakai d. mun.;2013;19;524;252;272
Trakai d. mun.;2013;20;502;271;231
Trakai d. mun.;2013;21;520;283;237
Trakai d. mun.;2013;22;487;262;225
Trakai d. mun.;2013;23;460;241;219
Trakai d. mun.;2013;24;448;242;206
Trakai d. mun.;2013;25;489;264;225
Trakai d. mun.;2013;26;478;240;238
Trakai d. mun.;2013;27;434;206;228
Trakai d. mun.;2013;28;441;257;184
Trakai d. mun.;2013;29;455;251;204
Trakai d. mun.;2013;30;402;208;194
Trakai d. mun.;2013;31;439;249;190
Trakai d. mun.;2013;32;421;205;216
Trakai d. mun.;2013;33;416;181;235
Trakai d. mun.;2013;34;420;192;228
Trakai d. mun.;2013;35;447;218;229
Trakai d. mun.;2013;36;498;244;254
Trakai d. mun.;2013;37;393;219;174
Trakai d. mun.;2013;38;423;200;223
Trakai d. mun.;2013;39;434;215;219
Trakai d. mun.;2013;40;487;237;250
Trakai d. mun.;2013;41;511;244;267
Trakai d. mun.;2013;42;481;229;252
Trakai d. mun.;2013;43;512;253;259
Trakai d. mun.;2013;44;527;244;283
Trakai d. mun.;2013;45;493;240;253
Trakai d. mun.;2013;46;489;254;235
Trakai d. mun.;2013;47;516;265;251
Trakai d. mun.;2013;48;531;257;274
Trakai d. mun.;2013;49;560;286;274
Trakai d. mun.;2013;50;529;254;275
Trakai d. mun.;2013;51;556;276;280
Trakai d. mun.;2013;52;517;242;275
Trakai d. mun.;2013;53;529;240;289
Trakai d. mun.;2013;54;513;226;287
Trakai d. mun.;2013;55;476;218;258
Trakai d. mun.;2013;56;458;218;240
Trakai d. mun.;2013;57;452;211;241
Trakai d. mun.;2013;58;422;183;239
Trakai d. mun.;2013;59;382;175;207
Trakai d. mun.;2013;60;388;185;203
Trakai d. mun.;2013;61;387;180;207
Trakai d. mun.;2013;62;374;174;200
Trakai d. mun.;2013;63;383;156;227
Trakai d. mun.;2013;64;325;143;182
Trakai d. mun.;2013;65;328;117;211
Trakai d. mun.;2013;66;293;111;182
Trakai d. mun.;2013;67;307;124;183
Trakai d. mun.;2013;68;238;100;138
Trakai d. mun.;2013;69;249;86;163
Trakai d. mun.;2013;70;289;117;172
Trakai d. mun.;2013;71;309;110;199
Trakai d. mun.;2013;72;281;85;196
Trakai d. mun.;2013;73;283;103;180
Trakai d. mun.;2013;74;323;109;214
Trakai d. mun.;2013;75;290;92;198
Trakai d. mun.;2013;76;331;107;224
Trakai d. mun.;2013;77;275;92;183
Trakai d. mun.;2013;78;237;76;161
Trakai d. mun.;2013;79;229;81;148
Trakai d. mun.;2013;80;257;74;183
Trakai d. mun.;2013;81;216;58;158
Trakai d. mun.;2013;82;196;51;145
Trakai d. mun.;2013;83;154;35;119
Trakai d. mun.;2013;84;163;42;121
Trakai d. mun.;2013;85;613;134;479
Trakai d. mun.;2014;-1;33556;15748;17808
Trakai d. mun.;2014;0;378;212;166
Trakai d. mun.;2014;1;334;187;147
Trakai d. mun.;2014;2;332;178;154
Trakai d. mun.;2014;3;344;176;168
Trakai d. mun.;2014;4;356;184;172
Trakai d. mun.;2014;5;328;187;141
Trakai d. mun.;2014;6;305;160;145
Trakai d. mun.;2014;7;288;167;121
Trakai d. mun.;2014;8;317;163;154
Trakai d. mun.;2014;9;338;182;156
Trakai d. mun.;2014;10;313;153;160
Trakai d. mun.;2014;11;307;155;152
Trakai d. mun.;2014;12;332;167;165
Trakai d. mun.;2014;13;379;201;178
Trakai d. mun.;2014;14;384;204;180
Trakai d. mun.;2014;15;367;188;179
Trakai d. mun.;2014;16;373;171;202
Trakai d. mun.;2014;17;417;214;203
Trakai d. mun.;2014;18;413;207;206
Trakai d. mun.;2014;19;401;215;186
Trakai d. mun.;2014;20;522;252;270
Trakai d. mun.;2014;21;495;268;227
Trakai d. mun.;2014;22;511;278;233
Trakai d. mun.;2014;23;474;255;219
Trakai d. mun.;2014;24;451;235;216
Trakai d. mun.;2014;25;451;242;209
Trakai d. mun.;2014;26;463;246;217
Trakai d. mun.;2014;27;472;238;234
Trakai d. mun.;2014;28;425;196;229
Trakai d. mun.;2014;29;441;253;188
Trakai d. mun.;2014;30;453;249;204
Trakai d. mun.;2014;31;379;198;181
Trakai d. mun.;2014;32;431;245;186
Trakai d. mun.;2014;33;422;210;212
Trakai d. mun.;2014;34;421;188;233
Trakai d. mun.;2014;35;411;186;225
Trakai d. mun.;2014;36;445;220;225
Trakai d. mun.;2014;37;494;242;252
Trakai d. mun.;2014;38;382;215;167
Trakai d. mun.;2014;39;422;198;224
Trakai d. mun.;2014;40;417;205;212
Trakai d. mun.;2014;41;472;224;248
Trakai d. mun.;2014;42;509;240;269
Trakai d. mun.;2014;43;477;224;253
Trakai d. mun.;2014;44;500;241;259
Trakai d. mun.;2014;45;530;247;283
Trakai d. mun.;2014;46;497;245;252
Trakai d. mun.;2014;47;479;251;228
Trakai d. mun.;2014;48;511;259;252
Trakai d. mun.;2014;49;528;255;273
Trakai d. mun.;2014;50;559;285;274
Trakai d. mun.;2014;51;534;251;283
Trakai d. mun.;2014;52;545;270;275
Trakai d. mun.;2014;53;515;242;273
Trakai d. mun.;2014;54;515;233;282
Trakai d. mun.;2014;55;508;224;284
Trakai d. mun.;2014;56;468;212;256
Trakai d. mun.;2014;57;448;214;234
Trakai d. mun.;2014;58;440;203;237
Trakai d. mun.;2014;59;421;179;242
Trakai d. mun.;2014;60;378;169;209
Trakai d. mun.;2014;61;378;179;199
Trakai d. mun.;2014;62;381;177;204
Trakai d. mun.;2014;63;373;172;201
Trakai d. mun.;2014;64;374;151;223
Trakai d. mun.;2014;65;321;140;181
Trakai d. mun.;2014;66;322;113;209
Trakai d. mun.;2014;67;294;110;184
Trakai d. mun.;2014;68;301;121;180
Trakai d. mun.;2014;69;234;97;137
Trakai d. mun.;2014;70;242;82;160
Trakai d. mun.;2014;71;286;115;171
Trakai d. mun.;2014;72;299;105;194
Trakai d. mun.;2014;73;271;81;190
Trakai d. mun.;2014;74;274;98;176
Trakai d. mun.;2014;75;310;102;208
Trakai d. mun.;2014;76;269;85;184
Trakai d. mun.;2014;77;317;98;219
Trakai d. mun.;2014;78;263;85;178
Trakai d. mun.;2014;79;231;73;158
Trakai d. mun.;2014;80;210;76;134
Trakai d. mun.;2014;81;240;67;173
Trakai d. mun.;2014;82;196;50;146
Trakai d. mun.;2014;83;180;48;132
Trakai d. mun.;2014;84;136;31;105
Trakai d. mun.;2014;85;632;134;498
Trakai d. mun.;2015;-1;33437;15726;17711
Trakai d. mun.;2015;0;363;190;173
Trakai d. mun.;2015;1;373;214;159
Trakai d. mun.;2015;2;330;189;141
Trakai d. mun.;2015;3;324;175;149
Trakai d. mun.;2015;4;349;178;171
Trakai d. mun.;2015;5;358;183;175
Trakai d. mun.;2015;6;328;188;140
Trakai d. mun.;2015;7;301;155;146
Trakai d. mun.;2015;8;291;169;122
Trakai d. mun.;2015;9;316;159;157
Trakai d. mun.;2015;10;336;178;158
Trakai d. mun.;2015;11;313;151;162
Trakai d. mun.;2015;12;297;153;144
Trakai d. mun.;2015;13;338;173;165
Trakai d. mun.;2015;14;373;201;172
Trakai d. mun.;2015;15;394;211;183
Trakai d. mun.;2015;16;367;187;180
Trakai d. mun.;2015;17;378;176;202
Trakai d. mun.;2015;18;406;210;196
Trakai d. mun.;2015;19;408;206;202
Trakai d. mun.;2015;20;399;213;186
Trakai d. mun.;2015;21;519;249;270
Trakai d. mun.;2015;22;487;263;224
Trakai d. mun.;2015;23;505;276;229
Trakai d. mun.;2015;24;450;247;203
Trakai d. mun.;2015;25;455;236;219
Trakai d. mun.;2015;26;431;234;197
Trakai d. mun.;2015;27;465;245;220
Trakai d. mun.;2015;28;463;238;225
Trakai d. mun.;2015;29;436;205;231
Trakai d. mun.;2015;30;456;260;196
Trakai d. mun.;2015;31;451;245;206
Trakai d. mun.;2015;32;372;197;175
Trakai d. mun.;2015;33;433;245;188
Trakai d. mun.;2015;34;426;213;213
Trakai d. mun.;2015;35;423;194;229
Trakai d. mun.;2015;36;413;180;233
Trakai d. mun.;2015;37;444;220;224
Trakai d. mun.;2015;38;499;246;253
Trakai d. mun.;2015;39;388;216;172
Trakai d. mun.;2015;40;426;199;227
Trakai d. mun.;2015;41;426;208;218
Trakai d. mun.;2015;42;456;217;239
Trakai d. mun.;2015;43;498;235;263
Trakai d. mun.;2015;44;476;228;248
Trakai d. mun.;2015;45;487;236;251
Trakai d. mun.;2015;46;531;248;283
Trakai d. mun.;2015;47;497;245;252
Trakai d. mun.;2015;48;476;247;229
Trakai d. mun.;2015;49;514;261;253
Trakai d. mun.;2015;50;533;259;274
Trakai d. mun.;2015;51;561;286;275
Trakai d. mun.;2015;52;529;248;281
Trakai d. mun.;2015;53;542;265;277
Trakai d. mun.;2015;54;508;237;271
Trakai d. mun.;2015;55;507;223;284
Trakai d. mun.;2015;56;507;222;285
Trakai d. mun.;2015;57;473;213;260
Trakai d. mun.;2015;58;446;213;233
Trakai d. mun.;2015;59;436;202;234
Trakai d. mun.;2015;60;418;176;242
Trakai d. mun.;2015;61;368;161;207
Trakai d. mun.;2015;62;374;175;199
Trakai d. mun.;2015;63;375;172;203
Trakai d. mun.;2015;64;371;172;199
Trakai d. mun.;2015;65;365;146;219
Trakai d. mun.;2015;66;312;132;180
Trakai d. mun.;2015;67;315;110;205
Trakai d. mun.;2015;68;284;106;178
Trakai d. mun.;2015;69;286;112;174
Trakai d. mun.;2015;70;224;90;134
Trakai d. mun.;2015;71;241;81;160
Trakai d. mun.;2015;72;270;103;167
Trakai d. mun.;2015;73;290;102;188
Trakai d. mun.;2015;74;259;74;185
Trakai d. mun.;2015;75;264;91;173
Trakai d. mun.;2015;76;294;94;200
Trakai d. mun.;2015;77;256;79;177
Trakai d. mun.;2015;78;307;91;216
Trakai d. mun.;2015;79;247;79;168
Trakai d. mun.;2015;80;219;63;156
Trakai d. mun.;2015;81;201;72;129
Trakai d. mun.;2015;82;223;62;161
Trakai d. mun.;2015;83;168;42;126
Trakai d. mun.;2015;84;161;44;117
Trakai d. mun.;2015;85;658;137;521
Trakai d. mun.;2016;-1;33020;15537;17483
Trakai d. mun.;2016;0;338;183;155
Trakai d. mun.;2016;1;355;190;165
Trakai d. mun.;2016;2;364;206;158
Trakai d. mun.;2016;3;318;182;136
Trakai d. mun.;2016;4;317;173;144
Trakai d. mun.;2016;5;342;175;167
Trakai d. mun.;2016;6;356;181;175
Trakai d. mun.;2016;7;331;193;138
Trakai d. mun.;2016;8;311;158;153
Trakai d. mun.;2016;9;291;170;121
Trakai d. mun.;2016;10;317;158;159
Trakai d. mun.;2016;11;326;171;155
Trakai d. mun.;2016;12;312;150;162
Trakai d. mun.;2016;13;298;155;143
Trakai d. mun.;2016;14;341;177;164
Trakai d. mun.;2016;15;371;200;171
Trakai d. mun.;2016;16;399;213;186
Trakai d. mun.;2016;17;363;186;177
Trakai d. mun.;2016;18;372;174;198
Trakai d. mun.;2016;19;398;205;193
Trakai d. mun.;2016;20;411;205;206
Trakai d. mun.;2016;21;390;209;181
Trakai d. mun.;2016;22;501;241;260
Trakai d. mun.;2016;23;471;252;219
Trakai d. mun.;2016;24;491;266;225
Trakai d. mun.;2016;25;426;238;188
Trakai d. mun.;2016;26;440;226;214
Trakai d. mun.;2016;27;426;226;200
Trakai d. mun.;2016;28;459;248;211
Trakai d. mun.;2016;29;449;229;220
Trakai d. mun.;2016;30;421;203;218
Trakai d. mun.;2016;31;434;248;186
Trakai d. mun.;2016;32;440;238;202
Trakai d. mun.;2016;33;366;196;170
Trakai d. mun.;2016;34;434;246;188
Trakai d. mun.;2016;35;419;210;209
Trakai d. mun.;2016;36;416;193;223
Trakai d. mun.;2016;37;411;179;232
Trakai d. mun.;2016;38;444;216;228
Trakai d. mun.;2016;39;499;245;254
Trakai d. mun.;2016;40;384;213;171
Trakai d. mun.;2016;41;433;205;228
Trakai d. mun.;2016;42;418;204;214
Trakai d. mun.;2016;43;446;211;235
Trakai d. mun.;2016;44;497;233;264
Trakai d. mun.;2016;45;469;220;249
Trakai d. mun.;2016;46;492;241;251
Trakai d. mun.;2016;47;522;246;276
Trakai d. mun.;2016;48;483;237;246
Trakai d. mun.;2016;49;465;237;228
Trakai d. mun.;2016;50;508;257;251
Trakai d. mun.;2016;51;525;257;268
Trakai d. mun.;2016;52;554;282;272
Trakai d. mun.;2016;53;530;240;290
Trakai d. mun.;2016;54;533;265;268
Trakai d. mun.;2016;55;497;228;269
Trakai d. mun.;2016;56;495;218;277
Trakai d. mun.;2016;57;503;222;281
Trakai d. mun.;2016;58;468;210;258
Trakai d. mun.;2016;59;438;206;232
Trakai d. mun.;2016;60;434;201;233
Trakai d. mun.;2016;61;405;167;238
Trakai d. mun.;2016;62;360;155;205
Trakai d. mun.;2016;63;367;165;202
Trakai d. mun.;2016;64;374;174;200
Trakai d. mun.;2016;65;358;165;193
Trakai d. mun.;2016;66;357;140;217
Trakai d. mun.;2016;67;303;123;180
Trakai d. mun.;2016;68;308;108;200
Trakai d. mun.;2016;69;275;100;175
Trakai d. mun.;2016;70;278;107;171
Trakai d. mun.;2016;71;219;86;133
Trakai d. mun.;2016;72;233;75;158
Trakai d. mun.;2016;73;256;97;159
Trakai d. mun.;2016;74;280;94;186
Trakai d. mun.;2016;75;252;70;182
Trakai d. mun.;2016;76;253;87;166
Trakai d. mun.;2016;77;279;88;191
Trakai d. mun.;2016;78;251;76;175
Trakai d. mun.;2016;79;293;83;210
Trakai d. mun.;2016;80;229;73;156
Trakai d. mun.;2016;81;203;58;145
Trakai d. mun.;2016;82;185;63;122
Trakai d. mun.;2016;83;196;54;142
Trakai d. mun.;2016;84;154;35;119
Trakai d. mun.;2016;85;690;147;543
Trakai d. mun.;2017;-1;32701;15439;17262
Trakai d. mun.;2017;0;338;181;157
Trakai d. mun.;2017;1;326;180;146
Trakai d. mun.;2017;2;338;182;156
Trakai d. mun.;2017;3;364;207;157
Trakai d. mun.;2017;4;319;185;134
Trakai d. mun.;2017;5;326;180;146
Trakai d. mun.;2017;6;337;177;160
Trakai d. mun.;2017;7;354;174;180
Trakai d. mun.;2017;8;332;193;139
Trakai d. mun.;2017;9;317;161;156
Trakai d. mun.;2017;10;286;167;119
Trakai d. mun.;2017;11;311;158;153
Trakai d. mun.;2017;12;328;173;155
Trakai d. mun.;2017;13;311;152;159
Trakai d. mun.;2017;14;303;162;141
Trakai d. mun.;2017;15;332;173;159
Trakai d. mun.;2017;16;372;200;172
Trakai d. mun.;2017;17;402;212;190
Trakai d. mun.;2017;18;369;190;179
Trakai d. mun.;2017;19;363;169;194
Trakai d. mun.;2017;20;394;204;190
Trakai d. mun.;2017;21;405;204;201
Trakai d. mun.;2017;22;379;203;176
Trakai d. mun.;2017;23;482;235;247
Trakai d. mun.;2017;24;462;249;213
Trakai d. mun.;2017;25;482;265;217
Trakai d. mun.;2017;26;410;224;186
Trakai d. mun.;2017;27;411;218;193
Trakai d. mun.;2017;28;414;220;194
Trakai d. mun.;2017;29;450;243;207
Trakai d. mun.;2017;30;433;222;211
Trakai d. mun.;2017;31;400;193;207
Trakai d. mun.;2017;32;424;240;184
Trakai d. mun.;2017;33;451;244;207
Trakai d. mun.;2017;34;364;198;166
Trakai d. mun.;2017;35;426;239;187
Trakai d. mun.;2017;36;415;206;209
Trakai d. mun.;2017;37;404;183;221
Trakai d. mun.;2017;38;415;178;237
Trakai d. mun.;2017;39;441;218;223
Trakai d. mun.;2017;40;494;243;251
Trakai d. mun.;2017;41;377;211;166
Trakai d. mun.;2017;42;436;204;232
Trakai d. mun.;2017;43;421;203;218
Trakai d. mun.;2017;44;449;209;240
Trakai d. mun.;2017;45;494;232;262
Trakai d. mun.;2017;46;464;221;243
Trakai d. mun.;2017;47;489;239;250
Trakai d. mun.;2017;48;513;239;274
Trakai d. mun.;2017;49;494;246;248
Trakai d. mun.;2017;50;466;236;230
Trakai d. mun.;2017;51;512;258;254
Trakai d. mun.;2017;52;518;255;263
Trakai d. mun.;2017;53;550;275;275
Trakai d. mun.;2017;54;527;237;290
Trakai d. mun.;2017;55;533;269;264
Trakai d. mun.;2017;56;503;231;272
Trakai d. mun.;2017;57;496;218;278
Trakai d. mun.;2017;58;491;215;276
Trakai d. mun.;2017;59;454;203;251
Trakai d. mun.;2017;60;438;207;231
Trakai d. mun.;2017;61;425;197;228
Trakai d. mun.;2017;62;401;163;238
Trakai d. mun.;2017;63;349;149;200
Trakai d. mun.;2017;64;358;159;199
Trakai d. mun.;2017;65;367;168;199
Trakai d. mun.;2017;66;347;156;191
Trakai d. mun.;2017;67;355;137;218
Trakai d. mun.;2017;68;298;118;180
Trakai d. mun.;2017;69;299;101;198
Trakai d. mun.;2017;70;268;95;173
Trakai d. mun.;2017;71;262;96;166
Trakai d. mun.;2017;72;209;82;127
Trakai d. mun.;2017;73;225;70;155
Trakai d. mun.;2017;74;249;94;155
Trakai d. mun.;2017;75;265;87;178
Trakai d. mun.;2017;76;249;71;178
Trakai d. mun.;2017;77;242;84;158
Trakai d. mun.;2017;78;255;75;180
Trakai d. mun.;2017;79;240;74;166
Trakai d. mun.;2017;80;275;76;199
Trakai d. mun.;2017;81;214;66;148
Trakai d. mun.;2017;82;196;56;140
Trakai d. mun.;2017;83;173;59;114
Trakai d. mun.;2017;84;171;45;126
Trakai d. mun.;2017;85;700;148;552
Trakai d. mun.;2018;-1;32492;15364;17128
Trakai d. mun.;2018;0;354;191;163
Trakai d. mun.;2018;1;343;184;159
Trakai d. mun.;2018;2;328;177;151
Trakai d. mun.;2018;3;335;186;149
Trakai d. mun.;2018;4;366;208;158
Trakai d. mun.;2018;5;314;181;133
Trakai d. mun.;2018;6;320;172;148
Trakai d. mun.;2018;7;332;172;160
Trakai d. mun.;2018;8;358;181;177
Trakai d. mun.;2018;9;333;189;144
Trakai d. mun.;2018;10;318;161;157
Trakai d. mun.;2018;11;286;167;119
Trakai d. mun.;2018;12;312;156;156
Trakai d. mun.;2018;13;327;171;156
Trakai d. mun.;2018;14;306;152;154
Trakai d. mun.;2018;15;295;156;139
Trakai d. mun.;2018;16;339;178;161
Trakai d. mun.;2018;17;375;200;175
Trakai d. mun.;2018;18;402;214;188
Trakai d. mun.;2018;19;368;189;179
Trakai d. mun.;2018;20;350;164;186
Trakai d. mun.;2018;21;383;200;183
Trakai d. mun.;2018;22;397;195;202
Trakai d. mun.;2018;23;369;196;173
Trakai d. mun.;2018;24;472;233;239
Trakai d. mun.;2018;25;447;241;206
Trakai d. mun.;2018;26;463;254;209
Trakai d. mun.;2018;27;404;225;179
Trakai d. mun.;2018;28;399;211;188
Trakai d. mun.;2018;29;414;222;192
Trakai d. mun.;2018;30;444;241;203
Trakai d. mun.;2018;31;434;229;205
Trakai d. mun.;2018;32;399;198;201
Trakai d. mun.;2018;33;422;232;190
Trakai d. mun.;2018;34;448;242;206
Trakai d. mun.;2018;35;365;197;168
Trakai d. mun.;2018;36;423;233;190
Trakai d. mun.;2018;37;418;207;211
Trakai d. mun.;2018;38;394;176;218
Trakai d. mun.;2018;39;410;178;232
Trakai d. mun.;2018;40;439;218;221
Trakai d. mun.;2018;41;493;243;250
Trakai d. mun.;2018;42;377;208;169
Trakai d. mun.;2018;43;436;208;228
Trakai d. mun.;2018;44;419;201;218
Trakai d. mun.;2018;45;442;204;238
Trakai d. mun.;2018;46;486;226;260
Trakai d. mun.;2018;47;460;220;240
Trakai d. mun.;2018;48;493;244;249
Trakai d. mun.;2018;49;511;238;273
Trakai d. mun.;2018;50;492;242;250
Trakai d. mun.;2018;51;466;238;228
Trakai d. mun.;2018;52;511;262;249
Trakai d. mun.;2018;53;510;248;262
Trakai d. mun.;2018;54;544;268;276
Trakai d. mun.;2018;55;532;243;289
Trakai d. mun.;2018;56;525;264;261
Trakai d. mun.;2018;57;496;226;270
Trakai d. mun.;2018;58;490;214;276
Trakai d. mun.;2018;59;490;211;279
Trakai d. mun.;2018;60;452;201;251
Trakai d. mun.;2018;61;439;205;234
Trakai d. mun.;2018;62;413;187;226
Trakai d. mun.;2018;63;396;161;235
Trakai d. mun.;2018;64;346;149;197
Trakai d. mun.;2018;65;347;151;196
Trakai d. mun.;2018;66;364;166;198
Trakai d. mun.;2018;67;341;154;187
Trakai d. mun.;2018;68;342;134;208
Trakai d. mun.;2018;69;291;112;179
Trakai d. mun.;2018;70;294;98;196
Trakai d. mun.;2018;71;254;87;167
Trakai d. mun.;2018;72;259;97;162
Trakai d. mun.;2018;73;198;76;122
Trakai d. mun.;2018;74;220;66;154
Trakai d. mun.;2018;75;244;91;153
Trakai d. mun.;2018;76;245;76;169
Trakai d. mun.;2018;77;238;64;174
Trakai d. mun.;2018;78;230;80;150
Trakai d. mun.;2018;79;238;67;171
Trakai d. mun.;2018;80;225;70;155
Trakai d. mun.;2018;81;256;68;188
Trakai d. mun.;2018;82;202;58;144
Trakai d. mun.;2018;83;183;52;131
Trakai d. mun.;2018;84;155;51;104
Trakai d. mun.;2018;85;742;158;584
Ukmergė d. mun.;2001;-1;48703;22802;25901
Ukmergė d. mun.;2001;0;408;210;198
Ukmergė d. mun.;2001;1;448;228;220
Ukmergė d. mun.;2001;2;467;252;215
Ukmergė d. mun.;2001;3;492;264;228
Ukmergė d. mun.;2001;4;462;229;233
Ukmergė d. mun.;2001;5;529;272;257
Ukmergė d. mun.;2001;6;548;284;264
Ukmergė d. mun.;2001;7;606;324;282
Ukmergė d. mun.;2001;8;693;350;343
Ukmergė d. mun.;2001;9;729;369;360
Ukmergė d. mun.;2001;10;728;386;342
Ukmergė d. mun.;2001;11;733;381;352
Ukmergė d. mun.;2001;12;747;367;380
Ukmergė d. mun.;2001;13;824;427;397
Ukmergė d. mun.;2001;14;796;409;387
Ukmergė d. mun.;2001;15;725;389;336
Ukmergė d. mun.;2001;16;758;375;383
Ukmergė d. mun.;2001;17;750;393;357
Ukmergė d. mun.;2001;18;581;296;285
Ukmergė d. mun.;2001;19;505;274;231
Ukmergė d. mun.;2001;20;484;247;237
Ukmergė d. mun.;2001;21;501;287;214
Ukmergė d. mun.;2001;22;502;261;241
Ukmergė d. mun.;2001;23;502;266;236
Ukmergė d. mun.;2001;24;521;267;254
Ukmergė d. mun.;2001;25;564;306;258
Ukmergė d. mun.;2001;26;555;271;284
Ukmergė d. mun.;2001;27;639;344;295
Ukmergė d. mun.;2001;28;614;301;313
Ukmergė d. mun.;2001;29;685;344;341
Ukmergė d. mun.;2001;30;688;365;323
Ukmergė d. mun.;2001;31;705;359;346
Ukmergė d. mun.;2001;32;605;326;279
Ukmergė d. mun.;2001;33;663;313;350
Ukmergė d. mun.;2001;34;734;363;371
Ukmergė d. mun.;2001;35;713;355;358
Ukmergė d. mun.;2001;36;714;352;362
Ukmergė d. mun.;2001;37;721;364;357
Ukmergė d. mun.;2001;38;746;362;384
Ukmergė d. mun.;2001;39;765;386;379
Ukmergė d. mun.;2001;40;727;364;363
Ukmergė d. mun.;2001;41;713;354;359
Ukmergė d. mun.;2001;42;703;338;365
Ukmergė d. mun.;2001;43;649;319;330
Ukmergė d. mun.;2001;44;584;299;285
Ukmergė d. mun.;2001;45;609;324;285
Ukmergė d. mun.;2001;46;518;264;254
Ukmergė d. mun.;2001;47;483;239;244
Ukmergė d. mun.;2001;48;574;273;301
Ukmergė d. mun.;2001;49;548;258;290
Ukmergė d. mun.;2001;50;595;284;311
Ukmergė d. mun.;2001;51;627;286;341
Ukmergė d. mun.;2001;52;567;239;328
Ukmergė d. mun.;2001;53;511;242;269
Ukmergė d. mun.;2001;54;500;240;260
Ukmergė d. mun.;2001;55;594;278;316
Ukmergė d. mun.;2001;56;527;232;295
Ukmergė d. mun.;2001;57;631;277;354
Ukmergė d. mun.;2001;58;661;260;401
Ukmergė d. mun.;2001;59;638;298;340
Ukmergė d. mun.;2001;60;607;256;351
Ukmergė d. mun.;2001;61;562;270;292
Ukmergė d. mun.;2001;62;606;255;351
Ukmergė d. mun.;2001;63;583;239;344
Ukmergė d. mun.;2001;64;596;264;332
Ukmergė d. mun.;2001;65;613;250;363
Ukmergė d. mun.;2001;66;556;220;336
Ukmergė d. mun.;2001;67;561;232;329
Ukmergė d. mun.;2001;68;614;222;392
Ukmergė d. mun.;2001;69;480;168;312
Ukmergė d. mun.;2001;70;541;203;338
Ukmergė d. mun.;2001;71;516;183;333
Ukmergė d. mun.;2001;72;505;197;308
Ukmergė d. mun.;2001;73;482;156;326
Ukmergė d. mun.;2001;74;421;127;294
Ukmergė d. mun.;2001;75;400;118;282
Ukmergė d. mun.;2001;76;406;119;287
Ukmergė d. mun.;2001;77;345;106;239
Ukmergė d. mun.;2001;78;335;106;229
Ukmergė d. mun.;2001;79;315;83;232
Ukmergė d. mun.;2001;80;275;93;182
Ukmergė d. mun.;2001;81;204;51;153
Ukmergė d. mun.;2001;82;126;45;81
Ukmergė d. mun.;2001;83;100;37;63
Ukmergė d. mun.;2001;84;112;33;79
Ukmergė d. mun.;2001;85;733;183;550
Ukmergė d. mun.;2002;-1;48071;22444;25627
Ukmergė d. mun.;2002;0;414;200;214
Ukmergė d. mun.;2002;1;399;204;195
Ukmergė d. mun.;2002;2;450;228;222
Ukmergė d. mun.;2002;3;461;252;209
Ukmergė d. mun.;2002;4;485;263;222
Ukmergė d. mun.;2002;5;457;228;229
Ukmergė d. mun.;2002;6;521;269;252
Ukmergė d. mun.;2002;7;546;281;265
Ukmergė d. mun.;2002;8;606;324;282
Ukmergė d. mun.;2002;9;684;343;341
Ukmergė d. mun.;2002;10;723;366;357
Ukmergė d. mun.;2002;11;714;375;339
Ukmergė d. mun.;2002;12;722;375;347
Ukmergė d. mun.;2002;13;734;357;377
Ukmergė d. mun.;2002;14;814;421;393
Ukmergė d. mun.;2002;15;783;402;381
Ukmergė d. mun.;2002;16;717;383;334
Ukmergė d. mun.;2002;17;743;369;374
Ukmergė d. mun.;2002;18;735;384;351
Ukmergė d. mun.;2002;19;566;288;278
Ukmergė d. mun.;2002;20;499;268;231
Ukmergė d. mun.;2002;21;471;240;231
Ukmergė d. mun.;2002;22;492;281;211
Ukmergė d. mun.;2002;23;486;252;234
Ukmergė d. mun.;2002;24;491;259;232
Ukmergė d. mun.;2002;25;513;261;252
Ukmergė d. mun.;2002;26;549;301;248
Ukmergė d. mun.;2002;27;542;263;279
Ukmergė d. mun.;2002;28;626;335;291
Ukmergė d. mun.;2002;29;596;292;304
Ukmergė d. mun.;2002;30;669;338;331
Ukmergė d. mun.;2002;31;672;355;317
Ukmergė d. mun.;2002;32;694;354;340
Ukmergė d. mun.;2002;33;591;315;276
Ukmergė d. mun.;2002;34;656;307;349
Ukmergė d. mun.;2002;35;719;352;367
Ukmergė d. mun.;2002;36;705;348;357
Ukmergė d. mun.;2002;37;701;343;358
Ukmergė d. mun.;2002;38;709;354;355
Ukmergė d. mun.;2002;39;733;352;381
Ukmergė d. mun.;2002;40;750;376;374
Ukmergė d. mun.;2002;41;716;358;358
Ukmergė d. mun.;2002;42;705;350;355
Ukmergė d. mun.;2002;43;700;338;362
Ukmergė d. mun.;2002;44;636;313;323
Ukmergė d. mun.;2002;45;576;291;285
Ukmergė d. mun.;2002;46;600;320;280
Ukmergė d. mun.;2002;47;511;258;253
Ukmergė d. mun.;2002;48;472;232;240
Ukmergė d. mun.;2002;49;570;271;299
Ukmergė d. mun.;2002;50;545;254;291
Ukmergė d. mun.;2002;51;582;276;306
Ukmergė d. mun.;2002;52;625;281;344
Ukmergė d. mun.;2002;53;559;240;319
Ukmergė d. mun.;2002;54;501;237;264
Ukmergė d. mun.;2002;55;491;234;257
Ukmergė d. mun.;2002;56;576;268;308
Ukmergė d. mun.;2002;57;518;229;289
Ukmergė d. mun.;2002;58;622;275;347
Ukmergė d. mun.;2002;59;650;256;394
Ukmergė d. mun.;2002;60;630;290;340
Ukmergė d. mun.;2002;61;600;253;347
Ukmergė d. mun.;2002;62;559;266;293
Ukmergė d. mun.;2002;63;595;244;351
Ukmergė d. mun.;2002;64;580;238;342
Ukmergė d. mun.;2002;65;588;260;328
Ukmergė d. mun.;2002;66;599;241;358
Ukmergė d. mun.;2002;67;537;209;328
Ukmergė d. mun.;2002;68;558;228;330
Ukmergė d. mun.;2002;69;606;220;386
Ukmergė d. mun.;2002;70;473;163;310
Ukmergė d. mun.;2002;71;534;197;337
Ukmergė d. mun.;2002;72;505;172;333
Ukmergė d. mun.;2002;73;491;186;305
Ukmergė d. mun.;2002;74;465;147;318
Ukmergė d. mun.;2002;75;419;122;297
Ukmergė d. mun.;2002;76;389;114;275
Ukmergė d. mun.;2002;77;385;111;274
Ukmergė d. mun.;2002;78;325;99;226
Ukmergė d. mun.;2002;79;320;99;221
Ukmergė d. mun.;2002;80;297;76;221
Ukmergė d. mun.;2002;81;252;82;170
Ukmergė d. mun.;2002;82;183;48;135
Ukmergė d. mun.;2002;83;115;36;79
Ukmergė d. mun.;2002;84;88;30;58
Ukmergė d. mun.;2002;85;685;174;511
Ukmergė d. mun.;2003;-1;47556;22167;25389
Ukmergė d. mun.;2003;0;354;183;171
Ukmergė d. mun.;2003;1;413;199;214
Ukmergė d. mun.;2003;2;393;197;196
Ukmergė d. mun.;2003;3;449;228;221
Ukmergė d. mun.;2003;4;463;252;211
Ukmergė d. mun.;2003;5;483;263;220
Ukmergė d. mun.;2003;6;454;227;227
Ukmergė d. mun.;2003;7;523;269;254
Ukmergė d. mun.;2003;8;541;278;263
Ukmergė d. mun.;2003;9;611;327;284
Ukmergė d. mun.;2003;10;689;347;342
Ukmergė d. mun.;2003;11;727;370;357
Ukmergė d. mun.;2003;12;710;372;338
Ukmergė d. mun.;2003;13;714;371;343
Ukmergė d. mun.;2003;14;723;350;373
Ukmergė d. mun.;2003;15;806;415;391
Ukmergė d. mun.;2003;16;774;396;378
Ukmergė d. mun.;2003;17;705;376;329
Ukmergė d. mun.;2003;18;740;369;371
Ukmergė d. mun.;2003;19;718;376;342
Ukmergė d. mun.;2003;20;562;286;276
Ukmergė d. mun.;2003;21;496;265;231
Ukmergė d. mun.;2003;22;472;237;235
Ukmergė d. mun.;2003;23;494;280;214
Ukmergė d. mun.;2003;24;489;255;234
Ukmergė d. mun.;2003;25;489;254;235
Ukmergė d. mun.;2003;26;510;259;251
Ukmergė d. mun.;2003;27;537;295;242
Ukmergė d. mun.;2003;28;540;264;276
Ukmergė d. mun.;2003;29;611;327;284
Ukmergė d. mun.;2003;30;587;286;301
Ukmergė d. mun.;2003;31;657;332;325
Ukmergė d. mun.;2003;32;669;349;320
Ukmergė d. mun.;2003;33;689;350;339
Ukmergė d. mun.;2003;34;580;308;272
Ukmergė d. mun.;2003;35;651;308;343
Ukmergė d. mun.;2003;36;714;353;361
Ukmergė d. mun.;2003;37;702;347;355
Ukmergė d. mun.;2003;38;688;336;352
Ukmergė d. mun.;2003;39;698;347;351
Ukmergė d. mun.;2003;40;728;349;379
Ukmergė d. mun.;2003;41;738;372;366
Ukmergė d. mun.;2003;42;711;355;356
Ukmergė d. mun.;2003;43;698;346;352
Ukmergė d. mun.;2003;44;694;337;357
Ukmergė d. mun.;2003;45;635;311;324
Ukmergė d. mun.;2003;46;571;289;282
Ukmergė d. mun.;2003;47;590;316;274
Ukmergė d. mun.;2003;48;506;256;250
Ukmergė d. mun.;2003;49;458;223;235
Ukmergė d. mun.;2003;50;563;270;293
Ukmergė d. mun.;2003;51;535;248;287
Ukmergė d. mun.;2003;52;573;270;303
Ukmergė d. mun.;2003;53;621;281;340
Ukmergė d. mun.;2003;54;552;234;318
Ukmergė d. mun.;2003;55;488;228;260
Ukmergė d. mun.;2003;56;485;229;256
Ukmergė d. mun.;2003;57;566;259;307
Ukmergė d. mun.;2003;58;512;222;290
Ukmergė d. mun.;2003;59;612;267;345
Ukmergė d. mun.;2003;60;632;244;388
Ukmergė d. mun.;2003;61;618;281;337
Ukmergė d. mun.;2003;62;592;247;345
Ukmergė d. mun.;2003;63;546;260;286
Ukmergė d. mun.;2003;64;585;234;351
Ukmergė d. mun.;2003;65;570;232;338
Ukmergė d. mun.;2003;66;579;253;326
Ukmergė d. mun.;2003;67;592;235;357
Ukmergė d. mun.;2003;68;523;197;326
Ukmergė d. mun.;2003;69;547;221;326
Ukmergė d. mun.;2003;70;591;208;383
Ukmergė d. mun.;2003;71;462;156;306
Ukmergė d. mun.;2003;72;517;190;327
Ukmergė d. mun.;2003;73;484;162;322
Ukmergė d. mun.;2003;74;476;176;300
Ukmergė d. mun.;2003;75;443;133;310
Ukmergė d. mun.;2003;76;402;121;281
Ukmergė d. mun.;2003;77;375;105;270
Ukmergė d. mun.;2003;78;357;97;260
Ukmergė d. mun.;2003;79;306;88;218
Ukmergė d. mun.;2003;80;297;89;208
Ukmergė d. mun.;2003;81;268;70;198
Ukmergė d. mun.;2003;82;232;72;160
Ukmergė d. mun.;2003;83;166;38;128
Ukmergė d. mun.;2003;84;98;34;64
Ukmergė d. mun.;2003;85;637;159;478
Ukmergė d. mun.;2004;-1;46920;21825;25095
Ukmergė d. mun.;2004;0;354;198;156
Ukmergė d. mun.;2004;1;357;185;172
Ukmergė d. mun.;2004;2;418;204;214
Ukmergė d. mun.;2004;3;397;196;201
Ukmergė d. mun.;2004;4;450;228;222
Ukmergė d. mun.;2004;5;468;257;211
Ukmergė d. mun.;2004;6;482;261;221
Ukmergė d. mun.;2004;7;458;228;230
Ukmergė d. mun.;2004;8;520;267;253
Ukmergė d. mun.;2004;9;546;279;267
Ukmergė d. mun.;2004;10;610;324;286
Ukmergė d. mun.;2004;11;687;341;346
Ukmergė d. mun.;2004;12;722;367;355
Ukmergė d. mun.;2004;13;701;371;330
Ukmergė d. mun.;2004;14;703;366;337
Ukmergė d. mun.;2004;15;711;349;362
Ukmergė d. mun.;2004;16;789;405;384
Ukmergė d. mun.;2004;17;753;386;367
Ukmergė d. mun.;2004;18;688;368;320
Ukmergė d. mun.;2004;19;728;361;367
Ukmergė d. mun.;2004;20;711;370;341
Ukmergė d. mun.;2004;21;547;281;266
Ukmergė d. mun.;2004;22;487;257;230
Ukmergė d. mun.;2004;23;472;232;240
Ukmergė d. mun.;2004;24;491;277;214
Ukmergė d. mun.;2004;25;474;246;228
Ukmergė d. mun.;2004;26;469;244;225
Ukmergė d. mun.;2004;27;500;257;243
Ukmergė d. mun.;2004;28;520;283;237
Ukmergė d. mun.;2004;29;521;255;266
Ukmergė d. mun.;2004;30;595;321;274
Ukmergė d. mun.;2004;31;563;267;296
Ukmergė d. mun.;2004;32;642;323;319
Ukmergė d. mun.;2004;33;661;343;318
Ukmergė d. mun.;2004;34;675;345;330
Ukmergė d. mun.;2004;35;576;309;267
Ukmergė d. mun.;2004;36;637;300;337
Ukmergė d. mun.;2004;37;697;346;351
Ukmergė d. mun.;2004;38;690;339;351
Ukmergė d. mun.;2004;39;684;335;349
Ukmergė d. mun.;2004;40;691;341;350
Ukmergė d. mun.;2004;41;716;343;373
Ukmergė d. mun.;2004;42;733;368;365
Ukmergė d. mun.;2004;43;702;348;354
Ukmergė d. mun.;2004;44;688;338;350
Ukmergė d. mun.;2004;45;700;342;358
Ukmergė d. mun.;2004;46;627;304;323
Ukmergė d. mun.;2004;47;560;280;280
Ukmergė d. mun.;2004;48;584;312;272
Ukmergė d. mun.;2004;49;497;247;250
Ukmergė d. mun.;2004;50;457;223;234
Ukmergė d. mun.;2004;51;554;263;291
Ukmergė d. mun.;2004;52;520;241;279
Ukmergė d. mun.;2004;53;568;266;302
Ukmergė d. mun.;2004;54;611;275;336
Ukmergė d. mun.;2004;55;541;224;317
Ukmergė d. mun.;2004;56;476;222;254
Ukmergė d. mun.;2004;57;478;227;251
Ukmergė d. mun.;2004;58;553;252;301
Ukmergė d. mun.;2004;59;505;217;288
Ukmergė d. mun.;2004;60;605;263;342
Ukmergė d. mun.;2004;61;615;234;381
Ukmergė d. mun.;2004;62;604;271;333
Ukmergė d. mun.;2004;63;580;241;339
Ukmergė d. mun.;2004;64;536;248;288
Ukmergė d. mun.;2004;65;575;230;345
Ukmergė d. mun.;2004;66;569;229;340
Ukmergė d. mun.;2004;67;564;243;321
Ukmergė d. mun.;2004;68;588;231;357
Ukmergė d. mun.;2004;69;514;190;324
Ukmergė d. mun.;2004;70;530;209;321
Ukmergė d. mun.;2004;71;581;203;378
Ukmergė d. mun.;2004;72;449;151;298
Ukmergė d. mun.;2004;73;505;183;322
Ukmergė d. mun.;2004;74;463;150;313
Ukmergė d. mun.;2004;75;458;164;294
Ukmergė d. mun.;2004;76;425;120;305
Ukmergė d. mun.;2004;77;383;114;269
Ukmergė d. mun.;2004;78;357;94;263
Ukmergė d. mun.;2004;79;336;88;248
Ukmergė d. mun.;2004;80;286;78;208
Ukmergė d. mun.;2004;81;275;79;196
Ukmergė d. mun.;2004;82;248;60;188
Ukmergė d. mun.;2004;83;204;60;144
Ukmergė d. mun.;2004;84;149;35;114
Ukmergė d. mun.;2004;85;606;153;453
Ukmergė d. mun.;2005;-1;46154;21457;24697
Ukmergė d. mun.;2005;0;347;184;163
Ukmergė d. mun.;2005;1;354;197;157
Ukmergė d. mun.;2005;2;354;183;171
Ukmergė d. mun.;2005;3;417;202;215
Ukmergė d. mun.;2005;4;397;197;200
Ukmergė d. mun.;2005;5;446;225;221
Ukmergė d. mun.;2005;6;463;254;209
Ukmergė d. mun.;2005;7;477;257;220
Ukmergė d. mun.;2005;8;450;220;230
Ukmergė d. mun.;2005;9;516;262;254
Ukmergė d. mun.;2005;10;544;279;265
Ukmergė d. mun.;2005;11;613;327;286
Ukmergė d. mun.;2005;12;677;337;340
Ukmergė d. mun.;2005;13;715;360;355
Ukmergė d. mun.;2005;14;693;370;323
Ukmergė d. mun.;2005;15;691;360;331
Ukmergė d. mun.;2005;16;700;345;355
Ukmergė d. mun.;2005;17;778;397;381
Ukmergė d. mun.;2005;18;736;376;360
Ukmergė d. mun.;2005;19;669;359;310
Ukmergė d. mun.;2005;20;707;350;357
Ukmergė d. mun.;2005;21;685;356;329
Ukmergė d. mun.;2005;22;524;271;253
Ukmergė d. mun.;2005;23;464;246;218
Ukmergė d. mun.;2005;24;458;227;231
Ukmergė d. mun.;2005;25;460;259;201
Ukmergė d. mun.;2005;26;455;239;216
Ukmergė d. mun.;2005;27;454;233;221
Ukmergė d. mun.;2005;28;487;248;239
Ukmergė d. mun.;2005;29;505;272;233
Ukmergė d. mun.;2005;30;502;255;247
Ukmergė d. mun.;2005;31;588;315;273
Ukmergė d. mun.;2005;32;546;261;285
Ukmergė d. mun.;2005;33;627;316;311
Ukmergė d. mun.;2005;34;649;339;310
Ukmergė d. mun.;2005;35;676;348;328
Ukmergė d. mun.;2005;36;559;299;260
Ukmergė d. mun.;2005;37;628;297;331
Ukmergė d. mun.;2005;38;696;342;354
Ukmergė d. mun.;2005;39;679;334;345
Ukmergė d. mun.;2005;40;672;326;346
Ukmergė d. mun.;2005;41;677;332;345
Ukmergė d. mun.;2005;42;712;341;371
Ukmergė d. mun.;2005;43;725;363;362
Ukmergė d. mun.;2005;44;697;345;352
Ukmergė d. mun.;2005;45;682;336;346
Ukmergė d. mun.;2005;46;695;345;350
Ukmergė d. mun.;2005;47;622;302;320
Ukmergė d. mun.;2005;48;552;277;275
Ukmergė d. mun.;2005;49;584;308;276
Ukmergė d. mun.;2005;50;499;248;251
Ukmergė d. mun.;2005;51;450;217;233
Ukmergė d. mun.;2005;52;547;260;287
Ukmergė d. mun.;2005;53;518;240;278
Ukmergė d. mun.;2005;54;561;262;299
Ukmergė d. mun.;2005;55;603;272;331
Ukmergė d. mun.;2005;56;542;223;319
Ukmergė d. mun.;2005;57;470;217;253
Ukmergė d. mun.;2005;58;473;225;248
Ukmergė d. mun.;2005;59;545;247;298
Ukmergė d. mun.;2005;60;501;214;287
Ukmergė d. mun.;2005;61;596;258;338
Ukmergė d. mun.;2005;62;602;226;376
Ukmergė d. mun.;2005;63;588;265;323
Ukmergė d. mun.;2005;64;570;236;334
Ukmergė d. mun.;2005;65;530;242;288
Ukmergė d. mun.;2005;66;556;216;340
Ukmergė d. mun.;2005;67;560;223;337
Ukmergė d. mun.;2005;68;547;231;316
Ukmergė d. mun.;2005;69;566;221;345
Ukmergė d. mun.;2005;70;498;180;318
Ukmergė d. mun.;2005;71;516;202;314
Ukmergė d. mun.;2005;72;556;187;369
Ukmergė d. mun.;2005;73;438;146;292
Ukmergė d. mun.;2005;74;477;167;310
Ukmergė d. mun.;2005;75;439;137;302
Ukmergė d. mun.;2005;76;438;151;287
Ukmergė d. mun.;2005;77;405;110;295
Ukmergė d. mun.;2005;78;363;104;259
Ukmergė d. mun.;2005;79;340;86;254
Ukmergė d. mun.;2005;80;320;80;240
Ukmergė d. mun.;2005;81;263;70;193
Ukmergė d. mun.;2005;82;259;72;187
Ukmergė d. mun.;2005;83;227;54;173
Ukmergė d. mun.;2005;84;182;52;130
Ukmergė d. mun.;2005;85;605;143;462
Ukmergė d. mun.;2006;-1;45142;21039;24103
Ukmergė d. mun.;2006;0;356;190;166
Ukmergė d. mun.;2006;1;344;185;159
Ukmergė d. mun.;2006;2;343;194;149
Ukmergė d. mun.;2006;3;348;179;169
Ukmergė d. mun.;2006;4;408;199;209
Ukmergė d. mun.;2006;5;393;196;197
Ukmergė d. mun.;2006;6;441;225;216
Ukmergė d. mun.;2006;7;461;253;208
Ukmergė d. mun.;2006;8;473;256;217
Ukmergė d. mun.;2006;9;445;219;226
Ukmergė d. mun.;2006;10;517;262;255
Ukmergė d. mun.;2006;11;541;279;262
Ukmergė d. mun.;2006;12;612;326;286
Ukmergė d. mun.;2006;13;665;330;335
Ukmergė d. mun.;2006;14;703;355;348
Ukmergė d. mun.;2006;15;671;357;314
Ukmergė d. mun.;2006;16;673;349;324
Ukmergė d. mun.;2006;17;683;336;347
Ukmergė d. mun.;2006;18;748;382;366
Ukmergė d. mun.;2006;19;702;360;342
Ukmergė d. mun.;2006;20;631;341;290
Ukmergė d. mun.;2006;21;665;335;330
Ukmergė d. mun.;2006;22;650;340;310
Ukmergė d. mun.;2006;23;506;260;246
Ukmergė d. mun.;2006;24;429;226;203
Ukmergė d. mun.;2006;25;438;218;220
Ukmergė d. mun.;2006;26;434;247;187
Ukmergė d. mun.;2006;27;437;231;206
Ukmergė d. mun.;2006;28;434;226;208
Ukmergė d. mun.;2006;29;475;241;234
Ukmergė d. mun.;2006;30;498;270;228
Ukmergė d. mun.;2006;31;492;249;243
Ukmergė d. mun.;2006;32;566;305;261
Ukmergė d. mun.;2006;33;532;251;281
Ukmergė d. mun.;2006;34;615;313;302
Ukmergė d. mun.;2006;35;628;329;299
Ukmergė d. mun.;2006;36;662;334;328
Ukmergė d. mun.;2006;37;553;294;259
Ukmergė d. mun.;2006;38;616;291;325
Ukmergė d. mun.;2006;39;681;336;345
Ukmergė d. mun.;2006;40;668;328;340
Ukmergė d. mun.;2006;41;655;318;337
Ukmergė d. mun.;2006;42;664;329;335
Ukmergė d. mun.;2006;43;696;335;361
Ukmergė d. mun.;2006;44;712;353;359
Ukmergė d. mun.;2006;45;689;341;348
Ukmergė d. mun.;2006;46;669;327;342
Ukmergė d. mun.;2006;47;688;341;347
Ukmergė d. mun.;2006;48;622;304;318
Ukmergė d. mun.;2006;49;543;269;274
Ukmergė d. mun.;2006;50;574;305;269
Ukmergė d. mun.;2006;51;494;247;247
Ukmergė d. mun.;2006;52;439;210;229
Ukmergė d. mun.;2006;53;533;253;280
Ukmergė d. mun.;2006;54;507;232;275
Ukmergė d. mun.;2006;55;551;259;292
Ukmergė d. mun.;2006;56;594;264;330
Ukmergė d. mun.;2006;57;533;221;312
Ukmergė d. mun.;2006;58;467;216;251
Ukmergė d. mun.;2006;59;460;218;242
Ukmergė d. mun.;2006;60;528;241;287
Ukmergė d. mun.;2006;61;491;208;283
Ukmergė d. mun.;2006;62;579;248;331
Ukmergė d. mun.;2006;63;591;220;371
Ukmergė d. mun.;2006;64;579;260;319
Ukmergė d. mun.;2006;65;552;223;329
Ukmergė d. mun.;2006;66;517;236;281
Ukmergė d. mun.;2006;67;550;210;340
Ukmergė d. mun.;2006;68;547;214;333
Ukmergė d. mun.;2006;69;531;224;307
Ukmergė d. mun.;2006;70;544;208;336
Ukmergė d. mun.;2006;71;489;174;315
Ukmergė d. mun.;2006;72;495;190;305
Ukmergė d. mun.;2006;73;529;176;353
Ukmergė d. mun.;2006;74;417;137;280
Ukmergė d. mun.;2006;75;457;155;302
Ukmergė d. mun.;2006;76;417;128;289
Ukmergė d. mun.;2006;77;416;144;272
Ukmergė d. mun.;2006;78;395;106;289
Ukmergė d. mun.;2006;79;336;99;237
Ukmergė d. mun.;2006;80;318;77;241
Ukmergė d. mun.;2006;81;307;74;233
Ukmergė d. mun.;2006;82;244;63;181
Ukmergė d. mun.;2006;83;239;69;170
Ukmergė d. mun.;2006;84;203;48;155
Ukmergė d. mun.;2006;85;644;168;476
Ukmergė d. mun.;2007;-1;44350;20611;23739
Ukmergė d. mun.;2007;0;324;160;164
Ukmergė d. mun.;2007;1;351;189;162
Ukmergė d. mun.;2007;2;338;180;158
Ukmergė d. mun.;2007;3;341;193;148
Ukmergė d. mun.;2007;4;345;178;167
Ukmergė d. mun.;2007;5;404;193;211
Ukmergė d. mun.;2007;6;390;190;200
Ukmergė d. mun.;2007;7;433;222;211
Ukmergė d. mun.;2007;8;457;250;207
Ukmergė d. mun.;2007;9;471;254;217
Ukmergė d. mun.;2007;10;448;220;228
Ukmergė d. mun.;2007;11;514;261;253
Ukmergė d. mun.;2007;12;538;277;261
Ukmergė d. mun.;2007;13;612;327;285
Ukmergė d. mun.;2007;14;662;330;332
Ukmergė d. mun.;2007;15;702;352;350
Ukmergė d. mun.;2007;16;662;353;309
Ukmergė d. mun.;2007;17;662;344;318
Ukmergė d. mun.;2007;18;677;333;344
Ukmergė d. mun.;2007;19;736;376;360
Ukmergė d. mun.;2007;20;681;348;333
Ukmergė d. mun.;2007;21;616;334;282
Ukmergė d. mun.;2007;22;652;329;323
Ukmergė d. mun.;2007;23;634;330;304
Ukmergė d. mun.;2007;24;486;249;237
Ukmergė d. mun.;2007;25;404;215;189
Ukmergė d. mun.;2007;26;415;204;211
Ukmergė d. mun.;2007;27;420;239;181
Ukmergė d. mun.;2007;28;415;222;193
Ukmergė d. mun.;2007;29;431;218;213
Ukmergė d. mun.;2007;30;470;236;234
Ukmergė d. mun.;2007;31;488;267;221
Ukmergė d. mun.;2007;32;478;240;238
Ukmergė d. mun.;2007;33;555;298;257
Ukmergė d. mun.;2007;34;528;246;282
Ukmergė d. mun.;2007;35;610;308;302
Ukmergė d. mun.;2007;36;621;325;296
Ukmergė d. mun.;2007;37;653;332;321
Ukmergė d. mun.;2007;38;543;287;256
Ukmergė d. mun.;2007;39;607;288;319
Ukmergė d. mun.;2007;40;661;323;338
Ukmergė d. mun.;2007;41;664;324;340
Ukmergė d. mun.;2007;42;648;314;334
Ukmergė d. mun.;2007;43;658;325;333
Ukmergė d. mun.;2007;44;689;330;359
Ukmergė d. mun.;2007;45;707;347;360
Ukmergė d. mun.;2007;46;687;341;346
Ukmergė d. mun.;2007;47;663;324;339
Ukmergė d. mun.;2007;48;681;337;344
Ukmergė d. mun.;2007;49;619;302;317
Ukmergė d. mun.;2007;50;539;263;276
Ukmergė d. mun.;2007;51;564;299;265
Ukmergė d. mun.;2007;52;489;243;246
Ukmergė d. mun.;2007;53;439;210;229
Ukmergė d. mun.;2007;54;527;247;280
Ukmergė d. mun.;2007;55;500;225;275
Ukmergė d. mun.;2007;56;539;251;288
Ukmergė d. mun.;2007;57;590;260;330
Ukmergė d. mun.;2007;58;524;215;309
Ukmergė d. mun.;2007;59;456;206;250
Ukmergė d. mun.;2007;60;452;212;240
Ukmergė d. mun.;2007;61;513;236;277
Ukmergė d. mun.;2007;62;478;199;279
Ukmergė d. mun.;2007;63;569;239;330
Ukmergė d. mun.;2007;64;576;210;366
Ukmergė d. mun.;2007;65;567;255;312
Ukmergė d. mun.;2007;66;535;206;329
Ukmergė d. mun.;2007;67;493;224;269
Ukmergė d. mun.;2007;68;533;197;336
Ukmergė d. mun.;2007;69;532;212;320
Ukmergė d. mun.;2007;70;525;221;304
Ukmergė d. mun.;2007;71;522;196;326
Ukmergė d. mun.;2007;72;475;162;313
Ukmergė d. mun.;2007;73;472;180;292
Ukmergė d. mun.;2007;74;504;163;341
Ukmergė d. mun.;2007;75;400;128;272
Ukmergė d. mun.;2007;76;426;138;288
Ukmergė d. mun.;2007;77;390;113;277
Ukmergė d. mun.;2007;78;387;128;259
Ukmergė d. mun.;2007;79;368;102;266
Ukmergė d. mun.;2007;80;311;88;223
Ukmergė d. mun.;2007;81;293;70;223
Ukmergė d. mun.;2007;82;284;67;217
Ukmergė d. mun.;2007;83;228;51;177
Ukmergė d. mun.;2007;84;216;65;151
Ukmergė d. mun.;2007;85;683;166;517
Ukmergė d. mun.;2008;-1;43643;20263;23380
Ukmergė d. mun.;2008;0;350;181;169
Ukmergė d. mun.;2008;1;319;156;163
Ukmergė d. mun.;2008;2;355;189;166
Ukmergė d. mun.;2008;3;345;183;162
Ukmergė d. mun.;2008;4;342;197;145
Ukmergė d. mun.;2008;5;340;175;165
Ukmergė d. mun.;2008;6;397;189;208
Ukmergė d. mun.;2008;7;393;190;203
Ukmergė d. mun.;2008;8;439;226;213
Ukmergė d. mun.;2008;9;457;251;206
Ukmergė d. mun.;2008;10;468;253;215
Ukmergė d. mun.;2008;11;444;217;227
Ukmergė d. mun.;2008;12;513;260;253
Ukmergė d. mun.;2008;13;539;280;259
Ukmergė d. mun.;2008;14;609;326;283
Ukmergė d. mun.;2008;15;662;331;331
Ukmergė d. mun.;2008;16;702;351;351
Ukmergė d. mun.;2008;17;654;351;303
Ukmergė d. mun.;2008;18;650;339;311
Ukmergė d. mun.;2008;19;661;327;334
Ukmergė d. mun.;2008;20;723;372;351
Ukmergė d. mun.;2008;21;667;343;324
Ukmergė d. mun.;2008;22;599;322;277
Ukmergė d. mun.;2008;23;648;324;324
Ukmergė d. mun.;2008;24;616;323;293
Ukmergė d. mun.;2008;25;478;246;232
Ukmergė d. mun.;2008;26;406;215;191
Ukmergė d. mun.;2008;27;396;196;200
Ukmergė d. mun.;2008;28;412;235;177
Ukmergė d. mun.;2008;29;408;214;194
Ukmergė d. mun.;2008;30;429;219;210
Ukmergė d. mun.;2008;31;460;233;227
Ukmergė d. mun.;2008;32;479;260;219
Ukmergė d. mun.;2008;33;479;239;240
Ukmergė d. mun.;2008;34;545;291;254
Ukmergė d. mun.;2008;35;529;249;280
Ukmergė d. mun.;2008;36;603;306;297
Ukmergė d. mun.;2008;37;614;320;294
Ukmergė d. mun.;2008;38;640;326;314
Ukmergė d. mun.;2008;39;538;286;252
Ukmergė d. mun.;2008;40;601;282;319
Ukmergė d. mun.;2008;41;656;322;334
Ukmergė d. mun.;2008;42;653;316;337
Ukmergė d. mun.;2008;43;629;305;324
Ukmergė d. mun.;2008;44;650;319;331
Ukmergė d. mun.;2008;45;684;325;359
Ukmergė d. mun.;2008;46;689;335;354
Ukmergė d. mun.;2008;47;688;343;345
Ukmergė d. mun.;2008;48;654;316;338
Ukmergė d. mun.;2008;49;677;335;342
Ukmergė d. mun.;2008;50;615;302;313
Ukmergė d. mun.;2008;51;531;257;274
Ukmergė d. mun.;2008;52;548;290;258
Ukmergė d. mun.;2008;53;478;236;242
Ukmergė d. mun.;2008;54;432;202;230
Ukmergė d. mun.;2008;55;514;238;276
Ukmergė d. mun.;2008;56;494;220;274
Ukmergė d. mun.;2008;57;529;242;287
Ukmergė d. mun.;2008;58;579;252;327
Ukmergė d. mun.;2008;59;515;209;306
Ukmergė d. mun.;2008;60;447;197;250
Ukmergė d. mun.;2008;61;434;197;237
Ukmergė d. mun.;2008;62;497;224;273
Ukmergė d. mun.;2008;63;465;188;277
Ukmergė d. mun.;2008;64;553;232;321
Ukmergė d. mun.;2008;65;561;202;359
Ukmergė d. mun.;2008;66;556;249;307
Ukmergė d. mun.;2008;67;525;202;323
Ukmergė d. mun.;2008;68;473;208;265
Ukmergė d. mun.;2008;69;521;188;333
Ukmergė d. mun.;2008;70;509;193;316
Ukmergė d. mun.;2008;71;510;211;299
Ukmergė d. mun.;2008;72;508;188;320
Ukmergė d. mun.;2008;73;464;158;306
Ukmergė d. mun.;2008;74;443;163;280
Ukmergė d. mun.;2008;75;487;157;330
Ukmergė d. mun.;2008;76;386;119;267
Ukmergė d. mun.;2008;77;405;130;275
Ukmergė d. mun.;2008;78;373;108;265
Ukmergė d. mun.;2008;79;351;110;241
Ukmergė d. mun.;2008;80;346;95;251
Ukmergė d. mun.;2008;81;281;73;208
Ukmergė d. mun.;2008;82;264;59;205
Ukmergė d. mun.;2008;83;254;62;192
Ukmergė d. mun.;2008;84;197;42;155
Ukmergė d. mun.;2008;85;709;171;538
Ukmergė d. mun.;2009;-1;42893;19883;23010
Ukmergė d. mun.;2009;0;377;177;200
Ukmergė d. mun.;2009;1;342;176;166
Ukmergė d. mun.;2009;2;316;155;161
Ukmergė d. mun.;2009;3;354;187;167
Ukmergė d. mun.;2009;4;337;177;160
Ukmergė d. mun.;2009;5;335;193;142
Ukmergė d. mun.;2009;6;337;176;161
Ukmergė d. mun.;2009;7;399;191;208
Ukmergė d. mun.;2009;8;392;190;202
Ukmergė d. mun.;2009;9;434;225;209
Ukmergė d. mun.;2009;10;457;251;206
Ukmergė d. mun.;2009;11;467;251;216
Ukmergė d. mun.;2009;12;439;217;222
Ukmergė d. mun.;2009;13;508;258;250
Ukmergė d. mun.;2009;14;537;277;260
Ukmergė d. mun.;2009;15;602;319;283
Ukmergė d. mun.;2009;16;665;334;331
Ukmergė d. mun.;2009;17;698;349;349
Ukmergė d. mun.;2009;18;654;353;301
Ukmergė d. mun.;2009;19;642;335;307
Ukmergė d. mun.;2009;20;648;320;328
Ukmergė d. mun.;2009;21;708;368;340
Ukmergė d. mun.;2009;22;657;338;319
Ukmergė d. mun.;2009;23;586;317;269
Ukmergė d. mun.;2009;24;630;318;312
Ukmergė d. mun.;2009;25;596;314;282
Ukmergė d. mun.;2009;26;453;230;223
Ukmergė d. mun.;2009;27;384;210;174
Ukmergė d. mun.;2009;28;384;189;195
Ukmergė d. mun.;2009;29;396;229;167
Ukmergė d. mun.;2009;30;395;212;183
Ukmergė d. mun.;2009;31;419;216;203
Ukmergė d. mun.;2009;32;456;231;225
Ukmergė d. mun.;2009;33;467;253;214
Ukmergė d. mun.;2009;34;468;236;232
Ukmergė d. mun.;2009;35;532;280;252
Ukmergė d. mun.;2009;36;524;242;282
Ukmergė d. mun.;2009;37;592;300;292
Ukmergė d. mun.;2009;38;609;313;296
Ukmergė d. mun.;2009;39;638;321;317
Ukmergė d. mun.;2009;40;538;288;250
Ukmergė d. mun.;2009;41;592;277;315
Ukmergė d. mun.;2009;42;644;316;328
Ukmergė d. mun.;2009;43;644;306;338
Ukmergė d. mun.;2009;44;617;297;320
Ukmergė d. mun.;2009;45;645;313;332
Ukmergė d. mun.;2009;46;669;314;355
Ukmergė d. mun.;2009;47;682;331;351
Ukmergė d. mun.;2009;48;680;337;343
Ukmergė d. mun.;2009;49;648;313;335
Ukmergė d. mun.;2009;50;666;330;336
Ukmergė d. mun.;2009;51;606;292;314
Ukmergė d. mun.;2009;52;525;251;274
Ukmergė d. mun.;2009;53;535;282;253
Ukmergė d. mun.;2009;54;474;235;239
Ukmergė d. mun.;2009;55;417;190;227
Ukmergė d. mun.;2009;56;504;229;275
Ukmergė d. mun.;2009;57;487;217;270
Ukmergė d. mun.;2009;58;517;236;281
Ukmergė d. mun.;2009;59;564;240;324
Ukmergė d. mun.;2009;60;509;205;304
Ukmergė d. mun.;2009;61;435;192;243
Ukmergė d. mun.;2009;62;427;193;234
Ukmergė d. mun.;2009;63;480;211;269
Ukmergė d. mun.;2009;64;451;181;270
Ukmergė d. mun.;2009;65;537;223;314
Ukmergė d. mun.;2009;66;538;185;353
Ukmergė d. mun.;2009;67;544;239;305
Ukmergė d. mun.;2009;68;518;199;319
Ukmergė d. mun.;2009;69;463;206;257
Ukmergė d. mun.;2009;70;505;177;328
Ukmergė d. mun.;2009;71;493;183;310
Ukmergė d. mun.;2009;72;481;188;293
Ukmergė d. mun.;2009;73;491;176;315
Ukmergė d. mun.;2009;74;441;148;293
Ukmergė d. mun.;2009;75;424;154;270
Ukmergė d. mun.;2009;76;464;148;316
Ukmergė d. mun.;2009;77;371;107;264
Ukmergė d. mun.;2009;78;376;123;253
Ukmergė d. mun.;2009;79;350;101;249
Ukmergė d. mun.;2009;80;325;100;225
Ukmergė d. mun.;2009;81;320;83;237
Ukmergė d. mun.;2009;82;265;66;199
Ukmergė d. mun.;2009;83;233;50;183
Ukmergė d. mun.;2009;84;223;55;168
Ukmergė d. mun.;2009;85;741;168;573
Ukmergė d. mun.;2010;-1;42042;19420;22622
Ukmergė d. mun.;2010;0;370;182;188
Ukmergė d. mun.;2010;1;367;170;197
Ukmergė d. mun.;2010;2;334;173;161
Ukmergė d. mun.;2010;3;314;154;160
Ukmergė d. mun.;2010;4;349;185;164
Ukmergė d. mun.;2010;5;329;174;155
Ukmergė d. mun.;2010;6;329;189;140
Ukmergė d. mun.;2010;7;335;175;160
Ukmergė d. mun.;2010;8;397;191;206
Ukmergė d. mun.;2010;9;391;190;201
Ukmergė d. mun.;2010;10;427;220;207
Ukmergė d. mun.;2010;11;455;249;206
Ukmergė d. mun.;2010;12;462;249;213
Ukmergė d. mun.;2010;13;438;214;224
Ukmergė d. mun.;2010;14;504;256;248
Ukmergė d. mun.;2010;15;529;274;255
Ukmergė d. mun.;2010;16;596;314;282
Ukmergė d. mun.;2010;17;656;326;330
Ukmergė d. mun.;2010;18;694;349;345
Ukmergė d. mun.;2010;19;643;345;298
Ukmergė d. mun.;2010;20;628;328;300
Ukmergė d. mun.;2010;21;631;314;317
Ukmergė d. mun.;2010;22;683;352;331
Ukmergė d. mun.;2010;23;633;326;307
Ukmergė d. mun.;2010;24;555;296;259
Ukmergė d. mun.;2010;25;596;304;292
Ukmergė d. mun.;2010;26;567;298;269
Ukmergė d. mun.;2010;27;426;220;206
Ukmergė d. mun.;2010;28;360;196;164
Ukmergė d. mun.;2010;29;365;178;187
Ukmergė d. mun.;2010;30;381;223;158
Ukmergė d. mun.;2010;31;375;200;175
Ukmergė d. mun.;2010;32;406;211;195
Ukmergė d. mun.;2010;33;444;224;220
Ukmergė d. mun.;2010;34;454;242;212
Ukmergė d. mun.;2010;35;456;231;225
Ukmergė d. mun.;2010;36;520;275;245
Ukmergė d. mun.;2010;37;521;239;282
Ukmergė d. mun.;2010;38;579;288;291
Ukmergė d. mun.;2010;39;594;302;292
Ukmergė d. mun.;2010;40;627;315;312
Ukmergė d. mun.;2010;41;535;287;248
Ukmergė d. mun.;2010;42;587;272;315
Ukmergė d. mun.;2010;43;630;307;323
Ukmergė d. mun.;2010;44;635;300;335
Ukmergė d. mun.;2010;45;610;296;314
Ukmergė d. mun.;2010;46;639;308;331
Ukmergė d. mun.;2010;47;660;309;351
Ukmergė d. mun.;2010;48;679;328;351
Ukmergė d. mun.;2010;49;664;327;337
Ukmergė d. mun.;2010;50;642;307;335
Ukmergė d. mun.;2010;51;657;327;330
Ukmergė d. mun.;2010;52;602;290;312
Ukmergė d. mun.;2010;53;520;248;272
Ukmergė d. mun.;2010;54;525;275;250
Ukmergė d. mun.;2010;55;464;226;238
Ukmergė d. mun.;2010;56;408;183;225
Ukmergė d. mun.;2010;57;500;224;276
Ukmergė d. mun.;2010;58;481;210;271
Ukmergė d. mun.;2010;59;508;233;275
Ukmergė d. mun.;2010;60;551;229;322
Ukmergė d. mun.;2010;61;497;198;299
Ukmergė d. mun.;2010;62;421;182;239
Ukmergė d. mun.;2010;63;418;188;230
Ukmergė d. mun.;2010;64;469;202;267
Ukmergė d. mun.;2010;65;443;175;268
Ukmergė d. mun.;2010;66;518;211;307
Ukmergė d. mun.;2010;67;516;167;349
Ukmergė d. mun.;2010;68;524;225;299
Ukmergė d. mun.;2010;69;507;192;315
Ukmergė d. mun.;2010;70;449;197;252
Ukmergė d. mun.;2010;71;489;166;323
Ukmergė d. mun.;2010;72;479;172;307
Ukmergė d. mun.;2010;73;467;182;285
Ukmergė d. mun.;2010;74;484;172;312
Ukmergė d. mun.;2010;75;419;135;284
Ukmergė d. mun.;2010;76;404;144;260
Ukmergė d. mun.;2010;77;431;129;302
Ukmergė d. mun.;2010;78;351;98;253
Ukmergė d. mun.;2010;79;361;117;244
Ukmergė d. mun.;2010;80;330;97;233
Ukmergė d. mun.;2010;81;296;88;208
Ukmergė d. mun.;2010;82;297;77;220
Ukmergė d. mun.;2010;83;244;59;185
Ukmergė d. mun.;2010;84;210;41;169
Ukmergė d. mun.;2010;85;801;179;622
Ukmergė d. mun.;2011;-1;40270;18567;21703
Ukmergė d. mun.;2011;0;293;139;154
Ukmergė d. mun.;2011;1;337;166;171
Ukmergė d. mun.;2011;2;345;159;186
Ukmergė d. mun.;2011;3;312;163;149
Ukmergė d. mun.;2011;4;285;141;144
Ukmergė d. mun.;2011;5;331;172;159
Ukmergė d. mun.;2011;6;301;154;147
Ukmergė d. mun.;2011;7;320;182;138
Ukmergė d. mun.;2011;8;316;175;141
Ukmergė d. mun.;2011;9;375;191;184
Ukmergė d. mun.;2011;10;386;200;186
Ukmergė d. mun.;2011;11;427;220;207
Ukmergė d. mun.;2011;12;434;227;207
Ukmergė d. mun.;2011;13;465;253;212
Ukmergė d. mun.;2011;14;435;218;217
Ukmergė d. mun.;2011;15;500;259;241
Ukmergė d. mun.;2011;16;521;271;250
Ukmergė d. mun.;2011;17;585;312;273
Ukmergė d. mun.;2011;18;625;317;308
Ukmergė d. mun.;2011;19;555;299;256
Ukmergė d. mun.;2011;20;526;303;223
Ukmergė d. mun.;2011;21;540;283;257
Ukmergė d. mun.;2011;22;511;261;250
Ukmergė d. mun.;2011;23;571;324;247
Ukmergė d. mun.;2011;24;497;274;223
Ukmergė d. mun.;2011;25;400;218;182
Ukmergė d. mun.;2011;26;421;225;196
Ukmergė d. mun.;2011;27;396;211;185
Ukmergė d. mun.;2011;28;371;190;181
Ukmergė d. mun.;2011;29;351;176;175
Ukmergė d. mun.;2011;30;354;174;180
Ukmergė d. mun.;2011;31;373;202;171
Ukmergė d. mun.;2011;32;384;183;201
Ukmergė d. mun.;2011;33;404;203;201
Ukmergė d. mun.;2011;34;413;207;206
Ukmergė d. mun.;2011;35;439;227;212
Ukmergė d. mun.;2011;36;455;219;236
Ukmergė d. mun.;2011;37;538;274;264
Ukmergė d. mun.;2011;38;531;245;286
Ukmergė d. mun.;2011;39;586;294;292
Ukmergė d. mun.;2011;40;609;304;305
Ukmergė d. mun.;2011;41;649;322;327
Ukmergė d. mun.;2011;42;553;297;256
Ukmergė d. mun.;2011;43;615;291;324
Ukmergė d. mun.;2011;44;619;305;314
Ukmergė d. mun.;2011;45;632;309;323
Ukmergė d. mun.;2011;46;632;307;325
Ukmergė d. mun.;2011;47;640;322;318
Ukmergė d. mun.;2011;48;639;302;337
Ukmergė d. mun.;2011;49;691;339;352
Ukmergė d. mun.;2011;50;645;322;323
Ukmergė d. mun.;2011;51;658;319;339
Ukmergė d. mun.;2011;52;636;300;336
Ukmergė d. mun.;2011;53;582;277;305
Ukmergė d. mun.;2011;54;533;260;273
Ukmergė d. mun.;2011;55;530;282;248
Ukmergė d. mun.;2011;56;441;204;237
Ukmergė d. mun.;2011;57;422;196;226
Ukmergė d. mun.;2011;58;501;218;283
Ukmergė d. mun.;2011;59;506;223;283
Ukmergė d. mun.;2011;60;505;222;283
Ukmergė d. mun.;2011;61;535;215;320
Ukmergė d. mun.;2011;62;475;182;293
Ukmergė d. mun.;2011;63;409;176;233
Ukmergė d. mun.;2011;64;423;182;241
Ukmergė d. mun.;2011;65;465;188;277
Ukmergė d. mun.;2011;66;441;175;266
Ukmergė d. mun.;2011;67;508;202;306
Ukmergė d. mun.;2011;68;525;172;353
Ukmergė d. mun.;2011;69;499;207;292
Ukmergė d. mun.;2011;70;480;183;297
Ukmergė d. mun.;2011;71;445;191;254
Ukmergė d. mun.;2011;72;468;154;314
Ukmergė d. mun.;2011;73;444;152;292
Ukmergė d. mun.;2011;74;447;167;280
Ukmergė d. mun.;2011;75;451;156;295
Ukmergė d. mun.;2011;76;407;128;279
Ukmergė d. mun.;2011;77;392;137;255
Ukmergė d. mun.;2011;78;407;114;293
Ukmergė d. mun.;2011;79;322;85;237
Ukmergė d. mun.;2011;80;338;104;234
Ukmergė d. mun.;2011;81;316;87;229
Ukmergė d. mun.;2011;82;269;75;194
Ukmergė d. mun.;2011;83;269;75;194
Ukmergė d. mun.;2011;84;217;49;168
Ukmergė d. mun.;2011;85;871;179;692
Ukmergė d. mun.;2012;-1;39222;18062;21160
Ukmergė d. mun.;2012;0;305;156;149
Ukmergė d. mun.;2012;1;297;137;160
Ukmergė d. mun.;2012;2;325;157;168
Ukmergė d. mun.;2012;3;330;152;178
Ukmergė d. mun.;2012;4;296;152;144
Ukmergė d. mun.;2012;5;270;134;136
Ukmergė d. mun.;2012;6;327;168;159
Ukmergė d. mun.;2012;7;298;154;144
Ukmergė d. mun.;2012;8;316;179;137
Ukmergė d. mun.;2012;9;317;175;142
Ukmergė d. mun.;2012;10;379;194;185
Ukmergė d. mun.;2012;11;381;198;183
Ukmergė d. mun.;2012;12;414;217;197
Ukmergė d. mun.;2012;13;430;224;206
Ukmergė d. mun.;2012;14;466;253;213
Ukmergė d. mun.;2012;15;427;213;214
Ukmergė d. mun.;2012;16;501;262;239
Ukmergė d. mun.;2012;17;520;270;250
Ukmergė d. mun.;2012;18;572;304;268
Ukmergė d. mun.;2012;19;604;309;295
Ukmergė d. mun.;2012;20;530;287;243
Ukmergė d. mun.;2012;21;491;290;201
Ukmergė d. mun.;2012;22;506;265;241
Ukmergė d. mun.;2012;23;468;241;227
Ukmergė d. mun.;2012;24;545;311;234
Ukmergė d. mun.;2012;25;449;248;201
Ukmergė d. mun.;2012;26;345;188;157
Ukmergė d. mun.;2012;27;384;203;181
Ukmergė d. mun.;2012;28;363;189;174
Ukmergė d. mun.;2012;29;364;185;179
Ukmergė d. mun.;2012;30;333;170;163
Ukmergė d. mun.;2012;31;346;172;174
Ukmergė d. mun.;2012;32;353;189;164
Ukmergė d. mun.;2012;33;343;168;175
Ukmergė d. mun.;2012;34;394;194;200
Ukmergė d. mun.;2012;35;394;199;195
Ukmergė d. mun.;2012;36;432;224;208
Ukmergė d. mun.;2012;37;443;206;237
Ukmergė d. mun.;2012;38;521;265;256
Ukmergė d. mun.;2012;39;519;235;284
Ukmergė d. mun.;2012;40;567;283;284
Ukmergė d. mun.;2012;41;603;298;305
Ukmergė d. mun.;2012;42;636;315;321
Ukmergė d. mun.;2012;43;543;290;253
Ukmergė d. mun.;2012;44;607;286;321
Ukmergė d. mun.;2012;45;609;301;308
Ukmergė d. mun.;2012;46;626;308;318
Ukmergė d. mun.;2012;47;620;301;319
Ukmergė d. mun.;2012;48;635;315;320
Ukmergė d. mun.;2012;49;627;297;330
Ukmergė d. mun.;2012;50;677;331;346
Ukmergė d. mun.;2012;51;626;309;317
Ukmergė d. mun.;2012;52;653;315;338
Ukmergė d. mun.;2012;53;631;298;333
Ukmergė d. mun.;2012;54;571;270;301
Ukmergė d. mun.;2012;55;522;254;268
Ukmergė d. mun.;2012;56;524;279;245
Ukmergė d. mun.;2012;57;438;200;238
Ukmergė d. mun.;2012;58;416;193;223
Ukmergė d. mun.;2012;59;492;211;281
Ukmergė d. mun.;2012;60;494;216;278
Ukmergė d. mun.;2012;61;497;219;278
Ukmergė d. mun.;2012;62;530;211;319
Ukmergė d. mun.;2012;63;469;178;291
Ukmergė d. mun.;2012;64;403;171;232
Ukmergė d. mun.;2012;65;416;174;242
Ukmergė d. mun.;2012;66;455;180;275
Ukmergė d. mun.;2012;67;428;168;260
Ukmergė d. mun.;2012;68;496;197;299
Ukmergė d. mun.;2012;69;509;163;346
Ukmergė d. mun.;2012;70;481;198;283
Ukmergė d. mun.;2012;71;470;177;293
Ukmergė d. mun.;2012;72;435;183;252
Ukmergė d. mun.;2012;73;452;144;308
Ukmergė d. mun.;2012;74;422;142;280
Ukmergė d. mun.;2012;75;429;160;269
Ukmergė d. mun.;2012;76;433;150;283
Ukmergė d. mun.;2012;77;392;122;270
Ukmergė d. mun.;2012;78;371;128;243
Ukmergė d. mun.;2012;79;382;105;277
Ukmergė d. mun.;2012;80;306;80;226
Ukmergė d. mun.;2012;81;313;95;218
Ukmergė d. mun.;2012;82;298;81;217
Ukmergė d. mun.;2012;83;245;67;178
Ukmergė d. mun.;2012;84;246;70;176
Ukmergė d. mun.;2012;85;929;192;737
Ukmergė d. mun.;2013;-1;38355;17620;20735
Ukmergė d. mun.;2013;0;313;145;168
Ukmergė d. mun.;2013;1;299;154;145
Ukmergė d. mun.;2013;2;291;134;157
Ukmergė d. mun.;2013;3;318;151;167
Ukmergė d. mun.;2013;4;325;154;171
Ukmergė d. mun.;2013;5;295;153;142
Ukmergė d. mun.;2013;6;258;127;131
Ukmergė d. mun.;2013;7;319;161;158
Ukmergė d. mun.;2013;8;301;157;144
Ukmergė d. mun.;2013;9;313;178;135
Ukmergė d. mun.;2013;10;306;172;134
Ukmergė d. mun.;2013;11;376;194;182
Ukmergė d. mun.;2013;12;373;191;182
Ukmergė d. mun.;2013;13;412;216;196
Ukmergė d. mun.;2013;14;424;221;203
Ukmergė d. mun.;2013;15;463;249;214
Ukmergė d. mun.;2013;16;426;214;212
Ukmergė d. mun.;2013;17;494;258;236
Ukmergė d. mun.;2013;18;513;267;246
Ukmergė d. mun.;2013;19;562;298;264
Ukmergė d. mun.;2013;20;590;303;287
Ukmergė d. mun.;2013;21;511;280;231
Ukmergė d. mun.;2013;22;456;274;182
Ukmergė d. mun.;2013;23;491;258;233
Ukmergė d. mun.;2013;24;447;233;214
Ukmergė d. mun.;2013;25;524;302;222
Ukmergė d. mun.;2013;26;424;243;181
Ukmergė d. mun.;2013;27;329;185;144
Ukmergė d. mun.;2013;28;360;191;169
Ukmergė d. mun.;2013;29;347;186;161
Ukmergė d. mun.;2013;30;349;176;173
Ukmergė d. mun.;2013;31;315;160;155
Ukmergė d. mun.;2013;32;328;163;165
Ukmergė d. mun.;2013;33;338;183;155
Ukmergė d. mun.;2013;34;327;161;166
Ukmergė d. mun.;2013;35;383;191;192
Ukmergė d. mun.;2013;36;383;197;186
Ukmergė d. mun.;2013;37;423;219;204
Ukmergė d. mun.;2013;38;425;193;232
Ukmergė d. mun.;2013;39;510;255;255
Ukmergė d. mun.;2013;40;516;231;285
Ukmergė d. mun.;2013;41;559;276;283
Ukmergė d. mun.;2013;42;599;294;305
Ukmergė d. mun.;2013;43;627;306;321
Ukmergė d. mun.;2013;44;534;287;247
Ukmergė d. mun.;2013;45;595;277;318
Ukmergė d. mun.;2013;46;597;296;301
Ukmergė d. mun.;2013;47;609;291;318
Ukmergė d. mun.;2013;48;611;293;318
Ukmergė d. mun.;2013;49;625;309;316
Ukmergė d. mun.;2013;50;619;289;330
Ukmergė d. mun.;2013;51;678;329;349
Ukmergė d. mun.;2013;52;628;308;320
Ukmergė d. mun.;2013;53;642;311;331
Ukmergė d. mun.;2013;54;620;290;330
Ukmergė d. mun.;2013;55;561;263;298
Ukmergė d. mun.;2013;56;519;252;267
Ukmergė d. mun.;2013;57;518;274;244
Ukmergė d. mun.;2013;58;433;194;239
Ukmergė d. mun.;2013;59;411;187;224
Ukmergė d. mun.;2013;60;487;208;279
Ukmergė d. mun.;2013;61;482;209;273
Ukmergė d. mun.;2013;62;486;213;273
Ukmergė d. mun.;2013;63;511;198;313
Ukmergė d. mun.;2013;64;459;172;287
Ukmergė d. mun.;2013;65;388;161;227
Ukmergė d. mun.;2013;66;406;164;242
Ukmergė d. mun.;2013;67;441;172;269
Ukmergė d. mun.;2013;68;412;159;253
Ukmergė d. mun.;2013;69;487;191;296
Ukmergė d. mun.;2013;70;503;160;343
Ukmergė d. mun.;2013;71;465;186;279
Ukmergė d. mun.;2013;72;452;164;288
Ukmergė d. mun.;2013;73;413;167;246
Ukmergė d. mun.;2013;74;433;131;302
Ukmergė d. mun.;2013;75;407;134;273
Ukmergė d. mun.;2013;76;402;146;256
Ukmergė d. mun.;2013;77;410;137;273
Ukmergė d. mun.;2013;78;374;115;259
Ukmergė d. mun.;2013;79;355;122;233
Ukmergė d. mun.;2013;80;355;92;263
Ukmergė d. mun.;2013;81;287;74;213
Ukmergė d. mun.;2013;82;287;86;201
Ukmergė d. mun.;2013;83;272;74;198
Ukmergė d. mun.;2013;84;225;57;168
Ukmergė d. mun.;2013;85;1014;224;790
Ukmergė d. mun.;2014;-1;37548;17275;20273
Ukmergė d. mun.;2014;0;317;154;163
Ukmergė d. mun.;2014;1;307;143;164
Ukmergė d. mun.;2014;2;291;150;141
Ukmergė d. mun.;2014;3;273;123;150
Ukmergė d. mun.;2014;4;316;157;159
Ukmergė d. mun.;2014;5;322;152;170
Ukmergė d. mun.;2014;6;291;153;138
Ukmergė d. mun.;2014;7;252;124;128
Ukmergė d. mun.;2014;8;315;160;155
Ukmergė d. mun.;2014;9;293;155;138
Ukmergė d. mun.;2014;10;308;176;132
Ukmergė d. mun.;2014;11;297;168;129
Ukmergė d. mun.;2014;12;368;188;180
Ukmergė d. mun.;2014;13;372;192;180
Ukmergė d. mun.;2014;14;403;211;192
Ukmergė d. mun.;2014;15;418;216;202
Ukmergė d. mun.;2014;16;460;247;213
Ukmergė d. mun.;2014;17;425;212;213
Ukmergė d. mun.;2014;18;490;255;235
Ukmergė d. mun.;2014;19;489;256;233
Ukmergė d. mun.;2014;20;537;285;252
Ukmergė d. mun.;2014;21;579;294;285
Ukmergė d. mun.;2014;22;502;275;227
Ukmergė d. mun.;2014;23;448;274;174
Ukmergė d. mun.;2014;24;460;242;218
Ukmergė d. mun.;2014;25;418;218;200
Ukmergė d. mun.;2014;26;499;288;211
Ukmergė d. mun.;2014;27;408;237;171
Ukmergė d. mun.;2014;28;313;174;139
Ukmergė d. mun.;2014;29;338;191;147
Ukmergė d. mun.;2014;30;337;181;156
Ukmergė d. mun.;2014;31;334;167;167
Ukmergė d. mun.;2014;32;301;160;141
Ukmergė d. mun.;2014;33;324;165;159
Ukmergė d. mun.;2014;34;331;180;151
Ukmergė d. mun.;2014;35;319;160;159
Ukmergė d. mun.;2014;36;385;197;188
Ukmergė d. mun.;2014;37;381;200;181
Ukmergė d. mun.;2014;38;409;212;197
Ukmergė d. mun.;2014;39;422;188;234
Ukmergė d. mun.;2014;40;508;255;253
Ukmergė d. mun.;2014;41;511;234;277
Ukmergė d. mun.;2014;42;554;274;280
Ukmergė d. mun.;2014;43;594;292;302
Ukmergė d. mun.;2014;44;627;304;323
Ukmergė d. mun.;2014;45;525;281;244
Ukmergė d. mun.;2014;46;594;276;318
Ukmergė d. mun.;2014;47;582;290;292
Ukmergė d. mun.;2014;48;605;286;319
Ukmergė d. mun.;2014;49;608;286;322
Ukmergė d. mun.;2014;50;622;309;313
Ukmergė d. mun.;2014;51;609;281;328
Ukmergė d. mun.;2014;52;672;324;348
Ukmergė d. mun.;2014;53;624;303;321
Ukmergė d. mun.;2014;54;623;302;321
Ukmergė d. mun.;2014;55;613;284;329
Ukmergė d. mun.;2014;56;558;257;301
Ukmergė d. mun.;2014;57;515;250;265
Ukmergė d. mun.;2014;58;507;268;239
Ukmergė d. mun.;2014;59;423;189;234
Ukmergė d. mun.;2014;60;405;182;223
Ukmergė d. mun.;2014;61;488;206;282
Ukmergė d. mun.;2014;62;470;199;271
Ukmergė d. mun.;2014;63;481;208;273
Ukmergė d. mun.;2014;64;497;192;305
Ukmergė d. mun.;2014;65;440;160;280
Ukmergė d. mun.;2014;66;379;154;225
Ukmergė d. mun.;2014;67;400;162;238
Ukmergė d. mun.;2014;68;428;167;261
Ukmergė d. mun.;2014;69;398;148;250
Ukmergė d. mun.;2014;70;470;181;289
Ukmergė d. mun.;2014;71;486;153;333
Ukmergė d. mun.;2014;72;448;176;272
Ukmergė d. mun.;2014;73;435;154;281
Ukmergė d. mun.;2014;74;400;161;239
Ukmergė d. mun.;2014;75;415;119;296
Ukmergė d. mun.;2014;76;386;123;263
Ukmergė d. mun.;2014;77;383;137;246
Ukmergė d. mun.;2014;78;390;129;261
Ukmergė d. mun.;2014;79;361;109;252
Ukmergė d. mun.;2014;80;339;110;229
Ukmergė d. mun.;2014;81;337;84;253
Ukmergė d. mun.;2014;82;265;64;201
Ukmergė d. mun.;2014;83;262;74;188
Ukmergė d. mun.;2014;84;242;66;176
Ukmergė d. mun.;2014;85;1017;232;785
Ukmergė d. mun.;2015;-1;36919;16974;19945
Ukmergė d. mun.;2015;0;326;174;152
Ukmergė d. mun.;2015;1;317;152;165
Ukmergė d. mun.;2015;2;310;142;168
Ukmergė d. mun.;2015;3;296;147;149
Ukmergė d. mun.;2015;4;274;123;151
Ukmergė d. mun.;2015;5;306;151;155
Ukmergė d. mun.;2015;6;314;149;165
Ukmergė d. mun.;2015;7;282;150;132
Ukmergė d. mun.;2015;8;253;125;128
Ukmergė d. mun.;2015;9;321;163;158
Ukmergė d. mun.;2015;10;291;154;137
Ukmergė d. mun.;2015;11;308;175;133
Ukmergė d. mun.;2015;12;298;167;131
Ukmergė d. mun.;2015;13;369;186;183
Ukmergė d. mun.;2015;14;374;194;180
Ukmergė d. mun.;2015;15;403;210;193
Ukmergė d. mun.;2015;16;414;215;199
Ukmergė d. mun.;2015;17;456;244;212
Ukmergė d. mun.;2015;18;418;210;208
Ukmergė d. mun.;2015;19;484;253;231
Ukmergė d. mun.;2015;20;480;248;232
Ukmergė d. mun.;2015;21;530;282;248
Ukmergė d. mun.;2015;22;555;283;272
Ukmergė d. mun.;2015;23;481;260;221
Ukmergė d. mun.;2015;24;442;270;172
Ukmergė d. mun.;2015;25;439;230;209
Ukmergė d. mun.;2015;26;394;212;182
Ukmergė d. mun.;2015;27;481;280;201
Ukmergė d. mun.;2015;28;392;227;165
Ukmergė d. mun.;2015;29;301;173;128
Ukmergė d. mun.;2015;30;320;182;138
Ukmergė d. mun.;2015;31;330;175;155
Ukmergė d. mun.;2015;32;320;157;163
Ukmergė d. mun.;2015;33;286;152;134
Ukmergė d. mun.;2015;34;310;157;153
Ukmergė d. mun.;2015;35;328;178;150
Ukmergė d. mun.;2015;36;312;152;160
Ukmergė d. mun.;2015;37;378;194;184
Ukmergė d. mun.;2015;38;380;199;181
Ukmergė d. mun.;2015;39;403;210;193
Ukmergė d. mun.;2015;40;422;185;237
Ukmergė d. mun.;2015;41;501;254;247
Ukmergė d. mun.;2015;42;505;232;273
Ukmergė d. mun.;2015;43;540;268;272
Ukmergė d. mun.;2015;44;583;290;293
Ukmergė d. mun.;2015;45;621;301;320
Ukmergė d. mun.;2015;46;521;280;241
Ukmergė d. mun.;2015;47;583;269;314
Ukmergė d. mun.;2015;48;582;291;291
Ukmergė d. mun.;2015;49;604;288;316
Ukmergė d. mun.;2015;50;600;278;322
Ukmergė d. mun.;2015;51;616;305;311
Ukmergė d. mun.;2015;52;606;274;332
Ukmergė d. mun.;2015;53;666;323;343
Ukmergė d. mun.;2015;54;616;300;316
Ukmergė d. mun.;2015;55;620;299;321
Ukmergė d. mun.;2015;56;606;278;328
Ukmergė d. mun.;2015;57;553;252;301
Ukmergė d. mun.;2015;58;507;247;260
Ukmergė d. mun.;2015;59;500;265;235
Ukmergė d. mun.;2015;60;416;181;235
Ukmergė d. mun.;2015;61;404;179;225
Ukmergė d. mun.;2015;62;485;203;282
Ukmergė d. mun.;2015;63;463;194;269
Ukmergė d. mun.;2015;64;478;207;271
Ukmergė d. mun.;2015;65;486;185;301
Ukmergė d. mun.;2015;66;435;158;277
Ukmergė d. mun.;2015;67;364;147;217
Ukmergė d. mun.;2015;68;390;155;235
Ukmergė d. mun.;2015;69;419;160;259
Ukmergė d. mun.;2015;70;386;139;247
Ukmergė d. mun.;2015;71;452;170;282
Ukmergė d. mun.;2015;72;474;148;326
Ukmergė d. mun.;2015;73;428;164;264
Ukmergė d. mun.;2015;74;421;145;276
Ukmergė d. mun.;2015;75;384;155;229
Ukmergė d. mun.;2015;76;396;110;286
Ukmergė d. mun.;2015;77;369;113;256
Ukmergė d. mun.;2015;78;362;124;238
Ukmergė d. mun.;2015;79;360;110;250
Ukmergė d. mun.;2015;80;345;100;245
Ukmergė d. mun.;2015;81;315;98;217
Ukmergė d. mun.;2015;82;313;79;234
Ukmergė d. mun.;2015;83;247;58;189
Ukmergė d. mun.;2015;84;233;65;168
Ukmergė d. mun.;2015;85;1066;243;823
Ukmergė d. mun.;2016;-1;36160;16634;19526
Ukmergė d. mun.;2016;0;339;175;164
Ukmergė d. mun.;2016;1;325;170;155
Ukmergė d. mun.;2016;2;319;155;164
Ukmergė d. mun.;2016;3;305;143;162
Ukmergė d. mun.;2016;4;293;149;144
Ukmergė d. mun.;2016;5;271;123;148
Ukmergė d. mun.;2016;6;299;145;154
Ukmergė d. mun.;2016;7;309;144;165
Ukmergė d. mun.;2016;8;282;150;132
Ukmergė d. mun.;2016;9;249;121;128
Ukmergė d. mun.;2016;10;314;164;150
Ukmergė d. mun.;2016;11;284;149;135
Ukmergė d. mun.;2016;12;307;172;135
Ukmergė d. mun.;2016;13;295;167;128
Ukmergė d. mun.;2016;14;367;186;181
Ukmergė d. mun.;2016;15;370;190;180
Ukmergė d. mun.;2016;16;404;210;194
Ukmergė d. mun.;2016;17;408;214;194
Ukmergė d. mun.;2016;18;439;236;203
Ukmergė d. mun.;2016;19;402;206;196
Ukmergė d. mun.;2016;20;468;245;223
Ukmergė d. mun.;2016;21;471;241;230
Ukmergė d. mun.;2016;22;519;273;246
Ukmergė d. mun.;2016;23;516;262;254
Ukmergė d. mun.;2016;24;452;244;208
Ukmergė d. mun.;2016;25;417;252;165
Ukmergė d. mun.;2016;26;424;220;204
Ukmergė d. mun.;2016;27;378;205;173
Ukmergė d. mun.;2016;28;464;268;196
Ukmergė d. mun.;2016;29;388;218;170
Ukmergė d. mun.;2016;30;307;177;130
Ukmergė d. mun.;2016;31;305;174;131
Ukmergė d. mun.;2016;32;314;168;146
Ukmergė d. mun.;2016;33;308;157;151
Ukmergė d. mun.;2016;34;280;147;133
Ukmergė d. mun.;2016;35;304;157;147
Ukmergė d. mun.;2016;36;311;173;138
Ukmergė d. mun.;2016;37;310;150;160
Ukmergė d. mun.;2016;38;373;190;183
Ukmergė d. mun.;2016;39;369;197;172
Ukmergė d. mun.;2016;40;395;203;192
Ukmergė d. mun.;2016;41;417;187;230
Ukmergė d. mun.;2016;42;504;257;247
Ukmergė d. mun.;2016;43;492;228;264
Ukmergė d. mun.;2016;44;528;260;268
Ukmergė d. mun.;2016;45;572;287;285
Ukmergė d. mun.;2016;46;617;300;317
Ukmergė d. mun.;2016;47;514;272;242
Ukmergė d. mun.;2016;48;580;272;308
Ukmergė d. mun.;2016;49;573;289;284
Ukmergė d. mun.;2016;50;603;287;316
Ukmergė d. mun.;2016;51;598;277;321
Ukmergė d. mun.;2016;52;608;300;308
Ukmergė d. mun.;2016;53;597;271;326
Ukmergė d. mun.;2016;54;665;318;347
Ukmergė d. mun.;2016;55;603;291;312
Ukmergė d. mun.;2016;56;615;293;322
Ukmergė d. mun.;2016;57;599;272;327
Ukmergė d. mun.;2016;58;543;246;297
Ukmergė d. mun.;2016;59;502;245;257
Ukmergė d. mun.;2016;60;496;265;231
Ukmergė d. mun.;2016;61;405;171;234
Ukmergė d. mun.;2016;62;393;172;221
Ukmergė d. mun.;2016;63;479;198;281
Ukmergė d. mun.;2016;64;454;189;265
Ukmergė d. mun.;2016;65;473;206;267
Ukmergė d. mun.;2016;66;473;175;298
Ukmergė d. mun.;2016;67;425;153;272
Ukmergė d. mun.;2016;68;350;137;213
Ukmergė d. mun.;2016;69;373;143;230
Ukmergė d. mun.;2016;70;402;150;252
Ukmergė d. mun.;2016;71;373;133;240
Ukmergė d. mun.;2016;72;437;159;278
Ukmergė d. mun.;2016;73;459;143;316
Ukmergė d. mun.;2016;74;410;154;256
Ukmergė d. mun.;2016;75;411;141;270
Ukmergė d. mun.;2016;76;358;139;219
Ukmergė d. mun.;2016;77;370;95;275
Ukmergė d. mun.;2016;78;349;106;243
Ukmergė d. mun.;2016;79;336;112;224
Ukmergė d. mun.;2016;80;336;98;238
Ukmergė d. mun.;2016;81;325;96;229
Ukmergė d. mun.;2016;82;293;89;204
Ukmergė d. mun.;2016;83;288;69;219
Ukmergė d. mun.;2016;84;222;49;173
Ukmergė d. mun.;2016;85;1086;250;836
Ukmergė d. mun.;2017;-1;35265;16248;19017
Ukmergė d. mun.;2017;0;316;169;147
Ukmergė d. mun.;2017;1;330;165;165
Ukmergė d. mun.;2017;2;326;169;157
Ukmergė d. mun.;2017;3;306;144;162
Ukmergė d. mun.;2017;4;302;141;161
Ukmergė d. mun.;2017;5;288;149;139
Ukmergė d. mun.;2017;6;271;123;148
Ukmergė d. mun.;2017;7;295;145;150
Ukmergė d. mun.;2017;8;306;144;162
Ukmergė d. mun.;2017;9;279;148;131
Ukmergė d. mun.;2017;10;253;120;133
Ukmergė d. mun.;2017;11;313;164;149
Ukmergė d. mun.;2017;12;283;152;131
Ukmergė d. mun.;2017;13;310;175;135
Ukmergė d. mun.;2017;14;297;168;129
Ukmergė d. mun.;2017;15;361;182;179
Ukmergė d. mun.;2017;16;371;191;180
Ukmergė d. mun.;2017;17;402;209;193
Ukmergė d. mun.;2017;18;407;211;196
Ukmergė d. mun.;2017;19;430;232;198
Ukmergė d. mun.;2017;20;394;202;192
Ukmergė d. mun.;2017;21;446;233;213
Ukmergė d. mun.;2017;22;448;231;217
Ukmergė d. mun.;2017;23;486;260;226
Ukmergė d. mun.;2017;24;498;261;237
Ukmergė d. mun.;2017;25;416;224;192
Ukmergė d. mun.;2017;26;377;234;143
Ukmergė d. mun.;2017;27;378;202;176
Ukmergė d. mun.;2017;28;357;199;158
Ukmergė d. mun.;2017;29;431;247;184
Ukmergė d. mun.;2017;30;360;208;152
Ukmergė d. mun.;2017;31;291;165;126
Ukmergė d. mun.;2017;32;285;165;120
Ukmergė d. mun.;2017;33;292;160;132
Ukmergė d. mun.;2017;34;287;149;138
Ukmergė d. mun.;2017;35;264;138;126
Ukmergė d. mun.;2017;36;285;144;141
Ukmergė d. mun.;2017;37;298;163;135
Ukmergė d. mun.;2017;38;299;143;156
Ukmergė d. mun.;2017;39;369;186;183
Ukmergė d. mun.;2017;40;364;196;168
Ukmergė d. mun.;2017;41;391;201;190
Ukmergė d. mun.;2017;42;408;179;229
Ukmergė d. mun.;2017;43;497;254;243
Ukmergė d. mun.;2017;44;491;231;260
Ukmergė d. mun.;2017;45;528;259;269
Ukmergė d. mun.;2017;46;572;286;286
Ukmergė d. mun.;2017;47;607;292;315
Ukmergė d. mun.;2017;48;517;276;241
Ukmergė d. mun.;2017;49;570;266;304
Ukmergė d. mun.;2017;50;565;283;282
Ukmergė d. mun.;2017;51;593;283;310
Ukmergė d. mun.;2017;52;591;273;318
Ukmergė d. mun.;2017;53;597;295;302
Ukmergė d. mun.;2017;54;588;264;324
Ukmergė d. mun.;2017;55;651;314;337
Ukmergė d. mun.;2017;56;596;287;309
Ukmergė d. mun.;2017;57;604;284;320
Ukmergė d. mun.;2017;58;595;266;329
Ukmergė d. mun.;2017;59;533;238;295
Ukmergė d. mun.;2017;60;492;241;251
Ukmergė d. mun.;2017;61;489;258;231
Ukmergė d. mun.;2017;62;397;169;228
Ukmergė d. mun.;2017;63;388;169;219
Ukmergė d. mun.;2017;64;471;194;277
Ukmergė d. mun.;2017;65;446;187;259
Ukmergė d. mun.;2017;66;465;199;266
Ukmergė d. mun.;2017;67;447;159;288
Ukmergė d. mun.;2017;68;412;144;268
Ukmergė d. mun.;2017;69;340;130;210
Ukmergė d. mun.;2017;70;363;137;226
Ukmergė d. mun.;2017;71;393;143;250
Ukmergė d. mun.;2017;72;360;127;233
Ukmergė d. mun.;2017;73;422;151;271
Ukmergė d. mun.;2017;74;438;132;306
Ukmergė d. mun.;2017;75;394;147;247
Ukmergė d. mun.;2017;76;396;134;262
Ukmergė d. mun.;2017;77;337;129;208
Ukmergė d. mun.;2017;78;349;86;263
Ukmergė d. mun.;2017;79;339;100;239
Ukmergė d. mun.;2017;80;303;100;203
Ukmergė d. mun.;2017;81;323;92;231
Ukmergė d. mun.;2017;82;305;92;213
Ukmergė d. mun.;2017;83;266;81;185
Ukmergė d. mun.;2017;84;261;58;203
Ukmergė d. mun.;2017;85;1104;247;857
Ukmergė d. mun.;2018;-1;34376;15808;18568
Ukmergė d. mun.;2018;0;309;159;150
Ukmergė d. mun.;2018;1;311;168;143
Ukmergė d. mun.;2018;2;327;165;162
Ukmergė d. mun.;2018;3;325;171;154
Ukmergė d. mun.;2018;4;300;145;155
Ukmergė d. mun.;2018;5;299;140;159
Ukmergė d. mun.;2018;6;281;147;134
Ukmergė d. mun.;2018;7;272;125;147
Ukmergė d. mun.;2018;8;293;144;149
Ukmergė d. mun.;2018;9;300;142;158
Ukmergė d. mun.;2018;10;271;143;128
Ukmergė d. mun.;2018;11;249;119;130
Ukmergė d. mun.;2018;12;311;161;150
Ukmergė d. mun.;2018;13;280;150;130
Ukmergė d. mun.;2018;14;305;171;134
Ukmergė d. mun.;2018;15;295;167;128
Ukmergė d. mun.;2018;16;356;181;175
Ukmergė d. mun.;2018;17;372;194;178
Ukmergė d. mun.;2018;18;396;206;190
Ukmergė d. mun.;2018;19;380;194;186
Ukmergė d. mun.;2018;20;421;223;198
Ukmergė d. mun.;2018;21;384;198;186
Ukmergė d. mun.;2018;22;416;214;202
Ukmergė d. mun.;2018;23;414;213;201
Ukmergė d. mun.;2018;24;461;255;206
Ukmergė d. mun.;2018;25;466;240;226
Ukmergė d. mun.;2018;26;380;212;168
Ukmergė d. mun.;2018;27;365;229;136
Ukmergė d. mun.;2018;28;351;189;162
Ukmergė d. mun.;2018;29;320;180;140
Ukmergė d. mun.;2018;30;409;236;173
Ukmergė d. mun.;2018;31;339;196;143
Ukmergė d. mun.;2018;32;272;151;121
Ukmergė d. mun.;2018;33;276;153;123
Ukmergė d. mun.;2018;34;267;142;125
Ukmergė d. mun.;2018;35;261;132;129
Ukmergė d. mun.;2018;36;263;134;129
Ukmergė d. mun.;2018;37;275;139;136
Ukmergė d. mun.;2018;38;299;162;137
Ukmergė d. mun.;2018;39;292;137;155
Ukmergė d. mun.;2018;40;366;185;181
Ukmergė d. mun.;2018;41;356;187;169
Ukmergė d. mun.;2018;42;383;195;188
Ukmergė d. mun.;2018;43;396;169;227
Ukmergė d. mun.;2018;44;488;247;241
Ukmergė d. mun.;2018;45;489;228;261
Ukmergė d. mun.;2018;46;517;253;264
Ukmergė d. mun.;2018;47;559;276;283
Ukmergė d. mun.;2018;48;591;287;304
Ukmergė d. mun.;2018;49;517;278;239
Ukmergė d. mun.;2018;50;565;263;302
Ukmergė d. mun.;2018;51;556;277;279
Ukmergė d. mun.;2018;52;585;278;307
Ukmergė d. mun.;2018;53;588;273;315
Ukmergė d. mun.;2018;54;592;290;302
Ukmergė d. mun.;2018;55;582;260;322
Ukmergė d. mun.;2018;56;646;313;333
Ukmergė d. mun.;2018;57;589;285;304
Ukmergė d. mun.;2018;58;591;275;316
Ukmergė d. mun.;2018;59;580;257;323
Ukmergė d. mun.;2018;60;530;236;294
Ukmergė d. mun.;2018;61;480;233;247
Ukmergė d. mun.;2018;62;477;246;231
Ukmergė d. mun.;2018;63;392;166;226
Ukmergė d. mun.;2018;64;385;168;217
Ukmergė d. mun.;2018;65;468;193;275
Ukmergė d. mun.;2018;66;439;182;257
Ukmergė d. mun.;2018;67;452;187;265
Ukmergė d. mun.;2018;68;439;156;283
Ukmergė d. mun.;2018;69;406;143;263
Ukmergė d. mun.;2018;70;327;123;204
Ukmergė d. mun.;2018;71;360;132;228
Ukmergė d. mun.;2018;72;383;140;243
Ukmergė d. mun.;2018;73;353;124;229
Ukmergė d. mun.;2018;74;403;138;265
Ukmergė d. mun.;2018;75;416;119;297
Ukmergė d. mun.;2018;76;375;136;239
Ukmergė d. mun.;2018;77;375;124;251
Ukmergė d. mun.;2018;78;321;122;199
Ukmergė d. mun.;2018;79;330;76;254
Ukmergė d. mun.;2018;80;317;89;228
Ukmergė d. mun.;2018;81;285;89;196
Ukmergė d. mun.;2018;82;304;84;220
Ukmergė d. mun.;2018;83;275;82;193
Ukmergė d. mun.;2018;84;240;76;164
Ukmergė d. mun.;2018;85;1145;241;904
Utena county;2001;-1;186368;88041;98327
Utena county;2001;0;1553;823;730
Utena county;2001;1;1701;868;833
Utena county;2001;2;1647;838;809
Utena county;2001;3;1753;887;866
Utena county;2001;4;1809;917;892
Utena county;2001;5;1925;977;948
Utena county;2001;6;2004;1055;949
Utena county;2001;7;2326;1210;1116
Utena county;2001;8;2702;1363;1339
Utena county;2001;9;2657;1392;1265
Utena county;2001;10;2757;1449;1308
Utena county;2001;11;2790;1437;1353
Utena county;2001;12;3010;1530;1480
Utena county;2001;13;3199;1627;1572
Utena county;2001;14;3146;1623;1523
Utena county;2001;15;3157;1645;1512
Utena county;2001;16;3034;1536;1498
Utena county;2001;17;2973;1533;1440
Utena county;2001;18;2528;1274;1254
Utena county;2001;19;2190;1207;983
Utena county;2001;20;2009;1093;916
Utena county;2001;21;2007;1067;940
Utena county;2001;22;1987;1053;934
Utena county;2001;23;1965;1022;943
Utena county;2001;24;2055;1074;981
Utena county;2001;25;2106;1046;1060
Utena county;2001;26;2068;1077;991
Utena county;2001;27;2146;1114;1032
Utena county;2001;28;2306;1205;1101
Utena county;2001;29;2354;1200;1154
Utena county;2001;30;2410;1206;1204
Utena county;2001;31;2469;1244;1225
Utena county;2001;32;2572;1286;1286
Utena county;2001;33;2500;1228;1272
Utena county;2001;34;2547;1256;1291
Utena county;2001;35;2748;1386;1362
Utena county;2001;36;2765;1410;1355
Utena county;2001;37;2988;1584;1404
Utena county;2001;38;3064;1547;1517
Utena county;2001;39;3199;1569;1630
Utena county;2001;40;3109;1574;1535
Utena county;2001;41;3148;1552;1596
Utena county;2001;42;2896;1398;1498
Utena county;2001;43;2741;1360;1381
Utena county;2001;44;2636;1296;1340
Utena county;2001;45;2640;1314;1326
Utena county;2001;46;2334;1166;1168
Utena county;2001;47;2283;1131;1152
Utena county;2001;48;2316;1130;1186
Utena county;2001;49;2340;1141;1199
Utena county;2001;50;2304;1156;1148
Utena county;2001;51;2312;1130;1182
Utena county;2001;52;2098;1024;1074
Utena county;2001;53;1867;894;973
Utena county;2001;54;1745;824;921
Utena county;2001;55;2063;965;1098
Utena county;2001;56;1712;845;867
Utena county;2001;57;2031;920;1111
Utena county;2001;58;2282;1040;1242
Utena county;2001;59;2205;1012;1193
Utena county;2001;60;2103;924;1179
Utena county;2001;61;2186;973;1213
Utena county;2001;62;2230;966;1264
Utena county;2001;63;2120;908;1212
Utena county;2001;64;2214;922;1292
Utena county;2001;65;2024;866;1158
Utena county;2001;66;1910;756;1154
Utena county;2001;67;2114;831;1283
Utena county;2001;68;2029;757;1272
Utena county;2001;69;1933;733;1200
Utena county;2001;70;1968;736;1232
Utena county;2001;71;1786;624;1162
Utena county;2001;72;1843;637;1206
Utena county;2001;73;1852;667;1185
Utena county;2001;74;1555;465;1090
Utena county;2001;75;1574;493;1081
Utena county;2001;76;1407;402;1005
Utena county;2001;77;1393;429;964
Utena county;2001;78;1187;353;834
Utena county;2001;79;1067;283;784
Utena county;2001;80;953;297;656
Utena county;2001;81;614;176;438
Utena county;2001;82;437;116;321
Utena county;2001;83;433;113;320
Utena county;2001;84;409;105;304
Utena county;2001;85;2839;779;2060
Utena county;2002;-1;183973;86911;97062
Utena county;2002;0;1482;767;715
Utena county;2002;1;1548;814;734
Utena county;2002;2;1690;862;828
Utena county;2002;3;1637;836;801
Utena county;2002;4;1740;881;859
Utena county;2002;5;1796;907;889
Utena county;2002;6;1905;966;939
Utena county;2002;7;1997;1055;942
Utena county;2002;8;2315;1208;1107
Utena county;2002;9;2663;1336;1327
Utena county;2002;10;2638;1386;1252
Utena county;2002;11;2721;1425;1296
Utena county;2002;12;2752;1421;1331
Utena county;2002;13;2960;1508;1452
Utena county;2002;14;3158;1604;1554
Utena county;2002;15;3099;1590;1509
Utena county;2002;16;3108;1620;1488
Utena county;2002;17;2973;1499;1474
Utena county;2002;18;2901;1498;1403
Utena county;2002;19;2442;1232;1210
Utena county;2002;20;2137;1178;959
Utena county;2002;21;1965;1062;903
Utena county;2002;22;1973;1038;935
Utena county;2002;23;1967;1034;933
Utena county;2002;24;1918;998;920
Utena county;2002;25;2033;1063;970
Utena county;2002;26;2047;1019;1028
Utena county;2002;27;2036;1061;975
Utena county;2002;28;2105;1093;1012
Utena county;2002;29;2253;1169;1084
Utena county;2002;30;2288;1166;1122
Utena county;2002;31;2346;1177;1169
Utena county;2002;32;2422;1223;1199
Utena county;2002;33;2529;1266;1263
Utena county;2002;34;2457;1207;1250
Utena county;2002;35;2497;1222;1275
Utena county;2002;36;2708;1367;1341
Utena county;2002;37;2713;1381;1332
Utena county;2002;38;2928;1553;1375
Utena county;2002;39;2987;1498;1489
Utena county;2002;40;3133;1531;1602
Utena county;2002;41;3053;1548;1505
Utena county;2002;42;3107;1530;1577
Utena county;2002;43;2863;1391;1472
Utena county;2002;44;2709;1351;1358
Utena county;2002;45;2570;1259;1311
Utena county;2002;46;2601;1291;1310
Utena county;2002;47;2311;1163;1148
Utena county;2002;48;2237;1106;1131
Utena county;2002;49;2274;1107;1167
Utena county;2002;50;2304;1113;1191
Utena county;2002;51;2238;1118;1120
Utena county;2002;52;2291;1117;1174
Utena county;2002;53;2079;1019;1060
Utena county;2002;54;1829;880;949
Utena county;2002;55;1709;811;898
Utena county;2002;56;2009;937;1072
Utena county;2002;57;1684;833;851
Utena county;2002;58;1987;897;1090
Utena county;2002;59;2218;1005;1213
Utena county;2002;60;2190;1010;1180
Utena county;2002;61;2094;908;1186
Utena county;2002;62;2159;958;1201
Utena county;2002;63;2226;960;1266
Utena county;2002;64;2106;897;1209
Utena county;2002;65;2202;910;1292
Utena county;2002;66;2006;853;1153
Utena county;2002;67;1879;737;1142
Utena county;2002;68;2072;810;1262
Utena county;2002;69;1979;733;1246
Utena county;2002;70;1908;713;1195
Utena county;2002;71;1929;708;1221
Utena county;2002;72;1745;592;1153
Utena county;2002;73;1803;624;1179
Utena county;2002;74;1811;645;1166
Utena county;2002;75;1504;443;1061
Utena county;2002;76;1504;463;1041
Utena county;2002;77;1348;369;979
Utena county;2002;78;1330;401;929
Utena county;2002;79;1123;331;792
Utena county;2002;80;1008;262;746
Utena county;2002;81;878;274;604
Utena county;2002;82;573;160;413
Utena county;2002;83;402;102;300
Utena county;2002;84;397;103;294
Utena county;2002;85;2757;748;2009
Utena county;2003;-1;181638;85726;95912
Utena county;2003;0;1278;619;659
Utena county;2003;1;1475;765;710
Utena county;2003;2;1542;810;732
Utena county;2003;3;1667;849;818
Utena county;2003;4;1625;829;796
Utena county;2003;5;1736;882;854
Utena county;2003;6;1792;906;886
Utena county;2003;7;1887;959;928
Utena county;2003;8;1988;1049;939
Utena county;2003;9;2300;1195;1105
Utena county;2003;10;2636;1331;1305
Utena county;2003;11;2616;1373;1243
Utena county;2003;12;2686;1409;1277
Utena county;2003;13;2711;1399;1312
Utena county;2003;14;2921;1479;1442
Utena county;2003;15;3094;1561;1533
Utena county;2003;16;3037;1554;1483
Utena county;2003;17;3051;1585;1466
Utena county;2003;18;2914;1476;1438
Utena county;2003;19;2860;1479;1381
Utena county;2003;20;2387;1210;1177
Utena county;2003;21;2115;1173;942
Utena county;2003;22;1929;1042;887
Utena county;2003;23;1957;1033;924
Utena county;2003;24;1956;1031;925
Utena county;2003;25;1907;992;915
Utena county;2003;26;1992;1044;948
Utena county;2003;27;2001;995;1006
Utena county;2003;28;1995;1043;952
Utena county;2003;29;2058;1065;993
Utena county;2003;30;2207;1141;1066
Utena county;2003;31;2258;1154;1104
Utena county;2003;32;2314;1158;1156
Utena county;2003;33;2412;1219;1193
Utena county;2003;34;2500;1256;1244
Utena county;2003;35;2410;1185;1225
Utena county;2003;36;2472;1215;1257
Utena county;2003;37;2654;1341;1313
Utena county;2003;38;2688;1370;1318
Utena county;2003;39;2881;1528;1353
Utena county;2003;40;2959;1483;1476
Utena county;2003;41;3104;1515;1589
Utena county;2003;42;3031;1536;1495
Utena county;2003;43;3082;1515;1567
Utena county;2003;44;2839;1390;1449
Utena county;2003;45;2661;1322;1339
Utena county;2003;46;2541;1247;1294
Utena county;2003;47;2572;1270;1302
Utena county;2003;48;2292;1148;1144
Utena county;2003;49;2215;1095;1120
Utena county;2003;50;2244;1089;1155
Utena county;2003;51;2263;1092;1171
Utena county;2003;52;2215;1110;1105
Utena county;2003;53;2270;1113;1157
Utena county;2003;54;2036;990;1046
Utena county;2003;55;1785;853;932
Utena county;2003;56;1693;799;894
Utena county;2003;57;1982;921;1061
Utena county;2003;58;1659;814;845
Utena county;2003;59;1954;868;1086
Utena county;2003;60;2172;979;1193
Utena county;2003;61;2150;984;1166
Utena county;2003;62;2074;895;1179
Utena county;2003;63;2134;936;1198
Utena county;2003;64;2192;941;1251
Utena county;2003;65;2080;874;1206
Utena county;2003;66;2185;895;1290
Utena county;2003;67;1974;827;1147
Utena county;2003;68;1842;703;1139
Utena county;2003;69;2017;766;1251
Utena county;2003;70;1940;705;1235
Utena county;2003;71;1838;676;1162
Utena county;2003;72;1876;683;1193
Utena county;2003;73;1688;559;1129
Utena county;2003;74;1746;589;1157
Utena county;2003;75;1742;606;1136
Utena county;2003;76;1453;413;1040
Utena county;2003;77;1458;437;1021
Utena county;2003;78;1292;346;946
Utena county;2003;79;1233;361;872
Utena county;2003;80;1036;285;751
Utena county;2003;81;950;237;713
Utena county;2003;82;806;243;563
Utena county;2003;83;517;134;383
Utena county;2003;84;367;92;275
Utena county;2003;85;2570;686;1884
Utena county;2004;-1;178637;84365;94272
Utena county;2004;0;1312;696;616
Utena county;2004;1;1271;615;656
Utena county;2004;2;1460;757;703
Utena county;2004;3;1532;808;724
Utena county;2004;4;1673;854;819
Utena county;2004;5;1611;819;792
Utena county;2004;6;1738;884;854
Utena county;2004;7;1786;903;883
Utena county;2004;8;1877;954;923
Utena county;2004;9;1972;1042;930
Utena county;2004;10;2281;1183;1098
Utena county;2004;11;2610;1319;1291
Utena county;2004;12;2585;1356;1229
Utena county;2004;13;2658;1402;1256
Utena county;2004;14;2658;1375;1283
Utena county;2004;15;2873;1464;1409
Utena county;2004;16;3035;1537;1498
Utena county;2004;17;2971;1528;1443
Utena county;2004;18;2973;1548;1425
Utena county;2004;19;2828;1440;1388
Utena county;2004;20;2781;1444;1337
Utena county;2004;21;2319;1186;1133
Utena county;2004;22;2045;1137;908
Utena county;2004;23;1843;1014;829
Utena county;2004;24;1908;1009;899
Utena county;2004;25;1900;993;907
Utena county;2004;26;1836;957;879
Utena county;2004;27;1933;1011;922
Utena county;2004;28;1932;958;974
Utena county;2004;29;1942;1017;925
Utena county;2004;30;2003;1046;957
Utena county;2004;31;2162;1119;1043
Utena county;2004;32;2206;1124;1082
Utena county;2004;33;2270;1145;1125
Utena county;2004;34;2367;1200;1167
Utena county;2004;35;2448;1233;1215
Utena county;2004;36;2369;1162;1207
Utena county;2004;37;2430;1196;1234
Utena county;2004;38;2599;1313;1286
Utena county;2004;39;2649;1354;1295
Utena county;2004;40;2833;1502;1331
Utena county;2004;41;2912;1460;1452
Utena county;2004;42;3058;1495;1563
Utena county;2004;43;2998;1524;1474
Utena county;2004;44;3017;1471;1546
Utena county;2004;45;2807;1379;1428
Utena county;2004;46;2619;1300;1319
Utena county;2004;47;2498;1224;1274
Utena county;2004;48;2526;1240;1286
Utena county;2004;49;2254;1130;1124
Utena county;2004;50;2175;1079;1096
Utena county;2004;51;2228;1090;1138
Utena county;2004;52;2214;1071;1143
Utena county;2004;53;2177;1083;1094
Utena county;2004;54;2254;1105;1149
Utena county;2004;55;2007;972;1035
Utena county;2004;56;1762;837;925
Utena county;2004;57;1669;784;885
Utena county;2004;58;1952;897;1055
Utena county;2004;59;1627;784;843
Utena county;2004;60;1904;836;1068
Utena county;2004;61;2129;955;1174
Utena county;2004;62;2098;953;1145
Utena county;2004;63;2057;878;1179
Utena county;2004;64;2100;911;1189
Utena county;2004;65;2177;930;1247
Utena county;2004;66;2064;859;1205
Utena county;2004;67;2140;856;1284
Utena county;2004;68;1934;797;1137
Utena county;2004;69;1809;675;1134
Utena county;2004;70;1950;724;1226
Utena county;2004;71;1891;676;1215
Utena county;2004;72;1775;643;1132
Utena county;2004;73;1814;650;1164
Utena county;2004;74;1639;527;1112
Utena county;2004;75;1692;566;1126
Utena county;2004;76;1661;572;1089
Utena county;2004;77;1379;387;992
Utena county;2004;78;1373;378;995
Utena county;2004;79;1222;315;907
Utena county;2004;80;1153;326;827
Utena county;2004;81;953;256;697
Utena county;2004;82;875;213;662
Utena county;2004;83;724;205;519
Utena county;2004;84;454;119;335
Utena county;2004;85;2437;629;1808
Utena county;2005;-1;175226;82656;92570
Utena county;2005;0;1314;682;632
Utena county;2005;1;1289;689;600
Utena county;2005;2;1258;607;651
Utena county;2005;3;1455;754;701
Utena county;2005;4;1516;795;721
Utena county;2005;5;1648;850;798
Utena county;2005;6;1596;815;781
Utena county;2005;7;1722;872;850
Utena county;2005;8;1774;899;875
Utena county;2005;9;1861;944;917
Utena county;2005;10;1960;1036;924
Utena county;2005;11;2268;1179;1089
Utena county;2005;12;2580;1304;1276
Utena county;2005;13;2568;1344;1224
Utena county;2005;14;2617;1382;1235
Utena county;2005;15;2617;1354;1263
Utena county;2005;16;2816;1432;1384
Utena county;2005;17;2968;1500;1468
Utena county;2005;18;2899;1487;1412
Utena county;2005;19;2880;1506;1374
Utena county;2005;20;2729;1390;1339
Utena county;2005;21;2681;1396;1285
Utena county;2005;22;2231;1147;1084
Utena county;2005;23;1959;1101;858
Utena county;2005;24;1750;960;790
Utena county;2005;25;1831;988;843
Utena county;2005;26;1832;957;875
Utena county;2005;27;1740;912;828
Utena county;2005;28;1872;983;889
Utena county;2005;29;1876;937;939
Utena county;2005;30;1885;988;897
Utena county;2005;31;1944;1009;935
Utena county;2005;32;2112;1089;1023
Utena county;2005;33;2152;1092;1060
Utena county;2005;34;2224;1122;1102
Utena county;2005;35;2318;1173;1145
Utena county;2005;36;2407;1203;1204
Utena county;2005;37;2335;1137;1198
Utena county;2005;38;2379;1167;1212
Utena county;2005;39;2547;1289;1258
Utena county;2005;40;2594;1322;1272
Utena county;2005;41;2779;1469;1310
Utena county;2005;42;2839;1418;1421
Utena county;2005;43;3028;1479;1549
Utena county;2005;44;2959;1506;1453
Utena county;2005;45;2960;1437;1523
Utena county;2005;46;2787;1370;1417
Utena county;2005;47;2582;1273;1309
Utena county;2005;48;2448;1194;1254
Utena county;2005;49;2475;1214;1261
Utena county;2005;50;2223;1116;1107
Utena county;2005;51;2143;1056;1087
Utena county;2005;52;2180;1065;1115
Utena county;2005;53;2173;1045;1128
Utena county;2005;54;2127;1053;1074
Utena county;2005;55;2230;1088;1142
Utena county;2005;56;1969;942;1027
Utena county;2005;57;1740;820;920
Utena county;2005;58;1642;763;879
Utena county;2005;59;1938;885;1053
Utena county;2005;60;1599;761;838
Utena county;2005;61;1866;807;1059
Utena county;2005;62;2085;920;1165
Utena county;2005;63;2070;928;1142
Utena county;2005;64;2022;855;1167
Utena county;2005;65;2053;874;1179
Utena county;2005;66;2126;889;1237
Utena county;2005;67;2000;812;1188
Utena county;2005;68;2082;817;1265
Utena county;2005;69;1916;777;1139
Utena county;2005;70;1763;652;1111
Utena county;2005;71;1884;678;1206
Utena county;2005;72;1838;643;1195
Utena county;2005;73;1709;613;1096
Utena county;2005;74;1744;613;1131
Utena county;2005;75;1564;495;1069
Utena county;2005;76;1611;526;1085
Utena county;2005;77;1591;526;1065
Utena county;2005;78;1297;359;938
Utena county;2005;79;1290;349;941
Utena county;2005;80;1149;279;870
Utena county;2005;81;1072;298;774
Utena county;2005;82;875;232;643
Utena county;2005;83;805;200;605
Utena county;2005;84;660;187;473
Utena county;2005;85;2329;580;1749
Utena county;2006;-1;170829;80292;90537
Utena county;2006;0;1292;657;635
Utena county;2006;1;1294;672;622
Utena county;2006;2;1265;674;591
Utena county;2006;3;1235;595;640
Utena county;2006;4;1421;737;684
Utena county;2006;5;1497;787;710
Utena county;2006;6;1630;843;787
Utena county;2006;7;1586;807;779
Utena county;2006;8;1702;859;843
Utena county;2006;9;1765;896;869
Utena county;2006;10;1851;940;911
Utena county;2006;11;1948;1030;918
Utena county;2006;12;2253;1170;1083
Utena county;2006;13;2536;1274;1262
Utena county;2006;14;2534;1327;1207
Utena county;2006;15;2551;1344;1207
Utena county;2006;16;2531;1303;1228
Utena county;2006;17;2727;1376;1351
Utena county;2006;18;2854;1434;1420
Utena county;2006;19;2728;1400;1328
Utena county;2006;20;2722;1415;1307
Utena county;2006;21;2566;1308;1258
Utena county;2006;22;2529;1323;1206
Utena county;2006;23;2116;1093;1023
Utena county;2006;24;1845;1048;797
Utena county;2006;25;1609;888;721
Utena county;2006;26;1740;937;803
Utena county;2006;27;1749;913;836
Utena county;2006;28;1625;845;780
Utena county;2006;29;1788;942;846
Utena county;2006;30;1816;895;921
Utena county;2006;31;1831;955;876
Utena county;2006;32;1881;975;906
Utena county;2006;33;2032;1044;988
Utena county;2006;34;2080;1051;1029
Utena county;2006;35;2158;1078;1080
Utena county;2006;36;2266;1140;1126
Utena county;2006;37;2339;1160;1179
Utena county;2006;38;2268;1091;1177
Utena county;2006;39;2336;1136;1200
Utena county;2006;40;2503;1261;1242
Utena county;2006;41;2545;1297;1248
Utena county;2006;42;2719;1434;1285
Utena county;2006;43;2768;1382;1386
Utena county;2006;44;2969;1443;1526
Utena county;2006;45;2922;1485;1437
Utena county;2006;46;2910;1407;1503
Utena county;2006;47;2748;1343;1405
Utena county;2006;48;2550;1251;1299
Utena county;2006;49;2399;1168;1231
Utena county;2006;50;2425;1181;1244
Utena county;2006;51;2198;1108;1090
Utena county;2006;52;2088;1022;1066
Utena county;2006;53;2136;1036;1100
Utena county;2006;54;2118;1006;1112
Utena county;2006;55;2089;1024;1065
Utena county;2006;56;2181;1055;1126
Utena county;2006;57;1937;919;1018
Utena county;2006;58;1716;801;915
Utena county;2006;59;1609;745;864
Utena county;2006;60;1878;849;1029
Utena county;2006;61;1564;733;831
Utena county;2006;62;1821;777;1044
Utena county;2006;63;2035;875;1160
Utena county;2006;64;2023;894;1129
Utena county;2006;65;1981;822;1159
Utena county;2006;66;2007;847;1160
Utena county;2006;67;2063;842;1221
Utena county;2006;68;1930;772;1158
Utena county;2006;69;2035;785;1250
Utena county;2006;70;1864;742;1122
Utena county;2006;71;1709;628;1081
Utena county;2006;72;1812;642;1170
Utena county;2006;73;1785;616;1169
Utena county;2006;74;1644;572;1072
Utena county;2006;75;1669;580;1089
Utena county;2006;76;1499;459;1040
Utena county;2006;77;1533;487;1046
Utena county;2006;78;1505;488;1017
Utena county;2006;79;1235;335;900
Utena county;2006;80;1217;320;897
Utena county;2006;81;1063;258;805
Utena county;2006;82;970;273;697
Utena county;2006;83;796;204;592
Utena county;2006;84;704;153;551
Utena county;2006;85;2461;609;1852
Utena county;2007;-1;167678;78634;89044
Utena county;2007;0;1262;647;615
Utena county;2007;1;1285;654;631
Utena county;2007;2;1276;664;612
Utena county;2007;3;1264;668;596
Utena county;2007;4;1221;593;628
Utena county;2007;5;1411;733;678
Utena county;2007;6;1478;774;704
Utena county;2007;7;1621;837;784
Utena county;2007;8;1578;801;777
Utena county;2007;9;1688;853;835
Utena county;2007;10;1754;891;863
Utena county;2007;11;1848;936;912
Utena county;2007;12;1943;1023;920
Utena county;2007;13;2232;1160;1072
Utena county;2007;14;2517;1269;1248
Utena county;2007;15;2511;1317;1194
Utena county;2007;16;2518;1330;1188
Utena county;2007;17;2503;1288;1215
Utena county;2007;18;2673;1345;1328
Utena county;2007;19;2788;1405;1383
Utena county;2007;20;2652;1366;1286
Utena county;2007;21;2634;1365;1269
Utena county;2007;22;2491;1266;1225
Utena county;2007;23;2457;1280;1177
Utena county;2007;24;2055;1053;1002
Utena county;2007;25;1746;1002;744
Utena county;2007;26;1534;845;689
Utena county;2007;27;1675;897;778
Utena county;2007;28;1681;890;791
Utena county;2007;29;1569;812;757
Utena county;2007;30;1755;921;834
Utena county;2007;31;1778;877;901
Utena county;2007;32;1800;937;863
Utena county;2007;33;1849;963;886
Utena county;2007;34;1989;1017;972
Utena county;2007;35;2044;1025;1019
Utena county;2007;36;2124;1058;1066
Utena county;2007;37;2222;1116;1106
Utena county;2007;38;2303;1134;1169
Utena county;2007;39;2242;1083;1159
Utena county;2007;40;2294;1108;1186
Utena county;2007;41;2470;1240;1230
Utena county;2007;42;2498;1269;1229
Utena county;2007;43;2668;1404;1264
Utena county;2007;44;2719;1349;1370
Utena county;2007;45;2923;1415;1508
Utena county;2007;46;2890;1471;1419
Utena county;2007;47;2861;1372;1489
Utena county;2007;48;2718;1321;1397
Utena county;2007;49;2514;1228;1286
Utena county;2007;50;2342;1128;1214
Utena county;2007;51;2380;1147;1233
Utena county;2007;52;2172;1087;1085
Utena county;2007;53;2051;996;1055
Utena county;2007;54;2112;1019;1093
Utena county;2007;55;2075;980;1095
Utena county;2007;56;2046;999;1047
Utena county;2007;57;2137;1020;1117
Utena county;2007;58;1908;893;1015
Utena county;2007;59;1676;772;904
Utena county;2007;60;1559;713;846
Utena county;2007;61;1830;822;1008
Utena county;2007;62;1523;702;821
Utena county;2007;63;1781;743;1038
Utena county;2007;64;1991;837;1154
Utena county;2007;65;1967;863;1104
Utena county;2007;66;1935;788;1147
Utena county;2007;67;1957;811;1146
Utena county;2007;68;2011;812;1199
Utena county;2007;69;1878;739;1139
Utena county;2007;70;1961;738;1223
Utena county;2007;71;1799;699;1100
Utena county;2007;72;1658;597;1061
Utena county;2007;73;1756;617;1139
Utena county;2007;74;1707;569;1138
Utena county;2007;75;1584;534;1050
Utena county;2007;76;1593;537;1056
Utena county;2007;77;1423;424;999
Utena county;2007;78;1455;445;1010
Utena county;2007;79;1406;441;965
Utena county;2007;80;1164;308;856
Utena county;2007;81;1129;290;839
Utena county;2007;82;968;228;740
Utena county;2007;83;873;247;626
Utena county;2007;84;706;176;530
Utena county;2007;85;2639;641;1998
Utena county;2008;-1;164167;76794;87373
Utena county;2008;0;1197;634;563
Utena county;2008;1;1251;640;611
Utena county;2008;2;1272;643;629
Utena county;2008;3;1259;652;607
Utena county;2008;4;1236;657;579
Utena county;2008;5;1206;585;621
Utena county;2008;6;1395;725;670
Utena county;2008;7;1470;771;699
Utena county;2008;8;1611;828;783
Utena county;2008;9;1572;795;777
Utena county;2008;10;1678;847;831
Utena county;2008;11;1749;888;861
Utena county;2008;12;1846;937;909
Utena county;2008;13;1942;1024;918
Utena county;2008;14;2224;1153;1071
Utena county;2008;15;2507;1259;1248
Utena county;2008;16;2495;1304;1191
Utena county;2008;17;2483;1312;1171
Utena county;2008;18;2451;1259;1192
Utena county;2008;19;2619;1315;1304
Utena county;2008;20;2719;1368;1351
Utena county;2008;21;2571;1325;1246
Utena county;2008;22;2569;1327;1242
Utena county;2008;23;2425;1228;1197
Utena county;2008;24;2382;1253;1129
Utena county;2008;25;1974;1017;957
Utena county;2008;26;1676;966;710
Utena county;2008;27;1461;808;653
Utena county;2008;28;1588;856;732
Utena county;2008;29;1608;853;755
Utena county;2008;30;1504;772;732
Utena county;2008;31;1707;889;818
Utena county;2008;32;1744;866;878
Utena county;2008;33;1756;919;837
Utena county;2008;34;1808;935;873
Utena county;2008;35;1954;1001;953
Utena county;2008;36;2000;1008;992
Utena county;2008;37;2104;1040;1064
Utena county;2008;38;2188;1098;1090
Utena county;2008;39;2268;1114;1154
Utena county;2008;40;2211;1055;1156
Utena county;2008;41;2252;1085;1167
Utena county;2008;42;2428;1217;1211
Utena county;2008;43;2459;1246;1213
Utena county;2008;44;2601;1361;1240
Utena county;2008;45;2653;1315;1338
Utena county;2008;46;2880;1389;1491
Utena county;2008;47;2847;1440;1407
Utena county;2008;48;2810;1334;1476
Utena county;2008;49;2668;1294;1374
Utena county;2008;50;2468;1193;1275
Utena county;2008;51;2295;1093;1202
Utena county;2008;52;2336;1119;1217
Utena county;2008;53;2135;1063;1072
Utena county;2008;54;2004;964;1040
Utena county;2008;55;2068;987;1081
Utena county;2008;56;2040;952;1088
Utena county;2008;57;2000;969;1031
Utena county;2008;58;2102;991;1111
Utena county;2008;59;1860;860;1000
Utena county;2008;60;1635;744;891
Utena county;2008;61;1530;696;834
Utena county;2008;62;1786;788;998
Utena county;2008;63;1480;666;814
Utena county;2008;64;1750;730;1020
Utena county;2008;65;1929;793;1136
Utena county;2008;66;1900;811;1089
Utena county;2008;67;1873;743;1130
Utena county;2008;68;1904;781;1123
Utena county;2008;69;1942;771;1171
Utena county;2008;70;1812;697;1115
Utena county;2008;71;1891;699;1192
Utena county;2008;72;1731;656;1075
Utena county;2008;73;1596;560;1036
Utena county;2008;74;1684;575;1109
Utena county;2008;75;1625;518;1107
Utena county;2008;76;1508;497;1011
Utena county;2008;77;1514;504;1010
Utena county;2008;78;1349;385;964
Utena county;2008;79;1372;403;969
Utena county;2008;80;1298;391;907
Utena county;2008;81;1087;275;812
Utena county;2008;82;1045;261;784
Utena county;2008;83;860;193;667
Utena county;2008;84;773;208;565
Utena county;2008;85;2707;651;2056
Utena county;2009;-1;161062;75327;85735
Utena county;2009;0;1327;674;653
Utena county;2009;1;1178;621;557
Utena county;2009;2;1236;634;602
Utena county;2009;3;1251;633;618
Utena county;2009;4;1230;639;591
Utena county;2009;5;1217;646;571
Utena county;2009;6;1187;575;612
Utena county;2009;7;1385;716;669
Utena county;2009;8;1453;759;694
Utena county;2009;9;1611;829;782
Utena county;2009;10;1555;782;773
Utena county;2009;11;1676;849;827
Utena county;2009;12;1729;882;847
Utena county;2009;13;1824;922;902
Utena county;2009;14;1921;1010;911
Utena county;2009;15;2204;1134;1070
Utena county;2009;16;2484;1247;1237
Utena county;2009;17;2472;1287;1185
Utena county;2009;18;2453;1301;1152
Utena county;2009;19;2417;1242;1175
Utena county;2009;20;2571;1297;1274
Utena county;2009;21;2657;1335;1322
Utena county;2009;22;2510;1295;1215
Utena county;2009;23;2509;1301;1208
Utena county;2009;24;2342;1193;1149
Utena county;2009;25;2291;1216;1075
Utena county;2009;26;1873;971;902
Utena county;2009;27;1595;924;671
Utena county;2009;28;1410;781;629
Utena county;2009;29;1535;833;702
Utena county;2009;30;1548;830;718
Utena county;2009;31;1444;750;694
Utena county;2009;32;1644;855;789
Utena county;2009;33;1687;843;844
Utena county;2009;34;1700;886;814
Utena county;2009;35;1766;911;855
Utena county;2009;36;1909;968;941
Utena county;2009;37;1974;990;984
Utena county;2009;38;2072;1023;1049
Utena county;2009;39;2167;1083;1084
Utena county;2009;40;2228;1095;1133
Utena county;2009;41;2178;1038;1140
Utena county;2009;42;2233;1073;1160
Utena county;2009;43;2390;1197;1193
Utena county;2009;44;2416;1218;1198
Utena county;2009;45;2557;1337;1220
Utena county;2009;46;2615;1299;1316
Utena county;2009;47;2837;1363;1474
Utena county;2009;48;2803;1415;1388
Utena county;2009;49;2779;1321;1458
Utena county;2009;50;2620;1264;1356
Utena county;2009;51;2431;1172;1259
Utena county;2009;52;2252;1060;1192
Utena county;2009;53;2288;1086;1202
Utena county;2009;54;2099;1034;1065
Utena county;2009;55;1965;942;1023
Utena county;2009;56;2024;955;1069
Utena county;2009;57;2000;927;1073
Utena county;2009;58;1957;939;1018
Utena county;2009;59;2066;965;1101
Utena county;2009;60;1836;847;989
Utena county;2009;61;1597;716;881
Utena county;2009;62;1498;682;816
Utena county;2009;63;1752;767;985
Utena county;2009;64;1444;641;803
Utena county;2009;65;1710;697;1013
Utena county;2009;66;1863;757;1106
Utena county;2009;67;1869;782;1087
Utena county;2009;68;1834;722;1112
Utena county;2009;69;1840;744;1096
Utena county;2009;70;1881;742;1139
Utena county;2009;71;1768;670;1098
Utena county;2009;72;1835;670;1165
Utena county;2009;73;1666;620;1046
Utena county;2009;74;1528;527;1001
Utena county;2009;75;1612;543;1069
Utena county;2009;76;1551;483;1068
Utena county;2009;77;1423;456;967
Utena county;2009;78;1431;464;967
Utena county;2009;79;1268;351;917
Utena county;2009;80;1280;369;911
Utena county;2009;81;1206;356;850
Utena county;2009;82;995;243;752
Utena county;2009;83;961;234;727
Utena county;2009;84;772;169;603
Utena county;2009;85;2890;708;2182
Utena county;2010;-1;157472;73403;84069
Utena county;2010;0;1239;626;613
Utena county;2010;1;1305;658;647
Utena county;2010;2;1158;608;550
Utena county;2010;3;1209;624;585
Utena county;2010;4;1231;630;601
Utena county;2010;5;1212;628;584
Utena county;2010;6;1196;636;560
Utena county;2010;7;1174;566;608
Utena county;2010;8;1369;712;657
Utena county;2010;9;1440;753;687
Utena county;2010;10;1598;820;778
Utena county;2010;11;1536;775;761
Utena county;2010;12;1667;847;820
Utena county;2010;13;1714;873;841
Utena county;2010;14;1804;909;895
Utena county;2010;15;1916;1009;907
Utena county;2010;16;2178;1118;1060
Utena county;2010;17;2461;1234;1227
Utena county;2010;18;2451;1276;1175
Utena county;2010;19;2415;1282;1133
Utena county;2010;20;2367;1214;1153
Utena county;2010;21;2495;1265;1230
Utena county;2010;22;2563;1290;1273
Utena county;2010;23;2407;1231;1176
Utena county;2010;24;2408;1247;1161
Utena county;2010;25;2241;1147;1094
Utena county;2010;26;2166;1157;1009
Utena county;2010;27;1767;921;846
Utena county;2010;28;1503;874;629
Utena county;2010;29;1339;744;595
Utena county;2010;30;1472;792;680
Utena county;2010;31;1483;788;695
Utena county;2010;32;1394;725;669
Utena county;2010;33;1597;821;776
Utena county;2010;34;1641;819;822
Utena county;2010;35;1617;839;778
Utena county;2010;36;1714;881;833
Utena county;2010;37;1869;950;919
Utena county;2010;38;1944;968;976
Utena county;2010;39;2034;993;1041
Utena county;2010;40;2133;1061;1072
Utena county;2010;41;2190;1065;1125
Utena county;2010;42;2138;1013;1125
Utena county;2010;43;2190;1042;1148
Utena county;2010;44;2345;1160;1185
Utena county;2010;45;2373;1191;1182
Utena county;2010;46;2495;1297;1198
Utena county;2010;47;2582;1274;1308
Utena county;2010;48;2796;1334;1462
Utena county;2010;49;2752;1378;1374
Utena county;2010;50;2724;1281;1443
Utena county;2010;51;2579;1236;1343
Utena county;2010;52;2386;1143;1243
Utena county;2010;53;2216;1038;1178
Utena county;2010;54;2236;1050;1186
Utena county;2010;55;2071;1017;1054
Utena county;2010;56;1926;911;1015
Utena county;2010;57;1993;938;1055
Utena county;2010;58;1961;897;1064
Utena county;2010;59;1926;919;1007
Utena county;2010;60;2032;936;1096
Utena county;2010;61;1800;820;980
Utena county;2010;62;1558;693;865
Utena county;2010;63;1470;658;812
Utena county;2010;64;1702;729;973
Utena county;2010;65;1399;612;787
Utena county;2010;66;1660;658;1002
Utena county;2010;67;1815;727;1088
Utena county;2010;68;1826;750;1076
Utena county;2010;69;1791;693;1098
Utena county;2010;70;1787;708;1079
Utena county;2010;71;1820;703;1117
Utena county;2010;72;1704;631;1073
Utena county;2010;73;1766;627;1139
Utena county;2010;74;1591;572;1019
Utena county;2010;75;1467;498;969
Utena county;2010;76;1554;509;1045
Utena county;2010;77;1473;442;1031
Utena county;2010;78;1347;416;931
Utena county;2010;79;1335;422;913
Utena county;2010;80;1182;322;860
Utena county;2010;81;1200;332;868
Utena county;2010;82;1102;312;790
Utena county;2010;83;897;217;680
Utena county;2010;84;846;199;647
Utena county;2010;85;3042;722;2320
Utena county;2011;-1;152577;71200;81377
Utena county;2011;0;1055;536;519
Utena county;2011;1;1130;579;551
Utena county;2011;2;1190;604;586
Utena county;2011;3;1058;553;505
Utena county;2011;4;1119;567;552
Utena county;2011;5;1151;596;555
Utena county;2011;6;1132;594;538
Utena county;2011;7;1170;632;538
Utena county;2011;8;1158;546;612
Utena county;2011;9;1314;686;628
Utena county;2011;10;1442;761;681
Utena county;2011;11;1579;809;770
Utena county;2011;12;1540;772;768
Utena county;2011;13;1652;852;800
Utena county;2011;14;1710;883;827
Utena county;2011;15;1809;920;889
Utena county;2011;16;1929;997;932
Utena county;2011;17;2214;1144;1070
Utena county;2011;18;2441;1234;1207
Utena county;2011;19;2150;1158;992
Utena county;2011;20;2027;1109;918
Utena county;2011;21;1911;1049;862
Utena county;2011;22;1994;1058;936
Utena county;2011;23;2012;1070;942
Utena county;2011;24;1884;1024;860
Utena county;2011;25;1832;1001;831
Utena county;2011;26;1642;888;754
Utena county;2011;27;1517;824;693
Utena county;2011;28;1441;753;688
Utena county;2011;29;1456;799;657
Utena county;2011;30;1367;729;638
Utena county;2011;31;1464;760;704
Utena county;2011;32;1557;802;755
Utena county;2011;33;1487;745;742
Utena county;2011;34;1635;838;797
Utena county;2011;35;1745;863;882
Utena county;2011;36;1717;856;861
Utena county;2011;37;1802;902;900
Utena county;2011;38;2011;1036;975
Utena county;2011;39;2050;1014;1036
Utena county;2011;40;2097;1013;1084
Utena county;2011;41;2201;1103;1098
Utena county;2011;42;2265;1106;1159
Utena county;2011;43;2242;1065;1177
Utena county;2011;44;2266;1096;1170
Utena county;2011;45;2413;1209;1204
Utena county;2011;46;2472;1253;1219
Utena county;2011;47;2594;1352;1242
Utena county;2011;48;2611;1297;1314
Utena county;2011;49;2825;1361;1464
Utena county;2011;50;2759;1374;1385
Utena county;2011;51;2777;1325;1452
Utena county;2011;52;2576;1226;1350
Utena county;2011;53;2418;1157;1261
Utena county;2011;54;2261;1065;1196
Utena county;2011;55;2255;1076;1179
Utena county;2011;56;2077;999;1078
Utena county;2011;57;1921;898;1023
Utena county;2011;58;2017;945;1072
Utena county;2011;59;1969;897;1072
Utena county;2011;60;1928;892;1036
Utena county;2011;61;1996;900;1096
Utena county;2011;62;1786;808;978
Utena county;2011;63;1575;699;876
Utena county;2011;64;1435;627;808
Utena county;2011;65;1674;695;979
Utena county;2011;66;1461;636;825
Utena county;2011;67;1664;651;1013
Utena county;2011;68;1772;705;1067
Utena county;2011;69;1779;720;1059
Utena county;2011;70;1727;661;1066
Utena county;2011;71;1742;672;1070
Utena county;2011;72;1773;665;1108
Utena county;2011;73;1642;604;1038
Utena county;2011;74;1694;577;1117
Utena county;2011;75;1508;526;982
Utena county;2011;76;1392;448;944
Utena county;2011;77;1479;475;1004
Utena county;2011;78;1375;409;966
Utena county;2011;79;1252;377;875
Utena county;2011;80;1206;356;850
Utena county;2011;81;1091;284;807
Utena county;2011;82;1061;285;776
Utena county;2011;83;979;269;710
Utena county;2011;84;784;183;601
Utena county;2011;85;3292;716;2576
Utena county;2012;-1;149001;69563;79438
Utena county;2012;0;1136;596;540
Utena county;2012;1;1043;528;515
Utena county;2012;2;1125;580;545
Utena county;2012;3;1168;588;580
Utena county;2012;4;1049;548;501
Utena county;2012;5;1081;551;530
Utena county;2012;6;1134;588;546
Utena county;2012;7;1117;588;529
Utena county;2012;8;1161;631;530
Utena county;2012;9;1151;544;607
Utena county;2012;10;1301;681;620
Utena county;2012;11;1422;751;671
Utena county;2012;12;1555;794;761
Utena county;2012;13;1525;766;759
Utena county;2012;14;1629;842;787
Utena county;2012;15;1699;881;818
Utena county;2012;16;1794;912;882
Utena county;2012;17;1915;991;924
Utena county;2012;18;2196;1131;1065
Utena county;2012;19;2359;1197;1162
Utena county;2012;20;2104;1126;978
Utena county;2012;21;1975;1087;888
Utena county;2012;22;1816;1003;813
Utena county;2012;23;1851;1000;851
Utena county;2012;24;1872;1009;863
Utena county;2012;25;1785;982;803
Utena county;2012;26;1674;928;746
Utena county;2012;27;1497;835;662
Utena county;2012;28;1402;760;642
Utena county;2012;29;1329;712;617
Utena county;2012;30;1361;749;612
Utena county;2012;31;1284;695;589
Utena county;2012;32;1397;726;671
Utena county;2012;33;1512;784;728
Utena county;2012;34;1434;710;724
Utena county;2012;35;1583;816;767
Utena county;2012;36;1694;828;866
Utena county;2012;37;1687;841;846
Utena county;2012;38;1759;882;877
Utena county;2012;39;1988;1023;965
Utena county;2012;40;2017;987;1030
Utena county;2012;41;2070;999;1071
Utena county;2012;42;2174;1084;1090
Utena county;2012;43;2241;1096;1145
Utena county;2012;44;2228;1059;1169
Utena county;2012;45;2231;1077;1154
Utena county;2012;46;2372;1187;1185
Utena county;2012;47;2439;1239;1200
Utena county;2012;48;2573;1334;1239
Utena county;2012;49;2571;1273;1298
Utena county;2012;50;2790;1344;1446
Utena county;2012;51;2730;1358;1372
Utena county;2012;52;2740;1301;1439
Utena county;2012;53;2534;1196;1338
Utena county;2012;54;2383;1130;1253
Utena county;2012;55;2227;1042;1185
Utena county;2012;56;2233;1058;1175
Utena county;2012;57;2036;976;1060
Utena county;2012;58;1891;876;1015
Utena county;2012;59;1989;926;1063
Utena county;2012;60;1945;879;1066
Utena county;2012;61;1904;871;1033
Utena county;2012;62;1964;881;1083
Utena county;2012;63;1754;780;974
Utena county;2012;64;1539;678;861
Utena county;2012;65;1402;598;804
Utena county;2012;66;1632;663;969
Utena county;2012;67;1426;609;817
Utena county;2012;68;1636;635;1001
Utena county;2012;69;1728;678;1050
Utena county;2012;70;1726;679;1047
Utena county;2012;71;1682;633;1049
Utena county;2012;72;1694;643;1051
Utena county;2012;73;1725;642;1083
Utena county;2012;74;1577;570;1007
Utena county;2012;75;1625;539;1086
Utena county;2012;76;1446;489;957
Utena county;2012;77;1327;417;910
Utena county;2012;78;1402;441;961
Utena county;2012;79;1291;372;919
Utena county;2012;80;1145;333;812
Utena county;2012;81;1102;307;795
Utena county;2012;82;1012;262;750
Utena county;2012;83;979;259;720
Utena county;2012;84;867;228;639
Utena county;2012;85;3438;751;2687
Utena county;2013;-1;145760;68059;77701
Utena county;2013;0;1152;594;558
Utena county;2013;1;1122;586;536
Utena county;2013;2;991;509;482
Utena county;2013;3;1078;558;520
Utena county;2013;4;1151;576;575
Utena county;2013;5;1027;534;493
Utena county;2013;6;1050;533;517
Utena county;2013;7;1122;587;535
Utena county;2013;8;1106;580;526
Utena county;2013;9;1149;625;524
Utena county;2013;10;1143;543;600
Utena county;2013;11;1281;671;610
Utena county;2013;12;1412;742;670
Utena county;2013;13;1540;779;761
Utena county;2013;14;1508;759;749
Utena county;2013;15;1623;838;785
Utena county;2013;16;1693;881;812
Utena county;2013;17;1779;904;875
Utena county;2013;18;1896;980;916
Utena county;2013;19;2131;1104;1027
Utena county;2013;20;2309;1162;1147
Utena county;2013;21;2066;1112;954
Utena county;2013;22;1928;1064;864
Utena county;2013;23;1707;953;754
Utena county;2013;24;1714;946;768
Utena county;2013;25;1742;966;776
Utena county;2013;26;1652;925;727
Utena county;2013;27;1526;875;651
Utena county;2013;28;1411;801;610
Utena county;2013;29;1299;707;592
Utena county;2013;30;1240;673;567
Utena county;2013;31;1291;723;568
Utena county;2013;32;1229;661;568
Utena county;2013;33;1338;697;641
Utena county;2013;34;1458;751;707
Utena county;2013;35;1384;687;697
Utena county;2013;36;1536;785;751
Utena county;2013;37;1654;809;845
Utena county;2013;38;1659;819;840
Utena county;2013;39;1743;868;875
Utena county;2013;40;1975;1018;957
Utena county;2013;41;1984;969;1015
Utena county;2013;42;2059;1000;1059
Utena county;2013;43;2151;1070;1081
Utena county;2013;44;2216;1082;1134
Utena county;2013;45;2206;1045;1161
Utena county;2013;46;2216;1060;1156
Utena county;2013;47;2367;1178;1189
Utena county;2013;48;2406;1216;1190
Utena county;2013;49;2547;1321;1226
Utena county;2013;50;2551;1260;1291
Utena county;2013;51;2767;1329;1438
Utena county;2013;52;2712;1345;1367
Utena county;2013;53;2707;1279;1428
Utena county;2013;54;2504;1180;1324
Utena county;2013;55;2356;1105;1251
Utena county;2013;56;2201;1024;1177
Utena county;2013;57;2211;1040;1171
Utena county;2013;58;1997;955;1042
Utena county;2013;59;1860;856;1004
Utena county;2013;60;1955;900;1055
Utena county;2013;61;1902;845;1057
Utena county;2013;62;1865;837;1028
Utena county;2013;63;1936;863;1073
Utena county;2013;64;1719;751;968
Utena county;2013;65;1504;656;848
Utena county;2013;66;1371;579;792
Utena county;2013;67;1592;635;957
Utena county;2013;68;1394;586;808
Utena county;2013;69;1596;608;988
Utena county;2013;70;1678;650;1028
Utena county;2013;71;1665;640;1025
Utena county;2013;72;1627;607;1020
Utena county;2013;73;1639;614;1025
Utena county;2013;74;1684;614;1070
Utena county;2013;75;1525;544;981
Utena county;2013;76;1568;508;1060
Utena county;2013;77;1384;458;926
Utena county;2013;78;1259;381;878
Utena county;2013;79;1327;408;919
Utena county;2013;80;1213;337;876
Utena county;2013;81;1074;299;775
Utena county;2013;82;1008;269;739
Utena county;2013;83;932;231;701
Utena county;2013;84;901;231;670
Utena county;2013;85;3609;809;2800
Utena county;2014;-1;142564;66620;75944
Utena county;2014;0;1111;559;552
Utena county;2014;1;1142;586;556
Utena county;2014;2;1098;575;523
Utena county;2014;3;979;496;483
Utena county;2014;4;1047;539;508
Utena county;2014;5;1132;566;566
Utena county;2014;6;1002;515;487
Utena county;2014;7;1036;533;503
Utena county;2014;8;1109;583;526
Utena county;2014;9;1096;578;518
Utena county;2014;10;1138;620;518
Utena county;2014;11;1116;529;587
Utena county;2014;12;1271;670;601
Utena county;2014;13;1398;737;661
Utena county;2014;14;1528;773;755
Utena county;2014;15;1494;756;738
Utena county;2014;16;1605;826;779
Utena county;2014;17;1684;876;808
Utena county;2014;18;1759;896;863
Utena county;2014;19;1840;958;882
Utena county;2014;20;2072;1069;1003
Utena county;2014;21;2245;1135;1110
Utena county;2014;22;1983;1069;914
Utena county;2014;23;1818;1019;799
Utena county;2014;24;1641;936;705
Utena county;2014;25;1639;919;720
Utena county;2014;26;1634;927;707
Utena county;2014;27;1551;885;666
Utena county;2014;28;1437;835;602
Utena county;2014;29;1337;767;570
Utena county;2014;30;1213;663;550
Utena county;2014;31;1162;646;516
Utena county;2014;32;1239;699;540
Utena county;2014;33;1195;645;550
Utena county;2014;34;1302;682;620
Utena county;2014;35;1397;725;672
Utena county;2014;36;1339;670;669
Utena county;2014;37;1501;773;728
Utena county;2014;38;1622;794;828
Utena county;2014;39;1621;803;818
Utena county;2014;40;1716;848;868
Utena county;2014;41;1951;1003;948
Utena county;2014;42;1971;965;1006
Utena county;2014;43;2035;987;1048
Utena county;2014;44;2123;1055;1068
Utena county;2014;45;2198;1077;1121
Utena county;2014;46;2177;1034;1143
Utena county;2014;47;2188;1047;1141
Utena county;2014;48;2337;1166;1171
Utena county;2014;49;2387;1202;1185
Utena county;2014;50;2524;1304;1220
Utena county;2014;51;2525;1244;1281
Utena county;2014;52;2748;1315;1433
Utena county;2014;53;2667;1320;1347
Utena county;2014;54;2679;1256;1423
Utena county;2014;55;2477;1164;1313
Utena county;2014;56;2326;1083;1243
Utena county;2014;57;2170;1002;1168
Utena county;2014;58;2182;1013;1169
Utena county;2014;59;1962;921;1041
Utena county;2014;60;1830;839;991
Utena county;2014;61;1923;876;1047
Utena county;2014;62;1854;813;1041
Utena county;2014;63;1819;798;1021
Utena county;2014;64;1894;837;1057
Utena county;2014;65;1694;736;958
Utena county;2014;66;1468;629;839
Utena county;2014;67;1337;558;779
Utena county;2014;68;1553;612;941
Utena county;2014;69;1360;559;801
Utena county;2014;70;1554;581;973
Utena county;2014;71;1622;615;1007
Utena county;2014;72;1610;603;1007
Utena county;2014;73;1581;579;1002
Utena county;2014;74;1582;581;1001
Utena county;2014;75;1614;571;1043
Utena county;2014;76;1458;509;949
Utena county;2014;77;1497;471;1026
Utena county;2014;78;1318;433;885
Utena county;2014;79;1178;344;834
Utena county;2014;80;1240;372;868
Utena county;2014;81;1120;303;817
Utena county;2014;82;988;270;718
Utena county;2014;83;915;234;681
Utena county;2014;84;853;204;649
Utena county;2014;85;3826;855;2971
Utena county;2015;-1;140170;65649;74521
Utena county;2015;0;1146;624;522
Utena county;2015;1;1110;552;558
Utena county;2015;2;1110;567;543
Utena county;2015;3;1086;568;518
Utena county;2015;4;957;487;470
Utena county;2015;5;1039;537;502
Utena county;2015;6;1113;553;560
Utena county;2015;7;985;509;476
Utena county;2015;8;1036;530;506
Utena county;2015;9;1110;585;525
Utena county;2015;10;1093;577;516
Utena county;2015;11;1122;611;511
Utena county;2015;12;1107;526;581
Utena county;2015;13;1258;659;599
Utena county;2015;14;1397;740;657
Utena county;2015;15;1518;768;750
Utena county;2015;16;1480;753;727
Utena county;2015;17;1599;821;778
Utena county;2015;18;1659;865;794
Utena county;2015;19;1707;878;829
Utena county;2015;20;1811;941;870
Utena county;2015;21;2053;1069;984
Utena county;2015;22;2217;1122;1095
Utena county;2015;23;1921;1055;866
Utena county;2015;24;1739;988;751
Utena county;2015;25;1584;923;661
Utena county;2015;26;1551;893;658
Utena county;2015;27;1540;886;654
Utena county;2015;28;1486;864;622
Utena county;2015;29;1381;817;564
Utena county;2015;30;1269;737;532
Utena county;2015;31;1172;629;543
Utena county;2015;32;1134;632;502
Utena county;2015;33;1219;696;523
Utena county;2015;34;1182;650;532
Utena county;2015;35;1257;653;604
Utena county;2015;36;1360;698;662
Utena county;2015;37;1335;669;666
Utena county;2015;38;1486;773;713
Utena county;2015;39;1608;789;819
Utena county;2015;40;1616;801;815
Utena county;2015;41;1703;843;860
Utena county;2015;42;1942;1006;936
Utena county;2015;43;1956;963;993
Utena county;2015;44;2010;974;1036
Utena county;2015;45;2095;1044;1051
Utena county;2015;46;2182;1064;1118
Utena county;2015;47;2171;1027;1144
Utena county;2015;48;2168;1032;1136
Utena county;2015;49;2314;1150;1164
Utena county;2015;50;2381;1196;1185
Utena county;2015;51;2519;1298;1221
Utena county;2015;52;2506;1228;1278
Utena county;2015;53;2720;1298;1422
Utena county;2015;54;2631;1297;1334
Utena county;2015;55;2650;1239;1411
Utena county;2015;56;2465;1154;1311
Utena county;2015;57;2307;1074;1233
Utena county;2015;58;2147;984;1163
Utena county;2015;59;2157;990;1167
Utena county;2015;60;1918;888;1030
Utena county;2015;61;1806;815;991
Utena county;2015;62;1891;852;1039
Utena county;2015;63;1819;787;1032
Utena county;2015;64;1789;776;1013
Utena county;2015;65;1860;819;1041
Utena county;2015;66;1654;703;951
Utena county;2015;67;1434;599;835
Utena county;2015;68;1307;542;765
Utena county;2015;69;1511;582;929
Utena county;2015;70;1320;535;785
Utena county;2015;71;1515;556;959
Utena county;2015;72;1573;589;984
Utena county;2015;73;1560;572;988
Utena county;2015;74;1520;547;973
Utena county;2015;75;1523;548;975
Utena county;2015;76;1554;537;1017
Utena county;2015;77;1393;471;922
Utena county;2015;78;1412;424;988
Utena county;2015;79;1256;406;850
Utena county;2015;80;1110;315;795
Utena county;2015;81;1148;334;814
Utena county;2015;82;1035;272;763
Utena county;2015;83;920;243;677
Utena county;2015;84;833;208;625
Utena county;2015;85;3932;873;3059
Utena county;2016;-1;137193;64265;72928
Utena county;2016;0;1140;576;564
Utena county;2016;1;1141;620;521
Utena county;2016;2;1079;542;537
Utena county;2016;3;1082;550;532
Utena county;2016;4;1056;547;509
Utena county;2016;5;956;490;466
Utena county;2016;6;1025;538;487
Utena county;2016;7;1091;543;548
Utena county;2016;8;984;511;473
Utena county;2016;9;1030;527;503
Utena county;2016;10;1104;579;525
Utena county;2016;11;1086;573;513
Utena county;2016;12;1114;604;510
Utena county;2016;13;1101;524;577
Utena county;2016;14;1236;649;587
Utena county;2016;15;1376;735;641
Utena county;2016;16;1497;755;742
Utena county;2016;17;1469;741;728
Utena county;2016;18;1581;816;765
Utena county;2016;19;1615;840;775
Utena county;2016;20;1656;849;807
Utena county;2016;21;1773;924;849
Utena county;2016;22;1977;1026;951
Utena county;2016;23;2133;1082;1051
Utena county;2016;24;1812;995;817
Utena county;2016;25;1643;946;697
Utena county;2016;26;1487;870;617
Utena county;2016;27;1444;845;599
Utena county;2016;28;1445;842;603
Utena county;2016;29;1382;827;555
Utena county;2016;30;1324;802;522
Utena county;2016;31;1177;692;485
Utena county;2016;32;1104;587;517
Utena county;2016;33;1092;611;481
Utena county;2016;34;1183;671;512
Utena county;2016;35;1145;637;508
Utena county;2016;36;1223;637;586
Utena county;2016;37;1334;681;653
Utena county;2016;38;1310;658;652
Utena county;2016;39;1458;753;705
Utena county;2016;40;1584;777;807
Utena county;2016;41;1586;786;800
Utena county;2016;42;1704;845;859
Utena county;2016;43;1914;992;922
Utena county;2016;44;1937;952;985
Utena county;2016;45;1993;968;1025
Utena county;2016;46;2084;1043;1041
Utena county;2016;47;2156;1047;1109
Utena county;2016;48;2144;1008;1136
Utena county;2016;49;2154;1025;1129
Utena county;2016;50;2287;1130;1157
Utena county;2016;51;2351;1172;1179
Utena county;2016;52;2494;1282;1212
Utena county;2016;53;2485;1211;1274
Utena county;2016;54;2700;1286;1414
Utena county;2016;55;2586;1271;1315
Utena county;2016;56;2626;1223;1403
Utena county;2016;57;2431;1131;1300
Utena county;2016;58;2298;1066;1232
Utena county;2016;59;2130;974;1156
Utena county;2016;60;2121;963;1158
Utena county;2016;61;1892;872;1020
Utena county;2016;62;1779;793;986
Utena county;2016;63;1853;820;1033
Utena county;2016;64;1792;768;1024
Utena county;2016;65;1751;743;1008
Utena county;2016;66;1823;795;1028
Utena county;2016;67;1605;665;940
Utena county;2016;68;1390;572;818
Utena county;2016;69;1276;518;758
Utena county;2016;70;1470;554;916
Utena county;2016;71;1279;506;773
Utena county;2016;72;1466;525;941
Utena county;2016;73;1519;552;967
Utena county;2016;74;1509;541;968
Utena county;2016;75;1453;515;938
Utena county;2016;76;1454;508;946
Utena county;2016;77;1492;507;985
Utena county;2016;78;1327;440;887
Utena county;2016;79;1331;384;947
Utena county;2016;80;1198;378;820
Utena county;2016;81;1054;296;758
Utena county;2016;82;1056;302;754
Utena county;2016;83;965;253;712
Utena county;2016;84;827;210;617
Utena county;2016;85;4002;901;3101
Utena county;2017;-1;133481;62542;70939
Utena county;2017;0;1069;568;501
Utena county;2017;1;1122;576;546
Utena county;2017;2;1122;605;517
Utena county;2017;3;1076;542;534
Utena county;2017;4;1067;544;523
Utena county;2017;5;1035;540;495
Utena county;2017;6;922;467;455
Utena county;2017;7;1019;537;482
Utena county;2017;8;1077;542;535
Utena county;2017;9;980;515;465
Utena county;2017;10;1014;520;494
Utena county;2017;11;1087;566;521
Utena county;2017;12;1064;562;502
Utena county;2017;13;1104;596;508
Utena county;2017;14;1086;519;567
Utena county;2017;15;1226;643;583
Utena county;2017;16;1368;726;642
Utena county;2017;17;1477;741;736
Utena county;2017;18;1448;729;719
Utena county;2017;19;1527;788;739
Utena county;2017;20;1557;811;746
Utena county;2017;21;1596;818;778
Utena county;2017;22;1728;900;828
Utena county;2017;23;1869;984;885
Utena county;2017;24;2006;1024;982
Utena county;2017;25;1705;951;754
Utena county;2017;26;1509;882;627
Utena county;2017;27;1354;812;542
Utena county;2017;28;1334;810;524
Utena county;2017;29;1331;785;546
Utena county;2017;30;1277;763;514
Utena county;2017;31;1221;751;470
Utena county;2017;32;1072;620;452
Utena county;2017;33;1018;541;477
Utena county;2017;34;1010;557;453
Utena county;2017;35;1093;620;473
Utena county;2017;36;1071;594;477
Utena county;2017;37;1176;618;558
Utena county;2017;38;1306;661;645
Utena county;2017;39;1276;634;642
Utena county;2017;40;1422;735;687
Utena county;2017;41;1565;765;800
Utena county;2017;42;1551;774;777
Utena county;2017;43;1680;836;844
Utena county;2017;44;1864;965;899
Utena county;2017;45;1906;944;962
Utena county;2017;46;1970;953;1017
Utena county;2017;47;2045;1021;1024
Utena county;2017;48;2129;1029;1100
Utena county;2017;49;2120;995;1125
Utena county;2017;50;2129;1010;1119
Utena county;2017;51;2248;1106;1142
Utena county;2017;52;2321;1151;1170
Utena county;2017;53;2462;1261;1201
Utena county;2017;54;2452;1190;1262
Utena county;2017;55;2657;1263;1394
Utena county;2017;56;2552;1247;1305
Utena county;2017;57;2590;1201;1389
Utena county;2017;58;2397;1110;1287
Utena county;2017;59;2260;1043;1217
Utena county;2017;60;2107;964;1143
Utena county;2017;61;2095;942;1153
Utena county;2017;62;1864;849;1015
Utena county;2017;63;1769;785;984
Utena county;2017;64;1826;801;1025
Utena county;2017;65;1760;738;1022
Utena county;2017;66;1722;723;999
Utena county;2017;67;1782;767;1015
Utena county;2017;68;1574;646;928
Utena county;2017;69;1351;548;803
Utena county;2017;70;1239;493;746
Utena county;2017;71;1423;533;890
Utena county;2017;72;1232;476;756
Utena county;2017;73;1399;487;912
Utena county;2017;74;1474;521;953
Utena county;2017;75;1460;510;950
Utena county;2017;76;1397;487;910
Utena county;2017;77;1391;475;916
Utena county;2017;78;1413;468;945
Utena county;2017;79;1256;404;852
Utena county;2017;80;1242;353;889
Utena county;2017;81;1114;338;776
Utena county;2017;82;971;268;703
Utena county;2017;83;971;263;708
Utena county;2017;84;873;232;641
Utena county;2017;85;4057;910;3147
Utena county;2018;-1;129639;60685;68954
Utena county;2018;0;987;513;474
Utena county;2018;1;1053;560;493
Utena county;2018;2;1100;561;539
Utena county;2018;3;1113;594;519
Utena county;2018;4;1087;546;541
Utena county;2018;5;1066;544;522
Utena county;2018;6;1023;532;491
Utena county;2018;7;923;474;449
Utena county;2018;8;1013;533;480
Utena county;2018;9;1072;538;534
Utena county;2018;10;971;511;460
Utena county;2018;11;1000;509;491
Utena county;2018;12;1067;555;512
Utena county;2018;13;1053;556;497
Utena county;2018;14;1095;594;501
Utena county;2018;15;1076;518;558
Utena county;2018;16;1211;633;578
Utena county;2018;17;1352;712;640
Utena county;2018;18;1452;725;727
Utena county;2018;19;1367;696;671
Utena county;2018;20;1448;743;705
Utena county;2018;21;1472;761;711
Utena county;2018;22;1504;770;734
Utena county;2018;23;1589;834;755
Utena county;2018;24;1759;940;819
Utena county;2018;25;1864;974;890
Utena county;2018;26;1556;874;682
Utena county;2018;27;1385;818;567
Utena county;2018;28;1222;743;479
Utena county;2018;29;1170;725;445
Utena county;2018;30;1205;719;486
Utena county;2018;31;1143;700;443
Utena county;2018;32;1111;681;430
Utena county;2018;33;1007;586;421
Utena county;2018;34;957;510;447
Utena county;2018;35;979;536;443
Utena county;2018;36;1042;586;456
Utena county;2018;37;1025;562;463
Utena county;2018;38;1133;599;534
Utena county;2018;39;1261;633;628
Utena county;2018;40;1246;619;627
Utena county;2018;41;1381;706;675
Utena county;2018;42;1535;752;783
Utena county;2018;43;1545;767;778
Utena county;2018;44;1664;828;836
Utena county;2018;45;1816;930;886
Utena county;2018;46;1886;937;949
Utena county;2018;47;1960;952;1008
Utena county;2018;48;2026;1009;1017
Utena county;2018;49;2118;1031;1087
Utena county;2018;50;2095;989;1106
Utena county;2018;51;2106;990;1116
Utena county;2018;52;2208;1079;1129
Utena county;2018;53;2293;1128;1165
Utena county;2018;54;2445;1247;1198
Utena county;2018;55;2419;1169;1250
Utena county;2018;56;2619;1235;1384
Utena county;2018;57;2513;1226;1287
Utena county;2018;58;2570;1193;1377
Utena county;2018;59;2357;1085;1272
Utena county;2018;60;2237;1027;1210
Utena county;2018;61;2086;945;1141
Utena county;2018;62;2060;914;1146
Utena county;2018;63;1839;825;1014
Utena county;2018;64;1735;760;975
Utena county;2018;65;1787;774;1013
Utena county;2018;66;1744;725;1019
Utena county;2018;67;1695;705;990
Utena county;2018;68;1734;734;1000
Utena county;2018;69;1526;613;913
Utena county;2018;70;1325;533;792
Utena county;2018;71;1203;468;735
Utena county;2018;72;1377;506;871
Utena county;2018;73;1193;458;735
Utena county;2018;74;1336;452;884
Utena county;2018;75;1419;496;923
Utena county;2018;76;1411;482;929
Utena county;2018;77;1325;449;876
Utena county;2018;78;1324;431;893
Utena county;2018;79;1344;434;910
Utena county;2018;80;1191;374;817
Utena county;2018;81;1153;318;835
Utena county;2018;82;1025;300;725
Utena county;2018;83;885;241;644
Utena county;2018;84;872;226;646
Utena county;2018;85;4098;925;3173
Utena d. mun.;2001;-1;50176;23561;26615
Utena d. mun.;2001;0;401;210;191
Utena d. mun.;2001;1;482;238;244
Utena d. mun.;2001;2;446;222;224
Utena d. mun.;2001;3;493;252;241
Utena d. mun.;2001;4;504;235;269
Utena d. mun.;2001;5;549;275;274
Utena d. mun.;2001;6;539;291;248
Utena d. mun.;2001;7;663;332;331
Utena d. mun.;2001;8;758;379;379
Utena d. mun.;2001;9;761;376;385
Utena d. mun.;2001;10;776;411;365
Utena d. mun.;2001;11;697;364;333
Utena d. mun.;2001;12;777;380;397
Utena d. mun.;2001;13;787;407;380
Utena d. mun.;2001;14;803;377;426
Utena d. mun.;2001;15;814;437;377
Utena d. mun.;2001;16;806;386;420
Utena d. mun.;2001;17;767;386;381
Utena d. mun.;2001;18;697;326;371
Utena d. mun.;2001;19;640;330;310
Utena d. mun.;2001;20;592;284;308
Utena d. mun.;2001;21;547;272;275
Utena d. mun.;2001;22;570;285;285
Utena d. mun.;2001;23;560;302;258
Utena d. mun.;2001;24;583;309;274
Utena d. mun.;2001;25;612;279;333
Utena d. mun.;2001;26;606;304;302
Utena d. mun.;2001;27;630;314;316
Utena d. mun.;2001;28;681;348;333
Utena d. mun.;2001;29;712;347;365
Utena d. mun.;2001;30;730;366;364
Utena d. mun.;2001;31;777;398;379
Utena d. mun.;2001;32;760;371;389
Utena d. mun.;2001;33;746;369;377
Utena d. mun.;2001;34;734;367;367
Utena d. mun.;2001;35;744;378;366
Utena d. mun.;2001;36;793;393;400
Utena d. mun.;2001;37;839;440;399
Utena d. mun.;2001;38;753;379;374
Utena d. mun.;2001;39;856;455;401
Utena d. mun.;2001;40;833;424;409
Utena d. mun.;2001;41;831;374;457
Utena d. mun.;2001;42;723;338;385
Utena d. mun.;2001;43;703;358;345
Utena d. mun.;2001;44;688;326;362
Utena d. mun.;2001;45;698;347;351
Utena d. mun.;2001;46;647;308;339
Utena d. mun.;2001;47;608;302;306
Utena d. mun.;2001;48;606;272;334
Utena d. mun.;2001;49;636;282;354
Utena d. mun.;2001;50;628;305;323
Utena d. mun.;2001;51;641;310;331
Utena d. mun.;2001;52;568;264;304
Utena d. mun.;2001;53;476;221;255
Utena d. mun.;2001;54;498;229;269
Utena d. mun.;2001;55;617;297;320
Utena d. mun.;2001;56;500;252;248
Utena d. mun.;2001;57;624;312;312
Utena d. mun.;2001;58;639;287;352
Utena d. mun.;2001;59;567;275;292
Utena d. mun.;2001;60;533;247;286
Utena d. mun.;2001;61;556;259;297
Utena d. mun.;2001;62;531;213;318
Utena d. mun.;2001;63;538;242;296
Utena d. mun.;2001;64;579;240;339
Utena d. mun.;2001;65;499;219;280
Utena d. mun.;2001;66;492;196;296
Utena d. mun.;2001;67;525;228;297
Utena d. mun.;2001;68;462;198;264
Utena d. mun.;2001;69;466;183;283
Utena d. mun.;2001;70;469;198;271
Utena d. mun.;2001;71;434;150;284
Utena d. mun.;2001;72;434;168;266
Utena d. mun.;2001;73;459;163;296
Utena d. mun.;2001;74;371;111;260
Utena d. mun.;2001;75;369;128;241
Utena d. mun.;2001;76;316;91;225
Utena d. mun.;2001;77;357;113;244
Utena d. mun.;2001;78;331;103;228
Utena d. mun.;2001;79;267;67;200
Utena d. mun.;2001;80;221;63;158
Utena d. mun.;2001;81;155;41;114
Utena d. mun.;2001;82;106;34;72
Utena d. mun.;2001;83;96;19;77
Utena d. mun.;2001;84;113;28;85
Utena d. mun.;2001;85;781;202;579
Utena d. mun.;2002;-1;49790;23346;26444
Utena d. mun.;2002;0;400;192;208
Utena d. mun.;2002;1;405;211;194
Utena d. mun.;2002;2;489;238;251
Utena d. mun.;2002;3;446;223;223
Utena d. mun.;2002;4;496;255;241
Utena d. mun.;2002;5;506;234;272
Utena d. mun.;2002;6;548;274;274
Utena d. mun.;2002;7;539;293;246
Utena d. mun.;2002;8;660;331;329
Utena d. mun.;2002;9;754;379;375
Utena d. mun.;2002;10;760;376;384
Utena d. mun.;2002;11;772;405;367
Utena d. mun.;2002;12;688;360;328
Utena d. mun.;2002;13;765;373;392
Utena d. mun.;2002;14;783;404;379
Utena d. mun.;2002;15;792;368;424
Utena d. mun.;2002;16;803;431;372
Utena d. mun.;2002;17;790;376;414
Utena d. mun.;2002;18;746;377;369
Utena d. mun.;2002;19;672;314;358
Utena d. mun.;2002;20;635;326;309
Utena d. mun.;2002;21;579;276;303
Utena d. mun.;2002;22;537;264;273
Utena d. mun.;2002;23;564;282;282
Utena d. mun.;2002;24;552;295;257
Utena d. mun.;2002;25;578;302;276
Utena d. mun.;2002;26;598;273;325
Utena d. mun.;2002;27;604;301;303
Utena d. mun.;2002;28;621;306;315
Utena d. mun.;2002;29;674;343;331
Utena d. mun.;2002;30;703;341;362
Utena d. mun.;2002;31;708;355;353
Utena d. mun.;2002;32;764;389;375
Utena d. mun.;2002;33;750;368;382
Utena d. mun.;2002;34;739;365;374
Utena d. mun.;2002;35;726;360;366
Utena d. mun.;2002;36;738;375;363
Utena d. mun.;2002;37;782;388;394
Utena d. mun.;2002;38;827;432;395
Utena d. mun.;2002;39;739;370;369
Utena d. mun.;2002;40;844;447;397
Utena d. mun.;2002;41;825;419;406
Utena d. mun.;2002;42;830;374;456
Utena d. mun.;2002;43;719;338;381
Utena d. mun.;2002;44;693;351;342
Utena d. mun.;2002;45;671;317;354
Utena d. mun.;2002;46;689;342;347
Utena d. mun.;2002;47;646;312;334
Utena d. mun.;2002;48;601;299;302
Utena d. mun.;2002;49;592;263;329
Utena d. mun.;2002;50;630;276;354
Utena d. mun.;2002;51;611;294;317
Utena d. mun.;2002;52;637;310;327
Utena d. mun.;2002;53;566;265;301
Utena d. mun.;2002;54;462;213;249
Utena d. mun.;2002;55;488;224;264
Utena d. mun.;2002;56;605;291;314
Utena d. mun.;2002;57;494;251;243
Utena d. mun.;2002;58;611;305;306
Utena d. mun.;2002;59;622;279;343
Utena d. mun.;2002;60;567;277;290
Utena d. mun.;2002;61;532;242;290
Utena d. mun.;2002;62;551;256;295
Utena d. mun.;2002;63;532;214;318
Utena d. mun.;2002;64;540;243;297
Utena d. mun.;2002;65;573;231;342
Utena d. mun.;2002;66;496;217;279
Utena d. mun.;2002;67;487;190;297
Utena d. mun.;2002;68;517;223;294
Utena d. mun.;2002;69;446;189;257
Utena d. mun.;2002;70;465;178;287
Utena d. mun.;2002;71;461;194;267
Utena d. mun.;2002;72;427;148;279
Utena d. mun.;2002;73;423;165;258
Utena d. mun.;2002;74;448;156;292
Utena d. mun.;2002;75;367;110;257
Utena d. mun.;2002;76;355;123;232
Utena d. mun.;2002;77;309;86;223
Utena d. mun.;2002;78;343;106;237
Utena d. mun.;2002;79;318;101;217
Utena d. mun.;2002;80;253;62;191
Utena d. mun.;2002;81;201;56;145
Utena d. mun.;2002;82;148;35;113
Utena d. mun.;2002;83;99;30;69
Utena d. mun.;2002;84;84;15;69
Utena d. mun.;2002;85;780;204;576
Utena d. mun.;2003;-1;49439;23169;26270
Utena d. mun.;2003;0;326;165;161
Utena d. mun.;2003;1;408;196;212
Utena d. mun.;2003;2;410;214;196
Utena d. mun.;2003;3;490;241;249
Utena d. mun.;2003;4;451;222;229
Utena d. mun.;2003;5;499;257;242
Utena d. mun.;2003;6;510;236;274
Utena d. mun.;2003;7;549;277;272
Utena d. mun.;2003;8;541;294;247
Utena d. mun.;2003;9;662;333;329
Utena d. mun.;2003;10;749;376;373
Utena d. mun.;2003;11;762;378;384
Utena d. mun.;2003;12;771;404;367
Utena d. mun.;2003;13;680;357;323
Utena d. mun.;2003;14;759;367;392
Utena d. mun.;2003;15;777;399;378
Utena d. mun.;2003;16;782;364;418
Utena d. mun.;2003;17;794;425;369
Utena d. mun.;2003;18;778;371;407
Utena d. mun.;2003;19;739;375;364
Utena d. mun.;2003;20;662;310;352
Utena d. mun.;2003;21;629;324;305
Utena d. mun.;2003;22;564;272;292
Utena d. mun.;2003;23;538;263;275
Utena d. mun.;2003;24;568;286;282
Utena d. mun.;2003;25;553;293;260
Utena d. mun.;2003;26;576;301;275
Utena d. mun.;2003;27;589;270;319
Utena d. mun.;2003;28;597;300;297
Utena d. mun.;2003;29;610;303;307
Utena d. mun.;2003;30;666;338;328
Utena d. mun.;2003;31;696;336;360
Utena d. mun.;2003;32;708;355;353
Utena d. mun.;2003;33;763;391;372
Utena d. mun.;2003;34;747;367;380
Utena d. mun.;2003;35;721;355;366
Utena d. mun.;2003;36;726;361;365
Utena d. mun.;2003;37;731;369;362
Utena d. mun.;2003;38;775;386;389
Utena d. mun.;2003;39;816;426;390
Utena d. mun.;2003;40;736;369;367
Utena d. mun.;2003;41;836;445;391
Utena d. mun.;2003;42;822;417;405
Utena d. mun.;2003;43;829;375;454
Utena d. mun.;2003;44;713;337;376
Utena d. mun.;2003;45;689;350;339
Utena d. mun.;2003;46;666;315;351
Utena d. mun.;2003;47;681;336;345
Utena d. mun.;2003;48;645;309;336
Utena d. mun.;2003;49;601;299;302
Utena d. mun.;2003;50;585;259;326
Utena d. mun.;2003;51;620;275;345
Utena d. mun.;2003;52;606;290;316
Utena d. mun.;2003;53;634;310;324
Utena d. mun.;2003;54;554;258;296
Utena d. mun.;2003;55;449;205;244
Utena d. mun.;2003;56;482;218;264
Utena d. mun.;2003;57;599;288;311
Utena d. mun.;2003;58;489;248;241
Utena d. mun.;2003;59;601;298;303
Utena d. mun.;2003;60;613;273;340
Utena d. mun.;2003;61;557;268;289
Utena d. mun.;2003;62;526;240;286
Utena d. mun.;2003;63;540;247;293
Utena d. mun.;2003;64;518;206;312
Utena d. mun.;2003;65;532;239;293
Utena d. mun.;2003;66;567;230;337
Utena d. mun.;2003;67;489;210;279
Utena d. mun.;2003;68;477;180;297
Utena d. mun.;2003;69;499;208;291
Utena d. mun.;2003;70;440;183;257
Utena d. mun.;2003;71;456;169;287
Utena d. mun.;2003;72;446;187;259
Utena d. mun.;2003;73;418;142;276
Utena d. mun.;2003;74;413;162;251
Utena d. mun.;2003;75;430;142;288
Utena d. mun.;2003;76;360;109;251
Utena d. mun.;2003;77;349;117;232
Utena d. mun.;2003;78;296;77;219
Utena d. mun.;2003;79;324;102;222
Utena d. mun.;2003;80;300;88;212
Utena d. mun.;2003;81;243;53;190
Utena d. mun.;2003;82;184;47;137
Utena d. mun.;2003;83;136;26;110
Utena d. mun.;2003;84;89;31;58
Utena d. mun.;2003;85;728;175;553
Utena d. mun.;2004;-1;48800;22862;25938
Utena d. mun.;2004;0;345;179;166
Utena d. mun.;2004;1;328;165;163
Utena d. mun.;2004;2;405;193;212
Utena d. mun.;2004;3;412;215;197
Utena d. mun.;2004;4;486;241;245
Utena d. mun.;2004;5;449;223;226
Utena d. mun.;2004;6;503;260;243
Utena d. mun.;2004;7;506;234;272
Utena d. mun.;2004;8;545;275;270
Utena d. mun.;2004;9;537;291;246
Utena d. mun.;2004;10;662;333;329
Utena d. mun.;2004;11;742;375;367
Utena d. mun.;2004;12;764;379;385
Utena d. mun.;2004;13;762;400;362
Utena d. mun.;2004;14;667;351;316
Utena d. mun.;2004;15;754;367;387
Utena d. mun.;2004;16;766;396;370
Utena d. mun.;2004;17;767;359;408
Utena d. mun.;2004;18;776;415;361
Utena d. mun.;2004;19;761;361;400
Utena d. mun.;2004;20;718;364;354
Utena d. mun.;2004;21;643;303;340
Utena d. mun.;2004;22;611;311;300
Utena d. mun.;2004;23;539;266;273
Utena d. mun.;2004;24;537;259;278
Utena d. mun.;2004;25;558;276;282
Utena d. mun.;2004;26;532;282;250
Utena d. mun.;2004;27;560;287;273
Utena d. mun.;2004;28;575;264;311
Utena d. mun.;2004;29;583;293;290
Utena d. mun.;2004;30;591;293;298
Utena d. mun.;2004;31;653;331;322
Utena d. mun.;2004;32;678;324;354
Utena d. mun.;2004;33;690;349;341
Utena d. mun.;2004;34;748;384;364
Utena d. mun.;2004;35;734;362;372
Utena d. mun.;2004;36;709;348;361
Utena d. mun.;2004;37;713;358;355
Utena d. mun.;2004;38;716;362;354
Utena d. mun.;2004;39;768;384;384
Utena d. mun.;2004;40;801;418;383
Utena d. mun.;2004;41;727;365;362
Utena d. mun.;2004;42;823;438;385
Utena d. mun.;2004;43;817;418;399
Utena d. mun.;2004;44;815;366;449
Utena d. mun.;2004;45;716;341;375
Utena d. mun.;2004;46;672;339;333
Utena d. mun.;2004;47;655;310;345
Utena d. mun.;2004;48;673;331;342
Utena d. mun.;2004;49;637;306;331
Utena d. mun.;2004;50;588;295;293
Utena d. mun.;2004;51;586;266;320
Utena d. mun.;2004;52;609;270;339
Utena d. mun.;2004;53;589;281;308
Utena d. mun.;2004;54;631;309;322
Utena d. mun.;2004;55;554;259;295
Utena d. mun.;2004;56;449;203;246
Utena d. mun.;2004;57;476;215;261
Utena d. mun.;2004;58;588;278;310
Utena d. mun.;2004;59;480;242;238
Utena d. mun.;2004;60;583;288;295
Utena d. mun.;2004;61;599;264;335
Utena d. mun.;2004;62;537;254;283
Utena d. mun.;2004;63;531;240;291
Utena d. mun.;2004;64;532;240;292
Utena d. mun.;2004;65;517;202;315
Utena d. mun.;2004;66;530;237;293
Utena d. mun.;2004;67;564;227;337
Utena d. mun.;2004;68;483;204;279
Utena d. mun.;2004;69;471;174;297
Utena d. mun.;2004;70;484;198;286
Utena d. mun.;2004;71;430;175;255
Utena d. mun.;2004;72;452;167;285
Utena d. mun.;2004;73;425;176;249
Utena d. mun.;2004;74;414;137;277
Utena d. mun.;2004;75;404;156;248
Utena d. mun.;2004;76;412;137;275
Utena d. mun.;2004;77;346;101;245
Utena d. mun.;2004;78;333;108;225
Utena d. mun.;2004;79;289;75;214
Utena d. mun.;2004;80;296;88;208
Utena d. mun.;2004;81;278;77;201
Utena d. mun.;2004;82;229;49;180
Utena d. mun.;2004;83;170;38;132
Utena d. mun.;2004;84;117;24;93
Utena d. mun.;2004;85;695;164;531
Utena d. mun.;2005;-1;48139;22511;25628
Utena d. mun.;2005;0;325;165;160
Utena d. mun.;2005;1;346;180;166
Utena d. mun.;2005;2;322;161;161
Utena d. mun.;2005;3;402;193;209
Utena d. mun.;2005;4;409;213;196
Utena d. mun.;2005;5;478;237;241
Utena d. mun.;2005;6;448;222;226
Utena d. mun.;2005;7;498;256;242
Utena d. mun.;2005;8;504;234;270
Utena d. mun.;2005;9;543;273;270
Utena d. mun.;2005;10;537;292;245
Utena d. mun.;2005;11;660;333;327
Utena d. mun.;2005;12;735;369;366
Utena d. mun.;2005;13;760;379;381
Utena d. mun.;2005;14;750;396;354
Utena d. mun.;2005;15;658;348;310
Utena d. mun.;2005;16;744;362;382
Utena d. mun.;2005;17;756;391;365
Utena d. mun.;2005;18;750;351;399
Utena d. mun.;2005;19;754;405;349
Utena d. mun.;2005;20;740;348;392
Utena d. mun.;2005;21;692;352;340
Utena d. mun.;2005;22;632;297;335
Utena d. mun.;2005;23;586;299;287
Utena d. mun.;2005;24;520;255;265
Utena d. mun.;2005;25;516;254;262
Utena d. mun.;2005;26;538;265;273
Utena d. mun.;2005;27;501;266;235
Utena d. mun.;2005;28;542;275;267
Utena d. mun.;2005;29;564;259;305
Utena d. mun.;2005;30;572;287;285
Utena d. mun.;2005;31;582;290;292
Utena d. mun.;2005;32;642;327;315
Utena d. mun.;2005;33;668;316;352
Utena d. mun.;2005;34;679;342;337
Utena d. mun.;2005;35;729;374;355
Utena d. mun.;2005;36;723;357;366
Utena d. mun.;2005;37;708;344;364
Utena d. mun.;2005;38;708;357;351
Utena d. mun.;2005;39;704;354;350
Utena d. mun.;2005;40;755;379;376
Utena d. mun.;2005;41;791;412;379
Utena d. mun.;2005;42;720;361;359
Utena d. mun.;2005;43;822;432;390
Utena d. mun.;2005;44;810;414;396
Utena d. mun.;2005;45;805;361;444
Utena d. mun.;2005;46;713;341;372
Utena d. mun.;2005;47;668;336;332
Utena d. mun.;2005;48;648;304;344
Utena d. mun.;2005;49;668;326;342
Utena d. mun.;2005;50;631;304;327
Utena d. mun.;2005;51;582;290;292
Utena d. mun.;2005;52;576;260;316
Utena d. mun.;2005;53;600;262;338
Utena d. mun.;2005;54;580;278;302
Utena d. mun.;2005;55;626;305;321
Utena d. mun.;2005;56;546;250;296
Utena d. mun.;2005;57;441;198;243
Utena d. mun.;2005;58;467;207;260
Utena d. mun.;2005;59;588;273;315
Utena d. mun.;2005;60;472;236;236
Utena d. mun.;2005;61;568;274;294
Utena d. mun.;2005;62;587;255;332
Utena d. mun.;2005;63;536;250;286
Utena d. mun.;2005;64;527;237;290
Utena d. mun.;2005;65;519;235;284
Utena d. mun.;2005;66;515;202;313
Utena d. mun.;2005;67;522;228;294
Utena d. mun.;2005;68;556;218;338
Utena d. mun.;2005;69;481;198;283
Utena d. mun.;2005;70;454;166;288
Utena d. mun.;2005;71;471;191;280
Utena d. mun.;2005;72;424;171;253
Utena d. mun.;2005;73;435;160;275
Utena d. mun.;2005;74;402;165;237
Utena d. mun.;2005;75;398;126;272
Utena d. mun.;2005;76;392;150;242
Utena d. mun.;2005;77;401;126;275
Utena d. mun.;2005;78;325;94;231
Utena d. mun.;2005;79;325;105;220
Utena d. mun.;2005;80;274;71;203
Utena d. mun.;2005;81;279;81;198
Utena d. mun.;2005;82;251;68;183
Utena d. mun.;2005;83;219;44;175
Utena d. mun.;2005;84;157;36;121
Utena d. mun.;2005;85;687;153;534
Utena d. mun.;2006;-1;47296;22042;25254
Utena d. mun.;2006;0;317;161;156
Utena d. mun.;2006;1;322;164;158
Utena d. mun.;2006;2;342;174;168
Utena d. mun.;2006;3;318;160;158
Utena d. mun.;2006;4;398;191;207
Utena d. mun.;2006;5;409;213;196
Utena d. mun.;2006;6;478;238;240
Utena d. mun.;2006;7;445;219;226
Utena d. mun.;2006;8;497;258;239
Utena d. mun.;2006;9;503;235;268
Utena d. mun.;2006;10;543;272;271
Utena d. mun.;2006;11;534;289;245
Utena d. mun.;2006;12;659;333;326
Utena d. mun.;2006;13;725;363;362
Utena d. mun.;2006;14;757;378;379
Utena d. mun.;2006;15;736;390;346
Utena d. mun.;2006;16;639;336;303
Utena d. mun.;2006;17;726;350;376
Utena d. mun.;2006;18;733;378;355
Utena d. mun.;2006;19;711;333;378
Utena d. mun.;2006;20;724;384;340
Utena d. mun.;2006;21;699;329;370
Utena d. mun.;2006;22;663;337;326
Utena d. mun.;2006;23;614;288;326
Utena d. mun.;2006;24;566;288;278
Utena d. mun.;2006;25;483;238;245
Utena d. mun.;2006;26;493;239;254
Utena d. mun.;2006;27;510;249;261
Utena d. mun.;2006;28;481;252;229
Utena d. mun.;2006;29;524;267;257
Utena d. mun.;2006;30;554;252;302
Utena d. mun.;2006;31;567;284;283
Utena d. mun.;2006;32;570;277;293
Utena d. mun.;2006;33;628;317;311
Utena d. mun.;2006;34;656;310;346
Utena d. mun.;2006;35;663;333;330
Utena d. mun.;2006;36;713;362;351
Utena d. mun.;2006;37;706;348;358
Utena d. mun.;2006;38;690;331;359
Utena d. mun.;2006;39;697;349;348
Utena d. mun.;2006;40;692;350;342
Utena d. mun.;2006;41;743;374;369
Utena d. mun.;2006;42;773;400;373
Utena d. mun.;2006;43;707;353;354
Utena d. mun.;2006;44;807;422;385
Utena d. mun.;2006;45;802;413;389
Utena d. mun.;2006;46;796;357;439
Utena d. mun.;2006;47;711;337;374
Utena d. mun.;2006;48;669;338;331
Utena d. mun.;2006;49;635;297;338
Utena d. mun.;2006;50;655;322;333
Utena d. mun.;2006;51;623;299;324
Utena d. mun.;2006;52;575;285;290
Utena d. mun.;2006;53;570;256;314
Utena d. mun.;2006;54;590;255;335
Utena d. mun.;2006;55;575;274;301
Utena d. mun.;2006;56;620;301;319
Utena d. mun.;2006;57;540;246;294
Utena d. mun.;2006;58;433;194;239
Utena d. mun.;2006;59;461;205;256
Utena d. mun.;2006;60;573;265;308
Utena d. mun.;2006;61;461;228;233
Utena d. mun.;2006;62;559;265;294
Utena d. mun.;2006;63;576;246;330
Utena d. mun.;2006;64;525;241;284
Utena d. mun.;2006;65;515;231;284
Utena d. mun.;2006;66;517;234;283
Utena d. mun.;2006;67;504;193;311
Utena d. mun.;2006;68;511;219;292
Utena d. mun.;2006;69;548;213;335
Utena d. mun.;2006;70;471;192;279
Utena d. mun.;2006;71;440;158;282
Utena d. mun.;2006;72;458;184;274
Utena d. mun.;2006;73;418;164;254
Utena d. mun.;2006;74;416;151;265
Utena d. mun.;2006;75;393;160;233
Utena d. mun.;2006;76;386;118;268
Utena d. mun.;2006;77;380;142;238
Utena d. mun.;2006;78;385;116;269
Utena d. mun.;2006;79;319;90;229
Utena d. mun.;2006;80;311;98;213
Utena d. mun.;2006;81;257;63;194
Utena d. mun.;2006;82;258;74;184
Utena d. mun.;2006;83;230;58;172
Utena d. mun.;2006;84;201;38;163
Utena d. mun.;2006;85;714;154;560
Utena d. mun.;2007;-1;46783;21751;25032
Utena d. mun.;2007;0;348;179;169
Utena d. mun.;2007;1;321;164;157
Utena d. mun.;2007;2;319;164;155
Utena d. mun.;2007;3;349;178;171
Utena d. mun.;2007;4;315;159;156
Utena d. mun.;2007;5;402;193;209
Utena d. mun.;2007;6;412;214;198
Utena d. mun.;2007;7;474;235;239
Utena d. mun.;2007;8;442;216;226
Utena d. mun.;2007;9;491;256;235
Utena d. mun.;2007;10;501;235;266
Utena d. mun.;2007;11;546;272;274
Utena d. mun.;2007;12;536;288;248
Utena d. mun.;2007;13;661;335;326
Utena d. mun.;2007;14;721;360;361
Utena d. mun.;2007;15;753;378;375
Utena d. mun.;2007;16;731;386;345
Utena d. mun.;2007;17;636;334;302
Utena d. mun.;2007;18;715;344;371
Utena d. mun.;2007;19;719;371;348
Utena d. mun.;2007;20;702;326;376
Utena d. mun.;2007;21;710;373;337
Utena d. mun.;2007;22;680;319;361
Utena d. mun.;2007;23;649;327;322
Utena d. mun.;2007;24;606;279;327
Utena d. mun.;2007;25;544;280;264
Utena d. mun.;2007;26;479;238;241
Utena d. mun.;2007;27;476;233;243
Utena d. mun.;2007;28;504;250;254
Utena d. mun.;2007;29;478;250;228
Utena d. mun.;2007;30;517;261;256
Utena d. mun.;2007;31;551;250;301
Utena d. mun.;2007;32;570;284;286
Utena d. mun.;2007;33;565;272;293
Utena d. mun.;2007;34;625;315;310
Utena d. mun.;2007;35;650;303;347
Utena d. mun.;2007;36;657;327;330
Utena d. mun.;2007;37;706;358;348
Utena d. mun.;2007;38;699;343;356
Utena d. mun.;2007;39;682;325;357
Utena d. mun.;2007;40;688;345;343
Utena d. mun.;2007;41;688;348;340
Utena d. mun.;2007;42;729;363;366
Utena d. mun.;2007;43;761;393;368
Utena d. mun.;2007;44;697;346;351
Utena d. mun.;2007;45;800;419;381
Utena d. mun.;2007;46;802;414;388
Utena d. mun.;2007;47;786;350;436
Utena d. mun.;2007;48;706;335;371
Utena d. mun.;2007;49;664;333;331
Utena d. mun.;2007;50;624;291;333
Utena d. mun.;2007;51;643;312;331
Utena d. mun.;2007;52;619;298;321
Utena d. mun.;2007;53;561;275;286
Utena d. mun.;2007;54;564;252;312
Utena d. mun.;2007;55;584;253;331
Utena d. mun.;2007;56;564;270;294
Utena d. mun.;2007;57;608;295;313
Utena d. mun.;2007;58;526;234;292
Utena d. mun.;2007;59;430;192;238
Utena d. mun.;2007;60;446;193;253
Utena d. mun.;2007;61;555;253;302
Utena d. mun.;2007;62;448;221;227
Utena d. mun.;2007;63;550;255;295
Utena d. mun.;2007;64;565;235;330
Utena d. mun.;2007;65;514;230;284
Utena d. mun.;2007;66;510;230;280
Utena d. mun.;2007;67;509;227;282
Utena d. mun.;2007;68;487;184;303
Utena d. mun.;2007;69;502;212;290
Utena d. mun.;2007;70;533;202;331
Utena d. mun.;2007;71;462;184;278
Utena d. mun.;2007;72;427;148;279
Utena d. mun.;2007;73;439;177;262
Utena d. mun.;2007;74;400;149;251
Utena d. mun.;2007;75;407;143;264
Utena d. mun.;2007;76;372;148;224
Utena d. mun.;2007;77;368;108;260
Utena d. mun.;2007;78;374;138;236
Utena d. mun.;2007;79;365;105;260
Utena d. mun.;2007;80;308;85;223
Utena d. mun.;2007;81;295;90;205
Utena d. mun.;2007;82;242;59;183
Utena d. mun.;2007;83;238;70;168
Utena d. mun.;2007;84;208;50;158
Utena d. mun.;2007;85;773;163;610
Utena d. mun.;2008;-1;46056;21378;24678
Utena d. mun.;2008;0;358;181;177
Utena d. mun.;2008;1;343;175;168
Utena d. mun.;2008;2;318;163;155
Utena d. mun.;2008;3;320;166;154
Utena d. mun.;2008;4;339;173;166
Utena d. mun.;2008;5;313;155;158
Utena d. mun.;2008;6;392;189;203
Utena d. mun.;2008;7;415;217;198
Utena d. mun.;2008;8;471;233;238
Utena d. mun.;2008;9;441;216;225
Utena d. mun.;2008;10;488;255;233
Utena d. mun.;2008;11;496;234;262
Utena d. mun.;2008;12;549;275;274
Utena d. mun.;2008;13;533;284;249
Utena d. mun.;2008;14;661;335;326
Utena d. mun.;2008;15;721;363;358
Utena d. mun.;2008;16;748;377;371
Utena d. mun.;2008;17;720;383;337
Utena d. mun.;2008;18;623;327;296
Utena d. mun.;2008;19;705;339;366
Utena d. mun.;2008;20;704;364;340
Utena d. mun.;2008;21;685;320;365
Utena d. mun.;2008;22;697;366;331
Utena d. mun.;2008;23;665;315;350
Utena d. mun.;2008;24;636;323;313
Utena d. mun.;2008;25;595;276;319
Utena d. mun.;2008;26;522;269;253
Utena d. mun.;2008;27;465;233;232
Utena d. mun.;2008;28;455;225;230
Utena d. mun.;2008;29;486;243;243
Utena d. mun.;2008;30;462;243;219
Utena d. mun.;2008;31;510;258;252
Utena d. mun.;2008;32;537;246;291
Utena d. mun.;2008;33;557;276;281
Utena d. mun.;2008;34;561;270;291
Utena d. mun.;2008;35;624;315;309
Utena d. mun.;2008;36;639;298;341
Utena d. mun.;2008;37;650;322;328
Utena d. mun.;2008;38;698;353;345
Utena d. mun.;2008;39;687;336;351
Utena d. mun.;2008;40;673;318;355
Utena d. mun.;2008;41;678;340;338
Utena d. mun.;2008;42;674;338;336
Utena d. mun.;2008;43;717;358;359
Utena d. mun.;2008;44;748;384;364
Utena d. mun.;2008;45;687;341;346
Utena d. mun.;2008;46;795;417;378
Utena d. mun.;2008;47;789;406;383
Utena d. mun.;2008;48;778;347;431
Utena d. mun.;2008;49;696;329;367
Utena d. mun.;2008;50;654;325;329
Utena d. mun.;2008;51;614;285;329
Utena d. mun.;2008;52;633;305;328
Utena d. mun.;2008;53;614;293;321
Utena d. mun.;2008;54;556;272;284
Utena d. mun.;2008;55;556;247;309
Utena d. mun.;2008;56;581;249;332
Utena d. mun.;2008;57;554;264;290
Utena d. mun.;2008;58;603;292;311
Utena d. mun.;2008;59;514;225;289
Utena d. mun.;2008;60;420;185;235
Utena d. mun.;2008;61;439;189;250
Utena d. mun.;2008;62;544;244;300
Utena d. mun.;2008;63;434;210;224
Utena d. mun.;2008;64;541;251;290
Utena d. mun.;2008;65;542;215;327
Utena d. mun.;2008;66;501;218;283
Utena d. mun.;2008;67;492;219;273
Utena d. mun.;2008;68;488;212;276
Utena d. mun.;2008;69;472;179;293
Utena d. mun.;2008;70;483;197;286
Utena d. mun.;2008;71;516;190;326
Utena d. mun.;2008;72;446;170;276
Utena d. mun.;2008;73;409;137;272
Utena d. mun.;2008;74;426;167;259
Utena d. mun.;2008;75;376;132;244
Utena d. mun.;2008;76;385;135;250
Utena d. mun.;2008;77;368;143;225
Utena d. mun.;2008;78;345;102;243
Utena d. mun.;2008;79;355;126;229
Utena d. mun.;2008;80;342;96;246
Utena d. mun.;2008;81;285;74;211
Utena d. mun.;2008;82;281;86;195
Utena d. mun.;2008;83;214;49;165
Utena d. mun.;2008;84;212;54;158
Utena d. mun.;2008;85;837;172;665
Utena d. mun.;2009;-1;45558;21142;24416
Utena d. mun.;2009;0;376;189;187
Utena d. mun.;2009;1;346;175;171
Utena d. mun.;2009;2;337;173;164
Utena d. mun.;2009;3;312;160;152
Utena d. mun.;2009;4;322;165;157
Utena d. mun.;2009;5;334;171;163
Utena d. mun.;2009;6;310;153;157
Utena d. mun.;2009;7;392;188;204
Utena d. mun.;2009;8;407;212;195
Utena d. mun.;2009;9;465;231;234
Utena d. mun.;2009;10;434;210;224
Utena d. mun.;2009;11;489;256;233
Utena d. mun.;2009;12;493;232;261
Utena d. mun.;2009;13;545;273;272
Utena d. mun.;2009;14;531;283;248
Utena d. mun.;2009;15;657;333;324
Utena d. mun.;2009;16;725;363;362
Utena d. mun.;2009;17;745;372;373
Utena d. mun.;2009;18;718;383;335
Utena d. mun.;2009;19;621;325;296
Utena d. mun.;2009;20;699;338;361
Utena d. mun.;2009;21;689;357;332
Utena d. mun.;2009;22;673;315;358
Utena d. mun.;2009;23;683;363;320
Utena d. mun.;2009;24;645;309;336
Utena d. mun.;2009;25;622;312;310
Utena d. mun.;2009;26;574;272;302
Utena d. mun.;2009;27;509;260;249
Utena d. mun.;2009;28;457;229;228
Utena d. mun.;2009;29;447;228;219
Utena d. mun.;2009;30;469;234;235
Utena d. mun.;2009;31;446;235;211
Utena d. mun.;2009;32;503;252;251
Utena d. mun.;2009;33;523;241;282
Utena d. mun.;2009;34;539;267;272
Utena d. mun.;2009;35;553;265;288
Utena d. mun.;2009;36;612;308;304
Utena d. mun.;2009;37;637;300;337
Utena d. mun.;2009;38;650;323;327
Utena d. mun.;2009;39;692;346;346
Utena d. mun.;2009;40;677;333;344
Utena d. mun.;2009;41;667;316;351
Utena d. mun.;2009;42;673;336;337
Utena d. mun.;2009;43;666;335;331
Utena d. mun.;2009;44;708;352;356
Utena d. mun.;2009;45;741;380;361
Utena d. mun.;2009;46;680;338;342
Utena d. mun.;2009;47;783;412;371
Utena d. mun.;2009;48;791;407;384
Utena d. mun.;2009;49;778;349;429
Utena d. mun.;2009;50;692;329;363
Utena d. mun.;2009;51;652;324;328
Utena d. mun.;2009;52;611;282;329
Utena d. mun.;2009;53;634;304;330
Utena d. mun.;2009;54;597;282;315
Utena d. mun.;2009;55;549;265;284
Utena d. mun.;2009;56;549;241;308
Utena d. mun.;2009;57;570;241;329
Utena d. mun.;2009;58;544;256;288
Utena d. mun.;2009;59;596;287;309
Utena d. mun.;2009;60;512;223;289
Utena d. mun.;2009;61;413;181;232
Utena d. mun.;2009;62;437;189;248
Utena d. mun.;2009;63;531;234;297
Utena d. mun.;2009;64;421;199;222
Utena d. mun.;2009;65;527;240;287
Utena d. mun.;2009;66;525;205;320
Utena d. mun.;2009;67;500;216;284
Utena d. mun.;2009;68;486;218;268
Utena d. mun.;2009;69;475;205;270
Utena d. mun.;2009;70;464;174;290
Utena d. mun.;2009;71;479;192;287
Utena d. mun.;2009;72;505;181;324
Utena d. mun.;2009;73;432;162;270
Utena d. mun.;2009;74;397;128;269
Utena d. mun.;2009;75;400;155;245
Utena d. mun.;2009;76;357;123;234
Utena d. mun.;2009;77;359;121;238
Utena d. mun.;2009;78;345;133;212
Utena d. mun.;2009;79;328;89;239
Utena d. mun.;2009;80;340;120;220
Utena d. mun.;2009;81;323;90;233
Utena d. mun.;2009;82;264;66;198
Utena d. mun.;2009;83;269;80;189
Utena d. mun.;2009;84;207;48;159
Utena d. mun.;2009;85;923;200;723
Utena d. mun.;2010;-1;44636;20635;24001
Utena d. mun.;2010;0;360;187;173
Utena d. mun.;2010;1;366;182;184
Utena d. mun.;2010;2;340;171;169
Utena d. mun.;2010;3;329;168;161
Utena d. mun.;2010;4;308;159;149
Utena d. mun.;2010;5;321;164;157
Utena d. mun.;2010;6;328;169;159
Utena d. mun.;2010;7;310;155;155
Utena d. mun.;2010;8;392;190;202
Utena d. mun.;2010;9;408;214;194
Utena d. mun.;2010;10;460;228;232
Utena d. mun.;2010;11;428;209;219
Utena d. mun.;2010;12;490;257;233
Utena d. mun.;2010;13;494;235;259
Utena d. mun.;2010;14;541;271;270
Utena d. mun.;2010;15;537;287;250
Utena d. mun.;2010;16;654;330;324
Utena d. mun.;2010;17;720;360;360
Utena d. mun.;2010;18;741;370;371
Utena d. mun.;2010;19;704;376;328
Utena d. mun.;2010;20;610;320;290
Utena d. mun.;2010;21;684;333;351
Utena d. mun.;2010;22;672;345;327
Utena d. mun.;2010;23;653;304;349
Utena d. mun.;2010;24;656;350;306
Utena d. mun.;2010;25;622;301;321
Utena d. mun.;2010;26;583;296;287
Utena d. mun.;2010;27;541;255;286
Utena d. mun.;2010;28;476;241;235
Utena d. mun.;2010;29;434;221;213
Utena d. mun.;2010;30;423;213;210
Utena d. mun.;2010;31;448;217;231
Utena d. mun.;2010;32;430;227;203
Utena d. mun.;2010;33;489;241;248
Utena d. mun.;2010;34;502;230;272
Utena d. mun.;2010;35;522;253;269
Utena d. mun.;2010;36;541;257;284
Utena d. mun.;2010;37;599;302;297
Utena d. mun.;2010;38;622;289;333
Utena d. mun.;2010;39;638;313;325
Utena d. mun.;2010;40;681;338;343
Utena d. mun.;2010;41;665;322;343
Utena d. mun.;2010;42;651;304;347
Utena d. mun.;2010;43;660;326;334
Utena d. mun.;2010;44;654;323;331
Utena d. mun.;2010;45;694;343;351
Utena d. mun.;2010;46;730;369;361
Utena d. mun.;2010;47;679;334;345
Utena d. mun.;2010;48;764;396;368
Utena d. mun.;2010;49;772;392;380
Utena d. mun.;2010;50;761;336;425
Utena d. mun.;2010;51;676;316;360
Utena d. mun.;2010;52;642;316;326
Utena d. mun.;2010;53;594;271;323
Utena d. mun.;2010;54;620;294;326
Utena d. mun.;2010;55;592;280;312
Utena d. mun.;2010;56;531;251;280
Utena d. mun.;2010;57;540;238;302
Utena d. mun.;2010;58;559;235;324
Utena d. mun.;2010;59;537;253;284
Utena d. mun.;2010;60;590;280;310
Utena d. mun.;2010;61;496;214;282
Utena d. mun.;2010;62;407;179;228
Utena d. mun.;2010;63;428;183;245
Utena d. mun.;2010;64;521;224;297
Utena d. mun.;2010;65;414;195;219
Utena d. mun.;2010;66;507;227;280
Utena d. mun.;2010;67;511;198;313
Utena d. mun.;2010;68;488;209;279
Utena d. mun.;2010;69;479;212;267
Utena d. mun.;2010;70;466;199;267
Utena d. mun.;2010;71;450;166;284
Utena d. mun.;2010;72;469;186;283
Utena d. mun.;2010;73;489;170;319
Utena d. mun.;2010;74;418;151;267
Utena d. mun.;2010;75;386;124;262
Utena d. mun.;2010;76;384;147;237
Utena d. mun.;2010;77;341;114;227
Utena d. mun.;2010;78;344;112;232
Utena d. mun.;2010;79;319;119;200
Utena d. mun.;2010;80;307;85;222
Utena d. mun.;2010;81;311;101;210
Utena d. mun.;2010;82;299;82;217
Utena d. mun.;2010;83;241;62;179
Utena d. mun.;2010;84;234;66;168
Utena d. mun.;2010;85;959;203;756
Utena d. mun.;2011;-1;43396;20061;23335
Utena d. mun.;2011;0;305;158;147
Utena d. mun.;2011;1;364;183;181
Utena d. mun.;2011;2;356;182;174
Utena d. mun.;2011;3;329;165;164
Utena d. mun.;2011;4;322;165;157
Utena d. mun.;2011;5;302;152;150
Utena d. mun.;2011;6;321;163;158
Utena d. mun.;2011;7;330;172;158
Utena d. mun.;2011;8;312;150;162
Utena d. mun.;2011;9;377;187;190
Utena d. mun.;2011;10;386;204;182
Utena d. mun.;2011;11;466;226;240
Utena d. mun.;2011;12;441;216;225
Utena d. mun.;2011;13;475;249;226
Utena d. mun.;2011;14;499;238;261
Utena d. mun.;2011;15;531;264;267
Utena d. mun.;2011;16;528;279;249
Utena d. mun.;2011;17;663;336;327
Utena d. mun.;2011;18;713;355;358
Utena d. mun.;2011;19;657;332;325
Utena d. mun.;2011;20;640;343;297
Utena d. mun.;2011;21;538;291;247
Utena d. mun.;2011;22;549;287;262
Utena d. mun.;2011;23;582;297;285
Utena d. mun.;2011;24;548;278;270
Utena d. mun.;2011;25;558;315;243
Utena d. mun.;2011;26;499;262;237
Utena d. mun.;2011;27;456;234;222
Utena d. mun.;2011;28;446;227;219
Utena d. mun.;2011;29;459;250;209
Utena d. mun.;2011;30;414;214;200
Utena d. mun.;2011;31;440;230;210
Utena d. mun.;2011;32;478;241;237
Utena d. mun.;2011;33;441;215;226
Utena d. mun.;2011;34;486;247;239
Utena d. mun.;2011;35;526;245;281
Utena d. mun.;2011;36;531;256;275
Utena d. mun.;2011;37;536;259;277
Utena d. mun.;2011;38;618;317;301
Utena d. mun.;2011;39;626;300;326
Utena d. mun.;2011;40;627;293;334
Utena d. mun.;2011;41;702;344;358
Utena d. mun.;2011;42;684;324;360
Utena d. mun.;2011;43;679;325;354
Utena d. mun.;2011;44;666;328;338
Utena d. mun.;2011;45;672;335;337
Utena d. mun.;2011;46;718;348;370
Utena d. mun.;2011;47;775;391;384
Utena d. mun.;2011;48;698;343;355
Utena d. mun.;2011;49;782;405;377
Utena d. mun.;2011;50;761;378;383
Utena d. mun.;2011;51;770;338;432
Utena d. mun.;2011;52;683;317;366
Utena d. mun.;2011;53;648;309;339
Utena d. mun.;2011;54;603;285;318
Utena d. mun.;2011;55;616;289;327
Utena d. mun.;2011;56;587;270;317
Utena d. mun.;2011;57;538;246;292
Utena d. mun.;2011;58;544;236;308
Utena d. mun.;2011;59;545;219;326
Utena d. mun.;2011;60;524;230;294
Utena d. mun.;2011;61;579;267;312
Utena d. mun.;2011;62;478;204;274
Utena d. mun.;2011;63;402;172;230
Utena d. mun.;2011;64;426;176;250
Utena d. mun.;2011;65;504;209;295
Utena d. mun.;2011;66;412;184;228
Utena d. mun.;2011;67;498;213;285
Utena d. mun.;2011;68;495;189;306
Utena d. mun.;2011;69;462;190;272
Utena d. mun.;2011;70;443;183;260
Utena d. mun.;2011;71;446;182;264
Utena d. mun.;2011;72;439;157;282
Utena d. mun.;2011;73;443;171;272
Utena d. mun.;2011;74;465;153;312
Utena d. mun.;2011;75;393;138;255
Utena d. mun.;2011;76;369;113;256
Utena d. mun.;2011;77;363;133;230
Utena d. mun.;2011;78;320;102;218
Utena d. mun.;2011;79;313;100;213
Utena d. mun.;2011;80;287;97;190
Utena d. mun.;2011;81;287;75;212
Utena d. mun.;2011;82;284;91;193
Utena d. mun.;2011;83;266;73;193
Utena d. mun.;2011;84;216;54;162
Utena d. mun.;2011;85;936;198;738
Utena d. mun.;2012;-1;42531;19680;22851
Utena d. mun.;2012;0;317;171;146
Utena d. mun.;2012;1;298;152;146
Utena d. mun.;2012;2;349;175;174
Utena d. mun.;2012;3;343;175;168
Utena d. mun.;2012;4;320;165;155
Utena d. mun.;2012;5;314;163;151
Utena d. mun.;2012;6;298;149;149
Utena d. mun.;2012;7;318;164;154
Utena d. mun.;2012;8;325;169;156
Utena d. mun.;2012;9;308;151;157
Utena d. mun.;2012;10;378;188;190
Utena d. mun.;2012;11;378;199;179
Utena d. mun.;2012;12;463;224;239
Utena d. mun.;2012;13;436;211;225
Utena d. mun.;2012;14;466;244;222
Utena d. mun.;2012;15;499;240;259
Utena d. mun.;2012;16;524;260;264
Utena d. mun.;2012;17;526;278;248
Utena d. mun.;2012;18;661;334;327
Utena d. mun.;2012;19;691;345;346
Utena d. mun.;2012;20;652;323;329
Utena d. mun.;2012;21;628;338;290
Utena d. mun.;2012;22;522;284;238
Utena d. mun.;2012;23;504;264;240
Utena d. mun.;2012;24;556;285;271
Utena d. mun.;2012;25;533;273;260
Utena d. mun.;2012;26;520;298;222
Utena d. mun.;2012;27;449;245;204
Utena d. mun.;2012;28;421;218;203
Utena d. mun.;2012;29;434;224;210
Utena d. mun.;2012;30;444;244;200
Utena d. mun.;2012;31;382;204;178
Utena d. mun.;2012;32;428;220;208
Utena d. mun.;2012;33;465;236;229
Utena d. mun.;2012;34;424;208;216
Utena d. mun.;2012;35;480;247;233
Utena d. mun.;2012;36;519;243;276
Utena d. mun.;2012;37;523;251;272
Utena d. mun.;2012;38;515;250;265
Utena d. mun.;2012;39;613;316;297
Utena d. mun.;2012;40;616;293;323
Utena d. mun.;2012;41;622;294;328
Utena d. mun.;2012;42;698;342;356
Utena d. mun.;2012;43;681;323;358
Utena d. mun.;2012;44;673;323;350
Utena d. mun.;2012;45;659;324;335
Utena d. mun.;2012;46;660;329;331
Utena d. mun.;2012;47;710;346;364
Utena d. mun.;2012;48;766;383;383
Utena d. mun.;2012;49;688;337;351
Utena d. mun.;2012;50;777;402;375
Utena d. mun.;2012;51;751;370;381
Utena d. mun.;2012;52;759;331;428
Utena d. mun.;2012;53;675;313;362
Utena d. mun.;2012;54;642;304;338
Utena d. mun.;2012;55;597;279;318
Utena d. mun.;2012;56;606;279;327
Utena d. mun.;2012;57;574;261;313
Utena d. mun.;2012;58;534;242;292
Utena d. mun.;2012;59;542;235;307
Utena d. mun.;2012;60;532;210;322
Utena d. mun.;2012;61;523;226;297
Utena d. mun.;2012;62;571;264;307
Utena d. mun.;2012;63;469;197;272
Utena d. mun.;2012;64;402;173;229
Utena d. mun.;2012;65;418;170;248
Utena d. mun.;2012;66;495;204;291
Utena d. mun.;2012;67;401;176;225
Utena d. mun.;2012;68;488;208;280
Utena d. mun.;2012;69;481;178;303
Utena d. mun.;2012;70;450;180;270
Utena d. mun.;2012;71;437;178;259
Utena d. mun.;2012;72;432;174;258
Utena d. mun.;2012;73;420;149;271
Utena d. mun.;2012;74;430;164;266
Utena d. mun.;2012;75;445;141;304
Utena d. mun.;2012;76;374;124;250
Utena d. mun.;2012;77;348;107;241
Utena d. mun.;2012;78;347;125;222
Utena d. mun.;2012;79;303;92;211
Utena d. mun.;2012;80;289;87;202
Utena d. mun.;2012;81;266;83;183
Utena d. mun.;2012;82;275;70;205
Utena d. mun.;2012;83;271;89;182
Utena d. mun.;2012;84;233;64;169
Utena d. mun.;2012;85;977;209;768
Utena d. mun.;2013;-1;41751;19275;22476
Utena d. mun.;2013;0;318;154;164
Utena d. mun.;2013;1;317;168;149
Utena d. mun.;2013;2;286;150;136
Utena d. mun.;2013;3;340;171;169
Utena d. mun.;2013;4;338;173;165
Utena d. mun.;2013;5;316;163;153
Utena d. mun.;2013;6;310;158;152
Utena d. mun.;2013;7;298;151;147
Utena d. mun.;2013;8;317;163;154
Utena d. mun.;2013;9;320;166;154
Utena d. mun.;2013;10;306;150;156
Utena d. mun.;2013;11;371;184;187
Utena d. mun.;2013;12;371;198;173
Utena d. mun.;2013;13;460;218;242
Utena d. mun.;2013;14;426;208;218
Utena d. mun.;2013;15;461;239;222
Utena d. mun.;2013;16;499;241;258
Utena d. mun.;2013;17;519;258;261
Utena d. mun.;2013;18;522;275;247
Utena d. mun.;2013;19;638;324;314
Utena d. mun.;2013;20;676;337;339
Utena d. mun.;2013;21;634;307;327
Utena d. mun.;2013;22;613;327;286
Utena d. mun.;2013;23;503;277;226
Utena d. mun.;2013;24;485;262;223
Utena d. mun.;2013;25;525;281;244
Utena d. mun.;2013;26;499;262;237
Utena d. mun.;2013;27;481;280;201
Utena d. mun.;2013;28;437;240;197
Utena d. mun.;2013;29;397;213;184
Utena d. mun.;2013;30;430;223;207
Utena d. mun.;2013;31;423;234;189
Utena d. mun.;2013;32;362;189;173
Utena d. mun.;2013;33;420;214;206
Utena d. mun.;2013;34;448;225;223
Utena d. mun.;2013;35;412;201;211
Utena d. mun.;2013;36;471;239;232
Utena d. mun.;2013;37;517;243;274
Utena d. mun.;2013;38;518;246;272
Utena d. mun.;2013;39;513;247;266
Utena d. mun.;2013;40;614;315;299
Utena d. mun.;2013;41;607;288;319
Utena d. mun.;2013;42;613;291;322
Utena d. mun.;2013;43;691;339;352
Utena d. mun.;2013;44;673;318;355
Utena d. mun.;2013;45;662;316;346
Utena d. mun.;2013;46;654;322;332
Utena d. mun.;2013;47;656;327;329
Utena d. mun.;2013;48;706;341;365
Utena d. mun.;2013;49;761;380;381
Utena d. mun.;2013;50;688;337;351
Utena d. mun.;2013;51;768;394;374
Utena d. mun.;2013;52;746;368;378
Utena d. mun.;2013;53;751;324;427
Utena d. mun.;2013;54;667;308;359
Utena d. mun.;2013;55;631;293;338
Utena d. mun.;2013;56;590;274;316
Utena d. mun.;2013;57;596;269;327
Utena d. mun.;2013;58;562;253;309
Utena d. mun.;2013;59;520;232;288
Utena d. mun.;2013;60;535;229;306
Utena d. mun.;2013;61;520;202;318
Utena d. mun.;2013;62;514;218;296
Utena d. mun.;2013;63;559;257;302
Utena d. mun.;2013;64;461;191;270
Utena d. mun.;2013;65;391;163;228
Utena d. mun.;2013;66;406;164;242
Utena d. mun.;2013;67;483;194;289
Utena d. mun.;2013;68;396;169;227
Utena d. mun.;2013;69;480;200;280
Utena d. mun.;2013;70;468;171;297
Utena d. mun.;2013;71;436;170;266
Utena d. mun.;2013;72;419;166;253
Utena d. mun.;2013;73;416;164;252
Utena d. mun.;2013;74;411;141;270
Utena d. mun.;2013;75;410;153;257
Utena d. mun.;2013;76;434;136;298
Utena d. mun.;2013;77;360;116;244
Utena d. mun.;2013;78;336;103;233
Utena d. mun.;2013;79;327;122;205
Utena d. mun.;2013;80;282;80;202
Utena d. mun.;2013;81;272;74;198
Utena d. mun.;2013;82;244;70;174
Utena d. mun.;2013;83;253;62;191
Utena d. mun.;2013;84;254;81;173
Utena d. mun.;2013;85;1031;231;800
Utena d. mun.;2014;-1;41008;18937;22071
Utena d. mun.;2014;0;303;166;137
Utena d. mun.;2014;1;315;152;163
Utena d. mun.;2014;2;316;164;152
Utena d. mun.;2014;3;283;148;135
Utena d. mun.;2014;4;331;164;167
Utena d. mun.;2014;5;337;170;167
Utena d. mun.;2014;6;313;161;152
Utena d. mun.;2014;7;312;159;153
Utena d. mun.;2014;8;293;148;145
Utena d. mun.;2014;9;312;161;151
Utena d. mun.;2014;10;321;168;153
Utena d. mun.;2014;11;302;148;154
Utena d. mun.;2014;12;369;184;185
Utena d. mun.;2014;13;369;194;175
Utena d. mun.;2014;14;456;215;241
Utena d. mun.;2014;15;425;209;216
Utena d. mun.;2014;16;454;234;220
Utena d. mun.;2014;17;496;240;256
Utena d. mun.;2014;18;514;256;258
Utena d. mun.;2014;19;498;266;232
Utena d. mun.;2014;20;628;320;308
Utena d. mun.;2014;21;672;333;339
Utena d. mun.;2014;22;619;300;319
Utena d. mun.;2014;23;586;322;264
Utena d. mun.;2014;24;481;267;214
Utena d. mun.;2014;25;460;259;201
Utena d. mun.;2014;26;504;273;231
Utena d. mun.;2014;27;480;256;224
Utena d. mun.;2014;28;474;273;201
Utena d. mun.;2014;29;424;232;192
Utena d. mun.;2014;30;373;200;173
Utena d. mun.;2014;31;412;222;190
Utena d. mun.;2014;32;415;228;187
Utena d. mun.;2014;33;356;186;170
Utena d. mun.;2014;34;416;213;203
Utena d. mun.;2014;35;427;216;211
Utena d. mun.;2014;36;405;199;206
Utena d. mun.;2014;37;461;235;226
Utena d. mun.;2014;38;512;237;275
Utena d. mun.;2014;39;506;243;263
Utena d. mun.;2014;40;504;243;261
Utena d. mun.;2014;41;602;308;294
Utena d. mun.;2014;42;606;289;317
Utena d. mun.;2014;43;606;286;320
Utena d. mun.;2014;44;684;338;346
Utena d. mun.;2014;45;662;309;353
Utena d. mun.;2014;46;646;312;334
Utena d. mun.;2014;47;649;320;329
Utena d. mun.;2014;48;650;324;326
Utena d. mun.;2014;49;704;339;365
Utena d. mun.;2014;50;758;377;381
Utena d. mun.;2014;51;682;333;349
Utena d. mun.;2014;52;753;382;371
Utena d. mun.;2014;53;728;359;369
Utena d. mun.;2014;54;747;318;429
Utena d. mun.;2014;55;664;305;359
Utena d. mun.;2014;56;627;288;339
Utena d. mun.;2014;57;576;267;309
Utena d. mun.;2014;58;589;262;327
Utena d. mun.;2014;59;551;242;309
Utena d. mun.;2014;60;519;230;289
Utena d. mun.;2014;61;526;222;304
Utena d. mun.;2014;62;505;195;310
Utena d. mun.;2014;63;498;206;292
Utena d. mun.;2014;64;546;249;297
Utena d. mun.;2014;65;452;185;267
Utena d. mun.;2014;66;377;152;225
Utena d. mun.;2014;67;396;160;236
Utena d. mun.;2014;68;476;191;285
Utena d. mun.;2014;69;386;160;226
Utena d. mun.;2014;70;470;193;277
Utena d. mun.;2014;71;454;164;290
Utena d. mun.;2014;72;425;159;266
Utena d. mun.;2014;73;410;159;251
Utena d. mun.;2014;74;403;156;247
Utena d. mun.;2014;75;398;133;265
Utena d. mun.;2014;76;390;141;249
Utena d. mun.;2014;77;420;130;290
Utena d. mun.;2014;78;342;108;234
Utena d. mun.;2014;79;317;91;226
Utena d. mun.;2014;80;307;110;197
Utena d. mun.;2014;81;264;70;194
Utena d. mun.;2014;82;255;68;187
Utena d. mun.;2014;83;216;59;157
Utena d. mun.;2014;84;240;60;180
Utena d. mun.;2014;85;1098;264;834
Utena d. mun.;2015;-1;40454;18698;21756
Utena d. mun.;2015;0;295;162;133
Utena d. mun.;2015;1;305;166;139
Utena d. mun.;2015;2;302;145;157
Utena d. mun.;2015;3;321;168;153
Utena d. mun.;2015;4;274;145;129
Utena d. mun.;2015;5;329;165;164
Utena d. mun.;2015;6;334;168;166
Utena d. mun.;2015;7;312;161;151
Utena d. mun.;2015;8;313;161;152
Utena d. mun.;2015;9;291;147;144
Utena d. mun.;2015;10;311;161;150
Utena d. mun.;2015;11;319;167;152
Utena d. mun.;2015;12;299;148;151
Utena d. mun.;2015;13;363;180;183
Utena d. mun.;2015;14;367;193;174
Utena d. mun.;2015;15;457;215;242
Utena d. mun.;2015;16;421;207;214
Utena d. mun.;2015;17;451;233;218
Utena d. mun.;2015;18;487;237;250
Utena d. mun.;2015;19;500;253;247
Utena d. mun.;2015;20;497;265;232
Utena d. mun.;2015;21;625;319;306
Utena d. mun.;2015;22;664;327;337
Utena d. mun.;2015;23;582;290;292
Utena d. mun.;2015;24;555;306;249
Utena d. mun.;2015;25;465;260;205
Utena d. mun.;2015;26;441;246;195
Utena d. mun.;2015;27;484;264;220
Utena d. mun.;2015;28;469;254;215
Utena d. mun.;2015;29;467;273;194
Utena d. mun.;2015;30;410;227;183
Utena d. mun.;2015;31;378;203;175
Utena d. mun.;2015;32;396;213;183
Utena d. mun.;2015;33;415;228;187
Utena d. mun.;2015;34;357;185;172
Utena d. mun.;2015;35;413;211;202
Utena d. mun.;2015;36;422;212;210
Utena d. mun.;2015;37;401;194;207
Utena d. mun.;2015;38;452;233;219
Utena d. mun.;2015;39;509;236;273
Utena d. mun.;2015;40;505;240;265
Utena d. mun.;2015;41;502;238;264
Utena d. mun.;2015;42;600;309;291
Utena d. mun.;2015;43;611;294;317
Utena d. mun.;2015;44;604;286;318
Utena d. mun.;2015;45;678;337;341
Utena d. mun.;2015;46;656;307;349
Utena d. mun.;2015;47;647;309;338
Utena d. mun.;2015;48;640;317;323
Utena d. mun.;2015;49;643;319;324
Utena d. mun.;2015;50;704;339;365
Utena d. mun.;2015;51;753;375;378
Utena d. mun.;2015;52;675;327;348
Utena d. mun.;2015;53;748;376;372
Utena d. mun.;2015;54;718;353;365
Utena d. mun.;2015;55;739;313;426
Utena d. mun.;2015;56;659;300;359
Utena d. mun.;2015;57;619;281;338
Utena d. mun.;2015;58;573;264;309
Utena d. mun.;2015;59;584;255;329
Utena d. mun.;2015;60;538;235;303
Utena d. mun.;2015;61;512;225;287
Utena d. mun.;2015;62;517;215;302
Utena d. mun.;2015;63;499;193;306
Utena d. mun.;2015;64;492;202;290
Utena d. mun.;2015;65;538;244;294
Utena d. mun.;2015;66;440;178;262
Utena d. mun.;2015;67;371;149;222
Utena d. mun.;2015;68;384;154;230
Utena d. mun.;2015;69;468;188;280
Utena d. mun.;2015;70;375;154;221
Utena d. mun.;2015;71;459;188;271
Utena d. mun.;2015;72;442;161;281
Utena d. mun.;2015;73;418;151;267
Utena d. mun.;2015;74;395;149;246
Utena d. mun.;2015;75;387;150;237
Utena d. mun.;2015;76;385;127;258
Utena d. mun.;2015;77;375;128;247
Utena d. mun.;2015;78;398;115;283
Utena d. mun.;2015;79;325;102;223
Utena d. mun.;2015;80;302;83;219
Utena d. mun.;2015;81;285;95;190
Utena d. mun.;2015;82;241;56;185
Utena d. mun.;2015;83;242;66;176
Utena d. mun.;2015;84;207;57;150
Utena d. mun.;2015;85;1148;266;882
Utena d. mun.;2016;-1;39826;18433;21393
Utena d. mun.;2016;0;321;168;153
Utena d. mun.;2016;1;295;160;135
Utena d. mun.;2016;2;301;164;137
Utena d. mun.;2016;3;300;143;157
Utena d. mun.;2016;4;307;159;148
Utena d. mun.;2016;5;274;146;128
Utena d. mun.;2016;6;325;164;161
Utena d. mun.;2016;7;322;158;164
Utena d. mun.;2016;8;309;156;153
Utena d. mun.;2016;9;311;161;150
Utena d. mun.;2016;10;291;147;144
Utena d. mun.;2016;11;304;157;147
Utena d. mun.;2016;12;315;164;151
Utena d. mun.;2016;13;297;148;149
Utena d. mun.;2016;14;356;177;179
Utena d. mun.;2016;15;355;190;165
Utena d. mun.;2016;16;451;213;238
Utena d. mun.;2016;17;420;206;214
Utena d. mun.;2016;18;452;234;218
Utena d. mun.;2016;19;478;230;248
Utena d. mun.;2016;20;486;242;244
Utena d. mun.;2016;21;490;262;228
Utena d. mun.;2016;22;603;313;290
Utena d. mun.;2016;23;636;319;317
Utena d. mun.;2016;24;557;278;279
Utena d. mun.;2016;25;527;302;225
Utena d. mun.;2016;26;452;256;196
Utena d. mun.;2016;27;429;233;196
Utena d. mun.;2016;28;473;262;211
Utena d. mun.;2016;29;438;247;191
Utena d. mun.;2016;30;451;271;180
Utena d. mun.;2016;31;392;219;173
Utena d. mun.;2016;32;369;199;170
Utena d. mun.;2016;33;392;213;179
Utena d. mun.;2016;34;397;219;178
Utena d. mun.;2016;35;341;181;160
Utena d. mun.;2016;36;413;215;198
Utena d. mun.;2016;37;416;207;209
Utena d. mun.;2016;38;402;197;205
Utena d. mun.;2016;39;444;228;216
Utena d. mun.;2016;40;512;237;275
Utena d. mun.;2016;41;504;240;264
Utena d. mun.;2016;42;501;238;263
Utena d. mun.;2016;43;596;309;287
Utena d. mun.;2016;44;610;295;315
Utena d. mun.;2016;45;600;284;316
Utena d. mun.;2016;46;683;340;343
Utena d. mun.;2016;47;655;304;351
Utena d. mun.;2016;48;632;299;333
Utena d. mun.;2016;49;635;315;320
Utena d. mun.;2016;50;633;309;324
Utena d. mun.;2016;51;699;334;365
Utena d. mun.;2016;52;751;376;375
Utena d. mun.;2016;53;669;320;349
Utena d. mun.;2016;54;744;373;371
Utena d. mun.;2016;55;706;346;360
Utena d. mun.;2016;56;731;307;424
Utena d. mun.;2016;57;655;297;358
Utena d. mun.;2016;58;619;280;339
Utena d. mun.;2016;59;571;265;306
Utena d. mun.;2016;60;570;245;325
Utena d. mun.;2016;61;524;225;299
Utena d. mun.;2016;62;506;221;285
Utena d. mun.;2016;63;512;212;300
Utena d. mun.;2016;64;495;192;303
Utena d. mun.;2016;65;480;192;288
Utena d. mun.;2016;66;524;235;289
Utena d. mun.;2016;67;433;171;262
Utena d. mun.;2016;68;365;142;223
Utena d. mun.;2016;69;381;154;227
Utena d. mun.;2016;70;457;179;278
Utena d. mun.;2016;71;368;150;218
Utena d. mun.;2016;72;442;175;267
Utena d. mun.;2016;73;429;152;277
Utena d. mun.;2016;74;405;142;263
Utena d. mun.;2016;75;377;140;237
Utena d. mun.;2016;76;368;140;228
Utena d. mun.;2016;77;373;118;255
Utena d. mun.;2016;78;361;120;241
Utena d. mun.;2016;79;378;105;273
Utena d. mun.;2016;80;313;92;221
Utena d. mun.;2016;81;288;81;207
Utena d. mun.;2016;82;267;87;180
Utena d. mun.;2016;83;233;55;178
Utena d. mun.;2016;84;222;59;163
Utena d. mun.;2016;85;1157;273;884
Utena d. mun.;2017;-1;38836;17937;20899
Utena d. mun.;2017;0;315;156;159
Utena d. mun.;2017;1;315;166;149
Utena d. mun.;2017;2;287;156;131
Utena d. mun.;2017;3;310;165;145
Utena d. mun.;2017;4;294;134;160
Utena d. mun.;2017;5;302;157;145
Utena d. mun.;2017;6;267;140;127
Utena d. mun.;2017;7;323;165;158
Utena d. mun.;2017;8;315;154;161
Utena d. mun.;2017;9;308;157;151
Utena d. mun.;2017;10;305;161;144
Utena d. mun.;2017;11;288;144;144
Utena d. mun.;2017;12;302;156;146
Utena d. mun.;2017;13;309;159;150
Utena d. mun.;2017;14;291;145;146
Utena d. mun.;2017;15;353;176;177
Utena d. mun.;2017;16;350;184;166
Utena d. mun.;2017;17;451;211;240
Utena d. mun.;2017;18;415;206;209
Utena d. mun.;2017;19;437;227;210
Utena d. mun.;2017;20;461;222;239
Utena d. mun.;2017;21;467;231;236
Utena d. mun.;2017;22;474;254;220
Utena d. mun.;2017;23;575;301;274
Utena d. mun.;2017;24;599;303;296
Utena d. mun.;2017;25;519;261;258
Utena d. mun.;2017;26;495;280;215
Utena d. mun.;2017;27;425;246;179
Utena d. mun.;2017;28;411;228;183
Utena d. mun.;2017;29;437;243;194
Utena d. mun.;2017;30;403;226;177
Utena d. mun.;2017;31;423;257;166
Utena d. mun.;2017;32;365;203;162
Utena d. mun.;2017;33;346;186;160
Utena d. mun.;2017;34;373;197;176
Utena d. mun.;2017;35;373;208;165
Utena d. mun.;2017;36;326;174;152
Utena d. mun.;2017;37;399;206;193
Utena d. mun.;2017;38;405;198;207
Utena d. mun.;2017;39;392;190;202
Utena d. mun.;2017;40;435;224;211
Utena d. mun.;2017;41;505;233;272
Utena d. mun.;2017;42;499;241;258
Utena d. mun.;2017;43;496;238;258
Utena d. mun.;2017;44;577;296;281
Utena d. mun.;2017;45;600;292;308
Utena d. mun.;2017;46;590;278;312
Utena d. mun.;2017;47;670;332;338
Utena d. mun.;2017;48;648;298;350
Utena d. mun.;2017;49;623;296;327
Utena d. mun.;2017;50;621;307;314
Utena d. mun.;2017;51;623;302;321
Utena d. mun.;2017;52;694;333;361
Utena d. mun.;2017;53;735;365;370
Utena d. mun.;2017;54;662;317;345
Utena d. mun.;2017;55;733;368;365
Utena d. mun.;2017;56;686;334;352
Utena d. mun.;2017;57;724;302;422
Utena d. mun.;2017;58;638;288;350
Utena d. mun.;2017;59;613;278;335
Utena d. mun.;2017;60;565;262;303
Utena d. mun.;2017;61;566;244;322
Utena d. mun.;2017;62;516;219;297
Utena d. mun.;2017;63;502;217;285
Utena d. mun.;2017;64;505;203;302
Utena d. mun.;2017;65;494;189;305
Utena d. mun.;2017;66;468;184;284
Utena d. mun.;2017;67;511;226;285
Utena d. mun.;2017;68;424;166;258
Utena d. mun.;2017;69;357;139;218
Utena d. mun.;2017;70;370;147;223
Utena d. mun.;2017;71;447;173;274
Utena d. mun.;2017;72;362;144;218
Utena d. mun.;2017;73;414;158;256
Utena d. mun.;2017;74;418;146;272
Utena d. mun.;2017;75;399;140;259
Utena d. mun.;2017;76;368;134;234
Utena d. mun.;2017;77;357;132;225
Utena d. mun.;2017;78;346;103;243
Utena d. mun.;2017;79;339;108;231
Utena d. mun.;2017;80;350;92;258
Utena d. mun.;2017;81;297;83;214
Utena d. mun.;2017;82;265;72;193
Utena d. mun.;2017;83;245;75;170
Utena d. mun.;2017;84;213;47;166
Utena d. mun.;2017;85;1161;279;882
Utena d. mun.;2018;-1;37914;17485;20429
Utena d. mun.;2018;0;278;156;122
Utena d. mun.;2018;1;316;155;161
Utena d. mun.;2018;2;314;163;151
Utena d. mun.;2018;3;287;151;136
Utena d. mun.;2018;4;314;165;149
Utena d. mun.;2018;5;296;137;159
Utena d. mun.;2018;6;297;154;143
Utena d. mun.;2018;7;268;143;125
Utena d. mun.;2018;8;318;161;157
Utena d. mun.;2018;9;308;150;158
Utena d. mun.;2018;10;303;157;146
Utena d. mun.;2018;11;299;158;141
Utena d. mun.;2018;12;285;144;141
Utena d. mun.;2018;13;298;154;144
Utena d. mun.;2018;14;310;160;150
Utena d. mun.;2018;15;288;144;144
Utena d. mun.;2018;16;350;175;175
Utena d. mun.;2018;17;347;180;167
Utena d. mun.;2018;18;450;209;241
Utena d. mun.;2018;19;394;196;198
Utena d. mun.;2018;20;427;222;205
Utena d. mun.;2018;21;433;207;226
Utena d. mun.;2018;22;446;222;224
Utena d. mun.;2018;23;438;235;203
Utena d. mun.;2018;24;539;293;246
Utena d. mun.;2018;25;562;289;273
Utena d. mun.;2018;26;470;238;232
Utena d. mun.;2018;27;442;244;198
Utena d. mun.;2018;28;386;225;161
Utena d. mun.;2018;29;361;200;161
Utena d. mun.;2018;30;415;230;185
Utena d. mun.;2018;31;381;220;161
Utena d. mun.;2018;32;393;238;155
Utena d. mun.;2018;33;355;199;156
Utena d. mun.;2018;34;342;187;155
Utena d. mun.;2018;35;371;195;176
Utena d. mun.;2018;36;364;204;160
Utena d. mun.;2018;37;319;171;148
Utena d. mun.;2018;38;396;206;190
Utena d. mun.;2018;39;395;191;204
Utena d. mun.;2018;40;388;186;202
Utena d. mun.;2018;41;421;213;208
Utena d. mun.;2018;42;496;229;267
Utena d. mun.;2018;43;492;235;257
Utena d. mun.;2018;44;492;236;256
Utena d. mun.;2018;45;567;289;278
Utena d. mun.;2018;46;592;290;302
Utena d. mun.;2018;47;585;280;305
Utena d. mun.;2018;48;669;330;339
Utena d. mun.;2018;49;644;297;347
Utena d. mun.;2018;50;610;290;320
Utena d. mun.;2018;51;624;308;316
Utena d. mun.;2018;52;623;302;321
Utena d. mun.;2018;53;688;328;360
Utena d. mun.;2018;54;724;358;366
Utena d. mun.;2018;55;653;308;345
Utena d. mun.;2018;56;723;361;362
Utena d. mun.;2018;57;674;328;346
Utena d. mun.;2018;58;714;297;417
Utena d. mun.;2018;59;627;282;345
Utena d. mun.;2018;60;605;269;336
Utena d. mun.;2018;61;559;257;302
Utena d. mun.;2018;62;554;237;317
Utena d. mun.;2018;63;510;214;296
Utena d. mun.;2018;64;494;211;283
Utena d. mun.;2018;65;499;199;300
Utena d. mun.;2018;66;484;181;303
Utena d. mun.;2018;67;463;179;284
Utena d. mun.;2018;68;495;216;279
Utena d. mun.;2018;69;413;158;255
Utena d. mun.;2018;70;347;134;213
Utena d. mun.;2018;71;363;141;222
Utena d. mun.;2018;72;435;166;269
Utena d. mun.;2018;73;355;136;219
Utena d. mun.;2018;74;393;142;251
Utena d. mun.;2018;75;404;139;265
Utena d. mun.;2018;76;384;132;252
Utena d. mun.;2018;77;347;123;224
Utena d. mun.;2018;78;341;120;221
Utena d. mun.;2018;79;336;99;237
Utena d. mun.;2018;80;328;103;225
Utena d. mun.;2018;81;325;79;246
Utena d. mun.;2018;82;274;71;203
Utena d. mun.;2018;83;242;63;179
Utena d. mun.;2018;84;227;67;160
Utena d. mun.;2018;85;1176;274;902
Varėna d. mun.;2001;-1;31204;14992;16212
Varėna d. mun.;2001;0;288;155;133
Varėna d. mun.;2001;1;280;151;129
Varėna d. mun.;2001;2;320;176;144
Varėna d. mun.;2001;3;304;164;140
Varėna d. mun.;2001;4;322;161;161
Varėna d. mun.;2001;5;344;167;177
Varėna d. mun.;2001;6;354;172;182
Varėna d. mun.;2001;7;414;226;188
Varėna d. mun.;2001;8;487;245;242
Varėna d. mun.;2001;9;470;233;237
Varėna d. mun.;2001;10;482;242;240
Varėna d. mun.;2001;11;471;258;213
Varėna d. mun.;2001;12;444;243;201
Varėna d. mun.;2001;13;471;239;232
Varėna d. mun.;2001;14;484;246;238
Varėna d. mun.;2001;15;487;236;251
Varėna d. mun.;2001;16;501;266;235
Varėna d. mun.;2001;17;466;247;219
Varėna d. mun.;2001;18;374;190;184
Varėna d. mun.;2001;19;297;166;131
Varėna d. mun.;2001;20;295;175;120
Varėna d. mun.;2001;21;284;166;118
Varėna d. mun.;2001;22;297;169;128
Varėna d. mun.;2001;23;289;164;125
Varėna d. mun.;2001;24;306;161;144
Varėna d. mun.;2001;25;363;207;156
Varėna d. mun.;2001;26;316;172;145
Varėna d. mun.;2001;27;348;191;157
Varėna d. mun.;2001;28;389;197;192
Varėna d. mun.;2001;29;351;171;180
Varėna d. mun.;2001;30;393;192;201
Varėna d. mun.;2001;31;424;211;213
Varėna d. mun.;2001;32;399;207;192
Varėna d. mun.;2001;33;415;238;177
Varėna d. mun.;2001;34;398;229;169
Varėna d. mun.;2001;35;383;203;180
Varėna d. mun.;2001;36;418;207;211
Varėna d. mun.;2001;37;413;240;173
Varėna d. mun.;2001;38;460;246;214
Varėna d. mun.;2001;39;461;231;230
Varėna d. mun.;2001;40;492;269;223
Varėna d. mun.;2001;41;482;246;236
Varėna d. mun.;2001;42;467;237;230
Varėna d. mun.;2001;43;440;241;199
Varėna d. mun.;2001;44;383;191;192
Varėna d. mun.;2001;45;392;199;193
Varėna d. mun.;2001;46;344;193;151
Varėna d. mun.;2001;47;341;172;169
Varėna d. mun.;2001;48;345;162;183
Varėna d. mun.;2001;49;367;182;185
Varėna d. mun.;2001;50;322;174;148
Varėna d. mun.;2001;51;380;194;186
Varėna d. mun.;2001;52;332;169;163
Varėna d. mun.;2001;53;303;123;180
Varėna d. mun.;2001;54;303;136;167
Varėna d. mun.;2001;55;342;168;174
Varėna d. mun.;2001;56;305;149;156
Varėna d. mun.;2001;57;379;169;210
Varėna d. mun.;2001;58;401;175;226
Varėna d. mun.;2001;59;381;166;215
Varėna d. mun.;2001;60;374;164;210
Varėna d. mun.;2001;61;395;177;218
Varėna d. mun.;2001;62;472;233;239
Varėna d. mun.;2001;63;409;169;240
Varėna d. mun.;2001;64;455;179;276
Varėna d. mun.;2001;65;447;180;267
Varėna d. mun.;2001;66;408;171;237
Varėna d. mun.;2001;67;357;152;205
Varėna d. mun.;2001;68;415;157;258
Varėna d. mun.;2001;69;378;145;233
Varėna d. mun.;2001;70;453;157;296
Varėna d. mun.;2001;71;379;138;241
Varėna d. mun.;2001;72;333;127;206
Varėna d. mun.;2001;73;359;130;229
Varėna d. mun.;2001;74;301;117;184
Varėna d. mun.;2001;75;319;98;221
Varėna d. mun.;2001;76;289;98;191
Varėna d. mun.;2001;77;224;73;151
Varėna d. mun.;2001;78;237;67;170
Varėna d. mun.;2001;79;155;47;108
Varėna d. mun.;2001;80;173;50;123
Varėna d. mun.;2001;81;145;48;97
Varėna d. mun.;2001;82;79;23;56
Varėna d. mun.;2001;83;75;23;52
Varėna d. mun.;2001;84;86;24;62
Varėna d. mun.;2001;85;524;170;354
Varėna d. mun.;2002;-1;30873;14817;16056
Varėna d. mun.;2002;0;274;130;144
Varėna d. mun.;2002;1;282;154;128
Varėna d. mun.;2002;2;278;150;128
Varėna d. mun.;2002;3;318;175;143
Varėna d. mun.;2002;4;301;163;138
Varėna d. mun.;2002;5;323;162;161
Varėna d. mun.;2002;6;344;168;176
Varėna d. mun.;2002;7;355;175;180
Varėna d. mun.;2002;8;413;228;185
Varėna d. mun.;2002;9;483;246;237
Varėna d. mun.;2002;10;473;233;240
Varėna d. mun.;2002;11;481;242;239
Varėna d. mun.;2002;12;466;253;213
Varėna d. mun.;2002;13;440;242;198
Varėna d. mun.;2002;14;467;236;231
Varėna d. mun.;2002;15;476;240;236
Varėna d. mun.;2002;16;477;231;246
Varėna d. mun.;2002;17;488;259;229
Varėna d. mun.;2002;18;454;241;213
Varėna d. mun.;2002;19;366;191;175
Varėna d. mun.;2002;20;288;162;126
Varėna d. mun.;2002;21;283;166;117
Varėna d. mun.;2002;22;280;165;115
Varėna d. mun.;2002;23;295;167;128
Varėna d. mun.;2002;24;277;162;115
Varėna d. mun.;2002;25;306;163;143
Varėna d. mun.;2002;26;354;202;152
Varėna d. mun.;2002;27;310;167;143
Varėna d. mun.;2002;28;342;185;157
Varėna d. mun.;2002;29;377;190;187
Varėna d. mun.;2002;30;342;169;173
Varėna d. mun.;2002;31;382;183;199
Varėna d. mun.;2002;32;413;203;210
Varėna d. mun.;2002;33;392;201;191
Varėna d. mun.;2002;34;405;233;172
Varėna d. mun.;2002;35;393;228;165
Varėna d. mun.;2002;36;378;201;177
Varėna d. mun.;2002;37;415;204;211
Varėna d. mun.;2002;38;409;236;173
Varėna d. mun.;2002;39;446;239;207
Varėna d. mun.;2002;40;457;229;228
Varėna d. mun.;2002;41;495;271;224
Varėna d. mun.;2002;42;476;243;233
Varėna d. mun.;2002;43;467;235;232
Varėna d. mun.;2002;44;439;242;197
Varėna d. mun.;2002;45;377;188;189
Varėna d. mun.;2002;46;385;194;191
Varėna d. mun.;2002;47;339;189;150
Varėna d. mun.;2002;48;333;167;166
Varėna d. mun.;2002;49;341;161;180
Varėna d. mun.;2002;50;366;181;185
Varėna d. mun.;2002;51;314;169;145
Varėna d. mun.;2002;52;379;192;187
Varėna d. mun.;2002;53;328;168;160
Varėna d. mun.;2002;54;301;124;177
Varėna d. mun.;2002;55;299;134;165
Varėna d. mun.;2002;56;329;160;169
Varėna d. mun.;2002;57;300;148;152
Varėna d. mun.;2002;58;370;164;206
Varėna d. mun.;2002;59;391;169;222
Varėna d. mun.;2002;60;374;164;210
Varėna d. mun.;2002;61;373;162;211
Varėna d. mun.;2002;62;390;170;220
Varėna d. mun.;2002;63;462;224;238
Varėna d. mun.;2002;64;406;166;240
Varėna d. mun.;2002;65;450;175;275
Varėna d. mun.;2002;66;442;178;264
Varėna d. mun.;2002;67;404;170;234
Varėna d. mun.;2002;68;355;149;206
Varėna d. mun.;2002;69;405;152;253
Varėna d. mun.;2002;70;372;141;231
Varėna d. mun.;2002;71;444;155;289
Varėna d. mun.;2002;72;370;134;236
Varėna d. mun.;2002;73;322;121;201
Varėna d. mun.;2002;74;353;127;226
Varėna d. mun.;2002;75;292;109;183
Varėna d. mun.;2002;76;305;93;212
Varėna d. mun.;2002;77;277;93;184
Varėna d. mun.;2002;78;217;69;148
Varėna d. mun.;2002;79;222;59;163
Varėna d. mun.;2002;80;146;43;103
Varėna d. mun.;2002;81;161;46;115
Varėna d. mun.;2002;82;134;45;89
Varėna d. mun.;2002;83;72;19;53
Varėna d. mun.;2002;84;65;17;48
Varėna d. mun.;2002;85;528;163;365
Varėna d. mun.;2003;-1;30556;14643;15913
Varėna d. mun.;2003;0;246;118;128
Varėna d. mun.;2003;1;267;127;140
Varėna d. mun.;2003;2;284;158;126
Varėna d. mun.;2003;3;269;145;124
Varėna d. mun.;2003;4;324;179;145
Varėna d. mun.;2003;5;300;163;137
Varėna d. mun.;2003;6;326;164;162
Varėna d. mun.;2003;7;343;168;175
Varėna d. mun.;2003;8;357;177;180
Varėna d. mun.;2003;9;417;230;187
Varėna d. mun.;2003;10;484;248;236
Varėna d. mun.;2003;11;475;234;241
Varėna d. mun.;2003;12;476;241;235
Varėna d. mun.;2003;13;459;251;208
Varėna d. mun.;2003;14;432;237;195
Varėna d. mun.;2003;15;463;232;231
Varėna d. mun.;2003;16;470;238;232
Varėna d. mun.;2003;17;467;225;242
Varėna d. mun.;2003;18;482;255;227
Varėna d. mun.;2003;19;452;241;211
Varėna d. mun.;2003;20;365;190;175
Varėna d. mun.;2003;21;289;162;127
Varėna d. mun.;2003;22;284;168;116
Varėna d. mun.;2003;23;278;164;114
Varėna d. mun.;2003;24;287;161;126
Varėna d. mun.;2003;25;265;153;112
Varėna d. mun.;2003;26;293;159;134
Varėna d. mun.;2003;27;347;198;149
Varėna d. mun.;2003;28;305;167;138
Varėna d. mun.;2003;29;330;178;152
Varėna d. mun.;2003;30;365;184;181
Varėna d. mun.;2003;31;342;172;170
Varėna d. mun.;2003;32;376;182;194
Varėna d. mun.;2003;33;410;200;210
Varėna d. mun.;2003;34;389;199;190
Varėna d. mun.;2003;35;397;231;166
Varėna d. mun.;2003;36;389;227;162
Varėna d. mun.;2003;37;373;196;177
Varėna d. mun.;2003;38;415;205;210
Varėna d. mun.;2003;39;402;231;171
Varėna d. mun.;2003;40;444;240;204
Varėna d. mun.;2003;41;453;227;226
Varėna d. mun.;2003;42;495;272;223
Varėna d. mun.;2003;43;471;239;232
Varėna d. mun.;2003;44;461;231;230
Varėna d. mun.;2003;45;433;239;194
Varėna d. mun.;2003;46;370;183;187
Varėna d. mun.;2003;47;382;193;189
Varėna d. mun.;2003;48;333;183;150
Varėna d. mun.;2003;49;328;165;163
Varėna d. mun.;2003;50;336;157;179
Varėna d. mun.;2003;51;362;180;182
Varėna d. mun.;2003;52;305;166;139
Varėna d. mun.;2003;53;381;193;188
Varėna d. mun.;2003;54;319;161;158
Varėna d. mun.;2003;55;298;120;178
Varėna d. mun.;2003;56;299;135;164
Varėna d. mun.;2003;57;330;159;171
Varėna d. mun.;2003;58;295;145;150
Varėna d. mun.;2003;59;363;159;204
Varėna d. mun.;2003;60;387;166;221
Varėna d. mun.;2003;61;373;163;210
Varėna d. mun.;2003;62;372;162;210
Varėna d. mun.;2003;63;386;168;218
Varėna d. mun.;2003;64;453;217;236
Varėna d. mun.;2003;65;402;163;239
Varėna d. mun.;2003;66;447;174;273
Varėna d. mun.;2003;67;437;174;263
Varėna d. mun.;2003;68;393;166;227
Varėna d. mun.;2003;69;347;142;205
Varėna d. mun.;2003;70;396;147;249
Varėna d. mun.;2003;71;369;139;230
Varėna d. mun.;2003;72;436;149;287
Varėna d. mun.;2003;73;352;121;231
Varėna d. mun.;2003;74;311;109;202
Varėna d. mun.;2003;75;337;115;222
Varėna d. mun.;2003;76;281;103;178
Varėna d. mun.;2003;77;297;88;209
Varėna d. mun.;2003;78;262;88;174
Varėna d. mun.;2003;79;201;63;138
Varėna d. mun.;2003;80;206;53;153
Varėna d. mun.;2003;81;134;39;95
Varėna d. mun.;2003;82;148;36;112
Varėna d. mun.;2003;83;123;40;83
Varėna d. mun.;2003;84;66;17;49
Varėna d. mun.;2003;85;488;136;352
Varėna d. mun.;2004;-1;30071;14331;15740
Varėna d. mun.;2004;0;265;107;158
Varėna d. mun.;2004;1;246;119;127
Varėna d. mun.;2004;2;268;125;143
Varėna d. mun.;2004;3;286;157;129
Varėna d. mun.;2004;4;272;146;126
Varėna d. mun.;2004;5;326;179;147
Varėna d. mun.;2004;6;299;161;138
Varėna d. mun.;2004;7;329;163;166
Varėna d. mun.;2004;8;337;164;173
Varėna d. mun.;2004;9;357;176;181
Varėna d. mun.;2004;10;423;231;192
Varėna d. mun.;2004;11;486;249;237
Varėna d. mun.;2004;12;472;235;237
Varėna d. mun.;2004;13;472;239;233
Varėna d. mun.;2004;14;451;244;207
Varėna d. mun.;2004;15;424;233;191
Varėna d. mun.;2004;16;453;228;225
Varėna d. mun.;2004;17;465;236;229
Varėna d. mun.;2004;18;455;219;236
Varėna d. mun.;2004;19;472;251;221
Varėna d. mun.;2004;20;445;237;208
Varėna d. mun.;2004;21;352;187;165
Varėna d. mun.;2004;22;280;159;121
Varėna d. mun.;2004;23;271;163;108
Varėna d. mun.;2004;24;273;161;112
Varėna d. mun.;2004;25;267;148;119
Varėna d. mun.;2004;26;248;141;107
Varėna d. mun.;2004;27;290;160;130
Varėna d. mun.;2004;28;323;181;142
Varėna d. mun.;2004;29;299;162;137
Varėna d. mun.;2004;30;316;168;148
Varėna d. mun.;2004;31;358;179;179
Varėna d. mun.;2004;32;337;169;168
Varėna d. mun.;2004;33;369;179;190
Varėna d. mun.;2004;34;399;192;207
Varėna d. mun.;2004;35;382;195;187
Varėna d. mun.;2004;36;387;223;164
Varėna d. mun.;2004;37;381;224;157
Varėna d. mun.;2004;38;366;192;174
Varėna d. mun.;2004;39;406;199;207
Varėna d. mun.;2004;40;396;229;167
Varėna d. mun.;2004;41;437;236;201
Varėna d. mun.;2004;42;447;223;224
Varėna d. mun.;2004;43;488;269;219
Varėna d. mun.;2004;44;462;230;232
Varėna d. mun.;2004;45;459;230;229
Varėna d. mun.;2004;46;432;239;193
Varėna d. mun.;2004;47;363;181;182
Varėna d. mun.;2004;48;381;192;189
Varėna d. mun.;2004;49;327;178;149
Varėna d. mun.;2004;50;319;159;160
Varėna d. mun.;2004;51;333;153;180
Varėna d. mun.;2004;52;357;177;180
Varėna d. mun.;2004;53;304;165;139
Varėna d. mun.;2004;54;381;194;187
Varėna d. mun.;2004;55;318;160;158
Varėna d. mun.;2004;56;291;116;175
Varėna d. mun.;2004;57;292;131;161
Varėna d. mun.;2004;58;321;153;168
Varėna d. mun.;2004;59;293;142;151
Varėna d. mun.;2004;60;352;152;200
Varėna d. mun.;2004;61;375;159;216
Varėna d. mun.;2004;62;366;160;206
Varėna d. mun.;2004;63;360;153;207
Varėna d. mun.;2004;64;379;164;215
Varėna d. mun.;2004;65;452;214;238
Varėna d. mun.;2004;66;395;158;237
Varėna d. mun.;2004;67;441;168;273
Varėna d. mun.;2004;68;422;162;260
Varėna d. mun.;2004;69;381;157;224
Varėna d. mun.;2004;70;334;135;199
Varėna d. mun.;2004;71;382;137;245
Varėna d. mun.;2004;72;356;129;227
Varėna d. mun.;2004;73;420;139;281
Varėna d. mun.;2004;74;338;114;224
Varėna d. mun.;2004;75;302;102;200
Varėna d. mun.;2004;76;320;105;215
Varėna d. mun.;2004;77;265;95;170
Varėna d. mun.;2004;78;278;80;198
Varėna d. mun.;2004;79;252;83;169
Varėna d. mun.;2004;80;191;58;133
Varėna d. mun.;2004;81;193;44;149
Varėna d. mun.;2004;82;125;32;93
Varėna d. mun.;2004;83;137;33;104
Varėna d. mun.;2004;84;103;33;70
Varėna d. mun.;2004;85;444;127;317
Varėna d. mun.;2005;-1;29427;13985;15442
Varėna d. mun.;2005;0;238;98;140
Varėna d. mun.;2005;1;257;103;154
Varėna d. mun.;2005;2;244;119;125
Varėna d. mun.;2005;3;265;124;141
Varėna d. mun.;2005;4;283;156;127
Varėna d. mun.;2005;5;270;146;124
Varėna d. mun.;2005;6;323;178;145
Varėna d. mun.;2005;7;298;162;136
Varėna d. mun.;2005;8;323;159;164
Varėna d. mun.;2005;9;335;162;173
Varėna d. mun.;2005;10;353;171;182
Varėna d. mun.;2005;11;424;232;192
Varėna d. mun.;2005;12;479;243;236
Varėna d. mun.;2005;13;465;231;234
Varėna d. mun.;2005;14;460;230;230
Varėna d. mun.;2005;15;445;241;204
Varėna d. mun.;2005;16;419;230;189
Varėna d. mun.;2005;17;448;224;224
Varėna d. mun.;2005;18;451;230;221
Varėna d. mun.;2005;19;443;216;227
Varėna d. mun.;2005;20;460;245;215
Varėna d. mun.;2005;21;429;227;202
Varėna d. mun.;2005;22;326;179;147
Varėna d. mun.;2005;23;279;159;120
Varėna d. mun.;2005;24;252;154;98
Varėna d. mun.;2005;25;271;157;114
Varėna d. mun.;2005;26;258;143;115
Varėna d. mun.;2005;27;232;135;97
Varėna d. mun.;2005;28;275;153;122
Varėna d. mun.;2005;29;307;175;132
Varėna d. mun.;2005;30;281;157;124
Varėna d. mun.;2005;31;305;165;140
Varėna d. mun.;2005;32;350;175;175
Varėna d. mun.;2005;33;325;162;163
Varėna d. mun.;2005;34;352;168;184
Varėna d. mun.;2005;35;387;186;201
Varėna d. mun.;2005;36;368;188;180
Varėna d. mun.;2005;37;374;214;160
Varėna d. mun.;2005;38;375;218;157
Varėna d. mun.;2005;39;354;187;167
Varėna d. mun.;2005;40;397;194;203
Varėna d. mun.;2005;41;388;223;165
Varėna d. mun.;2005;42;428;228;200
Varėna d. mun.;2005;43;441;221;220
Varėna d. mun.;2005;44;484;268;216
Varėna d. mun.;2005;45;453;224;229
Varėna d. mun.;2005;46;456;229;227
Varėna d. mun.;2005;47;431;239;192
Varėna d. mun.;2005;48;352;172;180
Varėna d. mun.;2005;49;378;193;185
Varėna d. mun.;2005;50;324;176;148
Varėna d. mun.;2005;51;315;157;158
Varėna d. mun.;2005;52;330;153;177
Varėna d. mun.;2005;53;351;173;178
Varėna d. mun.;2005;54;301;162;139
Varėna d. mun.;2005;55;376;188;188
Varėna d. mun.;2005;56;314;156;158
Varėna d. mun.;2005;57;294;119;175
Varėna d. mun.;2005;58;288;128;160
Varėna d. mun.;2005;59;316;151;165
Varėna d. mun.;2005;60;285;134;151
Varėna d. mun.;2005;61;346;147;199
Varėna d. mun.;2005;62;375;159;216
Varėna d. mun.;2005;63;358;152;206
Varėna d. mun.;2005;64;352;146;206
Varėna d. mun.;2005;65;373;158;215
Varėna d. mun.;2005;66;438;205;233
Varėna d. mun.;2005;67;389;155;234
Varėna d. mun.;2005;68;425;162;263
Varėna d. mun.;2005;69;410;155;255
Varėna d. mun.;2005;70;368;152;216
Varėna d. mun.;2005;71;324;126;198
Varėna d. mun.;2005;72;365;129;236
Varėna d. mun.;2005;73;344;119;225
Varėna d. mun.;2005;74;404;131;273
Varėna d. mun.;2005;75;328;109;219
Varėna d. mun.;2005;76;285;97;188
Varėna d. mun.;2005;77;303;96;207
Varėna d. mun.;2005;78;246;84;162
Varėna d. mun.;2005;79;259;73;186
Varėna d. mun.;2005;80;233;79;154
Varėna d. mun.;2005;81;174;50;124
Varėna d. mun.;2005;82;179;38;141
Varėna d. mun.;2005;83;105;27;78
Varėna d. mun.;2005;84;110;24;86
Varėna d. mun.;2005;85;449;122;327
Varėna d. mun.;2006;-1;28742;13605;15137
Varėna d. mun.;2006;0;233;116;117
Varėna d. mun.;2006;1;230;94;136
Varėna d. mun.;2006;2;252;100;152
Varėna d. mun.;2006;3;242;121;121
Varėna d. mun.;2006;4;260;123;137
Varėna d. mun.;2006;5;281;156;125
Varėna d. mun.;2006;6;265;143;122
Varėna d. mun.;2006;7;318;176;142
Varėna d. mun.;2006;8;296;162;134
Varėna d. mun.;2006;9;322;159;163
Varėna d. mun.;2006;10;332;160;172
Varėna d. mun.;2006;11;349;168;181
Varėna d. mun.;2006;12;418;231;187
Varėna d. mun.;2006;13;474;240;234
Varėna d. mun.;2006;14;460;228;232
Varėna d. mun.;2006;15;451;226;225
Varėna d. mun.;2006;16;430;231;199
Varėna d. mun.;2006;17;409;221;188
Varėna d. mun.;2006;18;436;219;217
Varėna d. mun.;2006;19;433;222;211
Varėna d. mun.;2006;20;427;208;219
Varėna d. mun.;2006;21;438;233;205
Varėna d. mun.;2006;22;404;214;190
Varėna d. mun.;2006;23;307;166;141
Varėna d. mun.;2006;24;272;157;115
Varėna d. mun.;2006;25;236;142;94
Varėna d. mun.;2006;26;258;149;109
Varėna d. mun.;2006;27;237;133;104
Varėna d. mun.;2006;28;213;126;87
Varėna d. mun.;2006;29;253;144;109
Varėna d. mun.;2006;30;295;166;129
Varėna d. mun.;2006;31;267;152;115
Varėna d. mun.;2006;32;282;154;128
Varėna d. mun.;2006;33;341;169;172
Varėna d. mun.;2006;34;310;151;159
Varėna d. mun.;2006;35;338;155;183
Varėna d. mun.;2006;36;373;177;196
Varėna d. mun.;2006;37;358;180;178
Varėna d. mun.;2006;38;375;216;159
Varėna d. mun.;2006;39;363;211;152
Varėna d. mun.;2006;40;351;182;169
Varėna d. mun.;2006;41;395;192;203
Varėna d. mun.;2006;42;383;219;164
Varėna d. mun.;2006;43;421;220;201
Varėna d. mun.;2006;44;439;219;220
Varėna d. mun.;2006;45;480;265;215
Varėna d. mun.;2006;46;445;220;225
Varėna d. mun.;2006;47;452;225;227
Varėna d. mun.;2006;48;422;234;188
Varėna d. mun.;2006;49;348;169;179
Varėna d. mun.;2006;50;371;188;183
Varėna d. mun.;2006;51;324;173;151
Varėna d. mun.;2006;52;313;156;157
Varėna d. mun.;2006;53;328;149;179
Varėna d. mun.;2006;54;347;168;179
Varėna d. mun.;2006;55;299;160;139
Varėna d. mun.;2006;56;374;184;190
Varėna d. mun.;2006;57;310;154;156
Varėna d. mun.;2006;58;290;115;175
Varėna d. mun.;2006;59;287;129;158
Varėna d. mun.;2006;60;307;150;157
Varėna d. mun.;2006;61;281;128;153
Varėna d. mun.;2006;62;340;145;195
Varėna d. mun.;2006;63;366;153;213
Varėna d. mun.;2006;64;356;149;207
Varėna d. mun.;2006;65;340;140;200
Varėna d. mun.;2006;66;363;149;214
Varėna d. mun.;2006;67;423;194;229
Varėna d. mun.;2006;68;382;151;231
Varėna d. mun.;2006;69;422;159;263
Varėna d. mun.;2006;70;399;145;254
Varėna d. mun.;2006;71;358;147;211
Varėna d. mun.;2006;72;319;122;197
Varėna d. mun.;2006;73;355;124;231
Varėna d. mun.;2006;74;324;102;222
Varėna d. mun.;2006;75;381;116;265
Varėna d. mun.;2006;76;314;102;212
Varėna d. mun.;2006;77;269;90;179
Varėna d. mun.;2006;78;281;84;197
Varėna d. mun.;2006;79;232;78;154
Varėna d. mun.;2006;80;238;69;169
Varėna d. mun.;2006;81;220;69;151
Varėna d. mun.;2006;82;158;44;114
Varėna d. mun.;2006;83;161;33;128
Varėna d. mun.;2006;84;96;23;73
Varėna d. mun.;2006;85;440;119;321
Varėna d. mun.;2007;-1;28099;13268;14831
Varėna d. mun.;2007;0;222;126;96
Varėna d. mun.;2007;1;231;116;115
Varėna d. mun.;2007;2;232;94;138
Varėna d. mun.;2007;3;249;96;153
Varėna d. mun.;2007;4;239;120;119
Varėna d. mun.;2007;5;260;123;137
Varėna d. mun.;2007;6;274;152;122
Varėna d. mun.;2007;7;261;142;119
Varėna d. mun.;2007;8;312;172;140
Varėna d. mun.;2007;9;294;159;135
Varėna d. mun.;2007;10;320;158;162
Varėna d. mun.;2007;11;329;156;173
Varėna d. mun.;2007;12;347;167;180
Varėna d. mun.;2007;13;415;228;187
Varėna d. mun.;2007;14;472;237;235
Varėna d. mun.;2007;15;458;227;231
Varėna d. mun.;2007;16;451;227;224
Varėna d. mun.;2007;17;425;228;197
Varėna d. mun.;2007;18;405;219;186
Varėna d. mun.;2007;19;427;213;214
Varėna d. mun.;2007;20;421;217;204
Varėna d. mun.;2007;21;409;201;208
Varėna d. mun.;2007;22;425;225;200
Varėna d. mun.;2007;23;382;200;182
Varėna d. mun.;2007;24;300;156;144
Varėna d. mun.;2007;25;249;141;108
Varėna d. mun.;2007;26;227;135;92
Varėna d. mun.;2007;27;239;138;101
Varėna d. mun.;2007;28;228;127;101
Varėna d. mun.;2007;29;205;124;81
Varėna d. mun.;2007;30;240;137;103
Varėna d. mun.;2007;31;293;163;130
Varėna d. mun.;2007;32;257;149;108
Varėna d. mun.;2007;33;277;151;126
Varėna d. mun.;2007;34;322;161;161
Varėna d. mun.;2007;35;305;148;157
Varėna d. mun.;2007;36;329;148;181
Varėna d. mun.;2007;37;367;173;194
Varėna d. mun.;2007;38;356;179;177
Varėna d. mun.;2007;39;366;207;159
Varėna d. mun.;2007;40;359;211;148
Varėna d. mun.;2007;41;349;182;167
Varėna d. mun.;2007;42;389;189;200
Varėna d. mun.;2007;43;376;215;161
Varėna d. mun.;2007;44;410;212;198
Varėna d. mun.;2007;45;430;214;216
Varėna d. mun.;2007;46;479;264;215
Varėna d. mun.;2007;47;438;216;222
Varėna d. mun.;2007;48;442;219;223
Varėna d. mun.;2007;49;420;230;190
Varėna d. mun.;2007;50;338;163;175
Varėna d. mun.;2007;51;366;185;181
Varėna d. mun.;2007;52;317;167;150
Varėna d. mun.;2007;53;302;152;150
Varėna d. mun.;2007;54;324;146;178
Varėna d. mun.;2007;55;333;159;174
Varėna d. mun.;2007;56;291;153;138
Varėna d. mun.;2007;57;361;173;188
Varėna d. mun.;2007;58;305;149;156
Varėna d. mun.;2007;59;284;107;177
Varėna d. mun.;2007;60;280;124;156
Varėna d. mun.;2007;61;301;145;156
Varėna d. mun.;2007;62;268;116;152
Varėna d. mun.;2007;63;335;143;192
Varėna d. mun.;2007;64;349;140;209
Varėna d. mun.;2007;65;349;143;206
Varėna d. mun.;2007;66;332;134;198
Varėna d. mun.;2007;67;352;142;210
Varėna d. mun.;2007;68;410;189;221
Varėna d. mun.;2007;69;364;144;220
Varėna d. mun.;2007;70;411;155;256
Varėna d. mun.;2007;71;383;139;244
Varėna d. mun.;2007;72;349;138;211
Varėna d. mun.;2007;73;302;113;189
Varėna d. mun.;2007;74;336;117;219
Varėna d. mun.;2007;75;309;94;215
Varėna d. mun.;2007;76;368;112;256
Varėna d. mun.;2007;77;298;97;201
Varėna d. mun.;2007;78;256;84;172
Varėna d. mun.;2007;79;263;77;186
Varėna d. mun.;2007;80;220;74;146
Varėna d. mun.;2007;81;214;58;156
Varėna d. mun.;2007;82;203;64;139
Varėna d. mun.;2007;83;148;42;106
Varėna d. mun.;2007;84;134;26;108
Varėna d. mun.;2007;85;432;112;320
Varėna d. mun.;2008;-1;27531;12982;14549
Varėna d. mun.;2008;0;187;101;86
Varėna d. mun.;2008;1;220;125;95
Varėna d. mun.;2008;2;225;113;112
Varėna d. mun.;2008;3;229;94;135
Varėna d. mun.;2008;4;244;93;151
Varėna d. mun.;2008;5;233;117;116
Varėna d. mun.;2008;6;256;120;136
Varėna d. mun.;2008;7;269;147;122
Varėna d. mun.;2008;8;264;143;121
Varėna d. mun.;2008;9;308;170;138
Varėna d. mun.;2008;10;288;155;133
Varėna d. mun.;2008;11;315;156;159
Varėna d. mun.;2008;12;325;154;171
Varėna d. mun.;2008;13;349;167;182
Varėna d. mun.;2008;14;414;227;187
Varėna d. mun.;2008;15;469;236;233
Varėna d. mun.;2008;16;453;224;229
Varėna d. mun.;2008;17;445;223;222
Varėna d. mun.;2008;18;424;229;195
Varėna d. mun.;2008;19;401;217;184
Varėna d. mun.;2008;20;418;209;209
Varėna d. mun.;2008;21;410;209;201
Varėna d. mun.;2008;22;400;196;204
Varėna d. mun.;2008;23;416;225;191
Varėna d. mun.;2008;24;371;193;178
Varėna d. mun.;2008;25;284;151;133
Varėna d. mun.;2008;26;240;135;105
Varėna d. mun.;2008;27;213;126;87
Varėna d. mun.;2008;28;223;133;90
Varėna d. mun.;2008;29;214;120;94
Varėna d. mun.;2008;30;201;119;82
Varėna d. mun.;2008;31;240;137;103
Varėna d. mun.;2008;32;290;163;127
Varėna d. mun.;2008;33;246;143;103
Varėna d. mun.;2008;34;269;147;122
Varėna d. mun.;2008;35;317;158;159
Varėna d. mun.;2008;36;294;141;153
Varėna d. mun.;2008;37;324;145;179
Varėna d. mun.;2008;38;359;173;186
Varėna d. mun.;2008;39;353;175;178
Varėna d. mun.;2008;40;364;203;161
Varėna d. mun.;2008;41;356;208;148
Varėna d. mun.;2008;42;346;181;165
Varėna d. mun.;2008;43;374;179;195
Varėna d. mun.;2008;44;374;214;160
Varėna d. mun.;2008;45;398;201;197
Varėna d. mun.;2008;46;426;212;214
Varėna d. mun.;2008;47;475;261;214
Varėna d. mun.;2008;48;427;205;222
Varėna d. mun.;2008;49;444;220;224
Varėna d. mun.;2008;50;409;218;191
Varėna d. mun.;2008;51;329;154;175
Varėna d. mun.;2008;52;366;185;181
Varėna d. mun.;2008;53;311;160;151
Varėna d. mun.;2008;54;296;145;151
Varėna d. mun.;2008;55;319;140;179
Varėna d. mun.;2008;56;331;156;175
Varėna d. mun.;2008;57;291;154;137
Varėna d. mun.;2008;58;354;167;187
Varėna d. mun.;2008;59;304;148;156
Varėna d. mun.;2008;60;278;105;173
Varėna d. mun.;2008;61;273;117;156
Varėna d. mun.;2008;62;297;141;156
Varėna d. mun.;2008;63;266;116;150
Varėna d. mun.;2008;64;328;138;190
Varėna d. mun.;2008;65;335;130;205
Varėna d. mun.;2008;66;339;137;202
Varėna d. mun.;2008;67;327;134;193
Varėna d. mun.;2008;68;344;136;208
Varėna d. mun.;2008;69;403;184;219
Varėna d. mun.;2008;70;356;140;216
Varėna d. mun.;2008;71;393;141;252
Varėna d. mun.;2008;72;364;128;236
Varėna d. mun.;2008;73;330;127;203
Varėna d. mun.;2008;74;289;110;179
Varėna d. mun.;2008;75;326;110;216
Varėna d. mun.;2008;76;298;92;206
Varėna d. mun.;2008;77;354;105;249
Varėna d. mun.;2008;78;280;89;191
Varėna d. mun.;2008;79;247;82;165
Varėna d. mun.;2008;80;247;70;177
Varėna d. mun.;2008;81;201;66;135
Varėna d. mun.;2008;82;201;58;143
Varėna d. mun.;2008;83;174;60;114
Varėna d. mun.;2008;84;129;37;92
Varėna d. mun.;2008;85;458;109;349
Varėna d. mun.;2009;-1;26931;12672;14259
Varėna d. mun.;2009;0;208;94;114
Varėna d. mun.;2009;1;186;101;85
Varėna d. mun.;2009;2;217;123;94
Varėna d. mun.;2009;3;226;114;112
Varėna d. mun.;2009;4;228;94;134
Varėna d. mun.;2009;5;242;93;149
Varėna d. mun.;2009;6;233;120;113
Varėna d. mun.;2009;7;247;117;130
Varėna d. mun.;2009;8;267;145;122
Varėna d. mun.;2009;9;260;142;118
Varėna d. mun.;2009;10;307;168;139
Varėna d. mun.;2009;11;288;154;134
Varėna d. mun.;2009;12;312;156;156
Varėna d. mun.;2009;13;320;153;167
Varėna d. mun.;2009;14;348;166;182
Varėna d. mun.;2009;15;411;225;186
Varėna d. mun.;2009;16;471;240;231
Varėna d. mun.;2009;17;455;226;229
Varėna d. mun.;2009;18;443;223;220
Varėna d. mun.;2009;19;420;228;192
Varėna d. mun.;2009;20;389;210;179
Varėna d. mun.;2009;21;409;206;203
Varėna d. mun.;2009;22;399;206;193
Varėna d. mun.;2009;23;387;191;196
Varėna d. mun.;2009;24;404;217;187
Varėna d. mun.;2009;25;351;187;164
Varėna d. mun.;2009;26;262;138;124
Varėna d. mun.;2009;27;226;128;98
Varėna d. mun.;2009;28;197;114;83
Varėna d. mun.;2009;29;210;125;85
Varėna d. mun.;2009;30;201;113;88
Varėna d. mun.;2009;31;199;118;81
Varėna d. mun.;2009;32;225;131;94
Varėna d. mun.;2009;33;279;158;121
Varėna d. mun.;2009;34;242;140;102
Varėna d. mun.;2009;35;256;140;116
Varėna d. mun.;2009;36;315;159;156
Varėna d. mun.;2009;37;287;135;152
Varėna d. mun.;2009;38;316;140;176
Varėna d. mun.;2009;39;347;167;180
Varėna d. mun.;2009;40;347;170;177
Varėna d. mun.;2009;41;359;201;158
Varėna d. mun.;2009;42;353;206;147
Varėna d. mun.;2009;43;337;174;163
Varėna d. mun.;2009;44;375;182;193
Varėna d. mun.;2009;45;371;211;160
Varėna d. mun.;2009;46;393;196;197
Varėna d. mun.;2009;47;421;211;210
Varėna d. mun.;2009;48;468;255;213
Varėna d. mun.;2009;49;421;202;219
Varėna d. mun.;2009;50;438;216;222
Varėna d. mun.;2009;51;406;218;188
Varėna d. mun.;2009;52;320;147;173
Varėna d. mun.;2009;53;361;181;180
Varėna d. mun.;2009;54;303;155;148
Varėna d. mun.;2009;55;289;140;149
Varėna d. mun.;2009;56;307;132;175
Varėna d. mun.;2009;57;321;150;171
Varėna d. mun.;2009;58;288;153;135
Varėna d. mun.;2009;59;346;160;186
Varėna d. mun.;2009;60;297;142;155
Varėna d. mun.;2009;61;273;102;171
Varėna d. mun.;2009;62;274;119;155
Varėna d. mun.;2009;63;295;139;156
Varėna d. mun.;2009;64;257;109;148
Varėna d. mun.;2009;65;323;130;193
Varėna d. mun.;2009;66;324;123;201
Varėna d. mun.;2009;67;328;129;199
Varėna d. mun.;2009;68;317;127;190
Varėna d. mun.;2009;69;332;127;205
Varėna d. mun.;2009;70;386;171;215
Varėna d. mun.;2009;71;348;131;217
Varėna d. mun.;2009;72;383;134;249
Varėna d. mun.;2009;73;354;124;230
Varėna d. mun.;2009;74;313;119;194
Varėna d. mun.;2009;75;279;104;175
Varėna d. mun.;2009;76;313;103;210
Varėna d. mun.;2009;77;285;87;198
Varėna d. mun.;2009;78;325;92;233
Varėna d. mun.;2009;79;264;80;184
Varėna d. mun.;2009;80;228;76;152
Varėna d. mun.;2009;81;230;61;169
Varėna d. mun.;2009;82;180;59;121
Varėna d. mun.;2009;83;178;50;128
Varėna d. mun.;2009;84;155;51;104
Varėna d. mun.;2009;85;476;118;358
Varėna d. mun.;2010;-1;26417;12413;14004
Varėna d. mun.;2010;0;212;113;99
Varėna d. mun.;2010;1;203;91;112
Varėna d. mun.;2010;2;181;99;82
Varėna d. mun.;2010;3;215;123;92
Varėna d. mun.;2010;4;228;116;112
Varėna d. mun.;2010;5;221;90;131
Varėna d. mun.;2010;6;244;98;146
Varėna d. mun.;2010;7;237;121;116
Varėna d. mun.;2010;8;247;114;133
Varėna d. mun.;2010;9;267;145;122
Varėna d. mun.;2010;10;260;141;119
Varėna d. mun.;2010;11;312;172;140
Varėna d. mun.;2010;12;285;153;132
Varėna d. mun.;2010;13;315;157;158
Varėna d. mun.;2010;14;321;154;167
Varėna d. mun.;2010;15;349;166;183
Varėna d. mun.;2010;16;409;224;185
Varėna d. mun.;2010;17;469;238;231
Varėna d. mun.;2010;18;450;223;227
Varėna d. mun.;2010;19;440;223;217
Varėna d. mun.;2010;20;407;222;185
Varėna d. mun.;2010;21;383;205;178
Varėna d. mun.;2010;22;395;199;196
Varėna d. mun.;2010;23;386;202;184
Varėna d. mun.;2010;24;374;185;189
Varėna d. mun.;2010;25;392;211;181
Varėna d. mun.;2010;26;327;173;154
Varėna d. mun.;2010;27;253;133;120
Varėna d. mun.;2010;28;214;124;90
Varėna d. mun.;2010;29;185;109;76
Varėna d. mun.;2010;30;199;121;78
Varėna d. mun.;2010;31;187;106;81
Varėna d. mun.;2010;32;191;114;77
Varėna d. mun.;2010;33;213;125;88
Varėna d. mun.;2010;34;273;154;119
Varėna d. mun.;2010;35;236;133;103
Varėna d. mun.;2010;36;251;140;111
Varėna d. mun.;2010;37;310;157;153
Varėna d. mun.;2010;38;282;133;149
Varėna d. mun.;2010;39;315;140;175
Varėna d. mun.;2010;40;345;163;182
Varėna d. mun.;2010;41;345;170;175
Varėna d. mun.;2010;42;354;198;156
Varėna d. mun.;2010;43;349;204;145
Varėna d. mun.;2010;44;333;169;164
Varėna d. mun.;2010;45;367;177;190
Varėna d. mun.;2010;46;367;206;161
Varėna d. mun.;2010;47;385;190;195
Varėna d. mun.;2010;48;418;209;209
Varėna d. mun.;2010;49;460;249;211
Varėna d. mun.;2010;50;413;196;217
Varėna d. mun.;2010;51;433;213;220
Varėna d. mun.;2010;52;409;219;190
Varėna d. mun.;2010;53;316;148;168
Varėna d. mun.;2010;54;352;171;181
Varėna d. mun.;2010;55;298;152;146
Varėna d. mun.;2010;56;288;137;151
Varėna d. mun.;2010;57;298;127;171
Varėna d. mun.;2010;58;316;146;170
Varėna d. mun.;2010;59;281;150;131
Varėna d. mun.;2010;60;341;157;184
Varėna d. mun.;2010;61;287;135;152
Varėna d. mun.;2010;62;268;97;171
Varėna d. mun.;2010;63;269;118;151
Varėna d. mun.;2010;64;285;132;153
Varėna d. mun.;2010;65;247;102;145
Varėna d. mun.;2010;66;316;126;190
Varėna d. mun.;2010;67;319;121;198
Varėna d. mun.;2010;68;319;124;195
Varėna d. mun.;2010;69;308;120;188
Varėna d. mun.;2010;70;322;122;200
Varėna d. mun.;2010;71;375;164;211
Varėna d. mun.;2010;72;338;129;209
Varėna d. mun.;2010;73;371;127;244
Varėna d. mun.;2010;74;344;121;223
Varėna d. mun.;2010;75;304;114;190
Varėna d. mun.;2010;76;267;97;170
Varėna d. mun.;2010;77;298;91;207
Varėna d. mun.;2010;78;274;80;194
Varėna d. mun.;2010;79;302;80;222
Varėna d. mun.;2010;80;244;70;174
Varėna d. mun.;2010;81;206;65;141
Varėna d. mun.;2010;82;211;54;157
Varėna d. mun.;2010;83;162;52;110
Varėna d. mun.;2010;84;162;44;118
Varėna d. mun.;2010;85;513;130;383
Varėna d. mun.;2011;-1;25506;11980;13526
Varėna d. mun.;2011;0;172;104;68
Varėna d. mun.;2011;1;172;93;79
Varėna d. mun.;2011;2;169;68;101
Varėna d. mun.;2011;3;150;85;65
Varėna d. mun.;2011;4;183;107;76
Varėna d. mun.;2011;5;188;98;90
Varėna d. mun.;2011;6;194;80;114
Varėna d. mun.;2011;7;215;88;127
Varėna d. mun.;2011;8;223;112;111
Varėna d. mun.;2011;9;240;114;126
Varėna d. mun.;2011;10;267;145;122
Varėna d. mun.;2011;11;256;133;123
Varėna d. mun.;2011;12;309;175;134
Varėna d. mun.;2011;13;283;151;132
Varėna d. mun.;2011;14;304;155;149
Varėna d. mun.;2011;15;316;148;168
Varėna d. mun.;2011;16;332;155;177
Varėna d. mun.;2011;17;392;217;175
Varėna d. mun.;2011;18;453;224;229
Varėna d. mun.;2011;19;366;185;181
Varėna d. mun.;2011;20;353;194;159
Varėna d. mun.;2011;21;324;178;146
Varėna d. mun.;2011;22;303;169;134
Varėna d. mun.;2011;23;307;171;136
Varėna d. mun.;2011;24;296;177;119
Varėna d. mun.;2011;25;269;136;133
Varėna d. mun.;2011;26;278;153;125
Varėna d. mun.;2011;27;227;129;98
Varėna d. mun.;2011;28;225;114;111
Varėna d. mun.;2011;29;234;126;108
Varėna d. mun.;2011;30;222;115;107
Varėna d. mun.;2011;31;215;114;101
Varėna d. mun.;2011;32;224;125;99
Varėna d. mun.;2011;33;246;130;116
Varėna d. mun.;2011;34;273;141;132
Varėna d. mun.;2011;35;304;153;151
Varėna d. mun.;2011;36;258;137;121
Varėna d. mun.;2011;37;288;154;134
Varėna d. mun.;2011;38;340;174;166
Varėna d. mun.;2011;39;328;155;173
Varėna d. mun.;2011;40;341;166;175
Varėna d. mun.;2011;41;400;188;212
Varėna d. mun.;2011;42;382;201;181
Varėna d. mun.;2011;43;378;214;164
Varėna d. mun.;2011;44;362;204;158
Varėna d. mun.;2011;45;368;186;182
Varėna d. mun.;2011;46;376;177;199
Varėna d. mun.;2011;47;374;220;154
Varėna d. mun.;2011;48;431;223;208
Varėna d. mun.;2011;49;423;214;209
Varėna d. mun.;2011;50;459;245;214
Varėna d. mun.;2011;51;456;220;236
Varėna d. mun.;2011;52;394;188;206
Varėna d. mun.;2011;53;396;206;190
Varėna d. mun.;2011;54;335;160;175
Varėna d. mun.;2011;55;348;165;183
Varėna d. mun.;2011;56;307;152;155
Varėna d. mun.;2011;57;279;139;140
Varėna d. mun.;2011;58;297;130;167
Varėna d. mun.;2011;59;312;140;172
Varėna d. mun.;2011;60;286;145;141
Varėna d. mun.;2011;61;311;135;176
Varėna d. mun.;2011;62;287;137;150
Varėna d. mun.;2011;63;265;102;163
Varėna d. mun.;2011;64;248;105;143
Varėna d. mun.;2011;65;275;120;155
Varėna d. mun.;2011;66;249;102;147
Varėna d. mun.;2011;67;305;121;184
Varėna d. mun.;2011;68;311;114;197
Varėna d. mun.;2011;69;303;118;185
Varėna d. mun.;2011;70;288;105;183
Varėna d. mun.;2011;71;315;118;197
Varėna d. mun.;2011;72;339;146;193
Varėna d. mun.;2011;73;313;112;201
Varėna d. mun.;2011;74;353;119;234
Varėna d. mun.;2011;75;316;109;207
Varėna d. mun.;2011;76;295;105;190
Varėna d. mun.;2011;77;253;83;170
Varėna d. mun.;2011;78;277;82;195
Varėna d. mun.;2011;79;236;67;169
Varėna d. mun.;2011;80;268;70;198
Varėna d. mun.;2011;81;208;62;146
Varėna d. mun.;2011;82;189;60;129
Varėna d. mun.;2011;83;171;43;128
Varėna d. mun.;2011;84;145;45;100
Varėna d. mun.;2011;85;584;135;449
Varėna d. mun.;2012;-1;24946;11724;13222
Varėna d. mun.;2012;0;194;105;89
Varėna d. mun.;2012;1;172;102;70
Varėna d. mun.;2012;2;173;96;77
Varėna d. mun.;2012;3;166;66;100
Varėna d. mun.;2012;4;149;83;66
Varėna d. mun.;2012;5;181;105;76
Varėna d. mun.;2012;6;188;98;90
Varėna d. mun.;2012;7;190;80;110
Varėna d. mun.;2012;8;212;87;125
Varėna d. mun.;2012;9;222;114;108
Varėna d. mun.;2012;10;238;113;125
Varėna d. mun.;2012;11;267;146;121
Varėna d. mun.;2012;12;250;130;120
Varėna d. mun.;2012;13;309;175;134
Varėna d. mun.;2012;14;283;151;132
Varėna d. mun.;2012;15;298;153;145
Varėna d. mun.;2012;16;314;148;166
Varėna d. mun.;2012;17;330;156;174
Varėna d. mun.;2012;18;383;209;174
Varėna d. mun.;2012;19;443;222;221
Varėna d. mun.;2012;20;364;187;177
Varėna d. mun.;2012;21;335;189;146
Varėna d. mun.;2012;22;310;174;136
Varėna d. mun.;2012;23;282;159;123
Varėna d. mun.;2012;24;300;164;136
Varėna d. mun.;2012;25;279;170;109
Varėna d. mun.;2012;26;253;128;125
Varėna d. mun.;2012;27;256;142;114
Varėna d. mun.;2012;28;207;122;85
Varėna d. mun.;2012;29;199;105;94
Varėna d. mun.;2012;30;220;119;101
Varėna d. mun.;2012;31;206;108;98
Varėna d. mun.;2012;32;211;110;101
Varėna d. mun.;2012;33;226;123;103
Varėna d. mun.;2012;34;237;123;114
Varėna d. mun.;2012;35;260;139;121
Varėna d. mun.;2012;36;287;149;138
Varėna d. mun.;2012;37;250;134;116
Varėna d. mun.;2012;38;279;149;130
Varėna d. mun.;2012;39;334;167;167
Varėna d. mun.;2012;40;322;152;170
Varėna d. mun.;2012;41;337;161;176
Varėna d. mun.;2012;42;393;185;208
Varėna d. mun.;2012;43;373;199;174
Varėna d. mun.;2012;44;373;211;162
Varėna d. mun.;2012;45;357;201;156
Varėna d. mun.;2012;46;365;184;181
Varėna d. mun.;2012;47;366;170;196
Varėna d. mun.;2012;48;369;219;150
Varėna d. mun.;2012;49;426;222;204
Varėna d. mun.;2012;50;419;212;207
Varėna d. mun.;2012;51;458;244;214
Varėna d. mun.;2012;52;456;219;237
Varėna d. mun.;2012;53;389;184;205
Varėna d. mun.;2012;54;394;204;190
Varėna d. mun.;2012;55;338;161;177
Varėna d. mun.;2012;56;343;161;182
Varėna d. mun.;2012;57;305;150;155
Varėna d. mun.;2012;58;278;138;140
Varėna d. mun.;2012;59;293;129;164
Varėna d. mun.;2012;60;307;136;171
Varėna d. mun.;2012;61;282;142;140
Varėna d. mun.;2012;62;310;133;177
Varėna d. mun.;2012;63;282;135;147
Varėna d. mun.;2012;64;259;98;161
Varėna d. mun.;2012;65;240;98;142
Varėna d. mun.;2012;66;267;114;153
Varėna d. mun.;2012;67;243;98;145
Varėna d. mun.;2012;68;291;109;182
Varėna d. mun.;2012;69;304;107;197
Varėna d. mun.;2012;70;293;112;181
Varėna d. mun.;2012;71;280;99;181
Varėna d. mun.;2012;72;308;112;196
Varėna d. mun.;2012;73;324;135;189
Varėna d. mun.;2012;74;299;105;194
Varėna d. mun.;2012;75;348;118;230
Varėna d. mun.;2012;76;306;105;201
Varėna d. mun.;2012;77;282;94;188
Varėna d. mun.;2012;78;240;75;165
Varėna d. mun.;2012;79;264;72;192
Varėna d. mun.;2012;80;221;60;161
Varėna d. mun.;2012;81;251;66;185
Varėna d. mun.;2012;82;185;56;129
Varėna d. mun.;2012;83;173;54;119
Varėna d. mun.;2012;84;158;39;119
Varėna d. mun.;2012;85;618;146;472
Varėna d. mun.;2013;-1;24380;11475;12905
Varėna d. mun.;2013;0;226;125;101
Varėna d. mun.;2013;1;186;100;86
Varėna d. mun.;2013;2;165;99;66
Varėna d. mun.;2013;3;170;97;73
Varėna d. mun.;2013;4;154;64;90
Varėna d. mun.;2013;5;145;81;64
Varėna d. mun.;2013;6;176;103;73
Varėna d. mun.;2013;7;180;94;86
Varėna d. mun.;2013;8;186;79;107
Varėna d. mun.;2013;9;209;86;123
Varėna d. mun.;2013;10;220;114;106
Varėna d. mun.;2013;11;242;115;127
Varėna d. mun.;2013;12;266;146;120
Varėna d. mun.;2013;13;249;127;122
Varėna d. mun.;2013;14;306;172;134
Varėna d. mun.;2013;15;284;152;132
Varėna d. mun.;2013;16;297;154;143
Varėna d. mun.;2013;17;314;150;164
Varėna d. mun.;2013;18;323;152;171
Varėna d. mun.;2013;19;376;208;168
Varėna d. mun.;2013;20;432;215;217
Varėna d. mun.;2013;21;350;183;167
Varėna d. mun.;2013;22;321;182;139
Varėna d. mun.;2013;23;290;162;128
Varėna d. mun.;2013;24;272;156;116
Varėna d. mun.;2013;25;281;159;122
Varėna d. mun.;2013;26;264;165;99
Varėna d. mun.;2013;27;220;116;104
Varėna d. mun.;2013;28;236;130;106
Varėna d. mun.;2013;29;191;115;76
Varėna d. mun.;2013;30;174;91;83
Varėna d. mun.;2013;31;202;105;97
Varėna d. mun.;2013;32;194;100;94
Varėna d. mun.;2013;33;202;106;96
Varėna d. mun.;2013;34;222;125;97
Varėna d. mun.;2013;35;227;120;107
Varėna d. mun.;2013;36;261;138;123
Varėna d. mun.;2013;37;276;143;133
Varėna d. mun.;2013;38;251;136;115
Varėna d. mun.;2013;39;270;144;126
Varėna d. mun.;2013;40;327;164;163
Varėna d. mun.;2013;41;322;153;169
Varėna d. mun.;2013;42;341;164;177
Varėna d. mun.;2013;43;391;185;206
Varėna d. mun.;2013;44;368;194;174
Varėna d. mun.;2013;45;375;213;162
Varėna d. mun.;2013;46;352;196;156
Varėna d. mun.;2013;47;363;182;181
Varėna d. mun.;2013;48;364;172;192
Varėna d. mun.;2013;49;368;220;148
Varėna d. mun.;2013;50;425;221;204
Varėna d. mun.;2013;51;417;212;205
Varėna d. mun.;2013;52;455;244;211
Varėna d. mun.;2013;53;446;210;236
Varėna d. mun.;2013;54;384;181;203
Varėna d. mun.;2013;55;388;201;187
Varėna d. mun.;2013;56;335;160;175
Varėna d. mun.;2013;57;336;157;179
Varėna d. mun.;2013;58;299;146;153
Varėna d. mun.;2013;59;271;134;137
Varėna d. mun.;2013;60;291;125;166
Varėna d. mun.;2013;61;301;131;170
Varėna d. mun.;2013;62;273;132;141
Varėna d. mun.;2013;63;301;127;174
Varėna d. mun.;2013;64;272;127;145
Varėna d. mun.;2013;65;251;93;158
Varėna d. mun.;2013;66;235;93;142
Varėna d. mun.;2013;67;259;108;151
Varėna d. mun.;2013;68;236;95;141
Varėna d. mun.;2013;69;282;105;177
Varėna d. mun.;2013;70;298;102;196
Varėna d. mun.;2013;71;286;108;178
Varėna d. mun.;2013;72;272;94;178
Varėna d. mun.;2013;73;297;106;191
Varėna d. mun.;2013;74;312;125;187
Varėna d. mun.;2013;75;280;97;183
Varėna d. mun.;2013;76;333;109;224
Varėna d. mun.;2013;77;293;99;194
Varėna d. mun.;2013;78;274;92;182
Varėna d. mun.;2013;79;216;63;153
Varėna d. mun.;2013;80;245;63;182
Varėna d. mun.;2013;81;207;54;153
Varėna d. mun.;2013;82;242;63;179
Varėna d. mun.;2013;83;165;46;119
Varėna d. mun.;2013;84;159;48;111
Varėna d. mun.;2013;85;663;152;511
Varėna d. mun.;2014;-1;23950;11284;12666
Varėna d. mun.;2014;0;205;110;95
Varėna d. mun.;2014;1;219;119;100
Varėna d. mun.;2014;2;184;100;84
Varėna d. mun.;2014;3;161;97;64
Varėna d. mun.;2014;4;167;92;75
Varėna d. mun.;2014;5;156;67;89
Varėna d. mun.;2014;6;145;79;66
Varėna d. mun.;2014;7;174;102;72
Varėna d. mun.;2014;8;179;93;86
Varėna d. mun.;2014;9;187;80;107
Varėna d. mun.;2014;10;207;86;121
Varėna d. mun.;2014;11;215;111;104
Varėna d. mun.;2014;12;240;116;124
Varėna d. mun.;2014;13;266;146;120
Varėna d. mun.;2014;14;248;127;121
Varėna d. mun.;2014;15;304;172;132
Varėna d. mun.;2014;16;284;152;132
Varėna d. mun.;2014;17;297;155;142
Varėna d. mun.;2014;18;309;148;161
Varėna d. mun.;2014;19;319;150;169
Varėna d. mun.;2014;20;363;202;161
Varėna d. mun.;2014;21;423;209;214
Varėna d. mun.;2014;22;338;178;160
Varėna d. mun.;2014;23;314;182;132
Varėna d. mun.;2014;24;281;157;124
Varėna d. mun.;2014;25;265;156;109
Varėna d. mun.;2014;26;265;149;116
Varėna d. mun.;2014;27;254;157;97
Varėna d. mun.;2014;28;214;116;98
Varėna d. mun.;2014;29;226;130;96
Varėna d. mun.;2014;30;179;106;73
Varėna d. mun.;2014;31;170;92;78
Varėna d. mun.;2014;32;191;98;93
Varėna d. mun.;2014;33;192;100;92
Varėna d. mun.;2014;34;193;103;90
Varėna d. mun.;2014;35;215;117;98
Varėna d. mun.;2014;36;218;113;105
Varėna d. mun.;2014;37;259;139;120
Varėna d. mun.;2014;38;277;144;133
Varėna d. mun.;2014;39;249;134;115
Varėna d. mun.;2014;40;261;138;123
Varėna d. mun.;2014;41;323;162;161
Varėna d. mun.;2014;42;321;156;165
Varėna d. mun.;2014;43;338;160;178
Varėna d. mun.;2014;44;390;183;207
Varėna d. mun.;2014;45;368;193;175
Varėna d. mun.;2014;46;371;210;161
Varėna d. mun.;2014;47;351;193;158
Varėna d. mun.;2014;48;358;177;181
Varėna d. mun.;2014;49;362;171;191
Varėna d. mun.;2014;50;367;219;148
Varėna d. mun.;2014;51;425;221;204
Varėna d. mun.;2014;52;407;206;201
Varėna d. mun.;2014;53;452;239;213
Varėna d. mun.;2014;54;439;202;237
Varėna d. mun.;2014;55;375;173;202
Varėna d. mun.;2014;56;384;199;185
Varėna d. mun.;2014;57;335;162;173
Varėna d. mun.;2014;58;330;151;179
Varėna d. mun.;2014;59;299;146;153
Varėna d. mun.;2014;60;270;133;137
Varėna d. mun.;2014;61;283;120;163
Varėna d. mun.;2014;62;297;129;168
Varėna d. mun.;2014;63;268;130;138
Varėna d. mun.;2014;64;295;124;171
Varėna d. mun.;2014;65;269;123;146
Varėna d. mun.;2014;66;250;92;158
Varėna d. mun.;2014;67;231;92;139
Varėna d. mun.;2014;68;255;104;151
Varėna d. mun.;2014;69;225;90;135
Varėna d. mun.;2014;70;271;99;172
Varėna d. mun.;2014;71;290;97;193
Varėna d. mun.;2014;72;278;103;175
Varėna d. mun.;2014;73;261;87;174
Varėna d. mun.;2014;74;290;102;188
Varėna d. mun.;2014;75;305;120;185
Varėna d. mun.;2014;76;272;94;178
Varėna d. mun.;2014;77;319;102;217
Varėna d. mun.;2014;78;285;96;189
Varėna d. mun.;2014;79;262;87;175
Varėna d. mun.;2014;80;195;56;139
Varėna d. mun.;2014;81;224;59;165
Varėna d. mun.;2014;82;192;51;141
Varėna d. mun.;2014;83;219;53;166
Varėna d. mun.;2014;84;154;41;113
Varėna d. mun.;2014;85;682;155;527
Varėna d. mun.;2015;-1;23528;11112;12416
Varėna d. mun.;2015;0;188;104;84
Varėna d. mun.;2015;1;203;109;94
Varėna d. mun.;2015;2;204;110;94
Varėna d. mun.;2015;3;185;101;84
Varėna d. mun.;2015;4;160;96;64
Varėna d. mun.;2015;5;169;95;74
Varėna d. mun.;2015;6;154;65;89
Varėna d. mun.;2015;7;146;81;65
Varėna d. mun.;2015;8;170;100;70
Varėna d. mun.;2015;9;174;89;85
Varėna d. mun.;2015;10;192;84;108
Varėna d. mun.;2015;11;202;85;117
Varėna d. mun.;2015;12;217;111;106
Varėna d. mun.;2015;13;234;114;120
Varėna d. mun.;2015;14;264;144;120
Varėna d. mun.;2015;15;244;126;118
Varėna d. mun.;2015;16;301;169;132
Varėna d. mun.;2015;17;281;153;128
Varėna d. mun.;2015;18;296;154;142
Varėna d. mun.;2015;19;304;147;157
Varėna d. mun.;2015;20;318;153;165
Varėna d. mun.;2015;21;355;198;157
Varėna d. mun.;2015;22;417;211;206
Varėna d. mun.;2015;23;333;175;158
Varėna d. mun.;2015;24;307;180;127
Varėna d. mun.;2015;25;271;154;117
Varėna d. mun.;2015;26;252;152;100
Varėna d. mun.;2015;27;261;151;110
Varėna d. mun.;2015;28;248;154;94
Varėna d. mun.;2015;29;208;119;89
Varėna d. mun.;2015;30;214;125;89
Varėna d. mun.;2015;31;173;102;71
Varėna d. mun.;2015;32;173;95;78
Varėna d. mun.;2015;33;187;96;91
Varėna d. mun.;2015;34;185;94;91
Varėna d. mun.;2015;35;188;100;88
Varėna d. mun.;2015;36;211;116;95
Varėna d. mun.;2015;37;214;114;100
Varėna d. mun.;2015;38;260;143;117
Varėna d. mun.;2015;39;270;139;131
Varėna d. mun.;2015;40;252;138;114
Varėna d. mun.;2015;41;264;140;124
Varėna d. mun.;2015;42;323;160;163
Varėna d. mun.;2015;43;316;153;163
Varėna d. mun.;2015;44;335;157;178
Varėna d. mun.;2015;45;386;181;205
Varėna d. mun.;2015;46;363;191;172
Varėna d. mun.;2015;47;364;208;156
Varėna d. mun.;2015;48;346;192;154
Varėna d. mun.;2015;49;357;174;183
Varėna d. mun.;2015;50;370;176;194
Varėna d. mun.;2015;51;365;217;148
Varėna d. mun.;2015;52;423;220;203
Varėna d. mun.;2015;53;405;202;203
Varėna d. mun.;2015;54;448;236;212
Varėna d. mun.;2015;55;438;200;238
Varėna d. mun.;2015;56;371;169;202
Varėna d. mun.;2015;57;384;197;187
Varėna d. mun.;2015;58;330;157;173
Varėna d. mun.;2015;59;323;143;180
Varėna d. mun.;2015;60;293;139;154
Varėna d. mun.;2015;61;265;131;134
Varėna d. mun.;2015;62;280;116;164
Varėna d. mun.;2015;63;291;125;166
Varėna d. mun.;2015;64;258;122;136
Varėna d. mun.;2015;65;288;115;173
Varėna d. mun.;2015;66;257;117;140
Varėna d. mun.;2015;67;239;85;154
Varėna d. mun.;2015;68;224;89;135
Varėna d. mun.;2015;69;250;101;149
Varėna d. mun.;2015;70;220;88;132
Varėna d. mun.;2015;71;261;93;168
Varėna d. mun.;2015;72;283;92;191
Varėna d. mun.;2015;73;273;98;175
Varėna d. mun.;2015;74;254;82;172
Varėna d. mun.;2015;75;285;98;187
Varėna d. mun.;2015;76;290;111;179
Varėna d. mun.;2015;77;256;87;169
Varėna d. mun.;2015;78;297;91;206
Varėna d. mun.;2015;79;271;88;183
Varėna d. mun.;2015;80;233;74;159
Varėna d. mun.;2015;81;179;48;131
Varėna d. mun.;2015;82;207;54;153
Varėna d. mun.;2015;83;174;44;130
Varėna d. mun.;2015;84;204;48;156
Varėna d. mun.;2015;85;700;157;543
Varėna d. mun.;2016;-1;23009;10841;12168
Varėna d. mun.;2016;0;201;92;109
Varėna d. mun.;2016;1;182;97;85
Varėna d. mun.;2016;2;197;105;92
Varėna d. mun.;2016;3;199;107;92
Varėna d. mun.;2016;4;189;100;89
Varėna d. mun.;2016;5;160;96;64
Varėna d. mun.;2016;6;163;91;72
Varėna d. mun.;2016;7;155;63;92
Varėna d. mun.;2016;8;145;81;64
Varėna d. mun.;2016;9;169;98;71
Varėna d. mun.;2016;10;176;91;85
Varėna d. mun.;2016;11;190;83;107
Varėna d. mun.;2016;12;202;87;115
Varėna d. mun.;2016;13;212;109;103
Varėna d. mun.;2016;14;232;111;121
Varėna d. mun.;2016;15;262;143;119
Varėna d. mun.;2016;16;241;127;114
Varėna d. mun.;2016;17;299;167;132
Varėna d. mun.;2016;18;275;151;124
Varėna d. mun.;2016;19;290;152;138
Varėna d. mun.;2016;20;297;146;151
Varėna d. mun.;2016;21;311;152;159
Varėna d. mun.;2016;22;356;197;159
Varėna d. mun.;2016;23;410;204;206
Varėna d. mun.;2016;24;310;165;145
Varėna d. mun.;2016;25;298;177;121
Varėna d. mun.;2016;26;256;146;110
Varėna d. mun.;2016;27;233;140;93
Varėna d. mun.;2016;28;229;137;92
Varėna d. mun.;2016;29;226;144;82
Varėna d. mun.;2016;30;198;113;85
Varėna d. mun.;2016;31;203;118;85
Varėna d. mun.;2016;32;166;103;63
Varėna d. mun.;2016;33;161;86;75
Varėna d. mun.;2016;34;186;95;91
Varėna d. mun.;2016;35;178;90;88
Varėna d. mun.;2016;36;180;92;88
Varėna d. mun.;2016;37;203;111;92
Varėna d. mun.;2016;38;208;112;96
Varėna d. mun.;2016;39;251;136;115
Varėna d. mun.;2016;40;264;135;129
Varėna d. mun.;2016;41;250;136;114
Varėna d. mun.;2016;42;258;138;120
Varėna d. mun.;2016;43;318;159;159
Varėna d. mun.;2016;44;309;151;158
Varėna d. mun.;2016;45;321;149;172
Varėna d. mun.;2016;46;376;174;202
Varėna d. mun.;2016;47;358;187;171
Varėna d. mun.;2016;48;361;206;155
Varėna d. mun.;2016;49;344;194;150
Varėna d. mun.;2016;50;355;171;184
Varėna d. mun.;2016;51;368;173;195
Varėna d. mun.;2016;52;368;215;153
Varėna d. mun.;2016;53;421;221;200
Varėna d. mun.;2016;54;400;201;199
Varėna d. mun.;2016;55;442;233;209
Varėna d. mun.;2016;56;433;196;237
Varėna d. mun.;2016;57;370;169;201
Varėna d. mun.;2016;58;376;191;185
Varėna d. mun.;2016;59;330;153;177
Varėna d. mun.;2016;60;314;138;176
Varėna d. mun.;2016;61;292;136;156
Varėna d. mun.;2016;62;265;132;133
Varėna d. mun.;2016;63;277;113;164
Varėna d. mun.;2016;64;289;122;167
Varėna d. mun.;2016;65;255;120;135
Varėna d. mun.;2016;66;280;109;171
Varėna d. mun.;2016;67;252;117;135
Varėna d. mun.;2016;68;235;81;154
Varėna d. mun.;2016;69;221;87;134
Varėna d. mun.;2016;70;248;100;148
Varėna d. mun.;2016;71;212;87;125
Varėna d. mun.;2016;72;251;85;166
Varėna d. mun.;2016;73;274;86;188
Varėna d. mun.;2016;74;258;91;167
Varėna d. mun.;2016;75;245;76;169
Varėna d. mun.;2016;76;274;91;183
Varėna d. mun.;2016;77;282;107;175
Varėna d. mun.;2016;78;238;75;163
Varėna d. mun.;2016;79;275;79;196
Varėna d. mun.;2016;80;254;81;173
Varėna d. mun.;2016;81;214;66;148
Varėna d. mun.;2016;82;168;46;122
Varėna d. mun.;2016;83;193;48;145
Varėna d. mun.;2016;84;163;39;124
Varėna d. mun.;2016;85;759;162;597
Varėna d. mun.;2017;-1;22399;10545;11854
Varėna d. mun.;2017;0;188;90;98
Varėna d. mun.;2017;1;197;88;109
Varėna d. mun.;2017;2;178;95;83
Varėna d. mun.;2017;3;191;100;91
Varėna d. mun.;2017;4;199;107;92
Varėna d. mun.;2017;5;189;101;88
Varėna d. mun.;2017;6;162;97;65
Varėna d. mun.;2017;7;162;90;72
Varėna d. mun.;2017;8;156;65;91
Varėna d. mun.;2017;9;147;82;65
Varėna d. mun.;2017;10;174;100;74
Varėna d. mun.;2017;11;173;88;85
Varėna d. mun.;2017;12;193;85;108
Varėna d. mun.;2017;13;201;86;115
Varėna d. mun.;2017;14;210;107;103
Varėna d. mun.;2017;15;229;110;119
Varėna d. mun.;2017;16;258;141;117
Varėna d. mun.;2017;17;244;127;117
Varėna d. mun.;2017;18;294;164;130
Varėna d. mun.;2017;19;267;149;118
Varėna d. mun.;2017;20;280;146;134
Varėna d. mun.;2017;21;281;138;143
Varėna d. mun.;2017;22;300;147;153
Varėna d. mun.;2017;23;337;186;151
Varėna d. mun.;2017;24;392;196;196
Varėna d. mun.;2017;25;295;165;130
Varėna d. mun.;2017;26;266;160;106
Varėna d. mun.;2017;27;235;145;90
Varėna d. mun.;2017;28;211;129;82
Varėna d. mun.;2017;29;208;123;85
Varėna d. mun.;2017;30;201;128;73
Varėna d. mun.;2017;31;179;105;74
Varėna d. mun.;2017;32;183;107;76
Varėna d. mun.;2017;33;154;96;58
Varėna d. mun.;2017;34;153;85;68
Varėna d. mun.;2017;35;176;88;88
Varėna d. mun.;2017;36;179;90;89
Varėna d. mun.;2017;37;182;91;91
Varėna d. mun.;2017;38;199;107;92
Varėna d. mun.;2017;39;204;108;96
Varėna d. mun.;2017;40;252;135;117
Varėna d. mun.;2017;41;259;130;129
Varėna d. mun.;2017;42;245;133;112
Varėna d. mun.;2017;43;255;136;119
Varėna d. mun.;2017;44;315;157;158
Varėna d. mun.;2017;45;308;151;157
Varėna d. mun.;2017;46;318;146;172
Varėna d. mun.;2017;47;372;172;200
Varėna d. mun.;2017;48;352;183;169
Varėna d. mun.;2017;49;359;205;154
Varėna d. mun.;2017;50;338;191;147
Varėna d. mun.;2017;51;348;167;181
Varėna d. mun.;2017;52;369;174;195
Varėna d. mun.;2017;53;363;214;149
Varėna d. mun.;2017;54;414;215;199
Varėna d. mun.;2017;55;396;198;198
Varėna d. mun.;2017;56;435;231;204
Varėna d. mun.;2017;57;419;189;230
Varėna d. mun.;2017;58;362;162;200
Varėna d. mun.;2017;59;376;192;184
Varėna d. mun.;2017;60;326;148;178
Varėna d. mun.;2017;61;307;134;173
Varėna d. mun.;2017;62;280;123;157
Varėna d. mun.;2017;63;258;127;131
Varėna d. mun.;2017;64;270;109;161
Varėna d. mun.;2017;65;288;119;169
Varėna d. mun.;2017;66;244;111;133
Varėna d. mun.;2017;67;272;104;168
Varėna d. mun.;2017;68;243;110;133
Varėna d. mun.;2017;69;232;78;154
Varėna d. mun.;2017;70;213;84;129
Varėna d. mun.;2017;71;247;100;147
Varėna d. mun.;2017;72;206;83;123
Varėna d. mun.;2017;73;241;80;161
Varėna d. mun.;2017;74;267;80;187
Varėna d. mun.;2017;75;238;79;159
Varėna d. mun.;2017;76;231;71;160
Varėna d. mun.;2017;77;265;86;179
Varėna d. mun.;2017;78;267;99;168
Varėna d. mun.;2017;79;223;68;155
Varėna d. mun.;2017;80;253;71;182
Varėna d. mun.;2017;81;237;73;164
Varėna d. mun.;2017;82;201;59;142
Varėna d. mun.;2017;83;154;42;112
Varėna d. mun.;2017;84;174;42;132
Varėna d. mun.;2017;85;780;172;608
Varėna d. mun.;2018;-1;21764;10267;11497
Varėna d. mun.;2018;0;182;93;89
Varėna d. mun.;2018;1;181;84;97
Varėna d. mun.;2018;2;197;89;108
Varėna d. mun.;2018;3;181;95;86
Varėna d. mun.;2018;4;193;102;91
Varėna d. mun.;2018;5;201;111;90
Varėna d. mun.;2018;6;183;94;89
Varėna d. mun.;2018;7;161;95;66
Varėna d. mun.;2018;8;159;88;71
Varėna d. mun.;2018;9;155;64;91
Varėna d. mun.;2018;10;145;82;63
Varėna d. mun.;2018;11;170;96;74
Varėna d. mun.;2018;12;172;87;85
Varėna d. mun.;2018;13;189;84;105
Varėna d. mun.;2018;14;201;85;116
Varėna d. mun.;2018;15;209;106;103
Varėna d. mun.;2018;16;228;108;120
Varėna d. mun.;2018;17;257;139;118
Varėna d. mun.;2018;18;239;125;114
Varėna d. mun.;2018;19;281;156;125
Varėna d. mun.;2018;20;261;143;118
Varėna d. mun.;2018;21;267;137;130
Varėna d. mun.;2018;22;274;135;139
Varėna d. mun.;2018;23;283;143;140
Varėna d. mun.;2018;24;329;182;147
Varėna d. mun.;2018;25;357;184;173
Varėna d. mun.;2018;26;266;150;116
Varėna d. mun.;2018;27;243;148;95
Varėna d. mun.;2018;28;214;135;79
Varėna d. mun.;2018;29;191;125;66
Varėna d. mun.;2018;30;192;122;70
Varėna d. mun.;2018;31;180;115;65
Varėna d. mun.;2018;32;171;106;65
Varėna d. mun.;2018;33;159;94;65
Varėna d. mun.;2018;34;139;85;54
Varėna d. mun.;2018;35;142;77;65
Varėna d. mun.;2018;36;163;84;79
Varėna d. mun.;2018;37;172;87;85
Varėna d. mun.;2018;38;180;87;93
Varėna d. mun.;2018;39;187;98;89
Varėna d. mun.;2018;40;196;103;93
Varėna d. mun.;2018;41;251;136;115
Varėna d. mun.;2018;42;253;127;126
Varėna d. mun.;2018;43;245;134;111
Varėna d. mun.;2018;44;256;137;119
Varėna d. mun.;2018;45;308;152;156
Varėna d. mun.;2018;46;309;152;157
Varėna d. mun.;2018;47;315;142;173
Varėna d. mun.;2018;48;364;166;198
Varėna d. mun.;2018;49;352;184;168
Varėna d. mun.;2018;50;356;203;153
Varėna d. mun.;2018;51;331;186;145
Varėna d. mun.;2018;52;345;168;177
Varėna d. mun.;2018;53;364;174;190
Varėna d. mun.;2018;54;357;209;148
Varėna d. mun.;2018;55;412;215;197
Varėna d. mun.;2018;56;396;197;199
Varėna d. mun.;2018;57;428;229;199
Varėna d. mun.;2018;58;416;187;229
Varėna d. mun.;2018;59;361;160;201
Varėna d. mun.;2018;60;372;187;185
Varėna d. mun.;2018;61;324;144;180
Varėna d. mun.;2018;62;302;129;173
Varėna d. mun.;2018;63;272;117;155
Varėna d. mun.;2018;64;252;121;131
Varėna d. mun.;2018;65;266;106;160
Varėna d. mun.;2018;66;282;115;167
Varėna d. mun.;2018;67;239;108;131
Varėna d. mun.;2018;68;267;104;163
Varėna d. mun.;2018;69;239;107;132
Varėna d. mun.;2018;70;223;74;149
Varėna d. mun.;2018;71;213;84;129
Varėna d. mun.;2018;72;242;96;146
Varėna d. mun.;2018;73;199;79;120
Varėna d. mun.;2018;74;235;80;155
Varėna d. mun.;2018;75;250;74;176
Varėna d. mun.;2018;76;233;77;156
Varėna d. mun.;2018;77;220;67;153
Varėna d. mun.;2018;78;252;79;173
Varėna d. mun.;2018;79;248;91;157
Varėna d. mun.;2018;80;203;61;142
Varėna d. mun.;2018;81;231;59;172
Varėna d. mun.;2018;82;214;61;153
Varėna d. mun.;2018;83;184;50;134
Varėna d. mun.;2018;84;136;38;98
Varėna d. mun.;2018;85;797;178;619
Vilkaviškis d. mun.;2001;-1;50236;23946;26290
Vilkaviškis d. mun.;2001;0;554;271;283
Vilkaviškis d. mun.;2001;1;617;306;311
Vilkaviškis d. mun.;2001;2;629;340;289
Vilkaviškis d. mun.;2001;3;651;320;331
Vilkaviškis d. mun.;2001;4;650;338;312
Vilkaviškis d. mun.;2001;5;657;341;316
Vilkaviškis d. mun.;2001;6;676;344;332
Vilkaviškis d. mun.;2001;7;744;373;371
Vilkaviškis d. mun.;2001;8;848;441;407
Vilkaviškis d. mun.;2001;9;830;419;411
Vilkaviškis d. mun.;2001;10;838;423;415
Vilkaviškis d. mun.;2001;11;816;416;400
Vilkaviškis d. mun.;2001;12;888;477;411
Vilkaviškis d. mun.;2001;13;892;461;431
Vilkaviškis d. mun.;2001;14;918;474;444
Vilkaviškis d. mun.;2001;15;868;420;448
Vilkaviškis d. mun.;2001;16;828;424;404
Vilkaviškis d. mun.;2001;17;753;383;370
Vilkaviškis d. mun.;2001;18;623;345;278
Vilkaviškis d. mun.;2001;19;544;303;241
Vilkaviškis d. mun.;2001;20;500;277;223
Vilkaviškis d. mun.;2001;21;551;300;251
Vilkaviškis d. mun.;2001;22;587;330;257
Vilkaviškis d. mun.;2001;23;556;285;271
Vilkaviškis d. mun.;2001;24;621;321;300
Vilkaviškis d. mun.;2001;25;549;270;279
Vilkaviškis d. mun.;2001;26;618;319;299
Vilkaviškis d. mun.;2001;27;631;309;322
Vilkaviškis d. mun.;2001;28;690;352;338
Vilkaviškis d. mun.;2001;29;734;372;362
Vilkaviškis d. mun.;2001;30;740;376;364
Vilkaviškis d. mun.;2001;31;679;360;319
Vilkaviškis d. mun.;2001;32;684;358;326
Vilkaviškis d. mun.;2001;33;641;329;312
Vilkaviškis d. mun.;2001;34;690;332;358
Vilkaviškis d. mun.;2001;35;652;322;330
Vilkaviškis d. mun.;2001;36;696;338;358
Vilkaviškis d. mun.;2001;37;679;340;339
Vilkaviškis d. mun.;2001;38;705;374;331
Vilkaviškis d. mun.;2001;39;795;410;385
Vilkaviškis d. mun.;2001;40;719;368;351
Vilkaviškis d. mun.;2001;41;706;385;321
Vilkaviškis d. mun.;2001;42;724;358;366
Vilkaviškis d. mun.;2001;43;698;361;337
Vilkaviškis d. mun.;2001;44;604;279;325
Vilkaviškis d. mun.;2001;45;622;307;315
Vilkaviškis d. mun.;2001;46;597;272;325
Vilkaviškis d. mun.;2001;47;550;280;270
Vilkaviškis d. mun.;2001;48;555;286;269
Vilkaviškis d. mun.;2001;49;645;314;331
Vilkaviškis d. mun.;2001;50;583;279;304
Vilkaviškis d. mun.;2001;51;633;314;319
Vilkaviškis d. mun.;2001;52;543;234;309
Vilkaviškis d. mun.;2001;53;502;257;245
Vilkaviškis d. mun.;2001;54;435;238;197
Vilkaviškis d. mun.;2001;55;578;274;304
Vilkaviškis d. mun.;2001;56;390;180;210
Vilkaviškis d. mun.;2001;57;556;247;309
Vilkaviškis d. mun.;2001;58;680;271;409
Vilkaviškis d. mun.;2001;59;587;263;324
Vilkaviškis d. mun.;2001;60;520;207;313
Vilkaviškis d. mun.;2001;61;473;203;270
Vilkaviškis d. mun.;2001;62;558;219;339
Vilkaviškis d. mun.;2001;63;527;223;304
Vilkaviškis d. mun.;2001;64;535;216;319
Vilkaviškis d. mun.;2001;65;532;217;315
Vilkaviškis d. mun.;2001;66;483;193;290
Vilkaviškis d. mun.;2001;67;574;243;331
Vilkaviškis d. mun.;2001;68;571;212;359
Vilkaviškis d. mun.;2001;69;504;202;302
Vilkaviškis d. mun.;2001;70;578;234;344
Vilkaviškis d. mun.;2001;71;552;189;363
Vilkaviškis d. mun.;2001;72;481;178;303
Vilkaviškis d. mun.;2001;73;433;146;287
Vilkaviškis d. mun.;2001;74;375;115;260
Vilkaviškis d. mun.;2001;75;340;112;228
Vilkaviškis d. mun.;2001;76;321;90;231
Vilkaviškis d. mun.;2001;77;299;92;207
Vilkaviškis d. mun.;2001;78;288;99;189
Vilkaviškis d. mun.;2001;79;219;79;140
Vilkaviškis d. mun.;2001;80;206;74;132
Vilkaviškis d. mun.;2001;81;190;58;132
Vilkaviškis d. mun.;2001;82;117;32;85
Vilkaviškis d. mun.;2001;83;101;30;71
Vilkaviškis d. mun.;2001;84;108;33;75
Vilkaviškis d. mun.;2001;85;622;190;432
Vilkaviškis d. mun.;2002;-1;49951;23844;26107
Vilkaviškis d. mun.;2002;0;549;298;251
Vilkaviškis d. mun.;2002;1;552;271;281
Vilkaviškis d. mun.;2002;2;615;306;309
Vilkaviškis d. mun.;2002;3;628;339;289
Vilkaviškis d. mun.;2002;4;653;322;331
Vilkaviškis d. mun.;2002;5;646;340;306
Vilkaviškis d. mun.;2002;6;660;341;319
Vilkaviškis d. mun.;2002;7;674;345;329
Vilkaviškis d. mun.;2002;8;749;376;373
Vilkaviškis d. mun.;2002;9;847;440;407
Vilkaviškis d. mun.;2002;10;824;413;411
Vilkaviškis d. mun.;2002;11;833;420;413
Vilkaviškis d. mun.;2002;12;807;414;393
Vilkaviškis d. mun.;2002;13;876;469;407
Vilkaviškis d. mun.;2002;14;884;457;427
Vilkaviškis d. mun.;2002;15;906;465;441
Vilkaviškis d. mun.;2002;16;862;417;445
Vilkaviškis d. mun.;2002;17;817;417;400
Vilkaviškis d. mun.;2002;18;739;380;359
Vilkaviškis d. mun.;2002;19;611;340;271
Vilkaviškis d. mun.;2002;20;534;298;236
Vilkaviškis d. mun.;2002;21;503;273;230
Vilkaviškis d. mun.;2002;22;555;306;249
Vilkaviškis d. mun.;2002;23;597;334;263
Vilkaviškis d. mun.;2002;24;550;283;267
Vilkaviškis d. mun.;2002;25;618;319;299
Vilkaviškis d. mun.;2002;26;538;261;277
Vilkaviškis d. mun.;2002;27;608;311;297
Vilkaviškis d. mun.;2002;28;616;305;311
Vilkaviškis d. mun.;2002;29;674;345;329
Vilkaviškis d. mun.;2002;30;722;363;359
Vilkaviškis d. mun.;2002;31;734;374;360
Vilkaviškis d. mun.;2002;32;663;347;316
Vilkaviškis d. mun.;2002;33;676;351;325
Vilkaviškis d. mun.;2002;34;635;325;310
Vilkaviškis d. mun.;2002;35;683;328;355
Vilkaviškis d. mun.;2002;36;645;317;328
Vilkaviškis d. mun.;2002;37;688;333;355
Vilkaviškis d. mun.;2002;38;666;332;334
Vilkaviškis d. mun.;2002;39;692;366;326
Vilkaviškis d. mun.;2002;40;781;399;382
Vilkaviškis d. mun.;2002;41;714;366;348
Vilkaviškis d. mun.;2002;42;691;376;315
Vilkaviškis d. mun.;2002;43;712;355;357
Vilkaviškis d. mun.;2002;44;694;359;335
Vilkaviškis d. mun.;2002;45;594;275;319
Vilkaviškis d. mun.;2002;46;613;303;310
Vilkaviškis d. mun.;2002;47;590;273;317
Vilkaviškis d. mun.;2002;48;541;274;267
Vilkaviškis d. mun.;2002;49;544;279;265
Vilkaviškis d. mun.;2002;50;634;307;327
Vilkaviškis d. mun.;2002;51;570;270;300
Vilkaviškis d. mun.;2002;52;627;311;316
Vilkaviškis d. mun.;2002;53;542;234;308
Vilkaviškis d. mun.;2002;54;490;249;241
Vilkaviškis d. mun.;2002;55;429;234;195
Vilkaviškis d. mun.;2002;56;563;264;299
Vilkaviškis d. mun.;2002;57;387;178;209
Vilkaviškis d. mun.;2002;58;542;242;300
Vilkaviškis d. mun.;2002;59;664;265;399
Vilkaviškis d. mun.;2002;60;582;261;321
Vilkaviškis d. mun.;2002;61;527;210;317
Vilkaviškis d. mun.;2002;62;473;201;272
Vilkaviškis d. mun.;2002;63;557;219;338
Vilkaviškis d. mun.;2002;64;524;224;300
Vilkaviškis d. mun.;2002;65;531;214;317
Vilkaviškis d. mun.;2002;66;518;208;310
Vilkaviškis d. mun.;2002;67;475;191;284
Vilkaviškis d. mun.;2002;68;561;238;323
Vilkaviškis d. mun.;2002;69;560;207;353
Vilkaviškis d. mun.;2002;70;490;195;295
Vilkaviškis d. mun.;2002;71;572;231;341
Vilkaviškis d. mun.;2002;72;539;186;353
Vilkaviškis d. mun.;2002;73;460;172;288
Vilkaviškis d. mun.;2002;74;417;137;280
Vilkaviškis d. mun.;2002;75;360;109;251
Vilkaviškis d. mun.;2002;76;332;111;221
Vilkaviškis d. mun.;2002;77;304;81;223
Vilkaviškis d. mun.;2002;78;280;79;201
Vilkaviškis d. mun.;2002;79;276;93;183
Vilkaviškis d. mun.;2002;80;206;76;130
Vilkaviškis d. mun.;2002;81;182;64;118
Vilkaviškis d. mun.;2002;82;170;54;116
Vilkaviškis d. mun.;2002;83;110;29;81
Vilkaviškis d. mun.;2002;84;90;27;63
Vilkaviškis d. mun.;2002;85;604;173;431
Vilkaviškis d. mun.;2003;-1;49622;23694;25928
Vilkaviškis d. mun.;2003;0;516;243;273
Vilkaviškis d. mun.;2003;1;537;291;246
Vilkaviškis d. mun.;2003;2;549;270;279
Vilkaviškis d. mun.;2003;3;615;305;310
Vilkaviškis d. mun.;2003;4;626;338;288
Vilkaviškis d. mun.;2003;5;650;319;331
Vilkaviškis d. mun.;2003;6;641;337;304
Vilkaviškis d. mun.;2003;7;661;342;319
Vilkaviškis d. mun.;2003;8;674;346;328
Vilkaviškis d. mun.;2003;9;745;374;371
Vilkaviškis d. mun.;2003;10;840;438;402
Vilkaviškis d. mun.;2003;11;821;414;407
Vilkaviškis d. mun.;2003;12;821;415;406
Vilkaviškis d. mun.;2003;13;796;407;389
Vilkaviškis d. mun.;2003;14;863;461;402
Vilkaviškis d. mun.;2003;15;870;449;421
Vilkaviškis d. mun.;2003;16;896;460;436
Vilkaviškis d. mun.;2003;17;844;407;437
Vilkaviškis d. mun.;2003;18;802;411;391
Vilkaviškis d. mun.;2003;19;734;377;357
Vilkaviškis d. mun.;2003;20;601;335;266
Vilkaviškis d. mun.;2003;21;538;303;235
Vilkaviškis d. mun.;2003;22;515;279;236
Vilkaviškis d. mun.;2003;23;554;308;246
Vilkaviškis d. mun.;2003;24;603;339;264
Vilkaviškis d. mun.;2003;25;552;284;268
Vilkaviškis d. mun.;2003;26;616;320;296
Vilkaviškis d. mun.;2003;27;519;253;266
Vilkaviškis d. mun.;2003;28;592;302;290
Vilkaviškis d. mun.;2003;29;606;299;307
Vilkaviškis d. mun.;2003;30;663;339;324
Vilkaviškis d. mun.;2003;31;715;363;352
Vilkaviškis d. mun.;2003;32;724;368;356
Vilkaviškis d. mun.;2003;33;656;346;310
Vilkaviškis d. mun.;2003;34;673;351;322
Vilkaviškis d. mun.;2003;35;630;322;308
Vilkaviškis d. mun.;2003;36;676;324;352
Vilkaviškis d. mun.;2003;37;636;314;322
Vilkaviškis d. mun.;2003;38;681;331;350
Vilkaviškis d. mun.;2003;39;660;330;330
Vilkaviškis d. mun.;2003;40;685;360;325
Vilkaviškis d. mun.;2003;41;776;398;378
Vilkaviškis d. mun.;2003;42;711;365;346
Vilkaviškis d. mun.;2003;43;689;375;314
Vilkaviškis d. mun.;2003;44;719;359;360
Vilkaviškis d. mun.;2003;45;685;355;330
Vilkaviškis d. mun.;2003;46;590;272;318
Vilkaviškis d. mun.;2003;47;609;301;308
Vilkaviškis d. mun.;2003;48;581;264;317
Vilkaviškis d. mun.;2003;49;537;270;267
Vilkaviškis d. mun.;2003;50;534;273;261
Vilkaviškis d. mun.;2003;51;628;304;324
Vilkaviškis d. mun.;2003;52;561;269;292
Vilkaviškis d. mun.;2003;53;626;312;314
Vilkaviškis d. mun.;2003;54;535;232;303
Vilkaviškis d. mun.;2003;55;489;248;241
Vilkaviškis d. mun.;2003;56;422;229;193
Vilkaviškis d. mun.;2003;57;558;262;296
Vilkaviškis d. mun.;2003;58;378;170;208
Vilkaviškis d. mun.;2003;59;534;236;298
Vilkaviškis d. mun.;2003;60;649;253;396
Vilkaviškis d. mun.;2003;61;578;257;321
Vilkaviškis d. mun.;2003;62;524;212;312
Vilkaviškis d. mun.;2003;63;466;197;269
Vilkaviškis d. mun.;2003;64;543;208;335
Vilkaviškis d. mun.;2003;65;513;219;294
Vilkaviškis d. mun.;2003;66;515;200;315
Vilkaviškis d. mun.;2003;67;517;208;309
Vilkaviškis d. mun.;2003;68;464;183;281
Vilkaviškis d. mun.;2003;69;549;232;317
Vilkaviškis d. mun.;2003;70;547;199;348
Vilkaviškis d. mun.;2003;71;468;183;285
Vilkaviškis d. mun.;2003;72;563;226;337
Vilkaviškis d. mun.;2003;73;507;171;336
Vilkaviškis d. mun.;2003;74;432;158;274
Vilkaviškis d. mun.;2003;75;403;127;276
Vilkaviškis d. mun.;2003;76;343;104;239
Vilkaviškis d. mun.;2003;77;312;101;211
Vilkaviškis d. mun.;2003;78;289;71;218
Vilkaviškis d. mun.;2003;79;263;75;188
Vilkaviškis d. mun.;2003;80;253;81;172
Vilkaviškis d. mun.;2003;81;189;67;122
Vilkaviškis d. mun.;2003;82;172;58;114
Vilkaviškis d. mun.;2003;83;155;49;106
Vilkaviškis d. mun.;2003;84;91;26;65
Vilkaviškis d. mun.;2003;85;559;161;398
Vilkaviškis d. mun.;2004;-1;49137;23403;25734
Vilkaviškis d. mun.;2004;0;478;241;237
Vilkaviškis d. mun.;2004;1;515;246;269
Vilkaviškis d. mun.;2004;2;532;285;247
Vilkaviškis d. mun.;2004;3;552;276;276
Vilkaviškis d. mun.;2004;4;609;304;305
Vilkaviškis d. mun.;2004;5;630;339;291
Vilkaviškis d. mun.;2004;6;644;316;328
Vilkaviškis d. mun.;2004;7;635;332;303
Vilkaviškis d. mun.;2004;8;656;337;319
Vilkaviškis d. mun.;2004;9;672;343;329
Vilkaviškis d. mun.;2004;10;747;372;375
Vilkaviškis d. mun.;2004;11;833;435;398
Vilkaviškis d. mun.;2004;12;812;410;402
Vilkaviškis d. mun.;2004;13;811;413;398
Vilkaviškis d. mun.;2004;14;775;398;377
Vilkaviškis d. mun.;2004;15;846;456;390
Vilkaviškis d. mun.;2004;16;856;443;413
Vilkaviškis d. mun.;2004;17;885;455;430
Vilkaviškis d. mun.;2004;18;830;400;430
Vilkaviškis d. mun.;2004;19;789;406;383
Vilkaviškis d. mun.;2004;20;723;371;352
Vilkaviškis d. mun.;2004;21;589;330;259
Vilkaviškis d. mun.;2004;22;542;303;239
Vilkaviškis d. mun.;2004;23;502;275;227
Vilkaviškis d. mun.;2004;24;549;300;249
Vilkaviškis d. mun.;2004;25;592;336;256
Vilkaviškis d. mun.;2004;26;531;268;263
Vilkaviškis d. mun.;2004;27;587;303;284
Vilkaviškis d. mun.;2004;28;502;246;256
Vilkaviškis d. mun.;2004;29;583;297;286
Vilkaviškis d. mun.;2004;30;588;287;301
Vilkaviškis d. mun.;2004;31;649;335;314
Vilkaviškis d. mun.;2004;32;701;357;344
Vilkaviškis d. mun.;2004;33;714;363;351
Vilkaviškis d. mun.;2004;34;646;344;302
Vilkaviškis d. mun.;2004;35;669;347;322
Vilkaviškis d. mun.;2004;36;617;313;304
Vilkaviškis d. mun.;2004;37;670;321;349
Vilkaviškis d. mun.;2004;38;629;312;317
Vilkaviškis d. mun.;2004;39;679;332;347
Vilkaviškis d. mun.;2004;40;651;323;328
Vilkaviškis d. mun.;2004;41;673;353;320
Vilkaviškis d. mun.;2004;42;770;393;377
Vilkaviškis d. mun.;2004;43;702;358;344
Vilkaviškis d. mun.;2004;44;674;364;310
Vilkaviškis d. mun.;2004;45;719;362;357
Vilkaviškis d. mun.;2004;46;684;355;329
Vilkaviškis d. mun.;2004;47;584;267;317
Vilkaviškis d. mun.;2004;48;597;293;304
Vilkaviškis d. mun.;2004;49;576;262;314
Vilkaviškis d. mun.;2004;50;527;266;261
Vilkaviškis d. mun.;2004;51;521;266;255
Vilkaviškis d. mun.;2004;52;624;301;323
Vilkaviškis d. mun.;2004;53;550;261;289
Vilkaviškis d. mun.;2004;54;623;310;313
Vilkaviškis d. mun.;2004;55;526;226;300
Vilkaviškis d. mun.;2004;56;481;242;239
Vilkaviškis d. mun.;2004;57;413;222;191
Vilkaviškis d. mun.;2004;58;552;257;295
Vilkaviškis d. mun.;2004;59;370;164;206
Vilkaviškis d. mun.;2004;60;516;226;290
Vilkaviškis d. mun.;2004;61;641;248;393
Vilkaviškis d. mun.;2004;62;569;251;318
Vilkaviškis d. mun.;2004;63;515;206;309
Vilkaviškis d. mun.;2004;64;461;192;269
Vilkaviškis d. mun.;2004;65;544;206;338
Vilkaviškis d. mun.;2004;66;504;210;294
Vilkaviškis d. mun.;2004;67;508;191;317
Vilkaviškis d. mun.;2004;68;508;194;314
Vilkaviškis d. mun.;2004;69;445;172;273
Vilkaviškis d. mun.;2004;70;544;224;320
Vilkaviškis d. mun.;2004;71;536;192;344
Vilkaviškis d. mun.;2004;72;450;176;274
Vilkaviškis d. mun.;2004;73;541;214;327
Vilkaviškis d. mun.;2004;74;487;159;328
Vilkaviškis d. mun.;2004;75;411;147;264
Vilkaviškis d. mun.;2004;76;381;113;268
Vilkaviškis d. mun.;2004;77;321;93;228
Vilkaviškis d. mun.;2004;78;295;93;202
Vilkaviškis d. mun.;2004;79;273;65;208
Vilkaviškis d. mun.;2004;80;244;67;177
Vilkaviškis d. mun.;2004;81;237;74;163
Vilkaviškis d. mun.;2004;82;179;62;117
Vilkaviškis d. mun.;2004;83;164;53;111
Vilkaviškis d. mun.;2004;84;133;41;92
Vilkaviškis d. mun.;2004;85;544;142;402
Vilkaviškis d. mun.;2005;-1;48338;22971;25367
Vilkaviškis d. mun.;2005;0;466;238;228
Vilkaviškis d. mun.;2005;1;473;239;234
Vilkaviškis d. mun.;2005;2;513;247;266
Vilkaviškis d. mun.;2005;3;529;285;244
Vilkaviškis d. mun.;2005;4;538;267;271
Vilkaviškis d. mun.;2005;5;601;302;299
Vilkaviškis d. mun.;2005;6;626;337;289
Vilkaviškis d. mun.;2005;7;643;315;328
Vilkaviškis d. mun.;2005;8;633;328;305
Vilkaviškis d. mun.;2005;9;650;335;315
Vilkaviškis d. mun.;2005;10;670;341;329
Vilkaviškis d. mun.;2005;11;741;370;371
Vilkaviškis d. mun.;2005;12;830;433;397
Vilkaviškis d. mun.;2005;13;810;408;402
Vilkaviškis d. mun.;2005;14;805;411;394
Vilkaviškis d. mun.;2005;15;766;394;372
Vilkaviškis d. mun.;2005;16;833;449;384
Vilkaviškis d. mun.;2005;17;839;433;406
Vilkaviškis d. mun.;2005;18;870;444;426
Vilkaviškis d. mun.;2005;19;813;391;422
Vilkaviškis d. mun.;2005;20;757;391;366
Vilkaviškis d. mun.;2005;21;704;364;340
Vilkaviškis d. mun.;2005;22;567;316;251
Vilkaviškis d. mun.;2005;23;518;293;225
Vilkaviškis d. mun.;2005;24;481;266;215
Vilkaviškis d. mun.;2005;25;515;277;238
Vilkaviškis d. mun.;2005;26;571;328;243
Vilkaviškis d. mun.;2005;27;496;253;243
Vilkaviškis d. mun.;2005;28;572;295;277
Vilkaviškis d. mun.;2005;29;478;236;242
Vilkaviškis d. mun.;2005;30;564;282;282
Vilkaviškis d. mun.;2005;31;575;276;299
Vilkaviškis d. mun.;2005;32;632;326;306
Vilkaviškis d. mun.;2005;33;683;350;333
Vilkaviškis d. mun.;2005;34;701;353;348
Vilkaviškis d. mun.;2005;35;630;334;296
Vilkaviškis d. mun.;2005;36;660;341;319
Vilkaviškis d. mun.;2005;37;598;303;295
Vilkaviškis d. mun.;2005;38;658;316;342
Vilkaviškis d. mun.;2005;39;620;310;310
Vilkaviškis d. mun.;2005;40;669;323;346
Vilkaviškis d. mun.;2005;41;639;316;323
Vilkaviškis d. mun.;2005;42;662;347;315
Vilkaviškis d. mun.;2005;43;762;385;377
Vilkaviškis d. mun.;2005;44;703;360;343
Vilkaviškis d. mun.;2005;45;666;358;308
Vilkaviškis d. mun.;2005;46;707;355;352
Vilkaviškis d. mun.;2005;47;681;350;331
Vilkaviškis d. mun.;2005;48;573;261;312
Vilkaviškis d. mun.;2005;49;590;288;302
Vilkaviškis d. mun.;2005;50;568;255;313
Vilkaviškis d. mun.;2005;51;519;261;258
Vilkaviškis d. mun.;2005;52;510;261;249
Vilkaviškis d. mun.;2005;53;617;300;317
Vilkaviškis d. mun.;2005;54;536;251;285
Vilkaviškis d. mun.;2005;55;609;299;310
Vilkaviškis d. mun.;2005;56;519;220;299
Vilkaviškis d. mun.;2005;57;471;236;235
Vilkaviškis d. mun.;2005;58;409;218;191
Vilkaviškis d. mun.;2005;59;541;252;289
Vilkaviškis d. mun.;2005;60;362;159;203
Vilkaviškis d. mun.;2005;61;503;218;285
Vilkaviškis d. mun.;2005;62;633;239;394
Vilkaviškis d. mun.;2005;63;561;243;318
Vilkaviškis d. mun.;2005;64;501;197;304
Vilkaviškis d. mun.;2005;65;452;188;264
Vilkaviškis d. mun.;2005;66;528;194;334
Vilkaviškis d. mun.;2005;67;486;198;288
Vilkaviškis d. mun.;2005;68;491;177;314
Vilkaviškis d. mun.;2005;69;484;179;305
Vilkaviškis d. mun.;2005;70;432;165;267
Vilkaviškis d. mun.;2005;71;526;212;314
Vilkaviškis d. mun.;2005;72;508;178;330
Vilkaviškis d. mun.;2005;73;432;163;269
Vilkaviškis d. mun.;2005;74;523;203;320
Vilkaviškis d. mun.;2005;75;460;146;314
Vilkaviškis d. mun.;2005;76;389;135;254
Vilkaviškis d. mun.;2005;77;361;106;255
Vilkaviškis d. mun.;2005;78;303;87;216
Vilkaviškis d. mun.;2005;79;272;87;185
Vilkaviškis d. mun.;2005;80;257;60;197
Vilkaviškis d. mun.;2005;81;218;58;160
Vilkaviškis d. mun.;2005;82;214;61;153
Vilkaviškis d. mun.;2005;83;168;58;110
Vilkaviškis d. mun.;2005;84;150;47;103
Vilkaviškis d. mun.;2005;85;544;140;404
Vilkaviškis d. mun.;2006;-1;47112;22320;24792
Vilkaviškis d. mun.;2006;0;459;224;235
Vilkaviškis d. mun.;2006;1;460;235;225
Vilkaviškis d. mun.;2006;2;464;233;231
Vilkaviškis d. mun.;2006;3;505;244;261
Vilkaviškis d. mun.;2006;4;517;280;237
Vilkaviškis d. mun.;2006;5;533;264;269
Vilkaviškis d. mun.;2006;6;594;301;293
Vilkaviškis d. mun.;2006;7;618;334;284
Vilkaviškis d. mun.;2006;8;638;315;323
Vilkaviškis d. mun.;2006;9;628;327;301
Vilkaviškis d. mun.;2006;10;642;332;310
Vilkaviškis d. mun.;2006;11;669;339;330
Vilkaviškis d. mun.;2006;12;733;364;369
Vilkaviškis d. mun.;2006;13;813;426;387
Vilkaviškis d. mun.;2006;14;797;402;395
Vilkaviškis d. mun.;2006;15;783;399;384
Vilkaviškis d. mun.;2006;16;743;382;361
Vilkaviškis d. mun.;2006;17;811;435;376
Vilkaviškis d. mun.;2006;18;804;416;388
Vilkaviškis d. mun.;2006;19;823;420;403
Vilkaviškis d. mun.;2006;20;765;368;397
Vilkaviškis d. mun.;2006;21;707;365;342
Vilkaviškis d. mun.;2006;22;657;343;314
Vilkaviškis d. mun.;2006;23;535;302;233
Vilkaviškis d. mun.;2006;24;489;272;217
Vilkaviškis d. mun.;2006;25;445;248;197
Vilkaviškis d. mun.;2006;26;478;256;222
Vilkaviškis d. mun.;2006;27;545;313;232
Vilkaviškis d. mun.;2006;28;477;241;236
Vilkaviškis d. mun.;2006;29;551;283;268
Vilkaviškis d. mun.;2006;30;454;217;237
Vilkaviškis d. mun.;2006;31;550;273;277
Vilkaviškis d. mun.;2006;32;554;262;292
Vilkaviškis d. mun.;2006;33;604;312;292
Vilkaviškis d. mun.;2006;34;663;336;327
Vilkaviškis d. mun.;2006;35;674;335;339
Vilkaviškis d. mun.;2006;36;613;324;289
Vilkaviškis d. mun.;2006;37;644;332;312
Vilkaviškis d. mun.;2006;38;578;288;290
Vilkaviškis d. mun.;2006;39;637;303;334
Vilkaviškis d. mun.;2006;40;605;303;302
Vilkaviškis d. mun.;2006;41;652;311;341
Vilkaviškis d. mun.;2006;42;622;304;318
Vilkaviškis d. mun.;2006;43;640;332;308
Vilkaviškis d. mun.;2006;44;746;373;373
Vilkaviškis d. mun.;2006;45;689;352;337
Vilkaviškis d. mun.;2006;46;655;351;304
Vilkaviškis d. mun.;2006;47;699;350;349
Vilkaviškis d. mun.;2006;48;673;346;327
Vilkaviškis d. mun.;2006;49;561;253;308
Vilkaviškis d. mun.;2006;50;572;277;295
Vilkaviškis d. mun.;2006;51;561;251;310
Vilkaviškis d. mun.;2006;52;504;252;252
Vilkaviškis d. mun.;2006;53;503;255;248
Vilkaviškis d. mun.;2006;54;606;292;314
Vilkaviškis d. mun.;2006;55;521;244;277
Vilkaviškis d. mun.;2006;56;594;289;305
Vilkaviškis d. mun.;2006;57;510;215;295
Vilkaviškis d. mun.;2006;58;455;227;228
Vilkaviškis d. mun.;2006;59;392;209;183
Vilkaviškis d. mun.;2006;60;524;245;279
Vilkaviškis d. mun.;2006;61;353;153;200
Vilkaviškis d. mun.;2006;62;486;211;275
Vilkaviškis d. mun.;2006;63;611;227;384
Vilkaviškis d. mun.;2006;64;543;229;314
Vilkaviškis d. mun.;2006;65;484;185;299
Vilkaviškis d. mun.;2006;66;433;178;255
Vilkaviškis d. mun.;2006;67;511;184;327
Vilkaviškis d. mun.;2006;68;466;184;282
Vilkaviškis d. mun.;2006;69;477;170;307
Vilkaviškis d. mun.;2006;70;472;172;300
Vilkaviškis d. mun.;2006;71;412;153;259
Vilkaviškis d. mun.;2006;72;502;195;307
Vilkaviškis d. mun.;2006;73;498;172;326
Vilkaviškis d. mun.;2006;74;413;157;256
Vilkaviškis d. mun.;2006;75;504;193;311
Vilkaviškis d. mun.;2006;76;437;136;301
Vilkaviškis d. mun.;2006;77;372;126;246
Vilkaviškis d. mun.;2006;78;334;94;240
Vilkaviškis d. mun.;2006;79;283;80;203
Vilkaviškis d. mun.;2006;80;245;77;168
Vilkaviškis d. mun.;2006;81;241;58;183
Vilkaviškis d. mun.;2006;82;196;52;144
Vilkaviškis d. mun.;2006;83;195;54;141
Vilkaviškis d. mun.;2006;84;146;51;95
Vilkaviškis d. mun.;2006;85;560;153;407
Vilkaviškis d. mun.;2007;-1;46239;21892;24347
Vilkaviškis d. mun.;2007;0;463;232;231
Vilkaviškis d. mun.;2007;1;453;219;234
Vilkaviškis d. mun.;2007;2;450;230;220
Vilkaviškis d. mun.;2007;3;463;232;231
Vilkaviškis d. mun.;2007;4;503;244;259
Vilkaviškis d. mun.;2007;5;515;277;238
Vilkaviškis d. mun.;2007;6;535;266;269
Vilkaviškis d. mun.;2007;7;592;301;291
Vilkaviškis d. mun.;2007;8;612;332;280
Vilkaviškis d. mun.;2007;9;627;310;317
Vilkaviškis d. mun.;2007;10;625;325;300
Vilkaviškis d. mun.;2007;11;637;331;306
Vilkaviškis d. mun.;2007;12;662;337;325
Vilkaviškis d. mun.;2007;13;726;360;366
Vilkaviškis d. mun.;2007;14;805;421;384
Vilkaviškis d. mun.;2007;15;791;400;391
Vilkaviškis d. mun.;2007;16;770;392;378
Vilkaviškis d. mun.;2007;17;728;376;352
Vilkaviškis d. mun.;2007;18;792;425;367
Vilkaviškis d. mun.;2007;19;784;406;378
Vilkaviškis d. mun.;2007;20;798;407;391
Vilkaviškis d. mun.;2007;21;733;352;381
Vilkaviškis d. mun.;2007;22;680;351;329
Vilkaviškis d. mun.;2007;23;631;332;299
Vilkaviškis d. mun.;2007;24;514;289;225
Vilkaviškis d. mun.;2007;25;465;259;206
Vilkaviškis d. mun.;2007;26;423;233;190
Vilkaviškis d. mun.;2007;27;461;247;214
Vilkaviškis d. mun.;2007;28;520;299;221
Vilkaviškis d. mun.;2007;29;457;233;224
Vilkaviškis d. mun.;2007;30;532;271;261
Vilkaviškis d. mun.;2007;31;443;211;232
Vilkaviškis d. mun.;2007;32;535;267;268
Vilkaviškis d. mun.;2007;33;544;255;289
Vilkaviškis d. mun.;2007;34;595;306;289
Vilkaviškis d. mun.;2007;35;643;326;317
Vilkaviškis d. mun.;2007;36;661;327;334
Vilkaviškis d. mun.;2007;37;595;314;281
Vilkaviškis d. mun.;2007;38;631;322;309
Vilkaviškis d. mun.;2007;39;569;284;285
Vilkaviškis d. mun.;2007;40;625;294;331
Vilkaviškis d. mun.;2007;41;592;293;299
Vilkaviškis d. mun.;2007;42;648;311;337
Vilkaviškis d. mun.;2007;43;609;297;312
Vilkaviškis d. mun.;2007;44;628;328;300
Vilkaviškis d. mun.;2007;45;736;367;369
Vilkaviškis d. mun.;2007;46;678;346;332
Vilkaviškis d. mun.;2007;47;641;339;302
Vilkaviškis d. mun.;2007;48;691;344;347
Vilkaviškis d. mun.;2007;49;664;343;321
Vilkaviškis d. mun.;2007;50;545;242;303
Vilkaviškis d. mun.;2007;51;554;268;286
Vilkaviškis d. mun.;2007;52;549;242;307
Vilkaviškis d. mun.;2007;53;492;244;248
Vilkaviškis d. mun.;2007;54;491;249;242
Vilkaviškis d. mun.;2007;55;593;284;309
Vilkaviškis d. mun.;2007;56;513;236;277
Vilkaviškis d. mun.;2007;57;580;280;300
Vilkaviškis d. mun.;2007;58;502;210;292
Vilkaviškis d. mun.;2007;59;447;219;228
Vilkaviškis d. mun.;2007;60;386;204;182
Vilkaviškis d. mun.;2007;61;513;238;275
Vilkaviškis d. mun.;2007;62;340;145;195
Vilkaviškis d. mun.;2007;63;480;205;275
Vilkaviškis d. mun.;2007;64;595;217;378
Vilkaviškis d. mun.;2007;65;521;215;306
Vilkaviškis d. mun.;2007;66;471;179;292
Vilkaviškis d. mun.;2007;67;428;174;254
Vilkaviškis d. mun.;2007;68;489;172;317
Vilkaviškis d. mun.;2007;69;447;176;271
Vilkaviškis d. mun.;2007;70;460;162;298
Vilkaviškis d. mun.;2007;71;466;168;298
Vilkaviškis d. mun.;2007;72;400;148;252
Vilkaviškis d. mun.;2007;73;482;183;299
Vilkaviškis d. mun.;2007;74;473;163;310
Vilkaviškis d. mun.;2007;75;392;148;244
Vilkaviškis d. mun.;2007;76;479;183;296
Vilkaviškis d. mun.;2007;77;414;126;288
Vilkaviškis d. mun.;2007;78;344;115;229
Vilkaviškis d. mun.;2007;79;307;86;221
Vilkaviškis d. mun.;2007;80;259;72;187
Vilkaviškis d. mun.;2007;81;227;71;156
Vilkaviškis d. mun.;2007;82;213;51;162
Vilkaviškis d. mun.;2007;83;179;45;134
Vilkaviškis d. mun.;2007;84;169;52;117
Vilkaviškis d. mun.;2007;85;564;157;407
Vilkaviškis d. mun.;2008;-1;45488;21511;23977
Vilkaviškis d. mun.;2008;0;419;215;204
Vilkaviškis d. mun.;2008;1;459;232;227
Vilkaviškis d. mun.;2008;2;453;221;232
Vilkaviškis d. mun.;2008;3;444;228;216
Vilkaviškis d. mun.;2008;4;453;227;226
Vilkaviškis d. mun.;2008;5;495;239;256
Vilkaviškis d. mun.;2008;6;509;273;236
Vilkaviškis d. mun.;2008;7;522;258;264
Vilkaviškis d. mun.;2008;8;582;295;287
Vilkaviškis d. mun.;2008;9;610;332;278
Vilkaviškis d. mun.;2008;10;621;305;316
Vilkaviškis d. mun.;2008;11;620;323;297
Vilkaviškis d. mun.;2008;12;633;327;306
Vilkaviškis d. mun.;2008;13;657;335;322
Vilkaviškis d. mun.;2008;14;725;358;367
Vilkaviškis d. mun.;2008;15;798;416;382
Vilkaviškis d. mun.;2008;16;785;400;385
Vilkaviškis d. mun.;2008;17;766;390;376
Vilkaviškis d. mun.;2008;18;716;371;345
Vilkaviškis d. mun.;2008;19;783;422;361
Vilkaviškis d. mun.;2008;20;770;400;370
Vilkaviškis d. mun.;2008;21;784;400;384
Vilkaviškis d. mun.;2008;22;713;344;369
Vilkaviškis d. mun.;2008;23;668;347;321
Vilkaviškis d. mun.;2008;24;616;328;288
Vilkaviškis d. mun.;2008;25;491;273;218
Vilkaviškis d. mun.;2008;26;438;243;195
Vilkaviškis d. mun.;2008;27;404;224;180
Vilkaviškis d. mun.;2008;28;441;240;201
Vilkaviškis d. mun.;2008;29;503;290;213
Vilkaviškis d. mun.;2008;30;450;226;224
Vilkaviškis d. mun.;2008;31;514;262;252
Vilkaviškis d. mun.;2008;32;437;209;228
Vilkaviškis d. mun.;2008;33;528;264;264
Vilkaviškis d. mun.;2008;34;534;248;286
Vilkaviškis d. mun.;2008;35;587;300;287
Vilkaviškis d. mun.;2008;36;633;320;313
Vilkaviškis d. mun.;2008;37;649;316;333
Vilkaviškis d. mun.;2008;38;583;307;276
Vilkaviškis d. mun.;2008;39;618;316;302
Vilkaviškis d. mun.;2008;40;562;281;281
Vilkaviškis d. mun.;2008;41;621;291;330
Vilkaviškis d. mun.;2008;42;583;290;293
Vilkaviškis d. mun.;2008;43;637;307;330
Vilkaviškis d. mun.;2008;44;593;284;309
Vilkaviškis d. mun.;2008;45;624;323;301
Vilkaviškis d. mun.;2008;46;720;357;363
Vilkaviškis d. mun.;2008;47;672;342;330
Vilkaviškis d. mun.;2008;48;635;334;301
Vilkaviškis d. mun.;2008;49;684;339;345
Vilkaviškis d. mun.;2008;50;652;336;316
Vilkaviškis d. mun.;2008;51;534;237;297
Vilkaviškis d. mun.;2008;52;549;265;284
Vilkaviškis d. mun.;2008;53;538;237;301
Vilkaviškis d. mun.;2008;54;486;237;249
Vilkaviškis d. mun.;2008;55;489;248;241
Vilkaviškis d. mun.;2008;56;583;282;301
Vilkaviškis d. mun.;2008;57;503;230;273
Vilkaviškis d. mun.;2008;58;557;267;290
Vilkaviškis d. mun.;2008;59;494;204;290
Vilkaviškis d. mun.;2008;60;431;209;222
Vilkaviškis d. mun.;2008;61;376;197;179
Vilkaviškis d. mun.;2008;62;499;227;272
Vilkaviškis d. mun.;2008;63;334;141;193
Vilkaviškis d. mun.;2008;64;467;194;273
Vilkaviškis d. mun.;2008;65;583;208;375
Vilkaviškis d. mun.;2008;66;511;208;303
Vilkaviškis d. mun.;2008;67;456;170;286
Vilkaviškis d. mun.;2008;68;417;168;249
Vilkaviškis d. mun.;2008;69;475;161;314
Vilkaviškis d. mun.;2008;70;433;168;265
Vilkaviškis d. mun.;2008;71;447;156;291
Vilkaviškis d. mun.;2008;72;442;158;284
Vilkaviškis d. mun.;2008;73;378;134;244
Vilkaviškis d. mun.;2008;74;458;170;288
Vilkaviškis d. mun.;2008;75;462;156;306
Vilkaviškis d. mun.;2008;76;372;137;235
Vilkaviškis d. mun.;2008;77;454;170;284
Vilkaviškis d. mun.;2008;78;379;111;268
Vilkaviškis d. mun.;2008;79;318;106;212
Vilkaviškis d. mun.;2008;80;287;80;207
Vilkaviškis d. mun.;2008;81;241;65;176
Vilkaviškis d. mun.;2008;82;201;61;140
Vilkaviškis d. mun.;2008;83;190;43;147
Vilkaviškis d. mun.;2008;84;154;38;116
Vilkaviškis d. mun.;2008;85;596;160;436
Vilkaviškis d. mun.;2009;-1;44899;21243;23656
Vilkaviškis d. mun.;2009;0;429;206;223
Vilkaviškis d. mun.;2009;1;415;212;203
Vilkaviškis d. mun.;2009;2;452;229;223
Vilkaviškis d. mun.;2009;3;443;218;225
Vilkaviškis d. mun.;2009;4;445;230;215
Vilkaviškis d. mun.;2009;5;451;229;222
Vilkaviškis d. mun.;2009;6;488;235;253
Vilkaviškis d. mun.;2009;7;506;272;234
Vilkaviškis d. mun.;2009;8;518;257;261
Vilkaviškis d. mun.;2009;9;579;297;282
Vilkaviškis d. mun.;2009;10;608;331;277
Vilkaviškis d. mun.;2009;11;619;306;313
Vilkaviškis d. mun.;2009;12;617;320;297
Vilkaviškis d. mun.;2009;13;629;325;304
Vilkaviškis d. mun.;2009;14;653;334;319
Vilkaviškis d. mun.;2009;15;717;351;366
Vilkaviškis d. mun.;2009;16;794;414;380
Vilkaviškis d. mun.;2009;17;779;397;382
Vilkaviškis d. mun.;2009;18;760;389;371
Vilkaviškis d. mun.;2009;19;710;369;341
Vilkaviškis d. mun.;2009;20;769;417;352
Vilkaviškis d. mun.;2009;21;745;389;356
Vilkaviškis d. mun.;2009;22;764;391;373
Vilkaviškis d. mun.;2009;23;698;340;358
Vilkaviškis d. mun.;2009;24;639;338;301
Vilkaviškis d. mun.;2009;25;609;323;286
Vilkaviškis d. mun.;2009;26;473;270;203
Vilkaviškis d. mun.;2009;27;429;243;186
Vilkaviškis d. mun.;2009;28;376;214;162
Vilkaviškis d. mun.;2009;29;428;232;196
Vilkaviškis d. mun.;2009;30;501;288;213
Vilkaviškis d. mun.;2009;31;434;215;219
Vilkaviškis d. mun.;2009;32;500;251;249
Vilkaviškis d. mun.;2009;33;430;204;226
Vilkaviškis d. mun.;2009;34;523;264;259
Vilkaviškis d. mun.;2009;35;519;241;278
Vilkaviškis d. mun.;2009;36;581;295;286
Vilkaviškis d. mun.;2009;37;634;323;311
Vilkaviškis d. mun.;2009;38;636;307;329
Vilkaviškis d. mun.;2009;39;580;307;273
Vilkaviškis d. mun.;2009;40;609;308;301
Vilkaviškis d. mun.;2009;41;556;276;280
Vilkaviškis d. mun.;2009;42;615;287;328
Vilkaviškis d. mun.;2009;43;582;288;294
Vilkaviškis d. mun.;2009;44;634;306;328
Vilkaviškis d. mun.;2009;45;586;281;305
Vilkaviškis d. mun.;2009;46;620;321;299
Vilkaviškis d. mun.;2009;47;710;353;357
Vilkaviškis d. mun.;2009;48;661;334;327
Vilkaviškis d. mun.;2009;49;629;332;297
Vilkaviškis d. mun.;2009;50;679;336;343
Vilkaviškis d. mun.;2009;51;648;333;315
Vilkaviškis d. mun.;2009;52;526;230;296
Vilkaviškis d. mun.;2009;53;542;259;283
Vilkaviškis d. mun.;2009;54;526;229;297
Vilkaviškis d. mun.;2009;55;474;231;243
Vilkaviškis d. mun.;2009;56;479;239;240
Vilkaviškis d. mun.;2009;57;564;269;295
Vilkaviškis d. mun.;2009;58;494;224;270
Vilkaviškis d. mun.;2009;59;550;262;288
Vilkaviškis d. mun.;2009;60;479;197;282
Vilkaviškis d. mun.;2009;61;428;209;219
Vilkaviškis d. mun.;2009;62;367;191;176
Vilkaviškis d. mun.;2009;63;490;221;269
Vilkaviškis d. mun.;2009;64;329;137;192
Vilkaviškis d. mun.;2009;65;454;185;269
Vilkaviškis d. mun.;2009;66;570;202;368
Vilkaviškis d. mun.;2009;67;495;199;296
Vilkaviškis d. mun.;2009;68;446;164;282
Vilkaviškis d. mun.;2009;69;402;159;243
Vilkaviškis d. mun.;2009;70;462;155;307
Vilkaviškis d. mun.;2009;71;420;157;263
Vilkaviškis d. mun.;2009;72;433;146;287
Vilkaviškis d. mun.;2009;73;429;151;278
Vilkaviškis d. mun.;2009;74;365;127;238
Vilkaviškis d. mun.;2009;75;434;155;279
Vilkaviškis d. mun.;2009;76;444;149;295
Vilkaviškis d. mun.;2009;77;351;126;225
Vilkaviškis d. mun.;2009;78;426;157;269
Vilkaviškis d. mun.;2009;79;353;99;254
Vilkaviškis d. mun.;2009;80;294;99;195
Vilkaviškis d. mun.;2009;81;268;74;194
Vilkaviškis d. mun.;2009;82;223;61;162
Vilkaviškis d. mun.;2009;83;177;53;124
Vilkaviškis d. mun.;2009;84;173;40;133
Vilkaviškis d. mun.;2009;85;623;159;464
Vilkaviškis d. mun.;2010;-1;44128;20901;23227
Vilkaviškis d. mun.;2010;0;462;225;237
Vilkaviškis d. mun.;2010;1;417;200;217
Vilkaviškis d. mun.;2010;2;403;205;198
Vilkaviškis d. mun.;2010;3;440;227;213
Vilkaviškis d. mun.;2010;4;433;213;220
Vilkaviškis d. mun.;2010;5;442;230;212
Vilkaviškis d. mun.;2010;6;445;228;217
Vilkaviškis d. mun.;2010;7;483;229;254
Vilkaviškis d. mun.;2010;8;503;273;230
Vilkaviškis d. mun.;2010;9;511;255;256
Vilkaviškis d. mun.;2010;10;578;298;280
Vilkaviškis d. mun.;2010;11;600;324;276
Vilkaviškis d. mun.;2010;12;615;307;308
Vilkaviškis d. mun.;2010;13;612;319;293
Vilkaviškis d. mun.;2010;14;625;325;300
Vilkaviškis d. mun.;2010;15;649;330;319
Vilkaviškis d. mun.;2010;16;713;351;362
Vilkaviškis d. mun.;2010;17;796;414;382
Vilkaviškis d. mun.;2010;18;774;396;378
Vilkaviškis d. mun.;2010;19;747;384;363
Vilkaviškis d. mun.;2010;20;695;364;331
Vilkaviškis d. mun.;2010;21;751;408;343
Vilkaviškis d. mun.;2010;22;724;381;343
Vilkaviškis d. mun.;2010;23;727;378;349
Vilkaviškis d. mun.;2010;24;667;325;342
Vilkaviškis d. mun.;2010;25;619;332;287
Vilkaviškis d. mun.;2010;26;582;312;270
Vilkaviškis d. mun.;2010;27;443;256;187
Vilkaviškis d. mun.;2010;28;398;222;176
Vilkaviškis d. mun.;2010;29;364;209;155
Vilkaviškis d. mun.;2010;30;398;216;182
Vilkaviškis d. mun.;2010;31;478;278;200
Vilkaviškis d. mun.;2010;32;419;207;212
Vilkaviškis d. mun.;2010;33;485;239;246
Vilkaviškis d. mun.;2010;34;410;197;213
Vilkaviškis d. mun.;2010;35;511;256;255
Vilkaviškis d. mun.;2010;36;512;236;276
Vilkaviškis d. mun.;2010;37;570;291;279
Vilkaviškis d. mun.;2010;38;616;313;303
Vilkaviškis d. mun.;2010;39;628;304;324
Vilkaviškis d. mun.;2010;40;567;299;268
Vilkaviškis d. mun.;2010;41;597;301;296
Vilkaviškis d. mun.;2010;42;549;273;276
Vilkaviškis d. mun.;2010;43;612;285;327
Vilkaviškis d. mun.;2010;44;574;283;291
Vilkaviškis d. mun.;2010;45;624;301;323
Vilkaviškis d. mun.;2010;46;573;275;298
Vilkaviškis d. mun.;2010;47;613;318;295
Vilkaviškis d. mun.;2010;48;708;356;352
Vilkaviškis d. mun.;2010;49;657;333;324
Vilkaviškis d. mun.;2010;50;619;328;291
Vilkaviškis d. mun.;2010;51;668;330;338
Vilkaviškis d. mun.;2010;52;632;321;311
Vilkaviškis d. mun.;2010;53;517;224;293
Vilkaviškis d. mun.;2010;54;538;255;283
Vilkaviškis d. mun.;2010;55;519;224;295
Vilkaviškis d. mun.;2010;56;466;227;239
Vilkaviškis d. mun.;2010;57;464;229;235
Vilkaviškis d. mun.;2010;58;555;262;293
Vilkaviškis d. mun.;2010;59;491;220;271
Vilkaviškis d. mun.;2010;60;540;256;284
Vilkaviškis d. mun.;2010;61;468;190;278
Vilkaviškis d. mun.;2010;62;416;198;218
Vilkaviškis d. mun.;2010;63;355;182;173
Vilkaviškis d. mun.;2010;64;483;218;265
Vilkaviškis d. mun.;2010;65;326;133;193
Vilkaviškis d. mun.;2010;66;443;177;266
Vilkaviškis d. mun.;2010;67;563;196;367
Vilkaviškis d. mun.;2010;68;486;196;290
Vilkaviškis d. mun.;2010;69;439;160;279
Vilkaviškis d. mun.;2010;70;396;157;239
Vilkaviškis d. mun.;2010;71;444;146;298
Vilkaviškis d. mun.;2010;72;394;145;249
Vilkaviškis d. mun.;2010;73;409;133;276
Vilkaviškis d. mun.;2010;74;408;141;267
Vilkaviškis d. mun.;2010;75;351;121;230
Vilkaviškis d. mun.;2010;76;416;150;266
Vilkaviškis d. mun.;2010;77;423;135;288
Vilkaviškis d. mun.;2010;78;325;113;212
Vilkaviškis d. mun.;2010;79;386;144;242
Vilkaviškis d. mun.;2010;80;332;93;239
Vilkaviškis d. mun.;2010;81;272;92;180
Vilkaviškis d. mun.;2010;82;247;69;178
Vilkaviškis d. mun.;2010;83;203;53;150
Vilkaviškis d. mun.;2010;84;155;42;113
Vilkaviškis d. mun.;2010;85;660;160;500
Vilkaviškis d. mun.;2011;-1;42710;20222;22488
Vilkaviškis d. mun.;2011;0;346;175;171
Vilkaviškis d. mun.;2011;1;424;204;220
Vilkaviškis d. mun.;2011;2;374;188;186
Vilkaviškis d. mun.;2011;3;356;188;168
Vilkaviškis d. mun.;2011;4;389;189;200
Vilkaviškis d. mun.;2011;5;402;202;200
Vilkaviškis d. mun.;2011;6;400;210;190
Vilkaviškis d. mun.;2011;7;396;201;195
Vilkaviškis d. mun.;2011;8;462;221;241
Vilkaviškis d. mun.;2011;9;480;262;218
Vilkaviškis d. mun.;2011;10;495;244;251
Vilkaviškis d. mun.;2011;11;565;291;274
Vilkaviškis d. mun.;2011;12;593;321;272
Vilkaviškis d. mun.;2011;13;595;294;301
Vilkaviškis d. mun.;2011;14;602;312;290
Vilkaviškis d. mun.;2011;15;599;314;285
Vilkaviškis d. mun.;2011;16;652;322;330
Vilkaviškis d. mun.;2011;17;681;342;339
Vilkaviškis d. mun.;2011;18;770;396;374
Vilkaviškis d. mun.;2011;19;636;331;305
Vilkaviškis d. mun.;2011;20;616;331;285
Vilkaviškis d. mun.;2011;21;576;317;259
Vilkaviškis d. mun.;2011;22;578;327;251
Vilkaviškis d. mun.;2011;23;536;296;240
Vilkaviškis d. mun.;2011;24;524;289;235
Vilkaviškis d. mun.;2011;25;482;241;241
Vilkaviškis d. mun.;2011;26;435;261;174
Vilkaviškis d. mun.;2011;27;396;225;171
Vilkaviškis d. mun.;2011;28;403;234;169
Vilkaviškis d. mun.;2011;29;437;229;208
Vilkaviškis d. mun.;2011;30;420;214;206
Vilkaviškis d. mun.;2011;31;427;206;221
Vilkaviškis d. mun.;2011;32;484;264;220
Vilkaviškis d. mun.;2011;33;432;216;216
Vilkaviškis d. mun.;2011;34;519;268;251
Vilkaviškis d. mun.;2011;35;470;231;239
Vilkaviškis d. mun.;2011;36;516;251;265
Vilkaviškis d. mun.;2011;37;548;258;290
Vilkaviškis d. mun.;2011;38;610;309;301
Vilkaviškis d. mun.;2011;39;673;355;318
Vilkaviškis d. mun.;2011;40;639;312;327
Vilkaviškis d. mun.;2011;41;595;319;276
Vilkaviškis d. mun.;2011;42;608;311;297
Vilkaviškis d. mun.;2011;43;579;296;283
Vilkaviškis d. mun.;2011;44;622;304;318
Vilkaviškis d. mun.;2011;45;589;296;293
Vilkaviškis d. mun.;2011;46;653;322;331
Vilkaviškis d. mun.;2011;47;588;289;299
Vilkaviškis d. mun.;2011;48;646;334;312
Vilkaviškis d. mun.;2011;49;719;355;364
Vilkaviškis d. mun.;2011;50;643;329;314
Vilkaviškis d. mun.;2011;51;624;326;298
Vilkaviškis d. mun.;2011;52;650;312;338
Vilkaviškis d. mun.;2011;53;618;317;301
Vilkaviškis d. mun.;2011;54;537;234;303
Vilkaviškis d. mun.;2011;55;564;253;311
Vilkaviškis d. mun.;2011;56;523;225;298
Vilkaviškis d. mun.;2011;57;503;249;254
Vilkaviškis d. mun.;2011;58;484;236;248
Vilkaviškis d. mun.;2011;59;572;262;310
Vilkaviškis d. mun.;2011;60;496;223;273
Vilkaviškis d. mun.;2011;61;519;238;281
Vilkaviškis d. mun.;2011;62;471;183;288
Vilkaviškis d. mun.;2011;63;417;196;221
Vilkaviškis d. mun.;2011;64;367;180;187
Vilkaviškis d. mun.;2011;65;489;215;274
Vilkaviškis d. mun.;2011;66;329;134;195
Vilkaviškis d. mun.;2011;67;431;162;269
Vilkaviškis d. mun.;2011;68;565;191;374
Vilkaviškis d. mun.;2011;69;483;192;291
Vilkaviškis d. mun.;2011;70;442;156;286
Vilkaviškis d. mun.;2011;71;375;138;237
Vilkaviškis d. mun.;2011;72;440;138;302
Vilkaviškis d. mun.;2011;73;373;139;234
Vilkaviškis d. mun.;2011;74;394;125;269
Vilkaviškis d. mun.;2011;75;402;140;262
Vilkaviškis d. mun.;2011;76;352;120;232
Vilkaviškis d. mun.;2011;77;399;144;255
Vilkaviškis d. mun.;2011;78;400;128;272
Vilkaviškis d. mun.;2011;79;310;103;207
Vilkaviškis d. mun.;2011;80;356;132;224
Vilkaviškis d. mun.;2011;81;300;84;216
Vilkaviškis d. mun.;2011;82;250;78;172
Vilkaviškis d. mun.;2011;83;224;63;161
Vilkaviškis d. mun.;2011;84;181;43;138
Vilkaviškis d. mun.;2011;85;690;167;523
Vilkaviškis d. mun.;2012;-1;41833;19836;21997
Vilkaviškis d. mun.;2012;0;416;219;197
Vilkaviškis d. mun.;2012;1;332;172;160
Vilkaviškis d. mun.;2012;2;422;200;222
Vilkaviškis d. mun.;2012;3;359;182;177
Vilkaviškis d. mun.;2012;4;351;184;167
Vilkaviškis d. mun.;2012;5;389;192;197
Vilkaviškis d. mun.;2012;6;393;200;193
Vilkaviškis d. mun.;2012;7;397;209;188
Vilkaviškis d. mun.;2012;8;389;197;192
Vilkaviškis d. mun.;2012;9;449;214;235
Vilkaviškis d. mun.;2012;10;479;261;218
Vilkaviškis d. mun.;2012;11;489;240;249
Vilkaviškis d. mun.;2012;12;560;289;271
Vilkaviškis d. mun.;2012;13;594;323;271
Vilkaviškis d. mun.;2012;14;592;293;299
Vilkaviškis d. mun.;2012;15;602;314;288
Vilkaviškis d. mun.;2012;16;596;311;285
Vilkaviškis d. mun.;2012;17;651;322;329
Vilkaviškis d. mun.;2012;18;674;341;333
Vilkaviškis d. mun.;2012;19;735;381;354
Vilkaviškis d. mun.;2012;20;619;326;293
Vilkaviškis d. mun.;2012;21;586;316;270
Vilkaviškis d. mun.;2012;22;549;307;242
Vilkaviškis d. mun.;2012;23;527;304;223
Vilkaviškis d. mun.;2012;24;508;287;221
Vilkaviškis d. mun.;2012;25;485;270;215
Vilkaviškis d. mun.;2012;26;441;226;215
Vilkaviškis d. mun.;2012;27;389;238;151
Vilkaviškis d. mun.;2012;28;385;223;162
Vilkaviškis d. mun.;2012;29;378;221;157
Vilkaviškis d. mun.;2012;30;419;214;205
Vilkaviškis d. mun.;2012;31;391;200;191
Vilkaviškis d. mun.;2012;32;412;196;216
Vilkaviškis d. mun.;2012;33;462;253;209
Vilkaviškis d. mun.;2012;34;427;216;211
Vilkaviškis d. mun.;2012;35;503;257;246
Vilkaviškis d. mun.;2012;36;453;225;228
Vilkaviškis d. mun.;2012;37;504;247;257
Vilkaviškis d. mun.;2012;38;538;252;286
Vilkaviškis d. mun.;2012;39;596;297;299
Vilkaviškis d. mun.;2012;40;668;355;313
Vilkaviškis d. mun.;2012;41;630;312;318
Vilkaviškis d. mun.;2012;42;586;310;276
Vilkaviškis d. mun.;2012;43;602;308;294
Vilkaviškis d. mun.;2012;44;567;291;276
Vilkaviškis d. mun.;2012;45;614;304;310
Vilkaviškis d. mun.;2012;46;584;294;290
Vilkaviškis d. mun.;2012;47;646;317;329
Vilkaviškis d. mun.;2012;48;579;284;295
Vilkaviškis d. mun.;2012;49;640;330;310
Vilkaviškis d. mun.;2012;50;708;349;359
Vilkaviškis d. mun.;2012;51;633;321;312
Vilkaviškis d. mun.;2012;52;616;318;298
Vilkaviškis d. mun.;2012;53;645;310;335
Vilkaviškis d. mun.;2012;54;603;310;293
Vilkaviškis d. mun.;2012;55;528;228;300
Vilkaviškis d. mun.;2012;56;551;243;308
Vilkaviškis d. mun.;2012;57;508;216;292
Vilkaviškis d. mun.;2012;58;496;241;255
Vilkaviškis d. mun.;2012;59;477;229;248
Vilkaviškis d. mun.;2012;60;561;252;309
Vilkaviškis d. mun.;2012;61;487;217;270
Vilkaviškis d. mun.;2012;62;504;228;276
Vilkaviškis d. mun.;2012;63;465;179;286
Vilkaviškis d. mun.;2012;64;407;188;219
Vilkaviškis d. mun.;2012;65;356;172;184
Vilkaviškis d. mun.;2012;66;475;205;270
Vilkaviškis d. mun.;2012;67;320;131;189
Vilkaviškis d. mun.;2012;68;424;158;266
Vilkaviškis d. mun.;2012;69;554;185;369
Vilkaviškis d. mun.;2012;70;465;180;285
Vilkaviškis d. mun.;2012;71;434;154;280
Vilkaviškis d. mun.;2012;72;362;132;230
Vilkaviškis d. mun.;2012;73;423;130;293
Vilkaviškis d. mun.;2012;74;361;134;227
Vilkaviškis d. mun.;2012;75;378;116;262
Vilkaviškis d. mun.;2012;76;384;130;254
Vilkaviškis d. mun.;2012;77;344;117;227
Vilkaviškis d. mun.;2012;78;372;133;239
Vilkaviškis d. mun.;2012;79;377;119;258
Vilkaviškis d. mun.;2012;80;288;91;197
Vilkaviškis d. mun.;2012;81;324;117;207
Vilkaviškis d. mun.;2012;82;277;77;200
Vilkaviškis d. mun.;2012;83;231;72;159
Vilkaviškis d. mun.;2012;84;204;56;148
Vilkaviškis d. mun.;2012;85;734;174;560
Vilkaviškis d. mun.;2013;-1;41055;19468;21587
Vilkaviškis d. mun.;2013;0;408;212;196
Vilkaviškis d. mun.;2013;1;403;216;187
Vilkaviškis d. mun.;2013;2;320;165;155
Vilkaviškis d. mun.;2013;3;413;195;218
Vilkaviškis d. mun.;2013;4;353;178;175
Vilkaviškis d. mun.;2013;5;345;180;165
Vilkaviškis d. mun.;2013;6;371;180;191
Vilkaviškis d. mun.;2013;7;383;198;185
Vilkaviškis d. mun.;2013;8;397;208;189
Vilkaviškis d. mun.;2013;9;385;193;192
Vilkaviškis d. mun.;2013;10;440;209;231
Vilkaviškis d. mun.;2013;11;472;259;213
Vilkaviškis d. mun.;2013;12;479;235;244
Vilkaviškis d. mun.;2013;13;557;285;272
Vilkaviškis d. mun.;2013;14;586;319;267
Vilkaviškis d. mun.;2013;15;588;292;296
Vilkaviškis d. mun.;2013;16;590;305;285
Vilkaviškis d. mun.;2013;17;592;307;285
Vilkaviškis d. mun.;2013;18;640;318;322
Vilkaviškis d. mun.;2013;19;641;324;317
Vilkaviškis d. mun.;2013;20;723;378;345
Vilkaviškis d. mun.;2013;21;608;319;289
Vilkaviškis d. mun.;2013;22;571;312;259
Vilkaviškis d. mun.;2013;23;530;297;233
Vilkaviškis d. mun.;2013;24;506;297;209
Vilkaviškis d. mun.;2013;25;487;277;210
Vilkaviškis d. mun.;2013;26;459;260;199
Vilkaviškis d. mun.;2013;27;418;218;200
Vilkaviškis d. mun.;2013;28;362;223;139
Vilkaviškis d. mun.;2013;29;356;211;145
Vilkaviškis d. mun.;2013;30;351;209;142
Vilkaviškis d. mun.;2013;31;401;206;195
Vilkaviškis d. mun.;2013;32;373;189;184
Vilkaviškis d. mun.;2013;33;409;193;216
Vilkaviškis d. mun.;2013;34;440;247;193
Vilkaviškis d. mun.;2013;35;415;207;208
Vilkaviškis d. mun.;2013;36;499;254;245
Vilkaviškis d. mun.;2013;37;442;219;223
Vilkaviškis d. mun.;2013;38;490;242;248
Vilkaviškis d. mun.;2013;39;527;245;282
Vilkaviškis d. mun.;2013;40;589;295;294
Vilkaviškis d. mun.;2013;41;661;351;310
Vilkaviškis d. mun.;2013;42;617;302;315
Vilkaviškis d. mun.;2013;43;582;310;272
Vilkaviškis d. mun.;2013;44;597;303;294
Vilkaviškis d. mun.;2013;45;558;289;269
Vilkaviškis d. mun.;2013;46;601;292;309
Vilkaviškis d. mun.;2013;47;580;292;288
Vilkaviškis d. mun.;2013;48;641;312;329
Vilkaviškis d. mun.;2013;49;575;283;292
Vilkaviškis d. mun.;2013;50;631;325;306
Vilkaviškis d. mun.;2013;51;709;347;362
Vilkaviškis d. mun.;2013;52;621;318;303
Vilkaviškis d. mun.;2013;53;608;314;294
Vilkaviškis d. mun.;2013;54;630;300;330
Vilkaviškis d. mun.;2013;55;598;305;293
Vilkaviškis d. mun.;2013;56;525;228;297
Vilkaviškis d. mun.;2013;57;546;237;309
Vilkaviškis d. mun.;2013;58;500;211;289
Vilkaviškis d. mun.;2013;59;491;238;253
Vilkaviškis d. mun.;2013;60;475;228;247
Vilkaviškis d. mun.;2013;61;557;247;310
Vilkaviškis d. mun.;2013;62;477;209;268
Vilkaviškis d. mun.;2013;63;495;221;274
Vilkaviškis d. mun.;2013;64;457;173;284
Vilkaviškis d. mun.;2013;65;399;182;217
Vilkaviškis d. mun.;2013;66;342;165;177
Vilkaviškis d. mun.;2013;67;469;201;268
Vilkaviškis d. mun.;2013;68;306;126;180
Vilkaviškis d. mun.;2013;69;413;152;261
Vilkaviškis d. mun.;2013;70;539;176;363
Vilkaviškis d. mun.;2013;71;451;171;280
Vilkaviškis d. mun.;2013;72;421;146;275
Vilkaviškis d. mun.;2013;73;350;125;225
Vilkaviškis d. mun.;2013;74;408;118;290
Vilkaviškis d. mun.;2013;75;348;127;221
Vilkaviškis d. mun.;2013;76;359;111;248
Vilkaviškis d. mun.;2013;77;363;118;245
Vilkaviškis d. mun.;2013;78;330;109;221
Vilkaviškis d. mun.;2013;79;344;115;229
Vilkaviškis d. mun.;2013;80;349;105;244
Vilkaviškis d. mun.;2013;81;275;82;193
Vilkaviškis d. mun.;2013;82;298;103;195
Vilkaviškis d. mun.;2013;83;246;68;178
Vilkaviškis d. mun.;2013;84;205;64;141
Vilkaviškis d. mun.;2013;85;789;193;596
Vilkaviškis d. mun.;2014;-1;40258;19122;21136
Vilkaviškis d. mun.;2014;0;403;215;188
Vilkaviškis d. mun.;2014;1;396;204;192
Vilkaviškis d. mun.;2014;2;405;220;185
Vilkaviškis d. mun.;2014;3;306;158;148
Vilkaviškis d. mun.;2014;4;410;194;216
Vilkaviškis d. mun.;2014;5;345;177;168
Vilkaviškis d. mun.;2014;6;341;177;164
Vilkaviškis d. mun.;2014;7;362;176;186
Vilkaviškis d. mun.;2014;8;381;195;186
Vilkaviškis d. mun.;2014;9;395;207;188
Vilkaviškis d. mun.;2014;10;376;190;186
Vilkaviškis d. mun.;2014;11;431;205;226
Vilkaviškis d. mun.;2014;12;465;258;207
Vilkaviškis d. mun.;2014;13;471;229;242
Vilkaviškis d. mun.;2014;14;555;282;273
Vilkaviškis d. mun.;2014;15;578;314;264
Vilkaviškis d. mun.;2014;16;583;289;294
Vilkaviškis d. mun.;2014;17;586;303;283
Vilkaviškis d. mun.;2014;18;581;300;281
Vilkaviškis d. mun.;2014;19;631;317;314
Vilkaviškis d. mun.;2014;20;627;315;312
Vilkaviškis d. mun.;2014;21;709;375;334
Vilkaviškis d. mun.;2014;22;584;315;269
Vilkaviškis d. mun.;2014;23;534;296;238
Vilkaviškis d. mun.;2014;24;510;293;217
Vilkaviškis d. mun.;2014;25;493;297;196
Vilkaviškis d. mun.;2014;26;460;266;194
Vilkaviškis d. mun.;2014;27;432;246;186
Vilkaviškis d. mun.;2014;28;396;211;185
Vilkaviškis d. mun.;2014;29;328;209;119
Vilkaviškis d. mun.;2014;30;326;197;129
Vilkaviškis d. mun.;2014;31;336;201;135
Vilkaviškis d. mun.;2014;32;390;203;187
Vilkaviškis d. mun.;2014;33;367;186;181
Vilkaviškis d. mun.;2014;34;402;186;216
Vilkaviškis d. mun.;2014;35;439;242;197
Vilkaviškis d. mun.;2014;36;407;204;203
Vilkaviškis d. mun.;2014;37;487;246;241
Vilkaviškis d. mun.;2014;38;443;221;222
Vilkaviškis d. mun.;2014;39;485;238;247
Vilkaviškis d. mun.;2014;40;527;248;279
Vilkaviškis d. mun.;2014;41;580;289;291
Vilkaviškis d. mun.;2014;42;652;346;306
Vilkaviškis d. mun.;2014;43;612;299;313
Vilkaviškis d. mun.;2014;44;577;308;269
Vilkaviškis d. mun.;2014;45;589;298;291
Vilkaviškis d. mun.;2014;46;545;276;269
Vilkaviškis d. mun.;2014;47;596;289;307
Vilkaviškis d. mun.;2014;48;570;283;287
Vilkaviškis d. mun.;2014;49;630;305;325
Vilkaviškis d. mun.;2014;50;566;277;289
Vilkaviškis d. mun.;2014;51;623;322;301
Vilkaviškis d. mun.;2014;52;700;342;358
Vilkaviškis d. mun.;2014;53;611;313;298
Vilkaviškis d. mun.;2014;54;597;309;288
Vilkaviškis d. mun.;2014;55;624;298;326
Vilkaviškis d. mun.;2014;56;583;296;287
Vilkaviškis d. mun.;2014;57;521;227;294
Vilkaviškis d. mun.;2014;58;540;233;307
Vilkaviškis d. mun.;2014;59;494;206;288
Vilkaviškis d. mun.;2014;60;487;237;250
Vilkaviškis d. mun.;2014;61;464;223;241
Vilkaviškis d. mun.;2014;62;543;238;305
Vilkaviškis d. mun.;2014;63;465;198;267
Vilkaviškis d. mun.;2014;64;476;207;269
Vilkaviškis d. mun.;2014;65;446;164;282
Vilkaviškis d. mun.;2014;66;383;168;215
Vilkaviškis d. mun.;2014;67;335;158;177
Vilkaviškis d. mun.;2014;68;458;195;263
Vilkaviškis d. mun.;2014;69;301;123;178
Vilkaviškis d. mun.;2014;70;402;143;259
Vilkaviškis d. mun.;2014;71;519;164;355
Vilkaviškis d. mun.;2014;72;426;155;271
Vilkaviškis d. mun.;2014;73;402;134;268
Vilkaviškis d. mun.;2014;74;333;117;216
Vilkaviškis d. mun.;2014;75;395;117;278
Vilkaviškis d. mun.;2014;76;328;115;213
Vilkaviškis d. mun.;2014;77;342;103;239
Vilkaviškis d. mun.;2014;78;346;113;233
Vilkaviškis d. mun.;2014;79;307;101;206
Vilkaviškis d. mun.;2014;80;315;103;212
Vilkaviškis d. mun.;2014;81;323;98;225
Vilkaviškis d. mun.;2014;82;253;72;181
Vilkaviškis d. mun.;2014;83;266;90;176
Vilkaviškis d. mun.;2014;84;218;59;159
Vilkaviškis d. mun.;2014;85;832;206;626
Vilkaviškis d. mun.;2015;-1;39465;18794;20671
Vilkaviškis d. mun.;2015;0;383;204;179
Vilkaviškis d. mun.;2015;1;397;212;185
Vilkaviškis d. mun.;2015;2;378;199;179
Vilkaviškis d. mun.;2015;3;404;222;182
Vilkaviškis d. mun.;2015;4;294;156;138
Vilkaviškis d. mun.;2015;5;401;190;211
Vilkaviškis d. mun.;2015;6;334;171;163
Vilkaviškis d. mun.;2015;7;338;175;163
Vilkaviškis d. mun.;2015;8;359;173;186
Vilkaviškis d. mun.;2015;9;379;193;186
Vilkaviškis d. mun.;2015;10;380;199;181
Vilkaviškis d. mun.;2015;11;377;190;187
Vilkaviškis d. mun.;2015;12;423;200;223
Vilkaviškis d. mun.;2015;13;463;256;207
Vilkaviškis d. mun.;2015;14;469;228;241
Vilkaviškis d. mun.;2015;15;557;283;274
Vilkaviškis d. mun.;2015;16;573;311;262
Vilkaviškis d. mun.;2015;17;584;288;296
Vilkaviškis d. mun.;2015;18;581;302;279
Vilkaviškis d. mun.;2015;19;562;292;270
Vilkaviškis d. mun.;2015;20;619;311;308
Vilkaviškis d. mun.;2015;21;607;307;300
Vilkaviškis d. mun.;2015;22;676;361;315
Vilkaviškis d. mun.;2015;23;550;303;247
Vilkaviškis d. mun.;2015;24;521;294;227
Vilkaviškis d. mun.;2015;25;486;284;202
Vilkaviškis d. mun.;2015;26;462;288;174
Vilkaviškis d. mun.;2015;27;430;253;177
Vilkaviškis d. mun.;2015;28;407;232;175
Vilkaviškis d. mun.;2015;29;378;209;169
Vilkaviškis d. mun.;2015;30;300;196;104
Vilkaviškis d. mun.;2015;31;299;181;118
Vilkaviškis d. mun.;2015;32;316;188;128
Vilkaviškis d. mun.;2015;33;375;202;173
Vilkaviškis d. mun.;2015;34;357;181;176
Vilkaviškis d. mun.;2015;35;381;169;212
Vilkaviškis d. mun.;2015;36;424;228;196
Vilkaviškis d. mun.;2015;37;402;198;204
Vilkaviškis d. mun.;2015;38;479;244;235
Vilkaviškis d. mun.;2015;39;436;213;223
Vilkaviškis d. mun.;2015;40;475;236;239
Vilkaviškis d. mun.;2015;41;525;248;277
Vilkaviškis d. mun.;2015;42;578;287;291
Vilkaviškis d. mun.;2015;43;648;342;306
Vilkaviškis d. mun.;2015;44;598;294;304
Vilkaviškis d. mun.;2015;45;567;305;262
Vilkaviškis d. mun.;2015;46;572;286;286
Vilkaviškis d. mun.;2015;47;536;271;265
Vilkaviškis d. mun.;2015;48;591;288;303
Vilkaviškis d. mun.;2015;49;571;282;289
Vilkaviškis d. mun.;2015;50;624;301;323
Vilkaviškis d. mun.;2015;51;568;278;290
Vilkaviškis d. mun.;2015;52;618;319;299
Vilkaviškis d. mun.;2015;53;691;332;359
Vilkaviškis d. mun.;2015;54;604;311;293
Vilkaviškis d. mun.;2015;55;592;302;290
Vilkaviškis d. mun.;2015;56;618;294;324
Vilkaviškis d. mun.;2015;57;572;290;282
Vilkaviškis d. mun.;2015;58;521;226;295
Vilkaviškis d. mun.;2015;59;532;226;306
Vilkaviškis d. mun.;2015;60;480;196;284
Vilkaviškis d. mun.;2015;61;477;232;245
Vilkaviškis d. mun.;2015;62;456;218;238
Vilkaviškis d. mun.;2015;63;529;231;298
Vilkaviškis d. mun.;2015;64;460;194;266
Vilkaviškis d. mun.;2015;65;467;202;265
Vilkaviškis d. mun.;2015;66;431;155;276
Vilkaviškis d. mun.;2015;67;376;165;211
Vilkaviškis d. mun.;2015;68;326;151;175
Vilkaviškis d. mun.;2015;69;448;191;257
Vilkaviškis d. mun.;2015;70;293;117;176
Vilkaviškis d. mun.;2015;71;387;136;251
Vilkaviškis d. mun.;2015;72;502;157;345
Vilkaviškis d. mun.;2015;73;408;143;265
Vilkaviškis d. mun.;2015;74;389;126;263
Vilkaviškis d. mun.;2015;75;315;109;206
Vilkaviškis d. mun.;2015;76;372;107;265
Vilkaviškis d. mun.;2015;77;314;108;206
Vilkaviškis d. mun.;2015;78;330;101;229
Vilkaviškis d. mun.;2015;79;332;107;225
Vilkaviškis d. mun.;2015;80;288;93;195
Vilkaviškis d. mun.;2015;81;294;95;199
Vilkaviškis d. mun.;2015;82;293;90;203
Vilkaviškis d. mun.;2015;83;230;68;162
Vilkaviškis d. mun.;2015;84;233;74;159
Vilkaviškis d. mun.;2015;85;893;224;669
Vilkaviškis d. mun.;2016;-1;38595;18372;20223
Vilkaviškis d. mun.;2016;0;394;211;183
Vilkaviškis d. mun.;2016;1;376;199;177
Vilkaviškis d. mun.;2016;2;384;203;181
Vilkaviškis d. mun.;2016;3;372;194;178
Vilkaviškis d. mun.;2016;4;399;223;176
Vilkaviškis d. mun.;2016;5;282;152;130
Vilkaviškis d. mun.;2016;6;380;177;203
Vilkaviškis d. mun.;2016;7;326;168;158
Vilkaviškis d. mun.;2016;8;332;173;159
Vilkaviškis d. mun.;2016;9;348;168;180
Vilkaviškis d. mun.;2016;10;366;185;181
Vilkaviškis d. mun.;2016;11;375;194;181
Vilkaviškis d. mun.;2016;12;372;186;186
Vilkaviškis d. mun.;2016;13;415;198;217
Vilkaviškis d. mun.;2016;14;461;255;206
Vilkaviškis d. mun.;2016;15;468;224;244
Vilkaviškis d. mun.;2016;16;555;285;270
Vilkaviškis d. mun.;2016;17;571;309;262
Vilkaviškis d. mun.;2016;18;573;282;291
Vilkaviškis d. mun.;2016;19;573;294;279
Vilkaviškis d. mun.;2016;20;546;275;271
Vilkaviškis d. mun.;2016;21;606;296;310
Vilkaviškis d. mun.;2016;22;587;300;287
Vilkaviškis d. mun.;2016;23;645;340;305
Vilkaviškis d. mun.;2016;24;519;294;225
Vilkaviškis d. mun.;2016;25;500;283;217
Vilkaviškis d. mun.;2016;26;456;269;187
Vilkaviškis d. mun.;2016;27;429;277;152
Vilkaviškis d. mun.;2016;28;400;240;160
Vilkaviškis d. mun.;2016;29;381;216;165
Vilkaviškis d. mun.;2016;30;351;203;148
Vilkaviškis d. mun.;2016;31;292;184;108
Vilkaviškis d. mun.;2016;32;283;171;112
Vilkaviškis d. mun.;2016;33;295;176;119
Vilkaviškis d. mun.;2016;34;363;199;164
Vilkaviškis d. mun.;2016;35;342;171;171
Vilkaviškis d. mun.;2016;36;358;158;200
Vilkaviškis d. mun.;2016;37;413;221;192
Vilkaviškis d. mun.;2016;38;403;201;202
Vilkaviškis d. mun.;2016;39;468;238;230
Vilkaviškis d. mun.;2016;40;425;202;223
Vilkaviškis d. mun.;2016;41;474;236;238
Vilkaviškis d. mun.;2016;42;521;248;273
Vilkaviškis d. mun.;2016;43;566;282;284
Vilkaviškis d. mun.;2016;44;640;336;304
Vilkaviškis d. mun.;2016;45;589;290;299
Vilkaviškis d. mun.;2016;46;565;302;263
Vilkaviškis d. mun.;2016;47;560;282;278
Vilkaviškis d. mun.;2016;48;534;269;265
Vilkaviškis d. mun.;2016;49;583;282;301
Vilkaviškis d. mun.;2016;50;565;280;285
Vilkaviškis d. mun.;2016;51;617;294;323
Vilkaviškis d. mun.;2016;52;562;279;283
Vilkaviškis d. mun.;2016;53;615;316;299
Vilkaviškis d. mun.;2016;54;684;327;357
Vilkaviškis d. mun.;2016;55;587;300;287
Vilkaviškis d. mun.;2016;56;584;295;289
Vilkaviškis d. mun.;2016;57;613;288;325
Vilkaviškis d. mun.;2016;58;560;279;281
Vilkaviškis d. mun.;2016;59;517;226;291
Vilkaviškis d. mun.;2016;60;527;222;305
Vilkaviškis d. mun.;2016;61;475;195;280
Vilkaviškis d. mun.;2016;62;465;222;243
Vilkaviškis d. mun.;2016;63;450;215;235
Vilkaviškis d. mun.;2016;64;513;219;294
Vilkaviškis d. mun.;2016;65;441;186;255
Vilkaviškis d. mun.;2016;66;450;191;259
Vilkaviškis d. mun.;2016;67;422;148;274
Vilkaviškis d. mun.;2016;68;363;155;208
Vilkaviškis d. mun.;2016;69;315;146;169
Vilkaviškis d. mun.;2016;70;436;183;253
Vilkaviškis d. mun.;2016;71;286;112;174
Vilkaviškis d. mun.;2016;72;375;129;246
Vilkaviškis d. mun.;2016;73;487;152;335
Vilkaviškis d. mun.;2016;74;394;138;256
Vilkaviškis d. mun.;2016;75;366;115;251
Vilkaviškis d. mun.;2016;76;306;101;205
Vilkaviškis d. mun.;2016;77;355;104;251
Vilkaviškis d. mun.;2016;78;291;95;196
Vilkaviškis d. mun.;2016;79;313;92;221
Vilkaviškis d. mun.;2016;80;312;97;215
Vilkaviškis d. mun.;2016;81;266;80;186
Vilkaviškis d. mun.;2016;82;264;80;184
Vilkaviškis d. mun.;2016;83;269;83;186
Vilkaviškis d. mun.;2016;84;208;60;148
Vilkaviškis d. mun.;2016;85;926;247;679
Vilkaviškis d. mun.;2017;-1;37473;17816;19657
Vilkaviškis d. mun.;2017;0;357;191;166
Vilkaviškis d. mun.;2017;1;380;203;177
Vilkaviškis d. mun.;2017;2;364;191;173
Vilkaviškis d. mun.;2017;3;370;195;175
Vilkaviškis d. mun.;2017;4;369;195;174
Vilkaviškis d. mun.;2017;5;395;221;174
Vilkaviškis d. mun.;2017;6;276;147;129
Vilkaviškis d. mun.;2017;7;367;172;195
Vilkaviškis d. mun.;2017;8;322;166;156
Vilkaviškis d. mun.;2017;9;328;172;156
Vilkaviškis d. mun.;2017;10;349;168;181
Vilkaviškis d. mun.;2017;11;357;180;177
Vilkaviškis d. mun.;2017;12;366;188;178
Vilkaviškis d. mun.;2017;13;364;181;183
Vilkaviškis d. mun.;2017;14;408;193;215
Vilkaviškis d. mun.;2017;15;454;252;202
Vilkaviškis d. mun.;2017;16;464;224;240
Vilkaviškis d. mun.;2017;17;551;285;266
Vilkaviškis d. mun.;2017;18;560;303;257
Vilkaviškis d. mun.;2017;19;545;270;275
Vilkaviškis d. mun.;2017;20;552;281;271
Vilkaviškis d. mun.;2017;21;516;261;255
Vilkaviškis d. mun.;2017;22;569;285;284
Vilkaviškis d. mun.;2017;23;553;286;267
Vilkaviškis d. mun.;2017;24;600;315;285
Vilkaviškis d. mun.;2017;25;490;281;209
Vilkaviškis d. mun.;2017;26;451;254;197
Vilkaviškis d. mun.;2017;27;415;251;164
Vilkaviškis d. mun.;2017;28;389;253;136
Vilkaviškis d. mun.;2017;29;348;211;137
Vilkaviškis d. mun.;2017;30;343;191;152
Vilkaviškis d. mun.;2017;31;314;183;131
Vilkaviškis d. mun.;2017;32;270;174;96
Vilkaviškis d. mun.;2017;33;248;147;101
Vilkaviškis d. mun.;2017;34;283;168;115
Vilkaviškis d. mun.;2017;35;343;183;160
Vilkaviškis d. mun.;2017;36;332;165;167
Vilkaviškis d. mun.;2017;37;338;146;192
Vilkaviškis d. mun.;2017;38;405;222;183
Vilkaviškis d. mun.;2017;39;387;192;195
Vilkaviškis d. mun.;2017;40;456;227;229
Vilkaviškis d. mun.;2017;41;418;197;221
Vilkaviškis d. mun.;2017;42;459;230;229
Vilkaviškis d. mun.;2017;43;506;241;265
Vilkaviškis d. mun.;2017;44;544;266;278
Vilkaviškis d. mun.;2017;45;623;327;296
Vilkaviškis d. mun.;2017;46;580;284;296
Vilkaviškis d. mun.;2017;47;558;298;260
Vilkaviškis d. mun.;2017;48;557;282;275
Vilkaviškis d. mun.;2017;49;519;259;260
Vilkaviškis d. mun.;2017;50;571;276;295
Vilkaviškis d. mun.;2017;51;559;277;282
Vilkaviškis d. mun.;2017;52;610;291;319
Vilkaviškis d. mun.;2017;53;554;271;283
Vilkaviškis d. mun.;2017;54;604;313;291
Vilkaviškis d. mun.;2017;55;676;323;353
Vilkaviškis d. mun.;2017;56;579;296;283
Vilkaviškis d. mun.;2017;57;574;289;285
Vilkaviškis d. mun.;2017;58;609;285;324
Vilkaviškis d. mun.;2017;59;550;273;277
Vilkaviškis d. mun.;2017;60;509;224;285
Vilkaviškis d. mun.;2017;61;523;217;306
Vilkaviškis d. mun.;2017;62;470;192;278
Vilkaviškis d. mun.;2017;63;452;217;235
Vilkaviškis d. mun.;2017;64;434;206;228
Vilkaviškis d. mun.;2017;65;500;212;288
Vilkaviškis d. mun.;2017;66;429;178;251
Vilkaviškis d. mun.;2017;67;429;178;251
Vilkaviškis d. mun.;2017;68;416;144;272
Vilkaviškis d. mun.;2017;69;354;146;208
Vilkaviškis d. mun.;2017;70;296;135;161
Vilkaviškis d. mun.;2017;71;426;175;251
Vilkaviškis d. mun.;2017;72;274;102;172
Vilkaviškis d. mun.;2017;73;362;120;242
Vilkaviškis d. mun.;2017;74;462;143;319
Vilkaviškis d. mun.;2017;75;387;134;253
Vilkaviškis d. mun.;2017;76;345;106;239
Vilkaviškis d. mun.;2017;77;299;99;200
Vilkaviškis d. mun.;2017;78;335;91;244
Vilkaviškis d. mun.;2017;79;270;88;182
Vilkaviškis d. mun.;2017;80;301;87;214
Vilkaviškis d. mun.;2017;81;294;91;203
Vilkaviškis d. mun.;2017;82;248;73;175
Vilkaviškis d. mun.;2017;83;244;75;169
Vilkaviškis d. mun.;2017;84;251;76;175
Vilkaviškis d. mun.;2017;85;965;256;709
Vilkaviškis d. mun.;2018;-1;36108;17141;18967
Vilkaviškis d. mun.;2018;0;341;162;179
Vilkaviškis d. mun.;2018;1;336;180;156
Vilkaviškis d. mun.;2018;2;364;193;171
Vilkaviškis d. mun.;2018;3;341;180;161
Vilkaviškis d. mun.;2018;4;355;190;165
Vilkaviškis d. mun.;2018;5;358;190;168
Vilkaviškis d. mun.;2018;6;380;214;166
Vilkaviškis d. mun.;2018;7;257;135;122
Vilkaviškis d. mun.;2018;8;358;166;192
Vilkaviškis d. mun.;2018;9;313;163;150
Vilkaviškis d. mun.;2018;10;325;168;157
Vilkaviškis d. mun.;2018;11;341;165;176
Vilkaviškis d. mun.;2018;12;352;178;174
Vilkaviškis d. mun.;2018;13;360;185;175
Vilkaviškis d. mun.;2018;14;362;181;181
Vilkaviškis d. mun.;2018;15;398;186;212
Vilkaviškis d. mun.;2018;16;443;245;198
Vilkaviškis d. mun.;2018;17;454;223;231
Vilkaviškis d. mun.;2018;18;538;277;261
Vilkaviškis d. mun.;2018;19;525;288;237
Vilkaviškis d. mun.;2018;20;505;253;252
Vilkaviškis d. mun.;2018;21;510;261;249
Vilkaviškis d. mun.;2018;22;461;243;218
Vilkaviškis d. mun.;2018;23;517;260;257
Vilkaviškis d. mun.;2018;24;497;260;237
Vilkaviškis d. mun.;2018;25;541;289;252
Vilkaviškis d. mun.;2018;26;437;252;185
Vilkaviškis d. mun.;2018;27;397;234;163
Vilkaviškis d. mun.;2018;28;363;225;138
Vilkaviškis d. mun.;2018;29;351;235;116
Vilkaviškis d. mun.;2018;30;306;187;119
Vilkaviškis d. mun.;2018;31;309;176;133
Vilkaviškis d. mun.;2018;32;283;160;123
Vilkaviškis d. mun.;2018;33;231;151;80
Vilkaviškis d. mun.;2018;34;226;132;94
Vilkaviškis d. mun.;2018;35;272;160;112
Vilkaviškis d. mun.;2018;36;323;174;149
Vilkaviškis d. mun.;2018;37;306;147;159
Vilkaviškis d. mun.;2018;38;321;139;182
Vilkaviškis d. mun.;2018;39;394;211;183
Vilkaviškis d. mun.;2018;40;380;186;194
Vilkaviškis d. mun.;2018;41;450;224;226
Vilkaviškis d. mun.;2018;42;409;193;216
Vilkaviškis d. mun.;2018;43;449;226;223
Vilkaviškis d. mun.;2018;44;496;237;259
Vilkaviškis d. mun.;2018;45;536;263;273
Vilkaviškis d. mun.;2018;46;608;321;287
Vilkaviškis d. mun.;2018;47;568;277;291
Vilkaviškis d. mun.;2018;48;548;291;257
Vilkaviškis d. mun.;2018;49;545;278;267
Vilkaviškis d. mun.;2018;50;516;257;259
Vilkaviškis d. mun.;2018;51;563;272;291
Vilkaviškis d. mun.;2018;52;547;270;277
Vilkaviškis d. mun.;2018;53;605;287;318
Vilkaviškis d. mun.;2018;54;548;267;281
Vilkaviškis d. mun.;2018;55;593;305;288
Vilkaviškis d. mun.;2018;56;666;320;346
Vilkaviškis d. mun.;2018;57;572;291;281
Vilkaviškis d. mun.;2018;58;565;280;285
Vilkaviškis d. mun.;2018;59;609;286;323
Vilkaviškis d. mun.;2018;60;542;269;273
Vilkaviškis d. mun.;2018;61;502;220;282
Vilkaviškis d. mun.;2018;62;514;208;306
Vilkaviškis d. mun.;2018;63;465;188;277
Vilkaviškis d. mun.;2018;64;444;213;231
Vilkaviškis d. mun.;2018;65;425;198;227
Vilkaviškis d. mun.;2018;66;489;205;284
Vilkaviškis d. mun.;2018;67;408;162;246
Vilkaviškis d. mun.;2018;68;421;173;248
Vilkaviškis d. mun.;2018;69;411;143;268
Vilkaviškis d. mun.;2018;70;341;138;203
Vilkaviškis d. mun.;2018;71;284;125;159
Vilkaviškis d. mun.;2018;72;414;168;246
Vilkaviškis d. mun.;2018;73;266;98;168
Vilkaviškis d. mun.;2018;74;345;108;237
Vilkaviškis d. mun.;2018;75;442;135;307
Vilkaviškis d. mun.;2018;76;377;129;248
Vilkaviškis d. mun.;2018;77;330;97;233
Vilkaviškis d. mun.;2018;78;278;89;189
Vilkaviškis d. mun.;2018;79;314;83;231
Vilkaviškis d. mun.;2018;80;251;79;172
Vilkaviškis d. mun.;2018;81;276;77;199
Vilkaviškis d. mun.;2018;82;269;77;192
Vilkaviškis d. mun.;2018;83;233;69;164
Vilkaviškis d. mun.;2018;84;229;71;158
Vilkaviškis d. mun.;2018;85;1014;270;744
Vilnius c. mun.;2001;-1;554281;252705;301576
Vilnius c. mun.;2001;0;5039;2586;2453
Vilnius c. mun.;2001;1;5241;2693;2548
Vilnius c. mun.;2001;2;5062;2621;2441
Vilnius c. mun.;2001;3;5007;2657;2350
Vilnius c. mun.;2001;4;5033;2544;2489
Vilnius c. mun.;2001;5;5382;2768;2614
Vilnius c. mun.;2001;6;5475;2801;2674
Vilnius c. mun.;2001;7;6002;3071;2931
Vilnius c. mun.;2001;8;6671;3427;3244
Vilnius c. mun.;2001;9;6950;3521;3429
Vilnius c. mun.;2001;10;7393;3739;3654
Vilnius c. mun.;2001;11;7306;3680;3626
Vilnius c. mun.;2001;12;7367;3730;3637
Vilnius c. mun.;2001;13;7866;4036;3830
Vilnius c. mun.;2001;14;8210;4176;4034
Vilnius c. mun.;2001;15;7979;4011;3968
Vilnius c. mun.;2001;16;8057;4081;3976
Vilnius c. mun.;2001;17;7907;4027;3880
Vilnius c. mun.;2001;18;8803;4272;4531
Vilnius c. mun.;2001;19;10389;4945;5444
Vilnius c. mun.;2001;20;10175;4835;5340
Vilnius c. mun.;2001;21;9957;4712;5245
Vilnius c. mun.;2001;22;9341;4431;4910
Vilnius c. mun.;2001;23;9255;4440;4815
Vilnius c. mun.;2001;24;8732;4125;4607
Vilnius c. mun.;2001;25;8306;3947;4359
Vilnius c. mun.;2001;26;8420;3987;4433
Vilnius c. mun.;2001;27;8596;4259;4337
Vilnius c. mun.;2001;28;9164;4555;4609
Vilnius c. mun.;2001;29;9518;4799;4719
Vilnius c. mun.;2001;30;9043;4452;4591
Vilnius c. mun.;2001;31;8818;4337;4481
Vilnius c. mun.;2001;32;8623;4166;4457
Vilnius c. mun.;2001;33;8445;4054;4391
Vilnius c. mun.;2001;34;8669;4169;4500
Vilnius c. mun.;2001;35;8453;4036;4417
Vilnius c. mun.;2001;36;8724;4093;4631
Vilnius c. mun.;2001;37;9323;4487;4836
Vilnius c. mun.;2001;38;9428;4347;5081
Vilnius c. mun.;2001;39;9739;4499;5240
Vilnius c. mun.;2001;40;9324;4166;5158
Vilnius c. mun.;2001;41;9501;4314;5187
Vilnius c. mun.;2001;42;8845;3914;4931
Vilnius c. mun.;2001;43;8421;3769;4652
Vilnius c. mun.;2001;44;8327;3850;4477
Vilnius c. mun.;2001;45;8059;3633;4426
Vilnius c. mun.;2001;46;7566;3335;4231
Vilnius c. mun.;2001;47;7401;3216;4185
Vilnius c. mun.;2001;48;7865;3499;4366
Vilnius c. mun.;2001;49;7757;3437;4320
Vilnius c. mun.;2001;50;7481;3275;4206
Vilnius c. mun.;2001;51;7497;3126;4371
Vilnius c. mun.;2001;52;6812;2828;3984
Vilnius c. mun.;2001;53;6283;2672;3611
Vilnius c. mun.;2001;54;5780;2365;3415
Vilnius c. mun.;2001;55;6029;2460;3569
Vilnius c. mun.;2001;56;5206;2163;3043
Vilnius c. mun.;2001;57;5572;2316;3256
Vilnius c. mun.;2001;58;5952;2509;3443
Vilnius c. mun.;2001;59;5725;2490;3235
Vilnius c. mun.;2001;60;5901;2450;3451
Vilnius c. mun.;2001;61;5860;2420;3440
Vilnius c. mun.;2001;62;5855;2382;3473
Vilnius c. mun.;2001;63;5554;2264;3290
Vilnius c. mun.;2001;64;5269;2095;3174
Vilnius c. mun.;2001;65;4844;1943;2901
Vilnius c. mun.;2001;66;4345;1685;2660
Vilnius c. mun.;2001;67;4555;1865;2690
Vilnius c. mun.;2001;68;4535;1842;2693
Vilnius c. mun.;2001;69;4285;1648;2637
Vilnius c. mun.;2001;70;4337;1756;2581
Vilnius c. mun.;2001;71;4066;1591;2475
Vilnius c. mun.;2001;72;4084;1530;2554
Vilnius c. mun.;2001;73;3775;1375;2400
Vilnius c. mun.;2001;74;3273;1010;2263
Vilnius c. mun.;2001;75;3066;846;2220
Vilnius c. mun.;2001;76;2684;704;1980
Vilnius c. mun.;2001;77;2378;594;1784
Vilnius c. mun.;2001;78;2047;537;1510
Vilnius c. mun.;2001;79;1645;464;1181
Vilnius c. mun.;2001;80;1328;359;969
Vilnius c. mun.;2001;81;1077;296;781
Vilnius c. mun.;2001;82;818;229;589
Vilnius c. mun.;2001;83;638;191;447
Vilnius c. mun.;2001;84;640;159;481
Vilnius c. mun.;2001;85;4151;1017;3134
Vilnius c. mun.;2002;-1;550924;250806;300118
Vilnius c. mun.;2002;0;4469;2301;2168
Vilnius c. mun.;2002;1;5030;2588;2442
Vilnius c. mun.;2002;2;5225;2680;2545
Vilnius c. mun.;2002;3;5059;2622;2437
Vilnius c. mun.;2002;4;5001;2653;2348
Vilnius c. mun.;2002;5;5031;2540;2491
Vilnius c. mun.;2002;6;5366;2748;2618
Vilnius c. mun.;2002;7;5484;2812;2672
Vilnius c. mun.;2002;8;5985;3061;2924
Vilnius c. mun.;2002;9;6658;3409;3249
Vilnius c. mun.;2002;10;6938;3503;3435
Vilnius c. mun.;2002;11;7324;3694;3630
Vilnius c. mun.;2002;12;7234;3641;3593
Vilnius c. mun.;2002;13;7245;3669;3576
Vilnius c. mun.;2002;14;7776;3975;3801
Vilnius c. mun.;2002;15;8117;4113;4004
Vilnius c. mun.;2002;16;7923;3982;3941
Vilnius c. mun.;2002;17;7961;4024;3937
Vilnius c. mun.;2002;18;7903;3988;3915
Vilnius c. mun.;2002;19;8723;4187;4536
Vilnius c. mun.;2002;20;10263;4850;5413
Vilnius c. mun.;2002;21;9932;4699;5233
Vilnius c. mun.;2002;22;9705;4572;5133
Vilnius c. mun.;2002;23;9176;4331;4845
Vilnius c. mun.;2002;24;9043;4311;4732
Vilnius c. mun.;2002;25;8614;4077;4537
Vilnius c. mun.;2002;26;8217;3875;4342
Vilnius c. mun.;2002;27;8369;3923;4446
Vilnius c. mun.;2002;28;8533;4199;4334
Vilnius c. mun.;2002;29;9074;4501;4573
Vilnius c. mun.;2002;30;9399;4733;4666
Vilnius c. mun.;2002;31;8936;4404;4532
Vilnius c. mun.;2002;32;8681;4240;4441
Vilnius c. mun.;2002;33;8538;4103;4435
Vilnius c. mun.;2002;34;8381;4019;4362
Vilnius c. mun.;2002;35;8558;4096;4462
Vilnius c. mun.;2002;36;8364;3988;4376
Vilnius c. mun.;2002;37;8605;4013;4592
Vilnius c. mun.;2002;38;9212;4421;4791
Vilnius c. mun.;2002;39;9260;4243;5017
Vilnius c. mun.;2002;40;9591;4410;5181
Vilnius c. mun.;2002;41;9208;4110;5098
Vilnius c. mun.;2002;42;9437;4285;5152
Vilnius c. mun.;2002;43;8826;3928;4898
Vilnius c. mun.;2002;44;8312;3713;4599
Vilnius c. mun.;2002;45;8170;3759;4411
Vilnius c. mun.;2002;46;7935;3567;4368
Vilnius c. mun.;2002;47;7542;3332;4210
Vilnius c. mun.;2002;48;7267;3145;4122
Vilnius c. mun.;2002;49;7734;3436;4298
Vilnius c. mun.;2002;50;7628;3350;4278
Vilnius c. mun.;2002;51;7332;3199;4133
Vilnius c. mun.;2002;52;7455;3101;4354
Vilnius c. mun.;2002;53;6749;2806;3943
Vilnius c. mun.;2002;54;6164;2632;3532
Vilnius c. mun.;2002;55;5667;2313;3354
Vilnius c. mun.;2002;56;5898;2402;3496
Vilnius c. mun.;2002;57;5096;2120;2976
Vilnius c. mun.;2002;58;5442;2259;3183
Vilnius c. mun.;2002;59;5824;2449;3375
Vilnius c. mun.;2002;60;5661;2447;3214
Vilnius c. mun.;2002;61;5863;2420;3443
Vilnius c. mun.;2002;62;5833;2385;3448
Vilnius c. mun.;2002;63;5823;2350;3473
Vilnius c. mun.;2002;64;5499;2207;3292
Vilnius c. mun.;2002;65;5196;2059;3137
Vilnius c. mun.;2002;66;4765;1890;2875
Vilnius c. mun.;2002;67;4292;1660;2632
Vilnius c. mun.;2002;68;4489;1823;2666
Vilnius c. mun.;2002;69;4473;1793;2680
Vilnius c. mun.;2002;70;4243;1614;2629
Vilnius c. mun.;2002;71;4259;1707;2552
Vilnius c. mun.;2002;72;3995;1566;2429
Vilnius c. mun.;2002;73;3980;1482;2498
Vilnius c. mun.;2002;74;3698;1328;2370
Vilnius c. mun.;2002;75;3173;966;2207
Vilnius c. mun.;2002;76;2991;818;2173
Vilnius c. mun.;2002;77;2581;670;1911
Vilnius c. mun.;2002;78;2312;567;1745
Vilnius c. mun.;2002;79;1975;513;1462
Vilnius c. mun.;2002;80;1564;439;1125
Vilnius c. mun.;2002;81;1245;337;908
Vilnius c. mun.;2002;82;999;271;728
Vilnius c. mun.;2002;83;764;210;554
Vilnius c. mun.;2002;84;581;161;420
Vilnius c. mun.;2002;85;4081;1019;3062
Vilnius c. mun.;2003;-1;550213;250346;299867
Vilnius c. mun.;2003;0;4565;2361;2204
Vilnius c. mun.;2003;1;4478;2295;2183
Vilnius c. mun.;2003;2;5026;2581;2445
Vilnius c. mun.;2003;3;5218;2672;2546
Vilnius c. mun.;2003;4;5063;2621;2442
Vilnius c. mun.;2003;5;5004;2660;2344
Vilnius c. mun.;2003;6;5024;2533;2491
Vilnius c. mun.;2003;7;5368;2747;2621
Vilnius c. mun.;2003;8;5496;2813;2683
Vilnius c. mun.;2003;9;5970;3046;2924
Vilnius c. mun.;2003;10;6610;3389;3221
Vilnius c. mun.;2003;11;6909;3488;3421
Vilnius c. mun.;2003;12;7276;3671;3605
Vilnius c. mun.;2003;13;7149;3601;3548
Vilnius c. mun.;2003;14;7147;3607;3540
Vilnius c. mun.;2003;15;7668;3913;3755
Vilnius c. mun.;2003;16;8024;4051;3973
Vilnius c. mun.;2003;17;7812;3901;3911
Vilnius c. mun.;2003;18;7883;3978;3905
Vilnius c. mun.;2003;19;7843;3946;3897
Vilnius c. mun.;2003;20;8628;4140;4488
Vilnius c. mun.;2003;21;10160;4819;5341
Vilnius c. mun.;2003;22;9820;4649;5171
Vilnius c. mun.;2003;23;9662;4533;5129
Vilnius c. mun.;2003;24;9160;4289;4871
Vilnius c. mun.;2003;25;9138;4364;4774
Vilnius c. mun.;2003;26;8723;4127;4596
Vilnius c. mun.;2003;27;8353;3913;4440
Vilnius c. mun.;2003;28;8463;3948;4515
Vilnius c. mun.;2003;29;8620;4239;4381
Vilnius c. mun.;2003;30;9117;4512;4605
Vilnius c. mun.;2003;31;9476;4782;4694
Vilnius c. mun.;2003;32;8946;4415;4531
Vilnius c. mun.;2003;33;8684;4236;4448
Vilnius c. mun.;2003;34;8499;4100;4399
Vilnius c. mun.;2003;35;8334;3993;4341
Vilnius c. mun.;2003;36;8512;4077;4435
Vilnius c. mun.;2003;37;8298;3952;4346
Vilnius c. mun.;2003;38;8547;3992;4555
Vilnius c. mun.;2003;39;9141;4401;4740
Vilnius c. mun.;2003;40;9187;4215;4972
Vilnius c. mun.;2003;41;9546;4406;5140
Vilnius c. mun.;2003;42;9161;4082;5079
Vilnius c. mun.;2003;43;9371;4253;5118
Vilnius c. mun.;2003;44;8775;3907;4868
Vilnius c. mun.;2003;45;8264;3689;4575
Vilnius c. mun.;2003;46;8103;3722;4381
Vilnius c. mun.;2003;47;7866;3523;4343
Vilnius c. mun.;2003;48;7482;3293;4189
Vilnius c. mun.;2003;49;7170;3098;4072
Vilnius c. mun.;2003;50;7638;3385;4253
Vilnius c. mun.;2003;51;7529;3303;4226
Vilnius c. mun.;2003;52;7232;3146;4086
Vilnius c. mun.;2003;53;7395;3078;4317
Vilnius c. mun.;2003;54;6681;2761;3920
Vilnius c. mun.;2003;55;6086;2579;3507
Vilnius c. mun.;2003;56;5587;2268;3319
Vilnius c. mun.;2003;57;5800;2345;3455
Vilnius c. mun.;2003;58;4996;2061;2935
Vilnius c. mun.;2003;59;5357;2214;3143
Vilnius c. mun.;2003;60;5732;2392;3340
Vilnius c. mun.;2003;61;5556;2386;3170
Vilnius c. mun.;2003;62;5816;2373;3443
Vilnius c. mun.;2003;63;5779;2349;3430
Vilnius c. mun.;2003;64;5748;2303;3445
Vilnius c. mun.;2003;65;5439;2162;3277
Vilnius c. mun.;2003;66;5135;2020;3115
Vilnius c. mun.;2003;67;4698;1845;2853
Vilnius c. mun.;2003;68;4202;1593;2609
Vilnius c. mun.;2003;69;4388;1752;2636
Vilnius c. mun.;2003;70;4378;1728;2650
Vilnius c. mun.;2003;71;4118;1543;2575
Vilnius c. mun.;2003;72;4128;1630;2498
Vilnius c. mun.;2003;73;3851;1491;2360
Vilnius c. mun.;2003;74;3878;1406;2472
Vilnius c. mun.;2003;75;3558;1259;2299
Vilnius c. mun.;2003;76;3048;916;2132
Vilnius c. mun.;2003;77;2876;764;2112
Vilnius c. mun.;2003;78;2465;621;1844
Vilnius c. mun.;2003;79;2200;532;1668
Vilnius c. mun.;2003;80;1840;463;1377
Vilnius c. mun.;2003;81;1450;387;1063
Vilnius c. mun.;2003;82;1168;295;873
Vilnius c. mun.;2003;83;924;228;696
Vilnius c. mun.;2003;84;695;186;509
Vilnius c. mun.;2003;85;4103;1039;3064
Vilnius c. mun.;2004;-1;548729;249384;299345
Vilnius c. mun.;2004;0;4658;2425;2233
Vilnius c. mun.;2004;1;4507;2328;2179
Vilnius c. mun.;2004;2;4439;2273;2166
Vilnius c. mun.;2004;3;4968;2549;2419
Vilnius c. mun.;2004;4;5163;2643;2520
Vilnius c. mun.;2004;5;5019;2608;2411
Vilnius c. mun.;2004;6;4949;2631;2318
Vilnius c. mun.;2004;7;4975;2505;2470
Vilnius c. mun.;2004;8;5320;2722;2598
Vilnius c. mun.;2004;9;5466;2802;2664
Vilnius c. mun.;2004;10;5948;3031;2917
Vilnius c. mun.;2004;11;6558;3367;3191
Vilnius c. mun.;2004;12;6852;3457;3395
Vilnius c. mun.;2004;13;7191;3636;3555
Vilnius c. mun.;2004;14;7026;3550;3476
Vilnius c. mun.;2004;15;7049;3576;3473
Vilnius c. mun.;2004;16;7583;3873;3710
Vilnius c. mun.;2004;17;7924;4008;3916
Vilnius c. mun.;2004;18;7676;3841;3835
Vilnius c. mun.;2004;19;7798;3925;3873
Vilnius c. mun.;2004;20;7814;3901;3913
Vilnius c. mun.;2004;21;8561;4129;4432
Vilnius c. mun.;2004;22;10090;4777;5313
Vilnius c. mun.;2004;23;9768;4641;5127
Vilnius c. mun.;2004;24;9612;4493;5119
Vilnius c. mun.;2004;25;9266;4315;4951
Vilnius c. mun.;2004;26;9300;4416;4884
Vilnius c. mun.;2004;27;8901;4188;4713
Vilnius c. mun.;2004;28;8520;3973;4547
Vilnius c. mun.;2004;29;8599;3997;4602
Vilnius c. mun.;2004;30;8719;4267;4452
Vilnius c. mun.;2004;31;9174;4541;4633
Vilnius c. mun.;2004;32;9526;4823;4703
Vilnius c. mun.;2004;33;8952;4401;4551
Vilnius c. mun.;2004;34;8708;4255;4453
Vilnius c. mun.;2004;35;8481;4107;4374
Vilnius c. mun.;2004;36;8276;3955;4321
Vilnius c. mun.;2004;37;8427;4045;4382
Vilnius c. mun.;2004;38;8232;3928;4304
Vilnius c. mun.;2004;39;8427;3962;4465
Vilnius c. mun.;2004;40;9051;4362;4689
Vilnius c. mun.;2004;41;9078;4172;4906
Vilnius c. mun.;2004;42;9407;4347;5060
Vilnius c. mun.;2004;43;9074;4031;5043
Vilnius c. mun.;2004;44;9243;4181;5062
Vilnius c. mun.;2004;45;8686;3867;4819
Vilnius c. mun.;2004;46;8206;3670;4536
Vilnius c. mun.;2004;47;8026;3682;4344
Vilnius c. mun.;2004;48;7792;3475;4317
Vilnius c. mun.;2004;49;7398;3246;4152
Vilnius c. mun.;2004;50;7084;3036;4048
Vilnius c. mun.;2004;51;7529;3323;4206
Vilnius c. mun.;2004;52;7368;3231;4137
Vilnius c. mun.;2004;53;7126;3084;4042
Vilnius c. mun.;2004;54;7324;3033;4291
Vilnius c. mun.;2004;55;6588;2705;3883
Vilnius c. mun.;2004;56;6007;2527;3480
Vilnius c. mun.;2004;57;5488;2201;3287
Vilnius c. mun.;2004;58;5719;2293;3426
Vilnius c. mun.;2004;59;4935;2013;2922
Vilnius c. mun.;2004;60;5237;2138;3099
Vilnius c. mun.;2004;61;5632;2339;3293
Vilnius c. mun.;2004;62;5463;2322;3141
Vilnius c. mun.;2004;63;5731;2326;3405
Vilnius c. mun.;2004;64;5693;2287;3406
Vilnius c. mun.;2004;65;5705;2250;3455
Vilnius c. mun.;2004;66;5341;2074;3267
Vilnius c. mun.;2004;67;5057;1941;3116
Vilnius c. mun.;2004;68;4618;1773;2845
Vilnius c. mun.;2004;69;4106;1527;2579
Vilnius c. mun.;2004;70;4268;1670;2598
Vilnius c. mun.;2004;71;4293;1662;2631
Vilnius c. mun.;2004;72;4004;1467;2537
Vilnius c. mun.;2004;73;4055;1571;2484
Vilnius c. mun.;2004;74;3742;1406;2336
Vilnius c. mun.;2004;75;3738;1319;2419
Vilnius c. mun.;2004;76;3422;1188;2234
Vilnius c. mun.;2004;77;2942;852;2090
Vilnius c. mun.;2004;78;2783;726;2057
Vilnius c. mun.;2004;79;2334;563;1771
Vilnius c. mun.;2004;80;2051;463;1588
Vilnius c. mun.;2004;81;1713;415;1298
Vilnius c. mun.;2004;82;1370;359;1011
Vilnius c. mun.;2004;83;1068;263;805
Vilnius c. mun.;2004;84;820;195;625
Vilnius c. mun.;2004;85;3992;945;3047
Vilnius c. mun.;2005;-1;546773;248292;298481
Vilnius c. mun.;2005;0;4782;2472;2310
Vilnius c. mun.;2005;1;4669;2440;2229
Vilnius c. mun.;2005;2;4488;2320;2168
Vilnius c. mun.;2005;3;4410;2256;2154
Vilnius c. mun.;2005;4;4950;2544;2406
Vilnius c. mun.;2005;5;5145;2639;2506
Vilnius c. mun.;2005;6;5006;2602;2404
Vilnius c. mun.;2005;7;4939;2633;2306
Vilnius c. mun.;2005;8;4999;2522;2477
Vilnius c. mun.;2005;9;5320;2725;2595
Vilnius c. mun.;2005;10;5454;2796;2658
Vilnius c. mun.;2005;11;5936;3033;2903
Vilnius c. mun.;2005;12;6546;3350;3196
Vilnius c. mun.;2005;13;6811;3438;3373
Vilnius c. mun.;2005;14;7118;3600;3518
Vilnius c. mun.;2005;15;6958;3525;3433
Vilnius c. mun.;2005;16;6934;3512;3422
Vilnius c. mun.;2005;17;7464;3810;3654
Vilnius c. mun.;2005;18;7784;3937;3847
Vilnius c. mun.;2005;19;7531;3771;3760
Vilnius c. mun.;2005;20;7724;3876;3848
Vilnius c. mun.;2005;21;7763;3842;3921
Vilnius c. mun.;2005;22;8430;4050;4380
Vilnius c. mun.;2005;23;9982;4720;5262
Vilnius c. mun.;2005;24;9744;4611;5133
Vilnius c. mun.;2005;25;9568;4490;5078
Vilnius c. mun.;2005;26;9330;4320;5010
Vilnius c. mun.;2005;27;9511;4513;4998
Vilnius c. mun.;2005;28;9054;4255;4799
Vilnius c. mun.;2005;29;8672;4031;4641
Vilnius c. mun.;2005;30;8694;4026;4668
Vilnius c. mun.;2005;31;8756;4270;4486
Vilnius c. mun.;2005;32;9197;4535;4662
Vilnius c. mun.;2005;33;9537;4825;4712
Vilnius c. mun.;2005;34;8967;4396;4571
Vilnius c. mun.;2005;35;8661;4232;4429
Vilnius c. mun.;2005;36;8381;4080;4301
Vilnius c. mun.;2005;37;8168;3902;4266
Vilnius c. mun.;2005;38;8322;3985;4337
Vilnius c. mun.;2005;39;8148;3894;4254
Vilnius c. mun.;2005;40;8317;3907;4410
Vilnius c. mun.;2005;41;8939;4292;4647
Vilnius c. mun.;2005;42;8969;4110;4859
Vilnius c. mun.;2005;43;9305;4285;5020
Vilnius c. mun.;2005;44;8990;3984;5006
Vilnius c. mun.;2005;45;9137;4130;5007
Vilnius c. mun.;2005;46;8629;3821;4808
Vilnius c. mun.;2005;47;8140;3630;4510
Vilnius c. mun.;2005;48;7894;3600;4294
Vilnius c. mun.;2005;49;7671;3392;4279
Vilnius c. mun.;2005;50;7319;3204;4115
Vilnius c. mun.;2005;51;6993;2993;4000
Vilnius c. mun.;2005;52;7428;3263;4165
Vilnius c. mun.;2005;53;7245;3160;4085
Vilnius c. mun.;2005;54;7019;3021;3998
Vilnius c. mun.;2005;55;7222;2959;4263
Vilnius c. mun.;2005;56;6486;2642;3844
Vilnius c. mun.;2005;57;5907;2455;3452
Vilnius c. mun.;2005;58;5380;2147;3233
Vilnius c. mun.;2005;59;5604;2228;3376
Vilnius c. mun.;2005;60;4857;1970;2887
Vilnius c. mun.;2005;61;5117;2074;3043
Vilnius c. mun.;2005;62;5529;2275;3254
Vilnius c. mun.;2005;63;5333;2240;3093
Vilnius c. mun.;2005;64;5611;2248;3363
Vilnius c. mun.;2005;65;5571;2217;3354
Vilnius c. mun.;2005;66;5602;2182;3420
Vilnius c. mun.;2005;67;5224;2001;3223
Vilnius c. mun.;2005;68;4958;1874;3084
Vilnius c. mun.;2005;69;4475;1683;2792
Vilnius c. mun.;2005;70;3993;1472;2521
Vilnius c. mun.;2005;71;4124;1601;2523
Vilnius c. mun.;2005;72;4158;1589;2569
Vilnius c. mun.;2005;73;3876;1385;2491
Vilnius c. mun.;2005;74;3885;1467;2418
Vilnius c. mun.;2005;75;3580;1326;2254
Vilnius c. mun.;2005;76;3579;1233;2346
Vilnius c. mun.;2005;77;3268;1111;2157
Vilnius c. mun.;2005;78;2786;795;1991
Vilnius c. mun.;2005;79;2627;662;1965
Vilnius c. mun.;2005;80;2185;520;1665
Vilnius c. mun.;2005;81;1925;417;1508
Vilnius c. mun.;2005;82;1587;385;1202
Vilnius c. mun.;2005;83;1264;315;949
Vilnius c. mun.;2005;84;966;239;727
Vilnius c. mun.;2005;85;4246;1010;3236
Vilnius c. mun.;2006;-1;542525;246032;296493
Vilnius c. mun.;2006;0;5045;2560;2485
Vilnius c. mun.;2006;1;4754;2455;2299
Vilnius c. mun.;2006;2;4610;2414;2196
Vilnius c. mun.;2006;3;4440;2305;2135
Vilnius c. mun.;2006;4;4372;2240;2132
Vilnius c. mun.;2006;5;4941;2537;2404
Vilnius c. mun.;2006;6;5117;2631;2486
Vilnius c. mun.;2006;7;5020;2601;2419
Vilnius c. mun.;2006;8;4922;2624;2298
Vilnius c. mun.;2006;9;4988;2533;2455
Vilnius c. mun.;2006;10;5313;2724;2589
Vilnius c. mun.;2006;11;5451;2798;2653
Vilnius c. mun.;2006;12;5927;3030;2897
Vilnius c. mun.;2006;13;6444;3303;3141
Vilnius c. mun.;2006;14;6752;3405;3347
Vilnius c. mun.;2006;15;6984;3541;3443
Vilnius c. mun.;2006;16;6789;3424;3365
Vilnius c. mun.;2006;17;6775;3413;3362
Vilnius c. mun.;2006;18;7247;3703;3544
Vilnius c. mun.;2006;19;7501;3769;3732
Vilnius c. mun.;2006;20;7271;3627;3644
Vilnius c. mun.;2006;21;7392;3688;3704
Vilnius c. mun.;2006;22;7520;3729;3791
Vilnius c. mun.;2006;23;8274;3950;4324
Vilnius c. mun.;2006;24;9780;4601;5179
Vilnius c. mun.;2006;25;9609;4546;5063
Vilnius c. mun.;2006;26;9503;4445;5058
Vilnius c. mun.;2006;27;9331;4330;5001
Vilnius c. mun.;2006;28;9540;4532;5008
Vilnius c. mun.;2006;29;9131;4309;4822
Vilnius c. mun.;2006;30;8710;4047;4663
Vilnius c. mun.;2006;31;8679;4001;4678
Vilnius c. mun.;2006;32;8710;4266;4444
Vilnius c. mun.;2006;33;9105;4479;4626
Vilnius c. mun.;2006;34;9433;4760;4673
Vilnius c. mun.;2006;35;8873;4331;4542
Vilnius c. mun.;2006;36;8589;4193;4396
Vilnius c. mun.;2006;37;8259;4006;4253
Vilnius c. mun.;2006;38;8052;3840;4212
Vilnius c. mun.;2006;39;8222;3924;4298
Vilnius c. mun.;2006;40;8008;3806;4202
Vilnius c. mun.;2006;41;8195;3836;4359
Vilnius c. mun.;2006;42;8775;4191;4584
Vilnius c. mun.;2006;43;8823;4038;4785
Vilnius c. mun.;2006;44;9200;4222;4978
Vilnius c. mun.;2006;45;8952;3960;4992
Vilnius c. mun.;2006;46;9042;4087;4955
Vilnius c. mun.;2006;47;8586;3792;4794
Vilnius c. mun.;2006;48;8061;3609;4452
Vilnius c. mun.;2006;49;7766;3510;4256
Vilnius c. mun.;2006;50;7581;3344;4237
Vilnius c. mun.;2006;51;7214;3135;4079
Vilnius c. mun.;2006;52;6892;2934;3958
Vilnius c. mun.;2006;53;7291;3187;4104
Vilnius c. mun.;2006;54;7125;3090;4035
Vilnius c. mun.;2006;55;6929;2969;3960
Vilnius c. mun.;2006;56;7139;2895;4244
Vilnius c. mun.;2006;57;6405;2579;3826
Vilnius c. mun.;2006;58;5838;2416;3422
Vilnius c. mun.;2006;59;5293;2087;3206
Vilnius c. mun.;2006;60;5506;2166;3340
Vilnius c. mun.;2006;61;4779;1912;2867
Vilnius c. mun.;2006;62;5035;2017;3018
Vilnius c. mun.;2006;63;5449;2220;3229
Vilnius c. mun.;2006;64;5265;2193;3072
Vilnius c. mun.;2006;65;5497;2174;3323
Vilnius c. mun.;2006;66;5446;2137;3309
Vilnius c. mun.;2006;67;5487;2115;3372
Vilnius c. mun.;2006;68;5131;1939;3192
Vilnius c. mun.;2006;69;4842;1806;3036
Vilnius c. mun.;2006;70;4372;1620;2752
Vilnius c. mun.;2006;71;3883;1408;2475
Vilnius c. mun.;2006;72;3985;1522;2463
Vilnius c. mun.;2006;73;4044;1530;2514
Vilnius c. mun.;2006;74;3752;1322;2430
Vilnius c. mun.;2006;75;3720;1390;2330
Vilnius c. mun.;2006;76;3414;1245;2169
Vilnius c. mun.;2006;77;3426;1164;2262
Vilnius c. mun.;2006;78;3101;1038;2063
Vilnius c. mun.;2006;79;2632;726;1906
Vilnius c. mun.;2006;80;2467;612;1855
Vilnius c. mun.;2006;81;2039;470;1569
Vilnius c. mun.;2006;82;1770;362;1408
Vilnius c. mun.;2006;83;1439;346;1093
Vilnius c. mun.;2006;84;1147;284;863
Vilnius c. mun.;2006;85;4407;1013;3394
Vilnius c. mun.;2007;-1;541732;245118;296614
Vilnius c. mun.;2007;0;5384;2737;2647
Vilnius c. mun.;2007;1;4997;2552;2445
Vilnius c. mun.;2007;2;4726;2438;2288
Vilnius c. mun.;2007;3;4609;2411;2198
Vilnius c. mun.;2007;4;4440;2297;2143
Vilnius c. mun.;2007;5;4371;2233;2138
Vilnius c. mun.;2007;6;4930;2526;2404
Vilnius c. mun.;2007;7;5132;2639;2493
Vilnius c. mun.;2007;8;5016;2590;2426
Vilnius c. mun.;2007;9;4918;2609;2309
Vilnius c. mun.;2007;10;5001;2531;2470
Vilnius c. mun.;2007;11;5321;2715;2606
Vilnius c. mun.;2007;12;5440;2787;2653
Vilnius c. mun.;2007;13;5931;3029;2902
Vilnius c. mun.;2007;14;6451;3305;3146
Vilnius c. mun.;2007;15;6745;3406;3339
Vilnius c. mun.;2007;16;6947;3521;3426
Vilnius c. mun.;2007;17;6722;3389;3333
Vilnius c. mun.;2007;18;6719;3386;3333
Vilnius c. mun.;2007;19;7198;3663;3535
Vilnius c. mun.;2007;20;7454;3729;3725
Vilnius c. mun.;2007;21;7185;3557;3628
Vilnius c. mun.;2007;22;7300;3603;3697
Vilnius c. mun.;2007;23;7450;3649;3801
Vilnius c. mun.;2007;24;8236;3876;4360
Vilnius c. mun.;2007;25;9846;4600;5246
Vilnius c. mun.;2007;26;9663;4558;5105
Vilnius c. mun.;2007;27;9557;4436;5121
Vilnius c. mun.;2007;28;9413;4336;5077
Vilnius c. mun.;2007;29;9565;4540;5025
Vilnius c. mun.;2007;30;9165;4319;4846
Vilnius c. mun.;2007;31;8780;4066;4714
Vilnius c. mun.;2007;32;8716;4014;4702
Vilnius c. mun.;2007;33;8711;4238;4473
Vilnius c. mun.;2007;34;9098;4458;4640
Vilnius c. mun.;2007;35;9409;4723;4686
Vilnius c. mun.;2007;36;8820;4304;4516
Vilnius c. mun.;2007;37;8557;4175;4382
Vilnius c. mun.;2007;38;8248;3992;4256
Vilnius c. mun.;2007;39;8000;3803;4197
Vilnius c. mun.;2007;40;8167;3901;4266
Vilnius c. mun.;2007;41;7959;3777;4182
Vilnius c. mun.;2007;42;8126;3784;4342
Vilnius c. mun.;2007;43;8694;4142;4552
Vilnius c. mun.;2007;44;8721;3970;4751
Vilnius c. mun.;2007;45;9116;4184;4932
Vilnius c. mun.;2007;46;8927;3946;4981
Vilnius c. mun.;2007;47;8956;4032;4924
Vilnius c. mun.;2007;48;8526;3737;4789
Vilnius c. mun.;2007;49;8016;3587;4429
Vilnius c. mun.;2007;50;7686;3460;4226
Vilnius c. mun.;2007;51;7476;3271;4205
Vilnius c. mun.;2007;52;7127;3090;4037
Vilnius c. mun.;2007;53;6836;2892;3944
Vilnius c. mun.;2007;54;7193;3104;4089
Vilnius c. mun.;2007;55;7020;3022;3998
Vilnius c. mun.;2007;56;6814;2902;3912
Vilnius c. mun.;2007;57;7034;2831;4203
Vilnius c. mun.;2007;58;6305;2515;3790
Vilnius c. mun.;2007;59;5738;2349;3389
Vilnius c. mun.;2007;60;5203;2032;3171
Vilnius c. mun.;2007;61;5418;2104;3314
Vilnius c. mun.;2007;62;4688;1850;2838
Vilnius c. mun.;2007;63;4951;1955;2996
Vilnius c. mun.;2007;64;5318;2137;3181
Vilnius c. mun.;2007;65;5151;2128;3023
Vilnius c. mun.;2007;66;5379;2096;3283
Vilnius c. mun.;2007;67;5314;2054;3260
Vilnius c. mun.;2007;68;5371;2043;3328
Vilnius c. mun.;2007;69;4995;1855;3140
Vilnius c. mun.;2007;70;4740;1742;2998
Vilnius c. mun.;2007;71;4239;1541;2698
Vilnius c. mun.;2007;72;3786;1361;2425
Vilnius c. mun.;2007;73;3852;1442;2410
Vilnius c. mun.;2007;74;3892;1443;2449
Vilnius c. mun.;2007;75;3597;1244;2353
Vilnius c. mun.;2007;76;3584;1308;2276
Vilnius c. mun.;2007;77;3270;1162;2108
Vilnius c. mun.;2007;78;3250;1080;2170
Vilnius c. mun.;2007;79;2904;950;1954
Vilnius c. mun.;2007;80;2469;663;1806
Vilnius c. mun.;2007;81;2286;544;1742
Vilnius c. mun.;2007;82;1863;417;1446
Vilnius c. mun.;2007;83;1606;317;1289
Vilnius c. mun.;2007;84;1320;314;1006
Vilnius c. mun.;2007;85;4678;1100;3578
Vilnius c. mun.;2008;-1;541596;244449;297147
Vilnius c. mun.;2008;0;5576;2851;2725
Vilnius c. mun.;2008;1;5353;2725;2628
Vilnius c. mun.;2008;2;4955;2538;2417
Vilnius c. mun.;2008;3;4707;2430;2277
Vilnius c. mun.;2008;4;4602;2405;2197
Vilnius c. mun.;2008;5;4439;2294;2145
Vilnius c. mun.;2008;6;4348;2217;2131
Vilnius c. mun.;2008;7;4956;2550;2406
Vilnius c. mun.;2008;8;5128;2639;2489
Vilnius c. mun.;2008;9;5039;2598;2441
Vilnius c. mun.;2008;10;4935;2616;2319
Vilnius c. mun.;2008;11;5001;2537;2464
Vilnius c. mun.;2008;12;5330;2712;2618
Vilnius c. mun.;2008;13;5428;2771;2657
Vilnius c. mun.;2008;14;5934;3038;2896
Vilnius c. mun.;2008;15;6429;3290;3139
Vilnius c. mun.;2008;16;6746;3413;3333
Vilnius c. mun.;2008;17;6882;3498;3384
Vilnius c. mun.;2008;18;6685;3377;3308
Vilnius c. mun.;2008;19;6678;3352;3326
Vilnius c. mun.;2008;20;7137;3639;3498
Vilnius c. mun.;2008;21;7378;3700;3678
Vilnius c. mun.;2008;22;7124;3514;3610
Vilnius c. mun.;2008;23;7298;3575;3723
Vilnius c. mun.;2008;24;7522;3632;3890
Vilnius c. mun.;2008;25;8290;3849;4441
Vilnius c. mun.;2008;26;9949;4603;5346
Vilnius c. mun.;2008;27;9789;4591;5198
Vilnius c. mun.;2008;28;9691;4475;5216
Vilnius c. mun.;2008;29;9517;4381;5136
Vilnius c. mun.;2008;30;9640;4578;5062
Vilnius c. mun.;2008;31;9197;4314;4883
Vilnius c. mun.;2008;32;8814;4080;4734
Vilnius c. mun.;2008;33;8753;4018;4735
Vilnius c. mun.;2008;34;8707;4236;4471
Vilnius c. mun.;2008;35;9083;4421;4662
Vilnius c. mun.;2008;36;9393;4716;4677
Vilnius c. mun.;2008;37;8777;4275;4502
Vilnius c. mun.;2008;38;8483;4130;4353
Vilnius c. mun.;2008;39;8199;3956;4243
Vilnius c. mun.;2008;40;7943;3778;4165
Vilnius c. mun.;2008;41;8102;3863;4239
Vilnius c. mun.;2008;42;7878;3724;4154
Vilnius c. mun.;2008;43;8050;3731;4319
Vilnius c. mun.;2008;44;8597;4075;4522
Vilnius c. mun.;2008;45;8613;3901;4712
Vilnius c. mun.;2008;46;9033;4131;4902
Vilnius c. mun.;2008;47;8865;3897;4968
Vilnius c. mun.;2008;48;8866;3973;4893
Vilnius c. mun.;2008;49;8439;3675;4764
Vilnius c. mun.;2008;50;7946;3539;4407
Vilnius c. mun.;2008;51;7589;3391;4198
Vilnius c. mun.;2008;52;7387;3225;4162
Vilnius c. mun.;2008;53;7021;3000;4021
Vilnius c. mun.;2008;54;6746;2842;3904
Vilnius c. mun.;2008;55;7090;3031;4059
Vilnius c. mun.;2008;56;6878;2933;3945
Vilnius c. mun.;2008;57;6705;2823;3882
Vilnius c. mun.;2008;58;6953;2754;4199
Vilnius c. mun.;2008;59;6197;2448;3749
Vilnius c. mun.;2008;60;5618;2264;3354
Vilnius c. mun.;2008;61;5087;1955;3132
Vilnius c. mun.;2008;62;5318;2035;3283
Vilnius c. mun.;2008;63;4609;1790;2819
Vilnius c. mun.;2008;64;4871;1897;2974
Vilnius c. mun.;2008;65;5200;2061;3139
Vilnius c. mun.;2008;66;5044;2051;2993
Vilnius c. mun.;2008;67;5277;2023;3254
Vilnius c. mun.;2008;68;5203;1980;3223
Vilnius c. mun.;2008;69;5236;1950;3286
Vilnius c. mun.;2008;70;4852;1770;3082
Vilnius c. mun.;2008;71;4622;1666;2956
Vilnius c. mun.;2008;72;4121;1467;2654
Vilnius c. mun.;2008;73;3644;1267;2377
Vilnius c. mun.;2008;74;3721;1373;2348
Vilnius c. mun.;2008;75;3741;1370;2371
Vilnius c. mun.;2008;76;3457;1168;2289
Vilnius c. mun.;2008;77;3406;1208;2198
Vilnius c. mun.;2008;78;3117;1086;2031
Vilnius c. mun.;2008;79;3080;1008;2072
Vilnius c. mun.;2008;80;2725;867;1858
Vilnius c. mun.;2008;81;2321;608;1713
Vilnius c. mun.;2008;82;2095;477;1618
Vilnius c. mun.;2008;83;1717;367;1350
Vilnius c. mun.;2008;84;1449;281;1168
Vilnius c. mun.;2008;85;5275;1192;4083
Vilnius c. mun.;2009;-1;542969;244653;298316
Vilnius c. mun.;2009;0;6194;3167;3027
Vilnius c. mun.;2009;1;5575;2851;2724
Vilnius c. mun.;2009;2;5328;2710;2618
Vilnius c. mun.;2009;3;4928;2526;2402
Vilnius c. mun.;2009;4;4680;2423;2257
Vilnius c. mun.;2009;5;4600;2397;2203
Vilnius c. mun.;2009;6;4436;2293;2143
Vilnius c. mun.;2009;7;4358;2219;2139
Vilnius c. mun.;2009;8;4961;2545;2416
Vilnius c. mun.;2009;9;5122;2634;2488
Vilnius c. mun.;2009;10;5046;2594;2452
Vilnius c. mun.;2009;11;4923;2607;2316
Vilnius c. mun.;2009;12;5001;2536;2465
Vilnius c. mun.;2009;13;5334;2710;2624
Vilnius c. mun.;2009;14;5434;2770;2664
Vilnius c. mun.;2009;15;5935;3043;2892
Vilnius c. mun.;2009;16;6441;3289;3152
Vilnius c. mun.;2009;17;6716;3384;3332
Vilnius c. mun.;2009;18;6851;3476;3375
Vilnius c. mun.;2009;19;6669;3349;3320
Vilnius c. mun.;2009;20;6632;3316;3316
Vilnius c. mun.;2009;21;7118;3596;3522
Vilnius c. mun.;2009;22;7389;3687;3702
Vilnius c. mun.;2009;23;7173;3514;3659
Vilnius c. mun.;2009;24;7413;3606;3807
Vilnius c. mun.;2009;25;7743;3724;4019
Vilnius c. mun.;2009;26;8463;3910;4553
Vilnius c. mun.;2009;27;10057;4644;5413
Vilnius c. mun.;2009;28;9903;4634;5269
Vilnius c. mun.;2009;29;9822;4523;5299
Vilnius c. mun.;2009;30;9632;4424;5208
Vilnius c. mun.;2009;31;9670;4579;5091
Vilnius c. mun.;2009;32;9242;4332;4910
Vilnius c. mun.;2009;33;8867;4102;4765
Vilnius c. mun.;2009;34;8771;4020;4751
Vilnius c. mun.;2009;35;8661;4198;4463
Vilnius c. mun.;2009;36;9050;4408;4642
Vilnius c. mun.;2009;37;9395;4717;4678
Vilnius c. mun.;2009;38;8770;4249;4521
Vilnius c. mun.;2009;39;8487;4136;4351
Vilnius c. mun.;2009;40;8171;3937;4234
Vilnius c. mun.;2009;41;7934;3764;4170
Vilnius c. mun.;2009;42;8040;3822;4218
Vilnius c. mun.;2009;43;7834;3683;4151
Vilnius c. mun.;2009;44;7997;3699;4298
Vilnius c. mun.;2009;45;8496;4008;4488
Vilnius c. mun.;2009;46;8518;3832;4686
Vilnius c. mun.;2009;47;8962;4079;4883
Vilnius c. mun.;2009;48;8830;3882;4948
Vilnius c. mun.;2009;49;8792;3922;4870
Vilnius c. mun.;2009;50;8362;3606;4756
Vilnius c. mun.;2009;51;7828;3447;4381
Vilnius c. mun.;2009;52;7502;3332;4170
Vilnius c. mun.;2009;53;7299;3163;4136
Vilnius c. mun.;2009;54;6945;2951;3994
Vilnius c. mun.;2009;55;6662;2782;3880
Vilnius c. mun.;2009;56;6992;2965;4027
Vilnius c. mun.;2009;57;6786;2868;3918
Vilnius c. mun.;2009;58;6608;2758;3850
Vilnius c. mun.;2009;59;6818;2667;4151
Vilnius c. mun.;2009;60;6104;2387;3717
Vilnius c. mun.;2009;61;5516;2192;3324
Vilnius c. mun.;2009;62;4994;1885;3109
Vilnius c. mun.;2009;63;5218;1966;3252
Vilnius c. mun.;2009;64;4525;1736;2789
Vilnius c. mun.;2009;65;4761;1834;2927
Vilnius c. mun.;2009;66;5082;1981;3101
Vilnius c. mun.;2009;67;4935;1979;2956
Vilnius c. mun.;2009;68;5169;1953;3216
Vilnius c. mun.;2009;69;5084;1898;3186
Vilnius c. mun.;2009;70;5115;1880;3235
Vilnius c. mun.;2009;71;4692;1681;3011
Vilnius c. mun.;2009;72;4508;1600;2908
Vilnius c. mun.;2009;73;3980;1395;2585
Vilnius c. mun.;2009;74;3512;1201;2311
Vilnius c. mun.;2009;75;3570;1283;2287
Vilnius c. mun.;2009;76;3574;1283;2291
Vilnius c. mun.;2009;77;3308;1090;2218
Vilnius c. mun.;2009;78;3274;1146;2128
Vilnius c. mun.;2009;79;2948;1011;1937
Vilnius c. mun.;2009;80;2912;932;1980
Vilnius c. mun.;2009;81;2539;783;1756
Vilnius c. mun.;2009;82;2139;552;1587
Vilnius c. mun.;2009;83;1940;427;1513
Vilnius c. mun.;2009;84;1569;326;1243
Vilnius c. mun.;2009;85;5835;1243;4592
Vilnius c. mun.;2010;-1;543191;243763;299428
Vilnius c. mun.;2010;0;6618;3370;3248
Vilnius c. mun.;2010;1;6162;3137;3025
Vilnius c. mun.;2010;2;5543;2832;2711
Vilnius c. mun.;2010;3;5319;2708;2611
Vilnius c. mun.;2010;4;4903;2508;2395
Vilnius c. mun.;2010;5;4644;2403;2241
Vilnius c. mun.;2010;6;4630;2413;2217
Vilnius c. mun.;2010;7;4445;2286;2159
Vilnius c. mun.;2010;8;4361;2212;2149
Vilnius c. mun.;2010;9;4964;2546;2418
Vilnius c. mun.;2010;10;5135;2629;2506
Vilnius c. mun.;2010;11;5058;2604;2454
Vilnius c. mun.;2010;12;4920;2598;2322
Vilnius c. mun.;2010;13;4993;2532;2461
Vilnius c. mun.;2010;14;5348;2713;2635
Vilnius c. mun.;2010;15;5447;2780;2667
Vilnius c. mun.;2010;16;5919;3029;2890
Vilnius c. mun.;2010;17;6441;3282;3159
Vilnius c. mun.;2010;18;6704;3379;3325
Vilnius c. mun.;2010;19;6867;3470;3397
Vilnius c. mun.;2010;20;6602;3302;3300
Vilnius c. mun.;2010;21;6592;3293;3299
Vilnius c. mun.;2010;22;7043;3517;3526
Vilnius c. mun.;2010;23;7325;3608;3717
Vilnius c. mun.;2010;24;7203;3475;3728
Vilnius c. mun.;2010;25;7507;3591;3916
Vilnius c. mun.;2010;26;7865;3767;4098
Vilnius c. mun.;2010;27;8498;3876;4622
Vilnius c. mun.;2010;28;10026;4583;5443
Vilnius c. mun.;2010;29;9930;4625;5305
Vilnius c. mun.;2010;30;9872;4536;5336
Vilnius c. mun.;2010;31;9636;4393;5243
Vilnius c. mun.;2010;32;9681;4596;5085
Vilnius c. mun.;2010;33;9246;4305;4941
Vilnius c. mun.;2010;34;8801;4052;4749
Vilnius c. mun.;2010;35;8717;3996;4721
Vilnius c. mun.;2010;36;8583;4139;4444
Vilnius c. mun.;2010;37;8990;4361;4629
Vilnius c. mun.;2010;38;9336;4655;4681
Vilnius c. mun.;2010;39;8701;4197;4504
Vilnius c. mun.;2010;40;8395;4059;4336
Vilnius c. mun.;2010;41;8080;3862;4218
Vilnius c. mun.;2010;42;7825;3662;4163
Vilnius c. mun.;2010;43;7937;3739;4198
Vilnius c. mun.;2010;44;7752;3602;4150
Vilnius c. mun.;2010;45;7875;3604;4271
Vilnius c. mun.;2010;46;8381;3914;4467
Vilnius c. mun.;2010;47;8438;3769;4669
Vilnius c. mun.;2010;48;8856;4002;4854
Vilnius c. mun.;2010;49;8756;3834;4922
Vilnius c. mun.;2010;50;8698;3843;4855
Vilnius c. mun.;2010;51;8283;3542;4741
Vilnius c. mun.;2010;52;7752;3380;4372
Vilnius c. mun.;2010;53;7444;3283;4161
Vilnius c. mun.;2010;54;7241;3116;4125
Vilnius c. mun.;2010;55;6848;2891;3957
Vilnius c. mun.;2010;56;6557;2715;3842
Vilnius c. mun.;2010;57;6912;2899;4013
Vilnius c. mun.;2010;58;6711;2814;3897
Vilnius c. mun.;2010;59;6489;2668;3821
Vilnius c. mun.;2010;60;6724;2601;4123
Vilnius c. mun.;2010;61;6003;2324;3679
Vilnius c. mun.;2010;62;5431;2131;3300
Vilnius c. mun.;2010;63;4928;1838;3090
Vilnius c. mun.;2010;64;5130;1903;3227
Vilnius c. mun.;2010;65;4454;1680;2774
Vilnius c. mun.;2010;66;4698;1782;2916
Vilnius c. mun.;2010;67;4998;1913;3085
Vilnius c. mun.;2010;68;4830;1911;2919
Vilnius c. mun.;2010;69;5051;1881;3170
Vilnius c. mun.;2010;70;4948;1804;3144
Vilnius c. mun.;2010;71;4997;1818;3179
Vilnius c. mun.;2010;72;4554;1607;2947
Vilnius c. mun.;2010;73;4388;1517;2871
Vilnius c. mun.;2010;74;3845;1321;2524
Vilnius c. mun.;2010;75;3363;1122;2241
Vilnius c. mun.;2010;76;3410;1198;2212
Vilnius c. mun.;2010;77;3419;1200;2219
Vilnius c. mun.;2010;78;3151;1021;2130
Vilnius c. mun.;2010;79;3074;1037;2037
Vilnius c. mun.;2010;80;2781;919;1862
Vilnius c. mun.;2010;81;2726;854;1872
Vilnius c. mun.;2010;82;2364;708;1656
Vilnius c. mun.;2010;83;1943;495;1448
Vilnius c. mun.;2010;84;1758;369;1389
Vilnius c. mun.;2010;85;6418;1313;5105
Vilnius c. mun.;2011;-1;536127;240186;295941
Vilnius c. mun.;2011;0;7200;3675;3525
Vilnius c. mun.;2011;1;6813;3470;3343
Vilnius c. mun.;2011;2;6261;3161;3100
Vilnius c. mun.;2011;3;5617;2862;2755
Vilnius c. mun.;2011;4;5315;2688;2627
Vilnius c. mun.;2011;5;4977;2518;2459
Vilnius c. mun.;2011;6;4689;2420;2269
Vilnius c. mun.;2011;7;4455;2312;2143
Vilnius c. mun.;2011;8;4336;2224;2112
Vilnius c. mun.;2011;9;4334;2196;2138
Vilnius c. mun.;2011;10;4702;2411;2291
Vilnius c. mun.;2011;11;4950;2543;2407
Vilnius c. mun.;2011;12;4986;2541;2445
Vilnius c. mun.;2011;13;4882;2579;2303
Vilnius c. mun.;2011;14;4931;2507;2424
Vilnius c. mun.;2011;15;5280;2696;2584
Vilnius c. mun.;2011;16;5314;2707;2607
Vilnius c. mun.;2011;17;5810;2940;2870
Vilnius c. mun.;2011;18;6577;3284;3293
Vilnius c. mun.;2011;19;8648;4122;4526
Vilnius c. mun.;2011;20;9105;4301;4804
Vilnius c. mun.;2011;21;8762;4142;4620
Vilnius c. mun.;2011;22;8833;4188;4645
Vilnius c. mun.;2011;23;9085;4370;4715
Vilnius c. mun.;2011;24;9555;4537;5018
Vilnius c. mun.;2011;25;9552;4490;5062
Vilnius c. mun.;2011;26;9739;4602;5137
Vilnius c. mun.;2011;27;9899;4775;5124
Vilnius c. mun.;2011;28;8976;4295;4681
Vilnius c. mun.;2011;29;9026;4359;4667
Vilnius c. mun.;2011;30;8754;4276;4478
Vilnius c. mun.;2011;31;8703;4180;4523
Vilnius c. mun.;2011;32;8594;4136;4458
Vilnius c. mun.;2011;33;8502;4121;4381
Vilnius c. mun.;2011;34;8267;3985;4282
Vilnius c. mun.;2011;35;7883;3664;4219
Vilnius c. mun.;2011;36;7883;3710;4173
Vilnius c. mun.;2011;37;7670;3682;3988
Vilnius c. mun.;2011;38;7751;3694;4057
Vilnius c. mun.;2011;39;8000;3878;4122
Vilnius c. mun.;2011;40;7491;3508;3983
Vilnius c. mun.;2011;41;7333;3474;3859
Vilnius c. mun.;2011;42;7104;3318;3786
Vilnius c. mun.;2011;43;6896;3154;3742
Vilnius c. mun.;2011;44;7038;3242;3796
Vilnius c. mun.;2011;45;6883;3108;3775
Vilnius c. mun.;2011;46;7123;3196;3927
Vilnius c. mun.;2011;47;7557;3431;4126
Vilnius c. mun.;2011;48;7655;3364;4291
Vilnius c. mun.;2011;49;8122;3594;4528
Vilnius c. mun.;2011;50;8229;3526;4703
Vilnius c. mun.;2011;51;8003;3451;4552
Vilnius c. mun.;2011;52;7968;3403;4565
Vilnius c. mun.;2011;53;7279;3124;4155
Vilnius c. mun.;2011;54;6774;2878;3896
Vilnius c. mun.;2011;55;6605;2739;3866
Vilnius c. mun.;2011;56;6418;2715;3703
Vilnius c. mun.;2011;57;5953;2365;3588
Vilnius c. mun.;2011;58;6299;2558;3741
Vilnius c. mun.;2011;59;6114;2488;3626
Vilnius c. mun.;2011;60;5898;2401;3497
Vilnius c. mun.;2011;61;6321;2421;3900
Vilnius c. mun.;2011;62;5709;2218;3491
Vilnius c. mun.;2011;63;5238;2047;3191
Vilnius c. mun.;2011;64;4749;1779;2970
Vilnius c. mun.;2011;65;4763;1735;3028
Vilnius c. mun.;2011;66;4004;1467;2537
Vilnius c. mun.;2011;67;4292;1622;2670
Vilnius c. mun.;2011;68;4650;1761;2889
Vilnius c. mun.;2011;69;4500;1759;2741
Vilnius c. mun.;2011;70;4750;1771;2979
Vilnius c. mun.;2011;71;4637;1699;2938
Vilnius c. mun.;2011;72;4842;1783;3059
Vilnius c. mun.;2011;73;4479;1577;2902
Vilnius c. mun.;2011;74;4277;1459;2818
Vilnius c. mun.;2011;75;3754;1293;2461
Vilnius c. mun.;2011;76;3272;1080;2192
Vilnius c. mun.;2011;77;3162;1091;2071
Vilnius c. mun.;2011;78;3326;1134;2192
Vilnius c. mun.;2011;79;2997;979;2018
Vilnius c. mun.;2011;80;2912;972;1940
Vilnius c. mun.;2011;81;2593;866;1727
Vilnius c. mun.;2011;82;2556;782;1774
Vilnius c. mun.;2011;83;2170;660;1510
Vilnius c. mun.;2011;84;1860;471;1389
Vilnius c. mun.;2011;85;6956;1482;5474
Vilnius c. mun.;2012;-1;533279;238785;294494
Vilnius c. mun.;2012;0;6470;3337;3133
Vilnius c. mun.;2012;1;7230;3686;3544
Vilnius c. mun.;2012;2;6793;3446;3347
Vilnius c. mun.;2012;3;6168;3121;3047
Vilnius c. mun.;2012;4;5539;2824;2715
Vilnius c. mun.;2012;5;5238;2648;2590
Vilnius c. mun.;2012;6;4932;2492;2440
Vilnius c. mun.;2012;7;4662;2410;2252
Vilnius c. mun.;2012;8;4412;2284;2128
Vilnius c. mun.;2012;9;4299;2194;2105
Vilnius c. mun.;2012;10;4294;2177;2117
Vilnius c. mun.;2012;11;4662;2386;2276
Vilnius c. mun.;2012;12;4924;2519;2405
Vilnius c. mun.;2012;13;4942;2518;2424
Vilnius c. mun.;2012;14;4849;2560;2289
Vilnius c. mun.;2012;15;4898;2493;2405
Vilnius c. mun.;2012;16;5249;2677;2572
Vilnius c. mun.;2012;17;5282;2693;2589
Vilnius c. mun.;2012;18;5776;2929;2847
Vilnius c. mun.;2012;19;6388;3195;3193
Vilnius c. mun.;2012;20;8590;4100;4490
Vilnius c. mun.;2012;21;8985;4250;4735
Vilnius c. mun.;2012;22;8624;4080;4544
Vilnius c. mun.;2012;23;8617;4101;4516
Vilnius c. mun.;2012;24;8983;4288;4695
Vilnius c. mun.;2012;25;9536;4493;5043
Vilnius c. mun.;2012;26;9575;4461;5114
Vilnius c. mun.;2012;27;9805;4611;5194
Vilnius c. mun.;2012;28;9967;4774;5193
Vilnius c. mun.;2012;29;9042;4334;4708
Vilnius c. mun.;2012;30;8993;4360;4633
Vilnius c. mun.;2012;31;8689;4248;4441
Vilnius c. mun.;2012;32;8638;4151;4487
Vilnius c. mun.;2012;33;8464;4084;4380
Vilnius c. mun.;2012;34;8360;4043;4317
Vilnius c. mun.;2012;35;8138;3922;4216
Vilnius c. mun.;2012;36;7792;3605;4187
Vilnius c. mun.;2012;37;7763;3641;4122
Vilnius c. mun.;2012;38;7581;3634;3947
Vilnius c. mun.;2012;39;7610;3612;3998
Vilnius c. mun.;2012;40;7835;3775;4060
Vilnius c. mun.;2012;41;7398;3457;3941
Vilnius c. mun.;2012;42;7206;3407;3799
Vilnius c. mun.;2012;43;6979;3262;3717
Vilnius c. mun.;2012;44;6787;3093;3694
Vilnius c. mun.;2012;45;6894;3172;3722
Vilnius c. mun.;2012;46;6779;3042;3737
Vilnius c. mun.;2012;47;6990;3120;3870
Vilnius c. mun.;2012;48;7460;3368;4092
Vilnius c. mun.;2012;49;7519;3292;4227
Vilnius c. mun.;2012;50;8008;3525;4483
Vilnius c. mun.;2012;51;8126;3468;4658
Vilnius c. mun.;2012;52;7887;3385;4502
Vilnius c. mun.;2012;53;7866;3354;4512
Vilnius c. mun.;2012;54;7135;3048;4087
Vilnius c. mun.;2012;55;6658;2817;3841
Vilnius c. mun.;2012;56;6483;2672;3811
Vilnius c. mun.;2012;57;6327;2664;3663
Vilnius c. mun.;2012;58;5852;2308;3544
Vilnius c. mun.;2012;59;6203;2498;3705
Vilnius c. mun.;2012;60;6000;2410;3590
Vilnius c. mun.;2012;61;5798;2343;3455
Vilnius c. mun.;2012;62;6205;2346;3859
Vilnius c. mun.;2012;63;5581;2135;3446
Vilnius c. mun.;2012;64;5113;1971;3142
Vilnius c. mun.;2012;65;4658;1718;2940
Vilnius c. mun.;2012;66;4648;1663;2985
Vilnius c. mun.;2012;67;3914;1411;2503
Vilnius c. mun.;2012;68;4193;1566;2627
Vilnius c. mun.;2012;69;4542;1701;2841
Vilnius c. mun.;2012;70;4373;1684;2689
Vilnius c. mun.;2012;71;4607;1684;2923
Vilnius c. mun.;2012;72;4504;1608;2896
Vilnius c. mun.;2012;73;4696;1698;2998
Vilnius c. mun.;2012;74;4322;1497;2825
Vilnius c. mun.;2012;75;4140;1402;2738
Vilnius c. mun.;2012;76;3608;1213;2395
Vilnius c. mun.;2012;77;3146;1023;2123
Vilnius c. mun.;2012;78;3014;1011;2003
Vilnius c. mun.;2012;79;3157;1046;2111
Vilnius c. mun.;2012;80;2829;907;1922
Vilnius c. mun.;2012;81;2708;894;1814
Vilnius c. mun.;2012;82;2401;778;1623
Vilnius c. mun.;2012;83;2356;722;1634
Vilnius c. mun.;2012;84;1983;585;1398
Vilnius c. mun.;2012;85;7632;1661;5971
Vilnius c. mun.;2013;-1;537152;240662;296490
Vilnius c. mun.;2013;0;6380;3241;3139
Vilnius c. mun.;2013;1;6640;3403;3237
Vilnius c. mun.;2013;2;7459;3790;3669
Vilnius c. mun.;2013;3;6875;3514;3361
Vilnius c. mun.;2013;4;6275;3174;3101
Vilnius c. mun.;2013;5;5611;2856;2755
Vilnius c. mun.;2013;6;5333;2701;2632
Vilnius c. mun.;2013;7;4925;2477;2448
Vilnius c. mun.;2013;8;4640;2388;2252
Vilnius c. mun.;2013;9;4415;2272;2143
Vilnius c. mun.;2013;10;4286;2191;2095
Vilnius c. mun.;2013;11;4255;2143;2112
Vilnius c. mun.;2013;12;4627;2374;2253
Vilnius c. mun.;2013;13;4892;2505;2387
Vilnius c. mun.;2013;14;4916;2497;2419
Vilnius c. mun.;2013;15;4836;2546;2290
Vilnius c. mun.;2013;16;4858;2472;2386
Vilnius c. mun.;2013;17;5229;2663;2566
Vilnius c. mun.;2013;18;5267;2684;2583
Vilnius c. mun.;2013;19;5723;2897;2826
Vilnius c. mun.;2013;20;6406;3212;3194
Vilnius c. mun.;2013;21;8673;4144;4529
Vilnius c. mun.;2013;22;9014;4259;4755
Vilnius c. mun.;2013;23;8732;4124;4608
Vilnius c. mun.;2013;24;8809;4173;4636
Vilnius c. mun.;2013;25;9373;4440;4933
Vilnius c. mun.;2013;26;9910;4632;5278
Vilnius c. mun.;2013;27;9964;4631;5333
Vilnius c. mun.;2013;28;10236;4773;5463
Vilnius c. mun.;2013;29;10296;4897;5399
Vilnius c. mun.;2013;30;9295;4459;4836
Vilnius c. mun.;2013;31;9180;4438;4742
Vilnius c. mun.;2013;32;8834;4321;4513
Vilnius c. mun.;2013;33;8735;4190;4545
Vilnius c. mun.;2013;34;8539;4127;4412
Vilnius c. mun.;2013;35;8342;4058;4284
Vilnius c. mun.;2013;36;8153;3959;4194
Vilnius c. mun.;2013;37;7811;3597;4214
Vilnius c. mun.;2013;38;7782;3670;4112
Vilnius c. mun.;2013;39;7601;3666;3935
Vilnius c. mun.;2013;40;7548;3585;3963
Vilnius c. mun.;2013;41;7782;3738;4044
Vilnius c. mun.;2013;42;7374;3446;3928
Vilnius c. mun.;2013;43;7179;3392;3787
Vilnius c. mun.;2013;44;6936;3233;3703
Vilnius c. mun.;2013;45;6692;3042;3650
Vilnius c. mun.;2013;46;6851;3164;3687
Vilnius c. mun.;2013;47;6750;3034;3716
Vilnius c. mun.;2013;48;6928;3090;3838
Vilnius c. mun.;2013;49;7370;3317;4053
Vilnius c. mun.;2013;50;7414;3245;4169
Vilnius c. mun.;2013;51;7898;3457;4441
Vilnius c. mun.;2013;52;8014;3383;4631
Vilnius c. mun.;2013;53;7827;3347;4480
Vilnius c. mun.;2013;54;7750;3292;4458
Vilnius c. mun.;2013;55;7054;3012;4042
Vilnius c. mun.;2013;56;6559;2757;3802
Vilnius c. mun.;2013;57;6397;2611;3786
Vilnius c. mun.;2013;58;6234;2593;3641
Vilnius c. mun.;2013;59;5752;2258;3494
Vilnius c. mun.;2013;60;6114;2440;3674
Vilnius c. mun.;2013;61;5901;2353;3548
Vilnius c. mun.;2013;62;5691;2268;3423
Vilnius c. mun.;2013;63;6110;2286;3824
Vilnius c. mun.;2013;64;5460;2062;3398
Vilnius c. mun.;2013;65;4980;1879;3101
Vilnius c. mun.;2013;66;4561;1661;2900
Vilnius c. mun.;2013;67;4545;1605;2940
Vilnius c. mun.;2013;68;3842;1373;2469
Vilnius c. mun.;2013;69;4074;1492;2582
Vilnius c. mun.;2013;70;4422;1626;2796
Vilnius c. mun.;2013;71;4268;1615;2653
Vilnius c. mun.;2013;72;4503;1628;2875
Vilnius c. mun.;2013;73;4379;1534;2845
Vilnius c. mun.;2013;74;4543;1628;2915
Vilnius c. mun.;2013;75;4172;1417;2755
Vilnius c. mun.;2013;76;3995;1331;2664
Vilnius c. mun.;2013;77;3457;1134;2323
Vilnius c. mun.;2013;78;2994;940;2054
Vilnius c. mun.;2013;79;2856;932;1924
Vilnius c. mun.;2013;80;2977;971;2006
Vilnius c. mun.;2013;81;2644;826;1818
Vilnius c. mun.;2013;82;2520;828;1692
Vilnius c. mun.;2013;83;2207;709;1498
Vilnius c. mun.;2013;84;2154;659;1495
Vilnius c. mun.;2013;85;8347;1911;6436
Vilnius c. mun.;2014;-1;539707;241732;297975
Vilnius c. mun.;2014;0;6295;3169;3126
Vilnius c. mun.;2014;1;6591;3359;3232
Vilnius c. mun.;2014;2;6826;3511;3315
Vilnius c. mun.;2014;3;7489;3795;3694
Vilnius c. mun.;2014;4;6849;3517;3332
Vilnius c. mun.;2014;5;6224;3160;3064
Vilnius c. mun.;2014;6;5597;2858;2739
Vilnius c. mun.;2014;7;5368;2716;2652
Vilnius c. mun.;2014;8;4894;2454;2440
Vilnius c. mun.;2014;9;4606;2370;2236
Vilnius c. mun.;2014;10;4387;2256;2131
Vilnius c. mun.;2014;11;4260;2184;2076
Vilnius c. mun.;2014;12;4230;2134;2096
Vilnius c. mun.;2014;13;4592;2346;2246
Vilnius c. mun.;2014;14;4868;2490;2378
Vilnius c. mun.;2014;15;4926;2506;2420
Vilnius c. mun.;2014;16;4794;2521;2273
Vilnius c. mun.;2014;17;4827;2450;2377
Vilnius c. mun.;2014;18;5261;2679;2582
Vilnius c. mun.;2014;19;5231;2659;2572
Vilnius c. mun.;2014;20;5721;2903;2818
Vilnius c. mun.;2014;21;6425;3209;3216
Vilnius c. mun.;2014;22;8700;4157;4543
Vilnius c. mun.;2014;23;9073;4266;4807
Vilnius c. mun.;2014;24;8873;4183;4690
Vilnius c. mun.;2014;25;9056;4260;4796
Vilnius c. mun.;2014;26;9630;4506;5124
Vilnius c. mun.;2014;27;10222;4759;5463
Vilnius c. mun.;2014;28;10322;4774;5548
Vilnius c. mun.;2014;29;10569;4921;5648
Vilnius c. mun.;2014;30;10530;4984;5546
Vilnius c. mun.;2014;31;9451;4525;4926
Vilnius c. mun.;2014;32;9256;4466;4790
Vilnius c. mun.;2014;33;8935;4375;4560
Vilnius c. mun.;2014;34;8756;4203;4553
Vilnius c. mun.;2014;35;8563;4137;4426
Vilnius c. mun.;2014;36;8347;4032;4315
Vilnius c. mun.;2014;37;8166;3955;4211
Vilnius c. mun.;2014;38;7782;3577;4205
Vilnius c. mun.;2014;39;7744;3666;4078
Vilnius c. mun.;2014;40;7566;3644;3922
Vilnius c. mun.;2014;41;7514;3572;3942
Vilnius c. mun.;2014;42;7740;3711;4029
Vilnius c. mun.;2014;43;7302;3414;3888
Vilnius c. mun.;2014;44;7156;3380;3776
Vilnius c. mun.;2014;45;6837;3161;3676
Vilnius c. mun.;2014;46;6598;2980;3618
Vilnius c. mun.;2014;47;6796;3127;3669
Vilnius c. mun.;2014;48;6688;3002;3686
Vilnius c. mun.;2014;49;6876;3073;3803
Vilnius c. mun.;2014;50;7294;3266;4028
Vilnius c. mun.;2014;51;7363;3210;4153
Vilnius c. mun.;2014;52;7804;3403;4401
Vilnius c. mun.;2014;53;7915;3325;4590
Vilnius c. mun.;2014;54;7735;3283;4452
Vilnius c. mun.;2014;55;7649;3225;4424
Vilnius c. mun.;2014;56;6949;2944;4005
Vilnius c. mun.;2014;57;6483;2702;3781
Vilnius c. mun.;2014;58;6296;2541;3755
Vilnius c. mun.;2014;59;6143;2539;3604
Vilnius c. mun.;2014;60;5674;2198;3476
Vilnius c. mun.;2014;61;6029;2385;3644
Vilnius c. mun.;2014;62;5804;2294;3510
Vilnius c. mun.;2014;63;5579;2206;3373
Vilnius c. mun.;2014;64;5998;2217;3781
Vilnius c. mun.;2014;65;5328;1983;3345
Vilnius c. mun.;2014;66;4871;1802;3069
Vilnius c. mun.;2014;67;4436;1589;2847
Vilnius c. mun.;2014;68;4449;1536;2913
Vilnius c. mun.;2014;69;3752;1324;2428
Vilnius c. mun.;2014;70;3991;1433;2558
Vilnius c. mun.;2014;71;4291;1545;2746
Vilnius c. mun.;2014;72;4124;1534;2590
Vilnius c. mun.;2014;73;4394;1561;2833
Vilnius c. mun.;2014;74;4246;1475;2771
Vilnius c. mun.;2014;75;4383;1538;2845
Vilnius c. mun.;2014;76;4026;1336;2690
Vilnius c. mun.;2014;77;3866;1271;2595
Vilnius c. mun.;2014;78;3301;1053;2248
Vilnius c. mun.;2014;79;2859;883;1976
Vilnius c. mun.;2014;80;2671;858;1813
Vilnius c. mun.;2014;81;2775;864;1911
Vilnius c. mun.;2014;82;2466;754;1712
Vilnius c. mun.;2014;83;2319;755;1564
Vilnius c. mun.;2014;84;2001;638;1363
Vilnius c. mun.;2014;85;9134;2206;6928
Vilnius c. mun.;2015;-1;542626;243206;299420
Vilnius c. mun.;2015;0;6759;3475;3284
Vilnius c. mun.;2015;1;6442;3255;3187
Vilnius c. mun.;2015;2;6686;3397;3289
Vilnius c. mun.;2015;3;6799;3519;3280
Vilnius c. mun.;2015;4;7424;3774;3650
Vilnius c. mun.;2015;5;6793;3485;3308
Vilnius c. mun.;2015;6;6190;3149;3041
Vilnius c. mun.;2015;7;5537;2822;2715
Vilnius c. mun.;2015;8;5327;2675;2652
Vilnius c. mun.;2015;9;4862;2439;2423
Vilnius c. mun.;2015;10;4603;2371;2232
Vilnius c. mun.;2015;11;4392;2271;2121
Vilnius c. mun.;2015;12;4233;2168;2065
Vilnius c. mun.;2015;13;4205;2122;2083
Vilnius c. mun.;2015;14;4576;2334;2242
Vilnius c. mun.;2015;15;4888;2507;2381
Vilnius c. mun.;2015;16;4884;2483;2401
Vilnius c. mun.;2015;17;4770;2503;2267
Vilnius c. mun.;2015;18;4839;2449;2390
Vilnius c. mun.;2015;19;5206;2625;2581
Vilnius c. mun.;2015;20;5186;2623;2563
Vilnius c. mun.;2015;21;5713;2886;2827
Vilnius c. mun.;2015;22;6407;3193;3214
Vilnius c. mun.;2015;23;8713;4147;4566
Vilnius c. mun.;2015;24;9174;4299;4875
Vilnius c. mun.;2015;25;8971;4227;4744
Vilnius c. mun.;2015;26;9273;4341;4932
Vilnius c. mun.;2015;27;10010;4654;5356
Vilnius c. mun.;2015;28;10551;4897;5654
Vilnius c. mun.;2015;29;10705;4925;5780
Vilnius c. mun.;2015;30;10877;5070;5807
Vilnius c. mun.;2015;31;10813;5143;5670
Vilnius c. mun.;2015;32;9627;4638;4989
Vilnius c. mun.;2015;33;9360;4534;4826
Vilnius c. mun.;2015;34;9016;4433;4583
Vilnius c. mun.;2015;35;8787;4247;4540
Vilnius c. mun.;2015;36;8632;4197;4435
Vilnius c. mun.;2015;37;8377;4049;4328
Vilnius c. mun.;2015;38;8152;3940;4212
Vilnius c. mun.;2015;39;7787;3588;4199
Vilnius c. mun.;2015;40;7691;3627;4064
Vilnius c. mun.;2015;41;7528;3635;3893
Vilnius c. mun.;2015;42;7513;3583;3930
Vilnius c. mun.;2015;43;7709;3673;4036
Vilnius c. mun.;2015;44;7280;3394;3886
Vilnius c. mun.;2015;45;7105;3352;3753
Vilnius c. mun.;2015;46;6744;3101;3643
Vilnius c. mun.;2015;47;6559;2951;3608
Vilnius c. mun.;2015;48;6721;3082;3639
Vilnius c. mun.;2015;49;6637;2965;3672
Vilnius c. mun.;2015;50;6802;3028;3774
Vilnius c. mun.;2015;51;7212;3220;3992
Vilnius c. mun.;2015;52;7298;3168;4130
Vilnius c. mun.;2015;53;7755;3359;4396
Vilnius c. mun.;2015;54;7851;3285;4566
Vilnius c. mun.;2015;55;7624;3213;4411
Vilnius c. mun.;2015;56;7534;3142;4392
Vilnius c. mun.;2015;57;6832;2871;3961
Vilnius c. mun.;2015;58;6409;2660;3749
Vilnius c. mun.;2015;59;6189;2470;3719
Vilnius c. mun.;2015;60;6058;2474;3584
Vilnius c. mun.;2015;61;5599;2149;3450
Vilnius c. mun.;2015;62;5920;2319;3601
Vilnius c. mun.;2015;63;5700;2225;3475
Vilnius c. mun.;2015;64;5472;2136;3336
Vilnius c. mun.;2015;65;5861;2136;3725
Vilnius c. mun.;2015;66;5212;1910;3302
Vilnius c. mun.;2015;67;4767;1739;3028
Vilnius c. mun.;2015;68;4347;1525;2822
Vilnius c. mun.;2015;69;4333;1468;2865
Vilnius c. mun.;2015;70;3669;1278;2391
Vilnius c. mun.;2015;71;3867;1363;2504
Vilnius c. mun.;2015;72;4144;1463;2681
Vilnius c. mun.;2015;73;4015;1468;2547
Vilnius c. mun.;2015;74;4277;1489;2788
Vilnius c. mun.;2015;75;4102;1393;2709
Vilnius c. mun.;2015;76;4234;1463;2771
Vilnius c. mun.;2015;77;3865;1251;2614
Vilnius c. mun.;2015;78;3710;1198;2512
Vilnius c. mun.;2015;79;3149;985;2164
Vilnius c. mun.;2015;80;2711;823;1888
Vilnius c. mun.;2015;81;2507;789;1718
Vilnius c. mun.;2015;82;2573;786;1787
Vilnius c. mun.;2015;83;2278;684;1594
Vilnius c. mun.;2015;84;2148;693;1455
Vilnius c. mun.;2015;85;9569;2366;7203
Vilnius c. mun.;2016;-1;543493;243054;300439
Vilnius c. mun.;2016;0;6994;3642;3352
Vilnius c. mun.;2016;1;6942;3563;3379
Vilnius c. mun.;2016;2;6555;3324;3231
Vilnius c. mun.;2016;3;6687;3414;3273
Vilnius c. mun.;2016;4;6808;3521;3287
Vilnius c. mun.;2016;5;7413;3778;3635
Vilnius c. mun.;2016;6;6766;3461;3305
Vilnius c. mun.;2016;7;6162;3126;3036
Vilnius c. mun.;2016;8;5447;2770;2677
Vilnius c. mun.;2016;9;5270;2643;2627
Vilnius c. mun.;2016;10;4830;2427;2403
Vilnius c. mun.;2016;11;4555;2358;2197
Vilnius c. mun.;2016;12;4324;2229;2095
Vilnius c. mun.;2016;13;4173;2136;2037
Vilnius c. mun.;2016;14;4185;2108;2077
Vilnius c. mun.;2016;15;4603;2346;2257
Vilnius c. mun.;2016;16;4830;2485;2345
Vilnius c. mun.;2016;17;4856;2473;2383
Vilnius c. mun.;2016;18;4733;2473;2260
Vilnius c. mun.;2016;19;4777;2405;2372
Vilnius c. mun.;2016;20;5100;2562;2538
Vilnius c. mun.;2016;21;5072;2545;2527
Vilnius c. mun.;2016;22;5602;2808;2794
Vilnius c. mun.;2016;23;6361;3123;3238
Vilnius c. mun.;2016;24;8731;4110;4621
Vilnius c. mun.;2016;25;9319;4311;5008
Vilnius c. mun.;2016;26;9191;4287;4904
Vilnius c. mun.;2016;27;9534;4419;5115
Vilnius c. mun.;2016;28;10421;4813;5608
Vilnius c. mun.;2016;29;10916;5040;5876
Vilnius c. mun.;2016;30;11004;5053;5951
Vilnius c. mun.;2016;31;11151;5218;5933
Vilnius c. mun.;2016;32;10942;5193;5749
Vilnius c. mun.;2016;33;9745;4691;5054
Vilnius c. mun.;2016;34;9332;4523;4809
Vilnius c. mun.;2016;35;8929;4373;4556
Vilnius c. mun.;2016;36;8702;4183;4519
Vilnius c. mun.;2016;37;8575;4142;4433
Vilnius c. mun.;2016;38;8293;4004;4289
Vilnius c. mun.;2016;39;8021;3844;4177
Vilnius c. mun.;2016;40;7703;3521;4182
Vilnius c. mun.;2016;41;7619;3559;4060
Vilnius c. mun.;2016;42;7389;3530;3859
Vilnius c. mun.;2016;43;7411;3501;3910
Vilnius c. mun.;2016;44;7545;3564;3981
Vilnius c. mun.;2016;45;7151;3311;3840
Vilnius c. mun.;2016;46;6977;3253;3724
Vilnius c. mun.;2016;47;6674;3060;3614
Vilnius c. mun.;2016;48;6459;2885;3574
Vilnius c. mun.;2016;49;6632;3024;3608
Vilnius c. mun.;2016;50;6529;2884;3645
Vilnius c. mun.;2016;51;6712;2962;3750
Vilnius c. mun.;2016;52;7111;3154;3957
Vilnius c. mun.;2016;53;7199;3098;4101
Vilnius c. mun.;2016;54;7629;3275;4354
Vilnius c. mun.;2016;55;7685;3200;4485
Vilnius c. mun.;2016;56;7490;3124;4366
Vilnius c. mun.;2016;57;7417;3045;4372
Vilnius c. mun.;2016;58;6766;2828;3938
Vilnius c. mun.;2016;59;6295;2591;3704
Vilnius c. mun.;2016;60;6085;2402;3683
Vilnius c. mun.;2016;61;5976;2407;3569
Vilnius c. mun.;2016;62;5507;2082;3425
Vilnius c. mun.;2016;63;5822;2253;3569
Vilnius c. mun.;2016;64;5593;2154;3439
Vilnius c. mun.;2016;65;5358;2078;3280
Vilnius c. mun.;2016;66;5739;2064;3675
Vilnius c. mun.;2016;67;5063;1816;3247
Vilnius c. mun.;2016;68;4633;1655;2978
Vilnius c. mun.;2016;69;4231;1454;2777
Vilnius c. mun.;2016;70;4210;1382;2828
Vilnius c. mun.;2016;71;3586;1225;2361
Vilnius c. mun.;2016;72;3760;1305;2455
Vilnius c. mun.;2016;73;4034;1395;2639
Vilnius c. mun.;2016;74;3879;1385;2494
Vilnius c. mun.;2016;75;4142;1417;2725
Vilnius c. mun.;2016;76;3957;1321;2636
Vilnius c. mun.;2016;77;4058;1370;2688
Vilnius c. mun.;2016;78;3693;1174;2519
Vilnius c. mun.;2016;79;3523;1120;2403
Vilnius c. mun.;2016;80;2991;927;2064
Vilnius c. mun.;2016;81;2532;752;1780
Vilnius c. mun.;2016;82;2359;722;1637
Vilnius c. mun.;2016;83;2365;702;1663
Vilnius c. mun.;2016;84;2084;603;1481
Vilnius c. mun.;2016;85;10069;2596;7473
Vilnius c. mun.;2017;-1;545280;244437;300843
Vilnius c. mun.;2017;0;7189;3717;3472
Vilnius c. mun.;2017;1;7045;3654;3391
Vilnius c. mun.;2017;2;7035;3614;3421
Vilnius c. mun.;2017;3;6500;3296;3204
Vilnius c. mun.;2017;4;6608;3358;3250
Vilnius c. mun.;2017;5;6721;3480;3241
Vilnius c. mun.;2017;6;7378;3759;3619
Vilnius c. mun.;2017;7;6659;3419;3240
Vilnius c. mun.;2017;8;6053;3077;2976
Vilnius c. mun.;2017;9;5357;2741;2616
Vilnius c. mun.;2017;10;5204;2624;2580
Vilnius c. mun.;2017;11;4792;2401;2391
Vilnius c. mun.;2017;12;4502;2327;2175
Vilnius c. mun.;2017;13;4288;2208;2080
Vilnius c. mun.;2017;14;4141;2112;2029
Vilnius c. mun.;2017;15;4172;2110;2062
Vilnius c. mun.;2017;16;4542;2318;2224
Vilnius c. mun.;2017;17;4784;2462;2322
Vilnius c. mun.;2017;18;4849;2463;2386
Vilnius c. mun.;2017;19;4664;2450;2214
Vilnius c. mun.;2017;20;4725;2377;2348
Vilnius c. mun.;2017;21;5014;2533;2481
Vilnius c. mun.;2017;22;5052;2539;2513
Vilnius c. mun.;2017;23;5613;2833;2780
Vilnius c. mun.;2017;24;6419;3147;3272
Vilnius c. mun.;2017;25;8893;4176;4717
Vilnius c. mun.;2017;26;9573;4387;5186
Vilnius c. mun.;2017;27;9550;4444;5106
Vilnius c. mun.;2017;28;9881;4534;5347
Vilnius c. mun.;2017;29;10796;5002;5794
Vilnius c. mun.;2017;30;11292;5259;6033
Vilnius c. mun.;2017;31;11328;5232;6096
Vilnius c. mun.;2017;32;11390;5373;6017
Vilnius c. mun.;2017;33;11075;5286;5789
Vilnius c. mun.;2017;34;9815;4756;5059
Vilnius c. mun.;2017;35;9342;4567;4775
Vilnius c. mun.;2017;36;8900;4387;4513
Vilnius c. mun.;2017;37;8687;4194;4493
Vilnius c. mun.;2017;38;8494;4133;4361
Vilnius c. mun.;2017;39;8215;3960;4255
Vilnius c. mun.;2017;40;7951;3828;4123
Vilnius c. mun.;2017;41;7610;3488;4122
Vilnius c. mun.;2017;42;7546;3523;4023
Vilnius c. mun.;2017;43;7297;3494;3803
Vilnius c. mun.;2017;44;7357;3496;3861
Vilnius c. mun.;2017;45;7397;3490;3907
Vilnius c. mun.;2017;46;7069;3266;3803
Vilnius c. mun.;2017;47;6884;3201;3683
Vilnius c. mun.;2017;48;6612;3044;3568
Vilnius c. mun.;2017;49;6349;2814;3535
Vilnius c. mun.;2017;50;6548;2987;3561
Vilnius c. mun.;2017;51;6442;2850;3592
Vilnius c. mun.;2017;52;6623;2927;3696
Vilnius c. mun.;2017;53;7012;3111;3901
Vilnius c. mun.;2017;54;7064;3002;4062
Vilnius c. mun.;2017;55;7541;3222;4319
Vilnius c. mun.;2017;56;7559;3123;4436
Vilnius c. mun.;2017;57;7379;3049;4330
Vilnius c. mun.;2017;58;7308;2982;4326
Vilnius c. mun.;2017;59;6640;2746;3894
Vilnius c. mun.;2017;60;6182;2520;3662
Vilnius c. mun.;2017;61;5996;2328;3668
Vilnius c. mun.;2017;62;5863;2340;3523
Vilnius c. mun.;2017;63;5401;2004;3397
Vilnius c. mun.;2017;64;5715;2189;3526
Vilnius c. mun.;2017;65;5479;2086;3393
Vilnius c. mun.;2017;66;5236;1999;3237
Vilnius c. mun.;2017;67;5619;1987;3632
Vilnius c. mun.;2017;68;4952;1756;3196
Vilnius c. mun.;2017;69;4502;1581;2921
Vilnius c. mun.;2017;70;4127;1391;2736
Vilnius c. mun.;2017;71;4086;1317;2769
Vilnius c. mun.;2017;72;3483;1170;2313
Vilnius c. mun.;2017;73;3625;1231;2394
Vilnius c. mun.;2017;74;3925;1341;2584
Vilnius c. mun.;2017;75;3757;1319;2438
Vilnius c. mun.;2017;76;3997;1332;2665
Vilnius c. mun.;2017;77;3794;1234;2560
Vilnius c. mun.;2017;78;3902;1297;2605
Vilnius c. mun.;2017;79;3522;1089;2433
Vilnius c. mun.;2017;80;3340;1022;2318
Vilnius c. mun.;2017;81;2849;862;1987
Vilnius c. mun.;2017;82;2381;695;1686
Vilnius c. mun.;2017;83;2210;652;1558
Vilnius c. mun.;2017;84;2170;635;1535
Vilnius c. mun.;2017;85;10442;2708;7734
Vilnius c. mun.;2018;-1;547484;246324;301160
Vilnius c. mun.;2018;0;6853;3563;3290
Vilnius c. mun.;2018;1;7321;3780;3541
Vilnius c. mun.;2018;2;7124;3693;3431
Vilnius c. mun.;2018;3;6955;3583;3372
Vilnius c. mun.;2018;4;6397;3255;3142
Vilnius c. mun.;2018;5;6522;3311;3211
Vilnius c. mun.;2018;6;6686;3449;3237
Vilnius c. mun.;2018;7;7292;3710;3582
Vilnius c. mun.;2018;8;6572;3374;3198
Vilnius c. mun.;2018;9;6019;3056;2963
Vilnius c. mun.;2018;10;5336;2738;2598
Vilnius c. mun.;2018;11;5158;2599;2559
Vilnius c. mun.;2018;12;4745;2388;2357
Vilnius c. mun.;2018;13;4469;2319;2150
Vilnius c. mun.;2018;14;4284;2201;2083
Vilnius c. mun.;2018;15;4173;2129;2044
Vilnius c. mun.;2018;16;4137;2078;2059
Vilnius c. mun.;2018;17;4510;2299;2211
Vilnius c. mun.;2018;18;4767;2458;2309
Vilnius c. mun.;2018;19;4732;2402;2330
Vilnius c. mun.;2018;20;4631;2438;2193
Vilnius c. mun.;2018;21;4661;2346;2315
Vilnius c. mun.;2018;22;4957;2500;2457
Vilnius c. mun.;2018;23;4930;2494;2436
Vilnius c. mun.;2018;24;5534;2797;2737
Vilnius c. mun.;2018;25;6467;3143;3324
Vilnius c. mun.;2018;26;9115;4263;4852
Vilnius c. mun.;2018;27;9800;4487;5313
Vilnius c. mun.;2018;28;9809;4564;5245
Vilnius c. mun.;2018;29;10248;4738;5510
Vilnius c. mun.;2018;30;11075;5152;5923
Vilnius c. mun.;2018;31;11517;5411;6106
Vilnius c. mun.;2018;32;11531;5378;6153
Vilnius c. mun.;2018;33;11533;5492;6041
Vilnius c. mun.;2018;34;11212;5436;5776
Vilnius c. mun.;2018;35;9893;4837;5056
Vilnius c. mun.;2018;36;9382;4615;4767
Vilnius c. mun.;2018;37;8933;4446;4487
Vilnius c. mun.;2018;38;8647;4203;4444
Vilnius c. mun.;2018;39;8470;4125;4345
Vilnius c. mun.;2018;40;8198;3996;4202
Vilnius c. mun.;2018;41;7947;3834;4113
Vilnius c. mun.;2018;42;7564;3467;4097
Vilnius c. mun.;2018;43;7505;3507;3998
Vilnius c. mun.;2018;44;7252;3504;3748
Vilnius c. mun.;2018;45;7323;3488;3835
Vilnius c. mun.;2018;46;7379;3512;3867
Vilnius c. mun.;2018;47;6995;3228;3767
Vilnius c. mun.;2018;48;6826;3168;3658
Vilnius c. mun.;2018;49;6553;3012;3541
Vilnius c. mun.;2018;50;6322;2809;3513
Vilnius c. mun.;2018;51;6470;2958;3512
Vilnius c. mun.;2018;52;6387;2815;3572
Vilnius c. mun.;2018;53;6560;2896;3664
Vilnius c. mun.;2018;54;6916;3057;3859
Vilnius c. mun.;2018;55;6993;2961;4032
Vilnius c. mun.;2018;56;7446;3161;4285
Vilnius c. mun.;2018;57;7458;3058;4400
Vilnius c. mun.;2018;58;7276;2981;4295
Vilnius c. mun.;2018;59;7224;2934;4290
Vilnius c. mun.;2018;60;6561;2685;3876
Vilnius c. mun.;2018;61;6096;2455;3641
Vilnius c. mun.;2018;62;5946;2293;3653
Vilnius c. mun.;2018;63;5771;2280;3491
Vilnius c. mun.;2018;64;5323;1954;3369
Vilnius c. mun.;2018;65;5577;2094;3483
Vilnius c. mun.;2018;66;5374;2017;3357
Vilnius c. mun.;2018;67;5128;1938;3190
Vilnius c. mun.;2018;68;5509;1905;3604
Vilnius c. mun.;2018;69;4837;1692;3145
Vilnius c. mun.;2018;70;4388;1512;2876
Vilnius c. mun.;2018;71;4037;1330;2707
Vilnius c. mun.;2018;72;3977;1266;2711
Vilnius c. mun.;2018;73;3394;1130;2264
Vilnius c. mun.;2018;74;3519;1177;2342
Vilnius c. mun.;2018;75;3802;1277;2525
Vilnius c. mun.;2018;76;3622;1243;2379
Vilnius c. mun.;2018;77;3859;1266;2593
Vilnius c. mun.;2018;78;3660;1186;2474
Vilnius c. mun.;2018;79;3737;1209;2528
Vilnius c. mun.;2018;80;3344;1007;2337
Vilnius c. mun.;2018;81;3174;953;2221
Vilnius c. mun.;2018;82;2650;780;1870
Vilnius c. mun.;2018;83;2226;638;1588
Vilnius c. mun.;2018;84;2057;593;1464
Vilnius c. mun.;2018;85;10925;2848;8077
Vilnius county;2001;-1;850668;393465;457203
Vilnius county;2001;0;7941;4101;3840
Vilnius county;2001;1;8253;4258;3995
Vilnius county;2001;2;8084;4172;3912
Vilnius county;2001;3;8144;4281;3863
Vilnius county;2001;4;8197;4173;4024
Vilnius county;2001;5;8660;4445;4215
Vilnius county;2001;6;8852;4545;4307
Vilnius county;2001;7;9840;5034;4806
Vilnius county;2001;8;11124;5706;5418
Vilnius county;2001;9;11455;5826;5629
Vilnius county;2001;10;12114;6190;5924
Vilnius county;2001;11;11868;6042;5826
Vilnius county;2001;12;12179;6195;5984
Vilnius county;2001;13;12942;6703;6239
Vilnius county;2001;14;13245;6766;6479
Vilnius county;2001;15;12805;6519;6286
Vilnius county;2001;16;12792;6512;6280
Vilnius county;2001;17;12550;6465;6085
Vilnius county;2001;18;12887;6464;6423
Vilnius county;2001;19;14142;6973;7169
Vilnius county;2001;20;13762;6737;7025
Vilnius county;2001;21;13524;6552;6972
Vilnius county;2001;22;12940;6315;6625
Vilnius county;2001;23;12720;6255;6465
Vilnius county;2001;24;12425;6011;6414
Vilnius county;2001;25;11901;5848;6053
Vilnius county;2001;26;12127;5850;6277
Vilnius county;2001;27;12522;6298;6224
Vilnius county;2001;28;13141;6546;6595
Vilnius county;2001;29;13663;6863;6800
Vilnius county;2001;30;13288;6602;6686
Vilnius county;2001;31;12941;6440;6501
Vilnius county;2001;32;12819;6308;6511
Vilnius county;2001;33;12590;6116;6474
Vilnius county;2001;34;12865;6297;6568
Vilnius county;2001;35;12700;6203;6497
Vilnius county;2001;36;13153;6379;6774
Vilnius county;2001;37;13938;6832;7106
Vilnius county;2001;38;14130;6741;7389
Vilnius county;2001;39;14630;6945;7685
Vilnius county;2001;40;14114;6571;7543
Vilnius county;2001;41;14210;6624;7586
Vilnius county;2001;42;13366;6182;7184
Vilnius county;2001;43;12605;5887;6718
Vilnius county;2001;44;12123;5727;6396
Vilnius county;2001;45;11824;5558;6266
Vilnius county;2001;46;11153;5147;6006
Vilnius county;2001;47;10814;4912;5902
Vilnius county;2001;48;11489;5277;6212
Vilnius county;2001;49;11384;5213;6171
Vilnius county;2001;50;11165;5075;6090
Vilnius county;2001;51;11258;4963;6295
Vilnius county;2001;52;10117;4378;5739
Vilnius county;2001;53;9273;4086;5187
Vilnius county;2001;54;8697;3744;4953
Vilnius county;2001;55;9207;3969;5238
Vilnius county;2001;56;7924;3437;4487
Vilnius county;2001;57;8691;3711;4980
Vilnius county;2001;58;9522;4078;5444
Vilnius county;2001;59;8873;3862;5011
Vilnius county;2001;60;9163;3830;5333
Vilnius county;2001;61;8992;3766;5226
Vilnius county;2001;62;9211;3800;5411
Vilnius county;2001;63;8874;3633;5241
Vilnius county;2001;64;8754;3566;5188
Vilnius county;2001;65;8208;3375;4833
Vilnius county;2001;66;7459;2949;4510
Vilnius county;2001;67;7548;3060;4488
Vilnius county;2001;68;7784;3028;4756
Vilnius county;2001;69;7203;2713;4490
Vilnius county;2001;70;7381;2910;4471
Vilnius county;2001;71;6806;2554;4252
Vilnius county;2001;72;6799;2473;4326
Vilnius county;2001;73;6330;2221;4109
Vilnius county;2001;74;5591;1742;3849
Vilnius county;2001;75;5280;1493;3787
Vilnius county;2001;76;4648;1229;3419
Vilnius county;2001;77;4214;1116;3098
Vilnius county;2001;78;3696;1006;2690
Vilnius county;2001;79;3110;871;2239
Vilnius county;2001;80;2565;703;1862
Vilnius county;2001;81;2003;559;1444
Vilnius county;2001;82;1421;406;1015
Vilnius county;2001;83;1116;327;789
Vilnius county;2001;84;1177;301;876
Vilnius county;2001;85;7673;1925;5748
Vilnius county;2002;-1;845292;390423;454869
Vilnius county;2002;0;7197;3665;3532
Vilnius county;2002;1;7927;4100;3827
Vilnius county;2002;2;8249;4250;3999
Vilnius county;2002;3;8085;4184;3901
Vilnius county;2002;4;8125;4269;3856
Vilnius county;2002;5;8188;4173;4015
Vilnius county;2002;6;8642;4429;4213
Vilnius county;2002;7;8852;4540;4312
Vilnius county;2002;8;9823;5026;4797
Vilnius county;2002;9;11089;5671;5418
Vilnius county;2002;10;11437;5811;5626
Vilnius county;2002;11;12012;6125;5887
Vilnius county;2002;12;11769;5985;5784
Vilnius county;2002;13;11994;6094;5900
Vilnius county;2002;14;12811;6614;6197
Vilnius county;2002;15;13114;6678;6436
Vilnius county;2002;16;12714;6469;6245
Vilnius county;2002;17;12641;6424;6217
Vilnius county;2002;18;12481;6383;6098
Vilnius county;2002;19;12726;6335;6391
Vilnius county;2002;20;13975;6847;7128
Vilnius county;2002;21;13460;6560;6900
Vilnius county;2002;22;13236;6381;6855
Vilnius county;2002;23;12715;6178;6537
Vilnius county;2002;24;12458;6091;6367
Vilnius county;2002;25;12290;5964;6326
Vilnius county;2002;26;11785;5757;6028
Vilnius county;2002;27;12029;5754;6275
Vilnius county;2002;28;12403;6194;6209
Vilnius county;2002;29;12984;6451;6533
Vilnius county;2002;30;13481;6769;6712
Vilnius county;2002;31;13112;6514;6598
Vilnius county;2002;32;12758;6313;6445
Vilnius county;2002;33;12686;6214;6472
Vilnius county;2002;34;12495;6062;6433
Vilnius county;2002;35;12700;6188;6512
Vilnius county;2002;36;12574;6136;6438
Vilnius county;2002;37;12994;6273;6721
Vilnius county;2002;38;13774;6718;7056
Vilnius county;2002;39;13895;6591;7304
Vilnius county;2002;40;14415;6806;7609
Vilnius county;2002;41;13973;6498;7475
Vilnius county;2002;42;14108;6578;7530
Vilnius county;2002;43;13344;6198;7146
Vilnius county;2002;44;12459;5812;6647
Vilnius county;2002;45;11893;5598;6295
Vilnius county;2002;46;11670;5478;6192
Vilnius county;2002;47;11126;5147;5979
Vilnius county;2002;48;10635;4813;5822
Vilnius county;2002;49;11301;5178;6123
Vilnius county;2002;50;11237;5098;6139
Vilnius county;2002;51;10943;4953;5990
Vilnius county;2002;52;11193;4913;6280
Vilnius county;2002;53;10022;4346;5676
Vilnius county;2002;54;9109;4027;5082
Vilnius county;2002;55;8526;3654;4872
Vilnius county;2002;56;8987;3861;5126
Vilnius county;2002;57;7759;3366;4393
Vilnius county;2002;58;8488;3622;4866
Vilnius county;2002;59;9317;3968;5349
Vilnius county;2002;60;8766;3791;4975
Vilnius county;2002;61;9095;3780;5315
Vilnius county;2002;62;8939;3707;5232
Vilnius county;2002;63;9131;3722;5409
Vilnius county;2002;64;8807;3560;5247
Vilnius county;2002;65;8635;3494;5141
Vilnius county;2002;66;8080;3286;4794
Vilnius county;2002;67;7321;2884;4437
Vilnius county;2002;68;7426;2976;4450
Vilnius county;2002;69;7656;2941;4715
Vilnius county;2002;70;7100;2649;4451
Vilnius county;2002;71;7216;2808;4408
Vilnius county;2002;72;6657;2485;4172
Vilnius county;2002;73;6613;2388;4225
Vilnius county;2002;74;6172;2134;4038
Vilnius county;2002;75;5415;1663;3752
Vilnius county;2002;76;5107;1426;3681
Vilnius county;2002;77;4443;1159;3284
Vilnius county;2002;78;4043;1050;2993
Vilnius county;2002;79;3550;954;2596
Vilnius county;2002;80;2947;821;2126
Vilnius county;2002;81;2385;635;1750
Vilnius county;2002;82;1841;510;1331
Vilnius county;2002;83;1310;365;945
Vilnius county;2002;84;1017;280;737
Vilnius county;2002;85;7435;1861;5574
Vilnius county;2003;-1;843320;389212;454108
Vilnius county;2003;0;7032;3630;3402
Vilnius county;2003;1;7214;3667;3547
Vilnius county;2003;2;7935;4089;3846
Vilnius county;2003;3;8245;4247;3998
Vilnius county;2003;4;8093;4182;3911
Vilnius county;2003;5;8124;4269;3855
Vilnius county;2003;6;8185;4174;4011
Vilnius county;2003;7;8653;4434;4219
Vilnius county;2003;8;8867;4551;4316
Vilnius county;2003;9;9832;5033;4799
Vilnius county;2003;10;11048;5662;5386
Vilnius county;2003;11;11410;5800;5610
Vilnius county;2003;12;11935;6084;5851
Vilnius county;2003;13;11653;5926;5727
Vilnius county;2003;14;11861;6005;5856
Vilnius county;2003;15;12667;6527;6140
Vilnius county;2003;16;12987;6594;6393
Vilnius county;2003;17;12533;6350;6183
Vilnius county;2003;18;12537;6366;6171
Vilnius county;2003;19;12372;6303;6069
Vilnius county;2003;20;12595;6272;6323
Vilnius county;2003;21;13858;6800;7058
Vilnius county;2003;22;13358;6511;6847
Vilnius county;2003;23;13204;6343;6861
Vilnius county;2003;24;12690;6134;6556
Vilnius county;2003;25;12555;6142;6413
Vilnius county;2003;26;12397;6012;6385
Vilnius county;2003;27;11882;5771;6111
Vilnius county;2003;28;12100;5768;6332
Vilnius county;2003;29;12484;6230;6254
Vilnius county;2003;30;12993;6443;6550
Vilnius county;2003;31;13509;6785;6724
Vilnius county;2003;32;13107;6510;6597
Vilnius county;2003;33;12731;6296;6435
Vilnius county;2003;34;12640;6203;6437
Vilnius county;2003;35;12406;6006;6400
Vilnius county;2003;36;12645;6167;6478
Vilnius county;2003;37;12494;6090;6404
Vilnius county;2003;38;12895;6237;6658
Vilnius county;2003;39;13668;6677;6991
Vilnius county;2003;40;13796;6558;7238
Vilnius county;2003;41;14348;6793;7555
Vilnius county;2003;42;13917;6466;7451
Vilnius county;2003;43;14020;6532;7488
Vilnius county;2003;44;13292;6183;7109
Vilnius county;2003;45;12389;5768;6621
Vilnius county;2003;46;11811;5550;6261
Vilnius county;2003;47;11572;5415;6157
Vilnius county;2003;48;11058;5096;5962
Vilnius county;2003;49;10517;4745;5772
Vilnius county;2003;50;11191;5119;6072
Vilnius county;2003;51;11082;5021;6061
Vilnius county;2003;52;10815;4877;5938
Vilnius county;2003;53;11124;4885;6239
Vilnius county;2003;54;9921;4275;5646
Vilnius county;2003;55;8998;3945;5053
Vilnius county;2003;56;8425;3584;4841
Vilnius county;2003;57;8842;3768;5074
Vilnius county;2003;58;7628;3280;4348
Vilnius county;2003;59;8365;3552;4813
Vilnius county;2003;60;9143;3862;5281
Vilnius county;2003;61;8604;3691;4913
Vilnius county;2003;62;8994;3698;5296
Vilnius county;2003;63;8836;3651;5185
Vilnius county;2003;64;9015;3642;5373
Vilnius county;2003;65;8719;3482;5237
Vilnius county;2003;66;8530;3412;5118
Vilnius county;2003;67;7957;3207;4750
Vilnius county;2003;68;7146;2763;4383
Vilnius county;2003;69;7250;2850;4400
Vilnius county;2003;70;7481;2818;4663
Vilnius county;2003;71;6882;2511;4371
Vilnius county;2003;72;7008;2684;4324
Vilnius county;2003;73;6403;2351;4052
Vilnius county;2003;74;6399;2250;4149
Vilnius county;2003;75;5926;1997;3929
Vilnius county;2003;76;5196;1564;3632
Vilnius county;2003;77;4907;1325;3582
Vilnius county;2003;78;4205;1054;3151
Vilnius county;2003;79;3837;976;2861
Vilnius county;2003;80;3331;869;2462
Vilnius county;2003;81;2732;730;2002
Vilnius county;2003;82;2224;564;1660
Vilnius county;2003;83;1701;431;1270
Vilnius county;2003;84;1181;328;853
Vilnius county;2003;85;7208;1800;5408
Vilnius county;2004;-1;841748;388106;453642
Vilnius county;2004;0;7103;3690;3413
Vilnius county;2004;1;7008;3616;3392
Vilnius county;2004;2;7197;3661;3536
Vilnius county;2004;3;7899;4067;3832
Vilnius county;2004;4;8210;4223;3987
Vilnius county;2004;5;8067;4180;3887
Vilnius county;2004;6;8102;4261;3841
Vilnius county;2004;7;8172;4167;4005
Vilnius county;2004;8;8626;4417;4209
Vilnius county;2004;9;8865;4557;4308
Vilnius county;2004;10;9825;5021;4804
Vilnius county;2004;11;11001;5651;5350
Vilnius county;2004;12;11341;5761;5580
Vilnius county;2004;13;11817;6037;5780
Vilnius county;2004;14;11487;5856;5631
Vilnius county;2004;15;11743;5977;5766
Vilnius county;2004;16;12531;6470;6061
Vilnius county;2004;17;12828;6532;6296
Vilnius county;2004;18;12349;6274;6075
Vilnius county;2004;19;12420;6308;6112
Vilnius county;2004;20;12309;6242;6067
Vilnius county;2004;21;12494;6242;6252
Vilnius county;2004;22;13773;6749;7024
Vilnius county;2004;23;13296;6487;6809
Vilnius county;2004;24;13170;6295;6875
Vilnius county;2004;25;12796;6144;6652
Vilnius county;2004;26;12703;6174;6529
Vilnius county;2004;27;12586;6087;6499
Vilnius county;2004;28;12059;5823;6236
Vilnius county;2004;29;12223;5807;6416
Vilnius county;2004;30;12579;6258;6321
Vilnius county;2004;31;13055;6464;6591
Vilnius county;2004;32;13556;6822;6734
Vilnius county;2004;33;13135;6516;6619
Vilnius county;2004;34;12764;6320;6444
Vilnius county;2004;35;12644;6231;6413
Vilnius county;2004;36;12335;5968;6367
Vilnius county;2004;37;12546;6125;6421
Vilnius county;2004;38;12422;6056;6366
Vilnius county;2004;39;12785;6202;6583
Vilnius county;2004;40;13581;6639;6942
Vilnius county;2004;41;13689;6515;7174
Vilnius county;2004;42;14211;6728;7483
Vilnius county;2004;43;13874;6426;7448
Vilnius county;2004;44;13877;6443;7434
Vilnius county;2004;45;13266;6184;7082
Vilnius county;2004;46;12322;5742;6580
Vilnius county;2004;47;11736;5492;6244
Vilnius county;2004;48;11494;5365;6129
Vilnius county;2004;49;10970;5040;5930
Vilnius county;2004;50;10438;4683;5755
Vilnius county;2004;51;11088;5053;6035
Vilnius county;2004;52;10909;4943;5966
Vilnius county;2004;53;10714;4811;5903
Vilnius county;2004;54;11078;4854;6224
Vilnius county;2004;55;9816;4196;5620
Vilnius county;2004;56;8908;3880;5028
Vilnius county;2004;57;8315;3509;4806
Vilnius county;2004;58;8745;3707;5038
Vilnius county;2004;59;7542;3216;4326
Vilnius county;2004;60;8220;3450;4770
Vilnius county;2004;61;8983;3771;5212
Vilnius county;2004;62;8464;3592;4872
Vilnius county;2004;63;8871;3622;5249
Vilnius county;2004;64;8700;3547;5153
Vilnius county;2004;65;8946;3563;5383
Vilnius county;2004;66;8577;3354;5223
Vilnius county;2004;67;8402;3291;5111
Vilnius county;2004;68;7844;3092;4752
Vilnius county;2004;69;7003;2652;4351
Vilnius county;2004;70;7070;2718;4352
Vilnius county;2004;71;7324;2705;4619
Vilnius county;2004;72;6697;2392;4305
Vilnius county;2004;73;6850;2571;4279
Vilnius county;2004;74;6200;2215;3985
Vilnius county;2004;75;6163;2108;4055
Vilnius county;2004;76;5689;1864;3825
Vilnius county;2004;77;4993;1459;3534
Vilnius county;2004;78;4703;1238;3465
Vilnius county;2004;79;3974;956;3018
Vilnius county;2004;80;3564;859;2705
Vilnius county;2004;81;3077;773;2304
Vilnius county;2004;82;2545;654;1891
Vilnius county;2004;83;2015;492;1523
Vilnius county;2004;84;1520;370;1150
Vilnius county;2004;85;6960;1634;5326
Vilnius county;2005;-1;838556;386357;452199
Vilnius county;2005;0;7367;3782;3585
Vilnius county;2005;1;7096;3688;3408
Vilnius county;2005;2;6984;3608;3376
Vilnius county;2005;3;7170;3647;3523
Vilnius county;2005;4;7871;4059;3812
Vilnius county;2005;5;8194;4222;3972
Vilnius county;2005;6;8058;4174;3884
Vilnius county;2005;7;8100;4265;3835
Vilnius county;2005;8;8198;4183;4015
Vilnius county;2005;9;8633;4419;4214
Vilnius county;2005;10;8867;4562;4305
Vilnius county;2005;11;9829;5027;4802
Vilnius county;2005;12;10978;5632;5346
Vilnius county;2005;13;11308;5747;5561
Vilnius county;2005;14;11732;6000;5732
Vilnius county;2005;15;11393;5816;5577
Vilnius county;2005;16;11576;5884;5692
Vilnius county;2005;17;12358;6369;5989
Vilnius county;2005;18;12595;6402;6193
Vilnius county;2005;19;12134;6169;5965
Vilnius county;2005;20;12247;6212;6035
Vilnius county;2005;21;12189;6139;6050
Vilnius county;2005;22;12306;6138;6168
Vilnius county;2005;23;13593;6661;6932
Vilnius county;2005;24;13250;6432;6818
Vilnius county;2005;25;13083;6269;6814
Vilnius county;2005;26;12856;6149;6707
Vilnius county;2005;27;12884;6235;6649
Vilnius county;2005;28;12721;6138;6583
Vilnius county;2005;29;12237;5904;6333
Vilnius county;2005;30;12300;5844;6456
Vilnius county;2005;31;12615;6264;6351
Vilnius county;2005;32;13064;6449;6615
Vilnius county;2005;33;13570;6825;6745
Vilnius county;2005;34;13140;6509;6631
Vilnius county;2005;35;12722;6296;6426
Vilnius county;2005;36;12537;6185;6352
Vilnius county;2005;37;12203;5899;6304
Vilnius county;2005;38;12451;6066;6385
Vilnius county;2005;39;12326;6021;6305
Vilnius county;2005;40;12644;6116;6528
Vilnius county;2005;41;13448;6559;6889
Vilnius county;2005;42;13571;6439;7132
Vilnius county;2005;43;14117;6663;7454
Vilnius county;2005;44;13786;6376;7410
Vilnius county;2005;45;13758;6385;7373
Vilnius county;2005;46;13187;6126;7061
Vilnius county;2005;47;12237;5690;6547
Vilnius county;2005;48;11599;5403;6196
Vilnius county;2005;49;11389;5286;6103
Vilnius county;2005;50;10876;4976;5900
Vilnius county;2005;51;10307;4612;5695
Vilnius county;2005;52;10961;4977;5984
Vilnius county;2005;53;10750;4847;5903
Vilnius county;2005;54;10581;4733;5848
Vilnius county;2005;55;10948;4754;6194
Vilnius county;2005;56;9701;4110;5591
Vilnius county;2005;57;8780;3792;4988
Vilnius county;2005;58;8187;3436;4751
Vilnius county;2005;59;8623;3630;4993
Vilnius county;2005;60;7440;3156;4284
Vilnius county;2005;61;8044;3352;4692
Vilnius county;2005;62;8824;3678;5146
Vilnius county;2005;63;8296;3483;4813
Vilnius county;2005;64;8686;3504;5182
Vilnius county;2005;65;8537;3446;5091
Vilnius county;2005;66;8770;3446;5324
Vilnius county;2005;67;8396;3241;5155
Vilnius county;2005;68;8205;3166;5039
Vilnius county;2005;69;7603;2937;4666
Vilnius county;2005;70;6816;2544;4272
Vilnius county;2005;71;6842;2599;4243
Vilnius county;2005;72;7071;2562;4509
Vilnius county;2005;73;6472;2255;4217
Vilnius county;2005;74;6562;2399;4163
Vilnius county;2005;75;5914;2068;3846
Vilnius county;2005;76;5888;1973;3915
Vilnius county;2005;77;5425;1733;3692
Vilnius county;2005;78;4745;1350;3395
Vilnius county;2005;79;4430;1122;3308
Vilnius county;2005;80;3720;874;2846
Vilnius county;2005;81;3320;773;2547
Vilnius county;2005;82;2842;703;2139
Vilnius county;2005;83;2336;573;1763
Vilnius county;2005;84;1833;444;1389
Vilnius county;2005;85;7354;1776;5578
Vilnius county;2006;-1;831237;382594;448643
Vilnius county;2006;0;7667;3892;3775
Vilnius county;2006;1;7336;3764;3572
Vilnius county;2006;2;7031;3662;3369
Vilnius county;2006;3;6931;3596;3335
Vilnius county;2006;4;7105;3620;3485
Vilnius county;2006;5;7856;4044;3812
Vilnius county;2006;6;8179;4225;3954
Vilnius county;2006;7;8064;4170;3894
Vilnius county;2006;8;8102;4268;3834
Vilnius county;2006;9;8192;4202;3990
Vilnius county;2006;10;8644;4433;4211
Vilnius county;2006;11;8889;4580;4309
Vilnius county;2006;12;9849;5039;4810
Vilnius county;2006;13;10832;5557;5275
Vilnius county;2006;14;11226;5709;5517
Vilnius county;2006;15;11504;5895;5609
Vilnius county;2006;16;11146;5660;5486
Vilnius county;2006;17;11336;5741;5595
Vilnius county;2006;18;12030;6201;5829
Vilnius county;2006;19;12147;6152;5995
Vilnius county;2006;20;11689;5923;5766
Vilnius county;2006;21;11713;5923;5790
Vilnius county;2006;22;11775;5955;5820
Vilnius county;2006;23;12035;5972;6063
Vilnius county;2006;24;13259;6463;6796
Vilnius county;2006;25;13025;6314;6711
Vilnius county;2006;26;12927;6182;6745
Vilnius county;2006;27;12780;6113;6667
Vilnius county;2006;28;12883;6245;6638
Vilnius county;2006;29;12780;6174;6606
Vilnius county;2006;30;12290;5933;6357
Vilnius county;2006;31;12289;5828;6461
Vilnius county;2006;32;12515;6223;6292
Vilnius county;2006;33;12923;6363;6560
Vilnius county;2006;34;13422;6746;6676
Vilnius county;2006;35;13012;6425;6587
Vilnius county;2006;36;12591;6214;6377
Vilnius county;2006;37;12381;6083;6298
Vilnius county;2006;38;12050;5818;6232
Vilnius county;2006;39;12289;5956;6333
Vilnius county;2006;40;12142;5899;6243
Vilnius county;2006;41;12474;6006;6468
Vilnius county;2006;42;13276;6456;6820
Vilnius county;2006;43;13366;6321;7045
Vilnius county;2006;44;13973;6573;7400
Vilnius county;2006;45;13735;6344;7391
Vilnius county;2006;46;13629;6315;7314
Vilnius county;2006;47;13142;6102;7040
Vilnius county;2006;48;12154;5654;6500
Vilnius county;2006;49;11443;5297;6146
Vilnius county;2006;50;11272;5232;6040
Vilnius county;2006;51;10766;4905;5861
Vilnius county;2006;52;10150;4518;5632
Vilnius county;2006;53;10787;4873;5914
Vilnius county;2006;54;10580;4732;5848
Vilnius county;2006;55;10457;4658;5799
Vilnius county;2006;56;10830;4660;6170
Vilnius county;2006;57;9608;4037;5571
Vilnius county;2006;58;8694;3736;4958
Vilnius county;2006;59;8056;3340;4716
Vilnius county;2006;60;8474;3538;4936
Vilnius county;2006;61;7310;3061;4249
Vilnius county;2006;62;7899;3257;4642
Vilnius county;2006;63;8677;3580;5097
Vilnius county;2006;64;8185;3410;4775
Vilnius county;2006;65;8485;3374;5111
Vilnius county;2006;66;8345;3329;5016
Vilnius county;2006;67;8606;3340;5266
Vilnius county;2006;68;8226;3133;5093
Vilnius county;2006;69;8002;3041;4961
Vilnius county;2006;70;7399;2806;4593
Vilnius county;2006;71;6625;2433;4192
Vilnius county;2006;72;6610;2469;4141
Vilnius county;2006;73;6852;2458;4394
Vilnius county;2006;74;6241;2149;4092
Vilnius county;2006;75;6278;2264;4014
Vilnius county;2006;76;5663;1940;3723
Vilnius county;2006;77;5610;1851;3759
Vilnius county;2006;78;5146;1617;3529
Vilnius county;2006;79;4465;1251;3214
Vilnius county;2006;80;4156;1028;3128
Vilnius county;2006;81;3483;784;2699
Vilnius county;2006;82;3055;678;2377
Vilnius county;2006;83;2546;619;1927
Vilnius county;2006;84;2105;510;1595
Vilnius county;2006;85;7566;1753;5813
Vilnius county;2007;-1;828191;380558;447633
Vilnius county;2007;0;7930;4023;3907
Vilnius county;2007;1;7622;3878;3744
Vilnius county;2007;2;7295;3746;3549
Vilnius county;2007;3;7035;3658;3377
Vilnius county;2007;4;6936;3588;3348
Vilnius county;2007;5;7102;3606;3496
Vilnius county;2007;6;7863;4043;3820
Vilnius county;2007;7;8172;4223;3949
Vilnius county;2007;8;8065;4166;3899
Vilnius county;2007;9;8117;4264;3853
Vilnius county;2007;10;8219;4209;4010
Vilnius county;2007;11;8669;4437;4232
Vilnius county;2007;12;8896;4577;4319
Vilnius county;2007;13;9871;5059;4812
Vilnius county;2007;14;10838;5566;5272
Vilnius county;2007;15;11228;5713;5515
Vilnius county;2007;16;11440;5864;5576
Vilnius county;2007;17;11050;5613;5437
Vilnius county;2007;18;11217;5688;5529
Vilnius county;2007;19;11892;6117;5775
Vilnius county;2007;20;11984;6053;5931
Vilnius county;2007;21;11524;5805;5719
Vilnius county;2007;22;11521;5787;5734
Vilnius county;2007;23;11607;5822;5785
Vilnius county;2007;24;11924;5856;6068
Vilnius county;2007;25;13233;6429;6804
Vilnius county;2007;26;13020;6289;6731
Vilnius county;2007;27;12956;6160;6796
Vilnius county;2007;28;12846;6108;6738
Vilnius county;2007;29;12888;6229;6659
Vilnius county;2007;30;12822;6179;6643
Vilnius county;2007;31;12361;5955;6406
Vilnius county;2007;32;12307;5837;6470
Vilnius county;2007;33;12500;6182;6318
Vilnius county;2007;34;12934;6350;6584
Vilnius county;2007;35;13392;6703;6689
Vilnius county;2007;36;12961;6400;6561
Vilnius county;2007;37;12540;6190;6350
Vilnius county;2007;38;12350;6057;6293
Vilnius county;2007;39;11965;5769;6196
Vilnius county;2007;40;12194;5904;6290
Vilnius county;2007;41;12048;5844;6204
Vilnius county;2007;42;12394;5946;6448
Vilnius county;2007;43;13153;6378;6775
Vilnius county;2007;44;13207;6216;6991
Vilnius county;2007;45;13869;6524;7345
Vilnius county;2007;46;13688;6324;7364
Vilnius county;2007;47;13516;6239;7277
Vilnius county;2007;48;13067;6026;7041
Vilnius county;2007;49;12094;5607;6487
Vilnius county;2007;50;11317;5213;6104
Vilnius county;2007;51;11128;5135;5993
Vilnius county;2007;52;10661;4855;5806
Vilnius county;2007;53;10058;4447;5611
Vilnius county;2007;54;10652;4751;5901
Vilnius county;2007;55;10429;4633;5796
Vilnius county;2007;56;10297;4555;5742
Vilnius county;2007;57;10691;4565;6126
Vilnius county;2007;58;9476;3954;5522
Vilnius county;2007;59;8551;3634;4917
Vilnius county;2007;60;7910;3243;4667
Vilnius county;2007;61;8346;3451;4895
Vilnius county;2007;62;7164;2966;4198
Vilnius county;2007;63;7741;3138;4603
Vilnius county;2007;64;8475;3453;5022
Vilnius county;2007;65;8000;3297;4703
Vilnius county;2007;66;8287;3234;5053
Vilnius county;2007;67;8120;3191;4929
Vilnius county;2007;68;8405;3207;5198
Vilnius county;2007;69;7988;2983;5005
Vilnius county;2007;70;7822;2930;4892
Vilnius county;2007;71;7157;2657;4500
Vilnius county;2007;72;6435;2308;4127
Vilnius county;2007;73;6372;2329;4043
Vilnius county;2007;74;6568;2304;4264
Vilnius county;2007;75;5971;2017;3954
Vilnius county;2007;76;5995;2108;3887
Vilnius county;2007;77;5370;1790;3580
Vilnius county;2007;78;5303;1708;3595
Vilnius county;2007;79;4801;1482;3319
Vilnius county;2007;80;4174;1137;3037
Vilnius county;2007;81;3832;923;2909
Vilnius county;2007;82;3175;688;2487
Vilnius county;2007;83;2766;591;2175
Vilnius county;2007;84;2304;552;1752
Vilnius county;2007;85;8128;1923;6205
Vilnius county;2008;-1;826306;379065;447241
Vilnius county;2008;0;8279;4271;4008
Vilnius county;2008;1;7900;4007;3893
Vilnius county;2008;2;7607;3880;3727
Vilnius county;2008;3;7297;3745;3552
Vilnius county;2008;4;7029;3649;3380
Vilnius county;2008;5;6930;3585;3345
Vilnius county;2008;6;7087;3595;3492
Vilnius county;2008;7;7892;4060;3832
Vilnius county;2008;8;8190;4240;3950
Vilnius county;2008;9;8099;4183;3916
Vilnius county;2008;10;8142;4278;3864
Vilnius county;2008;11;8235;4224;4011
Vilnius county;2008;12;8698;4453;4245
Vilnius county;2008;13;8898;4575;4323
Vilnius county;2008;14;9892;5075;4817
Vilnius county;2008;15;10841;5566;5275
Vilnius county;2008;16;11236;5719;5517
Vilnius county;2008;17;11385;5851;5534
Vilnius county;2008;18;10990;5590;5400
Vilnius county;2008;19;11113;5631;5482
Vilnius county;2008;20;11783;6075;5708
Vilnius county;2008;21;11834;5990;5844
Vilnius county;2008;22;11387;5726;5661
Vilnius county;2008;23;11439;5721;5718
Vilnius county;2008;24;11638;5793;5845
Vilnius county;2008;25;11937;5799;6138
Vilnius county;2008;26;13305;6402;6903
Vilnius county;2008;27;13085;6298;6787
Vilnius county;2008;28;13043;6181;6862
Vilnius county;2008;29;12923;6145;6778
Vilnius county;2008;30;12970;6273;6697
Vilnius county;2008;31;12841;6165;6676
Vilnius county;2008;32;12379;5963;6416
Vilnius county;2008;33;12359;5847;6512
Vilnius county;2008;34;12487;6170;6317
Vilnius county;2008;35;12923;6314;6609
Vilnius county;2008;36;13377;6695;6682
Vilnius county;2008;37;12933;6377;6556
Vilnius county;2008;38;12466;6140;6326
Vilnius county;2008;39;12302;6032;6270
Vilnius county;2008;40;11908;5736;6172
Vilnius county;2008;41;12110;5854;6256
Vilnius county;2008;42;11939;5775;6164
Vilnius county;2008;43;12290;5882;6408
Vilnius county;2008;44;13021;6284;6737
Vilnius county;2008;45;13085;6132;6953
Vilnius county;2008;46;13744;6443;7301
Vilnius county;2008;47;13593;6248;7345
Vilnius county;2008;48;13398;6163;7235
Vilnius county;2008;49;12952;5927;7025
Vilnius county;2008;50;12022;5554;6468
Vilnius county;2008;51;11196;5125;6071
Vilnius county;2008;52;11015;5058;5957
Vilnius county;2008;53;10517;4742;5775
Vilnius county;2008;54;9918;4355;5563
Vilnius county;2008;55;10507;4647;5860
Vilnius county;2008;56;10249;4518;5731
Vilnius county;2008;57;10143;4440;5703
Vilnius county;2008;58;10538;4441;6097
Vilnius county;2008;59;9319;3850;5469
Vilnius county;2008;60;8363;3487;4876
Vilnius county;2008;61;7736;3117;4619
Vilnius county;2008;62;8181;3337;4844
Vilnius county;2008;63;7020;2860;4160
Vilnius county;2008;64;7594;3040;4554
Vilnius county;2008;65;8279;3319;4960
Vilnius county;2008;66;7828;3182;4646
Vilnius county;2008;67;8108;3109;4999
Vilnius county;2008;68;7917;3055;4862
Vilnius county;2008;69;8189;3056;5133
Vilnius county;2008;70;7724;2822;4902
Vilnius county;2008;71;7579;2772;4807
Vilnius county;2008;72;6925;2507;4418
Vilnius county;2008;73;6207;2173;4034
Vilnius county;2008;74;6113;2190;3923
Vilnius county;2008;75;6307;2177;4130
Vilnius county;2008;76;5733;1894;3839
Vilnius county;2008;77;5690;1958;3732
Vilnius county;2008;78;5090;1656;3434
Vilnius county;2008;79;4987;1578;3409
Vilnius county;2008;80;4476;1350;3126
Vilnius county;2008;81;3888;1018;2870
Vilnius county;2008;82;3501;802;2699
Vilnius county;2008;83;2917;613;2304
Vilnius county;2008;84;2471;525;1946
Vilnius county;2008;85;8868;2011;6857
Vilnius county;2009;-1;826445;378913;447532
Vilnius county;2009;0;8973;4606;4367
Vilnius county;2009;1;8257;4256;4001
Vilnius county;2009;2;7877;4000;3877
Vilnius county;2009;3;7588;3870;3718
Vilnius county;2009;4;7303;3762;3541
Vilnius county;2009;5;7044;3653;3391
Vilnius county;2009;6;6944;3598;3346
Vilnius county;2009;7;7115;3609;3506
Vilnius county;2009;8;7912;4069;3843
Vilnius county;2009;9;8203;4250;3953
Vilnius county;2009;10;8120;4190;3930
Vilnius county;2009;11;8152;4282;3870
Vilnius county;2009;12;8252;4227;4025
Vilnius county;2009;13;8717;4458;4259
Vilnius county;2009;14;8925;4587;4338
Vilnius county;2009;15;9897;5076;4821
Vilnius county;2009;16;10858;5574;5284
Vilnius county;2009;17;11212;5705;5507
Vilnius county;2009;18;11363;5838;5525
Vilnius county;2009;19;10956;5555;5401
Vilnius county;2009;20;11044;5581;5463
Vilnius county;2009;21;11715;6011;5704
Vilnius county;2009;22;11807;5965;5842
Vilnius county;2009;23;11397;5719;5678
Vilnius county;2009;24;11510;5737;5773
Vilnius county;2009;25;11794;5862;5932
Vilnius county;2009;26;12034;5817;6217
Vilnius county;2009;27;13366;6428;6938
Vilnius county;2009;28;13177;6329;6848
Vilnius county;2009;29;13139;6219;6920
Vilnius county;2009;30;13033;6202;6831
Vilnius county;2009;31;13005;6285;6720
Vilnius county;2009;32;12894;6188;6706
Vilnius county;2009;33;12430;5980;6450
Vilnius county;2009;34;12401;5879;6522
Vilnius county;2009;35;12446;6129;6317
Vilnius county;2009;36;12909;6305;6604
Vilnius county;2009;37;13370;6689;6681
Vilnius county;2009;38;12930;6356;6574
Vilnius county;2009;39;12473;6156;6317
Vilnius county;2009;40;12286;6018;6268
Vilnius county;2009;41;11896;5722;6174
Vilnius county;2009;42;12036;5801;6235
Vilnius county;2009;43;11885;5718;6167
Vilnius county;2009;44;12232;5849;6383
Vilnius county;2009;45;12903;6195;6708
Vilnius county;2009;46;12973;6052;6921
Vilnius county;2009;47;13667;6394;7273
Vilnius county;2009;48;13533;6215;7318
Vilnius county;2009;49;13290;6086;7204
Vilnius county;2009;50;12869;5856;7013
Vilnius county;2009;51;11879;5440;6439
Vilnius county;2009;52;11080;5042;6038
Vilnius county;2009;53;10885;4970;5915
Vilnius county;2009;54;10397;4653;5744
Vilnius county;2009;55;9782;4249;5533
Vilnius county;2009;56;10370;4543;5827
Vilnius county;2009;57;10112;4428;5684
Vilnius county;2009;58;9998;4342;5656
Vilnius county;2009;59;10337;4297;6040
Vilnius county;2009;60;9172;3744;5428
Vilnius county;2009;61;8199;3375;4824
Vilnius county;2009;62;7581;3005;4576
Vilnius county;2009;63;8018;3221;4797
Vilnius county;2009;64;6873;2771;4102
Vilnius county;2009;65;7422;2934;4488
Vilnius county;2009;66;8072;3187;4885
Vilnius county;2009;67;7642;3054;4588
Vilnius county;2009;68;7923;2989;4934
Vilnius county;2009;69;7708;2925;4783
Vilnius county;2009;70;7966;2920;5046
Vilnius county;2009;71;7458;2669;4789
Vilnius county;2009;72;7347;2627;4720
Vilnius county;2009;73;6685;2386;4299
Vilnius county;2009;74;5970;2050;3920
Vilnius county;2009;75;5863;2059;3804
Vilnius county;2009;76;6012;2037;3975
Vilnius county;2009;77;5482;1764;3718
Vilnius county;2009;78;5405;1835;3570
Vilnius county;2009;79;4805;1535;3270
Vilnius county;2009;80;4675;1443;3232
Vilnius county;2009;81;4135;1214;2921
Vilnius county;2009;82;3591;916;2675
Vilnius county;2009;83;3209;713;2496
Vilnius county;2009;84;2636;540;2096
Vilnius county;2009;85;9644;2128;7516
Vilnius county;2010;-1;824193;376675;447518
Vilnius county;2010;0;9505;4857;4648
Vilnius county;2010;1;8921;4564;4357
Vilnius county;2010;2;8181;4217;3964
Vilnius county;2010;3;7860;4004;3856
Vilnius county;2010;4;7571;3856;3715
Vilnius county;2010;5;7290;3753;3537
Vilnius county;2010;6;7076;3676;3400
Vilnius county;2010;7;6950;3591;3359
Vilnius county;2010;8;7116;3612;3504
Vilnius county;2010;9;7926;4074;3852
Vilnius county;2010;10;8218;4246;3972
Vilnius county;2010;11;8134;4191;3943
Vilnius county;2010;12;8168;4282;3886
Vilnius county;2010;13;8274;4243;4031
Vilnius county;2010;14;8755;4487;4268
Vilnius county;2010;15;8956;4612;4344
Vilnius county;2010;16;9891;5068;4823
Vilnius county;2010;17;10864;5570;5294
Vilnius county;2010;18;11196;5706;5490
Vilnius county;2010;19;11354;5820;5534
Vilnius county;2010;20;10842;5492;5350
Vilnius county;2010;21;10911;5525;5386
Vilnius county;2010;22;11526;5871;5655
Vilnius county;2010;23;11628;5837;5791
Vilnius county;2010;24;11288;5594;5694
Vilnius county;2010;25;11487;5670;5817
Vilnius county;2010;26;11790;5832;5958
Vilnius county;2010;27;11957;5711;6246
Vilnius county;2010;28;13241;6300;6941
Vilnius county;2010;29;13135;6271;6864
Vilnius county;2010;30;13163;6227;6936
Vilnius county;2010;31;12984;6144;6840
Vilnius county;2010;32;13009;6301;6708
Vilnius county;2010;33;12846;6137;6709
Vilnius county;2010;34;12331;5903;6428
Vilnius county;2010;35;12284;5801;6483
Vilnius county;2010;36;12342;6050;6292
Vilnius county;2010;37;12776;6206;6570
Vilnius county;2010;38;13245;6569;6676
Vilnius county;2010;39;12806;6255;6551
Vilnius county;2010;40;12353;6056;6297
Vilnius county;2010;41;12162;5917;6245
Vilnius county;2010;42;11766;5598;6168
Vilnius county;2010;43;11899;5680;6219
Vilnius county;2010;44;11758;5608;6150
Vilnius county;2010;45;12050;5716;6334
Vilnius county;2010;46;12755;6064;6691
Vilnius county;2010;47;12838;5947;6891
Vilnius county;2010;48;13532;6291;7241
Vilnius county;2010;49;13392;6111;7281
Vilnius county;2010;50;13161;5972;7189
Vilnius county;2010;51;12763;5779;6984
Vilnius county;2010;52;11780;5345;6435
Vilnius county;2010;53;10980;4959;6021
Vilnius county;2010;54;10774;4884;5890
Vilnius county;2010;55;10253;4550;5703
Vilnius county;2010;56;9642;4150;5492
Vilnius county;2010;57;10248;4448;5800
Vilnius county;2010;58;9993;4335;5658
Vilnius county;2010;59;9837;4228;5609
Vilnius county;2010;60;10190;4189;6001
Vilnius county;2010;61;9018;3659;5359
Vilnius county;2010;62;8052;3268;4784
Vilnius county;2010;63;7465;2932;4533
Vilnius county;2010;64;7860;3104;4756
Vilnius county;2010;65;6739;2673;4066
Vilnius county;2010;66;7296;2838;4458
Vilnius county;2010;67;7904;3063;4841
Vilnius county;2010;68;7457;2933;4524
Vilnius county;2010;69;7737;2873;4864
Vilnius county;2010;70;7497;2790;4707
Vilnius county;2010;71;7772;2814;4958
Vilnius county;2010;72;7248;2552;4696
Vilnius county;2010;73;7135;2503;4632
Vilnius county;2010;74;6444;2256;4188
Vilnius county;2010;75;5738;1924;3814
Vilnius county;2010;76;5604;1930;3674
Vilnius county;2010;77;5709;1881;3828
Vilnius county;2010;78;5205;1642;3563
Vilnius county;2010;79;5076;1670;3406
Vilnius county;2010;80;4502;1381;3121
Vilnius county;2010;81;4361;1322;3039
Vilnius county;2010;82;3831;1099;2732
Vilnius county;2010;83;3276;819;2457
Vilnius county;2010;84;2912;622;2290
Vilnius county;2010;85;10432;2175;8257
Vilnius county;2011;-1;811515;370353;441162
Vilnius county;2011;0;9960;5046;4914
Vilnius county;2011;1;9853;5030;4823
Vilnius county;2011;2;9103;4629;4474
Vilnius county;2011;3;8342;4281;4061
Vilnius county;2011;4;7898;4027;3871
Vilnius county;2011;5;7659;3870;3789
Vilnius county;2011;6;7302;3748;3554
Vilnius county;2011;7;7027;3644;3383
Vilnius county;2011;8;6880;3554;3326
Vilnius county;2011;9;7123;3614;3509
Vilnius county;2011;10;7638;3956;3682
Vilnius county;2011;11;8008;4149;3859
Vilnius county;2011;12;8026;4107;3919
Vilnius county;2011;13;8119;4255;3864
Vilnius county;2011;14;8124;4153;3971
Vilnius county;2011;15;8583;4407;4176
Vilnius county;2011;16;8787;4527;4260
Vilnius county;2011;17;9753;4982;4771
Vilnius county;2011;18;10819;5481;5338
Vilnius county;2011;19;12625;6231;6394
Vilnius county;2011;20;13118;6478;6640
Vilnius county;2011;21;12524;6116;6408
Vilnius county;2011;22;12698;6185;6513
Vilnius county;2011;23;13028;6496;6532
Vilnius county;2011;24;13282;6472;6810
Vilnius county;2011;25;13150;6389;6761
Vilnius county;2011;26;13155;6414;6741
Vilnius county;2011;27;13439;6638;6801
Vilnius county;2011;28;12275;5985;6290
Vilnius county;2011;29;12296;6056;6240
Vilnius county;2011;30;12068;5977;6091
Vilnius county;2011;31;12124;5894;6230
Vilnius county;2011;32;12052;5837;6215
Vilnius county;2011;33;12030;5942;6088
Vilnius county;2011;34;11932;5817;6115
Vilnius county;2011;35;11499;5544;5955
Vilnius county;2011;36;11560;5548;6012
Vilnius county;2011;37;11540;5617;5923
Vilnius county;2011;38;11708;5619;6089
Vilnius county;2011;39;12086;5895;6191
Vilnius county;2011;40;11640;5571;6069
Vilnius county;2011;41;11460;5554;5906
Vilnius county;2011;42;11234;5411;5823
Vilnius county;2011;43;10959;5172;5787
Vilnius county;2011;44;11085;5271;5814
Vilnius county;2011;45;10956;5149;5807
Vilnius county;2011;46;11318;5322;5996
Vilnius county;2011;47;11943;5620;6323
Vilnius county;2011;48;12047;5532;6515
Vilnius county;2011;49;12745;5865;6880
Vilnius county;2011;50;12761;5744;7017
Vilnius county;2011;51;12454;5563;6891
Vilnius county;2011;52;12251;5479;6772
Vilnius county;2011;53;11207;5042;6165
Vilnius county;2011;54;10355;4586;5769
Vilnius county;2011;55;10110;4476;5634
Vilnius county;2011;56;9701;4287;5414
Vilnius county;2011;57;9027;3814;5213
Vilnius county;2011;58;9610;4093;5517
Vilnius county;2011;59;9376;3991;5385
Vilnius county;2011;60;9173;3909;5264
Vilnius county;2011;61;9639;3891;5748
Vilnius county;2011;62;8577;3448;5129
Vilnius county;2011;63;7747;3110;4637
Vilnius county;2011;64;7167;2806;4361
Vilnius county;2011;65;7369;2857;4512
Vilnius county;2011;66;6262;2431;3831
Vilnius county;2011;67;6786;2603;4183
Vilnius county;2011;68;7409;2827;4582
Vilnius county;2011;69;6984;2713;4271
Vilnius county;2011;70;7321;2728;4593
Vilnius county;2011;71;7099;2616;4483
Vilnius county;2011;72;7406;2678;4728
Vilnius county;2011;73;6952;2413;4539
Vilnius county;2011;74;6799;2338;4461
Vilnius county;2011;75;6122;2120;4002
Vilnius county;2011;76;5430;1784;3646
Vilnius county;2011;77;5180;1755;3425
Vilnius county;2011;78;5415;1732;3683
Vilnius county;2011;79;4806;1496;3310
Vilnius county;2011;80;4689;1498;3191
Vilnius county;2011;81;4127;1254;2873
Vilnius county;2011;82;3980;1166;2814
Vilnius county;2011;83;3461;990;2471
Vilnius county;2011;84;2978;726;2252
Vilnius county;2011;85;11205;2312;8893
Vilnius county;2012;-1;805915;367700;438215
Vilnius county;2012;0;9139;4720;4419
Vilnius county;2012;1;9977;5050;4927
Vilnius county;2012;2;9775;4984;4791
Vilnius county;2012;3;9009;4587;4422
Vilnius county;2012;4;8247;4227;4020
Vilnius county;2012;5;7813;3973;3840
Vilnius county;2012;6;7614;3851;3763
Vilnius county;2012;7;7265;3731;3534
Vilnius county;2012;8;6988;3627;3361
Vilnius county;2012;9;6841;3526;3315
Vilnius county;2012;10;7098;3601;3497
Vilnius county;2012;11;7611;3935;3676
Vilnius county;2012;12;7964;4125;3839
Vilnius county;2012;13;8000;4095;3905
Vilnius county;2012;14;8094;4243;3851
Vilnius county;2012;15;8081;4131;3950
Vilnius county;2012;16;8561;4400;4161
Vilnius county;2012;17;8747;4506;4241
Vilnius county;2012;18;9696;4956;4740
Vilnius county;2012;19;10552;5366;5186
Vilnius county;2012;20;12491;6167;6324
Vilnius county;2012;21;12913;6389;6524
Vilnius county;2012;22;12293;6010;6283
Vilnius county;2012;23;12330;6027;6303
Vilnius county;2012;24;12779;6360;6419
Vilnius county;2012;25;13091;6339;6752
Vilnius county;2012;26;12999;6259;6740
Vilnius county;2012;27;13101;6382;6719
Vilnius county;2012;28;13372;6563;6809
Vilnius county;2012;29;12273;5989;6284
Vilnius county;2012;30;12206;6043;6163
Vilnius county;2012;31;11986;5950;6036
Vilnius county;2012;32;12025;5829;6196
Vilnius county;2012;33;11868;5763;6105
Vilnius county;2012;34;11896;5876;6020
Vilnius county;2012;35;11779;5747;6032
Vilnius county;2012;36;11378;5479;5899
Vilnius county;2012;37;11412;5456;5956
Vilnius county;2012;38;11414;5542;5872
Vilnius county;2012;39;11547;5518;6029
Vilnius county;2012;40;11892;5781;6111
Vilnius county;2012;41;11535;5514;6021
Vilnius county;2012;42;11293;5464;5829
Vilnius county;2012;43;11098;5337;5761
Vilnius county;2012;44;10817;5088;5729
Vilnius county;2012;45;10905;5174;5731
Vilnius county;2012;46;10820;5065;5755
Vilnius county;2012;47;11159;5239;5920
Vilnius county;2012;48;11800;5524;6276
Vilnius county;2012;49;11860;5428;6432
Vilnius county;2012;50;12581;5762;6819
Vilnius county;2012;51;12590;5639;6951
Vilnius county;2012;52;12274;5456;6818
Vilnius county;2012;53;12101;5395;6706
Vilnius county;2012;54;11012;4923;6089
Vilnius county;2012;55;10203;4499;5704
Vilnius county;2012;56;9944;4373;5571
Vilnius county;2012;57;9568;4202;5366
Vilnius county;2012;58;8896;3735;5161
Vilnius county;2012;59;9472;3994;5478
Vilnius county;2012;60;9208;3878;5330
Vilnius county;2012;61;9008;3810;5198
Vilnius county;2012;62;9462;3769;5693
Vilnius county;2012;63;8416;3331;5085
Vilnius county;2012;64;7589;3009;4580
Vilnius county;2012;65;7040;2720;4320
Vilnius county;2012;66;7200;2751;4449
Vilnius county;2012;67;6106;2328;3778
Vilnius county;2012;68;6612;2502;4110
Vilnius county;2012;69;7212;2718;4494
Vilnius county;2012;70;6782;2585;4197
Vilnius county;2012;71;7112;2596;4516
Vilnius county;2012;72;6910;2487;4423
Vilnius county;2012;73;7167;2543;4624
Vilnius county;2012;74;6681;2275;4406
Vilnius county;2012;75;6559;2223;4336
Vilnius county;2012;76;5889;1998;3891
Vilnius county;2012;77;5197;1680;3517
Vilnius county;2012;78;4929;1620;3309
Vilnius county;2012;79;5137;1600;3537
Vilnius county;2012;80;4523;1376;3147
Vilnius county;2012;81;4350;1367;2983
Vilnius county;2012;82;3828;1126;2702
Vilnius county;2012;83;3658;1068;2590
Vilnius county;2012;84;3146;874;2272
Vilnius county;2012;85;12149;2552;9597
Vilnius county;2013;-1;806308;368036;438272
Vilnius county;2013;0;9157;4679;4478
Vilnius county;2013;1;9219;4746;4473
Vilnius county;2013;2;10043;5073;4970
Vilnius county;2013;3;9781;4995;4786
Vilnius county;2013;4;8996;4578;4418
Vilnius county;2013;5;8240;4236;4004
Vilnius county;2013;6;7815;3980;3835
Vilnius county;2013;7;7580;3819;3761
Vilnius county;2013;8;7229;3710;3519
Vilnius county;2013;9;6984;3612;3372
Vilnius county;2013;10;6807;3513;3294
Vilnius county;2013;11;7052;3575;3477
Vilnius county;2013;12;7567;3918;3649
Vilnius county;2013;13;7927;4103;3824
Vilnius county;2013;14;7958;4064;3894
Vilnius county;2013;15;8062;4221;3841
Vilnius county;2013;16;8046;4119;3927
Vilnius county;2013;17;8541;4382;4159
Vilnius county;2013;18;8706;4484;4222
Vilnius county;2013;19;9566;4893;4673
Vilnius county;2013;20;10508;5351;5157
Vilnius county;2013;21;12492;6168;6324
Vilnius county;2013;22;12846;6352;6494
Vilnius county;2013;23;12292;6008;6284
Vilnius county;2013;24;12391;6051;6340
Vilnius county;2013;25;13042;6464;6578
Vilnius county;2013;26;13315;6429;6886
Vilnius county;2013;27;13268;6386;6882
Vilnius county;2013;28;13411;6500;6911
Vilnius county;2013;29;13619;6666;6953
Vilnius county;2013;30;12460;6094;6366
Vilnius county;2013;31;12322;6092;6230
Vilnius county;2013;32;12044;5985;6059
Vilnius county;2013;33;12033;5842;6191
Vilnius county;2013;34;11876;5771;6105
Vilnius county;2013;35;11843;5868;5975
Vilnius county;2013;36;11749;5763;5986
Vilnius county;2013;37;11341;5439;5902
Vilnius county;2013;38;11383;5452;5931
Vilnius county;2013;39;11376;5547;5829
Vilnius county;2013;40;11469;5482;5987
Vilnius county;2013;41;11832;5739;6093
Vilnius county;2013;42;11463;5467;5996
Vilnius county;2013;43;11220;5415;5805
Vilnius county;2013;44;11008;5279;5729
Vilnius county;2013;45;10685;5014;5671
Vilnius county;2013;46;10823;5136;5687
Vilnius county;2013;47;10731;5008;5723
Vilnius county;2013;48;11033;5157;5876
Vilnius county;2013;49;11668;5445;6223
Vilnius county;2013;50;11737;5360;6377
Vilnius county;2013;51;12435;5671;6764
Vilnius county;2013;52;12462;5536;6926
Vilnius county;2013;53;12152;5379;6773
Vilnius county;2013;54;11956;5307;6649
Vilnius county;2013;55;10881;4848;6033
Vilnius county;2013;56;10054;4393;5661
Vilnius county;2013;57;9838;4295;5543
Vilnius county;2013;58;9436;4094;5342
Vilnius county;2013;59;8760;3657;5103
Vilnius county;2013;60;9327;3886;5441
Vilnius county;2013;61;9065;3788;5277
Vilnius county;2013;62;8867;3715;5152
Vilnius county;2013;63;9307;3664;5643
Vilnius county;2013;64;8243;3216;5027
Vilnius county;2013;65;7398;2877;4521
Vilnius county;2013;66;6905;2632;4273
Vilnius county;2013;67;7040;2653;4387
Vilnius county;2013;68;5972;2256;3716
Vilnius county;2013;69;6443;2392;4051
Vilnius county;2013;70;7031;2601;4430
Vilnius county;2013;71;6592;2463;4129
Vilnius county;2013;72;6932;2488;4444
Vilnius county;2013;73;6697;2364;4333
Vilnius county;2013;74;6920;2425;4495
Vilnius county;2013;75;6420;2135;4285
Vilnius county;2013;76;6322;2108;4214
Vilnius county;2013;77;5624;1858;3766
Vilnius county;2013;78;4920;1549;3371
Vilnius county;2013;79;4662;1494;3168
Vilnius county;2013;80;4829;1469;3360
Vilnius county;2013;81;4227;1261;2966
Vilnius county;2013;82;4026;1253;2773
Vilnius county;2013;83;3500;1019;2481
Vilnius county;2013;84;3337;961;2376
Vilnius county;2013;85;13172;2899;10273
Vilnius county;2014;-1;806106;367921;438185
Vilnius county;2014;0;8954;4551;4403
Vilnius county;2014;1;9259;4739;4520
Vilnius county;2014;2;9291;4796;4495
Vilnius county;2014;3;10006;5042;4964
Vilnius county;2014;4;9733;4991;4742
Vilnius county;2014;5;8921;4551;4370
Vilnius county;2014;6;8197;4218;3979
Vilnius county;2014;7;7807;3969;3838
Vilnius county;2014;8;7565;3804;3761
Vilnius county;2014;9;7201;3697;3504
Vilnius county;2014;10;6942;3590;3352
Vilnius county;2014;11;6772;3496;3276
Vilnius county;2014;12;7028;3561;3467
Vilnius county;2014;13;7545;3899;3646
Vilnius county;2014;14;7906;4087;3819
Vilnius county;2014;15;7945;4056;3889
Vilnius county;2014;16;8028;4200;3828
Vilnius county;2014;17;8013;4096;3917
Vilnius county;2014;18;8553;4375;4178
Vilnius county;2014;19;8602;4433;4169
Vilnius county;2014;20;9503;4866;4637
Vilnius county;2014;21;10466;5316;5150
Vilnius county;2014;22;12446;6154;6292
Vilnius county;2014;23;12841;6353;6488
Vilnius county;2014;24;12354;6036;6318
Vilnius county;2014;25;12556;6099;6457
Vilnius county;2014;26;13205;6485;6720
Vilnius county;2014;27;13532;6516;7016
Vilnius county;2014;28;13554;6497;7057
Vilnius county;2014;29;13673;6619;7054
Vilnius county;2014;30;13796;6727;7069
Vilnius county;2014;31;12540;6136;6404
Vilnius county;2014;32;12357;6110;6247
Vilnius county;2014;33;12106;6023;6083
Vilnius county;2014;34;12057;5856;6201
Vilnius county;2014;35;11848;5761;6087
Vilnius county;2014;36;11831;5849;5982
Vilnius county;2014;37;11735;5748;5987
Vilnius county;2014;38;11286;5404;5882
Vilnius county;2014;39;11331;5428;5903
Vilnius county;2014;40;11286;5501;5785
Vilnius county;2014;41;11416;5464;5952
Vilnius county;2014;42;11769;5699;6070
Vilnius county;2014;43;11360;5409;5951
Vilnius county;2014;44;11189;5393;5796
Vilnius county;2014;45;10873;5193;5680
Vilnius county;2014;46;10580;4938;5642
Vilnius county;2014;47;10726;5077;5649
Vilnius county;2014;48;10646;4953;5693
Vilnius county;2014;49;10948;5099;5849
Vilnius county;2014;50;11573;5370;6203
Vilnius county;2014;51;11654;5293;6361
Vilnius county;2014;52;12302;5582;6720
Vilnius county;2014;53;12344;5458;6886
Vilnius county;2014;54;11984;5262;6722
Vilnius county;2014;55;11804;5208;6596
Vilnius county;2014;56;10736;4741;5995
Vilnius county;2014;57;9925;4314;5611
Vilnius county;2014;58;9694;4187;5507
Vilnius county;2014;59;9293;3996;5297
Vilnius county;2014;60;8633;3555;5078
Vilnius county;2014;61;9194;3796;5398
Vilnius county;2014;62;8892;3677;5215
Vilnius county;2014;63;8701;3612;5089
Vilnius county;2014;64;9132;3553;5579
Vilnius county;2014;65;8052;3100;4952
Vilnius county;2014;66;7255;2776;4479
Vilnius county;2014;67;6735;2536;4199
Vilnius county;2014;68;6881;2549;4332
Vilnius county;2014;69;5814;2162;3652
Vilnius county;2014;70;6296;2293;4003
Vilnius county;2014;71;6835;2482;4353
Vilnius county;2014;72;6391;2349;4042
Vilnius county;2014;73;6726;2364;4362
Vilnius county;2014;74;6473;2258;4215
Vilnius county;2014;75;6655;2287;4368
Vilnius county;2014;76;6180;2014;4166
Vilnius county;2014;77;6070;1992;4078
Vilnius county;2014;78;5358;1726;3632
Vilnius county;2014;79;4695;1457;3238
Vilnius county;2014;80;4368;1381;2987
Vilnius county;2014;81;4496;1307;3189
Vilnius county;2014;82;3915;1137;2778
Vilnius county;2014;83;3702;1141;2561
Vilnius county;2014;84;3147;901;2246
Vilnius county;2014;85;14123;3245;10878
Vilnius county;2015;-1;807523;368847;438676
Vilnius county;2015;0;9410;4872;4538
Vilnius county;2015;1;9056;4613;4443
Vilnius county;2015;2;9264;4734;4530
Vilnius county;2015;3;9288;4804;4484
Vilnius county;2015;4;9984;5045;4939
Vilnius county;2015;5;9694;4968;4726
Vilnius county;2015;6;8876;4535;4341
Vilnius county;2015;7;8159;4192;3967
Vilnius county;2015;8;7799;3958;3841
Vilnius county;2015;9;7553;3798;3755
Vilnius county;2015;10;7201;3701;3500
Vilnius county;2015;11;6928;3586;3342
Vilnius county;2015;12;6741;3482;3259
Vilnius county;2015;13;7019;3556;3463
Vilnius county;2015;14;7530;3898;3632
Vilnius county;2015;15;7898;4085;3813
Vilnius county;2015;16;7911;4040;3871
Vilnius county;2015;17;8000;4182;3818
Vilnius county;2015;18;8014;4094;3920
Vilnius county;2015;19;8462;4305;4157
Vilnius county;2015;20;8515;4373;4142
Vilnius county;2015;21;9461;4829;4632
Vilnius county;2015;22;10378;5268;5110
Vilnius county;2015;23;12405;6122;6283
Vilnius county;2015;24;12856;6350;6506
Vilnius county;2015;25;12391;6065;6326
Vilnius county;2015;26;12680;6149;6531
Vilnius county;2015;27;13509;6593;6916
Vilnius county;2015;28;13810;6630;7180
Vilnius county;2015;29;13888;6641;7247
Vilnius county;2015;30;14020;6801;7219
Vilnius county;2015;31;14042;6860;7182
Vilnius county;2015;32;12700;6234;6466
Vilnius county;2015;33;12427;6166;6261
Vilnius county;2015;34;12183;6073;6110
Vilnius county;2015;35;12095;5906;6189
Vilnius county;2015;36;11906;5811;6095
Vilnius county;2015;37;11859;5869;5990
Vilnius county;2015;38;11728;5742;5986
Vilnius county;2015;39;11287;5418;5869
Vilnius county;2015;40;11298;5397;5901
Vilnius county;2015;41;11271;5502;5769
Vilnius county;2015;42;11382;5445;5937
Vilnius county;2015;43;11723;5662;6061
Vilnius county;2015;44;11301;5372;5929
Vilnius county;2015;45;11095;5339;5756
Vilnius county;2015;46;10771;5124;5647
Vilnius county;2015;47;10529;4895;5634
Vilnius county;2015;48;10636;5026;5610
Vilnius county;2015;49;10583;4908;5675
Vilnius county;2015;50;10848;5034;5814
Vilnius county;2015;51;11465;5297;6168
Vilnius county;2015;52;11558;5223;6335
Vilnius county;2015;53;12206;5506;6700
Vilnius county;2015;54;12231;5388;6843
Vilnius county;2015;55;11831;5155;6676
Vilnius county;2015;56;11666;5106;6560
Vilnius county;2015;57;10611;4647;5964
Vilnius county;2015;58;9825;4248;5577
Vilnius county;2015;59;9542;4084;5458
Vilnius county;2015;60;9190;3910;5280
Vilnius county;2015;61;8523;3476;5047
Vilnius county;2015;62;9051;3696;5355
Vilnius county;2015;63;8742;3576;5166
Vilnius county;2015;64;8548;3510;5038
Vilnius county;2015;65;8936;3433;5503
Vilnius county;2015;66;7881;2994;4887
Vilnius county;2015;67;7098;2676;4422
Vilnius county;2015;68;6580;2431;4149
Vilnius county;2015;69;6686;2431;4255
Vilnius county;2015;70;5665;2065;3600
Vilnius county;2015;71;6111;2184;3927
Vilnius county;2015;72;6606;2354;4252
Vilnius county;2015;73;6207;2237;3970
Vilnius county;2015;74;6524;2243;4281
Vilnius county;2015;75;6234;2130;4104
Vilnius county;2015;76;6417;2168;4249
Vilnius county;2015;77;5906;1879;4027
Vilnius county;2015;78;5824;1870;3954
Vilnius county;2015;79;5079;1590;3489
Vilnius county;2015;80;4432;1338;3094
Vilnius county;2015;81;4085;1264;2821
Vilnius county;2015;82;4167;1187;2980
Vilnius county;2015;83;3591;1025;2566
Vilnius county;2015;84;3382;1032;2350
Vilnius county;2015;85;14759;3442;11317
Vilnius county;2016;-1;805380;367252;438128
Vilnius county;2016;0;9777;5086;4691
Vilnius county;2016;1;9522;4931;4591
Vilnius county;2016;2;9071;4634;4437
Vilnius county;2016;3;9232;4737;4495
Vilnius county;2016;4;9271;4805;4466
Vilnius county;2016;5;9943;5028;4915
Vilnius county;2016;6;9625;4927;4698
Vilnius county;2016;7;8841;4519;4322
Vilnius county;2016;8;8107;4157;3950
Vilnius county;2016;9;7751;3926;3825
Vilnius county;2016;10;7515;3787;3728
Vilnius county;2016;11;7109;3655;3454
Vilnius county;2016;12;6856;3544;3312
Vilnius county;2016;13;6681;3452;3229
Vilnius county;2016;14;6990;3544;3446
Vilnius county;2016;15;7497;3877;3620
Vilnius county;2016;16;7843;4053;3790
Vilnius county;2016;17;7875;4026;3849
Vilnius county;2016;18;7918;4129;3789
Vilnius county;2016;19;7884;4018;3866
Vilnius county;2016;20;8310;4218;4092
Vilnius county;2016;21;8341;4256;4085
Vilnius county;2016;22;9259;4689;4570
Vilnius county;2016;23;10194;5116;5078
Vilnius county;2016;24;12309;6017;6292
Vilnius county;2016;25;12880;6299;6581
Vilnius county;2016;26;12514;6057;6457
Vilnius county;2016;27;12836;6171;6665
Vilnius county;2016;28;13858;6722;7136
Vilnius county;2016;29;14096;6732;7364
Vilnius county;2016;30;14164;6753;7411
Vilnius county;2016;31;14208;6918;7290
Vilnius county;2016;32;14096;6877;7219
Vilnius county;2016;33;12754;6254;6500
Vilnius county;2016;34;12379;6137;6242
Vilnius county;2016;35;12037;5985;6052
Vilnius county;2016;36;11973;5827;6146
Vilnius county;2016;37;11822;5743;6079
Vilnius county;2016;38;11746;5809;5937
Vilnius county;2016;39;11569;5632;5937
Vilnius county;2016;40;11184;5341;5843
Vilnius county;2016;41;11209;5331;5878
Vilnius county;2016;42;11087;5372;5715
Vilnius county;2016;43;11239;5345;5894
Vilnius county;2016;44;11542;5537;6005
Vilnius county;2016;45;11103;5246;5857
Vilnius county;2016;46;10927;5218;5709
Vilnius county;2016;47;10669;5048;5621
Vilnius county;2016;48;10401;4806;5595
Vilnius county;2016;49;10518;4943;5575
Vilnius county;2016;50;10448;4803;5645
Vilnius county;2016;51;10725;4948;5777
Vilnius county;2016;52;11319;5194;6125
Vilnius county;2016;53;11419;5111;6308
Vilnius county;2016;54;12057;5400;6657
Vilnius county;2016;55;12013;5256;6757
Vilnius county;2016;56;11662;5034;6628
Vilnius county;2016;57;11491;4967;6524
Vilnius county;2016;58;10494;4571;5923
Vilnius county;2016;59;9671;4153;5518
Vilnius county;2016;60;9386;3977;5409
Vilnius county;2016;61;9042;3797;5245
Vilnius county;2016;62;8389;3384;5005
Vilnius county;2016;63;8900;3587;5313
Vilnius county;2016;64;8584;3471;5113
Vilnius county;2016;65;8370;3406;4964
Vilnius county;2016;66;8749;3314;5435
Vilnius county;2016;67;7686;2866;4820
Vilnius county;2016;68;6897;2550;4347
Vilnius county;2016;69;6404;2318;4086
Vilnius county;2016;70;6507;2310;4197
Vilnius county;2016;71;5523;1972;3551
Vilnius county;2016;72;5930;2074;3856
Vilnius county;2016;73;6400;2233;4167
Vilnius county;2016;74;5991;2110;3881
Vilnius county;2016;75;6315;2136;4179
Vilnius county;2016;76;5990;2008;3982
Vilnius county;2016;77;6126;2015;4111
Vilnius county;2016;78;5645;1766;3879
Vilnius county;2016;79;5505;1731;3774
Vilnius county;2016;80;4788;1477;3311
Vilnius county;2016;81;4120;1214;2906
Vilnius county;2016;82;3807;1147;2660
Vilnius county;2016;83;3809;1064;2745
Vilnius county;2016;84;3262;896;2366
Vilnius county;2016;85;15424;3758;11666
Vilnius county;2017;-1;805173;367972;437201
Vilnius county;2017;0;9888;5126;4762
Vilnius county;2017;1;9785;5088;4697
Vilnius county;2017;2;9495;4915;4580
Vilnius county;2017;3;9018;4604;4414
Vilnius county;2017;4;9155;4705;4450
Vilnius county;2017;5;9199;4771;4428
Vilnius county;2017;6;9889;5008;4881
Vilnius county;2017;7;9550;4894;4656
Vilnius county;2017;8;8778;4475;4303
Vilnius county;2017;9;8052;4126;3926
Vilnius county;2017;10;7695;3909;3786
Vilnius county;2017;11;7471;3765;3706
Vilnius county;2017;12;7065;3634;3431
Vilnius county;2017;13;6831;3525;3306
Vilnius county;2017;14;6647;3434;3213
Vilnius county;2017;15;6947;3519;3428
Vilnius county;2017;16;7458;3862;3596
Vilnius county;2017;17;7814;4039;3775
Vilnius county;2017;18;7857;4008;3849
Vilnius county;2017;19;7811;4080;3731
Vilnius county;2017;20;7791;3978;3813
Vilnius county;2017;21;8183;4169;4014
Vilnius county;2017;22;8241;4221;4020
Vilnius county;2017;23;9163;4681;4482
Vilnius county;2017;24;10162;5118;5044
Vilnius county;2017;25;12350;6030;6320
Vilnius county;2017;26;12996;6312;6684
Vilnius county;2017;27;12767;6171;6596
Vilnius county;2017;28;13111;6272;6839
Vilnius county;2017;29;14159;6877;7282
Vilnius county;2017;30;14375;6917;7458
Vilnius county;2017;31;14436;6924;7512
Vilnius county;2017;32;14388;7037;7351
Vilnius county;2017;33;14200;6969;7231
Vilnius county;2017;34;12769;6289;6480
Vilnius county;2017;35;12334;6146;6188
Vilnius county;2017;36;11995;6007;5988
Vilnius county;2017;37;11918;5809;6109
Vilnius county;2017;38;11765;5751;6014
Vilnius county;2017;39;11664;5760;5904
Vilnius county;2017;40;11470;5599;5871
Vilnius county;2017;41;11097;5302;5795
Vilnius county;2017;42;11123;5296;5827
Vilnius county;2017;43;10985;5330;5655
Vilnius county;2017;44;11178;5339;5839
Vilnius county;2017;45;11421;5483;5938
Vilnius county;2017;46;11018;5212;5806
Vilnius county;2017;47;10822;5149;5673
Vilnius county;2017;48;10590;5023;5567
Vilnius county;2017;49;10283;4742;5541
Vilnius county;2017;50;10406;4892;5514
Vilnius county;2017;51;10351;4762;5589
Vilnius county;2017;52;10604;4899;5705
Vilnius county;2017;53;11203;5130;6073
Vilnius county;2017;54;11251;4986;6265
Vilnius county;2017;55;11936;5331;6605
Vilnius county;2017;56;11867;5176;6691
Vilnius county;2017;57;11534;4935;6599
Vilnius county;2017;58;11338;4868;6470
Vilnius county;2017;59;10316;4456;5860
Vilnius county;2017;60;9525;4049;5476
Vilnius county;2017;61;9246;3873;5373
Vilnius county;2017;62;8910;3710;5200
Vilnius county;2017;63;8238;3273;4965
Vilnius county;2017;64;8741;3481;5260
Vilnius county;2017;65;8406;3354;5052
Vilnius county;2017;66;8194;3289;4905
Vilnius county;2017;67;8562;3193;5369
Vilnius county;2017;68;7507;2760;4747
Vilnius county;2017;69;6711;2435;4276
Vilnius county;2017;70;6249;2216;4033
Vilnius county;2017;71;6303;2195;4108
Vilnius county;2017;72;5369;1892;3477
Vilnius county;2017;73;5738;1966;3772
Vilnius county;2017;74;6201;2126;4075
Vilnius county;2017;75;5783;2000;3783
Vilnius county;2017;76;6086;2006;4080
Vilnius county;2017;77;5741;1878;3863
Vilnius county;2017;78;5847;1881;3966
Vilnius county;2017;79;5370;1627;3743
Vilnius county;2017;80;5190;1576;3614
Vilnius county;2017;81;4522;1358;3164
Vilnius county;2017;82;3848;1108;2740
Vilnius county;2017;83;3522;1033;2489
Vilnius county;2017;84;3463;948;2515
Vilnius county;2017;85;15936;3910;12026
Vilnius county;2018;-1;805367;369481;435886
Vilnius county;2018;0;9403;4883;4520
Vilnius county;2018;1;9962;5161;4801
Vilnius county;2018;2;9779;5088;4691
Vilnius county;2018;3;9434;4899;4535
Vilnius county;2018;4;8922;4559;4363
Vilnius county;2018;5;9058;4651;4407
Vilnius county;2018;6;9146;4731;4415
Vilnius county;2018;7;9847;4979;4868
Vilnius county;2018;8;9506;4872;4634
Vilnius county;2018;9;8755;4458;4297
Vilnius county;2018;10;8008;4103;3905
Vilnius county;2018;11;7631;3873;3758
Vilnius county;2018;12;7428;3743;3685
Vilnius county;2018;13;7030;3622;3408
Vilnius county;2018;14;6796;3500;3296
Vilnius county;2018;15;6613;3420;3193
Vilnius county;2018;16;6916;3503;3413
Vilnius county;2018;17;7426;3847;3579
Vilnius county;2018;18;7766;4023;3743
Vilnius county;2018;19;7680;3922;3758
Vilnius county;2018;20;7705;4026;3679
Vilnius county;2018;21;7628;3904;3724
Vilnius county;2018;22;8033;4085;3948
Vilnius county;2018;23;8009;4132;3877
Vilnius county;2018;24;8971;4605;4366
Vilnius county;2018;25;10030;5039;4991
Vilnius county;2018;26;12419;6062;6357
Vilnius county;2018;27;13106;6374;6732
Vilnius county;2018;28;12934;6271;6663
Vilnius county;2018;29;13403;6461;6942
Vilnius county;2018;30;14388;7017;7371
Vilnius county;2018;31;14575;7069;7506
Vilnius county;2018;32;14581;7048;7533
Vilnius county;2018;33;14532;7144;7388
Vilnius county;2018;34;14296;7111;7185
Vilnius county;2018;35;12838;6377;6461
Vilnius county;2018;36;12398;6205;6193
Vilnius county;2018;37;12046;6095;5951
Vilnius county;2018;38;11900;5855;6045
Vilnius county;2018;39;11726;5756;5970
Vilnius county;2018;40;11636;5787;5849
Vilnius county;2018;41;11472;5624;5848
Vilnius county;2018;42;11052;5286;5766
Vilnius county;2018;43;11069;5293;5776
Vilnius county;2018;44;10964;5362;5602
Vilnius county;2018;45;11133;5341;5792
Vilnius county;2018;46;11383;5502;5881
Vilnius county;2018;47;10945;5183;5762
Vilnius county;2018;48;10776;5139;5637
Vilnius county;2018;49;10526;4988;5538
Vilnius county;2018;50;10262;4748;5514
Vilnius county;2018;51;10337;4868;5469
Vilnius county;2018;52;10277;4719;5558
Vilnius county;2018;53;10523;4862;5661
Vilnius county;2018;54;11085;5053;6032
Vilnius county;2018;55;11184;4960;6224
Vilnius county;2018;56;11807;5261;6546
Vilnius county;2018;57;11745;5099;6646
Vilnius county;2018;58;11413;4863;6550
Vilnius county;2018;59;11235;4799;6436
Vilnius county;2018;60;10202;4369;5833
Vilnius county;2018;61;9389;3950;5439
Vilnius county;2018;62;9146;3803;5343
Vilnius county;2018;63;8783;3629;5154
Vilnius county;2018;64;8121;3193;4928
Vilnius county;2018;65;8564;3364;5200
Vilnius county;2018;66;8249;3263;4986
Vilnius county;2018;67;8032;3186;4846
Vilnius county;2018;68;8393;3078;5315
Vilnius county;2018;69;7354;2669;4685
Vilnius county;2018;70;6550;2334;4216
Vilnius county;2018;71;6109;2127;3982
Vilnius county;2018;72;6136;2114;4022
Vilnius county;2018;73;5234;1825;3409
Vilnius county;2018;74;5568;1879;3689
Vilnius county;2018;75;5986;2012;3974
Vilnius county;2018;76;5559;1880;3679
Vilnius county;2018;77;5850;1897;3953
Vilnius county;2018;78;5499;1776;3723
Vilnius county;2018;79;5576;1742;3834
Vilnius county;2018;80;5062;1491;3571
Vilnius county;2018;81;4913;1459;3454
Vilnius county;2018;82;4199;1226;2973
Vilnius county;2018;83;3582;1014;2568
Vilnius county;2018;84;3233;940;2293
Vilnius county;2018;85;16630;4051;12579
Vilnius d. mun.;2001;-1;88492;42542;45950
Vilnius d. mun.;2001;0;928;498;430
Vilnius d. mun.;2001;1;963;506;457
Vilnius d. mun.;2001;2;932;459;473
Vilnius d. mun.;2001;3;984;528;456
Vilnius d. mun.;2001;4;982;529;453
Vilnius d. mun.;2001;5;1007;516;491
Vilnius d. mun.;2001;6;1008;516;492
Vilnius d. mun.;2001;7;1162;614;548
Vilnius d. mun.;2001;8;1361;722;639
Vilnius d. mun.;2001;9;1383;700;683
Vilnius d. mun.;2001;10;1463;737;726
Vilnius d. mun.;2001;11;1388;719;669
Vilnius d. mun.;2001;12;1413;723;690
Vilnius d. mun.;2001;13;1519;805;714
Vilnius d. mun.;2001;14;1512;781;731
Vilnius d. mun.;2001;15;1486;790;696
Vilnius d. mun.;2001;16;1450;726;724
Vilnius d. mun.;2001;17;1448;725;723
Vilnius d. mun.;2001;18;1355;735;620
Vilnius d. mun.;2001;19;1308;677;631
Vilnius d. mun.;2001;20;1286;673;613
Vilnius d. mun.;2001;21;1233;633;600
Vilnius d. mun.;2001;22;1254;661;593
Vilnius d. mun.;2001;23;1144;596;548
Vilnius d. mun.;2001;24;1182;600;582
Vilnius d. mun.;2001;25;1142;597;545
Vilnius d. mun.;2001;26;1185;576;609
Vilnius d. mun.;2001;27;1208;633;575
Vilnius d. mun.;2001;28;1247;604;643
Vilnius d. mun.;2001;29;1302;654;648
Vilnius d. mun.;2001;30;1341;652;689
Vilnius d. mun.;2001;31;1306;669;637
Vilnius d. mun.;2001;32;1366;691;675
Vilnius d. mun.;2001;33;1269;649;620
Vilnius d. mun.;2001;34;1279;630;649
Vilnius d. mun.;2001;35;1264;661;603
Vilnius d. mun.;2001;36;1358;706;652
Vilnius d. mun.;2001;37;1415;731;684
Vilnius d. mun.;2001;38;1473;755;718
Vilnius d. mun.;2001;39;1521;740;781
Vilnius d. mun.;2001;40;1483;728;755
Vilnius d. mun.;2001;41;1491;733;758
Vilnius d. mun.;2001;42;1426;709;717
Vilnius d. mun.;2001;43;1344;692;652
Vilnius d. mun.;2001;44;1165;544;621
Vilnius d. mun.;2001;45;1196;607;589
Vilnius d. mun.;2001;46;1084;560;524
Vilnius d. mun.;2001;47;1118;546;572
Vilnius d. mun.;2001;48;1158;566;592
Vilnius d. mun.;2001;49;1180;578;602
Vilnius d. mun.;2001;50;1188;590;598
Vilnius d. mun.;2001;51;1134;568;566
Vilnius d. mun.;2001;52;952;459;493
Vilnius d. mun.;2001;53;920;432;488
Vilnius d. mun.;2001;54;835;404;431
Vilnius d. mun.;2001;55;940;441;499
Vilnius d. mun.;2001;56;734;350;384
Vilnius d. mun.;2001;57;797;388;409
Vilnius d. mun.;2001;58;988;448;540
Vilnius d. mun.;2001;59;800;349;451
Vilnius d. mun.;2001;60;897;384;513
Vilnius d. mun.;2001;61;840;364;476
Vilnius d. mun.;2001;62;844;381;463
Vilnius d. mun.;2001;63;942;393;549
Vilnius d. mun.;2001;64;897;384;513
Vilnius d. mun.;2001;65;886;390;496
Vilnius d. mun.;2001;66;834;340;494
Vilnius d. mun.;2001;67;769;310;459
Vilnius d. mun.;2001;68;794;296;498
Vilnius d. mun.;2001;69;746;290;456
Vilnius d. mun.;2001;70;767;286;481
Vilnius d. mun.;2001;71;626;218;408
Vilnius d. mun.;2001;72;692;252;440
Vilnius d. mun.;2001;73;640;214;426
Vilnius d. mun.;2001;74;578;173;405
Vilnius d. mun.;2001;75;530;151;379
Vilnius d. mun.;2001;76;460;115;345
Vilnius d. mun.;2001;77;450;124;326
Vilnius d. mun.;2001;78;406;93;313
Vilnius d. mun.;2001;79;359;104;255
Vilnius d. mun.;2001;80;280;66;214
Vilnius d. mun.;2001;81;221;68;153
Vilnius d. mun.;2001;82;158;38;120
Vilnius d. mun.;2001;83;109;27;82
Vilnius d. mun.;2001;84;146;41;105
Vilnius d. mun.;2001;85;861;231;630
Vilnius d. mun.;2002;-1;88807;42671;46136
Vilnius d. mun.;2002;0;902;462;440
Vilnius d. mun.;2002;1;944;503;441
Vilnius d. mun.;2002;2;981;514;467
Vilnius d. mun.;2002;3;945;470;475
Vilnius d. mun.;2002;4;988;526;462
Vilnius d. mun.;2002;5;987;535;452
Vilnius d. mun.;2002;6;1020;526;494
Vilnius d. mun.;2002;7;1013;513;500
Vilnius d. mun.;2002;8;1164;612;552
Vilnius d. mun.;2002;9;1361;722;639
Vilnius d. mun.;2002;10;1390;706;684
Vilnius d. mun.;2002;11;1471;738;733
Vilnius d. mun.;2002;12;1392;719;673
Vilnius d. mun.;2002;13;1411;718;693
Vilnius d. mun.;2002;14;1522;805;717
Vilnius d. mun.;2002;15;1513;784;729
Vilnius d. mun.;2002;16;1480;784;696
Vilnius d. mun.;2002;17;1460;732;728
Vilnius d. mun.;2002;18;1450;720;730
Vilnius d. mun.;2002;19;1347;731;616
Vilnius d. mun.;2002;20;1308;668;640
Vilnius d. mun.;2002;21;1278;664;614
Vilnius d. mun.;2002;22;1236;630;606
Vilnius d. mun.;2002;23;1252;658;594
Vilnius d. mun.;2002;24;1144;593;551
Vilnius d. mun.;2002;25;1194;610;584
Vilnius d. mun.;2002;26;1152;598;554
Vilnius d. mun.;2002;27;1183;576;607
Vilnius d. mun.;2002;28;1213;630;583
Vilnius d. mun.;2002;29;1233;597;636
Vilnius d. mun.;2002;30;1297;652;645
Vilnius d. mun.;2002;31;1338;650;688
Vilnius d. mun.;2002;32;1313;675;638
Vilnius d. mun.;2002;33;1361;690;671
Vilnius d. mun.;2002;34;1264;643;621
Vilnius d. mun.;2002;35;1281;631;650
Vilnius d. mun.;2002;36;1268;664;604
Vilnius d. mun.;2002;37;1354;704;650
Vilnius d. mun.;2002;38;1403;715;688
Vilnius d. mun.;2002;39;1461;748;713
Vilnius d. mun.;2002;40;1513;730;783
Vilnius d. mun.;2002;41;1485;731;754
Vilnius d. mun.;2002;42;1491;731;760
Vilnius d. mun.;2002;43;1431;713;718
Vilnius d. mun.;2002;44;1339;690;649
Vilnius d. mun.;2002;45;1146;538;608
Vilnius d. mun.;2002;46;1204;610;594
Vilnius d. mun.;2002;47;1100;573;527
Vilnius d. mun.;2002;48;1114;543;571
Vilnius d. mun.;2002;49;1146;556;590
Vilnius d. mun.;2002;50;1178;570;608
Vilnius d. mun.;2002;51;1175;583;592
Vilnius d. mun.;2002;52;1136;567;569
Vilnius d. mun.;2002;53;950;457;493
Vilnius d. mun.;2002;54;916;437;479
Vilnius d. mun.;2002;55;830;399;431
Vilnius d. mun.;2002;56;915;429;486
Vilnius d. mun.;2002;57;720;342;378
Vilnius d. mun.;2002;58;785;383;402
Vilnius d. mun.;2002;59;971;435;536
Vilnius d. mun.;2002;60;782;337;445
Vilnius d. mun.;2002;61;893;380;513
Vilnius d. mun.;2002;62;840;361;479
Vilnius d. mun.;2002;63;832;369;463
Vilnius d. mun.;2002;64;951;399;552
Vilnius d. mun.;2002;65;894;374;520
Vilnius d. mun.;2002;66;883;386;497
Vilnius d. mun.;2002;67;821;335;486
Vilnius d. mun.;2002;68;756;301;455
Vilnius d. mun.;2002;69;785;290;495
Vilnius d. mun.;2002;70;727;281;446
Vilnius d. mun.;2002;71;742;270;472
Vilnius d. mun.;2002;72;609;215;394
Vilnius d. mun.;2002;73;680;243;437
Vilnius d. mun.;2002;74;613;203;410
Vilnius d. mun.;2002;75;552;161;391
Vilnius d. mun.;2002;76;514;143;371
Vilnius d. mun.;2002;77;429;103;326
Vilnius d. mun.;2002;78;425;117;308
Vilnius d. mun.;2002;79;391;89;302
Vilnius d. mun.;2002;80;338;100;238
Vilnius d. mun.;2002;81;255;53;202
Vilnius d. mun.;2002;82;196;56;140
Vilnius d. mun.;2002;83;142;33;109
Vilnius d. mun.;2002;84;100;26;74
Vilnius d. mun.;2002;85;838;213;625
Vilnius d. mun.;2003;-1;89405;42979;46426
Vilnius d. mun.;2003;0;817;422;395
Vilnius d. mun.;2003;1;920;480;440
Vilnius d. mun.;2003;2;968;512;456
Vilnius d. mun.;2003;3;993;522;471
Vilnius d. mun.;2003;4;961;478;483
Vilnius d. mun.;2003;5;1001;526;475
Vilnius d. mun.;2003;6;1005;550;455
Vilnius d. mun.;2003;7;1033;534;499
Vilnius d. mun.;2003;8;1031;527;504
Vilnius d. mun.;2003;9;1182;626;556
Vilnius d. mun.;2003;10;1376;732;644
Vilnius d. mun.;2003;11;1403;715;688
Vilnius d. mun.;2003;12;1468;736;732
Vilnius d. mun.;2003;13;1397;721;676
Vilnius d. mun.;2003;14;1422;720;702
Vilnius d. mun.;2003;15;1532;812;720
Vilnius d. mun.;2003;16;1513;782;731
Vilnius d. mun.;2003;17;1472;784;688
Vilnius d. mun.;2003;18;1477;742;735
Vilnius d. mun.;2003;19;1439;713;726
Vilnius d. mun.;2003;20;1353;735;618
Vilnius d. mun.;2003;21;1308;667;641
Vilnius d. mun.;2003;22;1282;666;616
Vilnius d. mun.;2003;23;1247;631;616
Vilnius d. mun.;2003;24;1250;657;593
Vilnius d. mun.;2003;25;1145;598;547
Vilnius d. mun.;2003;26;1203;611;592
Vilnius d. mun.;2003;27;1163;603;560
Vilnius d. mun.;2003;28;1196;581;615
Vilnius d. mun.;2003;29;1238;640;598
Vilnius d. mun.;2003;30;1244;606;638
Vilnius d. mun.;2003;31;1295;648;647
Vilnius d. mun.;2003;32;1349;656;693
Vilnius d. mun.;2003;33;1315;674;641
Vilnius d. mun.;2003;34;1369;694;675
Vilnius d. mun.;2003;35;1261;634;627
Vilnius d. mun.;2003;36;1295;640;655
Vilnius d. mun.;2003;37;1282;666;616
Vilnius d. mun.;2003;38;1359;707;652
Vilnius d. mun.;2003;39;1407;714;693
Vilnius d. mun.;2003;40;1473;758;715
Vilnius d. mun.;2003;41;1515;732;783
Vilnius d. mun.;2003;42;1495;739;756
Vilnius d. mun.;2003;43;1492;734;758
Vilnius d. mun.;2003;44;1444;722;722
Vilnius d. mun.;2003;45;1329;678;651
Vilnius d. mun.;2003;46;1155;546;609
Vilnius d. mun.;2003;47;1201;603;598
Vilnius d. mun.;2003;48;1112;574;538
Vilnius d. mun.;2003;49;1122;544;578
Vilnius d. mun.;2003;50;1148;556;592
Vilnius d. mun.;2003;51;1157;563;594
Vilnius d. mun.;2003;52;1178;582;596
Vilnius d. mun.;2003;53;1141;571;570
Vilnius d. mun.;2003;54;948;456;492
Vilnius d. mun.;2003;55;915;435;480
Vilnius d. mun.;2003;56;827;390;437
Vilnius d. mun.;2003;57;902;418;484
Vilnius d. mun.;2003;58;723;343;380
Vilnius d. mun.;2003;59;776;378;398
Vilnius d. mun.;2003;60;960;429;531
Vilnius d. mun.;2003;61;771;330;441
Vilnius d. mun.;2003;62;881;375;506
Vilnius d. mun.;2003;63;836;363;473
Vilnius d. mun.;2003;64;822;357;465
Vilnius d. mun.;2003;65;944;384;560
Vilnius d. mun.;2003;66;897;369;528
Vilnius d. mun.;2003;67;870;379;491
Vilnius d. mun.;2003;68;795;320;475
Vilnius d. mun.;2003;69;730;282;448
Vilnius d. mun.;2003;70;770;279;491
Vilnius d. mun.;2003;71;695;260;435
Vilnius d. mun.;2003;72;731;263;468
Vilnius d. mun.;2003;73;589;202;387
Vilnius d. mun.;2003;74;652;224;428
Vilnius d. mun.;2003;75;590;184;406
Vilnius d. mun.;2003;76;521;138;383
Vilnius d. mun.;2003;77;489;132;357
Vilnius d. mun.;2003;78;400;91;309
Vilnius d. mun.;2003;79;405;105;300
Vilnius d. mun.;2003;80;374;80;294
Vilnius d. mun.;2003;81;310;90;220
Vilnius d. mun.;2003;82;233;43;190
Vilnius d. mun.;2003;83;185;54;131
Vilnius d. mun.;2003;84;123;27;96
Vilnius d. mun.;2003;85;808;235;573
Vilnius d. mun.;2004;-1;91284;43899;47385
Vilnius d. mun.;2004;0;780;407;373
Vilnius d. mun.;2004;1;856;444;412
Vilnius d. mun.;2004;2;938;490;448
Vilnius d. mun.;2004;3;988;520;468
Vilnius d. mun.;2004;4;1018;530;488
Vilnius d. mun.;2004;5;984;491;493
Vilnius d. mun.;2004;6;1039;550;489
Vilnius d. mun.;2004;7;1040;569;471
Vilnius d. mun.;2004;8;1064;550;514
Vilnius d. mun.;2004;9;1061;543;518
Vilnius d. mun.;2004;10;1206;635;571
Vilnius d. mun.;2004;11;1396;751;645
Vilnius d. mun.;2004;12;1411;716;695
Vilnius d. mun.;2004;13;1472;740;732
Vilnius d. mun.;2004;14;1401;728;673
Vilnius d. mun.;2004;15;1435;732;703
Vilnius d. mun.;2004;16;1531;817;714
Vilnius d. mun.;2004;17;1514;789;725
Vilnius d. mun.;2004;18;1478;794;684
Vilnius d. mun.;2004;19;1500;763;737
Vilnius d. mun.;2004;20;1436;715;721
Vilnius d. mun.;2004;21;1359;736;623
Vilnius d. mun.;2004;22;1325;678;647
Vilnius d. mun.;2004;23;1296;675;621
Vilnius d. mun.;2004;24;1267;637;630
Vilnius d. mun.;2004;25;1295;669;626
Vilnius d. mun.;2004;26;1182;600;582
Vilnius d. mun.;2004;27;1253;637;616
Vilnius d. mun.;2004;28;1198;612;586
Vilnius d. mun.;2004;29;1225;588;637
Vilnius d. mun.;2004;30;1276;664;612
Vilnius d. mun.;2004;31;1297;632;665
Vilnius d. mun.;2004;32;1348;682;666
Vilnius d. mun.;2004;33;1392;677;715
Vilnius d. mun.;2004;34;1356;694;662
Vilnius d. mun.;2004;35;1402;713;689
Vilnius d. mun.;2004;36;1284;662;622
Vilnius d. mun.;2004;37;1322;653;669
Vilnius d. mun.;2004;38;1305;676;629
Vilnius d. mun.;2004;39;1395;721;674
Vilnius d. mun.;2004;40;1432;727;705
Vilnius d. mun.;2004;41;1502;770;732
Vilnius d. mun.;2004;42;1553;746;807
Vilnius d. mun.;2004;43;1559;769;790
Vilnius d. mun.;2004;44;1516;741;775
Vilnius d. mun.;2004;45;1495;753;742
Vilnius d. mun.;2004;46;1356;693;663
Vilnius d. mun.;2004;47;1172;541;631
Vilnius d. mun.;2004;48;1217;614;603
Vilnius d. mun.;2004;49;1138;584;554
Vilnius d. mun.;2004;50;1145;551;594
Vilnius d. mun.;2004;51;1183;569;614
Vilnius d. mun.;2004;52;1189;579;610
Vilnius d. mun.;2004;53;1208;599;609
Vilnius d. mun.;2004;54;1172;588;584
Vilnius d. mun.;2004;55;971;464;507
Vilnius d. mun.;2004;56;926;440;486
Vilnius d. mun.;2004;57;847;398;449
Vilnius d. mun.;2004;58;917;427;490
Vilnius d. mun.;2004;59;726;345;381
Vilnius d. mun.;2004;60;787;380;407
Vilnius d. mun.;2004;61;952;425;527
Vilnius d. mun.;2004;62;774;330;444
Vilnius d. mun.;2004;63;889;380;509
Vilnius d. mun.;2004;64;832;351;481
Vilnius d. mun.;2004;65;834;366;468
Vilnius d. mun.;2004;66;940;379;561
Vilnius d. mun.;2004;67;905;372;533
Vilnius d. mun.;2004;68;873;372;501
Vilnius d. mun.;2004;69;786;311;475
Vilnius d. mun.;2004;70;719;264;455
Vilnius d. mun.;2004;71;748;263;485
Vilnius d. mun.;2004;72;692;256;436
Vilnius d. mun.;2004;73;720;258;462
Vilnius d. mun.;2004;74;569;190;379
Vilnius d. mun.;2004;75;623;209;414
Vilnius d. mun.;2004;76;568;169;399
Vilnius d. mun.;2004;77;506;134;372
Vilnius d. mun.;2004;78;467;122;345
Vilnius d. mun.;2004;79;390;80;310
Vilnius d. mun.;2004;80;386;97;289
Vilnius d. mun.;2004;81;346;70;276
Vilnius d. mun.;2004;82;291;81;210
Vilnius d. mun.;2004;83;221;41;180
Vilnius d. mun.;2004;84;170;49;121
Vilnius d. mun.;2004;85;747;172;575
Vilnius d. mun.;2005;-1;92576;44551;48025
Vilnius d. mun.;2005;0;907;463;444
Vilnius d. mun.;2005;1;782;407;375
Vilnius d. mun.;2005;2;862;451;411
Vilnius d. mun.;2005;3;947;497;450
Vilnius d. mun.;2005;4;996;525;471
Vilnius d. mun.;2005;5;1036;542;494
Vilnius d. mun.;2005;6;1000;500;500
Vilnius d. mun.;2005;7;1056;556;500
Vilnius d. mun.;2005;8;1054;579;475
Vilnius d. mun.;2005;9;1075;556;519
Vilnius d. mun.;2005;10;1077;556;521
Vilnius d. mun.;2005;11;1222;645;577
Vilnius d. mun.;2005;12;1409;759;650
Vilnius d. mun.;2005;13;1432;730;702
Vilnius d. mun.;2005;14;1487;748;739
Vilnius d. mun.;2005;15;1406;730;676
Vilnius d. mun.;2005;16;1433;733;700
Vilnius d. mun.;2005;17;1535;815;720
Vilnius d. mun.;2005;18;1498;776;722
Vilnius d. mun.;2005;19;1475;792;683
Vilnius d. mun.;2005;20;1477;757;720
Vilnius d. mun.;2005;21;1447;714;733
Vilnius d. mun.;2005;22;1370;745;625
Vilnius d. mun.;2005;23;1319;681;638
Vilnius d. mun.;2005;24;1304;678;626
Vilnius d. mun.;2005;25;1281;647;634
Vilnius d. mun.;2005;26;1330;686;644
Vilnius d. mun.;2005;27;1222;613;609
Vilnius d. mun.;2005;28;1301;653;648
Vilnius d. mun.;2005;29;1264;650;614
Vilnius d. mun.;2005;30;1257;610;647
Vilnius d. mun.;2005;31;1303;683;620
Vilnius d. mun.;2005;32;1335;655;680
Vilnius d. mun.;2005;33;1377;704;673
Vilnius d. mun.;2005;34;1415;689;726
Vilnius d. mun.;2005;35;1376;702;674
Vilnius d. mun.;2005;36;1444;726;718
Vilnius d. mun.;2005;37;1298;669;629
Vilnius d. mun.;2005;38;1355;668;687
Vilnius d. mun.;2005;39;1325;685;640
Vilnius d. mun.;2005;40;1423;732;691
Vilnius d. mun.;2005;41;1450;738;712
Vilnius d. mun.;2005;42;1516;774;742
Vilnius d. mun.;2005;43;1580;757;823
Vilnius d. mun.;2005;44;1585;790;795
Vilnius d. mun.;2005;45;1528;745;783
Vilnius d. mun.;2005;46;1497;756;741
Vilnius d. mun.;2005;47;1371;702;669
Vilnius d. mun.;2005;48;1195;549;646
Vilnius d. mun.;2005;49;1241;624;617
Vilnius d. mun.;2005;50;1158;590;568
Vilnius d. mun.;2005;51;1151;556;595
Vilnius d. mun.;2005;52;1192;572;620
Vilnius d. mun.;2005;53;1194;578;616
Vilnius d. mun.;2005;54;1211;596;615
Vilnius d. mun.;2005;55;1175;581;594
Vilnius d. mun.;2005;56;987;465;522
Vilnius d. mun.;2005;57;920;435;485
Vilnius d. mun.;2005;58;855;403;452
Vilnius d. mun.;2005;59;930;428;502
Vilnius d. mun.;2005;60;727;342;385
Vilnius d. mun.;2005;61;776;372;404
Vilnius d. mun.;2005;62;948;423;525
Vilnius d. mun.;2005;63;777;327;450
Vilnius d. mun.;2005;64;868;366;502
Vilnius d. mun.;2005;65;836;352;484
Vilnius d. mun.;2005;66;819;357;462
Vilnius d. mun.;2005;67;931;372;559
Vilnius d. mun.;2005;68;884;360;524
Vilnius d. mun.;2005;69;856;363;493
Vilnius d. mun.;2005;70;762;289;473
Vilnius d. mun.;2005;71;699;253;446
Vilnius d. mun.;2005;72;727;251;476
Vilnius d. mun.;2005;73;674;243;431
Vilnius d. mun.;2005;74;693;242;451
Vilnius d. mun.;2005;75;537;175;362
Vilnius d. mun.;2005;76;607;196;411
Vilnius d. mun.;2005;77;547;154;393
Vilnius d. mun.;2005;78;485;120;365
Vilnius d. mun.;2005;79;441;106;335
Vilnius d. mun.;2005;80;367;73;294
Vilnius d. mun.;2005;81;361;92;269
Vilnius d. mun.;2005;82;322;61;261
Vilnius d. mun.;2005;83;267;71;196
Vilnius d. mun.;2005;84;208;36;172
Vilnius d. mun.;2005;85;809;209;600
Vilnius d. mun.;2006;-1;93324;44959;48365
Vilnius d. mun.;2006;0;943;472;471
Vilnius d. mun.;2006;1;922;470;452
Vilnius d. mun.;2006;2;791;412;379
Vilnius d. mun.;2006;3;879;464;415
Vilnius d. mun.;2006;4;949;495;454
Vilnius d. mun.;2006;5;1008;532;476
Vilnius d. mun.;2006;6;1061;555;506
Vilnius d. mun.;2006;7;1007;506;501
Vilnius d. mun.;2006;8;1082;569;513
Vilnius d. mun.;2006;9;1067;588;479
Vilnius d. mun.;2006;10;1094;569;525
Vilnius d. mun.;2006;11;1096;568;528
Vilnius d. mun.;2006;12;1250;660;590
Vilnius d. mun.;2006;13;1410;761;649
Vilnius d. mun.;2006;14;1434;734;700
Vilnius d. mun.;2006;15;1465;739;726
Vilnius d. mun.;2006;16;1397;720;677
Vilnius d. mun.;2006;17;1435;733;702
Vilnius d. mun.;2006;18;1522;805;717
Vilnius d. mun.;2006;19;1484;777;707
Vilnius d. mun.;2006;20;1439;772;667
Vilnius d. mun.;2006;21;1427;730;697
Vilnius d. mun.;2006;22;1412;700;712
Vilnius d. mun.;2006;23;1346;732;614
Vilnius d. mun.;2006;24;1296;671;625
Vilnius d. mun.;2006;25;1298;674;624
Vilnius d. mun.;2006;26;1277;650;627
Vilnius d. mun.;2006;27;1338;682;656
Vilnius d. mun.;2006;28;1247;630;617
Vilnius d. mun.;2006;29;1330;660;670
Vilnius d. mun.;2006;30;1310;675;635
Vilnius d. mun.;2006;31;1291;632;659
Vilnius d. mun.;2006;32;1318;684;634
Vilnius d. mun.;2006;33;1358;670;688
Vilnius d. mun.;2006;34;1391;716;675
Vilnius d. mun.;2006;35;1433;693;740
Vilnius d. mun.;2006;36;1386;707;679
Vilnius d. mun.;2006;37;1455;731;724
Vilnius d. mun.;2006;38;1309;675;634
Vilnius d. mun.;2006;39;1356;666;690
Vilnius d. mun.;2006;40;1328;684;644
Vilnius d. mun.;2006;41;1430;731;699
Vilnius d. mun.;2006;42;1492;767;725
Vilnius d. mun.;2006;43;1521;767;754
Vilnius d. mun.;2006;44;1587;758;829
Vilnius d. mun.;2006;45;1599;796;803
Vilnius d. mun.;2006;46;1536;746;790
Vilnius d. mun.;2006;47;1513;765;748
Vilnius d. mun.;2006;48;1391;710;681
Vilnius d. mun.;2006;49;1223;566;657
Vilnius d. mun.;2006;50;1254;638;616
Vilnius d. mun.;2006;51;1173;603;570
Vilnius d. mun.;2006;52;1140;549;591
Vilnius d. mun.;2006;53;1206;577;629
Vilnius d. mun.;2006;54;1198;572;626
Vilnius d. mun.;2006;55;1212;591;621
Vilnius d. mun.;2006;56;1178;583;595
Vilnius d. mun.;2006;57;1006;475;531
Vilnius d. mun.;2006;58;930;434;496
Vilnius d. mun.;2006;59;854;397;457
Vilnius d. mun.;2006;60;923;422;501
Vilnius d. mun.;2006;61;721;337;384
Vilnius d. mun.;2006;62;779;373;406
Vilnius d. mun.;2006;63;945;420;525
Vilnius d. mun.;2006;64;774;324;450
Vilnius d. mun.;2006;65;856;356;500
Vilnius d. mun.;2006;66;831;350;481
Vilnius d. mun.;2006;67;819;349;470
Vilnius d. mun.;2006;68;914;364;550
Vilnius d. mun.;2006;69;868;343;525
Vilnius d. mun.;2006;70;837;348;489
Vilnius d. mun.;2006;71;754;287;467
Vilnius d. mun.;2006;72;678;241;437
Vilnius d. mun.;2006;73;710;243;467
Vilnius d. mun.;2006;74;660;237;423
Vilnius d. mun.;2006;75;671;238;433
Vilnius d. mun.;2006;76;524;166;358
Vilnius d. mun.;2006;77;573;179;394
Vilnius d. mun.;2006;78;523;145;378
Vilnius d. mun.;2006;79;454;113;341
Vilnius d. mun.;2006;80;420;95;325
Vilnius d. mun.;2006;81;339;62;277
Vilnius d. mun.;2006;82;333;84;249
Vilnius d. mun.;2006;83;285;51;234
Vilnius d. mun.;2006;84;241;68;173
Vilnius d. mun.;2006;85;808;176;632
Vilnius d. mun.;2007;-1;93835;45292;48543
Vilnius d. mun.;2007;0;933;461;472
Vilnius d. mun.;2007;1;956;472;484
Vilnius d. mun.;2007;2;922;475;447
Vilnius d. mun.;2007;3;802;414;388
Vilnius d. mun.;2007;4;886;463;423
Vilnius d. mun.;2007;5;965;504;461
Vilnius d. mun.;2007;6;1025;545;480
Vilnius d. mun.;2007;7;1064;555;509
Vilnius d. mun.;2007;8;1018;516;502
Vilnius d. mun.;2007;9;1103;582;521
Vilnius d. mun.;2007;10;1080;595;485
Vilnius d. mun.;2007;11;1108;582;526
Vilnius d. mun.;2007;12;1124;585;539
Vilnius d. mun.;2007;13;1264;671;593
Vilnius d. mun.;2007;14;1424;771;653
Vilnius d. mun.;2007;15;1457;748;709
Vilnius d. mun.;2007;16;1471;745;726
Vilnius d. mun.;2007;17;1401;724;677
Vilnius d. mun.;2007;18;1407;722;685
Vilnius d. mun.;2007;19;1507;800;707
Vilnius d. mun.;2007;20;1458;768;690
Vilnius d. mun.;2007;21;1420;762;658
Vilnius d. mun.;2007;22;1408;722;686
Vilnius d. mun.;2007;23;1390;690;700
Vilnius d. mun.;2007;24;1343;729;614
Vilnius d. mun.;2007;25;1298;676;622
Vilnius d. mun.;2007;26;1306;679;627
Vilnius d. mun.;2007;27;1298;662;636
Vilnius d. mun.;2007;28;1357;686;671
Vilnius d. mun.;2007;29;1274;640;634
Vilnius d. mun.;2007;30;1355;671;684
Vilnius d. mun.;2007;31;1350;696;654
Vilnius d. mun.;2007;32;1304;648;656
Vilnius d. mun.;2007;33;1337;695;642
Vilnius d. mun.;2007;34;1377;679;698
Vilnius d. mun.;2007;35;1414;734;680
Vilnius d. mun.;2007;36;1459;711;748
Vilnius d. mun.;2007;37;1397;715;682
Vilnius d. mun.;2007;38;1459;737;722
Vilnius d. mun.;2007;39;1312;687;625
Vilnius d. mun.;2007;40;1361;667;694
Vilnius d. mun.;2007;41;1323;688;635
Vilnius d. mun.;2007;42;1435;733;702
Vilnius d. mun.;2007;43;1478;758;720
Vilnius d. mun.;2007;44;1507;759;748
Vilnius d. mun.;2007;45;1610;777;833
Vilnius d. mun.;2007;46;1606;803;803
Vilnius d. mun.;2007;47;1542;749;793
Vilnius d. mun.;2007;48;1530;772;758
Vilnius d. mun.;2007;49;1398;710;688
Vilnius d. mun.;2007;50;1209;556;653
Vilnius d. mun.;2007;51;1251;633;618
Vilnius d. mun.;2007;52;1183;612;571
Vilnius d. mun.;2007;53;1128;539;589
Vilnius d. mun.;2007;54;1199;571;628
Vilnius d. mun.;2007;55;1190;565;625
Vilnius d. mun.;2007;56;1209;586;623
Vilnius d. mun.;2007;57;1177;581;596
Vilnius d. mun.;2007;58;1004;479;525
Vilnius d. mun.;2007;59;916;425;491
Vilnius d. mun.;2007;60;836;385;451
Vilnius d. mun.;2007;61;923;422;501
Vilnius d. mun.;2007;62;712;331;381
Vilnius d. mun.;2007;63;755;351;404
Vilnius d. mun.;2007;64;930;407;523
Vilnius d. mun.;2007;65;771;318;453
Vilnius d. mun.;2007;66;837;341;496
Vilnius d. mun.;2007;67;813;336;477
Vilnius d. mun.;2007;68;792;330;462
Vilnius d. mun.;2007;69;886;339;547
Vilnius d. mun.;2007;70;848;332;516
Vilnius d. mun.;2007;71;807;329;478
Vilnius d. mun.;2007;72;736;267;469
Vilnius d. mun.;2007;73;652;221;431
Vilnius d. mun.;2007;74;674;222;452
Vilnius d. mun.;2007;75;625;217;408
Vilnius d. mun.;2007;76;642;221;421
Vilnius d. mun.;2007;77;493;155;338
Vilnius d. mun.;2007;78;534;164;370
Vilnius d. mun.;2007;79;493;139;354
Vilnius d. mun.;2007;80;431;109;322
Vilnius d. mun.;2007;81;386;85;301
Vilnius d. mun.;2007;82;313;58;255
Vilnius d. mun.;2007;83;298;72;226
Vilnius d. mun.;2007;84;244;45;199
Vilnius d. mun.;2007;85;915;216;699
Vilnius d. mun.;2008;-1;94669;45760;48909
Vilnius d. mun.;2008;0;1001;516;485
Vilnius d. mun.;2008;1;951;470;481
Vilnius d. mun.;2008;2;976;488;488
Vilnius d. mun.;2008;3;932;476;456
Vilnius d. mun.;2008;4;807;411;396
Vilnius d. mun.;2008;5;896;467;429
Vilnius d. mun.;2008;6;980;514;466
Vilnius d. mun.;2008;7;1035;552;483
Vilnius d. mun.;2008;8;1078;561;517
Vilnius d. mun.;2008;9;1031;527;504
Vilnius d. mun.;2008;10;1111;589;522
Vilnius d. mun.;2008;11;1094;604;490
Vilnius d. mun.;2008;12;1127;596;531
Vilnius d. mun.;2008;13;1133;594;539
Vilnius d. mun.;2008;14;1279;678;601
Vilnius d. mun.;2008;15;1440;780;660
Vilnius d. mun.;2008;16;1466;751;715
Vilnius d. mun.;2008;17;1486;755;731
Vilnius d. mun.;2008;18;1401;725;676
Vilnius d. mun.;2008;19;1410;728;682
Vilnius d. mun.;2008;20;1510;801;709
Vilnius d. mun.;2008;21;1440;759;681
Vilnius d. mun.;2008;22;1413;761;652
Vilnius d. mun.;2008;23;1374;710;664
Vilnius d. mun.;2008;24;1396;693;703
Vilnius d. mun.;2008;25;1354;730;624
Vilnius d. mun.;2008;26;1307;675;632
Vilnius d. mun.;2008;27;1319;689;630
Vilnius d. mun.;2008;28;1308;664;644
Vilnius d. mun.;2008;29;1383;705;678
Vilnius d. mun.;2008;30;1302;653;649
Vilnius d. mun.;2008;31;1369;673;696
Vilnius d. mun.;2008;32;1367;707;660
Vilnius d. mun.;2008;33;1335;666;669
Vilnius d. mun.;2008;34;1361;711;650
Vilnius d. mun.;2008;35;1407;694;713
Vilnius d. mun.;2008;36;1439;744;695
Vilnius d. mun.;2008;37;1491;736;755
Vilnius d. mun.;2008;38;1409;721;688
Vilnius d. mun.;2008;39;1485;755;730
Vilnius d. mun.;2008;40;1333;698;635
Vilnius d. mun.;2008;41;1381;676;705
Vilnius d. mun.;2008;42;1340;702;638
Vilnius d. mun.;2008;43;1454;745;709
Vilnius d. mun.;2008;44;1482;760;722
Vilnius d. mun.;2008;45;1530;772;758
Vilnius d. mun.;2008;46;1610;779;831
Vilnius d. mun.;2008;47;1602;794;808
Vilnius d. mun.;2008;48;1552;765;787
Vilnius d. mun.;2008;49;1528;760;768
Vilnius d. mun.;2008;50;1412;719;693
Vilnius d. mun.;2008;51;1214;560;654
Vilnius d. mun.;2008;52;1253;623;630
Vilnius d. mun.;2008;53;1186;614;572
Vilnius d. mun.;2008;54;1126;528;598
Vilnius d. mun.;2008;55;1189;559;630
Vilnius d. mun.;2008;56;1192;562;630
Vilnius d. mun.;2008;57;1208;581;627
Vilnius d. mun.;2008;58;1165;575;590
Vilnius d. mun.;2008;59;1003;473;530
Vilnius d. mun.;2008;60;896;407;489
Vilnius d. mun.;2008;61;833;375;458
Vilnius d. mun.;2008;62;910;416;494
Vilnius d. mun.;2008;63;698;320;378
Vilnius d. mun.;2008;64;743;344;399
Vilnius d. mun.;2008;65;915;394;521
Vilnius d. mun.;2008;66;757;310;447
Vilnius d. mun.;2008;67;823;329;494
Vilnius d. mun.;2008;68;793;319;474
Vilnius d. mun.;2008;69;777;318;459
Vilnius d. mun.;2008;70;854;320;534
Vilnius d. mun.;2008;71;811;308;503
Vilnius d. mun.;2008;72;780;312;468
Vilnius d. mun.;2008;73;711;256;455
Vilnius d. mun.;2008;74;620;203;417
Vilnius d. mun.;2008;75;654;210;444
Vilnius d. mun.;2008;76;599;204;395
Vilnius d. mun.;2008;77;612;210;402
Vilnius d. mun.;2008;78;461;138;323
Vilnius d. mun.;2008;79;509;156;353
Vilnius d. mun.;2008;80;447;130;317
Vilnius d. mun.;2008;81;391;93;298
Vilnius d. mun.;2008;82;362;79;283
Vilnius d. mun.;2008;83;298;53;245
Vilnius d. mun.;2008;84;268;68;200
Vilnius d. mun.;2008;85;984;214;770
Vilnius d. mun.;2009;-1;95700;46335;49365
Vilnius d. mun.;2009;0;1039;538;501
Vilnius d. mun.;2009;1;1003;514;489
Vilnius d. mun.;2009;2;963;478;485
Vilnius d. mun.;2009;3;995;498;497
Vilnius d. mun.;2009;4;965;498;467
Vilnius d. mun.;2009;5;830;425;405
Vilnius d. mun.;2009;6;916;476;440
Vilnius d. mun.;2009;7;997;520;477
Vilnius d. mun.;2009;8;1046;558;488
Vilnius d. mun.;2009;9;1100;576;524
Vilnius d. mun.;2009;10;1051;538;513
Vilnius d. mun.;2009;11;1121;599;522
Vilnius d. mun.;2009;12;1108;607;501
Vilnius d. mun.;2009;13;1154;609;545
Vilnius d. mun.;2009;14;1155;607;548
Vilnius d. mun.;2009;15;1289;678;611
Vilnius d. mun.;2009;16;1450;786;664
Vilnius d. mun.;2009;17;1488;771;717
Vilnius d. mun.;2009;18;1496;761;735
Vilnius d. mun.;2009;19;1414;732;682
Vilnius d. mun.;2009;20;1419;733;686
Vilnius d. mun.;2009;21;1505;799;706
Vilnius d. mun.;2009;22;1442;759;683
Vilnius d. mun.;2009;23;1427;774;653
Vilnius d. mun.;2009;24;1381;711;670
Vilnius d. mun.;2009;25;1406;697;709
Vilnius d. mun.;2009;26;1365;732;633
Vilnius d. mun.;2009;27;1320;683;637
Vilnius d. mun.;2009;28;1339;700;639
Vilnius d. mun.;2009;29;1327;675;652
Vilnius d. mun.;2009;30;1422;724;698
Vilnius d. mun.;2009;31;1335;676;659
Vilnius d. mun.;2009;32;1410;687;723
Vilnius d. mun.;2009;33;1400;731;669
Vilnius d. mun.;2009;34;1379;700;679
Vilnius d. mun.;2009;35;1396;732;664
Vilnius d. mun.;2009;36;1447;713;734
Vilnius d. mun.;2009;37;1462;756;706
Vilnius d. mun.;2009;38;1502;745;757
Vilnius d. mun.;2009;39;1438;748;690
Vilnius d. mun.;2009;40;1492;759;733
Vilnius d. mun.;2009;41;1354;711;643
Vilnius d. mun.;2009;42;1399;684;715
Vilnius d. mun.;2009;43;1338;697;641
Vilnius d. mun.;2009;44;1475;757;718
Vilnius d. mun.;2009;45;1480;755;725
Vilnius d. mun.;2009;46;1546;787;759
Vilnius d. mun.;2009;47;1621;789;832
Vilnius d. mun.;2009;48;1599;782;817
Vilnius d. mun.;2009;49;1548;759;789
Vilnius d. mun.;2009;50;1541;767;774
Vilnius d. mun.;2009;51;1422;726;696
Vilnius d. mun.;2009;52;1221;559;662
Vilnius d. mun.;2009;53;1259;624;635
Vilnius d. mun.;2009;54;1177;604;573
Vilnius d. mun.;2009;55;1121;523;598
Vilnius d. mun.;2009;56;1187;555;632
Vilnius d. mun.;2009;57;1196;562;634
Vilnius d. mun.;2009;58;1202;571;631
Vilnius d. mun.;2009;59;1149;559;590
Vilnius d. mun.;2009;60;990;455;535
Vilnius d. mun.;2009;61;874;394;480
Vilnius d. mun.;2009;62;804;354;450
Vilnius d. mun.;2009;63;897;407;490
Vilnius d. mun.;2009;64;680;314;366
Vilnius d. mun.;2009;65;737;342;395
Vilnius d. mun.;2009;66;894;383;511
Vilnius d. mun.;2009;67;740;294;446
Vilnius d. mun.;2009;68;796;309;487
Vilnius d. mun.;2009;69;763;303;460
Vilnius d. mun.;2009;70;748;296;452
Vilnius d. mun.;2009;71;819;297;522
Vilnius d. mun.;2009;72;794;291;503
Vilnius d. mun.;2009;73;751;293;458
Vilnius d. mun.;2009;74;692;241;451
Vilnius d. mun.;2009;75;593;192;401
Vilnius d. mun.;2009;76;634;199;435
Vilnius d. mun.;2009;77;575;195;380
Vilnius d. mun.;2009;78;570;193;377
Vilnius d. mun.;2009;79;431;125;306
Vilnius d. mun.;2009;80;478;144;334
Vilnius d. mun.;2009;81;406;110;296
Vilnius d. mun.;2009;82;368;87;281
Vilnius d. mun.;2009;83;330;69;261
Vilnius d. mun.;2009;84;266;44;222
Vilnius d. mun.;2009;85;1041;230;811
Vilnius d. mun.;2010;-1;95939;46246;49693
Vilnius d. mun.;2010;0;1122;586;536
Vilnius d. mun.;2010;1;1045;543;502
Vilnius d. mun.;2010;2;988;508;480
Vilnius d. mun.;2010;3;972;486;486
Vilnius d. mun.;2010;4;1014;508;506
Vilnius d. mun.;2010;5;993;504;489
Vilnius d. mun.;2010;6;840;434;406
Vilnius d. mun.;2010;7;921;480;441
Vilnius d. mun.;2010;8;1001;529;472
Vilnius d. mun.;2010;9;1055;563;492
Vilnius d. mun.;2010;10;1113;584;529
Vilnius d. mun.;2010;11;1062;535;527
Vilnius d. mun.;2010;12;1137;607;530
Vilnius d. mun.;2010;13;1138;624;514
Vilnius d. mun.;2010;14;1167;620;547
Vilnius d. mun.;2010;15;1163;609;554
Vilnius d. mun.;2010;16;1298;683;615
Vilnius d. mun.;2010;17;1468;799;669
Vilnius d. mun.;2010;18;1501;777;724
Vilnius d. mun.;2010;19;1510;772;738
Vilnius d. mun.;2010;20;1408;730;678
Vilnius d. mun.;2010;21;1408;732;676
Vilnius d. mun.;2010;22;1486;788;698
Vilnius d. mun.;2010;23;1416;743;673
Vilnius d. mun.;2010;24;1395;745;650
Vilnius d. mun.;2010;25;1356;699;657
Vilnius d. mun.;2010;26;1378;664;714
Vilnius d. mun.;2010;27;1336;701;635
Vilnius d. mun.;2010;28;1305;667;638
Vilnius d. mun.;2010;29;1330;678;652
Vilnius d. mun.;2010;30;1335;681;654
Vilnius d. mun.;2010;31;1415;724;691
Vilnius d. mun.;2010;32;1363;687;676
Vilnius d. mun.;2010;33;1408;691;717
Vilnius d. mun.;2010;34;1412;731;681
Vilnius d. mun.;2010;35;1361;670;691
Vilnius d. mun.;2010;36;1413;733;680
Vilnius d. mun.;2010;37;1429;691;738
Vilnius d. mun.;2010;38;1439;730;709
Vilnius d. mun.;2010;39;1494;731;763
Vilnius d. mun.;2010;40;1444;744;700
Vilnius d. mun.;2010;41;1482;745;737
Vilnius d. mun.;2010;42;1350;698;652
Vilnius d. mun.;2010;43;1384;664;720
Vilnius d. mun.;2010;44;1324;682;642
Vilnius d. mun.;2010;45;1454;737;717
Vilnius d. mun.;2010;46;1479;745;734
Vilnius d. mun.;2010;47;1531;769;762
Vilnius d. mun.;2010;48;1617;779;838
Vilnius d. mun.;2010;49;1581;759;822
Vilnius d. mun.;2010;50;1543;748;795
Vilnius d. mun.;2010;51;1550;773;777
Vilnius d. mun.;2010;52;1408;707;701
Vilnius d. mun.;2010;53;1204;544;660
Vilnius d. mun.;2010;54;1243;613;630
Vilnius d. mun.;2010;55;1169;593;576
Vilnius d. mun.;2010;56;1116;517;599
Vilnius d. mun.;2010;57;1172;544;628
Vilnius d. mun.;2010;58;1196;559;637
Vilnius d. mun.;2010;59;1205;573;632
Vilnius d. mun.;2010;60;1138;551;587
Vilnius d. mun.;2010;61;982;453;529
Vilnius d. mun.;2010;62;852;377;475
Vilnius d. mun.;2010;63;803;354;449
Vilnius d. mun.;2010;64;882;396;486
Vilnius d. mun.;2010;65;660;299;361
Vilnius d. mun.;2010;66;725;330;395
Vilnius d. mun.;2010;67;878;374;504
Vilnius d. mun.;2010;68;719;276;443
Vilnius d. mun.;2010;69;780;300;480
Vilnius d. mun.;2010;70;754;301;453
Vilnius d. mun.;2010;71;733;286;447
Vilnius d. mun.;2010;72;812;295;517
Vilnius d. mun.;2010;73;780;285;495
Vilnius d. mun.;2010;74;726;277;449
Vilnius d. mun.;2010;75;670;230;440
Vilnius d. mun.;2010;76;572;185;387
Vilnius d. mun.;2010;77;586;177;409
Vilnius d. mun.;2010;78;542;178;364
Vilnius d. mun.;2010;79;531;173;358
Vilnius d. mun.;2010;80;402;107;295
Vilnius d. mun.;2010;81;448;135;313
Vilnius d. mun.;2010;82;375;105;270
Vilnius d. mun.;2010;83;344;75;269
Vilnius d. mun.;2010;84;310;62;248
Vilnius d. mun.;2010;85;1088;205;883
Vilnius d. mun.;2011;-1;95313;45841;49472
Vilnius d. mun.;2011;0;1227;596;631
Vilnius d. mun.;2011;1;1334;690;644
Vilnius d. mun.;2011;2;1186;595;591
Vilnius d. mun.;2011;3;1123;569;554
Vilnius d. mun.;2011;4;1097;556;541
Vilnius d. mun.;2011;5;1064;517;547
Vilnius d. mun.;2011;6;1037;533;504
Vilnius d. mun.;2011;7;1011;515;496
Vilnius d. mun.;2011;8;1026;530;496
Vilnius d. mun.;2011;9;1071;566;505
Vilnius d. mun.;2011;10;1058;565;493
Vilnius d. mun.;2011;11;1117;580;537
Vilnius d. mun.;2011;12;1081;544;537
Vilnius d. mun.;2011;13;1123;602;521
Vilnius d. mun.;2011;14;1101;592;509
Vilnius d. mun.;2011;15;1118;575;543
Vilnius d. mun.;2011;16;1159;616;543
Vilnius d. mun.;2011;17;1327;706;621
Vilnius d. mun.;2011;18;1422;765;657
Vilnius d. mun.;2011;19;1378;725;653
Vilnius d. mun.;2011;20;1409;746;663
Vilnius d. mun.;2011;21;1288;660;628
Vilnius d. mun.;2011;22;1309;668;641
Vilnius d. mun.;2011;23;1372;717;655
Vilnius d. mun.;2011;24;1300;662;638
Vilnius d. mun.;2011;25;1332;716;616
Vilnius d. mun.;2011;26;1259;652;607
Vilnius d. mun.;2011;27;1366;674;692
Vilnius d. mun.;2011;28;1292;648;644
Vilnius d. mun.;2011;29;1274;648;626
Vilnius d. mun.;2011;30;1327;688;639
Vilnius d. mun.;2011;31;1381;693;688
Vilnius d. mun.;2011;32;1426;702;724
Vilnius d. mun.;2011;33;1481;751;730
Vilnius d. mun.;2011;34;1433;704;729
Vilnius d. mun.;2011;35;1455;756;699
Vilnius d. mun.;2011;36;1416;707;709
Vilnius d. mun.;2011;37;1407;708;699
Vilnius d. mun.;2011;38;1495;716;779
Vilnius d. mun.;2011;39;1477;755;722
Vilnius d. mun.;2011;40;1480;723;757
Vilnius d. mun.;2011;41;1462;738;724
Vilnius d. mun.;2011;42;1472;739;733
Vilnius d. mun.;2011;43;1399;723;676
Vilnius d. mun.;2011;44;1389;694;695
Vilnius d. mun.;2011;45;1369;700;669
Vilnius d. mun.;2011;46;1416;711;705
Vilnius d. mun.;2011;47;1483;752;731
Vilnius d. mun.;2011;48;1523;757;766
Vilnius d. mun.;2011;49;1577;774;803
Vilnius d. mun.;2011;50;1551;741;810
Vilnius d. mun.;2011;51;1517;719;798
Vilnius d. mun.;2011;52;1455;715;740
Vilnius d. mun.;2011;53;1369;687;682
Vilnius d. mun.;2011;54;1204;555;649
Vilnius d. mun.;2011;55;1204;588;616
Vilnius d. mun.;2011;56;1115;548;567
Vilnius d. mun.;2011;57;1098;526;572
Vilnius d. mun.;2011;58;1137;523;614
Vilnius d. mun.;2011;59;1130;531;599
Vilnius d. mun.;2011;60;1143;539;604
Vilnius d. mun.;2011;61;1066;507;559
Vilnius d. mun.;2011;62;917;407;510
Vilnius d. mun.;2011;63;813;349;464
Vilnius d. mun.;2011;64;734;325;409
Vilnius d. mun.;2011;65;817;359;458
Vilnius d. mun.;2011;66;626;282;344
Vilnius d. mun.;2011;67;685;289;396
Vilnius d. mun.;2011;68;795;329;466
Vilnius d. mun.;2011;69;650;248;402
Vilnius d. mun.;2011;70;728;293;435
Vilnius d. mun.;2011;71;717;269;448
Vilnius d. mun.;2011;72;654;242;412
Vilnius d. mun.;2011;73;714;244;470
Vilnius d. mun.;2011;74;680;242;438
Vilnius d. mun.;2011;75;648;235;413
Vilnius d. mun.;2011;76;586;197;389
Vilnius d. mun.;2011;77;512;173;339
Vilnius d. mun.;2011;78;532;156;376
Vilnius d. mun.;2011;79;469;143;326
Vilnius d. mun.;2011;80;472;135;337
Vilnius d. mun.;2011;81;374;93;281
Vilnius d. mun.;2011;82;373;100;273
Vilnius d. mun.;2011;83;332;85;247
Vilnius d. mun.;2011;84;280;58;222
Vilnius d. mun.;2011;85;1087;190;897
Vilnius d. mun.;2012;-1;95650;46050;49600
Vilnius d. mun.;2012;0;1026;527;499
Vilnius d. mun.;2012;1;1214;597;617
Vilnius d. mun.;2012;2;1319;688;631
Vilnius d. mun.;2012;3;1207;597;610
Vilnius d. mun.;2012;4;1137;574;563
Vilnius d. mun.;2012;5;1110;558;552
Vilnius d. mun.;2012;6;1078;527;551
Vilnius d. mun.;2012;7;1036;537;499
Vilnius d. mun.;2012;8;1030;535;495
Vilnius d. mun.;2012;9;1029;538;491
Vilnius d. mun.;2012;10;1087;572;515
Vilnius d. mun.;2012;11;1079;571;508
Vilnius d. mun.;2012;12;1127;593;534
Vilnius d. mun.;2012;13;1107;557;550
Vilnius d. mun.;2012;14;1129;611;518
Vilnius d. mun.;2012;15;1109;593;516
Vilnius d. mun.;2012;16;1131;585;546
Vilnius d. mun.;2012;17;1161;616;545
Vilnius d. mun.;2012;18;1328;704;624
Vilnius d. mun.;2012;19;1417;768;649
Vilnius d. mun.;2012;20;1363;718;645
Vilnius d. mun.;2012;21;1395;740;655
Vilnius d. mun.;2012;22;1272;664;608
Vilnius d. mun.;2012;23;1267;650;617
Vilnius d. mun.;2012;24;1321;698;623
Vilnius d. mun.;2012;25;1270;646;624
Vilnius d. mun.;2012;26;1312;702;610
Vilnius d. mun.;2012;27;1252;654;598
Vilnius d. mun.;2012;28;1351;674;677
Vilnius d. mun.;2012;29;1303;649;654
Vilnius d. mun.;2012;30;1276;648;628
Vilnius d. mun.;2012;31;1346;696;650
Vilnius d. mun.;2012;32;1393;695;698
Vilnius d. mun.;2012;33;1428;704;724
Vilnius d. mun.;2012;34;1512;771;741
Vilnius d. mun.;2012;35;1438;710;728
Vilnius d. mun.;2012;36;1466;762;704
Vilnius d. mun.;2012;37;1415;707;708
Vilnius d. mun.;2012;38;1411;708;703
Vilnius d. mun.;2012;39;1509;720;789
Vilnius d. mun.;2012;40;1494;769;725
Vilnius d. mun.;2012;41;1492;737;755
Vilnius d. mun.;2012;42;1455;734;721
Vilnius d. mun.;2012;43;1500;754;746
Vilnius d. mun.;2012;44;1400;723;677
Vilnius d. mun.;2012;45;1394;687;707
Vilnius d. mun.;2012;46;1377;711;666
Vilnius d. mun.;2012;47;1418;710;708
Vilnius d. mun.;2012;48;1463;738;725
Vilnius d. mun.;2012;49;1515;752;763
Vilnius d. mun.;2012;50;1555;754;801
Vilnius d. mun.;2012;51;1546;743;803
Vilnius d. mun.;2012;52;1501;708;793
Vilnius d. mun.;2012;53;1438;700;738
Vilnius d. mun.;2012;54;1357;668;689
Vilnius d. mun.;2012;55;1209;553;656
Vilnius d. mun.;2012;56;1190;578;612
Vilnius d. mun.;2012;57;1106;539;567
Vilnius d. mun.;2012;58;1093;522;571
Vilnius d. mun.;2012;59;1134;515;619
Vilnius d. mun.;2012;60;1117;523;594
Vilnius d. mun.;2012;61;1119;524;595
Vilnius d. mun.;2012;62;1056;496;560
Vilnius d. mun.;2012;63;918;401;517
Vilnius d. mun.;2012;64;803;341;462
Vilnius d. mun.;2012;65;726;320;406
Vilnius d. mun.;2012;66;802;350;452
Vilnius d. mun.;2012;67;610;267;343
Vilnius d. mun.;2012;68;662;273;389
Vilnius d. mun.;2012;69;777;320;457
Vilnius d. mun.;2012;70;638;235;403
Vilnius d. mun.;2012;71;717;287;430
Vilnius d. mun.;2012;72;698;258;440
Vilnius d. mun.;2012;73;636;230;406
Vilnius d. mun.;2012;74;684;229;455
Vilnius d. mun.;2012;75;651;221;430
Vilnius d. mun.;2012;76;622;228;394
Vilnius d. mun.;2012;77;554;180;374
Vilnius d. mun.;2012;78;485;161;324
Vilnius d. mun.;2012;79;511;149;362
Vilnius d. mun.;2012;80;445;135;310
Vilnius d. mun.;2012;81;445;123;322
Vilnius d. mun.;2012;82;345;79;266
Vilnius d. mun.;2012;83;344;93;251
Vilnius d. mun.;2012;84;309;71;238
Vilnius d. mun.;2012;85;1178;197;981
Vilnius d. mun.;2013;-1;95035;45732;49303
Vilnius d. mun.;2013;0;1067;553;514
Vilnius d. mun.;2013;1;954;489;465
Vilnius d. mun.;2013;2;1099;543;556
Vilnius d. mun.;2013;3;1275;650;625
Vilnius d. mun.;2013;4;1154;565;589
Vilnius d. mun.;2013;5;1091;555;536
Vilnius d. mun.;2013;6;1064;536;528
Vilnius d. mun.;2013;7;1077;532;545
Vilnius d. mun.;2013;8;1033;542;491
Vilnius d. mun.;2013;9;1036;537;499
Vilnius d. mun.;2013;10;1034;543;491
Vilnius d. mun.;2013;11;1089;579;510
Vilnius d. mun.;2013;12;1090;572;518
Vilnius d. mun.;2013;13;1131;591;540
Vilnius d. mun.;2013;14;1106;554;552
Vilnius d. mun.;2013;15;1130;617;513
Vilnius d. mun.;2013;16;1123;605;518
Vilnius d. mun.;2013;17;1147;589;558
Vilnius d. mun.;2013;18;1160;615;545
Vilnius d. mun.;2013;19;1317;697;620
Vilnius d. mun.;2013;20;1405;759;646
Vilnius d. mun.;2013;21;1344;709;635
Vilnius d. mun.;2013;22;1374;728;646
Vilnius d. mun.;2013;23;1246;648;598
Vilnius d. mun.;2013;24;1226;629;597
Vilnius d. mun.;2013;25;1289;682;607
Vilnius d. mun.;2013;26;1230;625;605
Vilnius d. mun.;2013;27;1279;679;600
Vilnius d. mun.;2013;28;1203;634;569
Vilnius d. mun.;2013;29;1343;674;669
Vilnius d. mun.;2013;30;1288;652;636
Vilnius d. mun.;2013;31;1256;640;616
Vilnius d. mun.;2013;32;1334;697;637
Vilnius d. mun.;2013;33;1368;695;673
Vilnius d. mun.;2013;34;1418;699;719
Vilnius d. mun.;2013;35;1512;770;742
Vilnius d. mun.;2013;36;1426;715;711
Vilnius d. mun.;2013;37;1465;763;702
Vilnius d. mun.;2013;38;1417;710;707
Vilnius d. mun.;2013;39;1396;697;699
Vilnius d. mun.;2013;40;1509;721;788
Vilnius d. mun.;2013;41;1493;770;723
Vilnius d. mun.;2013;42;1476;725;751
Vilnius d. mun.;2013;43;1430;718;712
Vilnius d. mun.;2013;44;1483;742;741
Vilnius d. mun.;2013;45;1396;721;675
Vilnius d. mun.;2013;46;1379;669;710
Vilnius d. mun.;2013;47;1362;696;666
Vilnius d. mun.;2013;48;1399;693;706
Vilnius d. mun.;2013;49;1456;731;725
Vilnius d. mun.;2013;50;1516;744;772
Vilnius d. mun.;2013;51;1550;749;801
Vilnius d. mun.;2013;52;1555;749;806
Vilnius d. mun.;2013;53;1483;688;795
Vilnius d. mun.;2013;54;1438;694;744
Vilnius d. mun.;2013;55;1336;648;688
Vilnius d. mun.;2013;56;1184;537;647
Vilnius d. mun.;2013;57;1178;570;608
Vilnius d. mun.;2013;58;1094;525;569
Vilnius d. mun.;2013;59;1088;518;570
Vilnius d. mun.;2013;60;1120;500;620
Vilnius d. mun.;2013;61;1104;510;594
Vilnius d. mun.;2013;62;1106;515;591
Vilnius d. mun.;2013;63;1045;480;565
Vilnius d. mun.;2013;64;907;387;520
Vilnius d. mun.;2013;65;796;336;460
Vilnius d. mun.;2013;66;717;311;406
Vilnius d. mun.;2013;67;788;339;449
Vilnius d. mun.;2013;68;598;260;338
Vilnius d. mun.;2013;69;657;265;392
Vilnius d. mun.;2013;70;758;307;451
Vilnius d. mun.;2013;71;618;224;394
Vilnius d. mun.;2013;72;685;266;419
Vilnius d. mun.;2013;73;678;247;431
Vilnius d. mun.;2013;74;613;219;394
Vilnius d. mun.;2013;75;643;210;433
Vilnius d. mun.;2013;76;633;216;417
Vilnius d. mun.;2013;77;600;213;387
Vilnius d. mun.;2013;78;521;169;352
Vilnius d. mun.;2013;79;460;150;310
Vilnius d. mun.;2013;80;478;131;347
Vilnius d. mun.;2013;81;415;122;293
Vilnius d. mun.;2013;82;415;115;300
Vilnius d. mun.;2013;83;313;70;243
Vilnius d. mun.;2013;84;314;82;232
Vilnius d. mun.;2013;85;1252;211;1041
Vilnius d. mun.;2014;-1;95031;45763;49268
Vilnius d. mun.;2014;0;1017;515;502
Vilnius d. mun.;2014;1;993;507;486
Vilnius d. mun.;2014;2;890;452;438
Vilnius d. mun.;2014;3;1069;525;544
Vilnius d. mun.;2014;4;1280;646;634
Vilnius d. mun.;2014;5;1140;559;581
Vilnius d. mun.;2014;6;1078;546;532
Vilnius d. mun.;2014;7;1048;530;518
Vilnius d. mun.;2014;8;1095;539;556
Vilnius d. mun.;2014;9;1051;550;501
Vilnius d. mun.;2014;10;1046;545;501
Vilnius d. mun.;2014;11;1035;539;496
Vilnius d. mun.;2014;12;1105;583;522
Vilnius d. mun.;2014;13;1103;580;523
Vilnius d. mun.;2014;14;1146;596;550
Vilnius d. mun.;2014;15;1099;550;549
Vilnius d. mun.;2014;16;1145;626;519
Vilnius d. mun.;2014;17;1136;613;523
Vilnius d. mun.;2014;18;1150;582;568
Vilnius d. mun.;2014;19;1148;614;534
Vilnius d. mun.;2014;20;1299;689;610
Vilnius d. mun.;2014;21;1402;759;643
Vilnius d. mun.;2014;22;1336;705;631
Vilnius d. mun.;2014;23;1360;739;621
Vilnius d. mun.;2014;24;1244;651;593
Vilnius d. mun.;2014;25;1218;626;592
Vilnius d. mun.;2014;26;1270;681;589
Vilnius d. mun.;2014;27;1219;626;593
Vilnius d. mun.;2014;28;1294;689;605
Vilnius d. mun.;2014;29;1187;623;564
Vilnius d. mun.;2014;30;1351;678;673
Vilnius d. mun.;2014;31;1286;658;628
Vilnius d. mun.;2014;32;1268;648;620
Vilnius d. mun.;2014;33;1321;684;637
Vilnius d. mun.;2014;34;1379;700;679
Vilnius d. mun.;2014;35;1409;698;711
Vilnius d. mun.;2014;36;1506;780;726
Vilnius d. mun.;2014;37;1427;716;711
Vilnius d. mun.;2014;38;1479;771;708
Vilnius d. mun.;2014;39;1419;706;713
Vilnius d. mun.;2014;40;1392;700;692
Vilnius d. mun.;2014;41;1529;737;792
Vilnius d. mun.;2014;42;1490;762;728
Vilnius d. mun.;2014;43;1467;716;751
Vilnius d. mun.;2014;44;1438;723;715
Vilnius d. mun.;2014;45;1479;743;736
Vilnius d. mun.;2014;46;1397;712;685
Vilnius d. mun.;2014;47;1380;671;709
Vilnius d. mun.;2014;48;1369;700;669
Vilnius d. mun.;2014;49;1382;674;708
Vilnius d. mun.;2014;50;1461;722;739
Vilnius d. mun.;2014;51;1508;738;770
Vilnius d. mun.;2014;52;1555;747;808
Vilnius d. mun.;2014;53;1560;747;813
Vilnius d. mun.;2014;54;1466;669;797
Vilnius d. mun.;2014;55;1419;686;733
Vilnius d. mun.;2014;56;1331;640;691
Vilnius d. mun.;2014;57;1168;532;636
Vilnius d. mun.;2014;58;1166;553;613
Vilnius d. mun.;2014;59;1078;512;566
Vilnius d. mun.;2014;60;1074;510;564
Vilnius d. mun.;2014;61;1099;487;612
Vilnius d. mun.;2014;62;1079;491;588
Vilnius d. mun.;2014;63;1096;506;590
Vilnius d. mun.;2014;64;1016;460;556
Vilnius d. mun.;2014;65;893;377;516
Vilnius d. mun.;2014;66;791;336;455
Vilnius d. mun.;2014;67;701;305;396
Vilnius d. mun.;2014;68;770;326;444
Vilnius d. mun.;2014;69;582;252;330
Vilnius d. mun.;2014;70;647;255;392
Vilnius d. mun.;2014;71;746;298;448
Vilnius d. mun.;2014;72;610;218;392
Vilnius d. mun.;2014;73;656;247;409
Vilnius d. mun.;2014;74;661;239;422
Vilnius d. mun.;2014;75;586;209;377
Vilnius d. mun.;2014;76;627;204;423
Vilnius d. mun.;2014;77;594;198;396
Vilnius d. mun.;2014;78;570;199;371
Vilnius d. mun.;2014;79;495;163;332
Vilnius d. mun.;2014;80;434;141;293
Vilnius d. mun.;2014;81;439;118;321
Vilnius d. mun.;2014;82;389;112;277
Vilnius d. mun.;2014;83;377;103;274
Vilnius d. mun.;2014;84;282;60;222
Vilnius d. mun.;2014;85;1334;241;1093
Vilnius d. mun.;2015;-1;95620;46051;49569
Vilnius d. mun.;2015;0;983;531;452
Vilnius d. mun.;2015;1;988;495;493
Vilnius d. mun.;2015;2;940;478;462
Vilnius d. mun.;2015;3;927;463;464
Vilnius d. mun.;2015;4;1108;546;562
Vilnius d. mun.;2015;5;1312;659;653
Vilnius d. mun.;2015;6;1145;558;587
Vilnius d. mun.;2015;7;1121;566;555
Vilnius d. mun.;2015;8;1068;549;519
Vilnius d. mun.;2015;9;1109;544;565
Vilnius d. mun.;2015;10;1065;562;503
Vilnius d. mun.;2015;11;1032;532;500
Vilnius d. mun.;2015;12;1046;547;499
Vilnius d. mun.;2015;13;1116;586;530
Vilnius d. mun.;2015;14;1113;590;523
Vilnius d. mun.;2015;15;1105;571;534
Vilnius d. mun.;2015;16;1112;562;550
Vilnius d. mun.;2015;17;1153;632;521
Vilnius d. mun.;2015;18;1146;616;530
Vilnius d. mun.;2015;19;1150;583;567
Vilnius d. mun.;2015;20;1133;608;525
Vilnius d. mun.;2015;21;1294;689;605
Vilnius d. mun.;2015;22;1396;761;635
Vilnius d. mun.;2015;23;1337;704;633
Vilnius d. mun.;2015;24;1343;730;613
Vilnius d. mun.;2015;25;1244;655;589
Vilnius d. mun.;2015;26;1219;621;598
Vilnius d. mun.;2015;27;1263;667;596
Vilnius d. mun.;2015;28;1239;645;594
Vilnius d. mun.;2015;29;1290;697;593
Vilnius d. mun.;2015;30;1246;663;583
Vilnius d. mun.;2015;31;1360;677;683
Vilnius d. mun.;2015;32;1311;664;647
Vilnius d. mun.;2015;33;1287;662;625
Vilnius d. mun.;2015;34;1346;696;650
Vilnius d. mun.;2015;35;1407;713;694
Vilnius d. mun.;2015;36;1435;717;718
Vilnius d. mun.;2015;37;1522;791;731
Vilnius d. mun.;2015;38;1452;731;721
Vilnius d. mun.;2015;39;1489;783;706
Vilnius d. mun.;2015;40;1438;719;719
Vilnius d. mun.;2015;41;1410;703;707
Vilnius d. mun.;2015;42;1532;726;806
Vilnius d. mun.;2015;43;1499;767;732
Vilnius d. mun.;2015;44;1461;708;753
Vilnius d. mun.;2015;45;1420;710;710
Vilnius d. mun.;2015;46;1483;743;740
Vilnius d. mun.;2015;47;1397;709;688
Vilnius d. mun.;2015;48;1379;674;705
Vilnius d. mun.;2015;49;1370;694;676
Vilnius d. mun.;2015;50;1380;671;709
Vilnius d. mun.;2015;51;1463;710;753
Vilnius d. mun.;2015;52;1507;738;769
Vilnius d. mun.;2015;53;1530;727;803
Vilnius d. mun.;2015;54;1550;737;813
Vilnius d. mun.;2015;55;1462;657;805
Vilnius d. mun.;2015;56;1419;684;735
Vilnius d. mun.;2015;57;1325;628;697
Vilnius d. mun.;2015;58;1166;524;642
Vilnius d. mun.;2015;59;1161;547;614
Vilnius d. mun.;2015;60;1086;515;571
Vilnius d. mun.;2015;61;1066;502;564
Vilnius d. mun.;2015;62;1088;474;614
Vilnius d. mun.;2015;63;1071;481;590
Vilnius d. mun.;2015;64;1066;485;581
Vilnius d. mun.;2015;65;1006;451;555
Vilnius d. mun.;2015;66;881;371;510
Vilnius d. mun.;2015;67;779;325;454
Vilnius d. mun.;2015;68;683;297;386
Vilnius d. mun.;2015;69;749;308;441
Vilnius d. mun.;2015;70;563;235;328
Vilnius d. mun.;2015;71;636;247;389
Vilnius d. mun.;2015;72;734;294;440
Vilnius d. mun.;2015;73;595;207;388
Vilnius d. mun.;2015;74;631;234;397
Vilnius d. mun.;2015;75;638;226;412
Vilnius d. mun.;2015;76;571;202;369
Vilnius d. mun.;2015;77;598;196;402
Vilnius d. mun.;2015;78;570;183;387
Vilnius d. mun.;2015;79;542;179;363
Vilnius d. mun.;2015;80;454;143;311
Vilnius d. mun.;2015;81;401;129;272
Vilnius d. mun.;2015;82;406;105;301
Vilnius d. mun.;2015;83;365;106;259
Vilnius d. mun.;2015;84;329;81;248
Vilnius d. mun.;2015;85;1408;255;1153
Vilnius d. mun.;2016;-1;95189;45782;49407
Vilnius d. mun.;2016;0;1080;576;504
Vilnius d. mun.;2016;1;927;504;423
Vilnius d. mun.;2016;2;904;460;444
Vilnius d. mun.;2016;3;933;471;462
Vilnius d. mun.;2016;4;917;465;452
Vilnius d. mun.;2016;5;1096;533;563
Vilnius d. mun.;2016;6;1290;651;639
Vilnius d. mun.;2016;7;1148;563;585
Vilnius d. mun.;2016;8;1136;571;565
Vilnius d. mun.;2016;9;1086;557;529
Vilnius d. mun.;2016;10;1104;541;563
Vilnius d. mun.;2016;11;1049;546;503
Vilnius d. mun.;2016;12;1039;536;503
Vilnius d. mun.;2016;13;1056;553;503
Vilnius d. mun.;2016;14;1109;585;524
Vilnius d. mun.;2016;15;1076;572;504
Vilnius d. mun.;2016;16;1110;574;536
Vilnius d. mun.;2016;17;1117;559;558
Vilnius d. mun.;2016;18;1146;627;519
Vilnius d. mun.;2016;19;1141;614;527
Vilnius d. mun.;2016;20;1132;576;556
Vilnius d. mun.;2016;21;1109;592;517
Vilnius d. mun.;2016;22;1260;662;598
Vilnius d. mun.;2016;23;1361;738;623
Vilnius d. mun.;2016;24;1305;683;622
Vilnius d. mun.;2016;25;1318;725;593
Vilnius d. mun.;2016;26;1215;633;582
Vilnius d. mun.;2016;27;1203;601;602
Vilnius d. mun.;2016;28;1262;660;602
Vilnius d. mun.;2016;29;1226;645;581
Vilnius d. mun.;2016;30;1311;696;615
Vilnius d. mun.;2016;31;1239;674;565
Vilnius d. mun.;2016;32;1333;672;661
Vilnius d. mun.;2016;33;1298;657;641
Vilnius d. mun.;2016;34;1297;664;633
Vilnius d. mun.;2016;35;1328;678;650
Vilnius d. mun.;2016;36;1420;721;699
Vilnius d. mun.;2016;37;1426;710;716
Vilnius d. mun.;2016;38;1509;786;723
Vilnius d. mun.;2016;39;1445;722;723
Vilnius d. mun.;2016;40;1494;787;707
Vilnius d. mun.;2016;41;1430;723;707
Vilnius d. mun.;2016;42;1397;693;704
Vilnius d. mun.;2016;43;1525;721;804
Vilnius d. mun.;2016;44;1497;765;732
Vilnius d. mun.;2016;45;1439;694;745
Vilnius d. mun.;2016;46;1396;693;703
Vilnius d. mun.;2016;47;1478;727;751
Vilnius d. mun.;2016;48;1396;702;694
Vilnius d. mun.;2016;49;1375;668;707
Vilnius d. mun.;2016;50;1369;686;683
Vilnius d. mun.;2016;51;1366;657;709
Vilnius d. mun.;2016;52;1440;689;751
Vilnius d. mun.;2016;53;1487;721;766
Vilnius d. mun.;2016;54;1531;725;806
Vilnius d. mun.;2016;55;1538;724;814
Vilnius d. mun.;2016;56;1453;641;812
Vilnius d. mun.;2016;57;1403;673;730
Vilnius d. mun.;2016;58;1306;616;690
Vilnius d. mun.;2016;59;1163;523;640
Vilnius d. mun.;2016;60;1140;528;612
Vilnius d. mun.;2016;61;1071;502;569
Vilnius d. mun.;2016;62;1063;501;562
Vilnius d. mun.;2016;63;1072;464;608
Vilnius d. mun.;2016;64;1058;470;588
Vilnius d. mun.;2016;65;1042;465;577
Vilnius d. mun.;2016;66;992;439;553
Vilnius d. mun.;2016;67;879;365;514
Vilnius d. mun.;2016;68;762;313;449
Vilnius d. mun.;2016;69;676;290;386
Vilnius d. mun.;2016;70;743;303;440
Vilnius d. mun.;2016;71;548;223;325
Vilnius d. mun.;2016;72;615;234;381
Vilnius d. mun.;2016;73;710;278;432
Vilnius d. mun.;2016;74;573;195;378
Vilnius d. mun.;2016;75;602;219;383
Vilnius d. mun.;2016;76;616;219;397
Vilnius d. mun.;2016;77;532;178;354
Vilnius d. mun.;2016;78;566;181;385
Vilnius d. mun.;2016;79;532;166;366
Vilnius d. mun.;2016;80;513;166;347
Vilnius d. mun.;2016;81;403;119;284
Vilnius d. mun.;2016;82;358;117;241
Vilnius d. mun.;2016;83;368;97;271
Vilnius d. mun.;2016;84;322;92;230
Vilnius d. mun.;2016;85;1489;277;1212
Vilnius d. mun.;2017;-1;95940;46277;49663
Vilnius d. mun.;2017;0;1056;544;512
Vilnius d. mun.;2017;1;1067;579;488
Vilnius d. mun.;2017;2;839;460;379
Vilnius d. mun.;2017;3;923;473;450
Vilnius d. mun.;2017;4;947;497;450
Vilnius d. mun.;2017;5;932;472;460
Vilnius d. mun.;2017;6;1100;542;558
Vilnius d. mun.;2017;7;1335;666;669
Vilnius d. mun.;2017;8;1190;575;615
Vilnius d. mun.;2017;9;1174;579;595
Vilnius d. mun.;2017;10;1107;570;537
Vilnius d. mun.;2017;11;1110;545;565
Vilnius d. mun.;2017;12;1058;553;505
Vilnius d. mun.;2017;13;1052;538;514
Vilnius d. mun.;2017;14;1048;547;501
Vilnius d. mun.;2017;15;1104;577;527
Vilnius d. mun.;2017;16;1100;584;516
Vilnius d. mun.;2017;17;1131;586;545
Vilnius d. mun.;2017;18;1123;564;559
Vilnius d. mun.;2017;19;1158;634;524
Vilnius d. mun.;2017;20;1139;615;524
Vilnius d. mun.;2017;21;1129;576;553
Vilnius d. mun.;2017;22;1095;592;503
Vilnius d. mun.;2017;23;1252;664;588
Vilnius d. mun.;2017;24;1343;737;606
Vilnius d. mun.;2017;25;1294;684;610
Vilnius d. mun.;2017;26;1311;719;592
Vilnius d. mun.;2017;27;1228;630;598
Vilnius d. mun.;2017;28;1213;621;592
Vilnius d. mun.;2017;29;1265;670;595
Vilnius d. mun.;2017;30;1215;640;575
Vilnius d. mun.;2017;31;1358;735;623
Vilnius d. mun.;2017;32;1254;676;578
Vilnius d. mun.;2017;33;1356;702;654
Vilnius d. mun.;2017;34;1324;660;664
Vilnius d. mun.;2017;35;1291;657;634
Vilnius d. mun.;2017;36;1351;699;652
Vilnius d. mun.;2017;37;1436;732;704
Vilnius d. mun.;2017;38;1477;738;739
Vilnius d. mun.;2017;39;1514;788;726
Vilnius d. mun.;2017;40;1449;720;729
Vilnius d. mun.;2017;41;1516;789;727
Vilnius d. mun.;2017;42;1443;738;705
Vilnius d. mun.;2017;43;1405;697;708
Vilnius d. mun.;2017;44;1527;725;802
Vilnius d. mun.;2017;45;1525;780;745
Vilnius d. mun.;2017;46;1450;701;749
Vilnius d. mun.;2017;47;1410;689;721
Vilnius d. mun.;2017;48;1479;734;745
Vilnius d. mun.;2017;49;1404;708;696
Vilnius d. mun.;2017;50;1364;661;703
Vilnius d. mun.;2017;51;1381;692;689
Vilnius d. mun.;2017;52;1360;656;704
Vilnius d. mun.;2017;53;1446;687;759
Vilnius d. mun.;2017;54;1493;718;775
Vilnius d. mun.;2017;55;1540;726;814
Vilnius d. mun.;2017;56;1545;729;816
Vilnius d. mun.;2017;57;1457;640;817
Vilnius d. mun.;2017;58;1393;663;730
Vilnius d. mun.;2017;59;1297;612;685
Vilnius d. mun.;2017;60;1166;514;652
Vilnius d. mun.;2017;61;1124;525;599
Vilnius d. mun.;2017;62;1083;505;578
Vilnius d. mun.;2017;63;1054;494;560
Vilnius d. mun.;2017;64;1056;448;608
Vilnius d. mun.;2017;65;1037;452;585
Vilnius d. mun.;2017;66;1028;455;573
Vilnius d. mun.;2017;67;981;432;549
Vilnius d. mun.;2017;68;869;359;510
Vilnius d. mun.;2017;69;741;295;446
Vilnius d. mun.;2017;70;664;281;383
Vilnius d. mun.;2017;71;722;290;432
Vilnius d. mun.;2017;72;542;221;321
Vilnius d. mun.;2017;73;598;225;373
Vilnius d. mun.;2017;74;686;265;421
Vilnius d. mun.;2017;75;557;186;371
Vilnius d. mun.;2017;76;582;206;376
Vilnius d. mun.;2017;77;590;204;386
Vilnius d. mun.;2017;78;500;159;341
Vilnius d. mun.;2017;79;530;161;369
Vilnius d. mun.;2017;80;503;157;346
Vilnius d. mun.;2017;81;470;148;322
Vilnius d. mun.;2017;82;368;102;266
Vilnius d. mun.;2017;83;323;106;217
Vilnius d. mun.;2017;84;332;86;246
Vilnius d. mun.;2017;85;1551;316;1235
Vilnius d. mun.;2018;-1;96575;46907;49668
Vilnius d. mun.;2018;0;1015;522;493
Vilnius d. mun.;2018;1;1010;524;486
Vilnius d. mun.;2018;2;1005;552;453
Vilnius d. mun.;2018;3;871;471;400
Vilnius d. mun.;2018;4;949;473;476
Vilnius d. mun.;2018;5;954;504;450
Vilnius d. mun.;2018;6;932;475;457
Vilnius d. mun.;2018;7;1154;568;586
Vilnius d. mun.;2018;8;1375;686;689
Vilnius d. mun.;2018;9;1210;588;622
Vilnius d. mun.;2018;10;1169;572;597
Vilnius d. mun.;2018;11;1108;566;542
Vilnius d. mun.;2018;12;1122;545;577
Vilnius d. mun.;2018;13;1064;557;507
Vilnius d. mun.;2018;14;1038;529;509
Vilnius d. mun.;2018;15;1012;532;480
Vilnius d. mun.;2018;16;1117;592;525
Vilnius d. mun.;2018;17;1109;587;522
Vilnius d. mun.;2018;18;1118;578;540
Vilnius d. mun.;2018;19;1113;563;550
Vilnius d. mun.;2018;20;1128;611;517
Vilnius d. mun.;2018;21;1106;598;508
Vilnius d. mun.;2018;22;1107;567;540
Vilnius d. mun.;2018;23;1073;588;485
Vilnius d. mun.;2018;24;1222;651;571
Vilnius d. mun.;2018;25;1272;704;568
Vilnius d. mun.;2018;26;1271;682;589
Vilnius d. mun.;2018;27;1287;728;559
Vilnius d. mun.;2018;28;1229;650;579
Vilnius d. mun.;2018;29;1235;640;595
Vilnius d. mun.;2018;30;1293;699;594
Vilnius d. mun.;2018;31;1252;658;594
Vilnius d. mun.;2018;32;1373;750;623
Vilnius d. mun.;2018;33;1291;699;592
Vilnius d. mun.;2018;34;1385;732;653
Vilnius d. mun.;2018;35;1341;677;664
Vilnius d. mun.;2018;36;1319;668;651
Vilnius d. mun.;2018;37;1385;735;650
Vilnius d. mun.;2018;38;1472;770;702
Vilnius d. mun.;2018;39;1489;762;727
Vilnius d. mun.;2018;40;1528;793;735
Vilnius d. mun.;2018;41;1458;739;719
Vilnius d. mun.;2018;42;1529;795;734
Vilnius d. mun.;2018;43;1450;747;703
Vilnius d. mun.;2018;44;1442;726;716
Vilnius d. mun.;2018;45;1535;740;795
Vilnius d. mun.;2018;46;1534;788;746
Vilnius d. mun.;2018;47;1469;715;754
Vilnius d. mun.;2018;48;1431;707;724
Vilnius d. mun.;2018;49;1487;735;752
Vilnius d. mun.;2018;50;1411;719;692
Vilnius d. mun.;2018;51;1386;668;718
Vilnius d. mun.;2018;52;1382;692;690
Vilnius d. mun.;2018;53;1365;661;704
Vilnius d. mun.;2018;54;1446;685;761
Vilnius d. mun.;2018;55;1512;735;777
Vilnius d. mun.;2018;56;1536;730;806
Vilnius d. mun.;2018;57;1550;730;820
Vilnius d. mun.;2018;58;1470;652;818
Vilnius d. mun.;2018;59;1396;659;737
Vilnius d. mun.;2018;60;1289;604;685
Vilnius d. mun.;2018;61;1155;511;644
Vilnius d. mun.;2018;62;1111;515;596
Vilnius d. mun.;2018;63;1083;504;579
Vilnius d. mun.;2018;64;1041;485;556
Vilnius d. mun.;2018;65;1049;447;602
Vilnius d. mun.;2018;66;1031;456;575
Vilnius d. mun.;2018;67;1009;437;572
Vilnius d. mun.;2018;68;972;426;546
Vilnius d. mun.;2018;69;866;354;512
Vilnius d. mun.;2018;70;734;289;445
Vilnius d. mun.;2018;71;655;279;376
Vilnius d. mun.;2018;72;709;281;428
Vilnius d. mun.;2018;73;534;215;319
Vilnius d. mun.;2018;74;585;222;363
Vilnius d. mun.;2018;75;664;251;413
Vilnius d. mun.;2018;76;544;182;362
Vilnius d. mun.;2018;77;560;197;363
Vilnius d. mun.;2018;78;560;186;374
Vilnius d. mun.;2018;79;480;149;331
Vilnius d. mun.;2018;80;497;148;349
Vilnius d. mun.;2018;81;483;150;333
Vilnius d. mun.;2018;82;437;135;302
Vilnius d. mun.;2018;83;342;92;250
Vilnius d. mun.;2018;84;291;99;192
Vilnius d. mun.;2018;85;1602;324;1278
Visaginas mun.;2001;-1;29697;14127;15570
Visaginas mun.;2001;0;204;117;87
Visaginas mun.;2001;1;231;130;101
Visaginas mun.;2001;2;217;106;111
Visaginas mun.;2001;3;223;124;99
Visaginas mun.;2001;4;277;135;142
Visaginas mun.;2001;5;271;132;139
Visaginas mun.;2001;6;274;146;128
Visaginas mun.;2001;7;294;158;136
Visaginas mun.;2001;8;367;182;185
Visaginas mun.;2001;9;369;188;181
Visaginas mun.;2001;10;423;210;213
Visaginas mun.;2001;11;552;255;297
Visaginas mun.;2001;12;623;322;301
Visaginas mun.;2001;13;695;339;356
Visaginas mun.;2001;14;686;368;318
Visaginas mun.;2001;15;753;389;364
Visaginas mun.;2001;16;755;401;354
Visaginas mun.;2001;17;663;327;336
Visaginas mun.;2001;18;585;295;290
Visaginas mun.;2001;19;536;279;257
Visaginas mun.;2001;20;483;256;227
Visaginas mun.;2001;21;478;234;244
Visaginas mun.;2001;22;407;200;207
Visaginas mun.;2001;23;403;191;212
Visaginas mun.;2001;24;404;201;203
Visaginas mun.;2001;25;415;194;221
Visaginas mun.;2001;26;375;189;186
Visaginas mun.;2001;27;378;192;186
Visaginas mun.;2001;28;376;176;200
Visaginas mun.;2001;29;402;191;211
Visaginas mun.;2001;30;398;191;207
Visaginas mun.;2001;31;400;184;216
Visaginas mun.;2001;32;411;199;212
Visaginas mun.;2001;33;378;161;217
Visaginas mun.;2001;34;429;193;236
Visaginas mun.;2001;35;524;218;306
Visaginas mun.;2001;36;552;250;302
Visaginas mun.;2001;37;656;319;337
Visaginas mun.;2001;38;768;352;416
Visaginas mun.;2001;39;780;336;444
Visaginas mun.;2001;40;746;338;408
Visaginas mun.;2001;41;824;412;412
Visaginas mun.;2001;42;734;320;414
Visaginas mun.;2001;43;684;319;365
Visaginas mun.;2001;44;687;333;354
Visaginas mun.;2001;45;630;310;320
Visaginas mun.;2001;46;522;252;270
Visaginas mun.;2001;47;548;250;298
Visaginas mun.;2001;48;445;212;233
Visaginas mun.;2001;49;473;237;236
Visaginas mun.;2001;50;416;200;216
Visaginas mun.;2001;51;377;166;211
Visaginas mun.;2001;52;334;157;177
Visaginas mun.;2001;53;286;139;147
Visaginas mun.;2001;54;245;112;133
Visaginas mun.;2001;55;185;69;116
Visaginas mun.;2001;56;163;84;79
Visaginas mun.;2001;57;122;50;72
Visaginas mun.;2001;58;199;98;101
Visaginas mun.;2001;59;213;98;115
Visaginas mun.;2001;60;202;87;115
Visaginas mun.;2001;61;244;115;129
Visaginas mun.;2001;62;251;111;140
Visaginas mun.;2001;63;227;101;126
Visaginas mun.;2001;64;167;67;100
Visaginas mun.;2001;65;142;56;86
Visaginas mun.;2001;66;101;28;73
Visaginas mun.;2001;67;119;54;65
Visaginas mun.;2001;68;129;52;77
Visaginas mun.;2001;69;98;36;62
Visaginas mun.;2001;70;83;32;51
Visaginas mun.;2001;71;95;37;58
Visaginas mun.;2001;72;100;31;69
Visaginas mun.;2001;73;94;39;55
Visaginas mun.;2001;74;73;24;49
Visaginas mun.;2001;75;75;19;56
Visaginas mun.;2001;76;44;9;35
Visaginas mun.;2001;77;31;7;24
Visaginas mun.;2001;78;25;8;17
Visaginas mun.;2001;79;18;5;13
Visaginas mun.;2001;80;28;8;20
Visaginas mun.;2001;81;12;2;10
Visaginas mun.;2001;82;16;4;12
Visaginas mun.;2001;83;11;2;9
Visaginas mun.;2001;84;6;0;6
Visaginas mun.;2001;85;58;7;51
Visaginas mun.;2002;-1;28718;13701;15017
Visaginas mun.;2002;0;231;138;93
Visaginas mun.;2002;1;196;111;85
Visaginas mun.;2002;2;216;121;95
Visaginas mun.;2002;3;210;103;107
Visaginas mun.;2002;4;214;120;94
Visaginas mun.;2002;5;264;129;135
Visaginas mun.;2002;6;258;124;134
Visaginas mun.;2002;7;262;140;122
Visaginas mun.;2002;8;287;156;131
Visaginas mun.;2002;9;349;172;177
Visaginas mun.;2002;10;354;182;172
Visaginas mun.;2002;11;403;201;202
Visaginas mun.;2002;12;532;253;279
Visaginas mun.;2002;13;598;313;285
Visaginas mun.;2002;14;671;327;344
Visaginas mun.;2002;15;663;357;306
Visaginas mun.;2002;16;727;374;353
Visaginas mun.;2002;17;735;389;346
Visaginas mun.;2002;18;635;314;321
Visaginas mun.;2002;19;556;281;275
Visaginas mun.;2002;20;502;264;238
Visaginas mun.;2002;21;451;237;214
Visaginas mun.;2002;22;446;216;230
Visaginas mun.;2002;23;389;190;199
Visaginas mun.;2002;24;380;184;196
Visaginas mun.;2002;25;387;197;190
Visaginas mun.;2002;26;388;183;205
Visaginas mun.;2002;27;354;179;175
Visaginas mun.;2002;28;366;185;181
Visaginas mun.;2002;29;361;170;191
Visaginas mun.;2002;30;384;184;200
Visaginas mun.;2002;31;377;183;194
Visaginas mun.;2002;32;380;175;205
Visaginas mun.;2002;33;394;193;201
Visaginas mun.;2002;34;365;154;211
Visaginas mun.;2002;35;410;182;228
Visaginas mun.;2002;36;505;208;297
Visaginas mun.;2002;37;532;242;290
Visaginas mun.;2002;38;634;307;327
Visaginas mun.;2002;39;735;335;400
Visaginas mun.;2002;40;745;318;427
Visaginas mun.;2002;41;721;328;393
Visaginas mun.;2002;42;795;396;399
Visaginas mun.;2002;43;707;313;394
Visaginas mun.;2002;44;666;313;353
Visaginas mun.;2002;45;656;315;341
Visaginas mun.;2002;46;612;300;312
Visaginas mun.;2002;47;501;246;255
Visaginas mun.;2002;48;525;240;285
Visaginas mun.;2002;49;433;207;226
Visaginas mun.;2002;50;457;227;230
Visaginas mun.;2002;51;396;189;207
Visaginas mun.;2002;52;365;158;207
Visaginas mun.;2002;53;321;154;167
Visaginas mun.;2002;54;277;137;140
Visaginas mun.;2002;55;239;111;128
Visaginas mun.;2002;56;178;66;112
Visaginas mun.;2002;57;155;81;74
Visaginas mun.;2002;58;117;50;67
Visaginas mun.;2002;59;189;91;98
Visaginas mun.;2002;60;206;95;111
Visaginas mun.;2002;61;199;85;114
Visaginas mun.;2002;62;239;113;126
Visaginas mun.;2002;63;253;113;140
Visaginas mun.;2002;64;222;96;126
Visaginas mun.;2002;65;164;65;99
Visaginas mun.;2002;66;137;51;86
Visaginas mun.;2002;67;98;27;71
Visaginas mun.;2002;68;114;54;60
Visaginas mun.;2002;69;124;52;72
Visaginas mun.;2002;70;94;32;62
Visaginas mun.;2002;71;77;29;48
Visaginas mun.;2002;72;91;35;56
Visaginas mun.;2002;73;102;33;69
Visaginas mun.;2002;74;87;35;52
Visaginas mun.;2002;75;66;19;47
Visaginas mun.;2002;76;63;14;49
Visaginas mun.;2002;77;44;8;36
Visaginas mun.;2002;78;26;5;21
Visaginas mun.;2002;79;22;6;16
Visaginas mun.;2002;80;19;3;16
Visaginas mun.;2002;81;26;8;18
Visaginas mun.;2002;82;12;1;11
Visaginas mun.;2002;83;15;3;12
Visaginas mun.;2002;84;11;2;9
Visaginas mun.;2002;85;51;4;47
Visaginas mun.;2003;-1;28066;13382;14684
Visaginas mun.;2003;0;172;80;92
Visaginas mun.;2003;1;223;135;88
Visaginas mun.;2003;2;188;104;84
Visaginas mun.;2003;3;210;116;94
Visaginas mun.;2003;4;205;103;102
Visaginas mun.;2003;5;209;119;90
Visaginas mun.;2003;6;264;128;136
Visaginas mun.;2003;7;251;119;132
Visaginas mun.;2003;8;252;137;115
Visaginas mun.;2003;9;283;149;134
Visaginas mun.;2003;10;339;169;170
Visaginas mun.;2003;11;338;173;165
Visaginas mun.;2003;12;396;198;198
Visaginas mun.;2003;13;516;243;273
Visaginas mun.;2003;14;581;307;274
Visaginas mun.;2003;15;650;317;333
Visaginas mun.;2003;16;640;344;296
Visaginas mun.;2003;17;703;359;344
Visaginas mun.;2003;18;702;372;330
Visaginas mun.;2003;19;610;301;309
Visaginas mun.;2003;20;533;270;263
Visaginas mun.;2003;21;489;264;225
Visaginas mun.;2003;22;440;230;210
Visaginas mun.;2003;23;418;208;210
Visaginas mun.;2003;24;379;185;194
Visaginas mun.;2003;25;371;182;189
Visaginas mun.;2003;26;372;188;184
Visaginas mun.;2003;27;371;178;193
Visaginas mun.;2003;28;341;169;172
Visaginas mun.;2003;29;355;176;179
Visaginas mun.;2003;30;338;159;179
Visaginas mun.;2003;31;373;179;194
Visaginas mun.;2003;32;368;178;190
Visaginas mun.;2003;33;374;169;205
Visaginas mun.;2003;34;383;188;195
Visaginas mun.;2003;35;356;152;204
Visaginas mun.;2003;36;400;179;221
Visaginas mun.;2003;37;489;203;286
Visaginas mun.;2003;38;518;240;278
Visaginas mun.;2003;39;610;292;318
Visaginas mun.;2003;40;727;330;397
Visaginas mun.;2003;41;728;310;418
Visaginas mun.;2003;42;705;321;384
Visaginas mun.;2003;43;789;392;397
Visaginas mun.;2003;44;692;310;382
Visaginas mun.;2003;45;639;298;341
Visaginas mun.;2003;46;645;312;333
Visaginas mun.;2003;47;599;294;305
Visaginas mun.;2003;48;490;238;252
Visaginas mun.;2003;49;509;234;275
Visaginas mun.;2003;50;424;201;223
Visaginas mun.;2003;51;442;219;223
Visaginas mun.;2003;52;384;184;200
Visaginas mun.;2003;53;365;161;204
Visaginas mun.;2003;54;310;149;161
Visaginas mun.;2003;55;268;136;132
Visaginas mun.;2003;56;233;109;124
Visaginas mun.;2003;57;172;63;109
Visaginas mun.;2003;58;154;80;74
Visaginas mun.;2003;59;114;48;66
Visaginas mun.;2003;60;183;90;93
Visaginas mun.;2003;61;199;90;109
Visaginas mun.;2003;62;197;84;113
Visaginas mun.;2003;63;242;114;128
Visaginas mun.;2003;64;247;109;138
Visaginas mun.;2003;65;220;93;127
Visaginas mun.;2003;66;161;61;100
Visaginas mun.;2003;67;137;50;87
Visaginas mun.;2003;68;96;25;71
Visaginas mun.;2003;69;111;49;62
Visaginas mun.;2003;70;116;49;67
Visaginas mun.;2003;71;89;29;60
Visaginas mun.;2003;72;74;27;47
Visaginas mun.;2003;73;86;31;55
Visaginas mun.;2003;74;97;30;67
Visaginas mun.;2003;75;84;34;50
Visaginas mun.;2003;76;64;18;46
Visaginas mun.;2003;77;63;12;51
Visaginas mun.;2003;78;40;6;34
Visaginas mun.;2003;79;27;6;21
Visaginas mun.;2003;80;23;6;17
Visaginas mun.;2003;81;19;3;16
Visaginas mun.;2003;82;25;8;17
Visaginas mun.;2003;83;11;1;10
Visaginas mun.;2003;84;14;3;11
Visaginas mun.;2003;85;42;3;39
Visaginas mun.;2004;-1;27915;13422;14493
Visaginas mun.;2004;0;212;114;98
Visaginas mun.;2004;1;167;79;88
Visaginas mun.;2004;2;219;134;85
Visaginas mun.;2004;3;190;107;83
Visaginas mun.;2004;4;220;124;96
Visaginas mun.;2004;5;202;98;104
Visaginas mun.;2004;6;218;121;97
Visaginas mun.;2004;7;263;124;139
Visaginas mun.;2004;8;253;122;131
Visaginas mun.;2004;9;247;135;112
Visaginas mun.;2004;10;278;147;131
Visaginas mun.;2004;11;335;165;170
Visaginas mun.;2004;12;336;170;166
Visaginas mun.;2004;13;386;197;189
Visaginas mun.;2004;14;513;242;271
Visaginas mun.;2004;15;569;304;265
Visaginas mun.;2004;16;636;310;326
Visaginas mun.;2004;17;620;336;284
Visaginas mun.;2004;18;681;353;328
Visaginas mun.;2004;19;680;366;314
Visaginas mun.;2004;20;580;292;288
Visaginas mun.;2004;21;522;270;252
Visaginas mun.;2004;22;467;253;214
Visaginas mun.;2004;23;424;228;196
Visaginas mun.;2004;24;410;205;205
Visaginas mun.;2004;25;375;186;189
Visaginas mun.;2004;26;367;184;183
Visaginas mun.;2004;27;375;192;183
Visaginas mun.;2004;28;368;173;195
Visaginas mun.;2004;29;336;168;168
Visaginas mun.;2004;30;356;175;181
Visaginas mun.;2004;31;339;170;169
Visaginas mun.;2004;32;366;176;190
Visaginas mun.;2004;33;361;176;185
Visaginas mun.;2004;34;367;167;200
Visaginas mun.;2004;35;373;182;191
Visaginas mun.;2004;36;354;155;199
Visaginas mun.;2004;37;399;183;216
Visaginas mun.;2004;38;481;201;280
Visaginas mun.;2004;39;513;242;271
Visaginas mun.;2004;40;608;293;315
Visaginas mun.;2004;41;710;329;381
Visaginas mun.;2004;42;717;308;409
Visaginas mun.;2004;43;697;322;375
Visaginas mun.;2004;44;776;383;393
Visaginas mun.;2004;45;680;308;372
Visaginas mun.;2004;46;630;294;336
Visaginas mun.;2004;47;632;306;326
Visaginas mun.;2004;48;594;296;298
Visaginas mun.;2004;49;487;239;248
Visaginas mun.;2004;50;504;233;271
Visaginas mun.;2004;51;419;201;218
Visaginas mun.;2004;52;434;221;213
Visaginas mun.;2004;53;380;180;200
Visaginas mun.;2004;54;369;164;205
Visaginas mun.;2004;55;310;149;161
Visaginas mun.;2004;56;261;134;127
Visaginas mun.;2004;57;230;106;124
Visaginas mun.;2004;58;173;62;111
Visaginas mun.;2004;59;152;77;75
Visaginas mun.;2004;60;112;46;66
Visaginas mun.;2004;61;186;92;94
Visaginas mun.;2004;62;203;93;110
Visaginas mun.;2004;63;200;89;111
Visaginas mun.;2004;64;248;118;130
Visaginas mun.;2004;65;251;112;139
Visaginas mun.;2004;66;223;95;128
Visaginas mun.;2004;67;167;65;102
Visaginas mun.;2004;68;136;49;87
Visaginas mun.;2004;69;95;23;72
Visaginas mun.;2004;70;119;52;67
Visaginas mun.;2004;71;112;47;65
Visaginas mun.;2004;72;89;28;61
Visaginas mun.;2004;73;73;27;46
Visaginas mun.;2004;74;80;29;51
Visaginas mun.;2004;75;97;30;67
Visaginas mun.;2004;76;87;33;54
Visaginas mun.;2004;77;62;15;47
Visaginas mun.;2004;78;57;8;49
Visaginas mun.;2004;79;40;7;33
Visaginas mun.;2004;80;29;6;23
Visaginas mun.;2004;81;23;8;15
Visaginas mun.;2004;82;15;2;13
Visaginas mun.;2004;83;25;8;17
Visaginas mun.;2004;84;10;1;9
Visaginas mun.;2004;85;55;8;47
Visaginas mun.;2005;-1;27302;13108;14194
Visaginas mun.;2005;0;207;107;100
Visaginas mun.;2005;1;209;111;98
Visaginas mun.;2005;2;161;77;84
Visaginas mun.;2005;3;222;134;88
Visaginas mun.;2005;4;184;102;82
Visaginas mun.;2005;5;212;123;89
Visaginas mun.;2005;6;195;97;98
Visaginas mun.;2005;7;214;115;99
Visaginas mun.;2005;8;260;123;137
Visaginas mun.;2005;9;247;118;129
Visaginas mun.;2005;10;246;134;112
Visaginas mun.;2005;11;268;140;128
Visaginas mun.;2005;12;325;161;164
Visaginas mun.;2005;13;333;165;168
Visaginas mun.;2005;14;378;194;184
Visaginas mun.;2005;15;496;236;260
Visaginas mun.;2005;16;547;290;257
Visaginas mun.;2005;17;613;300;313
Visaginas mun.;2005;18;598;321;277
Visaginas mun.;2005;19;661;346;315
Visaginas mun.;2005;20;645;345;300
Visaginas mun.;2005;21;560;285;275
Visaginas mun.;2005;22;498;257;241
Visaginas mun.;2005;23;449;238;211
Visaginas mun.;2005;24;403;213;190
Visaginas mun.;2005;25;395;205;190
Visaginas mun.;2005;26;358;174;184
Visaginas mun.;2005;27;357;181;176
Visaginas mun.;2005;28;370;196;174
Visaginas mun.;2005;29;364;172;192
Visaginas mun.;2005;30;334;169;165
Visaginas mun.;2005;31;347;170;177
Visaginas mun.;2005;32;342;166;176
Visaginas mun.;2005;33;353;169;184
Visaginas mun.;2005;34;352;171;181
Visaginas mun.;2005;35;364;166;198
Visaginas mun.;2005;36;365;177;188
Visaginas mun.;2005;37;340;150;190
Visaginas mun.;2005;38;383;168;215
Visaginas mun.;2005;39;467;197;270
Visaginas mun.;2005;40;499;233;266
Visaginas mun.;2005;41;596;286;310
Visaginas mun.;2005;42;674;308;366
Visaginas mun.;2005;43;698;299;399
Visaginas mun.;2005;44;680;316;364
Visaginas mun.;2005;45;747;367;380
Visaginas mun.;2005;46;672;304;368
Visaginas mun.;2005;47;616;286;330
Visaginas mun.;2005;48;610;293;317
Visaginas mun.;2005;49;578;287;291
Visaginas mun.;2005;50;477;233;244
Visaginas mun.;2005;51;488;225;263
Visaginas mun.;2005;52;414;199;215
Visaginas mun.;2005;53;419;214;205
Visaginas mun.;2005;54;368;177;191
Visaginas mun.;2005;55;361;161;200
Visaginas mun.;2005;56;306;144;162
Visaginas mun.;2005;57;260;130;130
Visaginas mun.;2005;58;224;105;119
Visaginas mun.;2005;59;171;62;109
Visaginas mun.;2005;60;146;77;69
Visaginas mun.;2005;61;109;44;65
Visaginas mun.;2005;62;178;86;92
Visaginas mun.;2005;63;196;91;105
Visaginas mun.;2005;64;198;89;109
Visaginas mun.;2005;65;238;110;128
Visaginas mun.;2005;66;245;107;138
Visaginas mun.;2005;67;211;87;124
Visaginas mun.;2005;68;159;62;97
Visaginas mun.;2005;69;135;49;86
Visaginas mun.;2005;70;93;23;70
Visaginas mun.;2005;71;116;50;66
Visaginas mun.;2005;72;112;45;67
Visaginas mun.;2005;73;86;27;59
Visaginas mun.;2005;74;69;26;43
Visaginas mun.;2005;75;72;27;45
Visaginas mun.;2005;76;92;28;64
Visaginas mun.;2005;77;85;33;52
Visaginas mun.;2005;78;59;14;45
Visaginas mun.;2005;79;55;8;47
Visaginas mun.;2005;80;39;8;31
Visaginas mun.;2005;81;19;4;15
Visaginas mun.;2005;82;22;7;15
Visaginas mun.;2005;83;14;2;12
Visaginas mun.;2005;84;24;7;17
Visaginas mun.;2005;85;50;5;45
Visaginas mun.;2006;-1;26421;12612;13809
Visaginas mun.;2006;0;213;119;94
Visaginas mun.;2006;1;200;105;95
Visaginas mun.;2006;2;204;108;96
Visaginas mun.;2006;3;159;75;84
Visaginas mun.;2006;4;208;126;82
Visaginas mun.;2006;5;180;100;80
Visaginas mun.;2006;6;207;120;87
Visaginas mun.;2006;7;196;98;98
Visaginas mun.;2006;8;206;110;96
Visaginas mun.;2006;9;253;119;134
Visaginas mun.;2006;10;243;115;128
Visaginas mun.;2006;11;243;132;111
Visaginas mun.;2006;12;262;137;125
Visaginas mun.;2006;13;314;152;162
Visaginas mun.;2006;14;323;160;163
Visaginas mun.;2006;15;362;183;179
Visaginas mun.;2006;16;476;226;250
Visaginas mun.;2006;17;525;276;249
Visaginas mun.;2006;18;578;278;300
Visaginas mun.;2006;19;551;296;255
Visaginas mun.;2006;20;614;318;296
Visaginas mun.;2006;21;597;323;274
Visaginas mun.;2006;22;526;267;259
Visaginas mun.;2006;23;472;245;227
Visaginas mun.;2006;24;423;223;200
Visaginas mun.;2006;25;371;198;173
Visaginas mun.;2006;26;377;194;183
Visaginas mun.;2006;27;345;170;175
Visaginas mun.;2006;28;328;165;163
Visaginas mun.;2006;29;357;188;169
Visaginas mun.;2006;30;351;161;190
Visaginas mun.;2006;31;330;166;164
Visaginas mun.;2006;32;343;167;176
Visaginas mun.;2006;33;324;156;168
Visaginas mun.;2006;34;335;158;177
Visaginas mun.;2006;35;335;158;177
Visaginas mun.;2006;36;351;155;196
Visaginas mun.;2006;37;344;164;180
Visaginas mun.;2006;38;321;136;185
Visaginas mun.;2006;39;376;166;210
Visaginas mun.;2006;40;455;187;268
Visaginas mun.;2006;41;485;227;258
Visaginas mun.;2006;42;583;278;305
Visaginas mun.;2006;43;650;296;354
Visaginas mun.;2006;44;670;285;385
Visaginas mun.;2006;45;661;308;353
Visaginas mun.;2006;46;720;348;372
Visaginas mun.;2006;47;656;296;360
Visaginas mun.;2006;48;602;276;326
Visaginas mun.;2006;49;597;289;308
Visaginas mun.;2006;50;565;277;288
Visaginas mun.;2006;51;464;226;238
Visaginas mun.;2006;52;476;217;259
Visaginas mun.;2006;53;394;189;205
Visaginas mun.;2006;54;399;202;197
Visaginas mun.;2006;55;352;164;188
Visaginas mun.;2006;56;349;154;195
Visaginas mun.;2006;57;294;138;156
Visaginas mun.;2006;58;253;125;128
Visaginas mun.;2006;59;218;102;116
Visaginas mun.;2006;60;168;63;105
Visaginas mun.;2006;61;142;74;68
Visaginas mun.;2006;62;104;41;63
Visaginas mun.;2006;63;173;83;90
Visaginas mun.;2006;64;189;87;102
Visaginas mun.;2006;65;197;86;111
Visaginas mun.;2006;66;233;108;125
Visaginas mun.;2006;67;231;97;134
Visaginas mun.;2006;68;208;84;124
Visaginas mun.;2006;69;155;61;94
Visaginas mun.;2006;70;133;48;85
Visaginas mun.;2006;71;89;22;67
Visaginas mun.;2006;72;108;45;63
Visaginas mun.;2006;73;106;40;66
Visaginas mun.;2006;74;87;28;59
Visaginas mun.;2006;75;63;26;37
Visaginas mun.;2006;76;68;26;42
Visaginas mun.;2006;77;84;25;59
Visaginas mun.;2006;78;76;30;46
Visaginas mun.;2006;79;55;12;43
Visaginas mun.;2006;80;46;6;40
Visaginas mun.;2006;81;31;8;23
Visaginas mun.;2006;82;13;1;12
Visaginas mun.;2006;83;17;6;11
Visaginas mun.;2006;84;14;1;13
Visaginas mun.;2006;85;65;7;58
Visaginas mun.;2007;-1;25897;12319;13578
Visaginas mun.;2007;0;234;116;118
Visaginas mun.;2007;1;211;118;93
Visaginas mun.;2007;2;193;99;94
Visaginas mun.;2007;3;201;107;94
Visaginas mun.;2007;4;158;75;83
Visaginas mun.;2007;5;202;124;78
Visaginas mun.;2007;6;169;95;74
Visaginas mun.;2007;7;204;122;82
Visaginas mun.;2007;8;194;97;97
Visaginas mun.;2007;9;200;106;94
Visaginas mun.;2007;10;247;115;132
Visaginas mun.;2007;11;239;112;127
Visaginas mun.;2007;12;236;127;109
Visaginas mun.;2007;13;253;132;121
Visaginas mun.;2007;14;310;152;158
Visaginas mun.;2007;15;315;156;159
Visaginas mun.;2007;16;357;181;176
Visaginas mun.;2007;17;464;220;244
Visaginas mun.;2007;18;513;268;245
Visaginas mun.;2007;19;561;270;291
Visaginas mun.;2007;20;536;290;246
Visaginas mun.;2007;21;591;308;283
Visaginas mun.;2007;22;574;308;266
Visaginas mun.;2007;23;509;254;255
Visaginas mun.;2007;24;462;235;227
Visaginas mun.;2007;25;402;214;188
Visaginas mun.;2007;26;353;188;165
Visaginas mun.;2007;27;362;186;176
Visaginas mun.;2007;28;338;167;171
Visaginas mun.;2007;29;311;154;157
Visaginas mun.;2007;30;351;185;166
Visaginas mun.;2007;31;339;155;184
Visaginas mun.;2007;32;323;167;156
Visaginas mun.;2007;33;335;164;171
Visaginas mun.;2007;34;307;145;162
Visaginas mun.;2007;35;322;148;174
Visaginas mun.;2007;36;327;150;177
Visaginas mun.;2007;37;339;149;190
Visaginas mun.;2007;38;336;160;176
Visaginas mun.;2007;39;319;140;179
Visaginas mun.;2007;40;365;161;204
Visaginas mun.;2007;41;444;180;264
Visaginas mun.;2007;42;474;220;254
Visaginas mun.;2007;43;564;271;293
Visaginas mun.;2007;44;633;286;347
Visaginas mun.;2007;45;655;278;377
Visaginas mun.;2007;46;645;297;348
Visaginas mun.;2007;47;706;340;366
Visaginas mun.;2007;48;648;290;358
Visaginas mun.;2007;49;587;267;320
Visaginas mun.;2007;50;581;279;302
Visaginas mun.;2007;51;548;269;279
Visaginas mun.;2007;52;465;224;241
Visaginas mun.;2007;53;469;214;255
Visaginas mun.;2007;54;384;183;201
Visaginas mun.;2007;55;387;194;193
Visaginas mun.;2007;56;343;159;184
Visaginas mun.;2007;57;345;149;196
Visaginas mun.;2007;58;286;132;154
Visaginas mun.;2007;59;248;121;127
Visaginas mun.;2007;60;213;101;112
Visaginas mun.;2007;61;161;62;99
Visaginas mun.;2007;62;134;70;64
Visaginas mun.;2007;63;100;37;63
Visaginas mun.;2007;64;170;80;90
Visaginas mun.;2007;65;178;83;95
Visaginas mun.;2007;66;189;80;109
Visaginas mun.;2007;67;218;102;116
Visaginas mun.;2007;68;229;94;135
Visaginas mun.;2007;69;199;79;120
Visaginas mun.;2007;70;146;55;91
Visaginas mun.;2007;71;123;43;80
Visaginas mun.;2007;72;86;21;65
Visaginas mun.;2007;73;103;43;60
Visaginas mun.;2007;74;102;36;66
Visaginas mun.;2007;75;83;25;58
Visaginas mun.;2007;76;57;22;35
Visaginas mun.;2007;77;66;25;41
Visaginas mun.;2007;78;79;22;57
Visaginas mun.;2007;79;76;28;48
Visaginas mun.;2007;80;52;10;42
Visaginas mun.;2007;81;37;5;32
Visaginas mun.;2007;82;27;8;19
Visaginas mun.;2007;83;11;1;10
Visaginas mun.;2007;84;15;5;10
Visaginas mun.;2007;85;69;9;60
Visaginas mun.;2008;-1;25232;11898;13334
Visaginas mun.;2008;0;235;134;101
Visaginas mun.;2008;1;232;116;116
Visaginas mun.;2008;2;206;114;92
Visaginas mun.;2008;3;189;98;91
Visaginas mun.;2008;4;197;103;94
Visaginas mun.;2008;5;158;74;84
Visaginas mun.;2008;6;198;121;77
Visaginas mun.;2008;7;174;99;75
Visaginas mun.;2008;8;203;118;85
Visaginas mun.;2008;9;191;94;97
Visaginas mun.;2008;10;196;103;93
Visaginas mun.;2008;11;246;111;135
Visaginas mun.;2008;12;237;113;124
Visaginas mun.;2008;13;235;128;107
Visaginas mun.;2008;14;251;129;122
Visaginas mun.;2008;15;310;148;162
Visaginas mun.;2008;16;311;151;160
Visaginas mun.;2008;17;349;174;175
Visaginas mun.;2008;18;451;212;239
Visaginas mun.;2008;19;499;257;242
Visaginas mun.;2008;20;538;259;279
Visaginas mun.;2008;21;515;276;239
Visaginas mun.;2008;22;570;294;276
Visaginas mun.;2008;23;554;297;257
Visaginas mun.;2008;24;488;248;240
Visaginas mun.;2008;25;434;221;213
Visaginas mun.;2008;26;392;210;182
Visaginas mun.;2008;27;340;183;157
Visaginas mun.;2008;28;344;177;167
Visaginas mun.;2008;29;323;161;162
Visaginas mun.;2008;30;300;145;155
Visaginas mun.;2008;31;337;176;161
Visaginas mun.;2008;32;334;153;181
Visaginas mun.;2008;33;312;162;150
Visaginas mun.;2008;34;322;155;167
Visaginas mun.;2008;35;297;139;158
Visaginas mun.;2008;36;314;144;170
Visaginas mun.;2008;37;318;146;172
Visaginas mun.;2008;38;327;141;186
Visaginas mun.;2008;39;330;156;174
Visaginas mun.;2008;40;313;131;182
Visaginas mun.;2008;41;357;155;202
Visaginas mun.;2008;42;436;176;260
Visaginas mun.;2008;43;455;208;247
Visaginas mun.;2008;44;538;254;284
Visaginas mun.;2008;45;606;272;334
Visaginas mun.;2008;46;630;261;369
Visaginas mun.;2008;47;626;282;344
Visaginas mun.;2008;48;686;325;361
Visaginas mun.;2008;49;625;277;348
Visaginas mun.;2008;50;570;256;314
Visaginas mun.;2008;51;556;261;295
Visaginas mun.;2008;52;530;256;274
Visaginas mun.;2008;53;447;212;235
Visaginas mun.;2008;54;452;204;248
Visaginas mun.;2008;55;374;175;199
Visaginas mun.;2008;56;372;183;189
Visaginas mun.;2008;57;332;151;181
Visaginas mun.;2008;58;334;140;194
Visaginas mun.;2008;59;269;120;149
Visaginas mun.;2008;60;244;116;128
Visaginas mun.;2008;61;204;96;108
Visaginas mun.;2008;62;152;56;96
Visaginas mun.;2008;63;122;63;59
Visaginas mun.;2008;64;97;36;61
Visaginas mun.;2008;65;157;72;85
Visaginas mun.;2008;66;169;78;91
Visaginas mun.;2008;67;179;69;110
Visaginas mun.;2008;68;208;99;109
Visaginas mun.;2008;69;216;85;131
Visaginas mun.;2008;70;193;76;117
Visaginas mun.;2008;71;135;49;86
Visaginas mun.;2008;72;122;44;78
Visaginas mun.;2008;73;85;21;64
Visaginas mun.;2008;74;93;37;56
Visaginas mun.;2008;75;93;29;64
Visaginas mun.;2008;76;82;25;57
Visaginas mun.;2008;77;51;22;29
Visaginas mun.;2008;78;61;18;43
Visaginas mun.;2008;79;73;20;53
Visaginas mun.;2008;80;61;21;40
Visaginas mun.;2008;81;47;9;38
Visaginas mun.;2008;82;31;4;27
Visaginas mun.;2008;83;25;6;19
Visaginas mun.;2008;84;9;1;8
Visaginas mun.;2008;85;58;7;51
Visaginas mun.;2009;-1;24644;11622;13022
Visaginas mun.;2009;0;249;132;117
Visaginas mun.;2009;1;227;129;98
Visaginas mun.;2009;2;228;114;114
Visaginas mun.;2009;3;198;111;87
Visaginas mun.;2009;4;184;97;87
Visaginas mun.;2009;5;190;99;91
Visaginas mun.;2009;6;150;72;78
Visaginas mun.;2009;7;190;116;74
Visaginas mun.;2009;8;169;95;74
Visaginas mun.;2009;9;199;115;84
Visaginas mun.;2009;10;186;91;95
Visaginas mun.;2009;11;191;100;91
Visaginas mun.;2009;12;230;106;124
Visaginas mun.;2009;13;228;107;121
Visaginas mun.;2009;14;224;122;102
Visaginas mun.;2009;15;248;125;123
Visaginas mun.;2009;16;301;142;159
Visaginas mun.;2009;17;304;148;156
Visaginas mun.;2009;18;345;173;172
Visaginas mun.;2009;19;444;211;233
Visaginas mun.;2009;20;478;248;230
Visaginas mun.;2009;21;515;251;264
Visaginas mun.;2009;22;499;269;230
Visaginas mun.;2009;23;551;282;269
Visaginas mun.;2009;24;529;281;248
Visaginas mun.;2009;25;464;241;223
Visaginas mun.;2009;26;416;210;206
Visaginas mun.;2009;27;366;197;169
Visaginas mun.;2009;28;321;173;148
Visaginas mun.;2009;29;339;173;166
Visaginas mun.;2009;30;310;155;155
Visaginas mun.;2009;31;284;139;145
Visaginas mun.;2009;32;317;163;154
Visaginas mun.;2009;33;322;151;171
Visaginas mun.;2009;34;298;158;140
Visaginas mun.;2009;35;315;148;167
Visaginas mun.;2009;36;282;125;157
Visaginas mun.;2009;37;311;141;170
Visaginas mun.;2009;38;310;141;169
Visaginas mun.;2009;39;320;139;181
Visaginas mun.;2009;40;321;155;166
Visaginas mun.;2009;41;299;125;174
Visaginas mun.;2009;42;356;154;202
Visaginas mun.;2009;43;428;170;258
Visaginas mun.;2009;44;436;199;237
Visaginas mun.;2009;45;525;248;277
Visaginas mun.;2009;46;590;265;325
Visaginas mun.;2009;47;616;253;363
Visaginas mun.;2009;48;607;276;331
Visaginas mun.;2009;49;671;319;352
Visaginas mun.;2009;50;614;269;345
Visaginas mun.;2009;51;555;248;307
Visaginas mun.;2009;52;540;251;289
Visaginas mun.;2009;53;512;246;266
Visaginas mun.;2009;54;440;206;234
Visaginas mun.;2009;55;435;197;238
Visaginas mun.;2009;56;359;167;192
Visaginas mun.;2009;57;364;177;187
Visaginas mun.;2009;58;321;143;178
Visaginas mun.;2009;59;323;133;190
Visaginas mun.;2009;60;271;122;149
Visaginas mun.;2009;61;240;115;125
Visaginas mun.;2009;62;195;93;102
Visaginas mun.;2009;63;147;55;92
Visaginas mun.;2009;64;124;64;60
Visaginas mun.;2009;65;90;32;58
Visaginas mun.;2009;66;152;67;85
Visaginas mun.;2009;67;168;75;93
Visaginas mun.;2009;68;173;68;105
Visaginas mun.;2009;69;199;94;105
Visaginas mun.;2009;70;207;82;125
Visaginas mun.;2009;71;185;73;112
Visaginas mun.;2009;72;129;48;81
Visaginas mun.;2009;73;117;40;77
Visaginas mun.;2009;74;83;21;62
Visaginas mun.;2009;75;92;35;57
Visaginas mun.;2009;76;91;27;64
Visaginas mun.;2009;77;77;23;54
Visaginas mun.;2009;78;51;21;30
Visaginas mun.;2009;79;52;16;36
Visaginas mun.;2009;80;64;17;47
Visaginas mun.;2009;81;57;20;37
Visaginas mun.;2009;82;43;8;35
Visaginas mun.;2009;83;22;4;18
Visaginas mun.;2009;84;18;5;13
Visaginas mun.;2009;85;53;6;47
Visaginas mun.;2010;-1;23992;11242;12750
Visaginas mun.;2010;0;246;117;129
Visaginas mun.;2010;1;243;128;115
Visaginas mun.;2010;2;219;125;94
Visaginas mun.;2010;3;224;113;111
Visaginas mun.;2010;4;188;107;81
Visaginas mun.;2010;5;177;92;85
Visaginas mun.;2010;6;181;95;86
Visaginas mun.;2010;7;144;67;77
Visaginas mun.;2010;8;190;116;74
Visaginas mun.;2010;9;165;93;72
Visaginas mun.;2010;10;195;114;81
Visaginas mun.;2010;11;179;86;93
Visaginas mun.;2010;12;187;97;90
Visaginas mun.;2010;13;227;104;123
Visaginas mun.;2010;14;220;101;119
Visaginas mun.;2010;15;222;118;104
Visaginas mun.;2010;16;242;121;121
Visaginas mun.;2010;17;294;138;156
Visaginas mun.;2010;18;295;143;152
Visaginas mun.;2010;19;334;166;168
Visaginas mun.;2010;20;425;203;222
Visaginas mun.;2010;21;460;239;221
Visaginas mun.;2010;22;492;241;251
Visaginas mun.;2010;23;476;256;220
Visaginas mun.;2010;24;527;267;260
Visaginas mun.;2010;25;502;267;235
Visaginas mun.;2010;26;431;220;211
Visaginas mun.;2010;27;384;193;191
Visaginas mun.;2010;28;347;186;161
Visaginas mun.;2010;29;302;162;140
Visaginas mun.;2010;30;327;163;164
Visaginas mun.;2010;31;303;151;152
Visaginas mun.;2010;32;279;134;145
Visaginas mun.;2010;33;312;157;155
Visaginas mun.;2010;34;311;144;167
Visaginas mun.;2010;35;278;151;127
Visaginas mun.;2010;36;300;142;158
Visaginas mun.;2010;37;269;121;148
Visaginas mun.;2010;38;307;138;169
Visaginas mun.;2010;39;299;135;164
Visaginas mun.;2010;40;314;139;175
Visaginas mun.;2010;41;316;150;166
Visaginas mun.;2010;42;290;121;169
Visaginas mun.;2010;43;342;144;198
Visaginas mun.;2010;44;416;163;253
Visaginas mun.;2010;45;423;191;232
Visaginas mun.;2010;46;508;240;268
Visaginas mun.;2010;47;572;255;317
Visaginas mun.;2010;48;599;243;356
Visaginas mun.;2010;49;590;268;322
Visaginas mun.;2010;50;650;307;343
Visaginas mun.;2010;51;601;262;339
Visaginas mun.;2010;52;537;236;301
Visaginas mun.;2010;53;522;241;281
Visaginas mun.;2010;54;495;235;260
Visaginas mun.;2010;55;428;201;227
Visaginas mun.;2010;56;422;188;234
Visaginas mun.;2010;57;345;160;185
Visaginas mun.;2010;58;355;169;186
Visaginas mun.;2010;59;316;141;175
Visaginas mun.;2010;60;316;127;189
Visaginas mun.;2010;61;265;116;149
Visaginas mun.;2010;62;232;110;122
Visaginas mun.;2010;63;189;89;100
Visaginas mun.;2010;64;140;51;89
Visaginas mun.;2010;65;121;61;60
Visaginas mun.;2010;66;86;29;57
Visaginas mun.;2010;67;142;60;82
Visaginas mun.;2010;68;165;74;91
Visaginas mun.;2010;69;166;63;103
Visaginas mun.;2010;70;193;91;102
Visaginas mun.;2010;71;198;78;120
Visaginas mun.;2010;72;176;67;109
Visaginas mun.;2010;73;118;42;76
Visaginas mun.;2010;74;111;37;74
Visaginas mun.;2010;75;77;20;57
Visaginas mun.;2010;76;86;31;55
Visaginas mun.;2010;77;84;23;61
Visaginas mun.;2010;78;71;22;49
Visaginas mun.;2010;79;50;21;29
Visaginas mun.;2010;80;47;14;33
Visaginas mun.;2010;81;62;17;45
Visaginas mun.;2010;82;47;17;30
Visaginas mun.;2010;83;40;7;33
Visaginas mun.;2010;84;14;0;14
Visaginas mun.;2010;85;52;10;42
Visaginas mun.;2011;-1;22708;10675;12033
Visaginas mun.;2011;0;192;94;98
Visaginas mun.;2011;1;227;108;119
Visaginas mun.;2011;2;230;116;114
Visaginas mun.;2011;3;213;130;83
Visaginas mun.;2011;4;206;108;98
Visaginas mun.;2011;5;182;103;79
Visaginas mun.;2011;6;172;94;78
Visaginas mun.;2011;7;188;106;82
Visaginas mun.;2011;8;151;70;81
Visaginas mun.;2011;9;202;110;92
Visaginas mun.;2011;10;185;111;74
Visaginas mun.;2011;11;205;119;86
Visaginas mun.;2011;12;201;99;102
Visaginas mun.;2011;13;200;112;88
Visaginas mun.;2011;14;247;132;115
Visaginas mun.;2011;15;237;119;118
Visaginas mun.;2011;16;263;127;136
Visaginas mun.;2011;17;266;132;134
Visaginas mun.;2011;18;288;142;146
Visaginas mun.;2011;19;232;118;114
Visaginas mun.;2011;20;250;138;112
Visaginas mun.;2011;21;295;152;143
Visaginas mun.;2011;22;338;177;161
Visaginas mun.;2011;23;344;177;167
Visaginas mun.;2011;24;322;184;138
Visaginas mun.;2011;25;376;191;185
Visaginas mun.;2011;26;325;180;145
Visaginas mun.;2011;27;270;145;125
Visaginas mun.;2011;28;262;133;129
Visaginas mun.;2011;29;269;137;132
Visaginas mun.;2011;30;261;130;131
Visaginas mun.;2011;31;260;139;121
Visaginas mun.;2011;32;260;134;126
Visaginas mun.;2011;33;211;99;112
Visaginas mun.;2011;34;243;118;125
Visaginas mun.;2011;35;262;113;149
Visaginas mun.;2011;36;250;121;129
Visaginas mun.;2011;37;259;125;134
Visaginas mun.;2011;38;280;135;145
Visaginas mun.;2011;39;285;128;157
Visaginas mun.;2011;40;279;128;151
Visaginas mun.;2011;41;305;137;168
Visaginas mun.;2011;42;296;137;159
Visaginas mun.;2011;43;284;112;172
Visaginas mun.;2011;44;318;133;185
Visaginas mun.;2011;45;393;170;223
Visaginas mun.;2011;46;414;189;225
Visaginas mun.;2011;47;471;225;246
Visaginas mun.;2011;48;527;236;291
Visaginas mun.;2011;49;605;263;342
Visaginas mun.;2011;50;619;287;332
Visaginas mun.;2011;51;646;317;329
Visaginas mun.;2011;52;645;281;364
Visaginas mun.;2011;53;567;260;307
Visaginas mun.;2011;54;549;248;301
Visaginas mun.;2011;55;489;239;250
Visaginas mun.;2011;56;441;207;234
Visaginas mun.;2011;57;397;174;223
Visaginas mun.;2011;58;351;162;189
Visaginas mun.;2011;59;359;177;182
Visaginas mun.;2011;60;315;143;172
Visaginas mun.;2011;61;314;126;188
Visaginas mun.;2011;62;279;128;151
Visaginas mun.;2011;63;239;116;123
Visaginas mun.;2011;64;194;88;106
Visaginas mun.;2011;65;144;46;98
Visaginas mun.;2011;66;131;63;68
Visaginas mun.;2011;67;100;36;64
Visaginas mun.;2011;68;139;55;84
Visaginas mun.;2011;69;167;79;88
Visaginas mun.;2011;70;179;65;114
Visaginas mun.;2011;71;208;92;116
Visaginas mun.;2011;72;220;84;136
Visaginas mun.;2011;73;203;78;125
Visaginas mun.;2011;74;134;46;88
Visaginas mun.;2011;75;106;32;74
Visaginas mun.;2011;76;90;23;67
Visaginas mun.;2011;77;93;35;58
Visaginas mun.;2011;78;99;34;65
Visaginas mun.;2011;79;82;22;60
Visaginas mun.;2011;80;72;23;49
Visaginas mun.;2011;81;58;17;41
Visaginas mun.;2011;82;70;18;52
Visaginas mun.;2011;83;56;16;40
Visaginas mun.;2011;84;43;8;35
Visaginas mun.;2011;85;109;14;95
Visaginas mun.;2012;-1;21921;10282;11639
Visaginas mun.;2012;0;203;99;104
Visaginas mun.;2012;1;195;95;100
Visaginas mun.;2012;2;236;110;126
Visaginas mun.;2012;3;231;117;114
Visaginas mun.;2012;4;215;129;86
Visaginas mun.;2012;5;198;105;93
Visaginas mun.;2012;6;173;97;76
Visaginas mun.;2012;7;168;91;77
Visaginas mun.;2012;8;188;107;81
Visaginas mun.;2012;9;151;71;80
Visaginas mun.;2012;10;194;104;90
Visaginas mun.;2012;11;181;110;71
Visaginas mun.;2012;12;199;116;83
Visaginas mun.;2012;13;199;100;99
Visaginas mun.;2012;14;193;109;84
Visaginas mun.;2012;15;236;129;107
Visaginas mun.;2012;16;234;120;114
Visaginas mun.;2012;17;257;126;131
Visaginas mun.;2012;18;259;127;132
Visaginas mun.;2012;19;265;130;135
Visaginas mun.;2012;20;218;109;109
Visaginas mun.;2012;21;230;128;102
Visaginas mun.;2012;22;262;136;126
Visaginas mun.;2012;23;292;161;131
Visaginas mun.;2012;24;304;161;143
Visaginas mun.;2012;25;295;162;133
Visaginas mun.;2012;26;321;164;157
Visaginas mun.;2012;27;270;155;115
Visaginas mun.;2012;28;236;121;115
Visaginas mun.;2012;29;227;122;105
Visaginas mun.;2012;30;229;117;112
Visaginas mun.;2012;31;236;116;120
Visaginas mun.;2012;32;238;133;105
Visaginas mun.;2012;33;247;130;117
Visaginas mun.;2012;34;198;90;108
Visaginas mun.;2012;35;226;109;117
Visaginas mun.;2012;36;242;98;144
Visaginas mun.;2012;37;243;120;123
Visaginas mun.;2012;38;251;123;128
Visaginas mun.;2012;39;268;129;139
Visaginas mun.;2012;40;272;121;151
Visaginas mun.;2012;41;262;115;147
Visaginas mun.;2012;42;291;129;162
Visaginas mun.;2012;43;291;135;156
Visaginas mun.;2012;44;280;110;170
Visaginas mun.;2012;45;306;128;178
Visaginas mun.;2012;46;382;167;215
Visaginas mun.;2012;47;412;186;226
Visaginas mun.;2012;48;462;221;241
Visaginas mun.;2012;49;515;233;282
Visaginas mun.;2012;50;587;255;332
Visaginas mun.;2012;51;602;281;321
Visaginas mun.;2012;52;634;310;324
Visaginas mun.;2012;53;638;278;360
Visaginas mun.;2012;54;550;247;303
Visaginas mun.;2012;55;541;248;293
Visaginas mun.;2012;56;486;236;250
Visaginas mun.;2012;57;431;202;229
Visaginas mun.;2012;58;387;166;221
Visaginas mun.;2012;59;347;160;187
Visaginas mun.;2012;60;357;174;183
Visaginas mun.;2012;61;307;140;167
Visaginas mun.;2012;62;308;122;186
Visaginas mun.;2012;63;274;123;151
Visaginas mun.;2012;64;229;110;119
Visaginas mun.;2012;65;188;85;103
Visaginas mun.;2012;66;138;43;95
Visaginas mun.;2012;67;128;58;70
Visaginas mun.;2012;68;99;35;64
Visaginas mun.;2012;69;130;53;77
Visaginas mun.;2012;70;165;77;88
Visaginas mun.;2012;71;179;65;114
Visaginas mun.;2012;72;205;91;114
Visaginas mun.;2012;73;216;82;134
Visaginas mun.;2012;74;190;69;121
Visaginas mun.;2012;75;128;43;85
Visaginas mun.;2012;76;100;28;72
Visaginas mun.;2012;77;87;20;67
Visaginas mun.;2012;78;88;31;57
Visaginas mun.;2012;79;89;33;56
Visaginas mun.;2012;80;76;21;55
Visaginas mun.;2012;81;68;20;48
Visaginas mun.;2012;82;54;14;40
Visaginas mun.;2012;83;64;14;50
Visaginas mun.;2012;84;47;12;35
Visaginas mun.;2012;85;123;15;108
Visaginas mun.;2013;-1;21237;9939;11298
Visaginas mun.;2013;0;217;117;100
Visaginas mun.;2013;1;208;98;110
Visaginas mun.;2013;2;186;89;97
Visaginas mun.;2013;3;223;105;118
Visaginas mun.;2013;4;224;113;111
Visaginas mun.;2013;5;207;122;85
Visaginas mun.;2013;6;186;97;89
Visaginas mun.;2013;7;167;96;71
Visaginas mun.;2013;8;163;88;75
Visaginas mun.;2013;9;186;107;79
Visaginas mun.;2013;10;149;71;78
Visaginas mun.;2013;11;187;100;87
Visaginas mun.;2013;12;173;103;70
Visaginas mun.;2013;13;200;115;85
Visaginas mun.;2013;14;200;102;98
Visaginas mun.;2013;15;193;111;82
Visaginas mun.;2013;16;233;130;103
Visaginas mun.;2013;17;229;118;111
Visaginas mun.;2013;18;245;122;123
Visaginas mun.;2013;19;241;117;124
Visaginas mun.;2013;20;253;118;135
Visaginas mun.;2013;21;215;110;105
Visaginas mun.;2013;22;220;124;96
Visaginas mun.;2013;23;233;116;117
Visaginas mun.;2013;24;246;135;111
Visaginas mun.;2013;25;259;139;120
Visaginas mun.;2013;26;259;146;113
Visaginas mun.;2013;27;293;161;132
Visaginas mun.;2013;28;253;150;103
Visaginas mun.;2013;29;215;101;114
Visaginas mun.;2013;30;194;106;88
Visaginas mun.;2013;31;202;108;94
Visaginas mun.;2013;32;211;105;106
Visaginas mun.;2013;33;218;126;92
Visaginas mun.;2013;34;244;128;116
Visaginas mun.;2013;35;190;86;104
Visaginas mun.;2013;36;211;101;110
Visaginas mun.;2013;37;229;93;136
Visaginas mun.;2013;38;232;113;119
Visaginas mun.;2013;39;244;118;126
Visaginas mun.;2013;40;267;129;138
Visaginas mun.;2013;41;261;116;145
Visaginas mun.;2013;42;263;116;147
Visaginas mun.;2013;43;284;124;160
Visaginas mun.;2013;44;271;127;144
Visaginas mun.;2013;45;266;104;162
Visaginas mun.;2013;46;300;124;176
Visaginas mun.;2013;47;370;159;211
Visaginas mun.;2013;48;388;171;217
Visaginas mun.;2013;49;446;213;233
Visaginas mun.;2013;50;500;221;279
Visaginas mun.;2013;51;578;250;328
Visaginas mun.;2013;52;592;272;320
Visaginas mun.;2013;53;614;297;317
Visaginas mun.;2013;54;621;271;350
Visaginas mun.;2013;55;544;242;302
Visaginas mun.;2013;56;528;243;285
Visaginas mun.;2013;57;479;230;249
Visaginas mun.;2013;58;416;198;218
Visaginas mun.;2013;59;383;166;217
Visaginas mun.;2013;60;343;158;185
Visaginas mun.;2013;61;347;167;180
Visaginas mun.;2013;62;306;138;168
Visaginas mun.;2013;63;299;115;184
Visaginas mun.;2013;64;270;121;149
Visaginas mun.;2013;65;222;106;116
Visaginas mun.;2013;66;184;84;100
Visaginas mun.;2013;67;134;40;94
Visaginas mun.;2013;68;125;57;68
Visaginas mun.;2013;69;94;32;62
Visaginas mun.;2013;70;125;50;75
Visaginas mun.;2013;71;162;74;88
Visaginas mun.;2013;72;174;64;110
Visaginas mun.;2013;73;196;85;111
Visaginas mun.;2013;74;212;80;132
Visaginas mun.;2013;75;186;66;120
Visaginas mun.;2013;76;124;39;85
Visaginas mun.;2013;77;95;26;69
Visaginas mun.;2013;78;83;17;66
Visaginas mun.;2013;79;84;28;56
Visaginas mun.;2013;80;80;30;50
Visaginas mun.;2013;81;73;22;51
Visaginas mun.;2013;82;61;16;45
Visaginas mun.;2013;83;53;12;41
Visaginas mun.;2013;84;59;11;48
Visaginas mun.;2013;85;137;23;114
Visaginas mun.;2014;-1;20627;9663;10964
Visaginas mun.;2014;0;200;98;102
Visaginas mun.;2014;1;218;117;101
Visaginas mun.;2014;2;201;99;102
Visaginas mun.;2014;3;185;86;99
Visaginas mun.;2014;4;211;98;113
Visaginas mun.;2014;5;212;108;104
Visaginas mun.;2014;6;198;116;82
Visaginas mun.;2014;7;181;97;84
Visaginas mun.;2014;8;164;96;68
Visaginas mun.;2014;9;165;90;75
Visaginas mun.;2014;10;182;106;76
Visaginas mun.;2014;11;139;67;72
Visaginas mun.;2014;12;179;97;82
Visaginas mun.;2014;13;167;100;67
Visaginas mun.;2014;14;198;115;83
Visaginas mun.;2014;15;195;100;95
Visaginas mun.;2014;16;189;107;82
Visaginas mun.;2014;17;229;127;102
Visaginas mun.;2014;18;220;115;105
Visaginas mun.;2014;19;231;121;110
Visaginas mun.;2014;20;221;107;114
Visaginas mun.;2014;21;235;113;122
Visaginas mun.;2014;22;198;101;97
Visaginas mun.;2014;23;200;116;84
Visaginas mun.;2014;24;221;116;105
Visaginas mun.;2014;25;235;132;103
Visaginas mun.;2014;26;229;133;96
Visaginas mun.;2014;27;223;128;95
Visaginas mun.;2014;28;268;148;120
Visaginas mun.;2014;29;238;141;97
Visaginas mun.;2014;30;203;90;113
Visaginas mun.;2014;31;164;96;68
Visaginas mun.;2014;32;186;104;82
Visaginas mun.;2014;33;193;94;99
Visaginas mun.;2014;34;204;117;87
Visaginas mun.;2014;35;225;119;106
Visaginas mun.;2014;36;170;78;92
Visaginas mun.;2014;37;195;96;99
Visaginas mun.;2014;38;224;93;131
Visaginas mun.;2014;39;228;110;118
Visaginas mun.;2014;40;241;116;125
Visaginas mun.;2014;41;259;127;132
Visaginas mun.;2014;42;256;112;144
Visaginas mun.;2014;43;259;117;142
Visaginas mun.;2014;44;271;117;154
Visaginas mun.;2014;45;267;125;142
Visaginas mun.;2014;46;265;102;163
Visaginas mun.;2014;47;297;128;169
Visaginas mun.;2014;48;360;155;205
Visaginas mun.;2014;49;383;167;216
Visaginas mun.;2014;50;438;208;230
Visaginas mun.;2014;51;483;215;268
Visaginas mun.;2014;52;569;242;327
Visaginas mun.;2014;53;578;266;312
Visaginas mun.;2014;54;600;289;311
Visaginas mun.;2014;55;609;264;345
Visaginas mun.;2014;56;531;236;295
Visaginas mun.;2014;57;521;233;288
Visaginas mun.;2014;58;471;223;248
Visaginas mun.;2014;59;406;190;216
Visaginas mun.;2014;60;375;165;210
Visaginas mun.;2014;61;346;156;190
Visaginas mun.;2014;62;336;159;177
Visaginas mun.;2014;63;292;128;164
Visaginas mun.;2014;64;293;112;181
Visaginas mun.;2014;65;266;118;148
Visaginas mun.;2014;66;216;100;116
Visaginas mun.;2014;67;178;81;97
Visaginas mun.;2014;68;130;38;92
Visaginas mun.;2014;69;123;53;70
Visaginas mun.;2014;70;93;32;61
Visaginas mun.;2014;71;125;50;75
Visaginas mun.;2014;72;156;68;88
Visaginas mun.;2014;73;171;64;107
Visaginas mun.;2014;74;191;79;112
Visaginas mun.;2014;75;204;74;130
Visaginas mun.;2014;76;177;65;112
Visaginas mun.;2014;77;118;36;82
Visaginas mun.;2014;78;91;25;66
Visaginas mun.;2014;79;78;13;65
Visaginas mun.;2014;80;79;27;52
Visaginas mun.;2014;81;66;25;41
Visaginas mun.;2014;82;65;21;44
Visaginas mun.;2014;83;53;12;41
Visaginas mun.;2014;84;50;11;39
Visaginas mun.;2014;85;167;27;140
Visaginas mun.;2015;-1;20249;9522;10727
Visaginas mun.;2015;0;237;137;100
Visaginas mun.;2015;1;204;100;104
Visaginas mun.;2015;2;217;119;98
Visaginas mun.;2015;3;191;93;98
Visaginas mun.;2015;4;181;88;93
Visaginas mun.;2015;5;209;96;113
Visaginas mun.;2015;6;207;104;103
Visaginas mun.;2015;7;197;116;81
Visaginas mun.;2015;8;182;100;82
Visaginas mun.;2015;9;161;95;66
Visaginas mun.;2015;10;161;87;74
Visaginas mun.;2015;11;177;102;75
Visaginas mun.;2015;12;132;64;68
Visaginas mun.;2015;13;176;92;84
Visaginas mun.;2015;14;166;98;68
Visaginas mun.;2015;15;193;111;82
Visaginas mun.;2015;16;189;97;92
Visaginas mun.;2015;17;185;104;81
Visaginas mun.;2015;18;219;125;94
Visaginas mun.;2015;19;204;107;97
Visaginas mun.;2015;20;219;114;105
Visaginas mun.;2015;21;221;109;112
Visaginas mun.;2015;22;231;111;120
Visaginas mun.;2015;23;190;103;87
Visaginas mun.;2015;24;187;110;77
Visaginas mun.;2015;25;216;121;95
Visaginas mun.;2015;26;213;126;87
Visaginas mun.;2015;27;215;122;93
Visaginas mun.;2015;28;209;118;91
Visaginas mun.;2015;29;260;150;110
Visaginas mun.;2015;30;219;132;87
Visaginas mun.;2015;31;184;78;106
Visaginas mun.;2015;32;158;94;64
Visaginas mun.;2015;33;171;100;71
Visaginas mun.;2015;34;182;91;91
Visaginas mun.;2015;35;193;109;84
Visaginas mun.;2015;36;217;115;102
Visaginas mun.;2015;37;166;78;88
Visaginas mun.;2015;38;196;97;99
Visaginas mun.;2015;39;221;91;130
Visaginas mun.;2015;40;223;107;116
Visaginas mun.;2015;41;235;114;121
Visaginas mun.;2015;42;255;125;130
Visaginas mun.;2015;43;249;110;139
Visaginas mun.;2015;44;251;114;137
Visaginas mun.;2015;45;266;120;146
Visaginas mun.;2015;46;265;124;141
Visaginas mun.;2015;47;262;102;160
Visaginas mun.;2015;48;289;123;166
Visaginas mun.;2015;49;352;152;200
Visaginas mun.;2015;50;379;167;212
Visaginas mun.;2015;51;435;205;230
Visaginas mun.;2015;52;475;209;266
Visaginas mun.;2015;53;551;236;315
Visaginas mun.;2015;54;566;261;305
Visaginas mun.;2015;55;586;282;304
Visaginas mun.;2015;56;603;261;342
Visaginas mun.;2015;57;514;228;286
Visaginas mun.;2015;58;513;228;285
Visaginas mun.;2015;59;459;214;245
Visaginas mun.;2015;60;392;181;211
Visaginas mun.;2015;61;374;161;213
Visaginas mun.;2015;62;344;156;188
Visaginas mun.;2015;63;335;157;178
Visaginas mun.;2015;64;293;130;163
Visaginas mun.;2015;65;281;108;173
Visaginas mun.;2015;66;256;111;145
Visaginas mun.;2015;67;209;93;116
Visaginas mun.;2015;68;171;78;93
Visaginas mun.;2015;69;127;36;91
Visaginas mun.;2015;70;117;49;68
Visaginas mun.;2015;71;92;32;60
Visaginas mun.;2015;72;119;47;72
Visaginas mun.;2015;73;152;66;86
Visaginas mun.;2015;74;160;58;102
Visaginas mun.;2015;75;187;74;113
Visaginas mun.;2015;76;198;67;131
Visaginas mun.;2015;77;165;56;109
Visaginas mun.;2015;78;108;34;74
Visaginas mun.;2015;79;85;22;63
Visaginas mun.;2015;80;76;12;64
Visaginas mun.;2015;81;76;27;49
Visaginas mun.;2015;82;51;19;32
Visaginas mun.;2015;83;62;18;44
Visaginas mun.;2015;84;47;10;37
Visaginas mun.;2015;85;188;34;154
Visaginas mun.;2016;-1;19774;9252;10522
Visaginas mun.;2016;0;214;94;120
Visaginas mun.;2016;1;237;136;101
Visaginas mun.;2016;2;198;102;96
Visaginas mun.;2016;3;208;114;94
Visaginas mun.;2016;4;182;86;96
Visaginas mun.;2016;5;183;86;97
Visaginas mun.;2016;6;203;96;107
Visaginas mun.;2016;7;204;105;99
Visaginas mun.;2016;8;202;118;84
Visaginas mun.;2016;9;181;100;81
Visaginas mun.;2016;10;159;92;67
Visaginas mun.;2016;11;161;88;73
Visaginas mun.;2016;12;178;103;75
Visaginas mun.;2016;13;128;61;67
Visaginas mun.;2016;14;171;88;83
Visaginas mun.;2016;15;159;96;63
Visaginas mun.;2016;16;182;103;79
Visaginas mun.;2016;17;186;96;90
Visaginas mun.;2016;18;176;100;76
Visaginas mun.;2016;19;210;122;88
Visaginas mun.;2016;20;193;100;93
Visaginas mun.;2016;21;203;105;98
Visaginas mun.;2016;22;205;99;106
Visaginas mun.;2016;23;221;105;116
Visaginas mun.;2016;24;168;90;78
Visaginas mun.;2016;25;175;98;77
Visaginas mun.;2016;26;185;101;84
Visaginas mun.;2016;27;193;113;80
Visaginas mun.;2016;28;204;117;87
Visaginas mun.;2016;29;202;117;85
Visaginas mun.;2016;30;248;140;108
Visaginas mun.;2016;31;200;127;73
Visaginas mun.;2016;32;180;77;103
Visaginas mun.;2016;33;142;86;56
Visaginas mun.;2016;34;167;92;75
Visaginas mun.;2016;35;171;88;83
Visaginas mun.;2016;36;174;98;76
Visaginas mun.;2016;37;209;110;99
Visaginas mun.;2016;38;162;79;83
Visaginas mun.;2016;39;189;98;91
Visaginas mun.;2016;40;210;87;123
Visaginas mun.;2016;41;214;103;111
Visaginas mun.;2016;42;232;114;118
Visaginas mun.;2016;43;239;117;122
Visaginas mun.;2016;44;238;103;135
Visaginas mun.;2016;45;244;108;136
Visaginas mun.;2016;46;257;118;139
Visaginas mun.;2016;47;254;120;134
Visaginas mun.;2016;48;256;99;157
Visaginas mun.;2016;49;286;122;164
Visaginas mun.;2016;50;349;150;199
Visaginas mun.;2016;51;367;154;213
Visaginas mun.;2016;52;426;197;229
Visaginas mun.;2016;53;478;210;268
Visaginas mun.;2016;54;544;239;305
Visaginas mun.;2016;55;554;254;300
Visaginas mun.;2016;56;576;273;303
Visaginas mun.;2016;57;598;259;339
Visaginas mun.;2016;58;508;224;284
Visaginas mun.;2016;59;508;223;285
Visaginas mun.;2016;60;454;209;245
Visaginas mun.;2016;61;386;179;207
Visaginas mun.;2016;62;367;158;209
Visaginas mun.;2016;63;333;149;184
Visaginas mun.;2016;64;330;152;178
Visaginas mun.;2016;65;284;121;163
Visaginas mun.;2016;66;273;105;168
Visaginas mun.;2016;67;249;104;145
Visaginas mun.;2016;68;201;88;113
Visaginas mun.;2016;69;165;72;93
Visaginas mun.;2016;70;124;34;90
Visaginas mun.;2016;71;112;44;68
Visaginas mun.;2016;72;86;32;54
Visaginas mun.;2016;73;117;45;72
Visaginas mun.;2016;74;149;63;86
Visaginas mun.;2016;75;157;57;100
Visaginas mun.;2016;76;174;65;109
Visaginas mun.;2016;77;192;65;127
Visaginas mun.;2016;78;150;50;100
Visaginas mun.;2016;79;105;33;72
Visaginas mun.;2016;80;81;22;59
Visaginas mun.;2016;81;71;11;60
Visaginas mun.;2016;82;74;27;47
Visaginas mun.;2016;83;44;16;28
Visaginas mun.;2016;84;51;17;34
Visaginas mun.;2016;85;194;34;160
Visaginas mun.;2017;-1;19178;8978;10200
Visaginas mun.;2017;0;182;92;90
Visaginas mun.;2017;1;209;92;117
Visaginas mun.;2017;2;229;131;98
Visaginas mun.;2017;3;198;102;96
Visaginas mun.;2017;4;201;112;89
Visaginas mun.;2017;5;180;88;92
Visaginas mun.;2017;6;170;75;95
Visaginas mun.;2017;7;204;97;107
Visaginas mun.;2017;8;203;106;97
Visaginas mun.;2017;9;199;120;79
Visaginas mun.;2017;10;170;95;75
Visaginas mun.;2017;11;155;91;64
Visaginas mun.;2017;12;151;83;68
Visaginas mun.;2017;13;173;99;74
Visaginas mun.;2017;14;129;63;66
Visaginas mun.;2017;15;166;85;81
Visaginas mun.;2017;16;156;94;62
Visaginas mun.;2017;17;177;101;76
Visaginas mun.;2017;18;180;93;87
Visaginas mun.;2017;19;167;97;70
Visaginas mun.;2017;20;195;112;83
Visaginas mun.;2017;21;181;95;86
Visaginas mun.;2017;22;198;101;97
Visaginas mun.;2017;23;186;90;96
Visaginas mun.;2017;24;196;90;106
Visaginas mun.;2017;25;159;90;69
Visaginas mun.;2017;26;150;76;74
Visaginas mun.;2017;27;157;86;71
Visaginas mun.;2017;28;169;105;64
Visaginas mun.;2017;29;194;110;84
Visaginas mun.;2017;30;191;115;76
Visaginas mun.;2017;31;219;129;90
Visaginas mun.;2017;32;182;116;66
Visaginas mun.;2017;33;152;64;88
Visaginas mun.;2017;34;118;71;47
Visaginas mun.;2017;35;148;86;62
Visaginas mun.;2017;36;155;81;74
Visaginas mun.;2017;37;158;93;65
Visaginas mun.;2017;38;205;109;96
Visaginas mun.;2017;39;156;72;84
Visaginas mun.;2017;40;178;93;85
Visaginas mun.;2017;41;200;84;116
Visaginas mun.;2017;42;201;97;104
Visaginas mun.;2017;43;222;106;116
Visaginas mun.;2017;44;231;113;118
Visaginas mun.;2017;45;231;101;130
Visaginas mun.;2017;46;244;109;135
Visaginas mun.;2017;47;248;112;136
Visaginas mun.;2017;48;249;117;132
Visaginas mun.;2017;49;257;102;155
Visaginas mun.;2017;50;286;119;167
Visaginas mun.;2017;51;339;147;192
Visaginas mun.;2017;52;359;149;210
Visaginas mun.;2017;53;420;195;225
Visaginas mun.;2017;54;467;204;263
Visaginas mun.;2017;55;535;236;299
Visaginas mun.;2017;56;552;257;295
Visaginas mun.;2017;57;564;266;298
Visaginas mun.;2017;58;591;258;333
Visaginas mun.;2017;59;499;223;276
Visaginas mun.;2017;60;505;223;282
Visaginas mun.;2017;61;440;200;240
Visaginas mun.;2017;62;379;175;204
Visaginas mun.;2017;63;367;158;209
Visaginas mun.;2017;64;330;150;180
Visaginas mun.;2017;65;319;144;175
Visaginas mun.;2017;66;282;118;164
Visaginas mun.;2017;67;262;99;163
Visaginas mun.;2017;68;248;103;145
Visaginas mun.;2017;69;193;82;111
Visaginas mun.;2017;70;156;69;87
Visaginas mun.;2017;71;121;33;88
Visaginas mun.;2017;72;105;39;66
Visaginas mun.;2017;73;82;28;54
Visaginas mun.;2017;74;114;43;71
Visaginas mun.;2017;75;143;57;86
Visaginas mun.;2017;76;149;52;97
Visaginas mun.;2017;77;166;57;109
Visaginas mun.;2017;78;184;60;124
Visaginas mun.;2017;79;143;48;95
Visaginas mun.;2017;80;101;33;68
Visaginas mun.;2017;81;77;21;56
Visaginas mun.;2017;82;65;11;54
Visaginas mun.;2017;83;64;21;43
Visaginas mun.;2017;84;39;16;23
Visaginas mun.;2017;85;203;43;160
Visaginas mun.;2018;-1;18686;8719;9967
Visaginas mun.;2018;0;183;87;96
Visaginas mun.;2018;1;182;94;88
Visaginas mun.;2018;2;210;92;118
Visaginas mun.;2018;3;226;130;96
Visaginas mun.;2018;4;201;103;98
Visaginas mun.;2018;5;203;114;89
Visaginas mun.;2018;6;177;86;91
Visaginas mun.;2018;7;164;75;89
Visaginas mun.;2018;8;199;95;104
Visaginas mun.;2018;9;210;111;99
Visaginas mun.;2018;10;200;118;82
Visaginas mun.;2018;11;165;92;73
Visaginas mun.;2018;12;149;86;63
Visaginas mun.;2018;13;149;80;69
Visaginas mun.;2018;14;170;100;70
Visaginas mun.;2018;15;128;62;66
Visaginas mun.;2018;16;160;81;79
Visaginas mun.;2018;17;153;92;61
Visaginas mun.;2018;18;169;95;74
Visaginas mun.;2018;19;157;85;72
Visaginas mun.;2018;20;151;83;68
Visaginas mun.;2018;21;174;97;77
Visaginas mun.;2018;22;164;88;76
Visaginas mun.;2018;23;170;86;84
Visaginas mun.;2018;24;170;83;87
Visaginas mun.;2018;25;182;81;101
Visaginas mun.;2018;26;137;79;58
Visaginas mun.;2018;27;142;76;66
Visaginas mun.;2018;28;141;79;62
Visaginas mun.;2018;29;138;92;46
Visaginas mun.;2018;30;166;94;72
Visaginas mun.;2018;31;163;107;56
Visaginas mun.;2018;32;195;114;81
Visaginas mun.;2018;33;168;105;63
Visaginas mun.;2018;34;142;57;85
Visaginas mun.;2018;35;114;70;44
Visaginas mun.;2018;36;149;82;67
Visaginas mun.;2018;37;142;71;71
Visaginas mun.;2018;38;151;91;60
Visaginas mun.;2018;39;189;98;91
Visaginas mun.;2018;40;154;71;83
Visaginas mun.;2018;41;176;91;85
Visaginas mun.;2018;42;193;79;114
Visaginas mun.;2018;43;194;93;101
Visaginas mun.;2018;44;223;107;116
Visaginas mun.;2018;45;218;106;112
Visaginas mun.;2018;46;222;95;127
Visaginas mun.;2018;47;251;113;138
Visaginas mun.;2018;48;240;108;132
Visaginas mun.;2018;49;249;119;130
Visaginas mun.;2018;50;255;104;151
Visaginas mun.;2018;51;276;113;163
Visaginas mun.;2018;52;326;134;192
Visaginas mun.;2018;53;355;146;209
Visaginas mun.;2018;54;414;191;223
Visaginas mun.;2018;55;461;203;258
Visaginas mun.;2018;56;523;231;292
Visaginas mun.;2018;57;545;256;289
Visaginas mun.;2018;58;559;267;292
Visaginas mun.;2018;59;588;255;333
Visaginas mun.;2018;60;491;221;270
Visaginas mun.;2018;61;498;219;279
Visaginas mun.;2018;62;431;192;239
Visaginas mun.;2018;63;378;172;206
Visaginas mun.;2018;64;361;153;208
Visaginas mun.;2018;65;315;138;177
Visaginas mun.;2018;66;321;146;175
Visaginas mun.;2018;67;279;116;163
Visaginas mun.;2018;68;259;97;162
Visaginas mun.;2018;69;244;104;140
Visaginas mun.;2018;70;196;84;112
Visaginas mun.;2018;71;148;65;83
Visaginas mun.;2018;72;116;30;86
Visaginas mun.;2018;73;104;40;64
Visaginas mun.;2018;74;81;28;53
Visaginas mun.;2018;75;111;41;70
Visaginas mun.;2018;76;137;53;84
Visaginas mun.;2018;77;144;50;94
Visaginas mun.;2018;78;156;51;105
Visaginas mun.;2018;79;177;57;120
Visaginas mun.;2018;80;138;44;94
Visaginas mun.;2018;81;92;31;61
Visaginas mun.;2018;82;66;18;48
Visaginas mun.;2018;83;54;9;45
Visaginas mun.;2018;84;58;20;38
Visaginas mun.;2018;85;206;47;159
Zarasai d. mun.;2001;-1;22863;10690;12173
Zarasai d. mun.;2001;0;218;114;104
Zarasai d. mun.;2001;1;224;114;110
Zarasai d. mun.;2001;2;217;112;105
Zarasai d. mun.;2001;3;210;103;107
Zarasai d. mun.;2001;4;229;126;103
Zarasai d. mun.;2001;5;235;116;119
Zarasai d. mun.;2001;6;243;118;125
Zarasai d. mun.;2001;7;290;158;132
Zarasai d. mun.;2001;8;339;161;178
Zarasai d. mun.;2001;9;348;188;160
Zarasai d. mun.;2001;10;362;184;178
Zarasai d. mun.;2001;11;335;154;181
Zarasai d. mun.;2001;12;357;174;183
Zarasai d. mun.;2001;13;400;206;194
Zarasai d. mun.;2001;14;403;221;182
Zarasai d. mun.;2001;15;366;187;179
Zarasai d. mun.;2001;16;342;168;174
Zarasai d. mun.;2001;17;361;194;167
Zarasai d. mun.;2001;18;282;147;135
Zarasai d. mun.;2001;19;225;127;98
Zarasai d. mun.;2001;20;215;123;92
Zarasai d. mun.;2001;21;207;114;93
Zarasai d. mun.;2001;22;220;127;93
Zarasai d. mun.;2001;23;214;105;109
Zarasai d. mun.;2001;24;244;125;119
Zarasai d. mun.;2001;25;226;125;101
Zarasai d. mun.;2001;26;226;125;101
Zarasai d. mun.;2001;27;235;123;112
Zarasai d. mun.;2001;28;276;151;125
Zarasai d. mun.;2001;29;252;124;128
Zarasai d. mun.;2001;30;276;138;138
Zarasai d. mun.;2001;31;285;149;136
Zarasai d. mun.;2001;32;282;148;134
Zarasai d. mun.;2001;33;291;141;150
Zarasai d. mun.;2001;34;289;140;149
Zarasai d. mun.;2001;35;315;169;146
Zarasai d. mun.;2001;36;329;174;155
Zarasai d. mun.;2001;37;324;167;157
Zarasai d. mun.;2001;38;324;169;155
Zarasai d. mun.;2001;39;337;164;173
Zarasai d. mun.;2001;40;327;178;149
Zarasai d. mun.;2001;41;333;180;153
Zarasai d. mun.;2001;42;320;149;171
Zarasai d. mun.;2001;43;304;153;151
Zarasai d. mun.;2001;44;277;135;142
Zarasai d. mun.;2001;45;282;150;132
Zarasai d. mun.;2001;46;276;150;126
Zarasai d. mun.;2001;47;230;120;110
Zarasai d. mun.;2001;48;275;134;141
Zarasai d. mun.;2001;49;257;121;136
Zarasai d. mun.;2001;50;273;117;156
Zarasai d. mun.;2001;51;269;131;138
Zarasai d. mun.;2001;52;257;126;131
Zarasai d. mun.;2001;53;258;125;133
Zarasai d. mun.;2001;54;211;108;103
Zarasai d. mun.;2001;55;261;127;134
Zarasai d. mun.;2001;56;239;114;125
Zarasai d. mun.;2001;57;266;114;152
Zarasai d. mun.;2001;58;274;121;153
Zarasai d. mun.;2001;59;305;143;162
Zarasai d. mun.;2001;60;263;115;148
Zarasai d. mun.;2001;61;265;110;155
Zarasai d. mun.;2001;62;300;122;178
Zarasai d. mun.;2001;63;250;110;140
Zarasai d. mun.;2001;64;296;134;162
Zarasai d. mun.;2001;65;296;134;162
Zarasai d. mun.;2001;66;275;128;147
Zarasai d. mun.;2001;67;319;118;201
Zarasai d. mun.;2001;68;289;98;191
Zarasai d. mun.;2001;69;320;117;203
Zarasai d. mun.;2001;70;267;114;153
Zarasai d. mun.;2001;71;273;94;179
Zarasai d. mun.;2001;72;295;90;205
Zarasai d. mun.;2001;73;276;102;174
Zarasai d. mun.;2001;74;222;61;161
Zarasai d. mun.;2001;75;240;74;166
Zarasai d. mun.;2001;76;196;52;144
Zarasai d. mun.;2001;77;201;53;148
Zarasai d. mun.;2001;78;170;45;125
Zarasai d. mun.;2001;79;149;37;112
Zarasai d. mun.;2001;80;154;44;110
Zarasai d. mun.;2001;81;89;21;68
Zarasai d. mun.;2001;82;74;11;63
Zarasai d. mun.;2001;83;72;17;55
Zarasai d. mun.;2001;84;58;16;42
Zarasai d. mun.;2001;85;407;104;303
Zarasai d. mun.;2002;-1;22647;10599;12048
Zarasai d. mun.;2002;0;200;96;104
Zarasai d. mun.;2002;1;218;117;101
Zarasai d. mun.;2002;2;227;117;110
Zarasai d. mun.;2002;3;217;112;105
Zarasai d. mun.;2002;4;207;102;105
Zarasai d. mun.;2002;5;230;125;105
Zarasai d. mun.;2002;6;236;117;119
Zarasai d. mun.;2002;7;243;120;123
Zarasai d. mun.;2002;8;289;155;134
Zarasai d. mun.;2002;9;337;158;179
Zarasai d. mun.;2002;10;346;187;159
Zarasai d. mun.;2002;11;360;183;177
Zarasai d. mun.;2002;12;332;152;180
Zarasai d. mun.;2002;13;356;173;183
Zarasai d. mun.;2002;14;394;204;190
Zarasai d. mun.;2002;15;396;215;181
Zarasai d. mun.;2002;16;363;186;177
Zarasai d. mun.;2002;17;332;164;168
Zarasai d. mun.;2002;18;349;192;157
Zarasai d. mun.;2002;19;277;145;132
Zarasai d. mun.;2002;20;218;120;98
Zarasai d. mun.;2002;21;213;118;95
Zarasai d. mun.;2002;22;212;118;94
Zarasai d. mun.;2002;23;226;129;97
Zarasai d. mun.;2002;24;207;100;107
Zarasai d. mun.;2002;25;239;125;114
Zarasai d. mun.;2002;26;223;126;97
Zarasai d. mun.;2002;27;223;125;98
Zarasai d. mun.;2002;28;231;125;106
Zarasai d. mun.;2002;29;269;147;122
Zarasai d. mun.;2002;30;245;122;123
Zarasai d. mun.;2002;31;276;137;139
Zarasai d. mun.;2002;32;282;149;133
Zarasai d. mun.;2002;33;282;149;133
Zarasai d. mun.;2002;34;282;137;145
Zarasai d. mun.;2002;35;281;134;147
Zarasai d. mun.;2002;36;309;168;141
Zarasai d. mun.;2002;37;325;170;155
Zarasai d. mun.;2002;38;318;165;153
Zarasai d. mun.;2002;39;321;166;155
Zarasai d. mun.;2002;40;330;160;170
Zarasai d. mun.;2002;41;323;175;148
Zarasai d. mun.;2002;42;328;177;151
Zarasai d. mun.;2002;43;316;144;172
Zarasai d. mun.;2002;44;301;151;150
Zarasai d. mun.;2002;45;269;131;138
Zarasai d. mun.;2002;46;282;150;132
Zarasai d. mun.;2002;47;275;147;128
Zarasai d. mun.;2002;48;224;115;109
Zarasai d. mun.;2002;49;270;130;140
Zarasai d. mun.;2002;50;255;119;136
Zarasai d. mun.;2002;51;270;118;152
Zarasai d. mun.;2002;52;262;128;134
Zarasai d. mun.;2002;53;253;124;129
Zarasai d. mun.;2002;54;257;127;130
Zarasai d. mun.;2002;55;207;107;100
Zarasai d. mun.;2002;56;259;127;132
Zarasai d. mun.;2002;57;230;109;121
Zarasai d. mun.;2002;58;261;110;151
Zarasai d. mun.;2002;59;268;119;149
Zarasai d. mun.;2002;60;309;145;164
Zarasai d. mun.;2002;61;263;114;149
Zarasai d. mun.;2002;62;264;108;156
Zarasai d. mun.;2002;63;298;120;178
Zarasai d. mun.;2002;64;250;109;141
Zarasai d. mun.;2002;65;294;135;159
Zarasai d. mun.;2002;66;292;131;161
Zarasai d. mun.;2002;67;272;124;148
Zarasai d. mun.;2002;68;311;114;197
Zarasai d. mun.;2002;69;282;96;186
Zarasai d. mun.;2002;70;315;115;200
Zarasai d. mun.;2002;71;261;107;154
Zarasai d. mun.;2002;72;269;92;177
Zarasai d. mun.;2002;73;285;85;200
Zarasai d. mun.;2002;74;272;101;171
Zarasai d. mun.;2002;75;216;56;160
Zarasai d. mun.;2002;76;234;71;163
Zarasai d. mun.;2002;77;188;50;138
Zarasai d. mun.;2002;78;192;48;144
Zarasai d. mun.;2002;79;161;40;121
Zarasai d. mun.;2002;80;140;35;105
Zarasai d. mun.;2002;81;135;39;96
Zarasai d. mun.;2002;82;80;18;62
Zarasai d. mun.;2002;83;69;11;58
Zarasai d. mun.;2002;84;63;14;49
Zarasai d. mun.;2002;85;401;103;298
Zarasai d. mun.;2003;-1;22394;10481;11913
Zarasai d. mun.;2003;0;181;96;85
Zarasai d. mun.;2003;1;200;94;106
Zarasai d. mun.;2003;2;224;122;102
Zarasai d. mun.;2003;3;227;117;110
Zarasai d. mun.;2003;4;209;107;102
Zarasai d. mun.;2003;5;206;102;104
Zarasai d. mun.;2003;6;225;124;101
Zarasai d. mun.;2003;7;234;117;117
Zarasai d. mun.;2003;8;246;120;126
Zarasai d. mun.;2003;9;291;158;133
Zarasai d. mun.;2003;10;335;160;175
Zarasai d. mun.;2003;11;349;187;162
Zarasai d. mun.;2003;12;357;182;175
Zarasai d. mun.;2003;13;330;153;177
Zarasai d. mun.;2003;14;354;170;184
Zarasai d. mun.;2003;15;386;198;188
Zarasai d. mun.;2003;16;389;209;180
Zarasai d. mun.;2003;17;357;182;175
Zarasai d. mun.;2003;18;329;161;168
Zarasai d. mun.;2003;19;344;189;155
Zarasai d. mun.;2003;20;269;141;128
Zarasai d. mun.;2003;21;210;118;92
Zarasai d. mun.;2003;22;210;116;94
Zarasai d. mun.;2003;23;213;116;97
Zarasai d. mun.;2003;24;225;130;95
Zarasai d. mun.;2003;25;209;101;108
Zarasai d. mun.;2003;26;231;122;109
Zarasai d. mun.;2003;27;216;120;96
Zarasai d. mun.;2003;28;220;122;98
Zarasai d. mun.;2003;29;229;122;107
Zarasai d. mun.;2003;30;264;143;121
Zarasai d. mun.;2003;31;244;122;122
Zarasai d. mun.;2003;32;273;137;136
Zarasai d. mun.;2003;33;280;151;129
Zarasai d. mun.;2003;34;276;147;129
Zarasai d. mun.;2003;35;277;135;142
Zarasai d. mun.;2003;36;280;133;147
Zarasai d. mun.;2003;37;308;168;140
Zarasai d. mun.;2003;38;324;167;157
Zarasai d. mun.;2003;39;313;165;148
Zarasai d. mun.;2003;40;319;166;153
Zarasai d. mun.;2003;41;328;158;170
Zarasai d. mun.;2003;42;321;172;149
Zarasai d. mun.;2003;43;322;172;150
Zarasai d. mun.;2003;44;313;144;169
Zarasai d. mun.;2003;45;296;147;149
Zarasai d. mun.;2003;46;269;131;138
Zarasai d. mun.;2003;47;283;149;134
Zarasai d. mun.;2003;48;271;145;126
Zarasai d. mun.;2003;49;225;117;108
Zarasai d. mun.;2003;50;267;129;138
Zarasai d. mun.;2003;51;252;118;134
Zarasai d. mun.;2003;52;268;118;150
Zarasai d. mun.;2003;53;260;127;133
Zarasai d. mun.;2003;54;248;119;129
Zarasai d. mun.;2003;55;248;120;128
Zarasai d. mun.;2003;56;206;105;101
Zarasai d. mun.;2003;57;257;123;134
Zarasai d. mun.;2003;58;228;107;121
Zarasai d. mun.;2003;59;254;105;149
Zarasai d. mun.;2003;60;260;114;146
Zarasai d. mun.;2003;61;305;143;162
Zarasai d. mun.;2003;62;262;111;151
Zarasai d. mun.;2003;63;261;105;156
Zarasai d. mun.;2003;64;297;119;178
Zarasai d. mun.;2003;65;247;103;144
Zarasai d. mun.;2003;66;295;132;163
Zarasai d. mun.;2003;67;285;127;158
Zarasai d. mun.;2003;68;263;116;147
Zarasai d. mun.;2003;69;304;106;198
Zarasai d. mun.;2003;70;272;91;181
Zarasai d. mun.;2003;71;308;113;195
Zarasai d. mun.;2003;72;258;106;152
Zarasai d. mun.;2003;73;263;90;173
Zarasai d. mun.;2003;74;284;84;200
Zarasai d. mun.;2003;75;262;96;166
Zarasai d. mun.;2003;76;206;49;157
Zarasai d. mun.;2003;77;221;64;157
Zarasai d. mun.;2003;78;186;49;137
Zarasai d. mun.;2003;79;177;43;134
Zarasai d. mun.;2003;80;144;34;110
Zarasai d. mun.;2003;81;137;32;105
Zarasai d. mun.;2003;82;123;34;89
Zarasai d. mun.;2003;83;70;17;53
Zarasai d. mun.;2003;84;64;9;55
Zarasai d. mun.;2003;85;361;98;263
Zarasai d. mun.;2004;-1;21927;10246;11681
Zarasai d. mun.;2004;0;167;88;79
Zarasai d. mun.;2004;1;176;92;84
Zarasai d. mun.;2004;2;197;93;104
Zarasai d. mun.;2004;3;220;119;101
Zarasai d. mun.;2004;4;229;118;111
Zarasai d. mun.;2004;5;209;107;102
Zarasai d. mun.;2004;6;201;101;100
Zarasai d. mun.;2004;7;224;124;100
Zarasai d. mun.;2004;8;226;113;113
Zarasai d. mun.;2004;9;243;118;125
Zarasai d. mun.;2004;10;288;156;132
Zarasai d. mun.;2004;11;333;158;175
Zarasai d. mun.;2004;12;342;185;157
Zarasai d. mun.;2004;13;354;183;171
Zarasai d. mun.;2004;14;328;152;176
Zarasai d. mun.;2004;15;347;168;179
Zarasai d. mun.;2004;16;381;195;186
Zarasai d. mun.;2004;17;385;208;177
Zarasai d. mun.;2004;18;349;177;172
Zarasai d. mun.;2004;19;317;158;159
Zarasai d. mun.;2004;20;343;187;156
Zarasai d. mun.;2004;21;261;138;123
Zarasai d. mun.;2004;22;205;117;88
Zarasai d. mun.;2004;23;195;112;83
Zarasai d. mun.;2004;24;197;110;87
Zarasai d. mun.;2004;25;215;126;89
Zarasai d. mun.;2004;26;197;94;103
Zarasai d. mun.;2004;27;220;118;102
Zarasai d. mun.;2004;28;202;110;92
Zarasai d. mun.;2004;29;208;115;93
Zarasai d. mun.;2004;30;225;119;106
Zarasai d. mun.;2004;31;262;142;120
Zarasai d. mun.;2004;32;236;119;117
Zarasai d. mun.;2004;33;272;137;135
Zarasai d. mun.;2004;34;279;153;126
Zarasai d. mun.;2004;35;271;143;128
Zarasai d. mun.;2004;36;274;132;142
Zarasai d. mun.;2004;37;276;131;145
Zarasai d. mun.;2004;38;305;165;140
Zarasai d. mun.;2004;39;319;166;153
Zarasai d. mun.;2004;40;306;161;145
Zarasai d. mun.;2004;41;313;164;149
Zarasai d. mun.;2004;42;327;158;169
Zarasai d. mun.;2004;43;319;172;147
Zarasai d. mun.;2004;44;312;164;148
Zarasai d. mun.;2004;45;305;138;167
Zarasai d. mun.;2004;46;292;144;148
Zarasai d. mun.;2004;47;266;128;138
Zarasai d. mun.;2004;48;272;139;133
Zarasai d. mun.;2004;49;265;142;123
Zarasai d. mun.;2004;50;218;110;108
Zarasai d. mun.;2004;51;268;128;140
Zarasai d. mun.;2004;52;248;116;132
Zarasai d. mun.;2004;53;260;113;147
Zarasai d. mun.;2004;54;256;124;132
Zarasai d. mun.;2004;55;244;116;128
Zarasai d. mun.;2004;56;243;117;126
Zarasai d. mun.;2004;57;205;104;101
Zarasai d. mun.;2004;58;251;118;133
Zarasai d. mun.;2004;59;226;106;120
Zarasai d. mun.;2004;60;254;105;149
Zarasai d. mun.;2004;61;250;108;142
Zarasai d. mun.;2004;62;299;141;158
Zarasai d. mun.;2004;63;261;110;151
Zarasai d. mun.;2004;64;255;100;155
Zarasai d. mun.;2004;65;288;114;174
Zarasai d. mun.;2004;66;245;99;146
Zarasai d. mun.;2004;67;278;115;163
Zarasai d. mun.;2004;68;278;120;158
Zarasai d. mun.;2004;69;259;111;148
Zarasai d. mun.;2004;70;291;97;194
Zarasai d. mun.;2004;71;262;83;179
Zarasai d. mun.;2004;72;287;104;183
Zarasai d. mun.;2004;73;252;101;151
Zarasai d. mun.;2004;74;254;84;170
Zarasai d. mun.;2004;75;271;80;191
Zarasai d. mun.;2004;76;241;86;155
Zarasai d. mun.;2004;77;196;49;147
Zarasai d. mun.;2004;78;210;56;154
Zarasai d. mun.;2004;79;175;45;130
Zarasai d. mun.;2004;80;171;40;131
Zarasai d. mun.;2004;81;130;26;104
Zarasai d. mun.;2004;82;126;29;97
Zarasai d. mun.;2004;83;108;29;79
Zarasai d. mun.;2004;84;61;15;46
Zarasai d. mun.;2004;85;351;90;261
Zarasai d. mun.;2005;-1;21386;10008;11378
Zarasai d. mun.;2005;0;159;83;76
Zarasai d. mun.;2005;1;161;84;77
Zarasai d. mun.;2005;2;173;91;82
Zarasai d. mun.;2005;3;197;93;104
Zarasai d. mun.;2005;4;221;121;100
Zarasai d. mun.;2005;5;225;116;109
Zarasai d. mun.;2005;6;203;106;97
Zarasai d. mun.;2005;7;200;101;99
Zarasai d. mun.;2005;8;221;124;97
Zarasai d. mun.;2005;9;222;111;111
Zarasai d. mun.;2005;10;242;117;125
Zarasai d. mun.;2005;11;290;158;132
Zarasai d. mun.;2005;12;329;156;173
Zarasai d. mun.;2005;13;337;181;156
Zarasai d. mun.;2005;14;349;180;169
Zarasai d. mun.;2005;15;325;148;177
Zarasai d. mun.;2005;16;345;165;180
Zarasai d. mun.;2005;17;373;191;182
Zarasai d. mun.;2005;18;375;202;173
Zarasai d. mun.;2005;19;332;168;164
Zarasai d. mun.;2005;20;302;151;151
Zarasai d. mun.;2005;21;328;178;150
Zarasai d. mun.;2005;22;248;132;116
Zarasai d. mun.;2005;23;197;116;81
Zarasai d. mun.;2005;24;180;109;71
Zarasai d. mun.;2005;25;186;105;81
Zarasai d. mun.;2005;26;204;122;82
Zarasai d. mun.;2005;27;181;86;95
Zarasai d. mun.;2005;28;214;114;100
Zarasai d. mun.;2005;29;192;108;84
Zarasai d. mun.;2005;30;199;110;89
Zarasai d. mun.;2005;31;220;115;105
Zarasai d. mun.;2005;32;250;132;118
Zarasai d. mun.;2005;33;228;117;111
Zarasai d. mun.;2005;34;266;134;132
Zarasai d. mun.;2005;35;270;148;122
Zarasai d. mun.;2005;36;265;139;126
Zarasai d. mun.;2005;37;273;127;146
Zarasai d. mun.;2005;38;267;127;140
Zarasai d. mun.;2005;39;302;166;136
Zarasai d. mun.;2005;40;312;161;151
Zarasai d. mun.;2005;41;300;157;143
Zarasai d. mun.;2005;42;310;160;150
Zarasai d. mun.;2005;43;325;158;167
Zarasai d. mun.;2005;44;316;172;144
Zarasai d. mun.;2005;45;305;159;146
Zarasai d. mun.;2005;46;304;137;167
Zarasai d. mun.;2005;47;284;135;149
Zarasai d. mun.;2005;48;261;127;134
Zarasai d. mun.;2005;49;262;136;126
Zarasai d. mun.;2005;50;258;137;121
Zarasai d. mun.;2005;51;214;109;105
Zarasai d. mun.;2005;52;265;127;138
Zarasai d. mun.;2005;53;248;113;135
Zarasai d. mun.;2005;54;252;106;146
Zarasai d. mun.;2005;55;254;122;132
Zarasai d. mun.;2005;56;241;114;127
Zarasai d. mun.;2005;57;242;116;126
Zarasai d. mun.;2005;58;202;103;99
Zarasai d. mun.;2005;59;248;118;130
Zarasai d. mun.;2005;60;215;98;117
Zarasai d. mun.;2005;61;249;102;147
Zarasai d. mun.;2005;62;243;104;139
Zarasai d. mun.;2005;63;300;142;158
Zarasai d. mun.;2005;64;256;107;149
Zarasai d. mun.;2005;65;255;99;156
Zarasai d. mun.;2005;66;281;105;176
Zarasai d. mun.;2005;67;232;93;139
Zarasai d. mun.;2005;68;272;110;162
Zarasai d. mun.;2005;69;272;116;156
Zarasai d. mun.;2005;70;251;106;145
Zarasai d. mun.;2005;71;278;88;190
Zarasai d. mun.;2005;72;253;78;175
Zarasai d. mun.;2005;73;274;97;177
Zarasai d. mun.;2005;74;246;98;148
Zarasai d. mun.;2005;75;239;81;158
Zarasai d. mun.;2005;76;249;71;178
Zarasai d. mun.;2005;77;225;79;146
Zarasai d. mun.;2005;78;178;44;134
Zarasai d. mun.;2005;79;194;51;143
Zarasai d. mun.;2005;80;165;41;124
Zarasai d. mun.;2005;81;156;35;121
Zarasai d. mun.;2005;82;118;26;92
Zarasai d. mun.;2005;83;108;25;83
Zarasai d. mun.;2005;84;92;27;65
Zarasai d. mun.;2005;85;331;86;245
Zarasai d. mun.;2006;-1;20816;9735;11081
Zarasai d. mun.;2006;0;175;89;86
Zarasai d. mun.;2006;1;159;83;76
Zarasai d. mun.;2006;2;159;83;76
Zarasai d. mun.;2006;3;169;89;80
Zarasai d. mun.;2006;4;191;92;99
Zarasai d. mun.;2006;5;217;119;98
Zarasai d. mun.;2006;6;221;114;107
Zarasai d. mun.;2006;7;203;106;97
Zarasai d. mun.;2006;8;197;98;99
Zarasai d. mun.;2006;9;222;124;98
Zarasai d. mun.;2006;10;221;111;110
Zarasai d. mun.;2006;11;240;116;124
Zarasai d. mun.;2006;12;288;157;131
Zarasai d. mun.;2006;13;330;155;175
Zarasai d. mun.;2006;14;332;180;152
Zarasai d. mun.;2006;15;339;177;162
Zarasai d. mun.;2006;16;313;141;172
Zarasai d. mun.;2006;17;335;161;174
Zarasai d. mun.;2006;18;361;183;178
Zarasai d. mun.;2006;19;352;189;163
Zarasai d. mun.;2006;20;311;157;154
Zarasai d. mun.;2006;21;284;142;142
Zarasai d. mun.;2006;22;300;165;135
Zarasai d. mun.;2006;23;228;123;105
Zarasai d. mun.;2006;24;181;113;68
Zarasai d. mun.;2006;25;158;98;60
Zarasai d. mun.;2006;26;175;96;79
Zarasai d. mun.;2006;27;190;114;76
Zarasai d. mun.;2006;28;171;78;93
Zarasai d. mun.;2006;29;202;110;92
Zarasai d. mun.;2006;30;190;107;83
Zarasai d. mun.;2006;31;188;102;86
Zarasai d. mun.;2006;32;205;111;94
Zarasai d. mun.;2006;33;241;129;112
Zarasai d. mun.;2006;34;223;115;108
Zarasai d. mun.;2006;35;259;128;131
Zarasai d. mun.;2006;36;266;145;121
Zarasai d. mun.;2006;37;258;137;121
Zarasai d. mun.;2006;38;266;123;143
Zarasai d. mun.;2006;39;262;125;137
Zarasai d. mun.;2006;40;293;160;133
Zarasai d. mun.;2006;41;311;160;151
Zarasai d. mun.;2006;42;294;156;138
Zarasai d. mun.;2006;43;302;156;146
Zarasai d. mun.;2006;44;324;157;167
Zarasai d. mun.;2006;45;316;172;144
Zarasai d. mun.;2006;46;302;158;144
Zarasai d. mun.;2006;47;300;135;165
Zarasai d. mun.;2006;48;283;134;149
Zarasai d. mun.;2006;49;257;123;134
Zarasai d. mun.;2006;50;258;134;124
Zarasai d. mun.;2006;51;260;140;120
Zarasai d. mun.;2006;52;205;102;103
Zarasai d. mun.;2006;53;268;130;138
Zarasai d. mun.;2006;54;241;109;132
Zarasai d. mun.;2006;55;250;107;143
Zarasai d. mun.;2006;56;242;112;130
Zarasai d. mun.;2006;57;238;112;126
Zarasai d. mun.;2006;58;241;117;124
Zarasai d. mun.;2006;59;201;102;99
Zarasai d. mun.;2006;60;241;113;128
Zarasai d. mun.;2006;61;214;97;117
Zarasai d. mun.;2006;62;242;98;144
Zarasai d. mun.;2006;63;234;97;137
Zarasai d. mun.;2006;64;288;134;154
Zarasai d. mun.;2006;65;241;96;145
Zarasai d. mun.;2006;66;249;96;153
Zarasai d. mun.;2006;67;273;100;173
Zarasai d. mun.;2006;68;220;85;135
Zarasai d. mun.;2006;69;263;103;160
Zarasai d. mun.;2006;70;258;106;152
Zarasai d. mun.;2006;71;246;103;143
Zarasai d. mun.;2006;72;263;81;182
Zarasai d. mun.;2006;73;244;76;168
Zarasai d. mun.;2006;74;254;84;170
Zarasai d. mun.;2006;75;226;90;136
Zarasai d. mun.;2006;76;227;72;155
Zarasai d. mun.;2006;77;237;66;171
Zarasai d. mun.;2006;78;214;76;138
Zarasai d. mun.;2006;79;162;43;119
Zarasai d. mun.;2006;80;187;51;136
Zarasai d. mun.;2006;81;160;38;122
Zarasai d. mun.;2006;82;147;32;115
Zarasai d. mun.;2006;83;109;24;85
Zarasai d. mun.;2006;84;104;20;84
Zarasai d. mun.;2006;85;345;93;252
Zarasai d. mun.;2007;-1;20376;9531;10845
Zarasai d. mun.;2007;0;169;92;77
Zarasai d. mun.;2007;1;173;87;86
Zarasai d. mun.;2007;2;156;81;75
Zarasai d. mun.;2007;3;157;81;76
Zarasai d. mun.;2007;4;166;89;77
Zarasai d. mun.;2007;5;191;92;99
Zarasai d. mun.;2007;6;214;116;98
Zarasai d. mun.;2007;7;219;111;108
Zarasai d. mun.;2007;8;204;107;97
Zarasai d. mun.;2007;9;194;96;98
Zarasai d. mun.;2007;10;215;121;94
Zarasai d. mun.;2007;11;220;111;109
Zarasai d. mun.;2007;12;241;119;122
Zarasai d. mun.;2007;13;282;153;129
Zarasai d. mun.;2007;14;328;156;172
Zarasai d. mun.;2007;15;330;178;152
Zarasai d. mun.;2007;16;334;175;159
Zarasai d. mun.;2007;17;311;141;170
Zarasai d. mun.;2007;18;330;159;171
Zarasai d. mun.;2007;19;349;177;172
Zarasai d. mun.;2007;20;336;185;151
Zarasai d. mun.;2007;21;295;149;146
Zarasai d. mun.;2007;22;276;140;136
Zarasai d. mun.;2007;23;289;160;129
Zarasai d. mun.;2007;24;213;117;96
Zarasai d. mun.;2007;25;169;105;64
Zarasai d. mun.;2007;26;147;94;53
Zarasai d. mun.;2007;27;170;91;79
Zarasai d. mun.;2007;28;177;109;68
Zarasai d. mun.;2007;29;161;71;90
Zarasai d. mun.;2007;30;192;105;87
Zarasai d. mun.;2007;31;181;102;79
Zarasai d. mun.;2007;32;178;96;82
Zarasai d. mun.;2007;33;202;112;90
Zarasai d. mun.;2007;34;231;122;109
Zarasai d. mun.;2007;35;218;112;106
Zarasai d. mun.;2007;36;256;129;127
Zarasai d. mun.;2007;37;259;141;118
Zarasai d. mun.;2007;38;256;136;120
Zarasai d. mun.;2007;39;257;117;140
Zarasai d. mun.;2007;40;258;122;136
Zarasai d. mun.;2007;41;287;156;131
Zarasai d. mun.;2007;42;306;158;148
Zarasai d. mun.;2007;43;291;153;138
Zarasai d. mun.;2007;44;299;157;142
Zarasai d. mun.;2007;45;321;157;164
Zarasai d. mun.;2007;46;312;173;139
Zarasai d. mun.;2007;47;295;152;143
Zarasai d. mun.;2007;48;295;131;164
Zarasai d. mun.;2007;49;278;133;145
Zarasai d. mun.;2007;50;248;116;132
Zarasai d. mun.;2007;51;257;131;126
Zarasai d. mun.;2007;52;252;134;118
Zarasai d. mun.;2007;53;197;96;101
Zarasai d. mun.;2007;54;268;128;140
Zarasai d. mun.;2007;55;240;108;132
Zarasai d. mun.;2007;56;247;105;142
Zarasai d. mun.;2007;57;239;109;130
Zarasai d. mun.;2007;58;233;109;124
Zarasai d. mun.;2007;59;236;115;121
Zarasai d. mun.;2007;60;196;99;97
Zarasai d. mun.;2007;61;234;111;123
Zarasai d. mun.;2007;62;208;91;117
Zarasai d. mun.;2007;63;237;96;141
Zarasai d. mun.;2007;64;228;92;136
Zarasai d. mun.;2007;65;286;133;153
Zarasai d. mun.;2007;66;233;88;145
Zarasai d. mun.;2007;67;243;91;152
Zarasai d. mun.;2007;68;268;98;170
Zarasai d. mun.;2007;69;214;81;133
Zarasai d. mun.;2007;70;256;101;155
Zarasai d. mun.;2007;71;250;99;151
Zarasai d. mun.;2007;72;240;100;140
Zarasai d. mun.;2007;73;256;79;177
Zarasai d. mun.;2007;74;232;71;161
Zarasai d. mun.;2007;75;238;75;163
Zarasai d. mun.;2007;76;218;84;134
Zarasai d. mun.;2007;77;214;68;146
Zarasai d. mun.;2007;78;228;60;168
Zarasai d. mun.;2007;79;200;66;134
Zarasai d. mun.;2007;80;147;36;111
Zarasai d. mun.;2007;81;176;49;127
Zarasai d. mun.;2007;82;151;34;117
Zarasai d. mun.;2007;83;136;29;107
Zarasai d. mun.;2007;84;100;21;79
Zarasai d. mun.;2007;85;382;101;281
Zarasai d. mun.;2008;-1;19891;9306;10585
Zarasai d. mun.;2008;0;140;68;72
Zarasai d. mun.;2008;1;167;91;76
Zarasai d. mun.;2008;2;171;86;85
Zarasai d. mun.;2008;3;151;76;75
Zarasai d. mun.;2008;4;148;78;70
Zarasai d. mun.;2008;5;162;88;74
Zarasai d. mun.;2008;6;189;90;99
Zarasai d. mun.;2008;7;209;114;95
Zarasai d. mun.;2008;8;217;110;107
Zarasai d. mun.;2008;9;201;105;96
Zarasai d. mun.;2008;10;191;94;97
Zarasai d. mun.;2008;11;215;123;92
Zarasai d. mun.;2008;12;221;111;110
Zarasai d. mun.;2008;13;240;118;122
Zarasai d. mun.;2008;14;281;151;130
Zarasai d. mun.;2008;15;322;150;172
Zarasai d. mun.;2008;16;330;177;153
Zarasai d. mun.;2008;17;329;173;156
Zarasai d. mun.;2008;18;301;138;163
Zarasai d. mun.;2008;19;319;155;164
Zarasai d. mun.;2008;20;342;173;169
Zarasai d. mun.;2008;21;327;177;150
Zarasai d. mun.;2008;22;290;146;144
Zarasai d. mun.;2008;23;270;136;134
Zarasai d. mun.;2008;24;281;158;123
Zarasai d. mun.;2008;25;207;115;92
Zarasai d. mun.;2008;26;158;100;58
Zarasai d. mun.;2008;27;128;86;42
Zarasai d. mun.;2008;28;160;86;74
Zarasai d. mun.;2008;29;169;108;61
Zarasai d. mun.;2008;30;155;67;88
Zarasai d. mun.;2008;31;177;94;83
Zarasai d. mun.;2008;32;174;97;77
Zarasai d. mun.;2008;33;176;97;79
Zarasai d. mun.;2008;34;194;107;87
Zarasai d. mun.;2008;35;226;120;106
Zarasai d. mun.;2008;36;212;109;103
Zarasai d. mun.;2008;37;253;125;128
Zarasai d. mun.;2008;38;257;141;116
Zarasai d. mun.;2008;39;260;140;120
Zarasai d. mun.;2008;40;256;117;139
Zarasai d. mun.;2008;41;252;120;132
Zarasai d. mun.;2008;42;278;152;126
Zarasai d. mun.;2008;43;304;157;147
Zarasai d. mun.;2008;44;283;149;134
Zarasai d. mun.;2008;45;288;149;139
Zarasai d. mun.;2008;46;320;157;163
Zarasai d. mun.;2008;47;310;173;137
Zarasai d. mun.;2008;48;289;145;144
Zarasai d. mun.;2008;49;295;131;164
Zarasai d. mun.;2008;50;273;127;146
Zarasai d. mun.;2008;51;241;110;131
Zarasai d. mun.;2008;52;252;127;125
Zarasai d. mun.;2008;53;246;132;114
Zarasai d. mun.;2008;54;189;91;98
Zarasai d. mun.;2008;55;264;127;137
Zarasai d. mun.;2008;56;233;104;129
Zarasai d. mun.;2008;57;242;104;138
Zarasai d. mun.;2008;58;239;108;131
Zarasai d. mun.;2008;59;226;104;122
Zarasai d. mun.;2008;60;234;114;120
Zarasai d. mun.;2008;61;189;94;95
Zarasai d. mun.;2008;62;232;110;122
Zarasai d. mun.;2008;63;207;91;116
Zarasai d. mun.;2008;64;232;95;137
Zarasai d. mun.;2008;65;223;90;133
Zarasai d. mun.;2008;66;275;123;152
Zarasai d. mun.;2008;67;234;88;146
Zarasai d. mun.;2008;68;239;89;150
Zarasai d. mun.;2008;69;261;93;168
Zarasai d. mun.;2008;70;205;73;132
Zarasai d. mun.;2008;71;247;95;152
Zarasai d. mun.;2008;72;242;96;146
Zarasai d. mun.;2008;73;236;97;139
Zarasai d. mun.;2008;74;249;75;174
Zarasai d. mun.;2008;75;219;64;155
Zarasai d. mun.;2008;76;223;66;157
Zarasai d. mun.;2008;77;203;80;123
Zarasai d. mun.;2008;78;200;60;140
Zarasai d. mun.;2008;79;209;51;158
Zarasai d. mun.;2008;80;185;61;124
Zarasai d. mun.;2008;81;142;34;108
Zarasai d. mun.;2008;82;161;42;119
Zarasai d. mun.;2008;83;134;29;105
Zarasai d. mun.;2008;84;118;28;90
Zarasai d. mun.;2008;85;392;106;286
Zarasai d. mun.;2009;-1;19409;9093;10316
Zarasai d. mun.;2009;0;159;85;74
Zarasai d. mun.;2009;1;140;67;73
Zarasai d. mun.;2009;2;167;90;77
Zarasai d. mun.;2009;3;167;84;83
Zarasai d. mun.;2009;4;149;75;74
Zarasai d. mun.;2009;5;150;78;72
Zarasai d. mun.;2009;6;157;84;73
Zarasai d. mun.;2009;7;187;89;98
Zarasai d. mun.;2009;8;208;113;95
Zarasai d. mun.;2009;9;220;112;108
Zarasai d. mun.;2009;10;197;104;93
Zarasai d. mun.;2009;11;190;94;96
Zarasai d. mun.;2009;12;216;124;92
Zarasai d. mun.;2009;13;218;109;109
Zarasai d. mun.;2009;14;236;116;120
Zarasai d. mun.;2009;15;278;148;130
Zarasai d. mun.;2009;16;319;149;170
Zarasai d. mun.;2009;17;330;178;152
Zarasai d. mun.;2009;18;321;169;152
Zarasai d. mun.;2009;19;297;134;163
Zarasai d. mun.;2009;20;314;154;160
Zarasai d. mun.;2009;21;336;169;167
Zarasai d. mun.;2009;22;314;169;145
Zarasai d. mun.;2009;23;285;146;139
Zarasai d. mun.;2009;24;259;133;126
Zarasai d. mun.;2009;25;269;153;116
Zarasai d. mun.;2009;26;196;108;88
Zarasai d. mun.;2009;27;155;98;57
Zarasai d. mun.;2009;28;115;78;37
Zarasai d. mun.;2009;29;150;82;68
Zarasai d. mun.;2009;30;159;104;55
Zarasai d. mun.;2009;31;148;66;82
Zarasai d. mun.;2009;32;169;91;78
Zarasai d. mun.;2009;33;169;97;72
Zarasai d. mun.;2009;34;171;92;79
Zarasai d. mun.;2009;35;189;106;83
Zarasai d. mun.;2009;36;222;117;105
Zarasai d. mun.;2009;37;204;102;102
Zarasai d. mun.;2009;38;245;121;124
Zarasai d. mun.;2009;39;251;138;113
Zarasai d. mun.;2009;40;248;130;118
Zarasai d. mun.;2009;41;251;114;137
Zarasai d. mun.;2009;42;247;117;130
Zarasai d. mun.;2009;43;274;149;125
Zarasai d. mun.;2009;44;299;153;146
Zarasai d. mun.;2009;45;277;149;128
Zarasai d. mun.;2009;46;283;147;136
Zarasai d. mun.;2009;47;317;155;162
Zarasai d. mun.;2009;48;305;169;136
Zarasai d. mun.;2009;49;288;145;143
Zarasai d. mun.;2009;50;288;127;161
Zarasai d. mun.;2009;51;271;127;144
Zarasai d. mun.;2009;52;237;107;130
Zarasai d. mun.;2009;53;240;120;120
Zarasai d. mun.;2009;54;243;130;113
Zarasai d. mun.;2009;55;185;88;97
Zarasai d. mun.;2009;56;253;119;134
Zarasai d. mun.;2009;57;226;98;128
Zarasai d. mun.;2009;58;234;100;134
Zarasai d. mun.;2009;59;233;103;130
Zarasai d. mun.;2009;60;217;100;117
Zarasai d. mun.;2009;61;231;112;119
Zarasai d. mun.;2009;62;183;92;91
Zarasai d. mun.;2009;63;227;107;120
Zarasai d. mun.;2009;64;202;87;115
Zarasai d. mun.;2009;65;227;89;138
Zarasai d. mun.;2009;66;214;86;128
Zarasai d. mun.;2009;67;273;123;150
Zarasai d. mun.;2009;68;229;85;144
Zarasai d. mun.;2009;69;233;85;148
Zarasai d. mun.;2009;70;252;88;164
Zarasai d. mun.;2009;71;199;72;127
Zarasai d. mun.;2009;72;239;90;149
Zarasai d. mun.;2009;73;240;94;146
Zarasai d. mun.;2009;74;220;91;129
Zarasai d. mun.;2009;75;244;75;169
Zarasai d. mun.;2009;76;210;60;150
Zarasai d. mun.;2009;77;208;59;149
Zarasai d. mun.;2009;78;193;76;117
Zarasai d. mun.;2009;79;193;58;135
Zarasai d. mun.;2009;80;195;47;148
Zarasai d. mun.;2009;81;164;54;110
Zarasai d. mun.;2009;82;130;27;103
Zarasai d. mun.;2009;83;143;37;106
Zarasai d. mun.;2009;84;121;26;95
Zarasai d. mun.;2009;85;397;100;297
Zarasai d. mun.;2010;-1;19013;8899;10114
Zarasai d. mun.;2010;0;155;82;73
Zarasai d. mun.;2010;1;157;84;73
Zarasai d. mun.;2010;2;138;66;72
Zarasai d. mun.;2010;3;162;89;73
Zarasai d. mun.;2010;4;164;83;81
Zarasai d. mun.;2010;5;148;75;73
Zarasai d. mun.;2010;6;148;77;71
Zarasai d. mun.;2010;7;159;84;75
Zarasai d. mun.;2010;8;184;88;96
Zarasai d. mun.;2010;9;207;112;95
Zarasai d. mun.;2010;10;218;110;108
Zarasai d. mun.;2010;11;197;105;92
Zarasai d. mun.;2010;12;186;95;91
Zarasai d. mun.;2010;13;212;121;91
Zarasai d. mun.;2010;14;218;108;110
Zarasai d. mun.;2010;15;235;115;120
Zarasai d. mun.;2010;16;275;146;129
Zarasai d. mun.;2010;17;316;148;168
Zarasai d. mun.;2010;18;326;174;152
Zarasai d. mun.;2010;19;318;169;149
Zarasai d. mun.;2010;20;293;132;161
Zarasai d. mun.;2010;21;302;149;153
Zarasai d. mun.;2010;22;325;164;161
Zarasai d. mun.;2010;23;297;155;142
Zarasai d. mun.;2010;24;276;140;136
Zarasai d. mun.;2010;25;252;129;123
Zarasai d. mun.;2010;26;259;147;112
Zarasai d. mun.;2010;27;186;107;79
Zarasai d. mun.;2010;28;148;95;53
Zarasai d. mun.;2010;29;109;76;33
Zarasai d. mun.;2010;30;141;75;66
Zarasai d. mun.;2010;31;154;101;53
Zarasai d. mun.;2010;32;137;61;76
Zarasai d. mun.;2010;33;160;85;75
Zarasai d. mun.;2010;34;168;98;70
Zarasai d. mun.;2010;35;165;89;76
Zarasai d. mun.;2010;36;183;103;80
Zarasai d. mun.;2010;37;223;119;104
Zarasai d. mun.;2010;38;204;102;102
Zarasai d. mun.;2010;39;246;122;124
Zarasai d. mun.;2010;40;250;137;113
Zarasai d. mun.;2010;41;249;131;118
Zarasai d. mun.;2010;42;242;108;134
Zarasai d. mun.;2010;43;249;119;130
Zarasai d. mun.;2010;44;268;145;123
Zarasai d. mun.;2010;45;297;151;146
Zarasai d. mun.;2010;46;273;146;127
Zarasai d. mun.;2010;47;276;140;136
Zarasai d. mun.;2010;48;315;154;161
Zarasai d. mun.;2010;49;302;166;136
Zarasai d. mun.;2010;50;284;141;143
Zarasai d. mun.;2010;51;289;128;161
Zarasai d. mun.;2010;52;271;127;144
Zarasai d. mun.;2010;53;239;108;131
Zarasai d. mun.;2010;54;237;118;119
Zarasai d. mun.;2010;55;244;130;114
Zarasai d. mun.;2010;56;184;88;96
Zarasai d. mun.;2010;57;251;120;131
Zarasai d. mun.;2010;58;222;95;127
Zarasai d. mun.;2010;59;236;103;133
Zarasai d. mun.;2010;60;231;101;130
Zarasai d. mun.;2010;61;218;100;118
Zarasai d. mun.;2010;62;224;107;117
Zarasai d. mun.;2010;63;182;90;92
Zarasai d. mun.;2010;64;220;101;119
Zarasai d. mun.;2010;65;199;86;113
Zarasai d. mun.;2010;66;219;82;137
Zarasai d. mun.;2010;67;210;84;126
Zarasai d. mun.;2010;68;264;116;148
Zarasai d. mun.;2010;69;224;80;144
Zarasai d. mun.;2010;70;221;76;145
Zarasai d. mun.;2010;71;247;85;162
Zarasai d. mun.;2010;72;191;65;126
Zarasai d. mun.;2010;73;227;83;144
Zarasai d. mun.;2010;74;223;81;142
Zarasai d. mun.;2010;75;206;85;121
Zarasai d. mun.;2010;76;231;65;166
Zarasai d. mun.;2010;77;200;52;148
Zarasai d. mun.;2010;78;196;54;142
Zarasai d. mun.;2010;79;177;71;106
Zarasai d. mun.;2010;80;181;51;130
Zarasai d. mun.;2010;81;183;43;140
Zarasai d. mun.;2010;82;146;47;99
Zarasai d. mun.;2010;83;118;23;95
Zarasai d. mun.;2010;84;124;32;92
Zarasai d. mun.;2010;85;422;104;318
Zarasai d. mun.;2011;-1;18472;8644;9828
Zarasai d. mun.;2011;0;124;58;66
Zarasai d. mun.;2011;1;135;79;56
Zarasai d. mun.;2011;2;136;75;61
Zarasai d. mun.;2011;3;118;57;61
Zarasai d. mun.;2011;4;148;79;69
Zarasai d. mun.;2011;5;152;80;72
Zarasai d. mun.;2011;6;119;64;55
Zarasai d. mun.;2011;7;146;75;71
Zarasai d. mun.;2011;8;143;76;67
Zarasai d. mun.;2011;9;171;89;82
Zarasai d. mun.;2011;10;200;105;95
Zarasai d. mun.;2011;11;201;100;101
Zarasai d. mun.;2011;12;194;104;90
Zarasai d. mun.;2011;13;199;103;96
Zarasai d. mun.;2011;14;209;119;90
Zarasai d. mun.;2011;15;212;103;109
Zarasai d. mun.;2011;16;235;117;118
Zarasai d. mun.;2011;17;265;140;125
Zarasai d. mun.;2011;18;299;140;159
Zarasai d. mun.;2011;19;281;158;123
Zarasai d. mun.;2011;20;270;141;129
Zarasai d. mun.;2011;21;226;113;113
Zarasai d. mun.;2011;22;234;117;117
Zarasai d. mun.;2011;23;240;135;105
Zarasai d. mun.;2011;24;225;128;97
Zarasai d. mun.;2011;25;200;115;85
Zarasai d. mun.;2011;26;174;93;81
Zarasai d. mun.;2011;27;201;118;83
Zarasai d. mun.;2011;28;160;81;79
Zarasai d. mun.;2011;29;140;79;61
Zarasai d. mun.;2011;30;142;80;62
Zarasai d. mun.;2011;31;167;87;80
Zarasai d. mun.;2011;32;176;99;77
Zarasai d. mun.;2011;33;175;90;85
Zarasai d. mun.;2011;34;195;103;92
Zarasai d. mun.;2011;35;196;110;86
Zarasai d. mun.;2011;36;199;102;97
Zarasai d. mun.;2011;37;213;107;106
Zarasai d. mun.;2011;38;231;113;118
Zarasai d. mun.;2011;39;235;123;112
Zarasai d. mun.;2011;40;261;134;127
Zarasai d. mun.;2011;41;257;142;115
Zarasai d. mun.;2011;42;274;140;134
Zarasai d. mun.;2011;43;267;122;145
Zarasai d. mun.;2011;44;273;132;141
Zarasai d. mun.;2011;45;286;146;140
Zarasai d. mun.;2011;46;310;163;147
Zarasai d. mun.;2011;47;289;150;139
Zarasai d. mun.;2011;48;287;141;146
Zarasai d. mun.;2011;49;310;148;162
Zarasai d. mun.;2011;50;296;163;133
Zarasai d. mun.;2011;51;289;146;143
Zarasai d. mun.;2011;52;282;123;159
Zarasai d. mun.;2011;53;270;136;134
Zarasai d. mun.;2011;54;255;121;134
Zarasai d. mun.;2011;55;237;111;126
Zarasai d. mun.;2011;56;251;137;114
Zarasai d. mun.;2011;57;199;98;101
Zarasai d. mun.;2011;58;256;121;135
Zarasai d. mun.;2011;59;227;97;130
Zarasai d. mun.;2011;60;239;100;139
Zarasai d. mun.;2011;61;228;95;133
Zarasai d. mun.;2011;62;223;103;120
Zarasai d. mun.;2011;63;221;105;116
Zarasai d. mun.;2011;64;176;84;92
Zarasai d. mun.;2011;65;210;96;114
Zarasai d. mun.;2011;66;211;91;120
Zarasai d. mun.;2011;67;215;81;134
Zarasai d. mun.;2011;68;209;88;121
Zarasai d. mun.;2011;69;252;111;141
Zarasai d. mun.;2011;70;213;76;137
Zarasai d. mun.;2011;71;218;72;146
Zarasai d. mun.;2011;72;233;79;154
Zarasai d. mun.;2011;73;178;58;120
Zarasai d. mun.;2011;74;212;73;139
Zarasai d. mun.;2011;75;213;75;138
Zarasai d. mun.;2011;76;198;79;119
Zarasai d. mun.;2011;77;221;60;161
Zarasai d. mun.;2011;78;179;47;132
Zarasai d. mun.;2011;79;182;50;132
Zarasai d. mun.;2011;80;159;59;100
Zarasai d. mun.;2011;81;160;40;120
Zarasai d. mun.;2011;82;152;33;119
Zarasai d. mun.;2011;83;131;37;94
Zarasai d. mun.;2011;84;105;20;85
Zarasai d. mun.;2011;85;472;106;366
Zarasai d. mun.;2012;-1;18013;8442;9571
Zarasai d. mun.;2012;0;143;88;55
Zarasai d. mun.;2012;1;121;58;63
Zarasai d. mun.;2012;2;131;79;52
Zarasai d. mun.;2012;3;131;68;63
Zarasai d. mun.;2012;4;119;57;62
Zarasai d. mun.;2012;5;144;78;66
Zarasai d. mun.;2012;6;152;80;72
Zarasai d. mun.;2012;7;116;63;53
Zarasai d. mun.;2012;8;146;76;70
Zarasai d. mun.;2012;9;140;74;66
Zarasai d. mun.;2012;10;169;87;82
Zarasai d. mun.;2012;11;195;102;93
Zarasai d. mun.;2012;12;198;96;102
Zarasai d. mun.;2012;13;193;103;90
Zarasai d. mun.;2012;14;198;102;96
Zarasai d. mun.;2012;15;207;116;91
Zarasai d. mun.;2012;16;214;104;110
Zarasai d. mun.;2012;17;233;115;118
Zarasai d. mun.;2012;18;261;136;125
Zarasai d. mun.;2012;19;291;134;157
Zarasai d. mun.;2012;20;273;154;119
Zarasai d. mun.;2012;21;269;140;129
Zarasai d. mun.;2012;22;210;104;106
Zarasai d. mun.;2012;23;211;111;100
Zarasai d. mun.;2012;24;224;125;99
Zarasai d. mun.;2012;25;204;123;81
Zarasai d. mun.;2012;26;188;110;78
Zarasai d. mun.;2012;27;161;87;74
Zarasai d. mun.;2012;28;194;114;80
Zarasai d. mun.;2012;29;143;73;70
Zarasai d. mun.;2012;30;128;77;51
Zarasai d. mun.;2012;31;133;78;55
Zarasai d. mun.;2012;32;160;82;78
Zarasai d. mun.;2012;33;172;94;78
Zarasai d. mun.;2012;34;169;88;81
Zarasai d. mun.;2012;35;185;99;86
Zarasai d. mun.;2012;36;188;103;85
Zarasai d. mun.;2012;37;194;98;96
Zarasai d. mun.;2012;38;211;105;106
Zarasai d. mun.;2012;39;228;110;118
Zarasai d. mun.;2012;40;241;126;115
Zarasai d. mun.;2012;41;257;131;126
Zarasai d. mun.;2012;42;251;137;114
Zarasai d. mun.;2012;43;270;141;129
Zarasai d. mun.;2012;44;267;124;143
Zarasai d. mun.;2012;45;270;130;140
Zarasai d. mun.;2012;46;285;144;141
Zarasai d. mun.;2012;47;304;161;143
Zarasai d. mun.;2012;48;292;150;142
Zarasai d. mun.;2012;49;283;137;146
Zarasai d. mun.;2012;50;308;148;160
Zarasai d. mun.;2012;51;295;161;134
Zarasai d. mun.;2012;52;286;144;142
Zarasai d. mun.;2012;53;278;117;161
Zarasai d. mun.;2012;54;269;135;134
Zarasai d. mun.;2012;55;254;120;134
Zarasai d. mun.;2012;56;233;108;125
Zarasai d. mun.;2012;57;244;135;109
Zarasai d. mun.;2012;58;194;96;98
Zarasai d. mun.;2012;59;252;116;136
Zarasai d. mun.;2012;60;229;98;131
Zarasai d. mun.;2012;61;233;95;138
Zarasai d. mun.;2012;62;225;92;133
Zarasai d. mun.;2012;63;218;98;120
Zarasai d. mun.;2012;64;215;100;115
Zarasai d. mun.;2012;65;171;79;92
Zarasai d. mun.;2012;66;202;90;112
Zarasai d. mun.;2012;67;206;87;119
Zarasai d. mun.;2012;68;210;76;134
Zarasai d. mun.;2012;69;205;86;119
Zarasai d. mun.;2012;70;240;104;136
Zarasai d. mun.;2012;71;203;68;135
Zarasai d. mun.;2012;72;215;69;146
Zarasai d. mun.;2012;73;228;78;150
Zarasai d. mun.;2012;74;171;55;116
Zarasai d. mun.;2012;75;204;69;135
Zarasai d. mun.;2012;76;206;70;136
Zarasai d. mun.;2012;77;187;72;115
Zarasai d. mun.;2012;78;206;57;149
Zarasai d. mun.;2012;79;164;45;119
Zarasai d. mun.;2012;80;164;43;121
Zarasai d. mun.;2012;81;143;51;92
Zarasai d. mun.;2012;82;153;38;115
Zarasai d. mun.;2012;83;131;28;103
Zarasai d. mun.;2012;84;115;31;84
Zarasai d. mun.;2012;85;489;111;378
Zarasai d. mun.;2013;-1;17693;8298;9395
Zarasai d. mun.;2013;0;171;93;78
Zarasai d. mun.;2013;1;143;88;55
Zarasai d. mun.;2013;2;122;58;64
Zarasai d. mun.;2013;3;130;79;51
Zarasai d. mun.;2013;4;129;66;63
Zarasai d. mun.;2013;5;115;54;61
Zarasai d. mun.;2013;6;146;82;64
Zarasai d. mun.;2013;7;154;82;72
Zarasai d. mun.;2013;8;114;62;52
Zarasai d. mun.;2013;9;148;76;72
Zarasai d. mun.;2013;10;136;74;62
Zarasai d. mun.;2013;11;166;87;79
Zarasai d. mun.;2013;12;194;100;94
Zarasai d. mun.;2013;13;193;94;99
Zarasai d. mun.;2013;14;193;103;90
Zarasai d. mun.;2013;15;197;101;96
Zarasai d. mun.;2013;16;207;116;91
Zarasai d. mun.;2013;17;215;105;110
Zarasai d. mun.;2013;18;232;113;119
Zarasai d. mun.;2013;19;257;134;123
Zarasai d. mun.;2013;20;290;132;158
Zarasai d. mun.;2013;21;268;150;118
Zarasai d. mun.;2013;22;259;136;123
Zarasai d. mun.;2013;23;199;100;99
Zarasai d. mun.;2013;24;187;105;82
Zarasai d. mun.;2013;25;210;121;89
Zarasai d. mun.;2013;26;188;116;72
Zarasai d. mun.;2013;27;172;99;73
Zarasai d. mun.;2013;28;154;88;66
Zarasai d. mun.;2013;29;188;110;78
Zarasai d. mun.;2013;30;133;70;63
Zarasai d. mun.;2013;31;125;74;51
Zarasai d. mun.;2013;32;131;76;55
Zarasai d. mun.;2013;33;153;82;71
Zarasai d. mun.;2013;34;165;89;76
Zarasai d. mun.;2013;35;167;88;79
Zarasai d. mun.;2013;36;176;92;84
Zarasai d. mun.;2013;37;186;101;85
Zarasai d. mun.;2013;38;188;94;94
Zarasai d. mun.;2013;39;206;100;106
Zarasai d. mun.;2013;40;223;105;118
Zarasai d. mun.;2013;41;243;127;116
Zarasai d. mun.;2013;42;254;132;122
Zarasai d. mun.;2013;43;253;137;116
Zarasai d. mun.;2013;44;271;141;130
Zarasai d. mun.;2013;45;264;122;142
Zarasai d. mun.;2013;46;272;129;143
Zarasai d. mun.;2013;47;287;143;144
Zarasai d. mun.;2013;48;301;158;143
Zarasai d. mun.;2013;49;288;149;139
Zarasai d. mun.;2013;50;284;140;144
Zarasai d. mun.;2013;51;310;148;162
Zarasai d. mun.;2013;52;298;161;137
Zarasai d. mun.;2013;53;279;139;140
Zarasai d. mun.;2013;54;278;115;163
Zarasai d. mun.;2013;55;268;133;135
Zarasai d. mun.;2013;56;254;118;136
Zarasai d. mun.;2013;57;230;105;125
Zarasai d. mun.;2013;58;238;129;109
Zarasai d. mun.;2013;59;192;93;99
Zarasai d. mun.;2013;60;243;109;134
Zarasai d. mun.;2013;61;220;91;129
Zarasai d. mun.;2013;62;229;91;138
Zarasai d. mun.;2013;63;223;91;132
Zarasai d. mun.;2013;64;214;93;121
Zarasai d. mun.;2013;65;209;96;113
Zarasai d. mun.;2013;66;171;79;92
Zarasai d. mun.;2013;67;201;90;111
Zarasai d. mun.;2013;68;202;83;119
Zarasai d. mun.;2013;69;199;73;126
Zarasai d. mun.;2013;70;196;82;114
Zarasai d. mun.;2013;71;228;94;134
Zarasai d. mun.;2013;72;201;67;134
Zarasai d. mun.;2013;73;213;68;145
Zarasai d. mun.;2013;74;227;78;149
Zarasai d. mun.;2013;75;169;53;116
Zarasai d. mun.;2013;76;195;63;132
Zarasai d. mun.;2013;77;197;68;129
Zarasai d. mun.;2013;78;174;62;112
Zarasai d. mun.;2013;79;198;52;146
Zarasai d. mun.;2013;80;159;44;115
Zarasai d. mun.;2013;81;148;37;111
Zarasai d. mun.;2013;82;129;48;81
Zarasai d. mun.;2013;83;141;32;109
Zarasai d. mun.;2013;84;114;21;93
Zarasai d. mun.;2013;85;499;119;380
Zarasai d. mun.;2014;-1;17316;8132;9184
Zarasai d. mun.;2014;0;131;61;70
Zarasai d. mun.;2014;1;169;91;78
Zarasai d. mun.;2014;2;139;85;54
Zarasai d. mun.;2014;3;119;57;62
Zarasai d. mun.;2014;4;130;81;49
Zarasai d. mun.;2014;5;127;65;62
Zarasai d. mun.;2014;6;114;53;61
Zarasai d. mun.;2014;7;142;83;59
Zarasai d. mun.;2014;8;154;82;72
Zarasai d. mun.;2014;9;112;61;51
Zarasai d. mun.;2014;10;145;74;71
Zarasai d. mun.;2014;11;133;73;60
Zarasai d. mun.;2014;12;169;89;80
Zarasai d. mun.;2014;13;192;99;93
Zarasai d. mun.;2014;14;193;94;99
Zarasai d. mun.;2014;15;192;102;90
Zarasai d. mun.;2014;16;193;99;94
Zarasai d. mun.;2014;17;205;115;90
Zarasai d. mun.;2014;18;216;105;111
Zarasai d. mun.;2014;19;232;113;119
Zarasai d. mun.;2014;20;252;131;121
Zarasai d. mun.;2014;21;281;128;153
Zarasai d. mun.;2014;22;261;144;117
Zarasai d. mun.;2014;23;250;132;118
Zarasai d. mun.;2014;24;196;102;94
Zarasai d. mun.;2014;25;175;99;76
Zarasai d. mun.;2014;26;192;115;77
Zarasai d. mun.;2014;27;173;109;64
Zarasai d. mun.;2014;28;163;98;65
Zarasai d. mun.;2014;29;148;86;62
Zarasai d. mun.;2014;30;166;99;67
Zarasai d. mun.;2014;31;128;69;59
Zarasai d. mun.;2014;32;118;71;47
Zarasai d. mun.;2014;33;134;79;55
Zarasai d. mun.;2014;34;151;84;67
Zarasai d. mun.;2014;35;167;91;76
Zarasai d. mun.;2014;36;159;84;75
Zarasai d. mun.;2014;37;175;95;80
Zarasai d. mun.;2014;38;180;97;83
Zarasai d. mun.;2014;39;184;93;91
Zarasai d. mun.;2014;40;205;100;105
Zarasai d. mun.;2014;41;224;102;122
Zarasai d. mun.;2014;42;245;132;113
Zarasai d. mun.;2014;43;251;129;122
Zarasai d. mun.;2014;44;251;136;115
Zarasai d. mun.;2014;45;269;142;127
Zarasai d. mun.;2014;46;261;121;140
Zarasai d. mun.;2014;47;267;123;144
Zarasai d. mun.;2014;48;282;141;141
Zarasai d. mun.;2014;49;301;157;144
Zarasai d. mun.;2014;50;281;146;135
Zarasai d. mun.;2014;51;285;141;144
Zarasai d. mun.;2014;52;310;148;162
Zarasai d. mun.;2014;53;297;160;137
Zarasai d. mun.;2014;54;276;134;142
Zarasai d. mun.;2014;55;278;115;163
Zarasai d. mun.;2014;56;267;131;136
Zarasai d. mun.;2014;57;254;118;136
Zarasai d. mun.;2014;58;227;100;127
Zarasai d. mun.;2014;59;238;128;110
Zarasai d. mun.;2014;60;187;90;97
Zarasai d. mun.;2014;61;238;105;133
Zarasai d. mun.;2014;62;213;88;125
Zarasai d. mun.;2014;63;223;85;138
Zarasai d. mun.;2014;64;221;90;131
Zarasai d. mun.;2014;65;210;91;119
Zarasai d. mun.;2014;66;203;91;112
Zarasai d. mun.;2014;67;165;75;90
Zarasai d. mun.;2014;68;192;85;107
Zarasai d. mun.;2014;69;198;81;117
Zarasai d. mun.;2014;70;190;68;122
Zarasai d. mun.;2014;71;185;75;110
Zarasai d. mun.;2014;72;217;87;130
Zarasai d. mun.;2014;73;193;62;131
Zarasai d. mun.;2014;74;204;63;141
Zarasai d. mun.;2014;75;215;71;144
Zarasai d. mun.;2014;76;164;51;113
Zarasai d. mun.;2014;77;184;60;124
Zarasai d. mun.;2014;78;184;60;124
Zarasai d. mun.;2014;79;161;56;105
Zarasai d. mun.;2014;80;186;45;141
Zarasai d. mun.;2014;81;151;42;109
Zarasai d. mun.;2014;82;136;34;102
Zarasai d. mun.;2014;83;121;46;75
Zarasai d. mun.;2014;84;125;24;101
Zarasai d. mun.;2014;85;521;115;406
Zarasai d. mun.;2015;-1;17035;7991;9044
Zarasai d. mun.;2015;0;152;69;83
Zarasai d. mun.;2015;1;128;58;70
Zarasai d. mun.;2015;2;162;86;76
Zarasai d. mun.;2015;3;135;81;54
Zarasai d. mun.;2015;4;114;55;59
Zarasai d. mun.;2015;5;125;79;46
Zarasai d. mun.;2015;6;118;60;58
Zarasai d. mun.;2015;7;114;53;61
Zarasai d. mun.;2015;8;140;79;61
Zarasai d. mun.;2015;9;155;83;72
Zarasai d. mun.;2015;10;111;60;51
Zarasai d. mun.;2015;11;142;72;70
Zarasai d. mun.;2015;12;133;72;61
Zarasai d. mun.;2015;13;169;89;80
Zarasai d. mun.;2015;14;195;100;95
Zarasai d. mun.;2015;15;193;95;98
Zarasai d. mun.;2015;16;191;102;89
Zarasai d. mun.;2015;17;196;98;98
Zarasai d. mun.;2015;18;204;112;92
Zarasai d. mun.;2015;19;211;103;108
Zarasai d. mun.;2015;20;223;108;115
Zarasai d. mun.;2015;21;249;129;120
Zarasai d. mun.;2015;22;277;127;150
Zarasai d. mun.;2015;23;254;139;115
Zarasai d. mun.;2015;24;245;131;114
Zarasai d. mun.;2015;25;186;97;89
Zarasai d. mun.;2015;26;160;96;64
Zarasai d. mun.;2015;27;177;112;65
Zarasai d. mun.;2015;28;164;109;55
Zarasai d. mun.;2015;29;153;94;59
Zarasai d. mun.;2015;30;143;84;59
Zarasai d. mun.;2015;31;159;93;66
Zarasai d. mun.;2015;32;119;65;54
Zarasai d. mun.;2015;33;116;72;44
Zarasai d. mun.;2015;34;136;81;55
Zarasai d. mun.;2015;35;145;81;64
Zarasai d. mun.;2015;36;154;82;72
Zarasai d. mun.;2015;37;161;87;74
Zarasai d. mun.;2015;38;177;98;79
Zarasai d. mun.;2015;39;174;95;79
Zarasai d. mun.;2015;40;183;91;92
Zarasai d. mun.;2015;41;207;103;104
Zarasai d. mun.;2015;42;226;105;121
Zarasai d. mun.;2015;43;241;130;111
Zarasai d. mun.;2015;44;249;127;122
Zarasai d. mun.;2015;45;253;137;116
Zarasai d. mun.;2015;46;266;138;128
Zarasai d. mun.;2015;47;263;123;140
Zarasai d. mun.;2015;48;268;121;147
Zarasai d. mun.;2015;49;281;140;141
Zarasai d. mun.;2015;50;304;160;144
Zarasai d. mun.;2015;51;282;145;137
Zarasai d. mun.;2015;52;281;138;143
Zarasai d. mun.;2015;53;311;147;164
Zarasai d. mun.;2015;54;295;158;137
Zarasai d. mun.;2015;55;277;134;143
Zarasai d. mun.;2015;56;277;114;163
Zarasai d. mun.;2015;57;270;130;140
Zarasai d. mun.;2015;58;257;118;139
Zarasai d. mun.;2015;59;226;99;127
Zarasai d. mun.;2015;60;238;125;113
Zarasai d. mun.;2015;61;180;85;95
Zarasai d. mun.;2015;62;232;102;130
Zarasai d. mun.;2015;63;210;87;123
Zarasai d. mun.;2015;64;217;82;135
Zarasai d. mun.;2015;65;220;90;130
Zarasai d. mun.;2015;66;208;85;123
Zarasai d. mun.;2015;67;197;85;112
Zarasai d. mun.;2015;68;165;75;90
Zarasai d. mun.;2015;69;185;78;107
Zarasai d. mun.;2015;70;190;76;114
Zarasai d. mun.;2015;71;185;63;122
Zarasai d. mun.;2015;72;177;70;107
Zarasai d. mun.;2015;73;209;80;129
Zarasai d. mun.;2015;74;184;56;128
Zarasai d. mun.;2015;75;196;60;136
Zarasai d. mun.;2015;76;207;68;139
Zarasai d. mun.;2015;77;153;47;106
Zarasai d. mun.;2015;78;174;56;118
Zarasai d. mun.;2015;79;180;58;122
Zarasai d. mun.;2015;80;152;50;102
Zarasai d. mun.;2015;81;171;43;128
Zarasai d. mun.;2015;82;145;41;104
Zarasai d. mun.;2015;83;127;31;96
Zarasai d. mun.;2015;84;111;41;70
Zarasai d. mun.;2015;85;545;113;432
Zarasai d. mun.;2016;-1;16636;7786;8850
Zarasai d. mun.;2016;0;120;60;60
Zarasai d. mun.;2016;1;150;69;81
Zarasai d. mun.;2016;2;125;58;67
Zarasai d. mun.;2016;3;156;83;73
Zarasai d. mun.;2016;4;137;79;58
Zarasai d. mun.;2016;5;112;54;58
Zarasai d. mun.;2016;6;126;79;47
Zarasai d. mun.;2016;7;118;62;56
Zarasai d. mun.;2016;8;113;55;58
Zarasai d. mun.;2016;9;139;79;60
Zarasai d. mun.;2016;10;155;85;70
Zarasai d. mun.;2016;11;111;58;53
Zarasai d. mun.;2016;12;136;66;70
Zarasai d. mun.;2016;13;135;73;62
Zarasai d. mun.;2016;14;166;87;79
Zarasai d. mun.;2016;15;195;100;95
Zarasai d. mun.;2016;16;191;94;97
Zarasai d. mun.;2016;17;189;99;90
Zarasai d. mun.;2016;18;196;98;98
Zarasai d. mun.;2016;19;195;107;88
Zarasai d. mun.;2016;20;201;97;104
Zarasai d. mun.;2016;21;216;103;113
Zarasai d. mun.;2016;22;234;118;116
Zarasai d. mun.;2016;23;267;121;146
Zarasai d. mun.;2016;24;238;133;105
Zarasai d. mun.;2016;25;236;127;109
Zarasai d. mun.;2016;26;172;88;84
Zarasai d. mun.;2016;27;147;95;52
Zarasai d. mun.;2016;28;164;106;58
Zarasai d. mun.;2016;29;146;103;43
Zarasai d. mun.;2016;30;145;91;54
Zarasai d. mun.;2016;31;124;73;51
Zarasai d. mun.;2016;32;150;87;63
Zarasai d. mun.;2016;33;120;67;53
Zarasai d. mun.;2016;34;114;66;48
Zarasai d. mun.;2016;35;129;73;56
Zarasai d. mun.;2016;36;144;78;66
Zarasai d. mun.;2016;37;156;83;73
Zarasai d. mun.;2016;38;159;85;74
Zarasai d. mun.;2016;39;174;97;77
Zarasai d. mun.;2016;40;171;94;77
Zarasai d. mun.;2016;41;180;91;89
Zarasai d. mun.;2016;42;208;103;105
Zarasai d. mun.;2016;43;226;104;122
Zarasai d. mun.;2016;44;240;128;112
Zarasai d. mun.;2016;45;249;129;120
Zarasai d. mun.;2016;46;251;135;116
Zarasai d. mun.;2016;47;266;139;127
Zarasai d. mun.;2016;48;260;121;139
Zarasai d. mun.;2016;49;266;117;149
Zarasai d. mun.;2016;50;276;136;140
Zarasai d. mun.;2016;51;299;157;142
Zarasai d. mun.;2016;52;281;146;135
Zarasai d. mun.;2016;53;276;135;141
Zarasai d. mun.;2016;54;309;143;166
Zarasai d. mun.;2016;55;294;157;137
Zarasai d. mun.;2016;56;279;137;142
Zarasai d. mun.;2016;57;277;113;164
Zarasai d. mun.;2016;58;272;131;141
Zarasai d. mun.;2016;59;254;114;140
Zarasai d. mun.;2016;60;220;94;126
Zarasai d. mun.;2016;61;236;124;112
Zarasai d. mun.;2016;62;176;83;93
Zarasai d. mun.;2016;63;225;96;129
Zarasai d. mun.;2016;64;202;79;123
Zarasai d. mun.;2016;65;217;82;135
Zarasai d. mun.;2016;66;218;87;131
Zarasai d. mun.;2016;67;199;79;120
Zarasai d. mun.;2016;68;189;78;111
Zarasai d. mun.;2016;69;163;71;92
Zarasai d. mun.;2016;70;185;79;106
Zarasai d. mun.;2016;71;181;68;113
Zarasai d. mun.;2016;72;181;61;120
Zarasai d. mun.;2016;73;170;65;105
Zarasai d. mun.;2016;74;206;78;128
Zarasai d. mun.;2016;75;173;53;120
Zarasai d. mun.;2016;76;186;55;131
Zarasai d. mun.;2016;77;194;61;133
Zarasai d. mun.;2016;78;147;44;103
Zarasai d. mun.;2016;79;162;47;115
Zarasai d. mun.;2016;80;170;54;116
Zarasai d. mun.;2016;81;145;46;99
Zarasai d. mun.;2016;82;153;38;115
Zarasai d. mun.;2016;83;137;39;98
Zarasai d. mun.;2016;84;111;28;83
Zarasai d. mun.;2016;85;555;131;424
Zarasai d. mun.;2017;-1;16169;7564;8605
Zarasai d. mun.;2017;0;139;71;68
Zarasai d. mun.;2017;1;116;60;56
Zarasai d. mun.;2017;2;144;67;77
Zarasai d. mun.;2017;3;124;56;68
Zarasai d. mun.;2017;4;152;82;70
Zarasai d. mun.;2017;5;129;74;55
Zarasai d. mun.;2017;6;112;55;57
Zarasai d. mun.;2017;7;124;78;46
Zarasai d. mun.;2017;8;120;62;58
Zarasai d. mun.;2017;9;113;54;59
Zarasai d. mun.;2017;10;139;79;60
Zarasai d. mun.;2017;11;155;82;73
Zarasai d. mun.;2017;12;112;58;54
Zarasai d. mun.;2017;13;136;67;69
Zarasai d. mun.;2017;14;133;73;60
Zarasai d. mun.;2017;15;165;87;78
Zarasai d. mun.;2017;16;192;98;94
Zarasai d. mun.;2017;17;190;94;96
Zarasai d. mun.;2017;18;186;97;89
Zarasai d. mun.;2017;19;189;98;91
Zarasai d. mun.;2017;20;190;108;82
Zarasai d. mun.;2017;21;196;92;104
Zarasai d. mun.;2017;22;215;101;114
Zarasai d. mun.;2017;23;224;117;107
Zarasai d. mun.;2017;24;252;116;136
Zarasai d. mun.;2017;25;220;124;96
Zarasai d. mun.;2017;26;217;121;96
Zarasai d. mun.;2017;27;152;77;75
Zarasai d. mun.;2017;28;128;89;39
Zarasai d. mun.;2017;29;155;103;52
Zarasai d. mun.;2017;30;136;97;39
Zarasai d. mun.;2017;31;130;81;49
Zarasai d. mun.;2017;32;104;57;47
Zarasai d. mun.;2017;33;146;86;60
Zarasai d. mun.;2017;34;109;61;48
Zarasai d. mun.;2017;35;104;61;43
Zarasai d. mun.;2017;36;121;69;52
Zarasai d. mun.;2017;37;138;77;61
Zarasai d. mun.;2017;38;148;78;70
Zarasai d. mun.;2017;39;154;81;73
Zarasai d. mun.;2017;40;173;96;77
Zarasai d. mun.;2017;41;174;95;79
Zarasai d. mun.;2017;42;176;85;91
Zarasai d. mun.;2017;43;210;105;105
Zarasai d. mun.;2017;44;224;102;122
Zarasai d. mun.;2017;45;236;126;110
Zarasai d. mun.;2017;46;245;127;118
Zarasai d. mun.;2017;47;251;136;115
Zarasai d. mun.;2017;48;265;137;128
Zarasai d. mun.;2017;49;258;118;140
Zarasai d. mun.;2017;50;265;119;146
Zarasai d. mun.;2017;51;274;134;140
Zarasai d. mun.;2017;52;294;152;142
Zarasai d. mun.;2017;53;280;146;134
Zarasai d. mun.;2017;54;271;132;139
Zarasai d. mun.;2017;55;301;138;163
Zarasai d. mun.;2017;56;291;154;137
Zarasai d. mun.;2017;57;273;134;139
Zarasai d. mun.;2017;58;275;111;164
Zarasai d. mun.;2017;59;265;123;142
Zarasai d. mun.;2017;60;247;109;138
Zarasai d. mun.;2017;61;216;90;126
Zarasai d. mun.;2017;62;233;120;113
Zarasai d. mun.;2017;63;173;82;91
Zarasai d. mun.;2017;64;220;92;128
Zarasai d. mun.;2017;65;200;79;121
Zarasai d. mun.;2017;66;216;84;132
Zarasai d. mun.;2017;67;215;85;130
Zarasai d. mun.;2017;68;192;75;117
Zarasai d. mun.;2017;69;186;74;112
Zarasai d. mun.;2017;70;158;67;91
Zarasai d. mun.;2017;71;175;73;102
Zarasai d. mun.;2017;72;168;61;107
Zarasai d. mun.;2017;73;172;57;115
Zarasai d. mun.;2017;74;167;63;104
Zarasai d. mun.;2017;75;194;69;125
Zarasai d. mun.;2017;76;163;51;112
Zarasai d. mun.;2017;77;178;53;125
Zarasai d. mun.;2017;78;184;56;128
Zarasai d. mun.;2017;79;137;40;97
Zarasai d. mun.;2017;80;150;45;105
Zarasai d. mun.;2017;81;160;49;111
Zarasai d. mun.;2017;82;134;41;93
Zarasai d. mun.;2017;83;137;30;107
Zarasai d. mun.;2017;84;119;34;85
Zarasai d. mun.;2017;85;565;127;438
Zarasai d. mun.;2018;-1;15668;7300;8368
Zarasai d. mun.;2018;0;123;58;65
Zarasai d. mun.;2018;1;134;69;65
Zarasai d. mun.;2018;2;115;62;53
Zarasai d. mun.;2018;3;147;67;80
Zarasai d. mun.;2018;4;125;57;68
Zarasai d. mun.;2018;5;151;79;72
Zarasai d. mun.;2018;6;127;71;56
Zarasai d. mun.;2018;7;111;53;58
Zarasai d. mun.;2018;8;124;77;47
Zarasai d. mun.;2018;9;120;64;56
Zarasai d. mun.;2018;10;111;51;60
Zarasai d. mun.;2018;11;139;79;60
Zarasai d. mun.;2018;12;152;81;71
Zarasai d. mun.;2018;13;112;58;54
Zarasai d. mun.;2018;14;135;65;70
Zarasai d. mun.;2018;15;130;73;57
Zarasai d. mun.;2018;16;166;87;79
Zarasai d. mun.;2018;17;190;96;94
Zarasai d. mun.;2018;18;187;93;94
Zarasai d. mun.;2018;19;170;89;81
Zarasai d. mun.;2018;20;174;92;82
Zarasai d. mun.;2018;21;176;102;74
Zarasai d. mun.;2018;22;181;86;95
Zarasai d. mun.;2018;23;197;90;107
Zarasai d. mun.;2018;24;218;111;107
Zarasai d. mun.;2018;25;234;116;118
Zarasai d. mun.;2018;26;200;112;88
Zarasai d. mun.;2018;27;197;108;89
Zarasai d. mun.;2018;28;140;72;68
Zarasai d. mun.;2018;29;116;86;30
Zarasai d. mun.;2018;30;135;89;46
Zarasai d. mun.;2018;31;121;82;39
Zarasai d. mun.;2018;32;118;76;42
Zarasai d. mun.;2018;33;104;57;47
Zarasai d. mun.;2018;34;131;76;55
Zarasai d. mun.;2018;35;103;60;43
Zarasai d. mun.;2018;36;96;53;43
Zarasai d. mun.;2018;37;114;64;50
Zarasai d. mun.;2018;38;136;75;61
Zarasai d. mun.;2018;39;142;74;68
Zarasai d. mun.;2018;40;149;79;70
Zarasai d. mun.;2018;41;167;92;75
Zarasai d. mun.;2018;42;169;93;76
Zarasai d. mun.;2018;43;178;85;93
Zarasai d. mun.;2018;44;204;101;103
Zarasai d. mun.;2018;45;219;100;119
Zarasai d. mun.;2018;46;235;128;107
Zarasai d. mun.;2018;47;242;127;115
Zarasai d. mun.;2018;48;247;134;113
Zarasai d. mun.;2018;49;261;136;125
Zarasai d. mun.;2018;50;256;115;141
Zarasai d. mun.;2018;51;265;114;151
Zarasai d. mun.;2018;52;269;132;137
Zarasai d. mun.;2018;53;291;149;142
Zarasai d. mun.;2018;54;284;147;137
Zarasai d. mun.;2018;55;266;128;138
Zarasai d. mun.;2018;56;297;136;161
Zarasai d. mun.;2018;57;285;149;136
Zarasai d. mun.;2018;58;272;134;138
Zarasai d. mun.;2018;59;264;105;159
Zarasai d. mun.;2018;60;263;123;140
Zarasai d. mun.;2018;61;245;107;138
Zarasai d. mun.;2018;62;216;89;127
Zarasai d. mun.;2018;63;223;115;108
Zarasai d. mun.;2018;64;164;75;89
Zarasai d. mun.;2018;65;219;92;127
Zarasai d. mun.;2018;66;202;80;122
Zarasai d. mun.;2018;67;208;79;129
Zarasai d. mun.;2018;68;211;83;128
Zarasai d. mun.;2018;69;188;70;118
Zarasai d. mun.;2018;70;181;71;110
Zarasai d. mun.;2018;71;154;64;90
Zarasai d. mun.;2018;72;169;70;99
Zarasai d. mun.;2018;73;161;60;101
Zarasai d. mun.;2018;74;164;53;111
Zarasai d. mun.;2018;75;161;60;101
Zarasai d. mun.;2018;76;191;68;123
Zarasai d. mun.;2018;77;150;44;106
Zarasai d. mun.;2018;78;172;50;122
Zarasai d. mun.;2018;79;174;49;125
Zarasai d. mun.;2018;80;130;35;95
Zarasai d. mun.;2018;81;143;41;102
Zarasai d. mun.;2018;82;153;45;108
Zarasai d. mun.;2018;83;123;39;84
Zarasai d. mun.;2018;84;125;26;99
Zarasai d. mun.;2018;85;556;118;438
